Nr.;"Darželio pavadinimas";"Grupės pavadinimas";"Vaiko Identifikacinis Nr.";"Deklaruotas mieste";"Pateisintos dėl ligos";"Pateisintos dėl kitų priežasčių";"Nepateisintos dienos";"Praleistos dienos Viso"
1;Aitvaras;"VIJURKAI (ALERG.)";6936031222;Ne;0;0;1;1
2;Aitvaras;"VIJURKAI (ALERG.)";2566375128;Ne;0;14;0;14
3;Aitvaras;"VIJURKAI (ALERG.)";1879540041;Ne;4;5;0;9
4;Aitvaras;"VIJURKAI (ALERG.)";8206046301;Ne;16;0;1;17
5;Aitvaras;"VIJURKAI (ALERG.)";1347364985;Ne;2;0;0;2
6;Aitvaras;"VIJURKAI (ALERG.)";9157794193;Ne;14;2;0;16
7;Aitvaras;"VIJURKAI (ALERG.)";9562494357;Ne;5;1;0;6
8;Aitvaras;"VIJURKAI (ALERG.)";6021342178;Ne;11;2;0;13
9;Aitvaras;"VIJURKAI (ALERG.)";2650483861;Ne;5;2;0;7
10;Aitvaras;"VIJURKAI (ALERG.)";2601983670;Ne;0;1;0;1
11;Aitvaras;"VIJURKAI (ALERG.)";3570820823;Ne;0;0;1;1
12;Aitvaras;"VIJURKAI (ALERG.)";6444377924;Ne;5;3;0;8
13;Aitvaras;"VIJURKAI (ALERG.)";4702400490;Ne;2;0;0;2
14;Aitvaras;"VIJURKAI (ALERG.)";9807784148;Ne;5;1;0;6
15;Aitvaras;"VIJURKAI (ALERG.)";8641433486;Ne;3;3;0;6
16;Aitvaras;"VIJURKAI (ALERG.)";5619137905;Ne;3;0;0;3
17;Aitvaras;"SMALSUČIAI (ALERG.)";7109001184;Ne;2;2;0;4
18;Aitvaras;"SMALSUČIAI (ALERG.)";4114397590;Ne;0;2;0;2
19;Aitvaras;"SMALSUČIAI (ALERG.)";2357399981;Ne;15;0;0;15
20;Aitvaras;"SMALSUČIAI (ALERG.)";2760970218;Ne;4;1;0;5
21;Aitvaras;"SMALSUČIAI (ALERG.)";8666824607;Ne;5;1;0;6
22;Aitvaras;"SMALSUČIAI (ALERG.)";5378212904;Ne;2;3;0;5
23;Aitvaras;"SMALSUČIAI (ALERG.)";4564723798;Ne;11;0;1;12
24;Aitvaras;"SMALSUČIAI (ALERG.)";4176681907;Ne;5;2;0;7
25;Aitvaras;"SMALSUČIAI (ALERG.)";3655710511;Ne;1;0;0;1
26;Aitvaras;"SMALSUČIAI (ALERG.)";7260577885;Ne;4;1;0;5
27;Aitvaras;"SMALSUČIAI (ALERG.)";4120515569;Ne;10;2;0;12
28;Aitvaras;"SMALSUČIAI (ALERG.)";4612994715;Ne;2;1;3;6
29;Aitvaras;"SMALSUČIAI (ALERG.)";9885781306;Ne;2;2;0;4
30;Aitvaras;"SMALSUČIAI (ALERG.)";1091372798;Ne;9;0;0;9
31;Aitvaras;"SMALSUČIAI (ALERG.)";1115202169;Ne;2;0;0;2
32;Aitvaras;"SMALSUČIAI (ALERG.)";1599183050;Ne;4;0;0;4
33;Aitvaras;PADAUŽIUKAI;8065540507;Ne;2;0;0;2
34;Aitvaras;PADAUŽIUKAI;2328771385;Taip;5;7;0;12
35;Aitvaras;PADAUŽIUKAI;1288810999;Ne;11;0;0;11
36;Aitvaras;PADAUŽIUKAI;6501943902;Ne;3;3;0;6
37;Aitvaras;PADAUŽIUKAI;4350590529;Ne;0;0;1;1
38;Aitvaras;PADAUŽIUKAI;7777235021;Ne;1;2;0;3
39;Aitvaras;PADAUŽIUKAI;5641224483;Ne;0;2;0;2
40;Aitvaras;PADAUŽIUKAI;6214572150;Ne;8;0;0;8
41;Aitvaras;PADAUŽIUKAI;1830134108;Taip;2;0;1;3
42;Aitvaras;PADAUŽIUKAI;5905456814;Ne;6;0;0;6
43;Aitvaras;PADAUŽIUKAI;1761446849;Ne;2;0;0;2
44;Aitvaras;PADAUŽIUKAI;3323458595;Ne;0;1;0;1
45;Aitvaras;PADAUŽIUKAI;2807595769;Ne;1;2;0;3
46;Aitvaras;PADAUŽIUKAI;8360380303;Ne;2;1;0;3
47;Aitvaras;PADAUŽIUKAI;1252145346;Ne;10;0;0;10
48;Aitvaras;PADAUŽIUKAI;7455895024;Ne;2;0;0;2
49;Aitvaras;PADAUŽIUKAI;8439586875;Ne;0;1;0;1
50;Aitvaras;PADAUŽIUKAI;1594675221;Ne;3;2;0;5
51;Aitvaras;"AITVARIUKAI (ALERG.)";3639102842;Ne;0;1;0;1
52;Aitvaras;"AITVARIUKAI (ALERG.)";6587437949;Ne;0;2;0;2
53;Aitvaras;"AITVARIUKAI (ALERG.)";7461284958;Ne;0;1;0;1
54;Aitvaras;"AITVARIUKAI (ALERG.)";3394251305;Ne;0;2;0;2
55;Aitvaras;"AITVARIUKAI (ALERG.)";6459307767;Ne;0;2;0;2
56;Aitvaras;"AITVARIUKAI (ALERG.)";5635576679;Taip;6;1;0;7
57;Aitvaras;"AITVARIUKAI (ALERG.)";7988247429;Ne;0;2;0;2
58;Aitvaras;"AITVARIUKAI (ALERG.)";3653879553;Ne;0;1;0;1
59;Aitvaras;"AITVARIUKAI (ALERG.)";9721273154;Ne;1;0;0;1
60;Aitvaras;"AITVARIUKAI (ALERG.)";8543644000;Ne;4;0;0;4
61;Aitvaras;"AITVARIUKAI (ALERG.)";4204923580;Ne;4;2;0;6
62;Aitvaras;"AITVARIUKAI (ALERG.)";4777266938;Ne;0;1;0;1
63;Aitvaras;"AITVARIUKAI (ALERG.)";7568388141;Ne;3;6;0;9
64;Aitvaras;"AITVARIUKAI (ALERG.)";2146963673;Ne;10;0;0;10
65;Aitvaras;"AITVARIUKAI (ALERG.)";9763502346;Ne;0;3;0;3
66;Aitvaras;"AITVARIUKAI (ALERG.)";9228736015;Ne;8;0;0;8
67;Aitvaras;"AITVARIUKAI (ALERG.)";3775634117;Ne;5;0;0;5
68;Aitvaras;"AITVARIUKAI (ALERG.)";2615576367;Ne;5;2;0;7
69;Aitvaras;"SAULĖS ZUIKUČIAI  (ALERG.)";5711324951;Ne;0;1;0;1
70;Aitvaras;"SAULĖS ZUIKUČIAI  (ALERG.)";4106097701;Ne;0;3;0;3
71;Aitvaras;"SAULĖS ZUIKUČIAI  (ALERG.)";9659883026;Ne;5;0;0;5
72;Aitvaras;"SAULĖS ZUIKUČIAI  (ALERG.)";2184231202;Ne;18;1;0;19
73;Aitvaras;"SAULĖS ZUIKUČIAI  (ALERG.)";2478737835;Ne;6;3;0;9
74;Aitvaras;"SAULĖS ZUIKUČIAI  (ALERG.)";1136438927;Ne;5;1;0;6
75;Aitvaras;"SAULĖS ZUIKUČIAI  (ALERG.)";8137900398;Ne;20;0;0;20
76;Aitvaras;"SAULĖS ZUIKUČIAI  (ALERG.)";9147954612;Ne;10;0;0;10
77;Aitvaras;"SAULĖS ZUIKUČIAI  (ALERG.)";2511844613;Ne;11;0;0;11
78;Aitvaras;"SAULĖS ZUIKUČIAI  (ALERG.)";7907357058;Ne;5;0;0;5
79;Aitvaras;"SAULĖS ZUIKUČIAI  (ALERG.)";9534206000;Ne;19;0;0;19
80;Aitvaras;"SAULĖS ZUIKUČIAI  (ALERG.)";3737054758;Taip;14;0;0;14
81;Aitvaras;"SAULĖS ZUIKUČIAI  (ALERG.)";9271534775;Ne;20;0;0;20
82;Aitvaras;"SAULĖS ZUIKUČIAI  (ALERG.)";6950820937;Ne;1;0;0;1
83;Aitvaras;"SAULĖS ZUIKUČIAI  (ALERG.)";5252728205;Ne;4;0;0;4
84;Aitvaras;"SAULĖS ZUIKUČIAI  (ALERG.)";2373509019;Ne;11;0;0;11
85;Aitvaras;"SAULĖS ZUIKUČIAI  (ALERG.)";2624566766;Ne;7;0;0;7
86;Aitvaras;"ŽEMYNUKAI (ALERG.)";8567255042;Ne;1;0;2;3
87;Aitvaras;"ŽEMYNUKAI (ALERG.)";6218019092;Ne;0;2;2;4
88;Aitvaras;"ŽEMYNUKAI (ALERG.)";7560642918;Ne;1;1;0;2
89;Aitvaras;"ŽEMYNUKAI (ALERG.)";3820930777;Ne;15;12;0;27
90;Aitvaras;"ŽEMYNUKAI (ALERG.)";6624986090;Taip;10;0;0;10
91;Aitvaras;"ŽEMYNUKAI (ALERG.)";4733627644;Ne;0;3;0;3
92;Aitvaras;"ŽEMYNUKAI (ALERG.)";3104109370;Ne;3;0;6;9
93;Aitvaras;"ŽEMYNUKAI (ALERG.)";7853714142;Taip;14;2;0;16
94;Aitvaras;"ŽEMYNUKAI (ALERG.)";1949144346;Ne;6;3;0;9
95;Aitvaras;"ŽEMYNUKAI (ALERG.)";3961423273;Ne;6;1;0;7
96;Aitvaras;"ŽEMYNUKAI (ALERG.)";7113016866;Ne;0;7;0;7
97;Aitvaras;"ŽEMYNUKAI (ALERG.)";4377666052;Taip;11;4;3;18
98;Aitvaras;"ŽEMYNUKAI (ALERG.)";8333823078;Ne;6;1;0;7
99;Aitvaras;"ŽEMYNUKAI (ALERG.)";5351333397;Ne;0;8;0;8
100;Aitvaras;"ŽEMYNUKAI (ALERG.)";2065988478;Ne;11;0;0;11
101;Aitvaras;"ŽEMYNUKAI (ALERG.)";3635354769;Ne;9;8;0;17
102;Aitvaras;"ŽEMYNUKAI (ALERG.)";3851322849;Ne;2;4;1;7
103;Aitvaras;"ŽEMYNUKAI (ALERG.)";7889947603;Ne;14;0;0;14
104;Aitvaras;"ŽEMYNUKAI (ALERG.)";1662289664;Ne;4;0;5;9
105;Aitvaras;"ŽEMYNUKAI (ALERG.)";6286268740;Ne;0;2;0;2
106;Aitvaras;"LINKSMUČIAI (ALERG.)";4721229601;Ne;12;0;0;12
107;Aitvaras;"LINKSMUČIAI (ALERG.)";7598319477;Ne;6;0;0;6
108;Aitvaras;"LINKSMUČIAI (ALERG.)";2231465856;Ne;15;1;0;16
109;Aitvaras;"LINKSMUČIAI (ALERG.)";5697675670;Ne;5;1;0;6
110;Aitvaras;"LINKSMUČIAI (ALERG.)";4394700961;Ne;23;0;1;24
111;Aitvaras;"LINKSMUČIAI (ALERG.)";8161320750;Ne;0;1;0;1
112;Aitvaras;"LINKSMUČIAI (ALERG.)";9006105693;Ne;17;0;0;17
113;Aitvaras;"LINKSMUČIAI (ALERG.)";7886218360;Ne;21;0;0;21
114;Aitvaras;"LINKSMUČIAI (ALERG.)";4897595828;Ne;8;0;0;8
115;Aitvaras;"LINKSMUČIAI (ALERG.)";2209078997;Ne;11;5;0;16
116;Aitvaras;"LINKSMUČIAI (ALERG.)";7463592589;Ne;23;0;0;23
117;Aitvaras;"LINKSMUČIAI (ALERG.)";5308153768;Ne;6;0;0;6
118;Aitvaras;"LINKSMUČIAI (ALERG.)";4954780185;Ne;21;0;0;21
119;Aitvaras;"LINKSMUČIAI (ALERG.)";9294248422;Ne;4;0;0;4
120;Aitvaras;"LINKSMUČIAI (ALERG.)";2263139249;Ne;0;2;0;2
121;Aitvaras;NAMINUKAI;3053557807;Ne;10;1;0;11
122;Aitvaras;NAMINUKAI;6126913961;Ne;2;0;0;2
123;Aitvaras;NAMINUKAI;3347213578;Ne;4;7;0;11
124;Aitvaras;NAMINUKAI;9024245490;Taip;0;1;0;1
125;Aitvaras;NAMINUKAI;8512502118;Ne;0;1;0;1
126;Aitvaras;NAMINUKAI;1376605323;Ne;0;3;0;3
127;Aitvaras;NAMINUKAI;6060880045;Ne;0;4;0;4
128;Aitvaras;NAMINUKAI;6048701733;Ne;0;6;0;6
129;Aitvaras;NAMINUKAI;4555281655;Ne;5;0;0;5
130;Aitvaras;NAMINUKAI;8043062737;Taip;0;5;0;5
131;Aitvaras;NAMINUKAI;3005447572;Ne;0;1;0;1
132;Aitvaras;NAMINUKAI;1549552392;Ne;0;3;0;3
133;Aitvaras;NAMINUKAI;9490714865;Ne;0;6;0;6
134;Aitvaras;NAMINUKAI;1498630458;Ne;0;1;0;1
135;Aitvaras;NAMINUKAI;5967188507;Ne;0;1;4;5
136;Aitvaras;NAMINUKAI;5161069611;Ne;0;1;1;2
137;Aitvaras;NAMINUKAI;7934344218;Ne;0;1;0;1
138;Aitvaras;NAMINUKAI;6279152796;Ne;0;1;0;1
139;Aitvaras;ŠELMIAI;4984058405;Taip;5;3;0;8
140;Aitvaras;ŠELMIAI;9725401255;Ne;7;0;0;7
141;Aitvaras;ŠELMIAI;4547342872;Ne;4;1;0;5
142;Aitvaras;ŠELMIAI;5684526288;Taip;0;5;0;5
143;Aitvaras;ŠELMIAI;7764574135;Ne;8;0;2;10
144;Aitvaras;ŠELMIAI;5601517340;Ne;0;6;0;6
145;Aitvaras;ŠELMIAI;1019103539;Ne;6;0;0;6
146;Aitvaras;ŠELMIAI;2185746898;Ne;4;2;0;6
147;Aitvaras;ŠELMIAI;8756012613;Ne;6;0;0;6
148;Aitvaras;ŠELMIAI;1203732956;Ne;1;5;0;6
149;Aitvaras;ŠELMIAI;5782609781;Ne;0;2;1;3
150;Aitvaras;ŠELMIAI;7352233454;Ne;0;7;2;9
151;Aitvaras;ŠELMIAI;1901118931;Ne;0;1;0;1
152;Aitvaras;ŠELMIAI;4812423010;Ne;8;1;0;9
153;Aitvaras;ŠELMIAI;8644983502;Ne;10;0;0;10
154;Aitvaras;ŠELMIAI;9295561516;Taip;0;2;4;6
155;Aitvaras;ŠELMIAI;6188186413;Ne;0;3;1;4
156;Aitvaras;ŠELMIAI;5886199823;Ne;1;0;0;1
157;Aitvaras;KODĖLČIUKAI;1495399113;Ne;0;1;0;1
158;Aitvaras;KODĖLČIUKAI;2887681961;Ne;7;0;0;7
159;Aitvaras;KODĖLČIUKAI;4760801928;Ne;15;0;1;16
160;Aitvaras;KODĖLČIUKAI;7136674662;Ne;0;5;0;5
161;Aitvaras;KODĖLČIUKAI;7922937851;Ne;4;1;0;5
162;Aitvaras;KODĖLČIUKAI;4085134058;Taip;6;2;0;8
163;Aitvaras;KODĖLČIUKAI;8746884740;Ne;4;0;0;4
164;Aitvaras;KODĖLČIUKAI;4163871634;Ne;7;0;0;7
165;Aitvaras;KODĖLČIUKAI;3988226974;Ne;7;0;0;7
166;Aitvaras;KODĖLČIUKAI;1070324386;Ne;0;2;3;5
167;Aitvaras;KODĖLČIUKAI;1599296739;Taip;0;11;9;20
168;Aitvaras;KODĖLČIUKAI;4987412561;Ne;5;0;0;5
169;Aitvaras;KODĖLČIUKAI;2239387580;Ne;0;2;0;2
170;Aitvaras;KODĖLČIUKAI;9949206639;Ne;0;0;7;7
171;Aitvaras;KODĖLČIUKAI;2892898328;Taip;10;1;0;11
172;Aitvaras;KODĖLČIUKAI;3749008647;Ne;0;0;7;7
173;Aitvaras;KODĖLČIUKAI;2871973045;Ne;6;0;0;6
174;Aitvaras;KODĖLČIUKAI;9218287162;Ne;16;0;0;16
175;Aitvaras;KODĖLČIUKAI;7181317805;Ne;0;0;2;2
176;Aitvaras;KODĖLČIUKAI;5093291829;Ne;10;0;0;10
177;Aitvaras;KODĖLČIUKAI;6119148164;Ne;2;2;0;4
178;Aitvaras;PABIRUČIAI;5563725441;Ne;5;0;0;5
179;Aitvaras;PABIRUČIAI;1961795617;Ne;6;0;0;6
180;Aitvaras;PABIRUČIAI;9081528512;Ne;10;1;0;11
181;Aitvaras;PABIRUČIAI;9494510876;Ne;5;2;0;7
182;Aitvaras;PABIRUČIAI;6689082073;Ne;0;2;7;9
183;Aitvaras;PABIRUČIAI;4816698202;Ne;0;8;0;8
184;Aitvaras;PABIRUČIAI;2817620246;Ne;5;0;4;9
185;Aitvaras;PABIRUČIAI;6906900852;Ne;8;1;0;9
186;Aitvaras;PABIRUČIAI;4560348711;Ne;7;5;0;12
187;Aitvaras;PABIRUČIAI;4251238917;Ne;9;0;1;10
188;Aitvaras;PABIRUČIAI;8003130815;Ne;4;0;0;4
189;Aitvaras;PABIRUČIAI;2045368104;Ne;0;5;0;5
190;Aitvaras;PABIRUČIAI;6660146833;Ne;3;2;0;5
191;Aitvaras;PABIRUČIAI;1020056632;Ne;11;0;0;11
192;Aitvaras;PABIRUČIAI;9993426833;Ne;5;0;0;5
193;Aitvaras;PABIRUČIAI;2747113542;Ne;2;0;0;2
194;Aitvaras;"SVAJOKLIAI  (ALERG.)";5659897032;Ne;20;0;0;20
195;Aitvaras;"SVAJOKLIAI  (ALERG.)";4618560397;Ne;2;2;0;4
196;Aitvaras;"SVAJOKLIAI  (ALERG.)";9209862610;Ne;15;1;0;16
197;Aitvaras;"SVAJOKLIAI  (ALERG.)";6191938291;Ne;1;0;0;1
198;Aitvaras;"SVAJOKLIAI  (ALERG.)";7006713502;Ne;2;1;0;3
199;Aitvaras;"SVAJOKLIAI  (ALERG.)";3923601422;Ne;3;0;0;3
200;Aitvaras;"SVAJOKLIAI  (ALERG.)";5790551266;Ne;5;0;0;5
201;Aitvaras;"SVAJOKLIAI  (ALERG.)";2975696317;Ne;6;0;0;6
202;Aitvaras;"SVAJOKLIAI  (ALERG.)";3891067128;Ne;3;1;0;4
203;Aitvaras;"SVAJOKLIAI  (ALERG.)";8352951885;Ne;8;0;2;10
204;Aitvaras;"SVAJOKLIAI  (ALERG.)";5255843693;Ne;10;0;0;10
205;Aitvaras;"SVAJOKLIAI  (ALERG.)";1448307414;Ne;2;0;0;2
206;Aitvaras;"SVAJOKLIAI  (ALERG.)";5593105541;Taip;2;1;0;3
207;Aitvaras;"SVAJOKLIAI  (ALERG.)";6319953077;Ne;0;1;0;1
208;Aitvaras;"SVAJOKLIAI  (ALERG.)";1131690624;Ne;3;1;0;4
209;Aitvaras;"SVAJOKLIAI  (ALERG.)";4801034095;Ne;2;2;0;4
210;Aitvaras;"SVAJOKLIAI  (ALERG.)";6916032116;Ne;7;1;0;8
211;Aitvaras;"SVAJOKLIAI  (ALERG.)";8300788433;Ne;0;14;0;14
212;Aitvaras;"SVAJOKLIAI  (ALERG.)";3026234787;Ne;12;0;0;12
213;Aitvaras;"SVAJOKLIAI  (ALERG.)";9810208704;Ne;4;1;0;5
214;Atžalėlės;Gėlytės;4284673729;Ne;4;4;0;8
215;Atžalėlės;Gėlytės;2385614957;Ne;3;0;0;3
216;Atžalėlės;Gėlytės;5432433423;Taip;0;8;0;8
217;Atžalėlės;Gėlytės;9715625283;Ne;7;1;0;8
218;Atžalėlės;Gėlytės;2131592139;Ne;4;1;0;5
219;Atžalėlės;Gėlytės;3191066669;Ne;5;0;0;5
220;Atžalėlės;Gėlytės;1722233272;Ne;0;7;0;7
221;Atžalėlės;Gėlytės;9189223222;Ne;6;0;0;6
222;Atžalėlės;Gėlytės;3283415814;Ne;2;3;0;5
223;Atžalėlės;Gėlytės;3870758086;Ne;8;0;1;9
224;Atžalėlės;Gėlytės;6202250600;Ne;0;0;1;1
225;Atžalėlės;Gėlytės;6177038838;Ne;0;2;0;2
226;Atžalėlės;Gėlytės;5742471497;Ne;2;0;0;2
227;Atžalėlės;Gėlytės;1137741059;Ne;15;0;0;15
228;Atžalėlės;Gėlytės;1036410428;Ne;1;1;1;3
229;Atžalėlės;Gėlytės;1450609695;Ne;0;1;0;1
230;Atžalėlės;Gėlytės;6597540627;Ne;7;0;0;7
231;Atžalėlės;Drugeliai;9481268935;Ne;7;0;6;13
232;Atžalėlės;Drugeliai;3738127350;Ne;10;0;0;10
233;Atžalėlės;Drugeliai;1423254771;Ne;8;0;1;9
234;Atžalėlės;Drugeliai;1505286928;Ne;5;0;0;5
235;Atžalėlės;Drugeliai;7483616061;Ne;0;11;0;11
236;Atžalėlės;Drugeliai;4227804985;Ne;0;3;0;3
237;Atžalėlės;Drugeliai;9053620501;Ne;0;0;1;1
238;Atžalėlės;Drugeliai;5174826594;Ne;1;0;0;1
239;Atžalėlės;Drugeliai;4148412941;Ne;0;12;0;12
240;Atžalėlės;Drugeliai;9054589111;Ne;0;2;0;2
241;Atžalėlės;Drugeliai;7501772398;Ne;5;6;0;11
242;Atžalėlės;Drugeliai;9346744866;Taip;2;1;0;3
243;Atžalėlės;Drugeliai;1710646812;Ne;6;0;2;8
244;Atžalėlės;Drugeliai;5972419628;Ne;0;1;0;1
245;Atžalėlės;Gandriukai;2083260403;Ne;6;10;0;16
246;Atžalėlės;Gandriukai;5119260525;Taip;6;0;0;6
247;Atžalėlės;Gandriukai;4293557144;Ne;8;9;0;17
248;Atžalėlės;Gandriukai;2078549599;Ne;0;0;1;1
249;Atžalėlės;Voveriukai;3795729265;Ne;5;0;1;6
250;Atžalėlės;Voveriukai;8201582382;Ne;13;0;0;13
251;Atžalėlės;Voveriukai;4362058013;Ne;13;0;0;13
252;Atžalėlės;Voveriukai;8819893830;Taip;4;0;3;7
253;Atžalėlės;Voveriukai;3069192413;Ne;0;0;2;2
254;Atžalėlės;Voveriukai;5705303891;Taip;0;1;1;2
255;Atžalėlės;Voveriukai;1212074068;Ne;2;0;0;2
256;Atžalėlės;Voveriukai;9967641617;Ne;0;8;0;8
257;Atžalėlės;Voveriukai;6723689098;Ne;3;0;1;4
258;Atžalėlės;Voveriukai;4661388894;Ne;9;5;0;14
259;Atžalėlės;Voveriukai;9677943321;Ne;0;0;1;1
260;Atžalėlės;Voveriukai;1538643591;Ne;0;4;0;4
261;Atžalėlės;Voveriukai;5319794176;Taip;1;0;0;1
262;Atžalėlės;Voveriukai;9085453655;Ne;7;0;0;7
263;Atžalėlės;Voveriukai;7196464328;Taip;4;0;3;7
264;Atžalėlės;Voveriukai;7018297883;Ne;5;0;1;6
265;Atžalėlės;Voveriukai;9508110719;Ne;4;0;0;4
266;Atžalėlės;Voveriukai;5584105084;Ne;1;0;1;2
267;Atžalėlės;Voveriukai;7522643082;Taip;5;0;0;5
268;Atžalėlės;Voveriukai;7613931447;Taip;5;0;0;5
269;Atžalėlės;Voveriukai;7510951079;Ne;12;1;0;13
270;Atžalėlės;Voveriukai;8547622670;Ne;20;0;0;20
271;Atžalėlės;Voveriukai;3143856911;Taip;3;10;0;13
272;Atžalėlės;Paukšteliai;7807313362;Ne;0;1;0;1
273;Atžalėlės;Paukšteliai;6537864486;Ne;2;0;2;4
274;Atžalėlės;Paukšteliai;8524244526;Taip;0;1;2;3
275;Atžalėlės;Paukšteliai;6873507667;Ne;2;0;0;2
276;Atžalėlės;Paukšteliai;7321516783;Taip;0;0;1;1
277;Atžalėlės;Paukšteliai;1844980319;Ne;1;1;0;2
278;Atžalėlės;Paukšteliai;8512283024;Ne;8;0;0;8
279;Atžalėlės;Paukšteliai;2078781673;Ne;5;0;1;6
280;Atžalėlės;Paukšteliai;1520206753;Ne;19;0;0;19
281;Atžalėlės;Paukšteliai;4790322154;Ne;0;3;0;3
282;Atžalėlės;Paukšteliai;4081717007;Ne;0;0;2;2
283;Atžalėlės;Paukšteliai;1089221288;Ne;0;0;1;1
284;Atžalėlės;Paukšteliai;7356877676;Ne;0;1;0;1
285;Atžalėlės;Paukšteliai;4392352210;Ne;2;0;0;2
286;Atžalėlės;Paukšteliai;1774212280;Ne;20;0;0;20
287;Atžalėlės;Meškiukai;8586739429;Ne;0;0;1;1
288;Atžalėlės;Meškiukai;9925178685;Ne;0;1;0;1
289;Atžalėlės;Meškiukai;2617568019;Taip;8;0;0;8
290;Atžalėlės;Meškiukai;8619613890;Ne;5;3;0;8
291;Atžalėlės;Meškiukai;3281114596;Ne;0;9;0;9
292;Atžalėlės;Meškiukai;9631336340;Ne;2;1;0;3
293;Atžalėlės;Meškiukai;2930612059;Ne;10;6;0;16
294;Atžalėlės;Meškiukai;2569491645;Ne;1;0;0;1
295;Atžalėlės;Meškiukai;1431197358;Ne;0;4;0;4
296;Atžalėlės;Meškiukai;3982090601;Ne;0;0;1;1
297;Atžalėlės;Meškiukai;3743308789;Ne;6;0;0;6
298;Atžalėlės;Meškiukai;7936991925;Ne;0;1;0;1
299;Atžalėlės;Meškiukai;8976815736;Ne;5;0;0;5
300;Atžalėlės;Saulutės;6048763811;Taip;5;2;1;8
301;Atžalėlės;Saulutės;5490741021;Ne;0;2;0;2
302;Atžalėlės;Saulutės;8313999012;Ne;3;0;0;3
303;Atžalėlės;Saulutės;2291204010;Ne;6;1;2;9
304;Atžalėlės;Saulutės;2306086573;Ne;10;0;4;14
305;Atžalėlės;Saulutės;8208908249;Ne;5;5;0;10
306;Atžalėlės;Bitutės;8060332402;Ne;0;0;4;4
307;Atžalėlės;Bitutės;6253257539;Ne;10;0;0;10
308;Atžalėlės;Bitutės;6211002805;Ne;5;0;0;5
309;Atžalėlės;Bitutės;1939076303;Ne;3;0;0;3
310;Atžalėlės;Bitutės;7052938312;Ne;0;0;2;2
311;Atžalėlės;Bitutės;8707875125;Ne;10;0;1;11
312;Atžalėlės;Bitutės;3559977339;Ne;3;0;0;3
313;Atžalėlės;Bitutės;6368553568;Taip;0;0;3;3
314;Atžalėlės;Bitutės;5148142239;Ne;0;0;5;5
315;Atžalėlės;Bitutės;5593774275;Ne;12;0;0;12
316;Atžalėlės;Bitutės;5511148178;Ne;11;0;1;12
317;Atžalėlės;Boružiukai;7104671423;Ne;5;15;0;20
318;Atžalėlės;Boružiukai;3119998745;Taip;16;4;0;20
319;Atžalėlės;Boružiukai;3998483465;Ne;9;0;0;9
320;Atžalėlės;Boružiukai;5582697993;Ne;3;0;0;3
321;Atžalėlės;Boružiukai;7980775632;Taip;0;10;0;10
322;Atžalėlės;Boružiukai;8681809797;Ne;7;0;0;7
323;Atžalėlės;Boružiukai;3590987364;Ne;0;0;3;3
324;Atžalėlės;Boružiukai;6237597328;Ne;0;1;0;1
325;Atžalėlės;Boružiukai;1383944713;Ne;3;1;0;4
326;Atžalėlės;Boružiukai;7091939299;Ne;16;0;0;16
327;Atžalėlės;Šypsenėlės;4071402757;Ne;3;5;0;8
328;Atžalėlės;Šypsenėlės;9487375092;Taip;10;1;0;11
329;Atžalėlės;Šypsenėlės;6828140775;Ne;0;0;3;3
330;Atžalėlės;Šypsenėlės;8564143904;Ne;11;0;7;18
331;Atžalėlės;Šypsenėlės;2271887521;Taip;6;0;2;8
332;Atžalėlės;Šypsenėlės;3346193393;Taip;3;0;0;3
333;Atžalėlės;Šypsenėlės;5822532151;Ne;5;0;0;5
334;Aušrelė;PASAKIUKAI;1754138341;Ne;14;0;0;14
335;Aušrelė;PASAKIUKAI;6913824678;Ne;2;0;0;2
336;Aušrelė;PASAKIUKAI;8542012622;Ne;0;1;0;1
337;Aušrelė;PASAKIUKAI;1949809977;Ne;1;0;0;1
338;Aušrelė;PASAKIUKAI;8126701466;Ne;2;0;0;2
339;Aušrelė;PASAKIUKAI;1798478023;Ne;6;0;0;6
340;Aušrelė;PASAKIUKAI;1544869163;Ne;5;0;1;6
341;Aušrelė;PASAKIUKAI;6577540623;Ne;14;0;0;14
342;Aušrelė;PASAKIUKAI;5460833944;Ne;11;0;0;11
343;Aušrelė;PASAKIUKAI;2311552230;Ne;1;0;0;1
344;Aušrelė;PASAKIUKAI;7130040621;Ne;12;0;0;12
345;Aušrelė;PASAKIUKAI;7208341200;Ne;6;0;0;6
346;Aušrelė;BORUŽĖLĖS;5733298006;Ne;0;9;0;9
347;Aušrelė;BORUŽĖLĖS;4565813136;Ne;7;0;0;7
348;Aušrelė;BORUŽĖLĖS;9877307844;Ne;5;0;0;5
349;Aušrelė;BORUŽĖLĖS;2873845920;Ne;0;1;0;1
350;Aušrelė;BORUŽĖLĖS;1458580523;Ne;11;1;0;12
351;Aušrelė;BORUŽĖLĖS;1463724119;Ne;0;3;0;3
352;Aušrelė;BORUŽĖLĖS;5904797250;Ne;0;0;1;1
353;Aušrelė;BORUŽĖLĖS;1871799626;Ne;16;0;0;16
354;Aušrelė;BORUŽĖLĖS;4924950592;Ne;6;0;0;6
355;Aušrelė;BORUŽĖLĖS;8947695521;Ne;3;0;0;3
356;Aušrelė;BORUŽĖLĖS;6672975558;Ne;12;0;2;14
357;Aušrelė;BORUŽĖLĖS;8799928392;Ne;8;0;1;9
358;Aušrelė;BORUŽĖLĖS;5801943729;Taip;0;4;0;4
359;Aušrelė;BORUŽĖLĖS;6418762623;Ne;7;0;0;7
360;Aušrelė;BORUŽĖLĖS;8835689988;Ne;0;7;0;7
361;Aušrelė;BORUŽĖLĖS;8689174023;Ne;0;2;0;2
362;Aušrelė;BORUŽĖLĖS;5358736178;Ne;11;0;1;12
363;Aušrelė;SMALSUČIAI;6761263775;Taip;0;3;0;3
364;Aušrelė;SMALSUČIAI;3015028879;Ne;0;2;0;2
365;Aušrelė;SMALSUČIAI;2390128933;Ne;4;0;1;5
366;Aušrelė;SMALSUČIAI;8503309819;Ne;20;0;0;20
367;Aušrelė;SMALSUČIAI;9443641849;Ne;5;0;0;5
368;Aušrelė;SMALSUČIAI;7930717076;Ne;6;0;0;6
369;Aušrelė;SMALSUČIAI;7609339123;Ne;0;1;0;1
370;Aušrelė;SMALSUČIAI;1556010005;Taip;0;0;1;1
371;Aušrelė;SMALSUČIAI;7070013052;Ne;0;0;3;3
372;Aušrelė;SMALSUČIAI;3581155949;Ne;5;0;0;5
373;Aušrelė;SMALSUČIAI;6507218940;Ne;0;1;0;1
374;Aušrelė;SMALSUČIAI;2266390402;Ne;0;3;0;3
375;Aušrelė;SMALSUČIAI;8032661062;Ne;0;0;1;1
376;Aušrelė;SMALSUČIAI;1976613166;Ne;5;0;0;5
377;Aušrelė;KODĖLČIUKAI;7723159748;Ne;10;0;0;10
378;Aušrelė;KODĖLČIUKAI;7367268748;Ne;0;1;0;1
379;Aušrelė;KODĖLČIUKAI;3623813061;Ne;8;0;0;8
380;Aušrelė;KODĖLČIUKAI;8693750994;Ne;10;1;0;11
381;Aušrelė;KODĖLČIUKAI;7327544406;Ne;0;3;0;3
382;Aušrelė;KODĖLČIUKAI;9566144610;Ne;10;0;0;10
383;Aušrelė;KODĖLČIUKAI;6308519574;Ne;2;3;0;5
384;Aušrelė;KODĖLČIUKAI;3320399046;Ne;0;2;0;2
385;Aušrelė;KODĖLČIUKAI;6911735462;Ne;2;3;0;5
386;Aušrelė;KODĖLČIUKAI;4248808572;Ne;0;8;0;8
387;Aušrelė;KODĖLČIUKAI;5046027475;Ne;0;2;0;2
388;Aušrelė;KODĖLČIUKAI;8338569001;Ne;16;0;0;16
389;Aušrelė;KODĖLČIUKAI;7515666888;Ne;0;1;0;1
390;Aušrelė;KODĖLČIUKAI;8862488358;Ne;2;0;0;2
391;Aušrelė;KODĖLČIUKAI;4882556718;Ne;0;1;0;1
392;Aušrelė;KODĖLČIUKAI;6321332888;Ne;1;2;0;3
393;Aušrelė;PELĖDŽIUKAI;3223092149;Ne;0;10;0;10
394;Aušrelė;PELĖDŽIUKAI;8580241126;Ne;0;0;10;10
395;Aušrelė;PELĖDŽIUKAI;8411336992;Ne;0;0;2;2
396;Aušrelė;PELĖDŽIUKAI;8917907028;Ne;5;0;0;5
397;Aušrelė;PELĖDŽIUKAI;7494298336;Ne;0;5;0;5
398;Aušrelė;PELĖDŽIUKAI;4012186237;Ne;0;0;1;1
399;Aušrelė;PELĖDŽIUKAI;3738923947;Ne;5;1;0;6
400;Aušrelė;PELĖDŽIUKAI;2294224426;Ne;7;0;0;7
401;Aušrelė;PELĖDŽIUKAI;1276792874;Ne;0;0;3;3
402;Aušrelė;PELĖDŽIUKAI;8210698019;Ne;1;0;0;1
403;Aušrelė;AITVARIUKAI;6833654667;Ne;0;5;0;5
404;Aušrelė;AITVARIUKAI;8102749675;Taip;5;0;0;5
405;Aušrelė;AITVARIUKAI;4595435635;Ne;0;10;0;10
406;Aušrelė;AITVARIUKAI;9608444990;Ne;0;2;0;2
407;Aušrelė;AITVARIUKAI;6434548772;Ne;9;0;0;9
408;Aušrelė;AITVARIUKAI;7978186455;Ne;7;7;0;14
409;Aušrelė;AITVARIUKAI;5602774323;Ne;0;3;0;3
410;Aušrelė;AITVARIUKAI;5708459561;Ne;4;4;0;8
411;Aušrelė;AITVARIUKAI;1039180129;Ne;2;2;0;4
412;Aušrelė;AITVARIUKAI;3807967685;Ne;8;0;0;8
413;Aušrelė;AITVARIUKAI;6081100604;Ne;2;0;0;2
414;Aušrelė;AITVARIUKAI;7847650967;Ne;0;1;0;1
415;Aušrelė;AITVARIUKAI;5727081833;Ne;3;2;0;5
416;Aušrelė;AITVARIUKAI;4942168388;Taip;0;2;0;2
417;Aušrelė;AITVARIUKAI;7788139791;Ne;0;1;0;1
418;Aušrelė;BITUTĖS;1741716341;Taip;0;8;0;8
419;Aušrelė;BITUTĖS;4989544273;Ne;0;2;0;2
420;Aušrelė;BITUTĖS;9960201865;Ne;0;1;1;2
421;Aušrelė;BITUTĖS;2071674661;Ne;0;19;0;19
422;Aušrelė;BITUTĖS;1450827353;Ne;1;1;0;2
423;Aušrelė;BITUTĖS;5598494461;Ne;0;7;0;7
424;Aušrelė;BITUTĖS;4935192851;Ne;3;5;0;8
425;Aušrelė;BITUTĖS;1931955562;Ne;5;0;0;5
426;Aušrelė;BITUTĖS;5614774250;Ne;0;2;0;2
427;Aušrelė;BITUTĖS;6591538425;Taip;11;1;0;12
428;Aušrelė;BITUTĖS;8203256528;Ne;0;20;0;20
429;Aušrelė;BITUTĖS;5741252819;Ne;0;20;0;20
430;Aušrelė;BITUTĖS;1243825974;Ne;0;6;0;6
431;Aušrelė;BITUTĖS;2468245186;Ne;6;5;0;11
432;Aušrelė;BITUTĖS;5266959731;Ne;9;1;0;10
433;Aušrelė;BITUTĖS;2545065554;Ne;0;4;0;4
434;Aušrelė;BITUTĖS;2543313198;Ne;7;0;0;7
435;Aušrelė;BITUTĖS;3288449407;Ne;0;7;0;7
436;Aušrelė;ŽIRNIUKAI;8833081700;Ne;10;0;0;10
437;Aušrelė;ŽIRNIUKAI;7028068342;Ne;2;1;0;3
438;Aušrelė;ŽIRNIUKAI;9274178180;Ne;7;2;0;9
439;Aušrelė;ŽIRNIUKAI;2553689977;Ne;5;1;0;6
440;Aušrelė;ŽIRNIUKAI;9859520649;Ne;9;3;0;12
441;Aušrelė;ŽIRNIUKAI;1915023166;Ne;5;0;0;5
442;Aušrelė;ŽIRNIUKAI;2543352192;Ne;9;0;0;9
443;Aušrelė;ŽIRNIUKAI;1528883001;Ne;15;0;0;15
444;Aušrelė;ŽIRNIUKAI;3023414781;Ne;5;0;0;5
445;Aušrelė;ŽIRNIUKAI;2582979005;Taip;5;1;0;6
446;Aušrelė;ŽIRNIUKAI;9884818480;Ne;8;0;0;8
447;Aušrelė;ŽIRNIUKAI;5429867368;Ne;6;0;0;6
448;Aušrelė;ŽIRNIUKAI;4004600465;Taip;0;6;0;6
449;Aušrelė;ŽIRNIUKAI;1138257807;Ne;9;1;0;10
450;Aušrelė;ŽIRNIUKAI;1451587500;Ne;6;1;0;7
451;Aušrelė;ŽIRNIUKAI;5689460984;Ne;9;1;0;10
452;Aušrelė;ŽIRNIUKAI;4260768468;Ne;13;0;0;13
453;Aušrelė;ŽIRNIUKAI;3295471821;Ne;11;1;0;12
454;Aušrelė;GRYBUKAI;2466858636;Taip;20;0;0;20
455;Aušrelė;GRYBUKAI;4213141410;Ne;9;0;0;9
456;Aušrelė;GRYBUKAI;6287520834;Ne;7;1;0;8
457;Aušrelė;GRYBUKAI;2450164324;Ne;2;2;0;4
458;Aušrelė;GRYBUKAI;2236345596;Ne;13;0;0;13
459;Aušrelė;GRYBUKAI;6902592468;Ne;3;0;0;3
460;Aušrelė;GRYBUKAI;4063895292;Ne;0;12;0;12
461;Aušrelė;GRYBUKAI;4719347430;Ne;6;0;0;6
462;Aušrelė;GRYBUKAI;5409930406;Ne;10;0;0;10
463;Aušrelė;GRYBUKAI;7058664271;Taip;20;0;0;20
464;Aušrelė;GRYBUKAI;1934623405;Ne;2;0;0;2
465;Aušrelė;GRYBUKAI;8103112254;Ne;15;0;0;15
466;Aušrelė;GRYBUKAI;7670935967;Taip;2;5;0;7
467;Aušrelė;GRYBUKAI;9007129980;Taip;9;1;1;11
468;Aušrelė;GRYBUKAI;5709799539;Ne;0;4;0;4
469;Aušrelė;GRYBUKAI;8724802289;Ne;0;4;0;4
470;Aušrelė;GRYBUKAI;9075395810;Ne;7;0;0;7
471;Aušrelė;GRYBUKAI;4840787696;Ne;0;10;0;10
472;Aušrelė;DRUGELIAI;3831695455;Ne;6;0;0;6
473;Aušrelė;DRUGELIAI;2737402297;Ne;7;0;0;7
474;Aušrelė;DRUGELIAI;4464947621;Taip;13;3;0;16
475;Aušrelė;DRUGELIAI;9126040500;Ne;0;4;0;4
476;Aušrelė;DRUGELIAI;7286960315;Ne;10;0;0;10
477;Aušrelė;DRUGELIAI;8102293098;Taip;4;0;0;4
478;Aušrelė;DRUGELIAI;2266835623;Ne;10;7;0;17
479;Aušrelė;DRUGELIAI;9514049590;Ne;0;0;1;1
480;Aušrelė;DRUGELIAI;5815844340;Ne;5;0;0;5
481;Aušrelė;DRUGELIAI;5668908532;Ne;0;6;0;6
482;Aušrelė;DRUGELIAI;9819729046;Ne;7;1;0;8
483;Aušrelė;DRUGELIAI;5698248175;Ne;9;0;0;9
484;Aušrelė;NYKŠTUKAI;9914518299;Ne;15;1;0;16
485;Aušrelė;NYKŠTUKAI;4297417711;Ne;7;0;0;7
486;Aušrelė;NYKŠTUKAI;7964156691;Taip;20;0;0;20
487;Aušrelė;NYKŠTUKAI;7140465960;Ne;2;1;0;3
488;Aušrelė;NYKŠTUKAI;7937067384;Ne;0;2;0;2
489;Aušrelė;NYKŠTUKAI;8099338305;Ne;5;0;1;6
490;Aušrelė;NYKŠTUKAI;4282189556;Ne;8;5;0;13
491;Aušrelė;NYKŠTUKAI;1950091527;Taip;11;2;0;13
492;Aušrelė;NYKŠTUKAI;8378225406;Ne;14;0;0;14
493;Aušrelė;NYKŠTUKAI;3259828075;Ne;5;0;0;5
494;Aušrelė;NYKŠTUKAI;4952876188;Ne;0;2;0;2
495;Aušrelė;NYKŠTUKAI;6474867237;Ne;3;0;0;3
496;Aušrelė;NYKŠTUKAI;2645772675;Ne;2;0;0;2
497;Aušrelė;NYKŠTUKAI;8829298943;Ne;4;0;0;4
498;Aušrelė;NYKŠTUKAI;5018495543;Ne;7;0;0;7
499;Aušrelė;SPINDULIUKAI;8848358559;Ne;0;1;0;1
500;Aušrelė;SPINDULIUKAI;2857158437;Ne;0;0;1;1
501;Aušrelė;SPINDULIUKAI;8801906679;Ne;4;2;1;7
502;Aušrelė;SPINDULIUKAI;1446194971;Ne;5;5;0;10
503;Aušrelė;SPINDULIUKAI;2319188134;Ne;11;0;0;11
504;Aušrelė;SPINDULIUKAI;8997650487;Ne;10;0;0;10
505;Aušrelė;SPINDULIUKAI;5274919078;Ne;7;1;0;8
506;Aušrelė;SPINDULIUKAI;2981314491;Ne;2;2;0;4
507;Aušrelė;SPINDULIUKAI;2441221298;Ne;1;0;0;1
508;Aušrelė;SPINDULIUKAI;8427699400;Ne;5;0;0;5
509;Aušrelė;SPINDULIUKAI;8797157671;Ne;13;0;0;13
510;Aušrelė;SPINDULIUKAI;3646395136;Ne;7;0;0;7
511;Aušrelė;SPINDULIUKAI;9973824348;Ne;19;0;0;19
512;Aušrelė;SPINDULIUKAI;8438945369;Ne;0;2;0;2
513;Aušrelė;SPINDULIUKAI;3072503569;Ne;10;1;0;11
514;Aušrelė;SPINDULIUKAI;9938762910;Ne;5;1;0;6
515;Beržynėlis;SVIRPLIUKAI;7360345539;Taip;4;0;0;4
516;Beržynėlis;SVIRPLIUKAI;4134371415;Ne;5;1;0;6
517;Beržynėlis;SVIRPLIUKAI;7278860816;Ne;3;0;0;3
518;Beržynėlis;SVIRPLIUKAI;8404801225;Taip;4;0;0;4
519;Beržynėlis;SVIRPLIUKAI;7953957525;Ne;0;1;0;1
520;Beržynėlis;SVIRPLIUKAI;2221708263;Ne;5;2;0;7
521;Beržynėlis;SVIRPLIUKAI;8880151537;Ne;10;0;0;10
522;Beržynėlis;SVIRPLIUKAI;6516665294;Taip;0;1;0;1
523;Beržynėlis;SVIRPLIUKAI;6673910279;Ne;10;0;0;10
524;Beržynėlis;SVIRPLIUKAI;5027712732;Taip;13;0;0;13
525;Beržynėlis;SVIRPLIUKAI;7555487759;Ne;4;0;0;4
526;Beržynėlis;SVIRPLIUKAI;3315079004;Ne;1;0;0;1
527;Beržynėlis;SVIRPLIUKAI;8533912024;Ne;6;1;0;7
528;Beržynėlis;SVIRPLIUKAI;4978363316;Ne;3;1;0;4
529;Beržynėlis;SVIRPLIUKAI;5864265458;Ne;0;4;0;4
530;Beržynėlis;PELEDŽIUKAI;9088059487;Ne;0;1;0;1
531;Beržynėlis;PELEDŽIUKAI;6337962165;Ne;4;0;0;4
532;Beržynėlis;PELEDŽIUKAI;6739927917;Ne;2;0;0;2
533;Beržynėlis;PELEDŽIUKAI;2971686368;Ne;0;3;0;3
534;Beržynėlis;PELEDŽIUKAI;9409317403;Ne;4;0;0;4
535;Beržynėlis;PELEDŽIUKAI;9305279614;Ne;5;0;0;5
536;Beržynėlis;PELEDŽIUKAI;1325972861;Ne;0;0;1;1
537;Beržynėlis;PELEDŽIUKAI;5856519538;Ne;5;0;0;5
538;Beržynėlis;PELEDŽIUKAI;8114761925;Ne;5;0;0;5
539;Beržynėlis;PELEDŽIUKAI;9896122318;Ne;0;1;0;1
540;Beržynėlis;PELEDŽIUKAI;4970999989;Ne;0;1;0;1
541;Beržynėlis;PELEDŽIUKAI;4035764376;Ne;6;0;0;6
542;Beržynėlis;PELEDŽIUKAI;8881566865;Ne;8;0;0;8
543;Beržynėlis;PELEDŽIUKAI;4161974847;Taip;0;2;0;2
544;Beržynėlis;ŽIOGELIAI;7903644161;Ne;0;0;1;1
545;Beržynėlis;ŽIOGELIAI;1707585750;Ne;2;6;0;8
546;Beržynėlis;ŽIOGELIAI;4382068779;Ne;2;0;0;2
547;Beržynėlis;ŽIOGELIAI;1831776326;Ne;1;0;0;1
548;Beržynėlis;ŽIOGELIAI;1118349439;Ne;3;0;0;3
549;Beržynėlis;ŽIOGELIAI;4369803044;Taip;12;0;0;12
550;Beržynėlis;ŽIOGELIAI;6592330036;Taip;5;2;3;10
551;Beržynėlis;ŽIOGELIAI;1503903200;Ne;2;2;1;5
552;Beržynėlis;ŽIOGELIAI;7972993168;Taip;1;6;0;7
553;Beržynėlis;ŽIOGELIAI;5049057730;Ne;1;0;0;1
554;Beržynėlis;ŽIOGELIAI;2583982025;Ne;2;2;0;4
555;Beržynėlis;ŽIOGELIAI;6932094459;Ne;0;1;0;1
556;Beržynėlis;ŽIOGELIAI;2155662035;Ne;5;2;0;7
557;Beržynėlis;ŽIOGELIAI;1558469002;Ne;9;0;0;9
558;Beržynėlis;ŽIOGELIAI;9603272698;Ne;10;4;1;15
559;Beržynėlis;ŽIOGELIAI;9493489114;Ne;10;4;1;15
560;Beržynėlis;ŽIOGELIAI;8665581794;Taip;18;0;0;18
561;Beržynėlis;ŽIOGELIAI;7806800327;Taip;20;0;0;20
562;Beržynėlis;ŽVIRBLIUKAI;8280378527;Ne;0;4;0;4
563;Beržynėlis;ŽVIRBLIUKAI;9754455116;Ne;0;2;0;2
564;Beržynėlis;ŽVIRBLIUKAI;3334994408;Ne;4;0;0;4
565;Beržynėlis;ŽVIRBLIUKAI;9777841895;Ne;0;2;1;3
566;Beržynėlis;ŽVIRBLIUKAI;6293884233;Taip;4;1;0;5
567;Beržynėlis;ŽVIRBLIUKAI;3209966996;Ne;0;2;2;4
568;Beržynėlis;ŽVIRBLIUKAI;5194416351;Ne;10;0;0;10
569;Beržynėlis;ŽVIRBLIUKAI;1228384088;Ne;1;0;0;1
570;Beržynėlis;ŽVIRBLIUKAI;6864823739;Ne;4;2;0;6
571;Beržynėlis;ŽVIRBLIUKAI;3484188772;Ne;0;1;0;1
572;Beržynėlis;ŽIRNIUKAI;4944466205;Ne;7;1;0;8
573;Beržynėlis;ŽIRNIUKAI;2154631640;Ne;0;10;0;10
574;Beržynėlis;ŽIRNIUKAI;9899702275;Ne;1;0;0;1
575;Beržynėlis;ŽIRNIUKAI;1320866413;Ne;2;0;0;2
576;Beržynėlis;ŽIRNIUKAI;5979829045;Ne;4;0;0;4
577;Beržynėlis;ŽIRNIUKAI;8027685774;Ne;0;4;0;4
578;Beržynėlis;ŽIRNIUKAI;2615367518;Ne;0;1;0;1
579;Beržynėlis;ŽIRNIUKAI;1986523281;Ne;4;0;0;4
580;Beržynėlis;ŽIRNIUKAI;9901466559;Ne;1;0;0;1
581;Beržynėlis;VIŠČIUKAI;9480959071;Ne;14;0;0;14
582;Beržynėlis;VIŠČIUKAI;8716270335;Ne;4;0;0;4
583;Beržynėlis;VIŠČIUKAI;4248556027;Ne;12;0;0;12
584;Beržynėlis;VIŠČIUKAI;7017827446;Taip;0;7;0;7
585;Beržynėlis;VIŠČIUKAI;4308655600;Ne;2;1;0;3
586;Beržynėlis;VIŠČIUKAI;3192897091;Ne;2;0;0;2
587;Beržynėlis;VIŠČIUKAI;8052073990;Taip;2;0;0;2
588;Beržynėlis;VIŠČIUKAI;5630272112;Ne;0;3;0;3
589;Beržynėlis;VIŠČIUKAI;6514295883;Ne;9;0;0;9
590;Beržynėlis;VIŠČIUKAI;1051991834;Ne;0;2;0;2
591;Beržynėlis;VIŠČIUKAI;4786786104;Ne;0;7;0;7
592;Birutės;SKRUZDELIUKŲ;4968068043;Ne;3;0;0;3
593;Birutės;SKRUZDELIUKŲ;1761065941;Ne;0;3;0;3
594;Birutės;SKRUZDELIUKŲ;9610268046;Ne;1;0;0;1
595;Birutės;SKRUZDELIUKŲ;4027700332;Ne;1;0;0;1
596;Birutės;SKRUZDELIUKŲ;8636113039;Ne;0;2;0;2
597;Birutės;SKRUZDELIUKŲ;9411016611;Ne;3;0;0;3
598;Birutės;SKRUZDELIUKŲ;7119951690;Ne;5;0;0;5
599;Birutės;SKRUZDELIUKŲ;1945532852;Ne;1;0;0;1
600;Birutės;SKRUZDELIUKŲ;5154903444;Ne;2;0;0;2
601;Birutės;SKRUZDELIUKŲ;6815916679;Ne;8;0;0;8
602;Birutės;SKRUZDELIUKŲ;9187671201;Ne;4;0;0;4
603;Birutės;SKRUZDELIUKŲ;2140552221;Ne;1;0;0;1
604;Birutės;SKRUZDELIUKŲ;7940403585;Ne;0;3;0;3
605;Birutės;SKRUZDELIUKŲ;8432173636;Ne;1;0;0;1
606;Birutės;SKRUZDELIUKŲ;9904827482;Ne;0;1;0;1
607;Birutės;SKRUZDELIUKŲ;2859160609;Ne;3;0;0;3
608;Birutės;SKRUZDELIUKŲ;2329522074;Ne;5;0;0;5
609;Birutės;SKRUZDELIUKŲ;1072357835;Taip;0;5;0;5
610;Birutės;BITUČIŲ;2866807046;Ne;8;0;0;8
611;Birutės;BITUČIŲ;7477555732;Ne;15;0;0;15
612;Birutės;BITUČIŲ;3991168916;Ne;7;0;0;7
613;Birutės;BITUČIŲ;7859284810;Taip;0;0;3;3
614;Birutės;BITUČIŲ;9147604398;Ne;5;0;0;5
615;Birutės;BITUČIŲ;3562960250;Taip;5;0;0;5
616;Birutės;BITUČIŲ;4647941243;Ne;8;0;0;8
617;Birutės;BITUČIŲ;6931635742;Ne;0;0;1;1
618;Birutės;BITUČIŲ;5443447213;Ne;6;0;0;6
619;Birutės;BITUČIŲ;8736343179;Ne;11;0;0;11
620;Birutės;BITUČIŲ;9303655949;Ne;1;0;0;1
621;Birutės;BITUČIŲ;9627882026;Ne;2;0;0;2
622;Birutės;BITUČIŲ;2046634392;Ne;4;0;0;4
623;Birutės;BITUČIŲ;4102490815;Ne;1;0;0;1
624;Birutės;BITUČIŲ;3584029960;Ne;7;0;0;7
625;Birutės;BITUČIŲ;7875884277;Ne;13;0;0;13
626;Birutės;BORUŽIUKAI;5893851353;Ne;1;0;0;1
627;Birutės;BORUŽIUKAI;5869137292;Ne;1;1;0;2
628;Birutės;BORUŽIUKAI;5026442722;Ne;3;2;0;5
629;Birutės;BORUŽIUKAI;6977276295;Ne;0;20;0;20
630;Birutės;BORUŽIUKAI;9263238557;Ne;0;1;0;1
631;Birutės;BORUŽIUKAI;4488481136;Ne;1;0;0;1
632;Birutės;BORUŽIUKAI;6973898557;Ne;0;4;1;5
633;Birutės;BORUŽIUKAI;7033907787;Ne;7;0;0;7
634;Birutės;BORUŽIUKAI;5745377474;Ne;5;0;0;5
635;Birutės;BORUŽIUKAI;5897671273;Ne;0;0;2;2
636;Birutės;BORUŽIUKAI;2016711225;Ne;7;0;0;7
637;Birutės;BORUŽIUKAI;7712882120;Ne;5;0;0;5
638;Birutės;BORUŽIUKAI;7741922416;Ne;0;8;0;8
639;Birutės;BORUŽIUKAI;1400510886;Ne;2;8;0;10
640;Birutės;BORUŽIUKAI;1776142202;Ne;1;0;0;1
641;Birutės;BORUŽIUKAI;4906874758;Ne;1;0;0;1
642;Birutės;DRUGELIAI;8854957814;Ne;5;0;1;6
643;Birutės;DRUGELIAI;6263985683;Ne;0;1;0;1
644;Birutės;DRUGELIAI;5957267018;Ne;4;0;1;5
645;Birutės;DRUGELIAI;1442496209;Ne;5;0;0;5
646;Birutės;DRUGELIAI;2318034045;Taip;7;0;0;7
647;Birutės;DRUGELIAI;9727836236;Ne;0;0;1;1
648;Birutės;DRUGELIAI;3516719248;Ne;0;0;1;1
649;Birutės;DRUGELIAI;5688633357;Ne;11;0;2;13
650;Birutės;DRUGELIAI;8559820030;Ne;10;0;10;20
651;Birutės;DRUGELIAI;9863681147;Ne;4;0;0;4
652;Birutės;DRUGELIAI;3115571205;Ne;0;0;2;2
653;Birutės;DRUGELIAI;4674152995;Ne;0;2;0;2
654;Birutės;DRUGELIAI;5177528200;Ne;0;0;10;10
655;Birutės;DRUGELIAI;3391101786;Ne;10;0;0;10
656;Birutės;DRUGELIAI;6765257633;Ne;2;0;0;2
657;Birutės;DRUGELIAI;7336936451;Ne;4;0;0;4
658;Birutės;DRUGELIAI;4995437657;Ne;6;0;0;6
659;Bitutė;Aitvariukų;4474600934;Ne;6;0;0;6
660;Bitutė;Aitvariukų;5606049201;Taip;12;0;0;12
661;Bitutė;Aitvariukų;6035394425;Ne;14;8;0;22
662;Bitutė;Aitvariukų;7132616264;Ne;18;6;0;24
663;Bitutė;Aitvariukų;6030674568;Ne;15;0;1;16
664;Bitutė;Aitvariukų;9747786638;Ne;7;3;0;10
665;Bitutė;Aitvariukų;8259512455;Ne;5;0;1;6
666;Bitutė;Aitvariukų;2899217019;Ne;12;0;0;12
667;Bitutė;Aitvariukų;8670124052;Ne;0;0;1;1
668;Bitutė;Aitvariukų;1340530611;Taip;0;4;0;4
669;Bitutė;Aitvariukų;6759511692;Ne;3;0;0;3
670;Bitutė;Aitvariukų;4164058783;Ne;5;0;4;9
671;Bitutė;Aitvariukų;8908052679;Ne;16;1;0;17
672;Bitutė;Aitvariukų;4924483609;Ne;10;2;0;12
673;Bitutė;Aitvariukų;7447624247;Taip;2;6;0;8
674;Bitutė;Aitvariukų;5880651175;Ne;4;1;0;5
675;Bitutė;Aitvariukų;7433169909;Ne;0;3;0;3
676;Bitutė;Ežiukų;5126303823;Ne;5;4;1;10
677;Bitutė;Ežiukų;4764586168;Ne;6;1;1;8
678;Bitutė;Ežiukų;8905075899;Ne;5;0;0;5
679;Bitutė;Ežiukų;6341806464;Ne;12;0;0;12
680;Bitutė;Ežiukų;2812580726;Ne;6;1;0;7
681;Bitutė;Ežiukų;8186706520;Ne;0;31;0;31
682;Bitutė;Ežiukų;2122052883;Ne;13;0;2;15
683;Bitutė;Ežiukų;4444523140;Taip;4;1;0;5
684;Bitutė;Ežiukų;4024758152;Ne;3;0;0;3
685;Bitutė;Ežiukų;6194712643;Ne;2;0;0;2
686;Bitutė;Ežiukų;4468366941;Ne;7;0;0;7
687;Bitutė;Ežiukų;5188828679;Ne;7;5;0;12
688;Bitutė;Ežiukų;8109028957;Ne;7;5;0;12
689;Bitutė;Ežiukų;3156654672;Ne;9;1;0;10
690;Bitutė;Ežiukų;9106644834;Taip;2;1;0;3
691;Bitutė;Ežiukų;1397711778;Ne;4;0;0;4
692;Bitutė;Ežiukų;5146691157;Ne;3;0;0;3
693;Bitutė;Žvirbliukų;1290146001;Taip;8;1;0;9
694;Bitutė;Žvirbliukų;6226996242;Ne;2;2;0;4
695;Bitutė;Žvirbliukų;1460746240;Ne;0;3;0;3
696;Bitutė;Žvirbliukų;3359918177;Ne;2;4;0;6
697;Bitutė;Žvirbliukų;9352292654;Ne;2;0;2;4
698;Bitutė;Žvirbliukų;5421744666;Ne;0;3;0;3
699;Bitutė;Žvirbliukų;9780599803;Ne;2;3;0;5
700;Bitutė;Žvirbliukų;7741454857;Ne;1;0;1;2
701;Bitutė;Žvirbliukų;6091108131;Ne;9;0;0;9
702;Bitutė;Žvirbliukų;4617493676;Taip;12;0;0;12
703;Bitutė;Žvirbliukų;3860047703;Taip;6;1;2;9
704;Bitutė;Žvirbliukų;5375847129;Ne;3;2;0;5
705;Bitutė;Žvirbliukų;3806852067;Taip;0;20;0;20
706;Bitutė;Žvirbliukų;3528436838;Ne;12;0;0;12
707;Bitutė;Žvirbliukų;2583001947;Taip;15;0;0;15
708;Bitutė;Žvirbliukų;2144809294;Ne;5;0;2;7
709;Bitutė;Žvirbliukų;7013249141;Ne;11;0;6;17
710;Bitutė;Žvirbliukų;4524571780;Ne;6;0;0;6
711;Bitutė;Gandriukų;8373296210;Ne;5;0;0;5
712;Bitutė;Gandriukų;8789574593;Ne;7;1;0;8
713;Bitutė;Gandriukų;8743960488;Ne;0;5;0;5
714;Bitutė;Gandriukų;9451529077;Ne;0;2;0;2
715;Bitutė;Gandriukų;4639968278;Ne;7;0;0;7
716;Bitutė;Gandriukų;1662815358;Taip;0;3;0;3
717;Bitutė;Gandriukų;1733189730;Ne;0;1;0;1
718;Bitutė;Gandriukų;4566919587;Ne;0;3;0;3
719;Bitutė;Gandriukų;9966437881;Ne;4;1;0;5
720;Bitutė;Gandriukų;1241863345;Ne;3;5;0;8
721;Bitutė;Gandriukų;9465186207;Ne;0;2;0;2
722;Bitutė;Pelėdžiukai;2444289145;Ne;4;0;0;4
723;Bitutė;Pelėdžiukai;3517750478;Ne;9;0;0;9
724;Bitutė;Pelėdžiukai;3804171750;Ne;0;1;0;1
725;Bitutė;Pelėdžiukai;8545377054;Ne;16;0;0;16
726;Bitutė;Pelėdžiukai;5406667195;Ne;1;0;0;1
727;Bitutė;Pelėdžiukai;4458990772;Ne;3;0;0;3
728;Bitutė;Pelėdžiukai;3723040682;Ne;4;0;0;4
729;Bitutė;Pelėdžiukai;5291764696;Ne;0;0;2;2
730;Bitutė;Pelėdžiukai;6014726741;Ne;0;1;0;1
731;Bitutė;Pelėdžiukai;4527880105;Ne;13;0;1;14
732;Bitutė;Pelėdžiukai;2190439190;Ne;3;0;0;3
733;Bitutė;Pelėdžiukai;9834697190;Ne;0;5;0;5
734;Bitutė;Pelėdžiukai;7113693496;Ne;8;0;0;8
735;Bitutė;Pelėdžiukai;9523588597;Ne;3;0;0;3
736;Bitutė;Pelėdžiukai;7047262367;Ne;0;1;0;1
737;Bitutė;Pelėdžiukai;4177331531;Ne;2;0;1;3
738;Bitutė;Pelėdžiukai;2483462846;Ne;3;1;0;4
739;Bitutė;Pelėdžiukai;7678106084;Ne;3;0;0;3
740;Bitutė;Pelėdžiukai;9166624750;Ne;1;2;0;3
741;Bitutė;Pelėdžiukai;8373105196;Ne;4;1;0;5
742;Bitutė;Pelėdžiukai;6044969600;Ne;3;0;0;3
743;Bitutė;Pelėdžiukai;3654065124;Ne;2;0;1;3
744;Bitutė;Boružėlių;8276590981;Ne;18;0;4;22
745;Bitutė;Boružėlių;3026526421;Ne;9;0;0;9
746;Bitutė;Boružėlių;7503203424;Taip;22;0;0;22
747;Bitutė;Boružėlių;1711888057;Ne;11;0;0;11
748;Bitutė;Boružėlių;8355346371;Ne;6;0;0;6
749;Bitutė;Boružėlių;9545405359;Ne;2;0;1;3
750;Bitutė;Boružėlių;9691450767;Ne;5;0;2;7
751;Bitutė;Boružėlių;3170266155;Taip;20;0;0;20
752;Bitutė;Boružėlių;8011051470;Ne;14;0;4;18
753;Bitutė;Boružėlių;9521938997;Ne;3;0;2;5
754;Bitutė;Boružėlių;9668365838;Ne;5;11;0;16
755;Bitutė;Boružėlių;3870675531;Ne;10;0;0;10
756;Bitutė;Boružėlių;7095475821;Taip;0;0;1;1
757;Bitutė;Boružėlių;6255439813;Ne;22;0;0;22
758;Bitutė;Boružėlių;2623999429;Ne;2;1;0;3
759;Bitutė;Boružėlių;6840722112;Ne;5;0;6;11
760;Bitutė;Boružėlių;4884898917;Ne;7;0;1;8
761;Bitutė;Boružėlių;4869423833;Ne;9;0;3;12
762;Bitutė;Boružėlių;5071978105;Ne;9;0;0;9
763;Bitutė;Šokliukų;8211710975;Ne;0;3;0;3
764;Bitutė;Šokliukų;8872286273;Ne;3;2;0;5
765;Bitutė;Šokliukų;5169768042;Ne;5;4;0;9
766;Bitutė;Šokliukų;1348548294;Ne;5;1;0;6
767;Bitutė;Šokliukų;7318555933;Ne;1;2;0;3
768;Bitutė;Šokliukų;9924340801;Ne;0;11;0;11
769;Bitutė;Šokliukų;7165511381;Ne;9;2;0;11
770;Bitutė;Šokliukų;2853616585;Ne;0;1;0;1
771;Bitutė;Šokliukų;5109258680;Ne;0;1;0;1
772;Bitutė;Šokliukų;3417576747;Ne;0;1;0;1
773;Bitutė;Šokliukų;8422448947;Ne;0;5;0;5
774;Bitutė;Šokliukų;7926482326;Ne;4;0;0;4
775;Bitutė;Šokliukų;5876700984;Ne;3;6;0;9
776;Bitutė;Šokliukų;2177537591;Ne;1;0;0;1
777;Bitutė;Šokliukų;5759407291;Ne;4;0;0;4
778;Bitutė;Šokliukų;4471813998;Ne;0;3;0;3
779;Bitutė;Drugelių;9094567866;Ne;1;0;0;1
780;Bitutė;Drugelių;5759595005;Ne;7;0;0;7
781;Bitutė;Drugelių;7376746010;Ne;0;0;1;1
782;Bitutė;Drugelių;5845408472;Ne;0;1;0;1
783;Bitutė;Drugelių;3611348253;Ne;0;0;2;2
784;Bitutė;Drugelių;8727525320;Ne;0;0;2;2
785;Bitutė;Drugelių;5796600501;Ne;0;0;1;1
786;Bitutė;Drugelių;1558826102;Ne;5;0;0;5
787;Bitutė;Drugelių;6325890676;Ne;19;1;0;20
788;Bitutė;Drugelių;2848732083;Taip;0;1;0;1
789;Bitutė;Drugelių;5278510767;Ne;0;2;0;2
790;Bitutė;Drugelių;8962725357;Ne;3;0;0;3
791;Bitutė;Drugelių;5471241132;Ne;0;2;4;6
792;Bitutė;Drugelių;1218462939;Ne;0;1;0;1
793;Bitutė;Drugelių;8008237092;Ne;0;0;6;6
794;Bitutė;Drugelių;4545188971;Ne;17;3;0;20
795;Bitutė;Kiškučių;3603716923;Ne;8;5;0;13
796;Bitutė;Kiškučių;5181958187;Ne;4;6;0;10
797;Bitutė;Kiškučių;1715987321;Ne;4;0;0;4
798;Bitutė;Kiškučių;4480187618;Ne;5;0;0;5
799;Bitutė;Kiškučių;4926289620;Ne;17;0;0;17
800;Bitutė;Kiškučių;7694916340;Ne;1;0;1;2
801;Bitutė;Kiškučių;5061164237;Ne;9;0;0;9
802;Bitutė;Kiškučių;8130382253;Ne;7;3;0;10
803;Bitutė;Kiškučių;5869737425;Ne;8;0;0;8
804;Bitutė;Kiškučių;5220694242;Ne;2;1;0;3
805;Bitutė;Kiškučių;8303932330;Ne;20;0;0;20
806;Bitutė;Kiškučių;8642411661;Ne;7;0;0;7
807;Bitutė;Kiškučių;3811028304;Ne;8;1;0;9
808;Bitutė;Kiškučių;9592567172;Ne;9;0;0;9
809;Bitutė;Kiškučių;7535583229;Ne;2;0;0;2
810;Bitutė;Kiškučių;7619112317;Ne;5;4;0;9
811;Bitutė;Kiškučių;8896842164;Ne;6;0;0;6
812;Bitutė;Kiškučių;8561037889;Ne;4;4;0;8
813;Bitutė;"Viščiukų ";2707925569;Ne;18;0;0;18
814;Bitutė;"Viščiukų ";9872069356;Ne;17;0;0;17
815;Bitutė;"Viščiukų ";7341046095;Ne;9;0;0;9
816;Bitutė;"Viščiukų ";9325422338;Ne;19;6;0;25
817;Bitutė;"Viščiukų ";1147029462;Ne;20;0;0;20
818;Bitutė;"Viščiukų ";9653424274;Ne;2;0;0;2
819;Bitutė;"Viščiukų ";3318389039;Ne;23;0;0;23
820;Bitutė;"Viščiukų ";7301966217;Ne;15;2;0;17
821;Bitutė;"Viščiukų ";4864590214;Taip;21;0;0;21
822;Bitutė;"Viščiukų ";5111232226;Ne;5;9;0;14
823;Bitutė;"Viščiukų ";7384402285;Ne;19;0;0;19
824;Bitutė;"Viščiukų ";6045476884;Ne;7;0;0;7
825;Bitutė;"Viščiukų ";7566001042;Taip;5;0;0;5
826;Bitutė;"Viščiukų ";2368846393;Ne;10;8;0;18
827;Bitutė;"Viščiukų ";4041036896;Ne;4;0;0;4
828;Bitutė;"Skruzdėliukai ";5686278261;Ne;10;0;0;10
829;Bitutė;"Skruzdėliukai ";1423694056;Ne;2;0;0;2
830;Bitutė;"Skruzdėliukai ";5942493696;Taip;0;1;0;1
831;Bitutė;"Skruzdėliukai ";6311396261;Ne;7;1;0;8
832;Bitutė;"Skruzdėliukai ";7145036085;Ne;8;0;3;11
833;Bitutė;"Skruzdėliukai ";2252157473;Ne;1;0;1;2
834;Bitutė;"Skruzdėliukai ";6169426273;Ne;8;0;0;8
835;Bitutė;"Skruzdėliukai ";4513783927;Ne;2;0;0;2
836;Bitutė;"Skruzdėliukai ";8667259778;Ne;0;0;5;5
837;Bitutė;"Skruzdėliukai ";4413880918;Ne;4;0;0;4
838;Bitutė;"Skruzdėliukai ";9436414962;Ne;20;0;0;20
839;Bitutė;"Skruzdėliukai ";9864771568;Ne;5;0;2;7
840;Bitutė;"Skruzdėliukai ";6353690252;Ne;14;0;0;14
841;Bitutė;"Skruzdėliukai ";2160735504;Ne;7;0;0;7
842;Bitutė;"Skruzdėliukai ";1387310054;Ne;0;0;1;1
843;Bitutė;"Skruzdėliukai ";7245807233;Ne;0;0;5;5
844;Bitutė;"Skruzdėliukai ";4467090141;Taip;0;0;2;2
845;Bitutė;"Skruzdėliukai ";5433617195;Ne;0;8;0;8
846;Bitutė;"Skruzdėliukai ";5490753578;Ne;11;0;0;11
847;Bitutė;"Nykštukų ";1677780832;Ne;3;0;0;3
848;Bitutė;"Nykštukų ";7093067437;Ne;17;0;0;17
849;Bitutė;"Nykštukų ";7494665747;Ne;7;2;1;10
850;Bitutė;"Nykštukų ";9392119453;Ne;0;31;0;31
851;Bitutė;"Nykštukų ";7618391238;Ne;5;4;0;9
852;Bitutė;"Nykštukų ";7201520408;Ne;0;31;0;31
853;Bitutė;"Nykštukų ";3564872382;Ne;12;0;0;12
854;Bitutė;"Nykštukų ";2779363539;Ne;12;0;0;12
855;Bitutė;"Nykštukų ";1094120235;Ne;5;0;0;5
856;Bitutė;"Nykštukų ";8344844253;Ne;5;0;0;5
857;Bitutė;"Nykštukų ";4341037730;Ne;3;1;0;4
858;Bitutė;"Nykštukų ";6591026369;Ne;11;0;0;11
859;Bitutė;"Nykštukų ";3430153178;Ne;9;1;0;10
860;Bitutė;"Nykštukų ";3938392405;Ne;4;0;0;4
861;Bitutė;"Nykštukų ";5974397461;Ne;4;0;0;4
862;Bitutė;"Nykštukų ";1124437382;Ne;1;0;0;1
863;Coliukė;"Bitutės (A.Kojelavičiaus g. 298)";6725408547;Ne;3;0;2;5
864;Coliukė;"Bitutės (A.Kojelavičiaus g. 298)";2167230398;Ne;0;1;0;1
865;Coliukė;"Bitutės (A.Kojelavičiaus g. 298)";5349969025;Ne;0;5;0;5
866;Coliukė;"Bitutės (A.Kojelavičiaus g. 298)";8767261039;Ne;3;6;0;9
867;Coliukė;"Bitutės (A.Kojelavičiaus g. 298)";7345905007;Ne;3;6;0;9
868;Coliukė;"Bitutės (A.Kojelavičiaus g. 298)";1968467455;Taip;0;1;0;1
869;Coliukė;"Bitutės (A.Kojelavičiaus g. 298)";9462610674;Ne;0;2;1;3
870;Coliukė;"Bitutės (A.Kojelavičiaus g. 298)";4188233426;Ne;0;0;1;1
871;Coliukė;"Bitutės (A.Kojelavičiaus g. 298)";9331485675;Ne;3;5;0;8
872;Coliukė;"Bitutės (A.Kojelavičiaus g. 298)";9879369365;Ne;5;3;0;8
873;Coliukė;"Bitutės (A.Kojelavičiaus g. 298)";4845247006;Ne;1;0;1;2
874;Coliukė;"Bitutės (A.Kojelavičiaus g. 298)";9885547263;Ne;0;0;2;2
875;Coliukė;"Bitutės (A.Kojelavičiaus g. 298)";8517128464;Ne;0;6;2;8
876;Coliukė;"Bitutės (A.Kojelavičiaus g. 298)";7358018315;Ne;16;1;0;17
877;Coliukė;"Bitutės (A.Kojelavičiaus g. 298)";9688432169;Ne;11;0;0;11
878;Coliukė;"Bitutės (A.Kojelavičiaus g. 298)";8478006305;Ne;0;0;3;3
879;Coliukė;"Bitutės (A.Kojelavičiaus g. 298)";9352547729;Ne;0;2;0;2
880;Coliukė;"Bitutės (A.Kojelavičiaus g. 298)";9750447455;Ne;17;0;0;17
881;Coliukė;"Bitutės (A.Kojelavičiaus g. 298)";7621095517;Ne;0;0;1;1
882;Coliukė;"Bitutės (A.Kojelavičiaus g. 298)";4140716483;Ne;3;0;0;3
883;Coliukė;"Bitutės (A.Kojelavičiaus g. 298)";2385917598;Ne;5;0;0;5
884;Coliukė;"Bitutės (A.Kojelavičiaus g. 298)";1390751418;Ne;5;0;0;5
885;Coliukė;"Bitutės (A.Kojelavičiaus g. 298)";4881447596;Ne;0;3;0;3
886;Coliukė;"Bitutės (A.Kojelavičiaus g. 298)";2151108735;Ne;3;1;0;4
887;Coliukė;"Boružėlės.spec. (Karklėnų g. 15)";5756690199;Ne;10;0;0;10
888;Coliukė;"Boružėlės.spec. (Karklėnų g. 15)";4422823135;Ne;13;0;0;13
889;Coliukė;"Boružėlės.spec. (Karklėnų g. 15)";2947495861;Ne;7;0;0;7
890;Coliukė;"Boružėlės.spec. (Karklėnų g. 15)";5008183731;Ne;4;0;0;4
891;Coliukė;"Boružėlės.spec. (Karklėnų g. 15)";1134875499;Ne;1;0;0;1
892;Coliukė;"Boružėlės.spec. (Karklėnų g. 15)";8347206534;Ne;2;0;0;2
893;Coliukė;"Boružėlės.spec. (Karklėnų g. 15)";3270283626;Ne;3;0;0;3
894;Coliukė;"Boružėlės.spec. (Karklėnų g. 15)";1326014786;Ne;16;0;0;16
895;Coliukė;"Boružėlės.spec. (Karklėnų g. 15)";7513522378;Ne;0;3;0;3
896;Coliukė;"Boružėlės.spec. (Karklėnų g. 15)";3905904092;Ne;2;0;0;2
897;Coliukė;"Boružėlės.spec. (Karklėnų g. 15)";6534433593;Ne;11;0;0;11
898;Coliukė;"Nykštukai (A.Kojelavičiaus g. 298)";4149083597;Ne;7;0;0;7
899;Coliukė;"Nykštukai (A.Kojelavičiaus g. 298)";2171894105;Taip;11;0;0;11
900;Coliukė;"Nykštukai (A.Kojelavičiaus g. 298)";5481656345;Ne;7;1;0;8
901;Coliukė;"Nykštukai (A.Kojelavičiaus g. 298)";2379680426;Taip;10;0;0;10
902;Coliukė;"Nykštukai (A.Kojelavičiaus g. 298)";6483218499;Ne;9;0;0;9
903;Coliukė;"Nykštukai (A.Kojelavičiaus g. 298)";1590896552;Ne;14;0;0;14
904;Coliukė;"Nykštukai (A.Kojelavičiaus g. 298)";4887837499;Ne;11;0;0;11
905;Coliukė;"Nykštukai (A.Kojelavičiaus g. 298)";1465212393;Ne;20;0;0;20
906;Coliukė;"Nykštukai (A.Kojelavičiaus g. 298)";1516038730;Ne;7;0;0;7
907;Coliukė;"Nykštukai (A.Kojelavičiaus g. 298)";7164457313;Ne;3;0;2;5
908;Coliukė;"Nykštukai (A.Kojelavičiaus g. 298)";6441253648;Ne;8;0;0;8
909;Coliukė;"Nykštukai (A.Kojelavičiaus g. 298)";4537756081;Ne;10;3;0;13
910;Coliukė;"Nykštukai (A.Kojelavičiaus g. 298)";3719547522;Ne;13;1;0;14
911;Coliukė;"Nykštukai (A.Kojelavičiaus g. 298)";5450167562;Ne;0;2;0;2
912;Coliukė;"Nykštukai (A.Kojelavičiaus g. 298)";9498557347;Ne;7;0;1;8
913;Coliukė;"Nykštukai (A.Kojelavičiaus g. 298)";3384332079;Taip;4;0;0;4
914;Coliukė;"Nykštukai (A.Kojelavičiaus g. 298)";1198781036;Ne;2;0;0;2
915;Coliukė;"Nykštukai (A.Kojelavičiaus g. 298)";9334564869;Ne;15;2;0;17
916;Coliukė;"Nykštukai (A.Kojelavičiaus g. 298)";3140659021;Ne;0;0;16;16
917;Coliukė;"Nykštukai (A.Kojelavičiaus g. 298)";2321127662;Ne;6;0;2;8
918;Coliukė;"Nykštukai (A.Kojelavičiaus g. 298)";8715608220;Ne;9;0;0;9
919;Coliukė;"Nykštukai (A.Kojelavičiaus g. 298)";3908791146;Ne;3;0;0;3
920;Coliukė;"Nykštukai (A.Kojelavičiaus g. 298)";4635299740;Ne;10;2;0;12
921;Coliukė;"Gėlytės (A.Kojelavičiaus g. 304) ";6226741104;Ne;2;0;0;2
922;Coliukė;"Gėlytės (A.Kojelavičiaus g. 304) ";1415007991;Ne;10;0;0;10
923;Coliukė;"Gėlytės (A.Kojelavičiaus g. 304) ";7500857860;Ne;0;0;1;1
924;Coliukė;"Gėlytės (A.Kojelavičiaus g. 304) ";2952029073;Taip;2;0;0;2
925;Coliukė;"Gėlytės (A.Kojelavičiaus g. 304) ";4757165137;Ne;9;0;0;9
926;Coliukė;"Gėlytės (A.Kojelavičiaus g. 304) ";3693899535;Ne;10;0;0;10
927;Coliukė;"Gėlytės (A.Kojelavičiaus g. 304) ";3419764892;Taip;15;0;0;15
928;Coliukė;"Gėlytės (A.Kojelavičiaus g. 304) ";7259282073;Ne;8;0;0;8
929;Coliukė;"Gėlytės (A.Kojelavičiaus g. 304) ";4327259627;Ne;0;2;0;2
930;Coliukė;"Drugeliai  (A.Kojelavičiaus g. 304)  ";6675290003;Ne;13;0;0;13
931;Coliukė;"Drugeliai  (A.Kojelavičiaus g. 304)  ";8202294275;Ne;13;0;0;13
932;Coliukė;"Drugeliai  (A.Kojelavičiaus g. 304)  ";7763035106;Ne;4;1;0;5
933;Coliukė;"Drugeliai  (A.Kojelavičiaus g. 304)  ";8756465257;Ne;5;4;0;9
934;Coliukė;"Drugeliai  (A.Kojelavičiaus g. 304)  ";6224089401;Ne;5;0;0;5
935;Coliukė;"Drugeliai  (A.Kojelavičiaus g. 304)  ";6102405328;Ne;11;0;0;11
936;Coliukė;"Drugeliai  (A.Kojelavičiaus g. 304)  ";1861955437;Ne;0;4;0;4
937;Coliukė;"Drugeliai  (A.Kojelavičiaus g. 304)  ";1220834062;Taip;0;1;0;1
938;Coliukė;"Drugeliai  (A.Kojelavičiaus g. 304)  ";3392367716;Ne;0;3;0;3
939;Coliukė;"Drugeliai  (A.Kojelavičiaus g. 304)  ";8698370746;Ne;6;0;0;6
940;Coliukė;"Drugeliai  (A.Kojelavičiaus g. 304)  ";6611713551;Ne;11;0;0;11
941;Coliukė;"Drugeliai  (A.Kojelavičiaus g. 304)  ";6755886435;Ne;10;0;0;10
942;Coliukė;"Drugeliai  (A.Kojelavičiaus g. 304)  ";1220385522;Taip;3;0;0;3
943;Coliukė;"Drugeliai  (A.Kojelavičiaus g. 304)  ";1452034828;Ne;1;1;0;2
944;Coliukė;"Drugeliai  (A.Kojelavičiaus g. 304)  ";6816085304;Ne;5;5;0;10
945;Coliukė;"Drugeliai  (A.Kojelavičiaus g. 304)  ";6941719947;Taip;0;1;0;1
946;Coliukė;"Drugeliai  (A.Kojelavičiaus g. 304)  ";5347456579;Ne;9;0;0;9
947;Coliukė;"Drugeliai  (A.Kojelavičiaus g. 304)  ";8606195508;Taip;11;0;0;11
948;Coliukė;"Drugeliai  (A.Kojelavičiaus g. 304)  ";2247086548;Ne;6;0;0;6
949;Čiauškutis;BITUTĖS;7976738303;Ne;0;0;3;3
950;Čiauškutis;BITUTĖS;4026881335;Taip;20;0;0;20
951;Čiauškutis;BITUTĖS;9753680961;Ne;8;0;0;8
952;Čiauškutis;BITUTĖS;4652951382;Ne;0;0;2;2
953;Čiauškutis;BITUTĖS;3837360101;Ne;0;0;1;1
954;Čiauškutis;BITUTĖS;2319237497;Ne;0;10;1;11
955;Čiauškutis;BITUTĖS;1765857419;Ne;0;1;0;1
956;Čiauškutis;BITUTĖS;7282041196;Ne;0;19;1;20
957;Čiauškutis;ŽVIRBLIUKAI;5125518366;Ne;5;0;0;5
958;Čiauškutis;ŽVIRBLIUKAI;4962200863;Ne;20;0;0;20
959;Čiauškutis;ŽVIRBLIUKAI;7324659239;Ne;2;0;0;2
960;Čiauškutis;ŽVIRBLIUKAI;1032711865;Ne;9;0;5;14
961;Čiauškutis;ŽVIRBLIUKAI;4599018314;Taip;8;0;2;10
962;Čiauškutis;ŽVIRBLIUKAI;7359935733;Ne;6;0;6;12
963;Čiauškutis;ŽVIRBLIUKAI;5368435217;Taip;2;0;2;4
964;Čiauškutis;SAULUTĖS;1158816422;Ne;0;18;2;20
965;Čiauškutis;SAULUTĖS;7239878097;Ne;0;0;1;1
966;Čiauškutis;SAULUTĖS;7489733038;Ne;10;0;0;10
967;Čiauškutis;SAULUTĖS;2237570705;Ne;0;0;1;1
968;Čiauškutis;SAULUTĖS;3724324861;Ne;0;20;0;20
969;Čiauškutis;SAULUTĖS;8580034134;Taip;0;0;2;2
970;Čiauškutis;SAULUTĖS;2445742257;Ne;0;14;6;20
971;Čiauškutis;SAULUTĖS;2737503753;Ne;0;0;1;1
972;Čiauškutis;SAULUTĖS;2686038029;Ne;0;0;1;1
973;Čiauškutis;EŽIUKAI;9565722619;Ne;0;20;0;20
974;Čiauškutis;EŽIUKAI;7654242839;Ne;5;0;0;5
975;Čiauškutis;EŽIUKAI;8297774828;Ne;0;0;1;1
976;Čiauškutis;EŽIUKAI;6303770262;Ne;4;0;0;4
977;Čiauškutis;EŽIUKAI;2380881303;Ne;0;0;1;1
978;Čiauškutis;DRUGELIAI;4681902267;Ne;3;0;0;3
979;Čiauškutis;DRUGELIAI;9959952114;Ne;0;0;1;1
980;Čiauškutis;DRUGELIAI;1928404791;Ne;4;0;0;4
981;Čiauškutis;DRUGELIAI;7746580858;Ne;2;0;0;2
982;Čiauškutis;DRUGELIAI;1234494170;Ne;7;0;0;7
983;Čiauškutis;DRUGELIAI;9897499968;Ne;0;19;1;20
984;Čiauškutis;DRUGELIAI;7630342576;Ne;5;0;0;5
985;Čiauškutis;DRUGELIAI;7135435979;Ne;0;0;1;1
986;Čiauškutis;GENELIAI;5957587644;Ne;15;0;0;15
987;Čiauškutis;GENELIAI;5052137859;Taip;0;20;0;20
988;Čiauškutis;GENELIAI;8876608072;Ne;16;0;1;17
989;Čiauškutis;GENELIAI;3650541072;Ne;0;7;0;7
990;Čiauškutis;GENELIAI;6785604459;Ne;5;12;3;20
991;Čiauškutis;GENELIAI;7851357992;Ne;4;0;1;5
992;Čiauškutis;GENELIAI;7928675053;Ne;3;15;2;20
993;Čiauškutis;GENELIAI;3644842573;Ne;3;0;0;3
994;Čiauškutis;GENELIAI;1113437256;Ne;8;0;3;11
995;Čiauškutis;LINKSMUČIAI;8689127061;Ne;9;0;4;13
996;Čiauškutis;LINKSMUČIAI;9062135043;Ne;4;0;0;4
997;Čiauškutis;LINKSMUČIAI;5910818962;Ne;2;0;0;2
998;Čiauškutis;LINKSMUČIAI;4881821738;Ne;0;0;2;2
999;Čiauškutis;LINKSMUČIAI;4881821738;Ne;0;0;2;2
1000;Čiauškutis;LINKSMUČIAI;6146321785;Ne;0;0;1;1
1001;Čiauškutis;LINKSMUČIAI;1733251156;Ne;0;0;1;1
1002;Čiauškutis;KIŠKUČIAI;1900086424;Ne;0;1;0;1
1003;Čiauškutis;KIŠKUČIAI;3465024013;Ne;0;18;2;20
1004;Čiauškutis;KIŠKUČIAI;2271458332;Ne;1;0;0;1
1005;Čiauškutis;KIŠKUČIAI;9754417066;Ne;0;20;0;20
1006;Čiauškutis;KIŠKUČIAI;5589764935;Ne;4;0;7;11
1007;Čiauškutis;KIŠKUČIAI;3583094831;Ne;0;0;1;1
1008;Čiauškutis;KIŠKUČIAI;4169517353;Ne;0;0;1;1
1009;Čiauškutis;KIŠKUČIAI;3126627913;Ne;0;0;1;1
1010;Čiauškutis;LAPIUKAI;6810906239;Ne;0;19;1;20
1011;Čiauškutis;LAPIUKAI;9460608737;Ne;0;0;3;3
1012;Čiauškutis;LAPIUKAI;9928767253;Ne;0;19;1;20
1013;Čiauškutis;LAPIUKAI;9702568740;Ne;3;17;0;20
1014;Čiauškutis;LAPIUKAI;5427045039;Ne;6;0;0;6
1015;Čiauškutis;LAPIUKAI;8737871477;Ne;9;9;2;20
1016;Čiauškutis;LAPIUKAI;5842585542;Ne;2;18;0;20
1017;Čiauškutis;LAPIUKAI;6940865564;Ne;5;15;0;20
1018;Čiauškutis;MEŠKUČIAI;2172687454;Ne;3;0;0;3
1019;Čiauškutis;MEŠKUČIAI;3660195990;Ne;10;0;1;11
1020;Čiauškutis;MEŠKUČIAI;4213259879;Ne;0;5;0;5
1021;Čiauškutis;MEŠKUČIAI;6608678558;Ne;5;0;2;7
1022;Čiauškutis;MEŠKUČIAI;7714816675;Ne;6;0;1;7
1023;Čiauškutis;MEŠKUČIAI;9684750515;Ne;0;0;2;2
1024;Čiauškutis;PELĖDŽIUKAI;4971788697;Ne;10;0;0;10
1025;Čiauškutis;PELĖDŽIUKAI;1561833758;Ne;0;0;1;1
1026;Čiauškutis;PELĖDŽIUKAI;3700692073;Ne;2;0;0;2
1027;Čiauškutis;PELĖDŽIUKAI;6615319751;Ne;7;0;0;7
1028;Čiauškutis;PELĖDŽIUKAI;3298272815;Ne;7;0;0;7
1029;Čiauškutis;NYKŠTUKAI;8948893335;Ne;0;0;1;1
1030;Čiauškutis;NYKŠTUKAI;2633243682;Ne;0;1;0;1
1031;Čiauškutis;NYKŠTUKAI;6705934636;Ne;1;0;0;1
1032;Čiauškutis;NYKŠTUKAI;2044220236;Ne;0;0;1;1
1033;Čiauškutis;NYKŠTUKAI;7335655769;Ne;4;0;1;5
1034;Čiauškutis;NYKŠTUKAI;5686690700;Ne;11;0;1;12
1035;Čiauškutis;NYKŠTUKAI;5734665607;Ne;2;0;1;3
1036;Delfinukas;Boružėlių;5963440967;Ne;9;0;0;9
1037;Delfinukas;Boružėlių;5320485170;Ne;5;1;0;6
1038;Delfinukas;Boružėlių;6878446154;Ne;13;1;0;14
1039;Delfinukas;Boružėlių;1970318187;Ne;17;0;0;17
1040;Delfinukas;Boružėlių;7752786752;Ne;17;0;0;17
1041;Delfinukas;Boružėlių;2459046463;Ne;9;0;0;9
1042;Delfinukas;Boružėlių;6133972529;Ne;7;0;0;7
1043;Delfinukas;Boružėlių;2323767897;Ne;9;0;5;14
1044;Delfinukas;Boružėlių;2830904360;Ne;10;0;0;10
1045;Delfinukas;Boružėlių;9127076507;Ne;0;5;0;5
1046;Delfinukas;Boružėlių;3015726598;Taip;5;0;1;6
1047;Delfinukas;Boružėlių;1843845065;Ne;5;0;0;5
1048;Delfinukas;Boružėlių;8554498555;Ne;0;0;6;6
1049;Delfinukas;Boružėlių;2716595364;Ne;20;0;0;20
1050;Delfinukas;Boružėlių;2450560824;Taip;10;10;0;20
1051;Delfinukas;Saulytės;8315269427;Ne;5;0;0;5
1052;Delfinukas;Saulytės;4215887291;Ne;0;4;0;4
1053;Delfinukas;Saulytės;3631520143;Ne;15;0;0;15
1054;Delfinukas;Saulytės;9424966984;Taip;5;0;0;5
1055;Delfinukas;Saulytės;6069600728;Ne;2;0;0;2
1056;Delfinukas;Saulytės;9729550922;Taip;0;3;0;3
1057;Delfinukas;Saulytės;1404270345;Taip;8;0;0;8
1058;Delfinukas;Saulytės;3842160990;Ne;7;1;0;8
1059;Delfinukas;Saulytės;8402529296;Taip;8;0;0;8
1060;Delfinukas;Saulytės;5125346405;Taip;0;2;0;2
1061;Delfinukas;Saulytės;5642328792;Ne;0;4;0;4
1062;Delfinukas;Saulytės;8176576958;Ne;5;0;0;5
1063;Delfinukas;Saulytės;8275943176;Ne;2;1;0;3
1064;Delfinukas;Saulytės;8085530134;Taip;3;8;0;11
1065;Delfinukas;Saulytės;8148610460;Ne;0;3;0;3
1066;Delfinukas;Saulytės;8186312409;Ne;6;1;0;7
1067;Delfinukas;Saulytės;1873630966;Ne;0;1;0;1
1068;Delfinukas;Saulytės;1953356983;Taip;1;0;0;1
1069;Delfinukas;Pelėdžiukų;8774145277;Taip;5;2;0;7
1070;Delfinukas;Pelėdžiukų;6113662246;Ne;20;0;0;20
1071;Delfinukas;Pelėdžiukų;4710894128;Taip;7;9;0;16
1072;Delfinukas;Pelėdžiukų;1526129772;Taip;0;1;0;1
1073;Delfinukas;Pelėdžiukų;8267992425;Ne;0;5;0;5
1074;Delfinukas;Pelėdžiukų;4096274346;Taip;4;2;0;6
1075;Delfinukas;Pelėdžiukų;5246300518;Taip;3;0;0;3
1076;Delfinukas;Pelėdžiukų;6286748047;Ne;0;8;0;8
1077;Delfinukas;Pelėdžiukų;4465504676;Taip;0;1;0;1
1078;Delfinukas;Pelėdžiukų;6282501549;Ne;6;2;0;8
1079;Delfinukas;Varliukų;4949220786;Ne;8;0;0;8
1080;Delfinukas;Varliukų;2792051636;Taip;0;11;0;11
1081;Delfinukas;Varliukų;4780352568;Taip;1;0;0;1
1082;Delfinukas;Varliukų;3577180085;Ne;13;0;0;13
1083;Delfinukas;Varliukų;6115370195;Taip;2;0;0;2
1084;Delfinukas;Varliukų;7976681530;Ne;0;0;1;1
1085;Delfinukas;Varliukų;4338259551;Ne;0;0;1;1
1086;Delfinukas;Varliukų;5095713834;Taip;3;4;1;8
1087;Delfinukas;Varliukų;5964021733;Ne;13;0;0;13
1088;Delfinukas;Varliukų;5821591959;Ne;0;2;0;2
1089;Delfinukas;Varliukų;5138840297;Ne;0;5;1;6
1090;Delfinukas;Varliukų;7072060541;Taip;0;0;1;1
1091;Delfinukas;Varliukų;3797355501;Ne;5;4;0;9
1092;Delfinukas;Varliukų;4751611934;Taip;0;10;0;10
1093;Delfinukas;Varliukų;4254414928;Taip;6;2;0;8
1094;Delfinukas;Varliukų;7359531377;Ne;0;1;0;1
1095;Delfinukas;Varpelių;8913681176;Ne;0;2;0;2
1096;Delfinukas;Varpelių;9514189769;Ne;0;2;0;2
1097;Delfinukas;Varpelių;3818558339;Ne;4;0;0;4
1098;Delfinukas;Varpelių;1484123788;Ne;0;1;2;3
1099;Delfinukas;Varpelių;9218154624;Ne;3;0;0;3
1100;Delfinukas;Varpelių;8950528288;Ne;1;0;0;1
1101;Delfinukas;Varpelių;8829835426;Taip;0;0;1;1
1102;Delfinukas;Varpelių;6938708939;Ne;0;1;0;1
1103;Delfinukas;Varpelių;2730512600;Ne;0;1;0;1
1104;Delfinukas;Varpelių;8911433659;Ne;4;0;0;4
1105;Delfinukas;Varpelių;6952314149;Ne;12;1;0;13
1106;Delfinukas;Varpelių;5158297103;Ne;1;0;0;1
1107;Delfinukas;Varpelių;4101463768;Ne;0;1;0;1
1108;Delfinukas;Varpelių;5467211088;Ne;5;0;0;5
1109;Delfinukas;Varpelių;7780893730;Taip;9;0;0;9
1110;Delfinukas;Varpelių;6071660741;Ne;5;0;0;5
1111;Delfinukas;Drugeliai;6604115681;Ne;10;7;0;17
1112;Delfinukas;Drugeliai;5990192934;Ne;6;2;0;8
1113;Delfinukas;Drugeliai;9635669748;Ne;0;2;0;2
1114;Delfinukas;Drugeliai;8526813977;Ne;0;2;0;2
1115;Delfinukas;Drugeliai;6873181103;Ne;0;7;0;7
1116;Delfinukas;Drugeliai;4484804360;Ne;0;2;2;4
1117;Delfinukas;Drugeliai;8328481987;Ne;2;1;0;3
1118;Delfinukas;Drugeliai;6992505341;Ne;7;0;0;7
1119;Delfinukas;Drugeliai;8129592398;Ne;2;0;0;2
1120;Delfinukas;Drugeliai;9927854348;Ne;1;0;0;1
1121;Delfinukas;Drugeliai;6884260821;Ne;13;0;0;13
1122;Delfinukas;Drugeliai;2985669766;Ne;11;1;0;12
1123;Delfinukas;Drugeliai;6457042338;Taip;0;4;0;4
1124;Delfinukas;Drugeliai;8411289299;Ne;8;0;0;8
1125;Delfinukas;Drugeliai;2683746435;Ne;0;1;0;1
1126;Delfinukas;Drugeliai;6623617856;Ne;6;0;0;6
1127;Delfinukas;Žuvytės;4384995354;Ne;8;2;0;10
1128;Delfinukas;Žuvytės;1918878505;Ne;0;2;1;3
1129;Delfinukas;Žuvytės;1575125658;Taip;11;1;0;12
1130;Delfinukas;Žuvytės;7354837777;Ne;10;0;1;11
1131;Delfinukas;Žuvytės;9253061888;Ne;3;0;0;3
1132;Delfinukas;Žuvytės;5665463557;Ne;4;0;0;4
1133;Delfinukas;Žuvytės;9686085316;Ne;0;0;1;1
1134;Delfinukas;Žuvytės;7464957954;Ne;12;0;0;12
1135;Delfinukas;Žuvytės;5281161835;Ne;5;0;0;5
1136;Delfinukas;Žuvytės;2425621326;Ne;14;0;0;14
1137;Delfinukas;Žuvytės;4782384361;Ne;12;0;0;12
1138;Delfinukas;Žuvytės;6865463448;Taip;5;1;0;6
1139;Delfinukas;Žuvytės;9773069890;Ne;3;0;0;3
1140;Delfinukas;Žuvytės;5397241026;Ne;0;7;0;7
1141;Delfinukas;Delfinai;7663934825;Taip;2;0;1;3
1142;Delfinukas;Delfinai;2382077576;Ne;3;0;0;3
1143;Delfinukas;Delfinai;1922513830;Taip;6;0;0;6
1144;Delfinukas;Delfinai;6270012707;Taip;5;2;0;7
1145;Delfinukas;Delfinai;8085481968;Ne;0;1;0;1
1146;Delfinukas;Delfinai;9605756229;Taip;0;0;1;1
1147;Delfinukas;Delfinai;8415516743;Ne;5;0;2;7
1148;Delfinukas;Delfinai;4855210424;Taip;7;0;0;7
1149;Delfinukas;Delfinai;3465399369;Ne;0;0;5;5
1150;Delfinukas;Delfinai;2890469172;Ne;4;0;4;8
1151;Delfinukas;Paukšteliai;7366145460;Ne;4;0;0;4
1152;Delfinukas;Paukšteliai;5278689745;Ne;1;2;0;3
1153;Delfinukas;Paukšteliai;6002086491;Taip;0;1;0;1
1154;Delfinukas;Paukšteliai;1164720538;Taip;10;0;0;10
1155;Delfinukas;Paukšteliai;9629225917;Ne;20;0;0;20
1156;Delfinukas;Paukšteliai;9332794060;Ne;11;0;0;11
1157;Delfinukas;Paukšteliai;6650725760;Ne;4;1;2;7
1158;Delfinukas;Paukšteliai;9776618488;Taip;11;0;0;11
1159;Delfinukas;Paukšteliai;4561911078;Ne;6;0;0;6
1160;Delfinukas;Paukšteliai;9289866851;Ne;4;0;0;4
1161;Delfinukas;Paukšteliai;1746566943;Taip;2;4;0;6
1162;Delfinukas;Paukšteliai;9073634575;Ne;5;0;1;6
1163;Delfinukas;Paukšteliai;2186801708;Ne;5;9;0;14
1164;Delfinukas;Paukšteliai;6055420223;Taip;16;0;0;16
1165;Delfinukas;Kiškučiai;5585334518;Taip;0;1;0;1
1166;Delfinukas;Kiškučiai;4196156707;Ne;0;1;0;1
1167;Delfinukas;Kiškučiai;5443027988;Taip;0;3;0;3
1168;Delfinukas;Kiškučiai;6301767635;Ne;0;10;0;10
1169;Delfinukas;Kiškučiai;4488260667;Ne;0;1;0;1
1170;Delfinukas;Kiškučiai;9184207705;Ne;0;2;1;3
1171;Delfinukas;Kiškučiai;2163238846;Ne;7;0;0;7
1172;Delfinukas;Kiškučiai;9747075687;Ne;0;3;0;3
1173;Delfinukas;Kiškučiai;4327924499;Ne;10;0;2;12
1174;Delfinukas;Kiškučiai;7312438969;Taip;4;0;0;4
1175;Delfinukas;Kiškučiai;6693756145;Ne;5;1;0;6
1176;Delfinukas;Kiškučiai;3205671100;Taip;0;1;0;1
1177;Delfinukas;Kiškučiai;4755699845;Ne;0;2;0;2
1178;Delfinukas;Kiškučiai;5164599763;Taip;10;0;1;11
1179;Delfinukas;Kiškučiai;9586646352;Taip;0;1;0;1
1180;Delfinukas;Kiškučiai;3487670354;Ne;1;0;0;1
1181;Delfinukas;BITUTĖS;9719348837;Ne;6;0;1;7
1182;Delfinukas;BITUTĖS;6601922746;Ne;0;0;3;3
1183;Delfinukas;BITUTĖS;8896957908;Taip;5;0;1;6
1184;Delfinukas;BITUTĖS;3239635507;Ne;0;0;2;2
1185;Delfinukas;BITUTĖS;6929926768;Ne;9;1;0;10
1186;Delfinukas;BITUTĖS;5557399916;Ne;5;0;0;5
1187;Delfinukas;BITUTĖS;5179080544;Taip;0;4;0;4
1188;Delfinukas;BITUTĖS;7727263761;Ne;0;1;0;1
1189;Delfinukas;BITUTĖS;9941631164;Ne;0;4;0;4
1190;Delfinukas;BITUTĖS;4198261848;Taip;3;1;0;4
1191;Delfinukas;BITUTĖS;8081895401;Ne;2;0;0;2
1192;Delfinukas;BITUTĖS;5600320855;Ne;7;4;0;11
1193;Delfinukas;BITUTĖS;2377204734;Ne;0;3;0;3
1194;Delfinukas;BITUTĖS;6243471374;Ne;0;4;0;4
1195;Delfinukas;BITUTĖS;4303234827;Ne;5;4;0;9
1196;Drevinukas;ZUIKUČIAI;5500759834;Ne;0;0;2;2
1197;Drevinukas;ZUIKUČIAI;9817317105;Ne;5;0;0;5
1198;Drevinukas;ZUIKUČIAI;1595081335;Ne;0;6;5;11
1199;Drevinukas;ZUIKUČIAI;2646799484;Ne;3;1;1;5
1200;Drevinukas;ZUIKUČIAI;2772424629;Ne;5;1;3;9
1201;Drevinukas;ZUIKUČIAI;1567790084;Ne;4;0;0;4
1202;Drevinukas;ZUIKUČIAI;3293457412;Ne;3;0;0;3
1203;Drevinukas;ZUIKUČIAI;6243097297;Ne;5;1;4;10
1204;Drevinukas;ZUIKUČIAI;5704489483;Ne;0;3;0;3
1205;Drevinukas;ZUIKUČIAI;7054681115;Ne;12;0;0;12
1206;Drevinukas;ZUIKUČIAI;3381363132;Ne;13;1;0;14
1207;Drevinukas;ZUIKUČIAI;9174977150;Ne;10;0;0;10
1208;Drevinukas;ZUIKUČIAI;4243045398;Ne;20;0;0;20
1209;Drevinukas;ZUIKUČIAI;4309475233;Ne;20;0;0;20
1210;Drevinukas;ZUIKUČIAI;6393960467;Ne;1;1;0;2
1211;Drevinukas;ZUIKUČIAI;5578749226;Ne;0;1;2;3
1212;Drevinukas;AŽUOLIUKŲ;1644656704;Ne;2;1;0;3
1213;Drevinukas;AŽUOLIUKŲ;5721031754;Ne;0;0;1;1
1214;Drevinukas;AŽUOLIUKŲ;4714478955;Ne;0;2;2;4
1215;Drevinukas;AŽUOLIUKŲ;8701250912;Ne;10;0;0;10
1216;Drevinukas;AŽUOLIUKŲ;8143614891;Ne;3;4;0;7
1217;Drevinukas;AŽUOLIUKŲ;5673244101;Ne;6;0;1;7
1218;Drevinukas;AŽUOLIUKŲ;3643007998;Ne;9;0;0;9
1219;Drevinukas;AŽUOLIUKŲ;4262951360;Ne;5;0;1;6
1220;Drevinukas;AŽUOLIUKŲ;4572837478;Ne;7;1;0;8
1221;Drevinukas;AŽUOLIUKŲ;1564065835;Ne;0;0;4;4
1222;Drevinukas;AŽUOLIUKŲ;9289471118;Ne;0;0;2;2
1223;Drevinukas;AŽUOLIUKŲ;9915130747;Ne;5;3;0;8
1224;Drevinukas;AŽUOLIUKŲ;6891793135;Ne;4;0;0;4
1225;Drevinukas;AŽUOLIUKŲ;1058927778;Ne;0;1;0;1
1226;Drevinukas;AŽUOLIUKŲ;9534007163;Ne;4;0;0;4
1227;Drevinukas;AŽUOLIUKŲ;2300338724;Ne;3;0;0;3
1228;Drevinukas;AŽUOLIUKŲ;6165662595;Ne;6;0;2;8
1229;Drevinukas;AŽUOLIUKŲ;2740093399;Ne;2;4;0;6
1230;Drevinukas;PELĖDŽIUKAI;3032536983;Ne;6;0;0;6
1231;Drevinukas;PELĖDŽIUKAI;3392249574;Ne;0;0;2;2
1232;Drevinukas;PELĖDŽIUKAI;5524567803;Ne;2;0;1;3
1233;Drevinukas;PELĖDŽIUKAI;4076576850;Ne;3;0;1;4
1234;Drevinukas;PELĖDŽIUKAI;6316000019;Taip;0;0;1;1
1235;Drevinukas;PELĖDŽIUKAI;4404254932;Ne;0;0;1;1
1236;Drevinukas;PELĖDŽIUKAI;2378493422;Ne;9;0;0;9
1237;Drevinukas;PELĖDŽIUKAI;1859208322;Ne;15;0;0;15
1238;Drevinukas;PELĖDŽIUKAI;2281463885;Ne;2;0;0;2
1239;Drevinukas;PELĖDŽIUKAI;5875459639;Ne;0;1;0;1
1240;Drevinukas;PELĖDŽIUKAI;7218201733;Ne;1;0;0;1
1241;Drevinukas;BORUŽĖLĖS;4242944055;Ne;3;0;0;3
1242;Drevinukas;BORUŽĖLĖS;6492987985;Ne;7;0;0;7
1243;Drevinukas;BORUŽĖLĖS;6645506336;Ne;3;4;0;7
1244;Drevinukas;BORUŽĖLĖS;9845207619;Ne;8;0;1;9
1245;Drevinukas;BORUŽĖLĖS;9517560132;Ne;6;0;0;6
1246;Drevinukas;BORUŽĖLĖS;6895472558;Ne;14;0;0;14
1247;Drevinukas;BORUŽĖLĖS;2039086829;Ne;1;0;0;1
1248;Drevinukas;BORUŽĖLĖS;4147987057;Ne;0;5;0;5
1249;Drevinukas;BORUŽĖLĖS;8694887879;Taip;6;1;0;7
1250;Drevinukas;BORUŽĖLĖS;3192583690;Ne;3;1;0;4
1251;Drevinukas;BORUŽĖLĖS;6659263391;Ne;3;1;0;4
1252;Drevinukas;BORUŽĖLĖS;5999370094;Ne;1;0;0;1
1253;Drevinukas;BORUŽĖLĖS;4588368596;Ne;8;0;0;8
1254;Drevinukas;BORUŽĖLĖS;2571295179;Taip;1;0;0;1
1255;Drevinukas;BORUŽĖLĖS;2820241608;Ne;0;2;0;2
1256;Drevinukas;BORUŽĖLĖS;8940838262;Ne;2;1;0;3
1257;Drevinukas;BORUŽĖLĖS;3240313747;Ne;8;0;0;8
1258;Drevinukas;BORUŽĖLĖS;2179736991;Ne;5;0;0;5
1259;Drevinukas;BITUTĖS;1098647410;Ne;2;0;0;2
1260;Drevinukas;BITUTĖS;2312241894;Ne;1;0;0;1
1261;Drevinukas;BITUTĖS;5394143000;Ne;7;0;0;7
1262;Drevinukas;BITUTĖS;3871506691;Ne;1;8;0;9
1263;Drevinukas;BITUTĖS;6914111231;Ne;1;8;0;9
1264;Drevinukas;BITUTĖS;2423143170;Ne;2;0;0;2
1265;Drevinukas;BITUTĖS;1343431478;Ne;3;0;0;3
1266;Drevinukas;BITUTĖS;4203106313;Ne;2;0;0;2
1267;Drevinukas;BITUTĖS;9513405583;Ne;1;0;0;1
1268;Drevinukas;BITUTĖS;3046196006;Taip;1;0;0;1
1269;Drevinukas;BITUTĖS;3617533357;Ne;20;0;0;20
1270;Drevinukas;NYKŠTUKAI;9105675010;Ne;8;0;0;8
1271;Drevinukas;NYKŠTUKAI;3611870655;Ne;3;0;0;3
1272;Drevinukas;NYKŠTUKAI;1094428951;Ne;7;1;0;8
1273;Drevinukas;NYKŠTUKAI;9283862598;Ne;15;0;0;15
1274;Drevinukas;NYKŠTUKAI;4759293403;Ne;9;0;0;9
1275;Drevinukas;NYKŠTUKAI;9715586195;Ne;9;0;0;9
1276;Drevinukas;NYKŠTUKAI;1368495173;Ne;1;8;0;9
1277;Drevinukas;NYKŠTUKAI;8284025903;Ne;4;0;0;4
1278;Drevinukas;NYKŠTUKAI;8654858364;Ne;11;0;1;12
1279;Drevinukas;NYKŠTUKAI;5445104383;Ne;3;0;0;3
1280;Drevinukas;NYKŠTUKAI;2662147175;Ne;5;5;0;10
1281;Drevinukas;NYKŠTUKAI;7801920518;Ne;11;0;2;13
1282;Drevinukas;NYKŠTUKAI;1570356979;Ne;5;0;0;5
1283;Drevinukas;NYKŠTUKAI;9123131368;Taip;0;0;2;2
1284;Drevinukas;NYKŠTUKAI;8877080179;Ne;5;0;0;5
1285;Drevinukas;NYKŠTUKAI;6492711565;Taip;0;0;1;1
1286;Drevinukas;NYKŠTUKAI;7316996793;Ne;0;4;0;4
1287;Drevinukas;NYKŠTUKAI;3408981880;Ne;0;1;0;1
1288;Drevinukas;NYKŠTUKAI;8953871512;Ne;17;0;0;17
1289;Drevinukas;NYKŠTUKAI;3983656958;Ne;12;1;0;13
1290;Drevinukas;SMALSUČIAI;7241671439;Ne;5;2;0;7
1291;Drevinukas;SMALSUČIAI;4089351543;Taip;5;0;0;5
1292;Drevinukas;SMALSUČIAI;7863529560;Ne;9;0;0;9
1293;Drevinukas;SMALSUČIAI;8107900397;Ne;4;0;0;4
1294;Drevinukas;SMALSUČIAI;5666172450;Ne;5;0;0;5
1295;Drevinukas;SMALSUČIAI;8704592094;Ne;10;0;0;10
1296;Drevinukas;SMALSUČIAI;1478224813;Ne;0;0;4;4
1297;Drevinukas;SMALSUČIAI;9707576704;Ne;9;0;0;9
1298;Drevinukas;SMALSUČIAI;2971775004;Ne;1;0;0;1
1299;Drevinukas;SMALSUČIAI;7466516412;Ne;5;0;0;5
1300;Drevinukas;SMALSUČIAI;2888797405;Ne;4;0;0;4
1301;Drevinukas;SMALSUČIAI;5614413092;Ne;3;0;0;3
1302;Drevinukas;SMALSUČIAI;4372760590;Ne;5;0;0;5
1303;Drevinukas;SMALSUČIAI;1934875187;Ne;3;0;0;3
1304;Drevinukas;ŽVIRBLIUKAI;5702650036;Ne;4;0;1;5
1305;Drevinukas;ŽVIRBLIUKAI;5928679046;Ne;0;0;3;3
1306;Drevinukas;ŽVIRBLIUKAI;5785185025;Ne;11;0;2;13
1307;Drevinukas;ŽVIRBLIUKAI;8482376948;Ne;5;0;1;6
1308;Drevinukas;ŽVIRBLIUKAI;5640493477;Ne;8;0;0;8
1309;Drevinukas;ŽVIRBLIUKAI;7970286765;Ne;0;0;1;1
1310;Drevinukas;ŽVIRBLIUKAI;3598394850;Ne;11;0;1;12
1311;Drevinukas;ŽVIRBLIUKAI;2968317659;Taip;5;0;0;5
1312;Drevinukas;ŽVIRBLIUKAI;6858049220;Ne;0;0;1;1
1313;Drevinukas;ŽVIRBLIUKAI;7639360777;Ne;9;0;0;9
1314;Drevinukas;ŽVIRBLIUKAI;5536448847;Ne;9;5;1;15
1315;Drevinukas;ŽVIRBLIUKAI;1471647820;Taip;0;2;2;4
1316;Drevinukas;ŽVIRBLIUKAI;7600838895;Ne;5;0;2;7
1317;Drevinukas;ŽVIRBLIUKAI;3049662927;Ne;0;0;2;2
1318;Drevinukas;ŽVIRBLIUKAI;4371848878;Ne;3;0;3;6
1319;Drugelis;NYKŠTUKŲ;9316073597;Ne;0;2;0;2
1320;Drugelis;NYKŠTUKŲ;3551095669;Ne;0;1;0;1
1321;Drugelis;NYKŠTUKŲ;1785724340;Ne;0;11;0;11
1322;Drugelis;NYKŠTUKŲ;7447519502;Ne;0;1;0;1
1323;Drugelis;NYKŠTUKŲ;8717445483;Ne;2;2;0;4
1324;Drugelis;NYKŠTUKŲ;4867387611;Ne;5;4;0;9
1325;Drugelis;NYKŠTUKŲ;5692743298;Ne;5;1;0;6
1326;Drugelis;NYKŠTUKŲ;6452921695;Taip;6;2;0;8
1327;Drugelis;NYKŠTUKŲ;8591548746;Taip;5;0;0;5
1328;Drugelis;NYKŠTUKŲ;5515894973;Ne;0;1;0;1
1329;Drugelis;SMALSUČIŲ;5121351234;Ne;16;0;0;16
1330;Drugelis;SMALSUČIŲ;6626437352;Taip;0;1;0;1
1331;Drugelis;SMALSUČIŲ;5000965458;Ne;11;6;0;17
1332;Drugelis;SMALSUČIŲ;9683350741;Ne;0;7;0;7
1333;Drugelis;SMALSUČIŲ;1617833459;Ne;0;5;0;5
1334;Drugelis;SMALSUČIŲ;4805858183;Ne;5;0;0;5
1335;Drugelis;SMALSUČIŲ;9650052415;Ne;0;0;2;2
1336;Drugelis;SMALSUČIŲ;5533529267;Ne;0;2;0;2
1337;Drugelis;SMALSUČIŲ;9066572677;Ne;4;5;0;9
1338;Drugelis;SMALSUČIŲ;2196445523;Ne;1;0;0;1
1339;Drugelis;SMALSUČIŲ;8186338261;Ne;2;0;1;3
1340;Drugelis;SMALSUČIŲ;2644563881;Ne;7;2;1;10
1341;Drugelis;SMALSUČIŲ;6613520046;Ne;13;0;0;13
1342;Drugelis;SMALSUČIŲ;6890441262;Ne;0;3;0;3
1343;Drugelis;SMALSUČIŲ;3509593041;Ne;0;1;0;1
1344;Drugelis;SMALSUČIŲ;1417298801;Ne;2;0;0;2
1345;Drugelis;SMALSUČIŲ;1074913909;Ne;4;0;0;4
1346;Drugelis;MUMINUKŲ;7390061272;Ne;0;0;1;1
1347;Drugelis;MUMINUKŲ;3311620018;Ne;0;1;0;1
1348;Drugelis;MUMINUKŲ;8812550811;Ne;0;1;0;1
1349;Drugelis;MUMINUKŲ;5661335344;Ne;0;1;0;1
1350;Drugelis;MUMINUKŲ;1666992752;Ne;6;5;0;11
1351;Drugelis;MUMINUKŲ;9510744779;Ne;0;4;0;4
1352;Drugelis;MUMINUKŲ;9029137302;Ne;4;0;0;4
1353;Drugelis;MUMINUKŲ;9907121223;Ne;0;4;0;4
1354;Drugelis;MUMINUKŲ;1858504360;Ne;4;1;0;5
1355;Drugelis;MUMINUKŲ;8366330478;Ne;0;2;1;3
1356;Drugelis;MUMINUKŲ;8107970910;Ne;10;1;0;11
1357;Drugelis;MUMINUKŲ;8282807535;Ne;9;0;1;10
1358;Drugelis;MUMINUKŲ;3293212749;Taip;2;0;0;2
1359;Drugelis;MUMINUKŲ;9588931333;Ne;2;2;0;4
1360;Drugelis;MUMINUKŲ;3176174057;Taip;0;2;0;2
1361;Drugelis;MUMINUKŲ;1761596625;Ne;7;4;0;11
1362;Drugelis;MUMINUKŲ;6390802189;Taip;5;0;0;5
1363;Drugelis;PŪKUOTUKAI;3560294703;Ne;0;0;2;2
1364;Drugelis;PŪKUOTUKAI;9005448398;Ne;7;0;0;7
1365;Drugelis;PŪKUOTUKAI;2926662708;Taip;1;0;0;1
1366;Drugelis;PŪKUOTUKAI;6504082488;Ne;0;7;0;7
1367;Drugelis;PŪKUOTUKAI;7321544601;Ne;0;1;0;1
1368;Drugelis;PŪKUOTUKAI;9296067137;Ne;5;5;0;10
1369;Drugelis;PŪKUOTUKAI;9855121078;Ne;5;3;0;8
1370;Drugelis;PŪKUOTUKAI;6068102133;Ne;0;3;0;3
1371;Drugelis;PŪKUOTUKAI;3081918342;Ne;5;5;0;10
1372;Drugelis;PŪKUOTUKAI;6032568621;Ne;0;2;0;2
1373;Drugelis;PŪKUOTUKAI;4580456500;Ne;12;0;0;12
1374;Drugelis;PŪKUOTUKAI;8259051898;Ne;2;2;0;4
1375;Drugelis;PŪKUOTUKAI;3567930528;Ne;0;1;0;1
1376;Drugelis;PŪKUOTUKAI;1808917187;Ne;5;0;0;5
1377;Drugelis;PŪKUOTUKAI;5995208093;Ne;7;1;1;9
1378;Drugelis;PŪKUOTUKAI;6965297550;Ne;0;1;0;1
1379;Drugelis;PŪKUOTUKAI;3800496237;Ne;9;0;0;9
1380;Drugelis;PŪKUOTUKAI;5557284298;Taip;11;0;0;11
1381;Drugelis;PŪKUOTUKAI;8438128438;Ne;0;1;0;1
1382;Drugelis;SPINDULIUKAI;7775085427;Ne;1;6;1;8
1383;Drugelis;SPINDULIUKAI;5129433046;Taip;0;0;4;4
1384;Drugelis;SPINDULIUKAI;2456724368;Ne;8;0;1;9
1385;Drugelis;SPINDULIUKAI;5538435916;Ne;7;0;0;7
1386;Drugelis;SPINDULIUKAI;3473680112;Ne;4;0;0;4
1387;Drugelis;SPINDULIUKAI;2105023760;Ne;9;0;0;9
1388;Drugelis;SPINDULIUKAI;9226673535;Ne;4;0;3;7
1389;Drugelis;SPINDULIUKAI;5082783072;Ne;2;0;0;2
1390;Drugelis;SPINDULIUKAI;5773336517;Ne;5;0;0;5
1391;Drugelis;SPINDULIUKAI;7160648094;Taip;11;0;0;11
1392;Drugelis;SPINDULIUKAI;5276647563;Ne;1;0;0;1
1393;Drugelis;SPINDULIUKAI;3883341684;Ne;0;0;19;19
1394;Drugelis;SPINDULIUKAI;5970909950;Ne;18;1;0;19
1395;Drugelis;SPINDULIUKAI;9908380623;Taip;5;0;0;5
1396;Drugelis;SPINDULIUKAI;4347439776;Ne;7;0;5;12
1397;Drugelis;SPINDULIUKAI;4061717129;Ne;2;0;1;3
1398;Drugelis;KIŠKUČIAI;3603051567;Ne;7;0;0;7
1399;Drugelis;KIŠKUČIAI;4628926113;Ne;10;1;0;11
1400;Drugelis;KIŠKUČIAI;7307032077;Ne;0;0;1;1
1401;Drugelis;KIŠKUČIAI;4871624566;Ne;4;0;0;4
1402;Drugelis;KIŠKUČIAI;1213610973;Taip;10;2;0;12
1403;Drugelis;KIŠKUČIAI;9211760307;Ne;0;0;5;5
1404;Drugelis;KIŠKUČIAI;6071997970;Ne;3;3;0;6
1405;Drugelis;KIŠKUČIAI;8819853863;Ne;4;0;0;4
1406;Drugelis;KIŠKUČIAI;5950704328;Ne;0;0;2;2
1407;Drugelis;KIŠKUČIAI;9900296726;Ne;10;0;0;10
1408;Drugelis;KIŠKUČIAI;4898099506;Ne;0;0;1;1
1409;Drugelis;KIŠKUČIAI;6997707085;Ne;5;0;0;5
1410;Drugelis;KIŠKUČIAI;1375535260;Ne;5;0;0;5
1411;Drugelis;KIŠKUČIAI;5857726963;Ne;11;0;4;15
1412;Drugelis;KIŠKUČIAI;1817932444;Ne;10;0;2;12
1413;Drugelis;KIŠKUČIAI;2729246397;Ne;11;0;0;11
1414;"Du gaideliai";Uodelių;5189121339;Ne;3;1;0;4
1415;"Du gaideliai";Uodelių;8624394105;Ne;5;5;0;10
1416;"Du gaideliai";Uodelių;9506572113;Taip;10;2;0;12
1417;"Du gaideliai";Uodelių;6224116229;Ne;10;0;0;10
1418;"Du gaideliai";Uodelių;5514521078;Ne;0;3;0;3
1419;"Du gaideliai";Uodelių;6630053388;Ne;11;0;0;11
1420;"Du gaideliai";Uodelių;3654057453;Taip;4;3;0;7
1421;"Du gaideliai";Uodelių;8921985681;Ne;3;9;0;12
1422;"Du gaideliai";Uodelių;5225949099;Ne;3;1;0;4
1423;"Du gaideliai";Uodelių;2122841302;Taip;10;1;0;11
1424;"Du gaideliai";Uodelių;3206388799;Taip;5;0;4;9
1425;"Du gaideliai";Uodelių;2084660815;Ne;5;6;0;11
1426;"Du gaideliai";Uodelių;4799107717;Ne;5;2;0;7
1427;"Du gaideliai";Uodelių;1940981083;Taip;20;0;0;20
1428;"Du gaideliai";Uodelių;5113352673;Ne;5;0;1;6
1429;"Du gaideliai";Uodelių;6054058539;Taip;4;4;0;8
1430;"Du gaideliai";Uodelių;9832883242;Ne;5;0;0;5
1431;"Du gaideliai";Uodelių;5016914497;Ne;9;0;2;11
1432;"Du gaideliai";Uodelių;4759244471;Ne;5;0;0;5
1433;"Du gaideliai";OŽIUKŲ;6942798420;Ne;0;2;0;2
1434;"Du gaideliai";OŽIUKŲ;8174023197;Ne;6;0;0;6
1435;"Du gaideliai";OŽIUKŲ;8420400705;Ne;0;9;0;9
1436;"Du gaideliai";OŽIUKŲ;7372149799;Ne;0;2;0;2
1437;"Du gaideliai";OŽIUKŲ;2826490663;Ne;0;0;1;1
1438;"Du gaideliai";OŽIUKŲ;4157021754;Ne;0;1;0;1
1439;"Du gaideliai";OŽIUKŲ;1968978650;Ne;0;1;0;1
1440;"Du gaideliai";OŽIUKŲ;5291934919;Ne;15;0;0;15
1441;"Du gaideliai";OŽIUKŲ;2564259600;Ne;0;0;2;2
1442;"Du gaideliai";OŽIUKŲ;6132405512;Ne;0;11;0;11
1443;"Du gaideliai";OŽIUKŲ;7563789811;Ne;0;1;0;1
1444;"Du gaideliai";OŽIUKŲ;6704167983;Ne;2;1;1;4
1445;"Du gaideliai";OŽIUKŲ;5726096980;Ne;0;3;0;3
1446;"Du gaideliai";OŽIUKŲ;4408537397;Ne;5;2;0;7
1447;"Du gaideliai";OŽIUKŲ;1527839162;Ne;0;1;2;3
1448;"Du gaideliai";OŽIUKŲ;8896316882;Ne;0;0;1;1
1449;"Du gaideliai";OŽIUKŲ;5809089345;Ne;4;1;0;5
1450;"Du gaideliai";OŽIUKŲ;1882241729;Taip;5;0;1;6
1451;"Du gaideliai";OŽIUKŲ;9934568135;Ne;11;6;0;17
1452;"Du gaideliai";Vištyčių;2100449108;Ne;0;0;1;1
1453;"Du gaideliai";Vištyčių;7033276798;Ne;0;0;1;1
1454;"Du gaideliai";Vištyčių;8744467866;Ne;1;0;0;1
1455;"Du gaideliai";Vištyčių;3019797369;Ne;5;0;0;5
1456;"Du gaideliai";Vištyčių;6204233540;Ne;1;0;0;1
1457;"Du gaideliai";Vištyčių;2845145754;Ne;0;5;0;5
1458;"Du gaideliai";Vištyčių;7726490359;Ne;0;0;1;1
1459;"Du gaideliai";Vištyčių;5788923258;Ne;0;12;0;12
1460;"Du gaideliai";Vištyčių;5728374219;Ne;5;0;0;5
1461;"Du gaideliai";Vištyčių;5611102395;Ne;0;12;0;12
1462;"Du gaideliai";Vištyčių;8410547195;Ne;0;6;0;6
1463;"Du gaideliai";Vištyčių;6120647567;Ne;0;10;0;10
1464;"Du gaideliai";Vištyčių;2905083899;Taip;7;0;0;7
1465;"Du gaideliai";Vištyčių;9585785202;Taip;15;0;0;15
1466;"Du gaideliai";Vištyčių;8043896286;Ne;18;0;0;18
1467;"Du gaideliai";GAIDŽIUKŲ;2635903222;Ne;19;0;0;19
1468;"Du gaideliai";GAIDŽIUKŲ;7537924142;Ne;16;0;0;16
1469;"Du gaideliai";GAIDŽIUKŲ;2240947701;Ne;5;0;0;5
1470;"Du gaideliai";GAIDŽIUKŲ;3507387826;Ne;0;2;1;3
1471;"Du gaideliai";GAIDŽIUKŲ;1785976627;Ne;5;0;0;5
1472;"Du gaideliai";GAIDŽIUKŲ;8047413507;Ne;8;1;0;9
1473;"Du gaideliai";GAIDŽIUKŲ;9568647033;Ne;3;1;0;4
1474;"Du gaideliai";GAIDŽIUKŲ;5894974508;Ne;0;0;1;1
1475;"Du gaideliai";GAIDŽIUKŲ;6247706405;Ne;10;1;0;11
1476;"Du gaideliai";GAIDŽIUKŲ;3370029981;Ne;0;1;0;1
1477;"Du gaideliai";GAIDŽIUKŲ;1751328192;Ne;3;2;0;5
1478;"Du gaideliai";GAIDŽIUKŲ;5652662610;Ne;3;1;0;4
1479;"Du gaideliai";GAIDŽIUKŲ;6870356241;Ne;5;1;0;6
1480;"Du gaideliai";GAIDŽIUKŲ;3854355215;Ne;0;0;7;7
1481;"Du gaideliai";GAIDŽIUKŲ;3849899284;Ne;4;0;0;4
1482;"Du gaideliai";Musyčių;8819197022;Ne;3;1;0;4
1483;"Du gaideliai";Musyčių;6826558709;Ne;17;0;0;17
1484;"Du gaideliai";Musyčių;3058039700;Ne;3;0;2;5
1485;"Du gaideliai";Musyčių;7556954721;Ne;5;0;0;5
1486;"Du gaideliai";Musyčių;3519099395;Ne;0;1;0;1
1487;"Du gaideliai";Musyčių;9561040908;Ne;5;0;0;5
1488;"Du gaideliai";Musyčių;7855653537;Ne;5;2;0;7
1489;"Du gaideliai";Musyčių;9619723983;Ne;0;1;0;1
1490;"Du gaideliai";Musyčių;2266999698;Ne;0;1;0;1
1491;"Du gaideliai";Musyčių;1048130675;Taip;0;13;0;13
1492;"Du gaideliai";MALŪNO;3457511180;Ne;0;15;0;15
1493;"Du gaideliai";MALŪNO;1706627632;Ne;8;4;0;12
1494;"Du gaideliai";MALŪNO;4995471264;Ne;5;0;0;5
1495;"Du gaideliai";MALŪNO;2135080469;Ne;8;0;0;8
1496;"Du gaideliai";MALŪNO;9289309829;Ne;9;0;0;9
1497;"Du gaideliai";MALŪNO;1025181286;Ne;10;0;0;10
1498;"Du gaideliai";MALŪNO;8427621976;Ne;5;0;1;6
1499;"Du gaideliai";MALŪNO;5028947424;Ne;5;0;5;10
1500;"Du gaideliai";MALŪNO;2613120460;Ne;4;0;1;5
1501;"Du gaideliai";MALŪNO;3469559577;Ne;6;0;0;6
1502;"Du gaideliai";MALŪNO;5625164689;Ne;0;0;1;1
1503;"Du gaideliai";MALŪNO;8197231934;Ne;6;0;0;6
1504;"Du gaideliai";MALŪNO;2261152926;Ne;7;5;0;12
1505;"Du gaideliai";MALŪNO;4792733524;Ne;5;0;0;5
1506;Eglutė;RAMUNĖ;7984911632;Ne;5;0;0;5
1507;Eglutė;RAMUNĖ;4252256130;Ne;3;0;0;3
1508;Eglutė;RAMUNĖ;5636437290;Ne;3;1;0;4
1509;Eglutė;RAMUNĖ;3985929379;Ne;0;5;0;5
1510;Eglutė;RAMUNĖ;1842517164;Ne;3;0;1;4
1511;Eglutė;RAMUNĖ;7530638623;Ne;0;6;0;6
1512;Eglutė;RAMUNĖ;2121177107;Taip;0;0;2;2
1513;Eglutė;RAMUNĖ;2357276888;Ne;0;0;2;2
1514;Eglutė;RAMUNĖ;7098548563;Ne;0;1;0;1
1515;Eglutė;RAMUNĖ;6146679388;Ne;0;12;0;12
1516;Eglutė;RAMUNĖ;5166183300;Ne;0;10;0;10
1517;Eglutė;PELĖDŽIUKAI;3883122650;Ne;5;0;0;5
1518;Eglutė;PELĖDŽIUKAI;7859815752;Ne;0;1;0;1
1519;Eglutė;PELĖDŽIUKAI;4176597208;Ne;0;2;1;3
1520;Eglutė;PELĖDŽIUKAI;7758643349;Ne;0;7;4;11
1521;Eglutė;PELĖDŽIUKAI;6483580751;Ne;0;1;0;1
1522;Eglutė;PELĖDŽIUKAI;4490295754;Ne;5;2;1;8
1523;Eglutė;PELĖDŽIUKAI;5924994736;Ne;2;0;0;2
1524;Eglutė;PELĖDŽIUKAI;1759383841;Ne;0;2;1;3
1525;Eglutė;PELĖDŽIUKAI;6597261061;Ne;0;4;0;4
1526;Eglutė;PELĖDŽIUKAI;9046652370;Ne;4;0;2;6
1527;Eglutė;PELĖDŽIUKAI;9356785605;Ne;0;1;0;1
1528;Eglutė;PELĖDŽIUKAI;8943684351;Ne;5;0;0;5
1529;Eglutė;PELĖDŽIUKAI;1932785408;Ne;0;8;1;9
1530;Eglutė;PELĖDŽIUKAI;8165126017;Ne;2;0;0;2
1531;Eglutė;PELĖDŽIUKAI;9967488317;Ne;7;0;0;7
1532;Eglutė;PELĖDŽIUKAI;3584247594;Ne;4;2;0;6
1533;Eglutė;PELĖDŽIUKAI;5678727198;Ne;5;0;0;5
1534;Eglutė;PELĖDŽIUKAI;4027143502;Ne;0;2;1;3
1535;Eglutė;PELĖDŽIUKAI;2611896463;Ne;5;1;0;6
1536;Eglutė;KODĖLČIUKAI;7831541089;Ne;5;0;2;7
1537;Eglutė;KODĖLČIUKAI;7735192219;Ne;0;1;0;1
1538;Eglutė;KODĖLČIUKAI;3430016771;Ne;0;9;0;9
1539;Eglutė;KODĖLČIUKAI;6382927775;Ne;5;2;0;7
1540;Eglutė;KODĖLČIUKAI;7919553451;Ne;0;3;0;3
1541;Eglutė;KODĖLČIUKAI;7229612001;Ne;2;0;0;2
1542;Eglutė;KODĖLČIUKAI;5783776734;Ne;0;1;0;1
1543;Eglutė;KODĖLČIUKAI;4932945207;Ne;20;0;0;20
1544;Eglutė;KODĖLČIUKAI;5407757245;Ne;5;0;0;5
1545;Eglutė;KODĖLČIUKAI;3237476593;Ne;5;0;0;5
1546;Eglutė;KODĖLČIUKAI;9542103745;Ne;1;1;0;2
1547;Eglutė;KODĖLČIUKAI;3848175048;Ne;0;1;0;1
1548;Eglutė;KODĖLČIUKAI;5947727288;Ne;5;0;0;5
1549;Eglutė;KODĖLČIUKAI;6653111225;Ne;3;5;0;8
1550;Eglutė;KODĖLČIUKAI;1122907387;Ne;13;0;0;13
1551;Eglutė;KODĖLČIUKAI;9686836846;Ne;0;2;0;2
1552;Eglutė;KODĖLČIUKAI;3650609128;Taip;4;0;0;4
1553;Eglutė;KODĖLČIUKAI;8847930854;Ne;6;0;0;6
1554;Eglutė;OBUOLIUKAI;5704418881;Ne;0;1;0;1
1555;Eglutė;OBUOLIUKAI;3488060437;Ne;0;2;0;2
1556;Eglutė;OBUOLIUKAI;8698242107;Ne;3;1;0;4
1557;Eglutė;OBUOLIUKAI;1630732306;Ne;4;0;0;4
1558;Eglutė;OBUOLIUKAI;9381529574;Ne;0;2;0;2
1559;Eglutė;OBUOLIUKAI;8749425471;Taip;10;2;0;12
1560;Eglutė;OBUOLIUKAI;5103022009;Taip;0;1;0;1
1561;Eglutė;OBUOLIUKAI;1460628870;Taip;4;1;1;6
1562;Eglutė;OBUOLIUKAI;8542684582;Ne;2;0;0;2
1563;Eglutė;OBUOLIUKAI;7313013331;Ne;11;0;2;13
1564;Eglutė;OBUOLIUKAI;3051637136;Ne;5;0;0;5
1565;Eglutė;OBUOLIUKAI;2669400743;Ne;1;1;0;2
1566;Eglutė;OBUOLIUKAI;3011330968;Ne;10;0;0;10
1567;Eglutė;OBUOLIUKAI;4823811890;Ne;0;10;0;10
1568;Eglutė;OBUOLIUKAI;9292940501;Ne;8;1;0;9
1569;Eglutė;KAŠTONAS;3107823269;Ne;3;2;0;5
1570;Eglutė;KAŠTONAS;3799824061;Taip;6;0;0;6
1571;Eglutė;KAŠTONAS;1380219881;Ne;6;0;0;6
1572;Eglutė;KAŠTONAS;3387392137;Taip;0;1;0;1
1573;Eglutė;KAŠTONAS;7027121333;Ne;4;0;0;4
1574;Eglutė;KAŠTONAS;1744942011;Ne;13;1;0;14
1575;Eglutė;KAŠTONAS;8384141923;Ne;8;0;0;8
1576;Eglutė;KAŠTONAS;3112281182;Ne;13;0;0;13
1577;Eglutė;KAŠTONAS;1432716037;Ne;2;0;0;2
1578;Eglutė;KAŠTONAS;4876032787;Ne;3;0;0;3
1579;Eglutė;KAŠTONAS;9542684993;Ne;2;1;0;3
1580;Eglutė;KAŠTONAS;6967074765;Ne;9;0;0;9
1581;Eglutė;KAŠTONAS;6679186715;Ne;5;0;0;5
1582;Eglutė;KAŠTONAS;9054104040;Ne;6;1;0;7
1583;Eglutė;KAŠTONAS;9193920390;Ne;0;4;0;4
1584;Eglutė;KAŠTONAS;8246870069;Ne;0;2;0;2
1585;Eglutė;KAŠTONAS;8721209423;Ne;8;0;0;8
1586;Eglutė;KAŠTONAS;7789753835;Ne;0;8;0;8
1587;Eglutė;KAŠTONAS;1774538642;Ne;1;0;0;1
1588;Eglutė;KAŠTONAS;7114040071;Ne;0;2;0;2
1589;Eglutė;KAŠTONAS;7254436716;Taip;13;0;0;13
1590;Eglutė;KAŠTONAS;2192673126;Ne;3;0;0;3
1591;Eglutė;EŽIUKAI;1422631723;Ne;0;12;0;12
1592;Eglutė;EŽIUKAI;6709551046;Taip;0;5;0;5
1593;Eglutė;EŽIUKAI;6093932811;Ne;0;4;0;4
1594;Eglutė;EŽIUKAI;3473388722;Ne;0;1;0;1
1595;Eglutė;EŽIUKAI;9402686801;Ne;0;3;0;3
1596;Eglutė;EŽIUKAI;2597978713;Ne;11;1;0;12
1597;Eglutė;EŽIUKAI;4451772812;Ne;0;1;0;1
1598;Eglutė;EŽIUKAI;9929681000;Ne;0;0;1;1
1599;Eglutė;EŽIUKAI;6105927493;Ne;0;0;1;1
1600;Eglutė;EŽIUKAI;4560670047;Ne;2;0;0;2
1601;Eglutė;EŽIUKAI;6279703448;Ne;3;2;0;5
1602;Eglutė;EŽIUKAI;6142326330;Ne;3;2;0;5
1603;Eglutė;EŽIUKAI;9728550000;Ne;4;0;0;4
1604;Eglutė;EŽIUKAI;1534556744;Ne;0;7;0;7
1605;Eglutė;EŽIUKAI;7598993411;Ne;8;4;0;12
1606;Eglutė;EŽIUKAI;4047404616;Ne;7;2;0;9
1607;Eglutė;EŽIUKAI;4230594049;Taip;0;2;0;2
1608;Eglutė;EŽIUKAI;8797889347;Taip;0;1;0;1
1609;Eglutė;EŽIUKAI;3006381069;Ne;5;0;0;5
1610;Eglutė;EŽIUKAI;3870885357;Ne;2;0;0;2
1611;Eglutė;GILĖ;1550045866;Ne;0;5;0;5
1612;Eglutė;GILĖ;6272115803;Taip;0;1;0;1
1613;Eglutė;GILĖ;6550999480;Ne;0;1;0;1
1614;Eglutė;GILĖ;5650957826;Ne;3;0;0;3
1615;Eglutė;GILĖ;8129230197;Ne;5;1;0;6
1616;Eglutė;GILĖ;1393626624;Ne;0;1;0;1
1617;Eglutė;GILĖ;2917925763;Ne;0;1;0;1
1618;Eglutė;GILĖ;5013664843;Ne;11;0;0;11
1619;Eglutė;GILĖ;2276311106;Ne;0;5;0;5
1620;Eglutė;GILĖ;5645197324;Ne;0;0;2;2
1621;Eglutė;GILĖ;9098132159;Ne;0;1;0;1
1622;Eglutė;GILĖ;2615824395;Ne;2;1;0;3
1623;Eglutė;GILĖ;3605053253;Ne;8;0;0;8
1624;Eglutė;GILĖ;1531942494;Taip;0;6;0;6
1625;Eglutė;GILĖ;5840014240;Ne;0;0;2;2
1626;Eglutė;GILĖ;9758104910;Ne;20;0;0;20
1627;Eglutė;GILĖ;9515238936;Ne;5;0;0;5
1628;Eglutė;SAULUTĖ;9741776217;Ne;0;7;0;7
1629;Eglutė;SAULUTĖ;5285593057;Ne;0;5;0;5
1630;Eglutė;SAULUTĖ;8739346084;Ne;0;2;0;2
1631;Eglutė;SAULUTĖ;5518570006;Ne;0;3;0;3
1632;Eglutė;SAULUTĖ;5805450838;Ne;0;2;3;5
1633;Eglutė;SAULUTĖ;9084576953;Ne;0;2;2;4
1634;Eglutė;SAULUTĖ;4489150480;Ne;10;4;0;14
1635;Eglutė;SAULUTĖ;2425927050;Ne;6;5;0;11
1636;Eglutė;SAULUTĖ;5918429438;Ne;0;0;2;2
1637;Eglutė;SAULUTĖ;5006042568;Ne;0;1;0;1
1638;Eglutė;SAULUTĖ;5275306818;Ne;0;1;0;1
1639;Eglutė;SAULUTĖ;2621445549;Ne;4;2;0;6
1640;Eglutė;SAULUTĖ;9661883776;Ne;0;3;0;3
1641;Eglutė;SAULUTĖ;8799063905;Ne;0;6;0;6
1642;Eglutė;SAULUTĖ;6572235324;Ne;0;2;3;5
1643;Eglutė;SAULUTĖ;1923176808;Ne;0;2;0;2
1644;Eglutė;SAULUTĖ;2872597971;Ne;0;1;0;1
1645;Eglutė;SAULUTĖ;3690266358;Ne;0;2;1;3
1646;Eglutė;ŠARKELĖ;1667851586;Ne;3;0;0;3
1647;Eglutė;ŠARKELĖ;8410302338;Ne;10;1;0;11
1648;Eglutė;ŠARKELĖ;1715411901;Ne;3;0;0;3
1649;Eglutė;ŠARKELĖ;9875724921;Ne;2;0;0;2
1650;Eglutė;ŠARKELĖ;9178835404;Ne;20;0;0;20
1651;Eglutė;ŠARKELĖ;6773894090;Ne;2;0;0;2
1652;Eglutė;ŠARKELĖ;5146804510;Ne;0;2;1;3
1653;Eglutė;ŠARKELĖ;7231828805;Ne;6;2;0;8
1654;Eglutė;ŠARKELĖ;6805213753;Ne;10;0;0;10
1655;Eglutė;ŠARKELĖ;3368734808;Ne;20;0;0;20
1656;Eglutė;ŠARKELĖ;4465995209;Ne;5;0;0;5
1657;Eglutė;ŠARKELĖ;2666894761;Ne;5;0;0;5
1658;Eglutė;ŠARKELĖ;4697026463;Ne;11;0;0;11
1659;Eglutė;ŠARKELĖ;9795027066;Ne;10;1;0;11
1660;Eglutė;ŠARKELĖ;3974970972;Taip;8;2;0;10
1661;Eglutė;ŠARKELĖ;2950414583;Ne;20;0;0;20
1662;Eglutė;ŠARKELĖ;6171697873;Ne;0;3;0;3
1663;Eglutė;ŠARKELĖ;6631296204;Ne;12;0;1;13
1664;Eglutė;NYKŠTUKAI;3210398495;Ne;5;2;1;8
1665;Eglutė;NYKŠTUKAI;2546506486;Taip;12;0;0;12
1666;Eglutė;NYKŠTUKAI;3319230753;Ne;5;0;0;5
1667;Eglutė;NYKŠTUKAI;6173724448;Ne;3;0;0;3
1668;Eglutė;NYKŠTUKAI;4357784237;Ne;5;0;0;5
1669;Eglutė;NYKŠTUKAI;2073980883;Ne;0;3;0;3
1670;Eglutė;NYKŠTUKAI;2643648862;Ne;5;0;0;5
1671;Eglutė;NYKŠTUKAI;9415802329;Ne;0;2;0;2
1672;Eglutė;NYKŠTUKAI;2824749988;Ne;13;0;0;13
1673;Eglutė;NYKŠTUKAI;4508182019;Ne;2;1;0;3
1674;Eglutė;NYKŠTUKAI;5840899666;Ne;16;1;0;17
1675;Eglutė;NYKŠTUKAI;4759435431;Ne;5;0;0;5
1676;Eglutė;ŽIRNIUKAI;3706904006;Ne;0;0;1;1
1677;Eglutė;ŽIRNIUKAI;6336987111;Ne;0;2;0;2
1678;Eglutė;ŽIRNIUKAI;9538253415;Ne;3;0;0;3
1679;Eglutė;ŽIRNIUKAI;4539511980;Ne;0;5;0;5
1680;Eglutė;ŽIRNIUKAI;6898851909;Ne;0;0;2;2
1681;Eglutė;ŽIRNIUKAI;1645141463;Ne;0;0;2;2
1682;Eglutė;ŽIRNIUKAI;1950577531;Ne;8;0;2;10
1683;Eglutė;ŽIRNIUKAI;8640230418;Taip;8;0;0;8
1684;Eglutė;ŽIRNIUKAI;6469399675;Ne;5;0;0;5
1685;Eglutė;ŽIRNIUKAI;5991097138;Ne;0;0;4;4
1686;Eglutė;ŽIRNIUKAI;1861429195;Ne;5;0;0;5
1687;Eglutė;ŽIRNIUKAI;5328886016;Ne;0;2;0;2
1688;Eglutė;BORUŽIUKAI;7994301287;Ne;10;1;0;11
1689;Eglutė;BORUŽIUKAI;9300315869;Ne;5;0;1;6
1690;Eglutė;BORUŽIUKAI;4476918512;Taip;10;4;0;14
1691;Eglutė;BORUŽIUKAI;8751687849;Ne;8;0;1;9
1692;Eglutė;BORUŽIUKAI;3228447710;Ne;5;0;1;6
1693;Eglutė;BORUŽIUKAI;7288367894;Ne;0;0;1;1
1694;Eglutė;BORUŽIUKAI;1446642492;Ne;5;6;0;11
1695;Eglutė;BORUŽIUKAI;4254216169;Ne;6;0;1;7
1696;Eglutė;BORUŽIUKAI;9894789541;Ne;20;0;0;20
1697;Eglutė;BORUŽIUKAI;1699040995;Ne;4;0;2;6
1698;Eglutė;BORUŽIUKAI;7184265921;Ne;2;0;0;2
1699;Eglutė;BORUŽIUKAI;6966897830;Ne;5;0;0;5
1700;Eglutė;BORUŽIUKAI;9925814376;Ne;8;0;0;8
1701;"Geniukų kalvė";SAULUTĖS;9557055841;Ne;5;0;0;5
1702;"Geniukų kalvė";SAULUTĖS;4329782598;Ne;0;7;0;7
1703;"Geniukų kalvė";SAULUTĖS;8932671578;Ne;9;0;1;10
1704;"Geniukų kalvė";SAULUTĖS;5348211316;Ne;0;1;0;1
1705;"Geniukų kalvė";SAULUTĖS;7886553419;Ne;0;0;1;1
1706;"Geniukų kalvė";SAULUTĖS;9768077014;Ne;5;0;0;5
1707;"Geniukų kalvė";SAULUTĖS;3889643236;Ne;17;0;0;17
1708;"Geniukų kalvė";SAULUTĖS;6016735700;Ne;8;0;1;9
1709;"Geniukų kalvė";SAULUTĖS;5180240547;Ne;2;1;0;3
1710;"Geniukų kalvė";SAULUTĖS;7140298387;Ne;0;0;1;1
1711;"Geniukų kalvė";SAULUTĖS;2525115674;Taip;7;0;0;7
1712;"Geniukų kalvė";SAULUTĖS;1571869318;Ne;0;0;2;2
1713;"Geniukų kalvė";BITUTĖS;5587035951;Ne;1;0;0;1
1714;"Geniukų kalvė";BITUTĖS;9323779212;Ne;3;0;0;3
1715;"Geniukų kalvė";BITUTĖS;4908674542;Ne;4;0;0;4
1716;"Geniukų kalvė";BITUTĖS;2110578252;Ne;7;0;0;7
1717;"Geniukų kalvė";BITUTĖS;8577323715;Ne;1;0;0;1
1718;"Geniukų kalvė";BITUTĖS;7453065865;Ne;4;0;0;4
1719;"Geniukų kalvė";BITUTĖS;3669378459;Ne;9;0;0;9
1720;"Geniukų kalvė";BITUTĖS;4201333532;Ne;9;0;0;9
1721;"Geniukų kalvė";BITUTĖS;5102325807;Ne;10;1;0;11
1722;"Geniukų kalvė";BITUTĖS;1492140432;Ne;10;0;0;10
1723;"Geniukų kalvė";BITUTĖS;1426555835;Taip;1;0;0;1
1724;"Geniukų kalvė";BITUTĖS;4691978116;Taip;6;0;0;6
1725;"Geniukų kalvė";BITUTĖS;6111168227;Ne;4;0;2;6
1726;"Geniukų kalvė";BITUTĖS;7744441981;Taip;7;0;0;7
1727;"Geniukų kalvė";BITUTĖS;1209268848;Taip;0;0;2;2
1728;"Geniukų kalvė";BITUTĖS;6214681079;Ne;0;2;0;2
1729;"Geniukų kalvė";KIŠKUČIAI;5253380852;Ne;8;0;1;9
1730;"Geniukų kalvė";KIŠKUČIAI;2684344984;Taip;7;0;0;7
1731;"Geniukų kalvė";KIŠKUČIAI;5078771341;Ne;5;0;0;5
1732;"Geniukų kalvė";KIŠKUČIAI;4849740486;Ne;2;0;0;2
1733;"Geniukų kalvė";KIŠKUČIAI;9730758999;Ne;4;0;0;4
1734;"Geniukų kalvė";KIŠKUČIAI;9579750299;Ne;0;0;2;2
1735;"Geniukų kalvė";KIŠKUČIAI;9543553237;Ne;3;2;1;6
1736;"Geniukų kalvė";KIŠKUČIAI;2032408983;Ne;3;2;1;6
1737;"Geniukų kalvė";KIŠKUČIAI;9386761753;Ne;9;0;0;9
1738;"Geniukų kalvė";KIŠKUČIAI;4864216994;Ne;9;0;0;9
1739;"Geniukų kalvė";KIŠKUČIAI;1945456486;Ne;0;0;1;1
1740;"Geniukų kalvė";KIŠKUČIAI;3887137828;Ne;2;0;0;2
1741;"Geniukų kalvė";KIŠKUČIAI;2396085192;Ne;0;0;1;1
1742;"Geniukų kalvė";KIŠKUČIAI;8760512032;Ne;15;0;0;15
1743;"Geniukų kalvė";KIŠKUČIAI;4249054993;Ne;0;0;1;1
1744;"Geniukų kalvė";KIŠKUČIAI;1642514752;Ne;0;0;4;4
1745;"Geniukų kalvė";KIŠKUČIAI;9199949456;Ne;15;0;0;15
1746;"Geniukų kalvė";KIŠKUČIAI;9368537477;Taip;2;0;2;4
1747;"Geniukų kalvė";KIŠKUČIAI;6022259388;Ne;5;0;0;5
1748;"Geniukų kalvė";KIŠKUČIAI;5817320560;Ne;7;0;0;7
1749;"Geniukų kalvė";VYTURĖLIAI;4958738745;Ne;1;0;0;1
1750;"Geniukų kalvė";VYTURĖLIAI;9069256760;Ne;7;0;0;7
1751;"Geniukų kalvė";VYTURĖLIAI;2665955524;Ne;3;0;0;3
1752;"Geniukų kalvė";VYTURĖLIAI;5161535756;Ne;4;3;0;7
1753;"Geniukų kalvė";VYTURĖLIAI;3493492581;Ne;0;1;0;1
1754;"Geniukų kalvė";VYTURĖLIAI;3193006249;Ne;2;0;0;2
1755;"Geniukų kalvė";VYTURĖLIAI;6828079735;Ne;3;1;0;4
1756;"Geniukų kalvė";VYTURĖLIAI;8769761434;Ne;13;0;0;13
1757;"Geniukų kalvė";VYTURĖLIAI;1454724752;Ne;8;0;0;8
1758;"Geniukų kalvė";VYTURĖLIAI;1891205998;Taip;1;0;0;1
1759;"Geniukų kalvė";VYTURĖLIAI;3297360222;Ne;9;0;0;9
1760;"Geniukų kalvė";VYTURĖLIAI;6794151223;Ne;2;0;0;2
1761;"Geniukų kalvė";VYTURĖLIAI;4777155321;Ne;5;0;0;5
1762;"Geniukų kalvė";VYTURĖLIAI;1037854104;Taip;5;0;0;5
1763;"Geniukų kalvė";VYTURĖLIAI;9643242164;Ne;0;2;0;2
1764;"Geniukų kalvė";VYTURĖLIAI;5684792148;Ne;10;0;0;10
1765;"Geniukų kalvė";DRUGELIAI;2217221922;Taip;3;0;0;3
1766;"Geniukų kalvė";DRUGELIAI;8271041553;Ne;0;1;0;1
1767;"Geniukų kalvė";DRUGELIAI;1237228692;Ne;0;1;0;1
1768;"Geniukų kalvė";DRUGELIAI;3055777730;Ne;0;1;0;1
1769;"Geniukų kalvė";DRUGELIAI;8770345339;Ne;5;0;0;5
1770;"Geniukų kalvė";DRUGELIAI;6070945557;Taip;0;2;0;2
1771;"Geniukų kalvė";DRUGELIAI;1051563985;Ne;0;2;0;2
1772;"Geniukų kalvė";DRUGELIAI;5146141771;Ne;0;0;1;1
1773;"Geniukų kalvė";DRUGELIAI;6174114461;Ne;15;0;0;15
1774;"Geniukų kalvė";DRUGELIAI;1611845627;Ne;5;0;0;5
1775;"Geniukų kalvė";DRUGELIAI;2659298240;Ne;0;1;0;1
1776;"Geniukų kalvė";DRUGELIAI;9677583445;Taip;5;2;0;7
1777;"Geniukų kalvė";DRUGELIAI;5704223824;Ne;0;2;0;2
1778;"Geniukų kalvė";DRUGELIAI;3166309530;Ne;0;1;0;1
1779;"Geniukų kalvė";"SAULĖS ZUIKUČIAI";7033628178;Ne;1;0;0;1
1780;"Geniukų kalvė";"SAULĖS ZUIKUČIAI";8309953586;Ne;5;0;0;5
1781;"Geniukų kalvė";"SAULĖS ZUIKUČIAI";7500079028;Taip;12;0;0;12
1782;"Geniukų kalvė";"SAULĖS ZUIKUČIAI";8071493871;Ne;2;0;2;4
1783;"Geniukų kalvė";"SAULĖS ZUIKUČIAI";1718428600;Ne;3;8;1;12
1784;"Geniukų kalvė";"SAULĖS ZUIKUČIAI";8914605154;Ne;5;0;0;5
1785;"Geniukų kalvė";"SAULĖS ZUIKUČIAI";6016585056;Ne;3;0;0;3
1786;"Geniukų kalvė";"SAULĖS ZUIKUČIAI";2816691996;Ne;0;1;0;1
1787;"Geniukų kalvė";"SAULĖS ZUIKUČIAI";5512172533;Ne;0;5;0;5
1788;"Geniukų kalvė";"SAULĖS ZUIKUČIAI";1375674317;Ne;6;1;0;7
1789;"Geniukų kalvė";"SAULĖS ZUIKUČIAI";4722801116;Ne;2;0;0;2
1790;"Geniukų kalvė";"SAULĖS ZUIKUČIAI";5763009912;Ne;1;0;0;1
1791;"Geniukų kalvė";"SAULĖS ZUIKUČIAI";5245434552;Ne;0;1;0;1
1792;"Geniukų kalvė";"SAULĖS ZUIKUČIAI";2952604528;Ne;5;0;0;5
1793;"Geniukų kalvė";"SAULĖS ZUIKUČIAI";5725034297;Ne;0;4;0;4
1794;"Geniukų kalvė";"SAULĖS ZUIKUČIAI";1499735818;Ne;5;0;0;5
1795;"Geniukų kalvė";"SAULĖS ZUIKUČIAI";4186376527;Ne;0;1;0;1
1796;"Geniukų kalvė";"SAULĖS ZUIKUČIAI";4975437036;Ne;2;0;0;2
1797;"Geniukų kalvė";"SAULĖS ZUIKUČIAI";1277485419;Ne;9;0;1;10
1798;"Geniukų kalvė";SMALSUČIAI;2499796674;Ne;1;0;0;1
1799;"Geniukų kalvė";SMALSUČIAI;5974481787;Ne;3;0;0;3
1800;"Geniukų kalvė";SMALSUČIAI;7915720190;Ne;3;0;0;3
1801;"Geniukų kalvė";SMALSUČIAI;7384802397;Ne;1;0;0;1
1802;"Geniukų kalvė";SMALSUČIAI;8985466295;Ne;0;2;0;2
1803;"Geniukų kalvė";SMALSUČIAI;5129841490;Ne;8;1;0;9
1804;"Geniukų kalvė";SMALSUČIAI;5705917381;Ne;2;1;0;3
1805;"Geniukų kalvė";SMALSUČIAI;4231659246;Ne;10;0;0;10
1806;"Geniukų kalvė";SMALSUČIAI;2300947427;Ne;3;1;0;4
1807;"Geniukų kalvė";SMALSUČIAI;1028242614;Ne;0;2;0;2
1808;"Geniukų kalvė";SMALSUČIAI;2596680448;Ne;2;1;0;3
1809;"Geniukų kalvė";SMALSUČIAI;4405381922;Ne;6;0;0;6
1810;"Geniukų kalvė";SMALSUČIAI;6473724074;Ne;15;0;0;15
1811;"Geniukų kalvė";SMALSUČIAI;3627418555;Ne;4;3;0;7
1812;"Geniukų kalvė";SMALSUČIAI;9155681194;Taip;10;2;0;12
1813;"Geniukų kalvė";SMALSUČIAI;7440029486;Taip;8;0;0;8
1814;"Geniukų kalvė";SMALSUČIAI;6168422514;Ne;17;0;0;17
1815;"Geniukų kalvė";SMALSUČIAI;6757580298;Ne;7;0;0;7
1816;"Geniukų kalvė";SMALSUČIAI;1573612317;Ne;0;2;0;2
1817;"Geniukų kalvė";SMALSUČIAI;6138451393;Ne;4;1;0;5
1818;"Geniukų kalvė";RUDNOSIUKAI;7079072084;Ne;8;0;0;8
1819;"Geniukų kalvė";RUDNOSIUKAI;6060825704;Ne;6;0;0;6
1820;"Geniukų kalvė";RUDNOSIUKAI;6149037133;Ne;0;4;0;4
1821;"Geniukų kalvė";RUDNOSIUKAI;2426186771;Ne;0;0;1;1
1822;"Geniukų kalvė";RUDNOSIUKAI;5205178173;Ne;2;0;0;2
1823;"Geniukų kalvė";RUDNOSIUKAI;2836282651;Ne;1;0;0;1
1824;"Geniukų kalvė";RUDNOSIUKAI;9847003556;Ne;1;0;0;1
1825;"Geniukų kalvė";RUDNOSIUKAI;5443596677;Ne;4;0;0;4
1826;"Geniukų kalvė";RUDNOSIUKAI;3852896932;Ne;2;0;0;2
1827;"Geniukų kalvė";RUDNOSIUKAI;2165793561;Ne;5;2;0;7
1828;"Geniukų kalvė";RUDNOSIUKAI;8973285553;Ne;3;0;0;3
1829;"Geniukų kalvė";RUDNOSIUKAI;4985606198;Ne;5;0;5;10
1830;"Geniukų kalvė";RUDNOSIUKAI;3631181701;Taip;0;0;2;2
1831;"Geniukų kalvė";RUDNOSIUKAI;2798750158;Ne;0;1;0;1
1832;"Geniukų kalvė";RUDNOSIUKAI;4476754204;Ne;1;0;0;1
1833;"Geniukų kalvė";PELĖDŽIUKAI;1844495906;Ne;3;0;0;3
1834;"Geniukų kalvė";PELĖDŽIUKAI;7234620406;Ne;0;5;0;5
1835;"Geniukų kalvė";PELĖDŽIUKAI;5744371590;Ne;1;0;0;1
1836;"Geniukų kalvė";PELĖDŽIUKAI;5847488152;Taip;12;0;0;12
1837;"Geniukų kalvė";PELĖDŽIUKAI;4890413509;Ne;6;0;0;6
1838;"Geniukų kalvė";PELĖDŽIUKAI;2490231586;Ne;2;0;0;2
1839;"Geniukų kalvė";PELĖDŽIUKAI;3676717541;Ne;0;1;4;5
1840;"Geniukų kalvė";PELĖDŽIUKAI;9319251542;Ne;9;0;0;9
1841;"Geniukų kalvė";PELĖDŽIUKAI;7310171451;Ne;7;3;0;10
1842;"Geniukų kalvė";PELĖDŽIUKAI;5115570519;Taip;0;2;1;3
1843;"Geniukų kalvė";PELĖDŽIUKAI;8277880528;Ne;5;0;0;5
1844;"Geniukų kalvė";PELĖDŽIUKAI;4037514656;Ne;5;0;0;5
1845;"Geniukų kalvė";PELĖDŽIUKAI;2448906549;Ne;5;0;0;5
1846;"Geniukų kalvė";PELĖDŽIUKAI;2884835744;Ne;15;0;0;15
1847;"Geniukų kalvė";PELĖDŽIUKAI;9958205266;Ne;14;0;0;14
1848;"Geniukų kalvė";PELĖDŽIUKAI;3921191150;Ne;4;0;1;5
1849;"Geniukų kalvė";BORUŽĖLĖS;7561521903;Ne;3;0;0;3
1850;"Geniukų kalvė";BORUŽĖLĖS;8217855034;Ne;1;5;0;6
1851;"Geniukų kalvė";BORUŽĖLĖS;1068112116;Ne;5;0;0;5
1852;"Geniukų kalvė";BORUŽĖLĖS;1421857914;Ne;9;1;0;10
1853;"Geniukų kalvė";BORUŽĖLĖS;1558977259;Ne;0;1;0;1
1854;"Geniukų kalvė";BORUŽĖLĖS;7736527608;Ne;2;0;0;2
1855;"Geniukų kalvė";BORUŽĖLĖS;4805806745;Ne;15;0;0;15
1856;"Geniukų kalvė";BORUŽĖLĖS;1383717352;Ne;15;0;0;15
1857;"Geniukų kalvė";BORUŽĖLĖS;3071724778;Ne;0;1;0;1
1858;"Geniukų kalvė";BORUŽĖLĖS;3024701779;Ne;3;0;0;3
1859;"Geniukų kalvė";BORUŽĖLĖS;3015544833;Ne;12;0;0;12
1860;"Geniukų kalvė";BORUŽĖLĖS;9264121921;Ne;3;1;0;4
1861;"Geniukų kalvė";BORUŽĖLĖS;3071147714;Ne;15;0;0;15
1862;"Geniukų kalvė";BORUŽĖLĖS;7776771879;Ne;2;0;0;2
1863;"Geniukų kalvė";BORUŽĖLĖS;9446649021;Ne;5;0;0;5
1864;"Geniukų kalvė";BORUŽĖLĖS;1733621845;Ne;4;5;0;9
1865;"Geniukų kalvė";PAGRANDUKAI;8525540366;Ne;5;0;0;5
1866;"Geniukų kalvė";PAGRANDUKAI;4651934103;Ne;3;0;0;3
1867;"Geniukų kalvė";PAGRANDUKAI;2584997232;Ne;5;0;0;5
1868;"Geniukų kalvė";PAGRANDUKAI;3430336639;Ne;3;0;0;3
1869;"Geniukų kalvė";PAGRANDUKAI;1330046867;Ne;8;0;0;8
1870;"Geniukų kalvė";PAGRANDUKAI;9669738771;Ne;8;6;0;14
1871;"Geniukų kalvė";PAGRANDUKAI;9483545114;Ne;12;0;0;12
1872;"Geniukų kalvė";PAGRANDUKAI;8987495724;Ne;3;0;0;3
1873;"Geniukų kalvė";PAGRANDUKAI;1060081499;Ne;8;0;0;8
1874;"Geniukų kalvė";PAGRANDUKAI;3961089171;Taip;5;0;0;5
1875;"Geniukų kalvė";PAGRANDUKAI;9261284850;Ne;5;0;0;5
1876;"Geniukų kalvė";NYKŠTUKAI;9322790214;Ne;4;2;0;6
1877;"Geniukų kalvė";NYKŠTUKAI;6680434763;Ne;0;2;0;2
1878;"Geniukų kalvė";NYKŠTUKAI;7161460256;Ne;15;1;0;16
1879;"Geniukų kalvė";NYKŠTUKAI;3484288126;Ne;2;0;0;2
1880;"Geniukų kalvė";NYKŠTUKAI;7093135374;Taip;0;0;1;1
1881;"Geniukų kalvė";NYKŠTUKAI;3227799882;Ne;13;0;0;13
1882;"Geniukų kalvė";NYKŠTUKAI;1639585179;Ne;7;0;1;8
1883;"Geniukų kalvė";NYKŠTUKAI;5102755395;Ne;0;0;1;1
1884;"Geniukų kalvė";NYKŠTUKAI;4251353237;Ne;0;0;1;1
1885;"Geniukų kalvė";NYKŠTUKAI;3942415928;Ne;5;1;0;6
1886;"Geniukų kalvė";NYKŠTUKAI;1828348351;Ne;10;0;0;10
1887;"Geniukų kalvė";NYKŠTUKAI;1842445148;Taip;3;0;1;4
1888;"Geniukų kalvė";NYKŠTUKAI;3601085940;Ne;0;5;0;5
1889;Gelvonėlis;ĄŽUOLIUKAI;2329699993;Taip;5;2;0;7
1890;Gelvonėlis;ĄŽUOLIUKAI;9058956012;Ne;3;3;0;6
1891;Gelvonėlis;ĄŽUOLIUKAI;4111774915;Ne;4;1;0;5
1892;Gelvonėlis;ĄŽUOLIUKAI;3677100165;Ne;8;1;0;9
1893;Gelvonėlis;ĄŽUOLIUKAI;7449710008;Ne;0;4;0;4
1894;Gelvonėlis;ĄŽUOLIUKAI;3942630720;Taip;10;4;0;14
1895;Gelvonėlis;ĄŽUOLIUKAI;1453271708;Taip;0;1;0;1
1896;Gelvonėlis;ĄŽUOLIUKAI;9756155028;Ne;5;2;0;7
1897;Gelvonėlis;ĄŽUOLIUKAI;8206816148;Taip;15;0;0;15
1898;Gelvonėlis;ĄŽUOLIUKAI;1274119900;Taip;2;4;0;6
1899;Gelvonėlis;ĄŽUOLIUKAI;5901499708;Ne;4;7;0;11
1900;Gelvonėlis;ĄŽUOLIUKAI;1403890893;Taip;5;0;0;5
1901;Gelvonėlis;ĄŽUOLIUKAI;2519955694;Taip;4;1;0;5
1902;Gelvonėlis;ĄŽUOLIUKAI;6620102515;Ne;8;0;0;8
1903;Gelvonėlis;ĄŽUOLIUKAI;6451006729;Ne;2;0;0;2
1904;Gelvonėlis;ĄŽUOLIUKAI;4190673346;Ne;10;4;0;14
1905;Gelvonėlis;ĄŽUOLIUKAI;2289745479;Taip;12;0;0;12
1906;Gelvonėlis;ĄŽUOLIUKAI;4913415466;Ne;0;0;3;3
1907;Gelvonėlis;ŽVIRBLIUKAI;5024860112;Ne;0;3;0;3
1908;Gelvonėlis;ŽVIRBLIUKAI;7632523330;Ne;5;0;0;5
1909;Gelvonėlis;ŽVIRBLIUKAI;1112841066;Ne;0;15;0;15
1910;Gelvonėlis;ŽVIRBLIUKAI;4156493586;Ne;0;0;1;1
1911;Gelvonėlis;ŽVIRBLIUKAI;2553846157;Ne;0;0;1;1
1912;Gelvonėlis;ŽVIRBLIUKAI;8003522011;Taip;0;1;1;2
1913;Gelvonėlis;ŽVIRBLIUKAI;9900244859;Ne;10;0;2;12
1914;Gelvonėlis;ŽVIRBLIUKAI;4027647695;Ne;0;0;5;5
1915;Gelvonėlis;ŽVIRBLIUKAI;5713586282;Ne;5;0;1;6
1916;Gelvonėlis;ŽVIRBLIUKAI;8560940316;Ne;0;5;0;5
1917;Gelvonėlis;ŽVIRBLIUKAI;5874473596;Taip;0;8;0;8
1918;Gelvonėlis;ŽVIRBLIUKAI;5305480599;Ne;6;0;0;6
1919;Gelvonėlis;ŽVIRBLIUKAI;8124516993;Ne;0;0;2;2
1920;Gelvonėlis;ŽVIRBLIUKAI;9751580494;Ne;0;3;0;3
1921;Gelvonėlis;RASELĖS;5996128423;Ne;12;5;0;17
1922;Gelvonėlis;RASELĖS;6451557430;Ne;0;3;0;3
1923;Gelvonėlis;RASELĖS;1802520150;Ne;2;0;0;2
1924;Gelvonėlis;RASELĖS;3192542909;Ne;5;0;1;6
1925;Gelvonėlis;RASELĖS;9622818893;Ne;0;0;2;2
1926;Gelvonėlis;RASELĖS;2638430817;Ne;2;0;1;3
1927;Gelvonėlis;RASELĖS;6949090250;Taip;1;0;0;1
1928;Gelvonėlis;RASELĖS;1462716950;Ne;0;0;3;3
1929;Gelvonėlis;RASELĖS;9600526942;Ne;5;4;0;9
1930;Gelvonėlis;RASELĖS;9650922918;Ne;0;3;0;3
1931;Gelvonėlis;RASELĖS;1587584701;Ne;0;0;1;1
1932;Gelvonėlis;SAULUTĖ;7392743619;Ne;10;0;0;10
1933;Gelvonėlis;SAULUTĖ;1734685590;Ne;3;0;3;6
1934;Gelvonėlis;SAULUTĖ;7936622964;Ne;0;1;0;1
1935;Gelvonėlis;SAULUTĖ;3719670896;Taip;5;3;1;9
1936;Gelvonėlis;SAULUTĖ;1672409070;Ne;5;0;0;5
1937;Gelvonėlis;SAULUTĖ;3771796903;Ne;0;0;3;3
1938;Gelvonėlis;SAULUTĖ;4268590631;Ne;0;0;1;1
1939;Gelvonėlis;SAULUTĖ;5598186460;Ne;0;2;0;2
1940;Gelvonėlis;SAULUTĖ;9767254134;Ne;4;0;0;4
1941;Gelvonėlis;SAULUTĖ;2452711535;Ne;0;2;0;2
1942;Gelvonėlis;SAULUTĖ;2800795052;Ne;0;0;5;5
1943;Gelvonėlis;SAULUTĖ;9980127170;Ne;5;0;0;5
1944;Gelvonėlis;SAULUTĖ;6206837435;Ne;0;0;1;1
1945;Gelvonėlis;SAULUTĖ;6840560863;Ne;10;0;0;10
1946;Gelvonėlis;PELĖDŽIUKAI;6604992169;Ne;0;3;0;3
1947;Gelvonėlis;PELĖDŽIUKAI;8508450500;Ne;0;11;0;11
1948;Gelvonėlis;PELĖDŽIUKAI;8704971956;Ne;7;0;0;7
1949;Gelvonėlis;PELĖDŽIUKAI;6556472766;Ne;0;1;2;3
1950;Gelvonėlis;PELĖDŽIUKAI;7182180008;Ne;0;0;1;1
1951;Gelvonėlis;PELĖDŽIUKAI;8976258838;Ne;0;0;1;1
1952;Gelvonėlis;PELĖDŽIUKAI;6598178467;Ne;9;1;0;10
1953;Gelvonėlis;PELĖDŽIUKAI;8885088900;Ne;0;1;2;3
1954;Gelvonėlis;PELĖDŽIUKAI;2400289466;Ne;4;0;2;6
1955;Gelvonėlis;PELĖDŽIUKAI;1987204544;Ne;0;4;0;4
1956;Gelvonėlis;PELĖDŽIUKAI;2288951845;Ne;1;0;0;1
1957;Gelvonėlis;PELĖDŽIUKAI;2515471132;Ne;0;1;1;2
1958;Gelvonėlis;PELĖDŽIUKAI;1085845218;Ne;0;0;1;1
1959;Gelvonėlis;PELĖDŽIUKAI;9538571448;Ne;0;2;0;2
1960;Gelvonėlis;PELĖDŽIUKAI;9147186080;Ne;0;1;0;1
1961;Gelvonėlis;PELĖDŽIUKAI;7620280474;Ne;1;0;0;1
1962;Gelvonėlis;DRUGELIAI;2407650243;Ne;0;1;0;1
1963;Gelvonėlis;DRUGELIAI;2407650243;Ne;0;1;0;1
1964;Gelvonėlis;DRUGELIAI;7262185834;Ne;9;0;0;9
1965;Gelvonėlis;DRUGELIAI;7733244178;Ne;10;0;0;10
1966;Gelvonėlis;DRUGELIAI;1252450619;Ne;14;0;0;14
1967;Gelvonėlis;DRUGELIAI;7811394993;Ne;15;0;0;15
1968;Gelvonėlis;DRUGELIAI;6197211003;Ne;5;0;0;5
1969;Gelvonėlis;DRUGELIAI;1723279380;Ne;16;0;0;16
1970;Gelvonėlis;DRUGELIAI;4125444433;Ne;10;0;0;10
1971;Gelvonėlis;DRUGELIAI;5104092000;Ne;0;2;0;2
1972;Gelvonėlis;DRUGELIAI;5301772700;Ne;12;0;0;12
1973;Gelvonėlis;DRUGELIAI;4738577955;Ne;12;0;0;12
1974;Gelvonėlis;DRUGELIAI;3452557722;Taip;10;0;0;10
1975;Gelvonėlis;DRUGELIAI;2045223350;Ne;0;3;0;3
1976;Gelvonėlis;DRUGELIAI;5850515555;Ne;0;3;0;3
1977;Gelvonėlis;VARPELIAI;6131268672;Ne;9;0;1;10
1978;Gelvonėlis;VARPELIAI;4088437014;Ne;9;0;3;12
1979;Gelvonėlis;VARPELIAI;3150970953;Ne;13;0;1;14
1980;Gelvonėlis;VARPELIAI;2877046472;Ne;2;0;0;2
1981;Gelvonėlis;VARPELIAI;2896360160;Ne;2;0;1;3
1982;Gelvonėlis;VARPELIAI;4162701876;Ne;12;1;0;13
1983;Gelvonėlis;VARPELIAI;8365647638;Ne;4;0;0;4
1984;Gelvonėlis;VARPELIAI;3618681535;Ne;11;0;0;11
1985;Gelvonėlis;VARPELIAI;9386056584;Ne;0;1;0;1
1986;Gelvonėlis;VARPELIAI;2114734415;Ne;7;0;2;9
1987;Gelvonėlis;VARPELIAI;5882430535;Taip;2;0;0;2
1988;Gelvonėlis;VARPELIAI;9140900868;Ne;14;0;0;14
1989;Gelvonėlis;VARPELIAI;2645337382;Taip;9;0;1;10
1990;Gelvonėlis;VARPELIAI;3813000890;Taip;0;0;1;1
1991;Gelvonėlis;VARPELIAI;6662081736;Ne;5;0;0;5
1992;Gelvonėlis;VARPELIAI;5379820728;Ne;5;0;0;5
1993;Gelvonėlis;VARPELIAI;1984082487;Ne;14;0;0;14
1994;Gelvonėlis;BORUŽĖLĖS;6554989142;Ne;0;0;1;1
1995;Gelvonėlis;BORUŽĖLĖS;8056058298;Ne;0;2;0;2
1996;Gelvonėlis;BORUŽĖLĖS;2698853686;Ne;0;1;0;1
1997;Gelvonėlis;BORUŽĖLĖS;4112607183;Ne;0;0;1;1
1998;Gelvonėlis;BORUŽĖLĖS;6243360625;Ne;0;7;0;7
1999;Gelvonėlis;BORUŽĖLĖS;8515746171;Ne;6;0;0;6
2000;Gelvonėlis;BORUŽĖLĖS;1712926391;Ne;7;0;2;9
2001;Gelvonėlis;BORUŽĖLĖS;6647585785;Ne;5;0;0;5
2002;Gelvonėlis;BORUŽĖLĖS;8973272332;Ne;3;0;0;3
2003;Gelvonėlis;BORUŽĖLĖS;3926733474;Ne;0;0;3;3
2004;Gelvonėlis;BORUŽĖLĖS;4620517551;Ne;0;0;1;1
2005;Gelvonėlis;BORUŽĖLĖS;6598688551;Ne;0;3;0;3
2006;Gelvonėlis;BORUŽĖLĖS;6680287456;Ne;5;0;0;5
2007;Gelvonėlis;NYKŠTUKAI;9150177446;Ne;0;0;1;1
2008;Gelvonėlis;NYKŠTUKAI;5311057148;Ne;3;0;3;6
2009;Gelvonėlis;NYKŠTUKAI;9266138595;Ne;10;2;0;12
2010;Gelvonėlis;NYKŠTUKAI;6740297512;Ne;5;1;1;7
2011;Gelvonėlis;NYKŠTUKAI;2302268767;Taip;9;0;2;11
2012;Gelvonėlis;NYKŠTUKAI;4723497260;Ne;10;1;0;11
2013;Gelvonėlis;NYKŠTUKAI;8962769076;Ne;16;0;0;16
2014;Gelvonėlis;NYKŠTUKAI;3173327297;Ne;0;1;0;1
2015;Gelvonėlis;NYKŠTUKAI;2820416461;Ne;7;0;0;7
2016;Gelvonėlis;NYKŠTUKAI;9529938060;Taip;7;0;0;7
2017;Gelvonėlis;NYKŠTUKAI;6072327798;Taip;10;5;0;15
2018;Gelvonėlis;NYKŠTUKAI;4423931995;Ne;10;0;0;10
2019;Gelvonėlis;NYKŠTUKAI;4244879840;Ne;10;0;0;10
2020;Gelvonėlis;NYKŠTUKAI;1167713450;Ne;11;0;0;11
2021;Gelvonėlis;NYKŠTUKAI;8863386276;Ne;16;0;0;16
2022;Gelvonėlis;NYKŠTUKAI;4827817614;Ne;6;0;0;6
2023;Gelvonėlis;BITUTĖS;6534527571;Ne;3;0;0;3
2024;Gelvonėlis;BITUTĖS;1105838340;Ne;2;0;0;2
2025;Gelvonėlis;BITUTĖS;5865866507;Ne;7;0;1;8
2026;Gelvonėlis;BITUTĖS;5444127599;Ne;10;0;0;10
2027;Gelvonėlis;BITUTĖS;1980703633;Ne;2;0;0;2
2028;Gelvonėlis;BITUTĖS;5633162524;Ne;5;2;0;7
2029;Gelvonėlis;BITUTĖS;6710189985;Ne;13;0;0;13
2030;Gelvonėlis;BITUTĖS;5281400074;Ne;5;1;0;6
2031;Gelvonėlis;BITUTĖS;3514762919;Ne;8;1;0;9
2032;Gelvonėlis;BITUTĖS;8792171281;Ne;5;0;3;8
2033;Gelvonėlis;BITUTĖS;7850553299;Ne;2;0;1;3
2034;Gelvonėlis;BITUTĖS;1730718430;Ne;9;0;3;12
2035;Gelvonėlis;BITUTĖS;8480138654;Ne;6;1;0;7
2036;Gelvonėlis;BITUTĖS;7725313260;Ne;0;18;0;18
2037;Gelvonėlis;BITUTĖS;5816373550;Ne;8;0;0;8
2038;Gelvonėlis;BITUTĖS;4380468764;Ne;6;5;0;11
2039;Gelvonėlis;RAMUNĖLĖS;1104204810;Ne;7;0;0;7
2040;Gelvonėlis;RAMUNĖLĖS;1355774181;Ne;10;0;0;10
2041;Gelvonėlis;RAMUNĖLĖS;2774170680;Ne;10;0;0;10
2042;Gelvonėlis;RAMUNĖLĖS;9403505858;Taip;0;6;0;6
2043;Gelvonėlis;RAMUNĖLĖS;7686930719;Taip;4;0;0;4
2044;Gelvonėlis;RAMUNĖLĖS;4450990418;Ne;0;1;0;1
2045;Gelvonėlis;RAMUNĖLĖS;7419947442;Ne;2;0;0;2
2046;Gelvonėlis;RAMUNĖLĖS;6883156109;Ne;6;0;0;6
2047;Gelvonėlis;RAMUNĖLĖS;1562829157;Ne;10;0;0;10
2048;Gelvonėlis;RAMUNĖLĖS;4211228746;Ne;0;4;0;4
2049;Gelvonėlis;RAMUNĖLĖS;1661034338;Ne;6;0;0;6
2050;Gelvonėlis;RAMUNĖLĖS;2821485779;Ne;10;0;0;10
2051;Gelvonėlis;RAMUNĖLĖS;2818319130;Ne;3;0;0;3
2052;Gelvonėlis;RAMUNĖLĖS;7301596834;Ne;7;0;0;7
2053;Gelvonėlis;RAMUNĖLĖS;9046297659;Taip;0;10;0;10
2054;Gelvonėlis;RAMUNĖLĖS;7654781219;Ne;6;3;0;9
2055;Gelvonėlis;RAMUNĖLĖS;7464963101;Ne;7;0;0;7
2056;Gelvonėlis;RIEŠUTĖLIAI;3368423382;Ne;8;0;0;8
2057;Gelvonėlis;RIEŠUTĖLIAI;5461812139;Ne;0;11;0;11
2058;Gelvonėlis;RIEŠUTĖLIAI;5986018609;Ne;0;0;2;2
2059;Gelvonėlis;RIEŠUTĖLIAI;8532801167;Ne;0;3;0;3
2060;Gelvonėlis;RIEŠUTĖLIAI;4208103106;Ne;0;10;0;10
2061;Gelvonėlis;RIEŠUTĖLIAI;8766702456;Ne;5;0;0;5
2062;Gelvonėlis;RIEŠUTĖLIAI;6305084811;Ne;7;0;2;9
2063;Gelvonėlis;RIEŠUTĖLIAI;2005647155;Ne;0;2;0;2
2064;Gelvonėlis;RIEŠUTĖLIAI;5934077931;Ne;5;0;2;7
2065;Gelvonėlis;RIEŠUTĖLIAI;4280463938;Ne;0;4;0;4
2066;Gelvonėlis;RIEŠUTĖLIAI;6471921512;Ne;8;0;0;8
2067;Gelvonėlis;RIEŠUTĖLIAI;3448444552;Ne;10;0;0;10
2068;Gelvonėlis;RIEŠUTĖLIAI;4832167372;Ne;7;1;0;8
2069;Gelvonėlis;RIEŠUTĖLIAI;9301814935;Ne;0;4;0;4
2070;Gelvonėlis;RIEŠUTĖLIAI;1466616814;Ne;0;0;2;2
2071;Gelvonėlis;RIEŠUTĖLIAI;2015807805;Ne;0;4;0;4
2072;Gelvonėlis;RIEŠUTĖLIAI;9323228591;Ne;5;0;0;5
2073;Gelvonėlis;RIEŠUTĖLIAI;2360728722;Ne;6;7;0;13
2074;Gelvonėlis;RIEŠUTĖLIAI;9132529216;Ne;0;12;0;12
2075;"Gervelė (Dzūkų g. 32)";ŽIRNIUKAI;7140356352;Ne;5;1;0;6
2076;"Gervelė (Dzūkų g. 32)";ŽIRNIUKAI;3170062234;Taip;1;0;0;1
2077;"Gervelė (Dzūkų g. 32)";ŽIRNIUKAI;8598429197;Ne;17;0;0;17
2078;"Gervelė (Dzūkų g. 32)";ŽIRNIUKAI;9532470407;Taip;0;0;1;1
2079;"Gervelė (Dzūkų g. 32)";ŽIRNIUKAI;5608916470;Ne;0;0;1;1
2080;"Gervelė (Dzūkų g. 32)";ŽIRNIUKAI;7205673717;Ne;1;0;1;2
2081;"Gervelė (Dzūkų g. 32)";ŽIRNIUKAI;3554640994;Ne;3;0;0;3
2082;"Gervelė (Dzūkų g. 32)";ŽIRNIUKAI;9884946783;Ne;10;0;0;10
2083;"Gervelė (Dzūkų g. 32)";ŽIRNIUKAI;4174471780;Ne;20;0;0;20
2084;"Gervelė (Dzūkų g. 32)";ŽIRNIUKAI;6424240375;Ne;20;0;0;20
2085;"Gervelė (Dzūkų g. 32)";ŽIRNIUKAI;2210605017;Ne;10;0;0;10
2086;"Gervelė (Dzūkų g. 32)";ŽIRNIUKAI;1777909973;Taip;12;0;1;13
2087;"Gervelė (Dzūkų g. 32)";ŽIRNIUKAI;1400829693;Ne;0;0;7;7
2088;"Gervelė (Dzūkų g. 32)";ŽIRNIUKAI;4661861470;Taip;20;0;0;20
2089;"Gervelė (Dzūkų g. 32)";LAŠIUKAI;2523056808;Taip;0;0;3;3
2090;"Gervelė (Dzūkų g. 32)";LAŠIUKAI;6844406500;Ne;8;2;0;10
2091;"Gervelė (Dzūkų g. 32)";LAŠIUKAI;2046282471;Ne;20;0;0;20
2092;"Gervelė (Dzūkų g. 32)";LAŠIUKAI;1573560581;Ne;5;0;0;5
2093;"Gervelė (Dzūkų g. 32)";LAŠIUKAI;9133101055;Ne;1;0;0;1
2094;"Gervelė (Dzūkų g. 32)";LAŠIUKAI;1024397071;Ne;7;0;0;7
2095;"Gervelė (Dzūkų g. 32)";LAŠIUKAI;1783612448;Ne;5;0;2;7
2096;"Gervelė (Dzūkų g. 32)";LAŠIUKAI;7040713170;Ne;13;0;5;18
2097;"Gervelė (Dzūkų g. 32)";LAŠIUKAI;6227091658;Ne;0;0;1;1
2098;"Gervelė (Dzūkų g. 32)";LAŠIUKAI;4075328330;Ne;4;0;3;7
2099;"Gervelė (Dzūkų g. 32)";LAŠIUKAI;7394199974;Ne;4;0;1;5
2100;"Gervelė (Dzūkų g. 32)";LAŠIUKAI;5497737178;Taip;10;0;0;10
2101;"Gervelė (Dzūkų g. 32)";LAŠIUKAI;5480025851;Ne;4;0;0;4
2102;"Gervelė (Dzūkų g. 32)";LAŠIUKAI;7363767471;Ne;14;0;2;16
2103;"Gervelė (Dzūkų g. 32)";LAŠIUKAI;4932912245;Taip;0;3;0;3
2104;"Gervelė (Dzūkų g. 32)";LAŠIUKAI;1808067249;Ne;0;1;0;1
2105;"Gervelė (Dzūkų g. 32)";PABIRUČIAI;1637204236;Ne;5;0;0;5
2106;"Gervelė (Dzūkų g. 32)";PABIRUČIAI;8157865822;Ne;1;0;0;1
2107;"Gervelė (Dzūkų g. 32)";PABIRUČIAI;7924884022;Ne;0;6;0;6
2108;"Gervelė (Dzūkų g. 32)";PABIRUČIAI;1323074335;Ne;3;0;0;3
2109;"Gervelė (Dzūkų g. 32)";PABIRUČIAI;6058944385;Ne;0;5;0;5
2110;"Gervelė (Dzūkų g. 32)";PABIRUČIAI;3647044817;Ne;1;0;2;3
2111;"Gervelė (Dzūkų g. 32)";PABIRUČIAI;2446758975;Taip;1;3;0;4
2112;"Gervelė (Dzūkų g. 32)";PABIRUČIAI;2413995770;Ne;0;1;0;1
2113;"Gervelė (Dzūkų g. 32)";PABIRUČIAI;1353920541;Ne;0;3;0;3
2114;"Gervelė (Dzūkų g. 32)";PABIRUČIAI;6895415337;Ne;4;0;0;4
2115;"Gervelė (Dzūkų g. 32)";PABIRUČIAI;8533480337;Ne;0;4;0;4
2116;"Gervelė (Dzūkų g. 32)";PABIRUČIAI;8287867336;Ne;0;3;1;4
2117;"Gervelė (Dzūkų g. 32)";PABIRUČIAI;2186818108;Ne;16;0;0;16
2118;"Gervelė (Dzūkų g. 32)";PABIRUČIAI;9799715031;Taip;0;0;4;4
2119;"Gervelė (Dzūkų g. 32)";PABIRUČIAI;8439479958;Ne;0;7;0;7
2120;"Gervelė (Dzūkų g. 32)";BITUTĖS;5360362280;Ne;0;0;3;3
2121;"Gervelė (Dzūkų g. 32)";BITUTĖS;5360362280;Ne;0;0;3;3
2122;"Gervelė (Dzūkų g. 32)";BITUTĖS;7317091881;Ne;5;1;0;6
2123;"Gervelė (Dzūkų g. 32)";BITUTĖS;6951455424;Ne;0;0;2;2
2124;"Gervelė (Dzūkų g. 32)";BITUTĖS;9977349707;Ne;0;5;0;5
2125;"Gervelė (Dzūkų g. 32)";BITUTĖS;4295743997;Ne;0;1;0;1
2126;"Gervelė (Dzūkų g. 32)";BITUTĖS;1112844296;Ne;0;0;4;4
2127;"Gervelė (Dzūkų g. 32)";BITUTĖS;7935059565;Ne;5;0;0;5
2128;"Gervelė (Dzūkų g. 32)";BITUTĖS;5267617723;Ne;0;0;4;4
2129;"Gervelė (Dzūkų g. 32)";BITUTĖS;5953552777;Ne;0;3;0;3
2130;"Gervelė (Dzūkų g. 32)";BITUTĖS;1160084928;Ne;7;0;2;9
2131;"Gervelė (Dzūkų g. 32)";BITUTĖS;6287806975;Taip;0;5;0;5
2132;"Gervelė (Dzūkų g. 32)";BITUTĖS;5685222621;Ne;1;0;1;2
2133;"Gervelė (Dzūkų g. 32)";BITUTĖS;6431701403;Ne;9;0;0;9
2134;"Gervelė (Dzūkų g. 32)";BURATINO;9239897472;Ne;5;0;0;5
2135;"Gervelė (Dzūkų g. 32)";BURATINO;9982951468;Ne;10;1;0;11
2136;"Gervelė (Dzūkų g. 32)";BURATINO;4775822341;Ne;0;7;0;7
2137;"Gervelė (Dzūkų g. 32)";BURATINO;2913622440;Ne;7;0;0;7
2138;"Gervelė (Dzūkų g. 32)";BURATINO;6166476760;Ne;1;0;0;1
2139;"Gervelė (Dzūkų g. 32)";BURATINO;4516538272;Ne;2;0;0;2
2140;"Gervelė (Dzūkų g. 32)";BURATINO;3723783633;Ne;4;0;0;4
2141;"Gervelė (Dzūkų g. 32)";BURATINO;8472436632;Taip;4;0;0;4
2142;"Gervelė (Dzūkų g. 32)";BURATINO;1655678792;Ne;2;0;0;2
2143;"Gervelė (Dzūkų g. 32)";BURATINO;9697299387;Taip;0;5;0;5
2144;"Gervelė (Dzūkų g. 32)";BURATINO;7300458249;Ne;2;0;0;2
2145;"Gervelė (Dzūkų g. 32)";BURATINO;7998812497;Ne;7;0;0;7
2146;"Gervelė (Dzūkų g. 32)";BURATINO;5737517940;Ne;2;0;0;2
2147;"Gervelė (Dzūkų g. 32)";BURATINO;6595410865;Ne;4;4;0;8
2148;"Gervelė (Dzūkų g. 32)";BURATINO;1328359434;Ne;1;0;0;1
2149;"Gervelė (Dzūkų g. 32)";BURATINO;1932916710;Ne;0;6;0;6
2150;"Gervelė (Dzūkų g. 32)";BURATINO;2080374597;Ne;5;0;0;5
2151;"Gervelė (Dzūkų g. 32)";BURATINO;9768014964;Ne;4;0;0;4
2152;"Gervelė (Dzūkų g. 32)";VIŠČIUKŲ;1810783092;Ne;10;0;0;10
2153;"Gervelė (Dzūkų g. 32)";VIŠČIUKŲ;4112178405;Ne;0;0;1;1
2154;"Gervelė (Dzūkų g. 32)";VIŠČIUKŲ;8193126684;Ne;0;17;0;17
2155;"Gervelė (Dzūkų g. 32)";VIŠČIUKŲ;7152159380;Ne;0;0;1;1
2156;"Gervelė (Dzūkų g. 32)";VIŠČIUKŲ;6503715631;Ne;5;0;5;10
2157;"Gervelė (Dzūkų g. 32)";VIŠČIUKŲ;6071962550;Ne;16;0;0;16
2158;"Gervelė (Dzūkų g. 32)";VIŠČIUKŲ;8456221074;Ne;13;0;3;16
2159;"Gervelė (Dzūkų g. 32)";VIŠČIUKŲ;9738262953;Ne;0;3;4;7
2160;"Gervelė (Dzūkų g. 32)";VIŠČIUKŲ;8392147716;Ne;5;0;0;5
2161;"Gilužis (Vydūno g. 11A)";Skruzdėliukų;8628253655;Ne;0;7;0;7
2162;"Gilužis (Vydūno g. 11A)";Skruzdėliukų;9783700319;Ne;9;1;0;10
2163;"Gilužis (Vydūno g. 11A)";Skruzdėliukų;4509741536;Ne;10;1;0;11
2164;"Gilužis (Vydūno g. 11A)";Skruzdėliukų;3002266577;Ne;14;1;0;15
2165;"Gilužis (Vydūno g. 11A)";Skruzdėliukų;5497242500;Ne;5;3;0;8
2166;"Gilužis (Vydūno g. 11A)";Skruzdėliukų;5190752112;Ne;4;3;0;7
2167;"Gilužis (Vydūno g. 11A)";Skruzdėliukų;2440762487;Ne;4;3;0;7
2168;"Gilužis (Vydūno g. 11A)";Skruzdėliukų;9104005195;Ne;4;1;0;5
2169;"Gilužis (Vydūno g. 11A)";Skruzdėliukų;5394693502;Ne;7;0;0;7
2170;"Gilužis (Vydūno g. 11A)";Skruzdėliukų;4876074981;Ne;9;1;0;10
2171;"Gilužis (Vydūno g. 11A)";Skruzdėliukų;2633680406;Ne;0;1;0;1
2172;"Gilužis (Vydūno g. 11A)";Skruzdėliukų;4455977087;Ne;0;1;0;1
2173;"Gilužis (Vydūno g. 11A)";Skruzdėliukų;2615087717;Ne;2;2;0;4
2174;"Gilužis (Vydūno g. 11A)";Skruzdėliukų;2516315604;Ne;2;1;0;3
2175;"Gilužis (Vydūno g. 11A)";Skruzdėliukų;2706629834;Ne;0;2;0;2
2176;"Gilužis (Vydūno g. 11A)";Skruzdėliukų;6831107153;Ne;6;0;0;6
2177;"Gilužis (Vydūno g. 11A)";Skruzdėliukų;8852862161;Ne;6;0;0;6
2178;"Gilužis (Vydūno g. 11A)";Skruzdėliukų;2955779117;Ne;6;0;0;6
2179;"Gilužis (Vydūno g. 11A)";Nykštukų;3132445117;Ne;0;3;0;3
2180;"Gilužis (Vydūno g. 11A)";Nykštukų;7937643339;Ne;7;0;0;7
2181;"Gilužis (Vydūno g. 11A)";Nykštukų;3473889426;Ne;0;6;0;6
2182;"Gilužis (Vydūno g. 11A)";Nykštukų;9362581908;Ne;0;6;0;6
2183;"Gilužis (Vydūno g. 11A)";Nykštukų;8899557365;Ne;7;0;0;7
2184;"Gilužis (Vydūno g. 11A)";Nykštukų;2661894041;Ne;8;0;0;8
2185;"Gilužis (Vydūno g. 11A)";Nykštukų;5109935385;Ne;3;4;0;7
2186;"Gilužis (Vydūno g. 11A)";Nykštukų;7228498662;Ne;5;0;0;5
2187;"Gilužis (Vydūno g. 11A)";Nykštukų;3335512812;Ne;0;1;0;1
2188;"Gilužis (Vydūno g. 11A)";Nykštukų;1459273692;Ne;2;0;0;2
2189;"Gilužis (Vydūno g. 11A)";Nykštukų;4156613717;Ne;9;1;0;10
2190;"Gilužis (Vydūno g. 11A)";Nykštukų;5713786735;Ne;4;0;0;4
2191;"Gilužis (Vydūno g. 11A)";Nykštukų;6315155554;Ne;2;0;0;2
2192;"Gilužis (Vydūno g. 11A)";Nykštukų;4541291716;Ne;1;1;0;2
2193;"Gilužis (Vydūno g. 11A)";Nykštukų;8522552650;Ne;7;2;1;10
2194;"Gilužis (Vydūno g. 11A)";Nykštukų;3176305306;Ne;2;4;0;6
2195;"Gilužis (Vydūno g. 11A)";Nykštukų;4795108770;Ne;0;2;0;2
2196;"Gilužis (Vydūno g. 11A)";Nykštukų;4094486541;Ne;2;1;0;3
2197;"Gilužis (Vydūno g. 11A)";Nykštukų;6493142538;Ne;7;0;0;7
2198;"Gilužis (Vydūno g. 11A)";Nykštukų;5088561405;Ne;0;5;0;5
2199;"Gilužis (Vydūno g. 11A)";Bitučių;4841014668;Ne;5;0;0;5
2200;"Gilužis (Vydūno g. 11A)";Bitučių;1634295583;Ne;0;4;3;7
2201;"Gilužis (Vydūno g. 11A)";Bitučių;4360261750;Ne;0;4;3;7
2202;"Gilužis (Vydūno g. 11A)";Bitučių;5728341732;Taip;0;1;0;1
2203;"Gilužis (Vydūno g. 11A)";Bitučių;6931726275;Ne;0;4;0;4
2204;"Gilužis (Vydūno g. 11A)";Bitučių;1867185320;Ne;0;6;0;6
2205;"Gilužis (Vydūno g. 11A)";Bitučių;3429435736;Ne;0;1;0;1
2206;"Gilužis (Vydūno g. 11A)";Bitučių;8539946703;Taip;0;20;0;20
2207;"Gilužis (Vydūno g. 11A)";Bitučių;9000351000;Ne;0;3;0;3
2208;"Gilužis (Vydūno g. 11A)";Bitučių;5366174839;Ne;0;1;0;1
2209;"Gilužis (Vydūno g. 11A)";Bitučių;5162397237;Ne;0;4;0;4
2210;"Gilužis (Vydūno g. 11A)";Bitučių;9053608903;Ne;0;11;0;11
2211;"Gilužis (Vydūno g. 11A)";Bitučių;6115776872;Ne;0;0;6;6
2212;"Gilužis (Vydūno g. 11A)";Bitučių;5651799121;Ne;0;0;1;1
2213;"Gilužis (Vydūno g. 11A)";Bitučių;1334619137;Taip;4;0;0;4
2214;"Gilužis (Vydūno g. 11A)";Bitučių;2950813185;Ne;0;1;0;1
2215;"Gilužis (Vydūno g. 11A)";Bitučių;6515525848;Ne;0;1;0;1
2216;"Gilužis (Vydūno g. 11A)";Kačiukų;1273655212;Ne;3;0;0;3
2217;"Gilužis (Vydūno g. 11A)";Kačiukų;4978922821;Ne;5;1;0;6
2218;"Gilužis (Vydūno g. 11A)";Kačiukų;2945406185;Ne;5;1;0;6
2219;"Gilužis (Vydūno g. 11A)";Kačiukų;1582241363;Ne;0;6;0;6
2220;"Gilužis (Vydūno g. 11A)";Kačiukų;7330938312;Ne;5;0;3;8
2221;"Gilužis (Vydūno g. 11A)";Kačiukų;6571132974;Ne;2;7;5;14
2222;"Gilužis (Vydūno g. 11A)";Kačiukų;9034842169;Ne;2;0;0;2
2223;"Gilužis (Vydūno g. 11A)";Kačiukų;6966795180;Ne;2;0;0;2
2224;"Gilužis (Vydūno g. 11A)";Kačiukų;5128383851;Ne;5;0;4;9
2225;"Gilužis (Vydūno g. 11A)";Kačiukų;8318405114;Ne;10;1;0;11
2226;"Gilužis (Vydūno g. 11A)";Kačiukų;7826015897;Ne;4;4;0;8
2227;"Gilužis (Vydūno g. 11A)";Kačiukų;4403218878;Ne;0;1;0;1
2228;"Gilužis (Vydūno g. 11A)";Kačiukų;3419281756;Ne;10;1;0;11
2229;"Gilužis (Vydūno g. 11A)";Kačiukų;1862524255;Ne;7;0;1;8
2230;"Gilužis (Vydūno g. 11A)";Kačiukų;9421351780;Ne;8;0;0;8
2231;"Gilužis (Vydūno g. 11A)";Kačiukų;6404411477;Ne;5;0;0;5
2232;"Gilužis (Vydūno g. 11A)";Kačiukų;4128387076;Ne;1;0;1;2
2233;"Gilužis (Vydūno g. 11A)";Kačiukų;7042664923;Ne;3;0;0;3
2234;"Gilužis (Vydūno g. 11A)";Kačiukų;9097165155;Ne;10;0;0;10
2235;"Gilužis (Vydūno g. 11A)";Kačiukų;8762534617;Ne;4;9;0;13
2236;"Gilužis (Vydūno g. 11A)";Kačiukų;5641406427;Ne;7;0;2;9
2237;"Gilužis (Vydūno g. 11A)";Pelėdžiukų;5217748032;Ne;0;1;0;1
2238;"Gilužis (Vydūno g. 11A)";Pelėdžiukų;7998695149;Ne;1;0;0;1
2239;"Gilužis (Vydūno g. 11A)";Pelėdžiukų;7742783427;Ne;1;0;0;1
2240;"Gilužis (Vydūno g. 11A)";Pelėdžiukų;7358572344;Ne;9;2;0;11
2241;"Gilužis (Vydūno g. 11A)";Pelėdžiukų;4617259961;Ne;2;1;1;4
2242;"Gilužis (Vydūno g. 11A)";Pelėdžiukų;1222370750;Ne;2;0;0;2
2243;"Gilužis (Vydūno g. 11A)";Pelėdžiukų;6270071724;Ne;0;1;0;1
2244;"Gilužis (Vydūno g. 11A)";Pelėdžiukų;4051726208;Ne;5;2;0;7
2245;"Gilužis (Vydūno g. 11A)";Pelėdžiukų;4435227217;Ne;1;1;0;2
2246;"Gilužis (Vydūno g. 11A)";Pelėdžiukų;1804218972;Ne;1;0;0;1
2247;"Gilužis (Vydūno g. 11A)";Pelėdžiukų;3166161973;Ne;0;1;0;1
2248;"Gilužis (Vydūno g. 11A)";Pelėdžiukų;5070988982;Ne;6;0;0;6
2249;"Gilužis (Vydūno g. 11A)";Pelėdžiukų;7899274495;Ne;3;0;0;3
2250;"Gilužis (Vydūno g. 11A)";Pelėdžiukų;6093514885;Ne;5;0;0;5
2251;"Gilužis (Vydūno g. 11A)";Pelėdžiukų;9520409342;Ne;8;0;0;8
2252;"Gilužis (Vydūno g. 11A)";Pelėdžiukų;9186274541;Ne;1;0;0;1
2253;"Gilužis (Vydūno g. 11A)";Drugelių;6121625070;Taip;20;0;0;20
2254;"Gilužis (Vydūno g. 11A)";Drugelių;1770064694;Taip;2;1;0;3
2255;"Gilužis (Vydūno g. 11A)";Drugelių;9591229878;Ne;2;0;0;2
2256;"Gilužis (Vydūno g. 11A)";Drugelių;9092013248;Ne;0;6;0;6
2257;"Gilužis (Vydūno g. 11A)";Drugelių;9109883577;Ne;9;0;0;9
2258;"Gilužis (Vydūno g. 11A)";Drugelių;5118401707;Ne;4;0;0;4
2259;"Gilužis (Vydūno g. 11A)";Drugelių;3190597262;Ne;6;0;0;6
2260;"Gilužis (Vydūno g. 11A)";Drugelių;3532863024;Ne;0;20;0;20
2261;"Gilužis (Vydūno g. 11A)";Drugelių;1376645277;Ne;0;1;0;1
2262;"Gilužis (Vydūno g. 11A)";Drugelių;1410870589;Ne;3;2;0;5
2263;"Gilužis (Vydūno g. 11A)";Drugelių;6786334223;Taip;1;8;0;9
2264;"Gilužis (Vydūno g. 11A)";Drugelių;9112993465;Ne;5;6;0;11
2265;"Gilužis (Vydūno g. 11A)";Drugelių;4909329417;Ne;0;1;1;2
2266;"Gilužis (Vydūno g. 11A)";Drugelių;8244385001;Ne;0;1;1;2
2267;"Gilužis (Vydūno g. 11A)";Drugelių;6429142049;Ne;1;0;0;1
2268;"Gilužis (Vydūno g. 11A)";Drugelių;7731169885;Taip;5;0;0;5
2269;"Gilužis (Vydūno g. 11A)";Drugelių;1093643746;Ne;0;7;0;7
2270;"Gilužis (Vydūno g. 11A)";Drugelių;6950139609;Ne;2;0;0;2
2271;"Gilužis (Vydūno g. 11A)";Drugelių;2397231165;Taip;0;1;0;1
2272;"Gilužis (Vydūno g. 11A)";Saulučių;5705945483;Ne;0;8;0;8
2273;"Gilužis (Vydūno g. 11A)";Saulučių;8237963602;Taip;10;0;0;10
2274;"Gilužis (Vydūno g. 11A)";Saulučių;6914566889;Ne;10;0;0;10
2275;"Gilužis (Vydūno g. 11A)";Saulučių;5306278297;Taip;15;0;0;15
2276;"Gilužis (Vydūno g. 11A)";Saulučių;1054809163;Ne;11;0;1;12
2277;"Gilužis (Vydūno g. 11A)";Saulučių;7887970476;Ne;1;0;0;1
2278;"Gilužis (Vydūno g. 11A)";Saulučių;6507021182;Ne;8;0;0;8
2279;"Gilužis (Vydūno g. 11A)";Saulučių;4652281185;Ne;6;0;1;7
2280;"Gilužis (Vydūno g. 11A)";Saulučių;4122073923;Ne;2;0;0;2
2281;"Gilužis (Vydūno g. 11A)";Saulučių;2364391112;Ne;3;0;0;3
2282;"Gilužis (Vydūno g. 11A)";Saulučių;7068801003;Taip;0;0;1;1
2283;"Gilužis (Vydūno g. 11A)";Saulučių;3081351563;Ne;5;0;0;5
2284;"Gilužis (Vydūno g. 11A)";Saulučių;1015379578;Ne;1;1;0;2
2285;"Gilužis (Vydūno g. 11A)";Saulučių;7247606321;Ne;5;0;3;8
2286;"Gilužis (Vydūno g. 11A)";Saulučių;2915024298;Ne;4;0;0;4
2287;"Gilužis (Vydūno g. 11A)";Saulučių;2567788346;Ne;0;0;1;1
2288;"Gilužis (Vydūno g. 11A)";Saulučių;8717811266;Ne;4;2;0;6
2289;"Gilužis (Vydūno g. 11A)";Saulučių;7487731015;Taip;5;0;0;5
2290;"Gilužis (Vydūno g. 11A)";Saulučių;5079154238;Ne;8;0;2;10
2291;"Gilužis (Vydūno g. 11A)";Saulučių;5490128851;Ne;12;0;0;12
2292;"Gilužis (Vydūno g. 11A)";Saulučių;5784201106;Ne;9;0;0;9
2293;"Gilužis (Vydūno g. 11A)";Saulučių;8904873416;Ne;5;0;0;5
2294;"Gilužis (Vydūno g. 11A)";Saulučių;2851682356;Ne;1;0;0;1
2295;"Gilužis (Vydūno g. 11A)";Paukštelių;8110869130;Ne;0;0;1;1
2296;"Gilužis (Vydūno g. 11A)";Paukštelių;2883959240;Ne;8;0;0;8
2297;"Gilužis (Vydūno g. 11A)";Paukštelių;6322255194;Taip;1;0;0;1
2298;"Gilužis (Vydūno g. 11A)";Paukštelių;6572690788;Ne;0;5;1;6
2299;"Gilužis (Vydūno g. 11A)";Paukštelių;4153834736;Ne;7;0;1;8
2300;"Gilužis (Vydūno g. 11A)";Paukštelių;3646988912;Ne;0;2;0;2
2301;"Gilužis (Vydūno g. 11A)";Paukštelių;5030871828;Ne;0;0;1;1
2302;"Gilužis (Vydūno g. 11A)";Paukštelių;9919631327;Ne;0;0;1;1
2303;"Gilužis (Vydūno g. 11A)";Paukštelių;3954379433;Ne;0;11;0;11
2304;"Gilužis (Vydūno g. 11A)";Paukštelių;6129884232;Ne;5;0;0;5
2305;"Gilužis (Vydūno g. 11A)";Paukštelių;9520598359;Ne;5;0;0;5
2306;"Gilužis (Vydūno g. 11A)";Paukštelių;3804996594;Ne;3;0;0;3
2307;"Gilužis (Vydūno g. 11A)";Paukštelių;7307386173;Taip;0;0;1;1
2308;"Gilužis (Vydūno g. 11A)";Paukštelių;6478152041;Ne;0;1;0;1
2309;"Gilužis (Vydūno g. 11A)";Paukštelių;2524936605;Ne;7;0;0;7
2310;"Gilužis (Vydūno g. 11A)";Paukštelių;1005178052;Taip;0;1;0;1
2311;"Gilužis (Vydūno g. 11A)";Paukštelių;3141225891;Ne;0;0;1;1
2312;"Gilužis (Vydūno g. 11A)";Obuoliukų;8201769917;Ne;0;1;0;1
2313;"Gilužis (Vydūno g. 11A)";Obuoliukų;9892608223;Taip;0;3;0;3
2314;"Gilužis (Vydūno g. 11A)";Obuoliukų;1540018160;Ne;9;0;0;9
2315;"Gilužis (Vydūno g. 11A)";Obuoliukų;7716908903;Ne;5;0;0;5
2316;"Gilužis (Vydūno g. 11A)";Obuoliukų;3131597174;Ne;0;2;0;2
2317;"Gilužis (Vydūno g. 11A)";Obuoliukų;6239369861;Ne;12;0;0;12
2318;"Gilužis (Vydūno g. 11A)";Obuoliukų;6172360933;Ne;2;1;0;3
2319;"Gilužis (Vydūno g. 11A)";Obuoliukų;4592380105;Ne;5;4;0;9
2320;"Gilužis (Vydūno g. 11A)";Obuoliukų;4242362889;Ne;3;1;0;4
2321;"Gilužis (Vydūno g. 11A)";Obuoliukų;7560732216;Ne;3;1;0;4
2322;"Gilužis (Vydūno g. 11A)";Obuoliukų;7606394325;Taip;0;1;0;1
2323;"Gilužis (Vydūno g. 11A)";Obuoliukų;6737884137;Ne;0;12;0;12
2324;"Gilužis (Vydūno g. 11A)";Obuoliukų;6825745985;Ne;0;1;0;1
2325;"Gilužis (Vydūno g. 11A)";Obuoliukų;3458957423;Ne;0;20;0;20
2326;"Gilužis (Vydūno g. 11A)";Obuoliukų;8900414658;Ne;2;4;0;6
2327;"Gilužis (Vydūno g. 11A)";Obuoliukų;3219101391;Taip;0;1;0;1
2328;"Gilužis (Vydūno g. 11A)";Obuoliukų;4528131001;Ne;4;4;0;8
2329;"Gilužis (Vydūno g. 11A)";Obuoliukų;5895659747;Ne;4;11;0;15
2330;"Gilužis (Vydūno g. 11A)";Obuoliukų;3331616067;Taip;3;1;2;6
2331;"Gilužis (Vydūno g. 11A)";KIŠKUČIŲ;5744027226;Ne;0;0;4;4
2332;"Gilužis (Vydūno g. 11A)";KIŠKUČIŲ;8639633038;Ne;5;0;0;5
2333;"Gilužis (Vydūno g. 11A)";KIŠKUČIŲ;5721924532;Ne;6;0;0;6
2334;"Gilužis (Vydūno g. 11A)";KIŠKUČIŲ;9484221435;Ne;2;0;0;2
2335;"Gilužis (Vydūno g. 11A)";KIŠKUČIŲ;6323747855;Ne;0;0;1;1
2336;"Gilužis (Vydūno g. 11A)";KIŠKUČIŲ;2680643896;Ne;0;2;0;2
2337;"Gilužis (Vydūno g. 11A)";KIŠKUČIŲ;3649616461;Taip;0;0;1;1
2338;"Gilužis (Vydūno g. 11A)";KIŠKUČIŲ;7632771776;Taip;4;0;0;4
2339;"Gilužis (Vydūno g. 11A)";KIŠKUČIŲ;7477282548;Ne;10;0;0;10
2340;"Gilužis (Vydūno g. 11A)";KIŠKUČIŲ;9061835019;Ne;7;0;1;8
2341;"Gilužis (Vydūno g. 11A)";KIŠKUČIŲ;7560574633;Taip;10;0;1;11
2342;"Gilužis (Vydūno g. 11A)";KIŠKUČIŲ;4199633620;Ne;15;0;2;17
2343;"Gilužis (Vydūno g. 11A)";KIŠKUČIŲ;9851612698;Ne;0;0;1;1
2344;"Gilužis (Vydūno g. 11A)";KIŠKUČIŲ;1391410955;Taip;17;0;0;17
2345;"Gilužis (Vydūno g. 11A)";KIŠKUČIŲ;6383469680;Ne;0;10;0;10
2346;"Gilužis (Vydūno g. 11A)";KIŠKUČIŲ;8341597766;Taip;0;0;1;1
2347;"Gilužis (Vydūno g. 11A)";KIŠKUČIŲ;3171560628;Ne;14;0;1;15
2348;"Gilužis (Vydūno g. 11A)";KIŠKUČIŲ;4347319425;Ne;2;0;0;2
2349;"Gilužis (Vydūno g. 11A)";KIŠKUČIŲ;8591741716;Taip;6;1;0;7
2350;"Gilužis (Vydūno g. 11A)";KIŠKUČIŲ;8877445672;Ne;14;0;0;14
2351;"Gilužis (Vydūno g. 11A)";KIŠKUČIŲ;9489594782;Ne;0;1;0;1
2352;"Gilužis (Vydūno g. 11A)";Meškučių;7263432152;Taip;1;2;0;3
2353;"Gilužis (Vydūno g. 11A)";Meškučių;4655266106;Ne;2;0;0;2
2354;"Gilužis (Vydūno g. 11A)";Meškučių;3800593189;Ne;6;3;0;9
2355;"Gilužis (Vydūno g. 11A)";Meškučių;8393554697;Ne;6;4;0;10
2356;"Gilužis (Vydūno g. 11A)";Meškučių;8301535013;Ne;2;1;0;3
2357;"Gilužis (Vydūno g. 11A)";Meškučių;2939982311;Ne;9;0;0;9
2358;"Gilužis (Vydūno g. 11A)";Meškučių;3365778697;Ne;7;2;0;9
2359;"Gilužis (Vydūno g. 11A)";Meškučių;7912093880;Taip;13;0;0;13
2360;"Gilužis (Vydūno g. 11A)";Meškučių;2389277783;Ne;0;1;0;1
2361;"Gilužis (Vydūno g. 11A)";Meškučių;2500949029;Ne;0;3;0;3
2362;"Gilužis (Vydūno g. 11A)";Meškučių;4741129495;Ne;12;1;0;13
2363;"Gilužis (Vydūno g. 11A)";Meškučių;7992750316;Ne;0;20;0;20
2364;"Gilužis (Vydūno g. 11A)";Meškučių;5505153657;Taip;3;2;0;5
2365;"Gilužis (Vydūno g. 11A)";Meškučių;2577554894;Ne;7;0;0;7
2366;"Gilužis (Vydūno g. 11A)";Meškučių;3148477315;Ne;16;0;0;16
2367;"Gilužis (Vydūno g. 11A)";Meškučių;1068375927;Ne;1;0;0;1
2368;"Gilužis (Vydūno g. 11A)";Meškučių;8476240141;Ne;3;6;0;9
2369;"Gilužis (Vydūno g. 11A)";Meškučių;6185280967;Ne;10;1;0;11
2370;"Gilužis (Vydūno g. 11A)";Meškučių;5177805719;Taip;0;4;0;4
2371;"Gilužis (Vydūno g. 11A)";Meškučių;5654754316;Ne;14;0;0;14
2372;"Gilužis (Vydūno g. 11A)";Pagrandukai;6884146146;Ne;2;1;0;3
2373;"Gilužis (Vydūno g. 11A)";Pagrandukai;6920910054;Ne;12;2;0;14
2374;"Gilužis (Vydūno g. 11A)";Pagrandukai;6501973647;Ne;0;2;0;2
2375;"Gilužis (Vydūno g. 11A)";Pagrandukai;5397975739;Ne;0;2;0;2
2376;"Gilužis (Vydūno g. 11A)";Pagrandukai;6109205159;Ne;0;1;0;1
2377;"Gilužis (Vydūno g. 11A)";Pagrandukai;2328338059;Ne;0;1;0;1
2378;"Gilužis (Vydūno g. 11A)";Pagrandukai;5376639182;Ne;0;2;0;2
2379;"Gilužis (Vydūno g. 11A)";Pagrandukai;5378701300;Ne;4;0;0;4
2380;"Gilužis (Vydūno g. 11A)";Pagrandukai;3366788027;Ne;4;0;0;4
2381;"Gilužis (Vydūno g. 11A)";Pagrandukai;5334441484;Ne;0;1;0;1
2382;"Gilužis (Vydūno g. 11A)";Pagrandukai;8477445384;Ne;1;0;0;1
2383;"Gilužis (Vydūno g. 11A)";Pagrandukai;1758670627;Ne;2;0;0;2
2384;"Gilužis (Vydūno g. 11A)";Pagrandukai;6766559505;Taip;0;6;0;6
2385;"Gilužis (Vydūno g. 11A)";Pagrandukai;5737505086;Ne;5;0;0;5
2386;"Gilužis (Vydūno g. 11A)";Pagrandukai;6207304860;Ne;5;0;0;5
2387;"Gilužis (Vydūno g. 11A)";Pagrandukai;5921538837;Ne;0;2;1;3
2388;"Gilužis (Vydūno g. 11A)";Pagrandukai;9846916206;Taip;13;1;0;14
2389;"Gilužis (Vydūno g. 11A)";Pagrandukai;9325927745;Ne;6;5;0;11
2390;"Gilužis (Vydūno g. 11A)";Pagrandukai;4927117901;Ne;0;1;0;1
2391;"Gilužis (Vydūno g. 11A)";Boružėlių;5581417252;Ne;14;0;0;14
2392;"Gilužis (Vydūno g. 11A)";Boružėlių;1209632075;Ne;3;1;0;4
2393;"Gilužis (Vydūno g. 11A)";Boružėlių;9753512366;Taip;12;5;0;17
2394;"Gilužis (Vydūno g. 11A)";Boružėlių;1541283216;Ne;1;0;0;1
2395;"Gilužis (Vydūno g. 11A)";Boružėlių;5664892047;Ne;5;0;0;5
2396;"Gilužis (Vydūno g. 11A)";Boružėlių;3917385813;Taip;6;0;0;6
2397;"Gilužis (Vydūno g. 11A)";Boružėlių;3194397689;Ne;3;0;0;3
2398;"Gilužis (Vydūno g. 11A)";Boružėlių;6586605929;Ne;10;0;0;10
2399;"Gilužis (Vydūno g. 11A)";Boružėlių;4325300253;Ne;0;0;1;1
2400;"Gilužis (Vydūno g. 11A)";Boružėlių;1826248450;Ne;6;0;0;6
2401;"Gilužis (Vydūno g. 11A)";Boružėlių;3279830266;Ne;8;0;0;8
2402;"Gilužis (Vydūno g. 11A)";Boružėlių;9676661005;Ne;5;0;0;5
2403;"Gilužis (Vydūno g. 11A)";Boružėlių;1306757860;Ne;5;0;1;6
2404;"Gilužis (Vydūno g. 11A)";Boružėlių;1604096952;Ne;0;1;0;1
2405;"Gilužis (Vydūno g. 11A)";Boružėlių;4266998302;Ne;5;0;0;5
2406;"Gintarėlis (Didlaukio g. 35)";PAPŪGĖLĖS;6402043654;Ne;0;1;0;1
2407;"Gintarėlis (Didlaukio g. 35)";PAPŪGĖLĖS;6558614008;Ne;0;2;0;2
2408;"Gintarėlis (Didlaukio g. 35)";PAPŪGĖLĖS;4348245746;Ne;0;2;0;2
2409;"Gintarėlis (Didlaukio g. 35)";PAPŪGĖLĖS;1400817076;Ne;5;0;1;6
2410;"Gintarėlis (Didlaukio g. 35)";PAPŪGĖLĖS;3091731769;Ne;7;1;0;8
2411;"Gintarėlis (Didlaukio g. 35)";PAPŪGĖLĖS;6484966941;Ne;0;4;0;4
2412;"Gintarėlis (Didlaukio g. 35)";PAPŪGĖLĖS;9004590065;Ne;8;1;0;9
2413;"Gintarėlis (Didlaukio g. 35)";PAPŪGĖLĖS;2624469768;Ne;0;2;1;3
2414;"Gintarėlis (Didlaukio g. 35)";PAPŪGĖLĖS;9622824643;Ne;14;0;0;14
2415;"Gintarėlis (Didlaukio g. 35)";PAPŪGĖLĖS;8516817506;Ne;0;8;0;8
2416;"Gintarėlis (Didlaukio g. 35)";PAPŪGĖLĖS;4809352525;Ne;2;0;0;2
2417;"Gintarėlis (Didlaukio g. 35)";PAPŪGĖLĖS;1371258551;Ne;4;1;0;5
2418;"Gintarėlis (Didlaukio g. 35)";PAPŪGĖLĖS;9970786396;Ne;8;2;0;10
2419;"Gintarėlis (Didlaukio g. 35)";PAPŪGĖLĖS;7118758040;Ne;0;1;0;1
2420;"Gintarėlis (Didlaukio g. 35)";PAPŪGĖLĖS;8213388778;Ne;1;0;0;1
2421;"Gintarėlis (Didlaukio g. 35)";PAPŪGĖLĖS;8355089218;Ne;1;2;0;3
2422;"Gintarėlis (Didlaukio g. 35)";PAPŪGĖLĖS;8471302686;Ne;13;2;0;15
2423;"Gintarėlis (Didlaukio g. 35)";PAPŪGĖLĖS;4266286613;Ne;3;1;0;4
2424;"Gintarėlis (Didlaukio g. 35)";SPINDULIUKAI;8498936096;Ne;1;0;0;1
2425;"Gintarėlis (Didlaukio g. 35)";SPINDULIUKAI;8913652291;Ne;4;0;0;4
2426;"Gintarėlis (Didlaukio g. 35)";SPINDULIUKAI;2485750596;Ne;11;0;0;11
2427;"Gintarėlis (Didlaukio g. 35)";SPINDULIUKAI;8610886062;Ne;3;1;0;4
2428;"Gintarėlis (Didlaukio g. 35)";SPINDULIUKAI;5811396263;Ne;0;4;0;4
2429;"Gintarėlis (Didlaukio g. 35)";SPINDULIUKAI;1511718436;Ne;0;5;0;5
2430;"Gintarėlis (Didlaukio g. 35)";SPINDULIUKAI;1768789948;Ne;1;0;0;1
2431;"Gintarėlis (Didlaukio g. 35)";SPINDULIUKAI;2595566032;Ne;2;0;0;2
2432;"Gintarėlis (Didlaukio g. 35)";SPINDULIUKAI;2235045173;Ne;6;0;0;6
2433;"Gintarėlis (Didlaukio g. 35)";SPINDULIUKAI;9494521554;Ne;0;4;0;4
2434;"Gintarėlis (Didlaukio g. 35)";SPINDULIUKAI;7494884360;Ne;0;2;0;2
2435;"Gintarėlis (Didlaukio g. 35)";SPINDULIUKAI;1648843117;Ne;11;2;0;13
2436;"Gintarėlis (Didlaukio g. 35)";SPINDULIUKAI;7147842224;Ne;0;1;0;1
2437;"Gintarėlis (Didlaukio g. 35)";SPINDULIUKAI;5783939567;Ne;0;0;3;3
2438;"Gintarėlis (Didlaukio g. 35)";SPINDULIUKAI;7674351459;Ne;0;1;0;1
2439;"Gintarėlis (Didlaukio g. 35)";SPINDULIUKAI;1861324153;Ne;0;2;0;2
2440;"Gintarėlis (Didlaukio g. 35)";SPINDULIUKAI;3457974670;Ne;1;2;0;3
2441;"Gintarėlis (Didlaukio g. 35)";SPINDULIUKAI;6080108998;Ne;1;2;0;3
2442;"Gintarėlis (Didlaukio g. 35)";SPINDULIUKAI;6655645997;Ne;1;2;0;3
2443;"Gintarėlis (Didlaukio g. 35)";SPINDULIUKAI;4484711857;Ne;1;0;0;1
2444;"Gintarėlis (Didlaukio g. 35)";SPINDULIUKAI;6292664833;Ne;1;0;0;1
2445;"Gintarėlis (Didlaukio g. 35)";LAŠIUKAI;5717123412;Taip;4;4;0;8
2446;"Gintarėlis (Didlaukio g. 35)";LAŠIUKAI;3794027499;Ne;4;1;0;5
2447;"Gintarėlis (Didlaukio g. 35)";LAŠIUKAI;7813187438;Ne;0;1;0;1
2448;"Gintarėlis (Didlaukio g. 35)";LAŠIUKAI;6561070982;Ne;5;0;0;5
2449;"Gintarėlis (Didlaukio g. 35)";LAŠIUKAI;2256002308;Ne;6;0;0;6
2450;"Gintarėlis (Didlaukio g. 35)";LAŠIUKAI;1327681704;Ne;0;2;0;2
2451;"Gintarėlis (Didlaukio g. 35)";LAŠIUKAI;7123016029;Taip;0;1;0;1
2452;"Gintarėlis (Didlaukio g. 35)";LAŠIUKAI;7976989629;Ne;7;0;0;7
2453;"Gintarėlis (Didlaukio g. 35)";LAŠIUKAI;6545866812;Taip;1;2;0;3
2454;"Gintarėlis (Didlaukio g. 35)";LAŠIUKAI;5467958458;Ne;0;3;0;3
2455;"Gintarėlis (Didlaukio g. 35)";MEŠKUČIAI;2926488239;Ne;0;1;0;1
2456;"Gintarėlis (Didlaukio g. 35)";MEŠKUČIAI;5187894822;Ne;0;2;0;2
2457;"Gintarėlis (Didlaukio g. 35)";MEŠKUČIAI;3630567294;Ne;2;1;0;3
2458;"Gintarėlis (Didlaukio g. 35)";MEŠKUČIAI;5181872438;Ne;0;1;0;1
2459;"Gintarėlis (Didlaukio g. 35)";MEŠKUČIAI;1565802953;Ne;0;20;0;20
2460;"Gintarėlis (Didlaukio g. 35)";MEŠKUČIAI;2072435242;Ne;2;0;0;2
2461;"Gintarėlis (Didlaukio g. 35)";MEŠKUČIAI;4356211536;Taip;6;5;0;11
2462;"Gintarėlis (Didlaukio g. 35)";MEŠKUČIAI;1502740714;Ne;1;1;0;2
2463;"Gintarėlis (Didlaukio g. 35)";MEŠKUČIAI;6636835034;Ne;0;1;0;1
2464;"Gintarėlis (Didlaukio g. 35)";MEŠKUČIAI;3830154353;Taip;0;1;0;1
2465;"Gintarėlis (Didlaukio g. 35)";MEŠKUČIAI;3947405446;Ne;2;1;0;3
2466;"Gintarėlis (Didlaukio g. 35)";MEŠKUČIAI;7948438165;Ne;0;1;0;1
2467;"Gintarėlis (Didlaukio g. 35)";MEŠKUČIAI;4642142931;Ne;0;3;0;3
2468;"Gintarėlis (Didlaukio g. 35)";MEŠKUČIAI;9017592249;Ne;2;1;0;3
2469;"Gintarėlis (Didlaukio g. 35)";MEŠKUČIAI;8375475174;Ne;0;13;0;13
2470;"Gintarėlis (Didlaukio g. 35)";MEŠKUČIAI;7029401386;Ne;7;0;0;7
2471;"Gintarėlis (Didlaukio g. 35)";MEŠKUČIAI;1790629500;Ne;6;0;0;6
2472;"Gintarėlis (Didlaukio g. 35)";KAČIUKAI;3665764153;Ne;2;2;0;4
2473;"Gintarėlis (Didlaukio g. 35)";KAČIUKAI;9774056578;Ne;2;2;0;4
2474;"Gintarėlis (Didlaukio g. 35)";KAČIUKAI;2212296954;Ne;7;1;0;8
2475;"Gintarėlis (Didlaukio g. 35)";KAČIUKAI;9825811100;Ne;2;0;0;2
2476;"Gintarėlis (Didlaukio g. 35)";KAČIUKAI;1011749698;Taip;3;4;4;11
2477;"Gintarėlis (Didlaukio g. 35)";KAČIUKAI;8261770154;Ne;0;2;0;2
2478;"Gintarėlis (Didlaukio g. 35)";KAČIUKAI;7061545258;Ne;2;2;0;4
2479;"Gintarėlis (Didlaukio g. 35)";KAČIUKAI;5436695400;Ne;3;2;1;6
2480;"Gintarėlis (Didlaukio g. 35)";KAČIUKAI;5921751507;Ne;5;1;0;6
2481;"Gintarėlis (Didlaukio g. 35)";KAČIUKAI;9450900915;Ne;6;0;0;6
2482;"Gintarėlis (Didlaukio g. 35)";KAČIUKAI;5153948767;Ne;0;2;0;2
2483;"Gintarėlis (Didlaukio g. 35)";KAČIUKAI;3814485627;Ne;7;0;0;7
2484;"Gintarėlis (Didlaukio g. 35)";KAČIUKAI;1571260478;Ne;1;0;0;1
2485;"Gintarėlis (Didlaukio g. 35)";KAČIUKAI;9244715396;Ne;15;0;0;15
2486;"Gintarėlis (Didlaukio g. 35)";KAČIUKAI;3015327416;Ne;0;4;0;4
2487;"Gintarėlis (Didlaukio g. 35)";KIŠKUČIAI;3921015919;Taip;0;2;0;2
2488;"Gintarėlis (Didlaukio g. 35)";KIŠKUČIAI;7143014339;Ne;3;1;0;4
2489;"Gintarėlis (Didlaukio g. 35)";KIŠKUČIAI;1918879534;Ne;17;0;0;17
2490;"Gintarėlis (Didlaukio g. 35)";KIŠKUČIAI;7509100750;Ne;0;3;0;3
2491;"Gintarėlis (Didlaukio g. 35)";KIŠKUČIAI;6239242631;Ne;7;0;0;7
2492;"Gintarėlis (Didlaukio g. 35)";KIŠKUČIAI;5965570522;Ne;0;1;0;1
2493;"Gintarėlis (Didlaukio g. 35)";KIŠKUČIAI;8286814809;Taip;4;1;0;5
2494;"Gintarėlis (Didlaukio g. 35)";KIŠKUČIAI;3839660368;Ne;2;2;0;4
2495;"Gintarėlis (Didlaukio g. 35)";KIŠKUČIAI;5509394003;Ne;4;0;0;4
2496;"Gintarėlis (Didlaukio g. 35)";KIŠKUČIAI;9501012756;Ne;5;2;0;7
2497;"Gintarėlis (Didlaukio g. 35)";KIŠKUČIAI;7629635034;Taip;9;0;1;10
2498;"Gintarėlis (Didlaukio g. 35)";KIŠKUČIAI;1918458858;Ne;3;0;0;3
2499;"Gintarėlis (Didlaukio g. 35)";KIŠKUČIAI;8410642485;Ne;0;0;1;1
2500;"Gintarėlis (Didlaukio g. 35)";KIŠKUČIAI;3235154374;Ne;0;2;0;2
2501;"Gintarėlis (Didlaukio g. 35)";KIŠKUČIAI;6047468576;Taip;3;0;0;3
2502;"Gintarėlis (Didlaukio g. 35)";BORUŽĖLĖS;2499727321;Ne;15;0;0;15
2503;"Gintarėlis (Didlaukio g. 35)";BORUŽĖLĖS;6133476137;Ne;17;0;0;17
2504;"Gintarėlis (Didlaukio g. 35)";BORUŽĖLĖS;6751822184;Ne;0;3;0;3
2505;"Gintarėlis (Didlaukio g. 35)";BORUŽĖLĖS;8721340357;Ne;3;0;1;4
2506;"Gintarėlis (Didlaukio g. 35)";BORUŽĖLĖS;1482227839;Ne;0;3;0;3
2507;"Gintarėlis (Didlaukio g. 35)";BORUŽĖLĖS;3876016666;Ne;2;0;0;2
2508;"Gintarėlis (Didlaukio g. 35)";BORUŽĖLĖS;5338409090;Ne;0;2;2;4
2509;"Gintarėlis (Didlaukio g. 35)";BORUŽĖLĖS;8403881160;Ne;0;9;0;9
2510;"Gintarėlis (Didlaukio g. 35)";BORUŽĖLĖS;2809388552;Ne;0;0;4;4
2511;"Gintarėlis (Didlaukio g. 35)";BORUŽĖLĖS;2488622623;Taip;0;1;0;1
2512;"Gintarėlis (Didlaukio g. 35)";BORUŽĖLĖS;2482981227;Ne;6;0;0;6
2513;"Gintarėlis (Didlaukio g. 35)";BORUŽĖLĖS;8279078612;Ne;0;4;3;7
2514;"Gintarėlis (Didlaukio g. 35)";BORUŽĖLĖS;4146454470;Ne;10;0;0;10
2515;"Gintarėlis (Didlaukio g. 35)";EŽIUKAI;1082941468;Ne;3;3;0;6
2516;"Gintarėlis (Didlaukio g. 35)";EŽIUKAI;8529974367;Ne;5;0;0;5
2517;"Gintarėlis (Didlaukio g. 35)";EŽIUKAI;4623909811;Ne;5;2;0;7
2518;"Gintarėlis (Didlaukio g. 35)";EŽIUKAI;9279399214;Taip;7;1;0;8
2519;"Gintarėlis (Didlaukio g. 35)";EŽIUKAI;3357866319;Taip;0;2;0;2
2520;"Gintarėlis (Didlaukio g. 35)";EŽIUKAI;2814569415;Ne;0;2;0;2
2521;"Gintarėlis (Didlaukio g. 35)";EŽIUKAI;5355691986;Ne;0;2;0;2
2522;"Gintarėlis (Didlaukio g. 35)";EŽIUKAI;5796729245;Ne;0;2;0;2
2523;"Gintarėlis (Didlaukio g. 35)";EŽIUKAI;3792697409;Ne;3;0;0;3
2524;"Gintarėlis (Didlaukio g. 35)";EŽIUKAI;8287685690;Ne;0;2;0;2
2525;"Gintarėlis (Didlaukio g. 35)";EŽIUKAI;7815317644;Ne;0;2;3;5
2526;"Gintarėlis (Didlaukio g. 35)";EŽIUKAI;6914904213;Ne;2;1;0;3
2527;"Gintarėlis (Didlaukio g. 35)";EŽIUKAI;1696337909;Ne;2;1;0;3
2528;"Gintarėlis (Didlaukio g. 35)";EŽIUKAI;8116557698;Taip;0;7;0;7
2529;"Gintarėlis (Didlaukio g. 35)";EŽIUKAI;6862629244;Ne;9;1;0;10
2530;"Gintarėlis (Didlaukio g. 35)";EŽIUKAI;3398936974;Ne;0;2;0;2
2531;"Gintarėlis (Didlaukio g. 35)";EŽIUKAI;8704248985;Ne;0;12;0;12
2532;"Gintarėlis (Didlaukio g. 35)";"SAULĖS ZUIKUČIAI";5336654560;Ne;0;4;0;4
2533;"Gintarėlis (Didlaukio g. 35)";"SAULĖS ZUIKUČIAI";3732252177;Ne;0;4;0;4
2534;"Gintarėlis (Didlaukio g. 35)";"SAULĖS ZUIKUČIAI";7004430575;Ne;2;1;0;3
2535;"Gintarėlis (Didlaukio g. 35)";"SAULĖS ZUIKUČIAI";4579612197;Ne;5;0;0;5
2536;"Gintarėlis (Didlaukio g. 35)";"SAULĖS ZUIKUČIAI";4127749930;Ne;11;0;0;11
2537;"Gintarėlis (Didlaukio g. 35)";"SAULĖS ZUIKUČIAI";5594809861;Ne;0;14;0;14
2538;"Gintarėlis (Didlaukio g. 35)";"SAULĖS ZUIKUČIAI";5064767935;Ne;12;0;0;12
2539;"Gintarėlis (Didlaukio g. 35)";"SAULĖS ZUIKUČIAI";8170509526;Ne;14;0;0;14
2540;"Gintarėlis (Didlaukio g. 35)";"SAULĖS ZUIKUČIAI";1408481989;Ne;7;0;0;7
2541;"Gintarėlis (Didlaukio g. 35)";"SAULĖS ZUIKUČIAI";5109775795;Ne;10;0;0;10
2542;"Gintarėlis (Didlaukio g. 35)";"SAULĖS ZUIKUČIAI";4811778274;Ne;2;1;0;3
2543;"Gintarėlis (Didlaukio g. 35)";"SAULĖS ZUIKUČIAI";1158055621;Taip;0;1;0;1
2544;"Gintarėlis (Didlaukio g. 35)";"SAULĖS ZUIKUČIAI";1474802737;Ne;8;2;0;10
2545;"Gintarėlis (Didlaukio g. 35)";"SAULĖS ZUIKUČIAI";4199030732;Ne;17;0;0;17
2546;"Gintarėlis (Didlaukio g. 35)";Šypsenėlės;3575375401;Ne;0;0;13;13
2547;"Gintarėlis (Didlaukio g. 35)";Šypsenėlės;3575375401;Ne;0;0;13;13
2548;"Gintarėlis (Didlaukio g. 35)";Šypsenėlės;3575375401;Ne;0;0;13;13
2549;"Gintarėlis (Didlaukio g. 35)";Šypsenėlės;9020619501;Ne;4;2;0;6
2550;"Gintarėlis (Didlaukio g. 35)";Šypsenėlės;5120761293;Ne;3;0;0;3
2551;"Gintarėlis (Didlaukio g. 35)";Šypsenėlės;7337543180;Ne;0;2;0;2
2552;"Gintarėlis (Didlaukio g. 35)";Šypsenėlės;7337543180;Ne;0;2;0;2
2553;"Gintarėlis (Didlaukio g. 35)";Šypsenėlės;7337543180;Ne;0;2;0;2
2554;"Gintarėlis (Didlaukio g. 35)";Šypsenėlės;1567290856;Ne;9;0;0;9
2555;"Gintarėlis (Didlaukio g. 35)";Šypsenėlės;7661638176;Taip;0;2;0;2
2556;"Gintarėlis (Didlaukio g. 35)";Šypsenėlės;9477018713;Ne;0;1;0;1
2557;"Gintarėlis (Didlaukio g. 35)";Šypsenėlės;9477018713;Ne;0;1;0;1
2558;"Gintarėlis (Didlaukio g. 35)";Šypsenėlės;9477018713;Ne;0;1;0;1
2559;"Gintarėlis (Didlaukio g. 35)";Šypsenėlės;3088663209;Ne;0;2;0;2
2560;"Gintarėlis (Didlaukio g. 35)";Šypsenėlės;3459439843;Ne;0;7;0;7
2561;"Gintarėlis (Didlaukio g. 35)";Šypsenėlės;1872534206;Taip;3;0;0;3
2562;"Gintarėlis (Didlaukio g. 35)";Šypsenėlės;4334349824;Ne;0;1;0;1
2563;"Gintarėlis (Didlaukio g. 35)";Šypsenėlės;9954282865;Ne;0;2;0;2
2564;"Gintarėlis (Didlaukio g. 35)";Šypsenėlės;8768094601;Taip;8;0;0;8
2565;"Gintarėlis (Didlaukio g. 35)";Šypsenėlės;5834772263;Ne;7;1;0;8
2566;"Gintarėlis (Didlaukio g. 35)";Šypsenėlės;1367305617;Taip;5;2;0;7
2567;"Gintarėlis (Didlaukio g. 35)";Šypsenėlės;7537009709;Ne;3;0;0;3
2568;"Gintarėlis (Didlaukio g. 35)";Šypsenėlės;1875958358;Ne;6;0;0;6
2569;"Gintarėlis (Didlaukio g. 35)";Šypsenėlės;4079793067;Ne;5;0;0;5
2570;"Gintarėlis (Didlaukio g. 35)";Smalsučiai;7486822380;Taip;0;2;3;5
2571;"Gintarėlis (Didlaukio g. 35)";Smalsučiai;8387819754;Ne;0;2;0;2
2572;"Gintarėlis (Didlaukio g. 35)";Smalsučiai;8292698645;Taip;10;2;0;12
2573;"Gintarėlis (Didlaukio g. 35)";Smalsučiai;1876292168;Ne;4;12;0;16
2574;"Gintarėlis (Didlaukio g. 35)";Smalsučiai;8754068506;Taip;0;2;0;2
2575;"Gintarėlis (Didlaukio g. 35)";Smalsučiai;1537528341;Taip;0;2;0;2
2576;"Gintarėlis (Didlaukio g. 35)";Smalsučiai;6578588403;Ne;4;1;1;6
2577;"Gintarėlis (Didlaukio g. 35)";Smalsučiai;8815001033;Ne;0;2;0;2
2578;"Gintarėlis (Didlaukio g. 35)";Smalsučiai;1433395471;Ne;4;2;0;6
2579;"Gintarėlis (Didlaukio g. 35)";Smalsučiai;1766430091;Ne;0;1;2;3
2580;"Gintarėlis (Didlaukio g. 35)";Smalsučiai;9787141660;Ne;4;3;0;7
2581;"Gintarėlis (Didlaukio g. 35)";Smalsučiai;9533972547;Ne;7;0;8;15
2582;"Gintarėlis (Didlaukio g. 35)";Smalsučiai;1337062268;Ne;6;0;1;7
2583;"Gintarėlis (Didlaukio g. 35)";Gintariukai;6244066576;Ne;0;20;0;20
2584;"Gintarėlis (Didlaukio g. 35)";Gintariukai;6056471440;Ne;11;2;0;13
2585;"Gintarėlis (Didlaukio g. 35)";Gintariukai;9374716095;Ne;5;7;0;12
2586;"Gintarėlis (Didlaukio g. 35)";Gintariukai;8999913328;Ne;5;9;0;14
2587;"Gintarėlis (Didlaukio g. 35)";Gintariukai;6357825030;Ne;12;1;0;13
2588;"Gintarėlis (Didlaukio g. 35)";Gintariukai;3044631569;Ne;12;0;1;13
2589;"Gintarėlis (Didlaukio g. 35)";Gintariukai;8329253118;Taip;5;0;0;5
2590;"Gintarėlis (Didlaukio g. 35)";Gintariukai;1848386512;Ne;5;0;1;6
2591;"Gintarėlis (Didlaukio g. 35)";Gintariukai;7427026272;Ne;0;7;0;7
2592;"Gintarėlis (Didlaukio g. 35)";GILIUKAI;3973889495;Ne;1;0;0;1
2593;"Gintarėlis (Didlaukio g. 35)";GILIUKAI;4749559606;Ne;5;2;0;7
2594;"Gintarėlis (Didlaukio g. 35)";GILIUKAI;2178808286;Ne;0;12;0;12
2595;"Gintarėlis (Didlaukio g. 35)";GILIUKAI;9073499040;Ne;3;5;0;8
2596;"Gintarėlis (Didlaukio g. 35)";GILIUKAI;6711773127;Ne;0;2;1;3
2597;"Gintarėlis (Didlaukio g. 35)";GILIUKAI;8805356168;Ne;3;0;0;3
2598;"Gintarėlis (Didlaukio g. 35)";GILIUKAI;4751066825;Ne;4;1;0;5
2599;"Gintarėlis (Didlaukio g. 35)";GILIUKAI;7562170082;Ne;8;8;0;16
2600;"Gintarėlis (Didlaukio g. 35)";GILIUKAI;7418672923;Ne;3;0;0;3
2601;"Gintarėlis (Didlaukio g. 35)";GILIUKAI;1039098192;Ne;9;2;0;11
2602;"Gintarėlis (Didlaukio g. 35)";GILIUKAI;9191264261;Ne;10;0;1;11
2603;"Gintarėlis (Didlaukio g. 35)";GILIUKAI;6042885133;Ne;0;2;0;2
2604;"Gintarėlis (Didlaukio g. 35)";GILIUKAI;3232990779;Ne;0;2;0;2
2605;"Gintarėlis (Didlaukio g. 35)";GILIUKAI;2920734274;Ne;0;0;1;1
2606;"Gintarėlis (Didlaukio g. 35)";GILIUKAI;8613554277;Ne;0;1;0;1
2607;"Gintarėlis (Didlaukio g. 35)";GILIUKAI;7573269886;Ne;0;2;1;3
2608;Giraitė;Aviliukas;4292730355;Ne;2;0;0;2
2609;Giraitė;Aviliukas;7001163828;Ne;1;0;1;2
2610;Giraitė;Aviliukas;6159650070;Ne;2;0;6;8
2611;Giraitė;Aviliukas;4758750245;Ne;0;0;1;1
2612;Giraitė;Aviliukas;2219854347;Ne;3;0;3;6
2613;Giraitė;Aviliukas;2338867192;Ne;8;0;0;8
2614;Giraitė;Aviliukas;3719285343;Ne;0;0;3;3
2615;Giraitė;Aviliukas;7807844145;Ne;2;0;0;2
2616;Giraitė;Aviliukas;3757900478;Ne;1;0;2;3
2617;Giraitė;Aviliukas;7876457529;Ne;1;0;1;2
2618;Giraitė;Aviliukas;3992069614;Taip;5;0;1;6
2619;Giraitė;Aviliukas;6121586335;Ne;0;0;6;6
2620;Giraitė;Aviliukas;4440444700;Ne;0;2;0;2
2621;Giraitė;Aviliukas;6296485105;Ne;2;0;4;6
2622;Giraitė;Aviliukas;5356944812;Ne;5;0;1;6
2623;Giraitė;Aviliukas;4554565631;Ne;10;0;0;10
2624;Giraitė;LapiukaI;6141730004;Ne;11;0;0;11
2625;Giraitė;LapiukaI;6325909670;Ne;2;4;0;6
2626;Giraitė;LapiukaI;7831526566;Ne;2;0;1;3
2627;Giraitė;LapiukaI;5006156109;Ne;0;2;0;2
2628;Giraitė;LapiukaI;4663343304;Ne;1;1;0;2
2629;Giraitė;LapiukaI;1974159110;Ne;6;0;1;7
2630;Giraitė;LapiukaI;5532639133;Ne;9;0;0;9
2631;Giraitė;LapiukaI;5902161665;Ne;5;3;0;8
2632;Giraitė;LapiukaI;4955786826;Taip;0;1;0;1
2633;Giraitė;LapiukaI;4260343903;Taip;4;0;0;4
2634;Giraitė;LapiukaI;9088123796;Ne;3;0;1;4
2635;Giraitė;LapiukaI;7772177095;Ne;3;0;0;3
2636;Giraitė;LapiukaI;2880342138;Ne;1;0;0;1
2637;Giraitė;LapiukaI;9503157590;Ne;0;5;0;5
2638;Giraitė;LapiukaI;5471577047;Ne;2;0;0;2
2639;Giraitė;Voveriukai;8612554184;Ne;0;9;0;9
2640;Giraitė;Voveriukai;1436302175;Ne;0;0;1;1
2641;Giraitė;Voveriukai;3039445733;Ne;10;0;0;10
2642;Giraitė;Voveriukai;8050306951;Ne;14;0;0;14
2643;Giraitė;Voveriukai;1262854023;Ne;13;0;0;13
2644;Giraitė;Voveriukai;7260229442;Ne;7;0;0;7
2645;Giraitė;Voveriukai;1126576745;Taip;10;0;1;11
2646;Giraitė;Voveriukai;4719547384;Ne;10;0;0;10
2647;Giraitė;Voveriukai;1772997796;Ne;15;2;0;17
2648;Giraitė;Voveriukai;4008393576;Ne;4;4;0;8
2649;Giraitė;Voveriukai;9281071794;Taip;3;0;0;3
2650;Giraitė;Voveriukai;9766107773;Taip;20;0;0;20
2651;Giraitė;Voveriukai;9386943162;Ne;4;1;0;5
2652;Giraitė;Voveriukai;3613828494;Ne;1;0;2;3
2653;Giraitė;Voveriukai;2686885139;Taip;8;0;0;8
2654;Giraitė;Voveriukai;9764802294;Ne;9;0;0;9
2655;Giraitė;Voveriukai;2726766768;Taip;12;0;0;12
2656;Giraitė;Voveriukai;6565165993;Ne;0;5;0;5
2657;Giraitė;Voveriukai;7392324344;Taip;10;0;2;12
2658;Giraitė;Grybukai;7354834895;Ne;2;0;0;2
2659;Giraitė;Grybukai;8799195526;Ne;0;0;1;1
2660;Giraitė;Grybukai;2177856916;Ne;0;3;0;3
2661;Giraitė;Grybukai;4387282125;Ne;0;2;0;2
2662;Giraitė;Grybukai;6225092500;Ne;0;0;1;1
2663;Giraitė;Grybukai;4137699629;Ne;3;0;0;3
2664;Giraitė;Grybukai;7919088987;Ne;4;0;0;4
2665;Giraitė;Grybukai;4773517160;Ne;0;0;1;1
2666;Giraitė;Grybukai;5616242311;Ne;0;0;1;1
2667;Giraitė;Grybukai;4932174149;Ne;3;1;0;4
2668;Giraitė;Grybukai;3875214088;Ne;0;1;0;1
2669;Giraitė;Grybukai;5202562049;Ne;4;2;0;6
2670;Giraitė;Grybukai;3607198556;Ne;0;4;0;4
2671;Giraitė;Grybukai;3896789232;Ne;0;0;1;1
2672;Giraitė;Riešutėliai;5365264259;Taip;5;0;0;5
2673;Giraitė;Riešutėliai;3158451613;Ne;1;0;0;1
2674;Giraitė;Riešutėliai;7910736839;Ne;4;0;0;4
2675;Giraitė;Riešutėliai;3308792461;Ne;4;0;0;4
2676;Giraitė;Riešutėliai;7423115504;Ne;8;0;0;8
2677;Giraitė;Riešutėliai;6838184704;Ne;3;1;0;4
2678;Giraitė;Riešutėliai;5161383686;Ne;2;1;0;3
2679;Giraitė;Riešutėliai;5148257412;Ne;3;0;0;3
2680;Giraitė;Riešutėliai;3839432744;Ne;5;0;0;5
2681;Giraitė;Riešutėliai;6288016799;Ne;0;0;2;2
2682;Giraitė;Riešutėliai;3278871662;Ne;2;1;0;3
2683;Giraitė;Riešutėliai;4168934880;Ne;4;2;0;6
2684;Giraitė;Riešutėliai;6337090583;Ne;10;0;1;11
2685;Giraitė;Riešutėliai;3843211767;Ne;4;1;0;5
2686;Giraitė;Meškiukai;9751078590;Ne;3;0;0;3
2687;Giraitė;Meškiukai;5447466102;Ne;6;4;0;10
2688;Giraitė;Meškiukai;5574589536;Ne;13;0;0;13
2689;Giraitė;Meškiukai;7744101334;Taip;0;1;0;1
2690;Giraitė;Meškiukai;5876711899;Ne;3;0;0;3
2691;Giraitė;Meškiukai;9589760939;Ne;4;0;0;4
2692;Giraitė;Meškiukai;3144724475;Taip;10;2;0;12
2693;Giraitė;Meškiukai;8427713392;Taip;10;0;0;10
2694;Giraitė;Meškiukai;5525538498;Ne;20;0;0;20
2695;Giraitė;Meškiukai;2867735227;Ne;5;0;0;5
2696;Giraitė;Meškiukai;4681342624;Ne;6;3;0;9
2697;Giraitė;Meškiukai;6799728348;Taip;5;0;0;5
2698;Giraitė;Meškiukai;4431964254;Taip;6;0;0;6
2699;Giraitė;Meškiukai;9669849051;Ne;10;2;0;12
2700;Giraitė;Meškiukai;4946664007;Ne;1;0;0;1
2701;Giraitė;Meškiukai;1170698327;Ne;5;0;0;5
2702;Giraitė;Meškiukai;6865072274;Ne;17;0;0;17
2703;Giraitė;Meškiukai;3108521607;Ne;8;3;0;11
2704;Giraitė;Meškiukai;3612494313;Ne;5;0;0;5
2705;Giraitė;Meškiukai;2076989836;Ne;8;0;0;8
2706;Giraitė;Uogelės;1729871315;Ne;4;0;0;4
2707;Giraitė;Uogelės;2102237550;Ne;4;2;0;6
2708;Giraitė;Uogelės;5255040944;Ne;0;1;0;1
2709;Giraitė;Uogelės;7094750784;Taip;0;1;1;2
2710;Giraitė;Uogelės;1356340471;Ne;5;0;0;5
2711;Giraitė;Uogelės;7377939409;Ne;0;3;0;3
2712;Giraitė;Uogelės;4288937528;Ne;7;0;4;11
2713;Giraitė;Uogelės;6293111179;Ne;0;1;0;1
2714;Giraitė;Uogelės;7390702355;Ne;0;2;0;2
2715;Giraitė;Šaltinėlis;3334974747;Ne;8;0;0;8
2716;Giraitė;Šaltinėlis;1125576830;Ne;0;0;1;1
2717;Giraitė;Šaltinėlis;2223501723;Taip;7;0;0;7
2718;Giraitė;Šaltinėlis;3262098794;Ne;8;0;1;9
2719;Giraitė;Šaltinėlis;8938565070;Ne;8;1;0;9
2720;Giraitė;Šaltinėlis;4094300540;Ne;12;1;0;13
2721;Giraitė;Šaltinėlis;7831610906;Taip;7;0;6;13
2722;Giraitė;Šaltinėlis;8686898517;Ne;10;0;0;10
2723;Giraitė;Šaltinėlis;6897620778;Ne;9;0;0;9
2724;Giraitė;Šaltinėlis;2652478107;Ne;5;0;0;5
2725;Giraitė;Šaltinėlis;3498087339;Ne;3;1;0;4
2726;Giraitė;Boružėlės;5543356573;Taip;6;0;0;6
2727;Giraitė;Boružėlės;8552588816;Ne;4;0;0;4
2728;Giraitė;Boružėlės;4315974617;Ne;5;0;0;5
2729;Giraitė;Boružėlės;2782467129;Ne;4;0;0;4
2730;Giraitė;Boružėlės;7149126803;Ne;0;0;2;2
2731;Giraitė;Boružėlės;6989400181;Ne;18;0;0;18
2732;Giraitė;Boružėlės;8163272129;Ne;2;0;1;3
2733;Giraitė;Boružėlės;2463291913;Ne;5;0;0;5
2734;Giraitė;Boružėlės;2483204684;Ne;15;0;0;15
2735;Giraitė;Boružėlės;3620400530;Ne;5;0;0;5
2736;Giraitė;Boružėlės;3801118082;Ne;2;0;0;2
2737;Giraitė;Boružėlės;4876614491;Ne;9;1;0;10
2738;Giraitė;Boružėlės;3035520579;Ne;2;0;1;3
2739;Giraitė;Boružėlės;2344506210;Ne;4;0;0;4
2740;Giraitė;Gandriukai;8525380061;Ne;0;3;1;4
2741;Giraitė;Gandriukai;7767820565;Ne;4;0;0;4
2742;Giraitė;Gandriukai;8819218663;Ne;4;0;0;4
2743;Giraitė;Gandriukai;7269074498;Ne;2;0;0;2
2744;Giraitė;Gandriukai;1490748887;Taip;2;0;1;3
2745;Giraitė;Gandriukai;7789414361;Ne;6;1;0;7
2746;Giraitė;Gandriukai;9850432917;Ne;4;0;0;4
2747;Giraitė;Gandriukai;2313273738;Ne;0;2;0;2
2748;Giraitė;Gandriukai;8101302584;Taip;11;0;2;13
2749;Giraitė;Gandriukai;3027761044;Ne;1;0;0;1
2750;Giraitė;Gandriukai;4371263826;Ne;5;1;0;6
2751;Giraitė;Gandriukai;1227555563;Ne;2;0;0;2
2752;Giraitė;ŽVIRBLIUKAI;6715354865;Ne;3;0;0;3
2753;Giraitė;ŽVIRBLIUKAI;8461725999;Ne;5;0;3;8
2754;Giraitė;ŽVIRBLIUKAI;5086296808;Ne;0;7;0;7
2755;Giraitė;ŽVIRBLIUKAI;9669916418;Ne;0;0;3;3
2756;Giraitė;ŽVIRBLIUKAI;3481695682;Ne;0;2;0;2
2757;Giraitė;ŽVIRBLIUKAI;7678134658;Ne;0;0;2;2
2758;Giraitė;ŽVIRBLIUKAI;9471560738;Ne;0;2;0;2
2759;Giraitė;ŽVIRBLIUKAI;6677278422;Taip;3;0;0;3
2760;Giraitė;ŽVIRBLIUKAI;7230351549;Ne;3;0;0;3
2761;Giraitė;ŽVIRBLIUKAI;9392127689;Ne;5;0;0;5
2762;Giraitė;ŽVIRBLIUKAI;2416162886;Taip;5;0;1;6
2763;Giraitė;ŽVIRBLIUKAI;7543605905;Ne;0;12;0;12
2764;Giraitė;ŽVIRBLIUKAI;4233170371;Ne;0;0;2;2
2765;Giraitė;ŽVIRBLIUKAI;3214528809;Ne;0;0;1;1
2766;Giraitė;ŽVIRBLIUKAI;5548434439;Ne;0;0;1;1
2767;Giraitė;ŽVIRBLIUKAI;4450822125;Ne;3;0;0;3
2768;Giraitė;ŽVIRBLIUKAI;6474975269;Ne;3;0;1;4
2769;Giraitė;Kiškeliai;8259691835;Ne;10;0;0;10
2770;Giraitė;Kiškeliai;8782435144;Ne;10;0;0;10
2771;Giraitė;Kiškeliai;3457058930;Ne;5;2;0;7
2772;Giraitė;Kiškeliai;8787203512;Ne;2;0;0;2
2773;Giraitė;Kiškeliai;9503522932;Ne;3;0;0;3
2774;Giraitė;Kiškeliai;3599734091;Ne;6;0;0;6
2775;Giraitė;Kiškeliai;8869418518;Ne;4;0;0;4
2776;Giraitė;Kiškeliai;7227780890;Taip;6;0;0;6
2777;Giraitė;Kiškeliai;4964803735;Ne;3;0;0;3
2778;Giraitė;Kiškeliai;4858846263;Ne;2;0;0;2
2779;Giraitė;Kiškeliai;8148626841;Ne;2;0;0;2
2780;Giraitė;Kiškeliai;9459699089;Ne;5;0;0;5
2781;Gudrutis;Gandriukų;3264829331;Ne;5;0;0;5
2782;Gudrutis;Gandriukų;7143849852;Ne;11;0;0;11
2783;Gudrutis;Gandriukų;4600814480;Ne;5;0;0;5
2784;Gudrutis;Gandriukų;5931281687;Ne;7;0;0;7
2785;Gudrutis;Gandriukų;5498218329;Ne;0;1;0;1
2786;Gudrutis;Gandriukų;9454206104;Ne;0;0;1;1
2787;Gudrutis;Gandriukų;5911423362;Ne;9;0;0;9
2788;Gudrutis;Gandriukų;3316297441;Ne;6;1;0;7
2789;Gudrutis;Gandriukų;1170008457;Ne;7;0;0;7
2790;Gudrutis;Gandriukų;2278368966;Ne;5;0;0;5
2791;Gudrutis;Gandriukų;3000289515;Ne;1;1;0;2
2792;Gudrutis;Gandriukų;6458053920;Ne;0;1;0;1
2793;Gudrutis;Gandriukų;2256458624;Ne;7;0;0;7
2794;Gudrutis;Gandriukų;2784392885;Ne;11;0;0;11
2795;Gudrutis;Gandriukų;3136349573;Taip;6;0;0;6
2796;Gudrutis;"Saulės zuikučių";7934673005;Ne;2;0;0;2
2797;Gudrutis;"Saulės zuikučių";1670550212;Taip;0;1;2;3
2798;Gudrutis;"Saulės zuikučių";5241856014;Taip;19;0;0;19
2799;Gudrutis;"Saulės zuikučių";8500911420;Ne;1;1;3;5
2800;Gudrutis;"Saulės zuikučių";5408444872;Ne;5;0;0;5
2801;Gudrutis;"Saulės zuikučių";9697445037;Ne;3;1;0;4
2802;Gudrutis;"Saulės zuikučių";6846653547;Ne;3;0;0;3
2803;Gudrutis;"Saulės zuikučių";3281890659;Ne;6;2;0;8
2804;Gudrutis;"Saulės zuikučių";2291393238;Ne;1;0;0;1
2805;Gudrutis;"Saulės zuikučių";1384696362;Ne;0;0;1;1
2806;Gudrutis;"Saulės zuikučių";2666772437;Ne;3;0;3;6
2807;Gudrutis;"Saulės zuikučių";2994309084;Ne;0;0;1;1
2808;Gudrutis;"Saulės zuikučių";9044566825;Taip;6;1;2;9
2809;Gudrutis;"Saulės zuikučių";9683107780;Ne;0;1;0;1
2810;Gudrutis;"Saulės zuikučių";1197649093;Ne;6;5;1;12
2811;Gudrutis;Pelėdžiukų;7955353991;Ne;0;5;0;5
2812;Gudrutis;Pelėdžiukų;2197278086;Ne;0;1;0;1
2813;Gudrutis;Pelėdžiukų;6358318238;Ne;0;1;0;1
2814;Gudrutis;Pelėdžiukų;8774935740;Taip;10;0;0;10
2815;Gudrutis;Pelėdžiukų;4844838728;Ne;6;0;0;6
2816;Gudrutis;Pelėdžiukų;1685531183;Ne;0;0;3;3
2817;Gudrutis;Pelėdžiukų;9253468183;Ne;5;2;0;7
2818;Gudrutis;Pelėdžiukų;7755882832;Ne;3;2;2;7
2819;Gudrutis;Pelėdžiukų;9297898193;Taip;12;0;0;12
2820;Gudrutis;Pelėdžiukų;7663746093;Ne;1;2;0;3
2821;Gudrutis;Pelėdžiukų;9784116399;Ne;0;0;1;1
2822;Gudrutis;Pelėdžiukų;8512130106;Ne;0;0;1;1
2823;Gudrutis;Pelėdžiukų;3919786807;Taip;2;1;4;7
2824;Gudrutis;Pelėdžiukų;1485530468;Ne;5;0;2;7
2825;Gudrutis;Pelėdžiukų;8598450150;Ne;18;0;0;18
2826;Gudrutis;Pelėdžiukų;2484715724;Ne;18;0;0;18
2827;Gudrutis;Pelėdžiukų;5508723821;Ne;3;2;0;5
2828;Gudrutis;BITUČIŲ;6700254479;Ne;0;0;13;13
2829;Gudrutis;BITUČIŲ;7773150642;Ne;0;0;2;2
2830;Gudrutis;BITUČIŲ;2293472716;Ne;0;1;0;1
2831;Gudrutis;BITUČIŲ;6835038962;Ne;2;0;0;2
2832;Gudrutis;BITUČIŲ;6731806925;Ne;9;0;0;9
2833;Gudrutis;BITUČIŲ;2118727861;Ne;0;0;1;1
2834;Gudrutis;BITUČIŲ;9701111916;Ne;5;0;0;5
2835;Gudrutis;BITUČIŲ;1725920873;Ne;7;0;2;9
2836;Gudrutis;BITUČIŲ;1901358996;Ne;4;0;0;4
2837;Gudrutis;BITUČIŲ;3646335609;Ne;2;0;2;4
2838;Gudrutis;BITUČIŲ;7871991275;Ne;0;0;2;2
2839;Gudrutis;BITUČIŲ;5580618896;Ne;0;0;2;2
2840;Gudrutis;BITUČIŲ;3625838131;Ne;5;1;0;6
2841;Gudrutis;BITUČIŲ;2337493193;Ne;5;0;0;5
2842;Gudrutis;BITUČIŲ;2408038213;Ne;3;0;1;4
2843;Gudrutis;BITUČIŲ;2764843216;Ne;3;1;0;4
2844;Gudrutis;BITUČIŲ;1012579870;Ne;0;0;2;2
2845;Gudrutis;Boružėlių;4623428212;Ne;9;0;5;14
2846;Gudrutis;Boružėlių;9893732913;Ne;12;0;0;12
2847;Gudrutis;Boružėlių;2807547699;Ne;6;0;0;6
2848;Gudrutis;Boružėlių;6326258371;Ne;2;0;1;3
2849;Gudrutis;Boružėlių;7033634744;Ne;2;0;2;4
2850;Gudrutis;Boružėlių;5748775407;Ne;5;0;0;5
2851;Gudrutis;Boružėlių;8296416202;Ne;5;0;0;5
2852;Gudrutis;Boružėlių;3959030593;Ne;9;0;0;9
2853;Gudrutis;Boružėlių;4672748361;Ne;6;0;0;6
2854;Gudrutis;Boružėlių;8081931247;Ne;6;0;0;6
2855;Gudrutis;Boružėlių;5382755416;Ne;13;0;1;14
2856;Gudrutis;Boružėlių;4546694746;Ne;6;0;0;6
2857;Gudrutis;Boružėlių;9948022627;Ne;8;0;1;9
2858;Gudrutis;Boružėlių;4540855641;Ne;8;0;0;8
2859;Gudrutis;Boružėlių;1277537891;Ne;6;0;6;12
2860;Gudrutis;Boružėlių;5121141955;Ne;6;0;0;6
2861;Gudrutis;Boružėlių;4691454736;Ne;7;0;0;7
2862;Gudrutis;Drugeliai;2497248749;Ne;7;0;0;7
2863;Gudrutis;Drugeliai;6284712576;Ne;0;0;2;2
2864;Gudrutis;Drugeliai;3797656483;Ne;4;0;3;7
2865;Gudrutis;Drugeliai;9200644104;Ne;4;0;4;8
2866;Gudrutis;Drugeliai;9096764346;Ne;2;1;0;3
2867;Gudrutis;Drugeliai;5306281458;Ne;13;0;0;13
2868;Gudrutis;Drugeliai;8783180638;Ne;13;0;0;13
2869;Gudrutis;Drugeliai;1737001982;Ne;14;0;0;14
2870;Gudrutis;Drugeliai;8525851058;Ne;5;0;0;5
2871;Gudrutis;Drugeliai;8080976400;Ne;12;0;0;12
2872;Gudrutis;Drugeliai;9808350750;Ne;0;1;0;1
2873;Gudrutis;Drugeliai;6101410750;Ne;8;2;2;12
2874;Gudrutis;Drugeliai;5710348070;Ne;8;0;2;10
2875;Gudrutis;Drugeliai;8843761360;Ne;8;0;2;10
2876;Gudrutis;Drugeliai;5590297232;Ne;0;1;3;4
2877;Gudrutis;Drugeliai;2827279258;Ne;0;0;1;1
2878;Gudrutis;Drugeliai;5093267385;Ne;5;0;4;9
2879;Gudrutis;Drugeliai;1364145110;Ne;6;0;0;6
2880;Gudrutis;Drugeliai;8803747496;Ne;10;0;0;10
2881;Gudrutis;Drugeliai;9714712791;Ne;2;0;1;3
2882;Gudrutis;Drugeliai;6063661969;Taip;9;0;0;9
2883;Gudrutis;Drugeliai;2435945253;Ne;4;0;0;4
2884;Gudrutis;Drugeliai;6268669142;Taip;0;0;1;1
2885;Jurginėlis;Ąžuoliukai;7309052653;Ne;1;0;0;1
2886;Jurginėlis;Ąžuoliukai;6168508647;Ne;12;0;0;12
2887;Jurginėlis;Ąžuoliukai;3933113321;Ne;4;10;0;14
2888;Jurginėlis;Ąžuoliukai;5861418459;Ne;2;6;0;8
2889;Jurginėlis;Ąžuoliukai;3562210465;Ne;1;0;0;1
2890;Jurginėlis;Ąžuoliukai;9029587175;Ne;3;0;0;3
2891;Jurginėlis;Ąžuoliukai;9889620429;Ne;2;0;0;2
2892;Jurginėlis;Ąžuoliukai;3324811458;Ne;5;0;0;5
2893;Jurginėlis;Ąžuoliukai;9850874714;Ne;5;0;0;5
2894;Jurginėlis;Ąžuoliukai;8174251359;Ne;4;0;0;4
2895;Jurginėlis;Ąžuoliukai;2447025385;Ne;12;0;0;12
2896;Jurginėlis;Ąžuoliukai;5313627252;Ne;14;0;0;14
2897;Jurginėlis;Žiogeliai;8159210242;Ne;7;9;0;16
2898;Jurginėlis;Žiogeliai;7251598691;Ne;0;11;0;11
2899;Jurginėlis;Žiogeliai;6906225772;Ne;1;3;0;4
2900;Jurginėlis;Žiogeliai;7010130915;Ne;3;0;3;6
2901;Jurginėlis;Žiogeliai;7907096012;Ne;15;0;1;16
2902;Jurginėlis;Žiogeliai;7250246853;Ne;0;8;0;8
2903;Jurginėlis;Žiogeliai;7300018733;Ne;7;0;0;7
2904;Jurginėlis;Žiogeliai;4674128568;Ne;0;5;0;5
2905;Jurginėlis;Žiogeliai;9305884152;Ne;0;4;0;4
2906;Jurginėlis;Žiogeliai;9716328349;Ne;0;20;0;20
2907;Jurginėlis;Žiogeliai;4441183185;Ne;0;2;0;2
2908;Jurginėlis;Žiogeliai;4502564783;Ne;3;0;0;3
2909;Jurginėlis;Žiogeliai;1937927553;Ne;2;0;1;3
2910;Jurginėlis;Žiogeliai;7527178332;Ne;0;2;0;2
2911;Jurginėlis;Žiogeliai;4682125116;Ne;0;3;0;3
2912;Jurginėlis;Žiogeliai;3920971621;Ne;5;2;0;7
2913;Jurginėlis;Žiogeliai;5037980414;Ne;4;0;0;4
2914;Jurginėlis;Pelėdžiukų;8844614653;Ne;6;0;0;6
2915;Jurginėlis;Pelėdžiukų;4466955830;Ne;14;0;0;14
2916;Jurginėlis;Pelėdžiukų;6932501634;Ne;1;0;0;1
2917;Jurginėlis;Pelėdžiukų;2248773321;Ne;1;0;0;1
2918;Jurginėlis;Pelėdžiukų;3675820817;Ne;1;2;0;3
2919;Jurginėlis;Pelėdžiukų;6285599044;Ne;8;0;0;8
2920;Jurginėlis;Pelėdžiukų;2982526236;Ne;5;0;0;5
2921;Jurginėlis;Pelėdžiukų;1537710974;Ne;3;0;0;3
2922;Jurginėlis;Pelėdžiukų;6594025023;Ne;0;2;0;2
2923;Jurginėlis;Pelėdžiukų;6124147401;Ne;7;0;0;7
2924;Jurginėlis;Pelėdžiukų;6648657850;Ne;9;0;0;9
2925;Jurginėlis;Pelėdžiukų;9139025010;Ne;5;0;0;5
2926;Jurginėlis;Pelėdžiukų;7554346190;Taip;2;0;0;2
2927;Jurginėlis;Pelėdžiukų;4555257132;Taip;1;0;0;1
2928;Jurginėlis;Boružėlių;6806704355;Ne;2;0;0;2
2929;Jurginėlis;Boružėlių;3091019969;Taip;5;0;0;5
2930;Jurginėlis;Boružėlių;9288380246;Ne;4;0;0;4
2931;Jurginėlis;Boružėlių;2837099502;Ne;1;0;0;1
2932;Jurginėlis;Boružėlių;2548920722;Taip;3;0;0;3
2933;Jurginėlis;Boružėlių;2263818210;Ne;3;0;0;3
2934;Jurginėlis;Boružėlių;4827340942;Ne;5;1;0;6
2935;Jurginėlis;Boružėlių;4463258777;Ne;2;0;0;2
2936;Jurginėlis;Boružėlių;2225892248;Ne;2;0;0;2
2937;Jurginėlis;Boružėlių;3462969423;Ne;0;3;0;3
2938;Jurginėlis;Boružėlių;7990015623;Ne;0;1;0;1
2939;Jurginėlis;Boružėlių;7486778826;Ne;0;6;0;6
2940;Jurginėlis;Boružėlių;4158502752;Ne;1;0;0;1
2941;Jurginėlis;Boružėlių;5242359650;Taip;0;6;0;6
2942;Jurginėlis;Boružėlių;3284464951;Ne;0;10;0;10
2943;Jurginėlis;Boružėlių;2536744421;Ne;0;20;0;20
2944;Jurginėlis;Bitučių;5984893389;Ne;0;5;0;5
2945;Jurginėlis;Bitučių;3079495897;Ne;2;0;0;2
2946;Jurginėlis;Bitučių;8727844649;Ne;0;0;5;5
2947;Jurginėlis;Bitučių;1455749921;Ne;0;4;0;4
2948;Jurginėlis;Bitučių;2417314519;Ne;5;0;0;5
2949;Jurginėlis;Bitučių;9760394658;Taip;0;0;1;1
2950;Jurginėlis;Bitučių;8443412187;Ne;2;0;0;2
2951;Jurginėlis;Bitučių;4967548277;Ne;6;0;0;6
2952;Jurginėlis;Bitučių;2925253653;Ne;0;3;0;3
2953;Jurginėlis;Bitučių;2221708420;Ne;2;1;0;3
2954;Jurginėlis;Bitučių;6181547354;Ne;0;2;0;2
2955;Jurginėlis;Bitučių;2490875633;Ne;10;2;0;12
2956;Jurginėlis;Bitučių;4689913361;Ne;0;0;1;1
2957;Jurginėlis;Skruzdeliukų;1351306981;Ne;2;0;0;2
2958;Jurginėlis;Skruzdeliukų;9146039217;Ne;0;1;0;1
2959;Jurginėlis;Skruzdeliukų;1885598986;Ne;0;1;0;1
2960;Jurginėlis;Skruzdeliukų;5734506036;Ne;0;1;0;1
2961;Jurginėlis;Skruzdeliukų;3699180485;Ne;5;0;0;5
2962;Jurginėlis;Skruzdeliukų;1634502874;Taip;5;1;0;6
2963;Jurginėlis;Skruzdeliukų;1763849354;Ne;13;1;0;14
2964;Jurginėlis;Skruzdeliukų;4944292549;Ne;0;5;0;5
2965;Jurginėlis;Skruzdeliukų;9550110246;Ne;4;1;0;5
2966;Jurginėlis;Skruzdeliukų;1204999684;Ne;10;0;0;10
2967;Jurginėlis;Skruzdeliukų;9937405742;Ne;6;0;0;6
2968;Jurginėlis;Skruzdeliukų;1726968598;Ne;0;14;0;14
2969;Jurginėlis;Skruzdeliukų;2332714713;Ne;10;2;0;12
2970;Jurginėlis;Skruzdeliukų;6542567172;Taip;0;5;0;5
2971;Jurginėlis;Drugelių;2025403481;Ne;4;1;0;5
2972;Jurginėlis;Drugelių;9065349248;Ne;2;0;0;2
2973;Jurginėlis;Drugelių;8341951659;Ne;7;4;0;11
2974;Jurginėlis;Drugelių;7795042485;Taip;10;0;0;10
2975;Jurginėlis;Drugelių;5138832895;Ne;10;0;0;10
2976;Jurginėlis;Drugelių;5751977493;Taip;9;0;0;9
2977;Jurginėlis;Drugelių;6068645621;Taip;0;7;0;7
2978;Jurginėlis;Drugelių;4276237094;Taip;0;1;0;1
2979;Jurginėlis;Drugelių;2689492215;Taip;1;0;0;1
2980;Jurginėlis;Drugelių;3527520303;Ne;3;0;0;3
2981;Jurginėlis;Drugelių;5874949368;Taip;7;0;0;7
2982;Jurginėlis;Drugelių;3063084253;Ne;12;0;0;12
2983;Jurginėlis;Drugelių;7409019574;Ne;5;0;0;5
2984;Jurginėlis;Drugelių;5928303681;Ne;5;2;0;7
2985;Jurginėlis;Drugelių;5476486516;Ne;3;0;0;3
2986;Jurginėlis;Žibučių;4979618298;Ne;1;0;0;1
2987;Jurginėlis;Žibučių;6636147085;Ne;3;1;3;7
2988;Jurginėlis;Žibučių;1438159631;Ne;4;0;0;4
2989;Jurginėlis;Žibučių;1336429135;Ne;1;0;0;1
2990;Jurginėlis;Žibučių;6948834218;Ne;24;0;0;24
2991;Jurginėlis;Žibučių;7721612113;Ne;11;0;0;11
2992;Jurginėlis;Žibučių;6988386438;Ne;4;0;0;4
2993;Jurginėlis;Žibučių;5936508522;Taip;4;19;0;23
2994;Jurginėlis;Žibučių;6717892969;Ne;3;3;0;6
2995;Jurginėlis;Žibučių;7977676733;Ne;4;0;0;4
2996;Jurginėlis;Žibučių;7530846375;Ne;0;2;0;2
2997;Jurginėlis;Žibučių;3899526893;Ne;0;1;0;1
2998;Jurginėlis;Žibučių;3861311860;Ne;9;1;0;10
2999;Jurginėlis;Žibučių;1263601087;Ne;1;1;0;2
3000;Jurginėlis;Žibučių;5549766339;Ne;2;7;0;9
3001;Jurginėlis;Žibučių;8968718021;Ne;0;2;0;2
3002;Jurginėlis;Žibučių;2782553941;Ne;22;0;0;22
3003;Jurginėlis;Žibučių;6259461257;Ne;6;0;0;6
3004;Jurginėlis;Žibučių;7252041334;Ne;8;0;0;8
3005;Jurginėlis;Zuikučių;5958832413;Ne;0;3;0;3
3006;Jurginėlis;Zuikučių;4432849717;Ne;3;8;0;11
3007;Jurginėlis;Zuikučių;8097652962;Ne;3;0;0;3
3008;Jurginėlis;Zuikučių;4763313715;Ne;10;0;0;10
3009;Jurginėlis;Zuikučių;6671759364;Ne;2;0;0;2
3010;Jurginėlis;Zuikučių;2820249307;Ne;1;0;0;1
3011;Jurginėlis;Zuikučių;8161347781;Ne;3;8;0;11
3012;Jurginėlis;Zuikučių;4113264904;Taip;0;0;1;1
3013;Jurginėlis;Zuikučių;8117563141;Ne;0;4;0;4
3014;Jurginėlis;Zuikučių;5652597514;Taip;6;0;0;6
3015;Jurginėlis;Zuikučių;6341896288;Ne;6;0;1;7
3016;Jurginėlis;Zuikučių;4180071775;Ne;1;0;0;1
3017;Jurginėlis;Zuikučių;8017976529;Ne;3;0;0;3
3018;Jurginėlis;Zuikučių;3530906368;Ne;10;0;0;10
3019;Jurginėlis;Viščiukų;1405338657;Ne;17;0;0;17
3020;Jurginėlis;Viščiukų;2211222679;Ne;11;1;0;12
3021;Jurginėlis;Viščiukų;9366610698;Taip;14;0;0;14
3022;Jurginėlis;Viščiukų;8050408300;Ne;10;0;1;11
3023;Jurginėlis;Viščiukų;2378007686;Ne;28;0;0;28
3024;Jurginėlis;Viščiukų;6657367395;Ne;1;1;0;2
3025;Jurginėlis;Viščiukų;3254001601;Ne;7;0;0;7
3026;Jurginėlis;Viščiukų;8050843105;Taip;14;1;0;15
3027;Jurginėlis;Viščiukų;9556978001;Ne;20;5;0;25
3028;Jurginėlis;Viščiukų;6550401531;Taip;8;0;0;8
3029;Jurginėlis;Viščiukų;1449454050;Ne;11;0;0;11
3030;Jurginėlis;Viščiukų;7684663210;Taip;11;0;0;11
3031;Jurginėlis;Viščiukų;6135184014;Ne;8;2;3;13
3032;Jurginėlis;Viščiukų;4515820114;Ne;2;2;0;4
3033;Jurginėlis;Meškiukų;6584048242;Ne;4;0;0;4
3034;Jurginėlis;Meškiukų;2652507538;Taip;16;0;0;16
3035;Jurginėlis;Meškiukų;4645348169;Ne;9;0;0;9
3036;Jurginėlis;Meškiukų;7424513586;Ne;6;0;0;6
3037;Jurginėlis;Meškiukų;5945075337;Ne;8;0;0;8
3038;Jurginėlis;Meškiukų;5472986119;Ne;9;0;0;9
3039;Jurginėlis;Meškiukų;5105758563;Ne;2;2;0;4
3040;Jurginėlis;Meškiukų;7892411156;Ne;6;0;0;6
3041;Jurginėlis;Meškiukų;2967314352;Ne;6;1;0;7
3042;Jurginėlis;Meškiukų;7053226448;Ne;9;1;0;10
3043;Jurginėlis;Gandriukų;6306274502;Taip;10;0;0;10
3044;Jurginėlis;Gandriukų;9603380131;Ne;11;0;0;11
3045;Jurginėlis;Gandriukų;7193314762;Ne;5;0;0;5
3046;Jurginėlis;Gandriukų;4506484183;Ne;1;0;0;1
3047;Jurginėlis;Gandriukų;5474358669;Ne;16;0;0;16
3048;Jurginėlis;Gandriukų;2595002682;Ne;7;0;0;7
3049;Jurginėlis;Gandriukų;5866358319;Taip;4;0;0;4
3050;Jurginėlis;Gandriukų;1598578487;Ne;7;0;0;7
3051;Jurginėlis;Gandriukų;4644476606;Taip;12;0;0;12
3052;Jurginėlis;Gandriukų;3230200231;Ne;11;0;0;11
3053;Jurginėlis;Gandriukų;7636442845;Ne;2;0;0;2
3054;Jurginėlis;Gandriukų;1286603999;Ne;5;0;0;5
3055;Jurginėlis;Gandriukų;4617952912;Ne;5;0;0;5
3056;Jurginėlis;Gandriukų;3672557409;Ne;5;1;0;6
3057;Jurginėlis;Gandriukų;1043529560;Ne;13;0;0;13
3058;Jurginėlis;Gandriukų;1888949640;Taip;0;31;0;31
3059;Jurginėlis;Gandriukų;5688209539;Ne;13;0;0;13
3060;Jurginėlis;Gandriukų;2084877917;Ne;1;0;0;1
3061;Karuselė;PAGRANDUKAS;1621482372;Ne;8;2;0;10
3062;Karuselė;PAGRANDUKAS;3984262482;Ne;6;0;0;6
3063;Karuselė;PAGRANDUKAS;9130534156;Ne;9;0;0;9
3064;Karuselė;PAGRANDUKAS;3660843696;Ne;0;1;0;1
3065;Karuselė;PAGRANDUKAS;5132581245;Ne;5;0;0;5
3066;Karuselė;PAGRANDUKAS;2412418335;Ne;0;3;0;3
3067;Karuselė;PAGRANDUKAS;5695697634;Ne;0;1;0;1
3068;Karuselė;PAGRANDUKAS;6252613489;Ne;9;6;0;15
3069;Karuselė;PAGRANDUKAS;6004882312;Ne;5;3;0;8
3070;Karuselė;PAGRANDUKAS;3972815393;Taip;0;4;0;4
3071;Karuselė;PAGRANDUKAS;8157193503;Taip;9;3;0;12
3072;Karuselė;PAGRANDUKAS;9651192437;Taip;0;1;0;1
3073;Karuselė;PAGRANDUKAS;7916589127;Ne;7;0;0;7
3074;Karuselė;PAGRANDUKAS;7564618678;Ne;12;1;0;13
3075;Karuselė;PAGRANDUKAS;6546648346;Ne;5;2;0;7
3076;Karuselė;PAGRANDUKAS;8182071103;Ne;0;4;0;4
3077;Karuselė;NYKŠTUKAS;4966362343;Ne;7;0;0;7
3078;Karuselė;NYKŠTUKAS;9997776739;Ne;10;0;0;10
3079;Karuselė;NYKŠTUKAS;4445214427;Ne;8;7;0;15
3080;Karuselė;NYKŠTUKAS;9354431582;Ne;2;0;0;2
3081;Karuselė;NYKŠTUKAS;5216815933;Ne;0;4;0;4
3082;Karuselė;NYKŠTUKAS;7817417459;Ne;0;2;0;2
3083;Karuselė;NYKŠTUKAS;9654804545;Ne;5;6;0;11
3084;Karuselė;NYKŠTUKAS;6581798125;Ne;12;0;0;12
3085;Karuselė;NYKŠTUKAS;1486577955;Ne;13;0;0;13
3086;Karuselė;NYKŠTUKAS;5697305819;Taip;0;2;0;2
3087;Karuselė;NYKŠTUKAS;8007341411;Ne;10;4;0;14
3088;Karuselė;NYKŠTUKAS;4363388969;Ne;12;1;0;13
3089;Karuselė;NYKŠTUKAS;4296509304;Ne;5;1;0;6
3090;Karuselė;NYKŠTUKAS;9243932017;Ne;5;1;0;6
3091;Karuselė;NYKŠTUKAS;5986973796;Ne;4;1;0;5
3092;Karuselė;NYKŠTUKAS;4856589410;Ne;1;2;0;3
3093;Karuselė;NYKŠTUKAS;9999461542;Ne;15;0;0;15
3094;Karuselė;NYKŠTUKAS;9385698812;Ne;12;2;0;14
3095;Karuselė;NYKŠTUKAS;4868770355;Ne;5;0;0;5
3096;Karuselė;NYKŠTUKAS;1084415930;Ne;16;0;0;16
3097;Karuselė;NYKŠTUKAS;9071878406;Ne;8;0;0;8
3098;Karuselė;NYKŠTUKAS;1078396181;Ne;7;0;0;7
3099;Karuselė;BITUTĖ;8175498192;Ne;0;2;5;7
3100;Karuselė;BITUTĖ;5951045233;Ne;0;4;0;4
3101;Karuselė;BITUTĖ;6165548450;Taip;2;3;0;5
3102;Karuselė;BITUTĖ;7733032142;Ne;0;4;0;4
3103;Karuselė;BITUTĖ;1412890120;Ne;6;5;0;11
3104;Karuselė;BITUTĖ;5135054911;Ne;5;0;0;5
3105;Karuselė;BITUTĖ;4130693235;Ne;14;0;0;14
3106;Karuselė;BITUTĖ;6826455161;Ne;0;5;0;5
3107;Karuselė;BITUTĖ;2727440190;Ne;0;1;0;1
3108;Karuselė;BITUTĖ;2306922755;Ne;5;4;0;9
3109;Karuselė;BITUTĖ;6062361348;Ne;6;0;0;6
3110;Karuselė;BITUTĖ;9996567374;Ne;0;1;0;1
3111;Karuselė;BITUTĖ;2529641529;Ne;0;6;0;6
3112;Karuselė;BITUTĖ;4262640017;Ne;0;1;0;1
3113;Karuselė;BITUTĖ;8406462155;Ne;4;1;0;5
3114;Karuselė;BITUTĖ;2247913568;Ne;0;1;0;1
3115;Karuselė;BORUŽĖLĖ;7030946179;Ne;5;0;1;6
3116;Karuselė;BORUŽĖLĖ;6283563118;Ne;10;0;0;10
3117;Karuselė;BORUŽĖLĖ;9303194274;Ne;11;0;0;11
3118;Karuselė;BORUŽĖLĖ;7817670288;Ne;2;0;0;2
3119;Karuselė;BORUŽĖLĖ;7986277964;Ne;10;0;0;10
3120;Karuselė;BORUŽĖLĖ;5397256562;Ne;4;0;0;4
3121;Karuselė;BORUŽĖLĖ;8004953571;Ne;13;1;0;14
3122;Karuselė;BORUŽĖLĖ;8357973162;Ne;11;0;0;11
3123;Karuselė;BORUŽĖLĖ;8689140295;Taip;4;1;0;5
3124;Karuselė;BORUŽĖLĖ;7430518094;Ne;10;1;0;11
3125;Karuselė;BORUŽĖLĖ;9995800164;Ne;3;0;0;3
3126;Karuselė;BORUŽĖLĖ;8664628232;Ne;20;0;0;20
3127;Karuselė;BORUŽĖLĖ;8234778310;Ne;10;0;0;10
3128;Karuselė;BORUŽĖLĖ;7869324652;Ne;5;0;0;5
3129;Karuselė;BORUŽĖLĖ;5519366758;Ne;15;0;0;15
3130;Karuselė;BORUŽĖLĖ;6669293437;Ne;15;0;0;15
3131;Karuselė;BORUŽĖLĖ;1004895817;Taip;5;1;1;7
3132;Karuselė;UOGELĖ;1119373532;Taip;7;1;0;8
3133;Karuselė;UOGELĖ;2135332292;Ne;0;6;0;6
3134;Karuselė;UOGELĖ;9463553056;Ne;9;1;0;10
3135;Karuselė;UOGELĖ;4871960780;Ne;7;0;0;7
3136;Karuselė;UOGELĖ;8257771271;Ne;0;8;0;8
3137;Karuselė;UOGELĖ;7749015193;Ne;6;5;0;11
3138;Karuselė;UOGELĖ;3075592618;Ne;10;0;0;10
3139;Karuselė;UOGELĖ;2450390957;Ne;0;8;0;8
3140;Karuselė;UOGELĖ;7535451590;Ne;0;11;0;11
3141;Karuselė;UOGELĖ;4302662341;Ne;0;17;0;17
3142;Karuselė;UOGELĖ;4865727149;Ne;10;0;0;10
3143;Karuselė;UOGELĖ;8952114853;Ne;0;4;0;4
3144;Karuselė;UOGELĖ;9649615834;Ne;6;0;0;6
3145;Karuselė;UOGELĖ;3885475525;Ne;0;11;0;11
3146;Karuselė;UOGELĖ;6562490670;Ne;5;1;0;6
3147;Karuselė;UOGELĖ;4799230363;Ne;19;0;0;19
3148;Karuselė;GINTARĖLIS;3773170060;Ne;5;0;0;5
3149;Karuselė;GINTARĖLIS;3904453423;Ne;5;2;0;7
3150;Karuselė;GINTARĖLIS;7489136297;Ne;8;2;0;10
3151;Karuselė;GINTARĖLIS;3534074990;Ne;2;12;0;14
3152;Karuselė;GINTARĖLIS;7540323186;Ne;0;1;1;2
3153;Karuselė;GINTARĖLIS;1019322763;Ne;2;0;0;2
3154;Karuselė;GINTARĖLIS;8481143199;Ne;4;2;0;6
3155;Karuselė;GINTARĖLIS;3157893936;Ne;2;0;0;2
3156;Karuselė;GINTARĖLIS;8409412605;Ne;1;2;3;6
3157;Karuselė;GINTARĖLIS;2688863117;Ne;4;1;0;5
3158;Karuselė;GINTARĖLIS;7439791054;Ne;16;0;0;16
3159;Karuselė;GINTARĖLIS;3696384277;Ne;0;1;0;1
3160;Karuselė;GINTARĖLIS;2945027875;Ne;5;2;0;7
3161;Karuselė;GINTARĖLIS;9116238924;Ne;6;1;0;7
3162;Karuselė;GINTARĖLIS;6433987745;Ne;2;0;3;5
3163;Karuselė;GINTARĖLIS;9763326660;Ne;5;0;0;5
3164;Karuselė;GINTARĖLIS;9479962436;Taip;2;0;0;2
3165;Karuselė;GINTARĖLIS;3471091687;Ne;5;1;0;6
3166;Karuselė;GINTARĖLIS;4103816990;Ne;2;0;2;4
3167;Karuselė;GINTARĖLIS;4325959483;Ne;17;0;0;17
3168;Karuselė;GINTARĖLIS;6785226197;Ne;0;0;1;1
3169;Karuselė;SAULUTĖ;5627583683;Ne;2;2;0;4
3170;Karuselė;SAULUTĖ;2242659064;Ne;8;4;0;12
3171;Karuselė;SAULUTĖ;5704218177;Ne;17;1;0;18
3172;Karuselė;SAULUTĖ;5146709341;Ne;3;0;0;3
3173;Karuselė;SAULUTĖ;8331985564;Ne;3;0;0;3
3174;Karuselė;SAULUTĖ;9656723409;Ne;7;2;0;9
3175;Karuselė;SAULUTĖ;5766390337;Ne;0;1;0;1
3176;Karuselė;SAULUTĖ;4879654321;Ne;2;9;0;11
3177;Karuselė;SAULUTĖ;5803808409;Ne;0;1;0;1
3178;Karuselė;SAULUTĖ;2269840705;Ne;5;0;0;5
3179;Karuselė;SAULUTĖ;3149575456;Ne;2;1;0;3
3180;Karuselė;SAULUTĖ;5640656442;Ne;0;1;0;1
3181;Karuselė;SAULUTĖ;9451789237;Ne;2;1;0;3
3182;Karuselė;SAULUTĖ;9450841251;Ne;2;1;0;3
3183;Karuselė;SAULUTĖ;6338379641;Ne;10;0;0;10
3184;Karuselė;SAULUTĖ;3228100488;Ne;8;0;0;8
3185;Karuselė;SAULUTĖ;5830080035;Ne;2;0;0;2
3186;Karuselė;SAULUTĖ;9985033530;Ne;1;1;0;2
3187;Karuselė;SAULUTĖ;4211688032;Ne;2;0;0;2
3188;Karuselė;SAULUTĖ;5802996641;Taip;0;1;0;1
3189;Karuselė;SAULUTĖ;3271464159;Taip;10;0;0;10
3190;Karuselė;SAULUTĖ;7501323454;Ne;5;2;0;7
3191;Karuselė;TIGRIUKAS;9561892809;Ne;4;1;0;5
3192;Karuselė;TIGRIUKAS;9726299722;Ne;0;2;0;2
3193;Karuselė;TIGRIUKAS;1576201225;Ne;0;5;0;5
3194;Karuselė;TIGRIUKAS;9344514262;Ne;9;0;0;9
3195;Karuselė;TIGRIUKAS;7131255599;Ne;16;0;0;16
3196;Karuselė;TIGRIUKAS;4180604225;Ne;16;0;0;16
3197;Karuselė;TIGRIUKAS;2397938004;Ne;4;0;0;4
3198;Karuselė;TIGRIUKAS;3605966015;Ne;5;0;0;5
3199;Karuselė;TIGRIUKAS;9252093125;Ne;0;4;0;4
3200;Karuselė;TIGRIUKAS;5176597751;Ne;3;0;0;3
3201;Karuselė;TIGRIUKAS;6656808100;Ne;2;2;0;4
3202;Karuselė;TIGRIUKAS;8474027736;Ne;0;7;0;7
3203;Karuselė;TIGRIUKAS;2549599594;Ne;10;1;0;11
3204;Karuselė;TIGRIUKAS;9394220081;Ne;4;2;0;6
3205;Karuselė;TIGRIUKAS;7618984957;Ne;0;6;0;6
3206;Karuselė;TIGRIUKAS;6678283260;Ne;0;1;0;1
3207;Karuselė;TIGRIUKAS;9736020767;Ne;4;0;0;4
3208;Karuselė;TIGRIUKAS;5964942317;Ne;0;12;0;12
3209;Karuselė;VAIVORYKŠTĖ;1289442716;Ne;3;0;0;3
3210;Karuselė;VAIVORYKŠTĖ;9855242602;Ne;11;0;0;11
3211;Karuselė;VAIVORYKŠTĖ;9408843254;Ne;0;1;0;1
3212;Karuselė;VAIVORYKŠTĖ;3514315636;Ne;0;1;0;1
3213;Karuselė;VAIVORYKŠTĖ;8085919723;Ne;0;1;0;1
3214;Karuselė;VAIVORYKŠTĖ;1581504806;Ne;5;0;1;6
3215;Karuselė;VAIVORYKŠTĖ;2215367063;Ne;0;1;0;1
3216;Karuselė;VAIVORYKŠTĖ;6424622497;Ne;2;0;0;2
3217;Karuselė;VAIVORYKŠTĖ;5855430678;Taip;6;0;0;6
3218;Karuselė;VAIVORYKŠTĖ;5128774216;Ne;10;0;0;10
3219;Karuselė;VAIVORYKŠTĖ;4110024673;Ne;11;0;1;12
3220;Karuselė;VAIVORYKŠTĖ;9400856559;Ne;8;0;0;8
3221;Karuselė;VAIVORYKŠTĖ;1083786182;Ne;8;0;0;8
3222;Karuselė;VAIVORYKŠTĖ;5998868204;Ne;0;1;0;1
3223;Karuselė;VAIVORYKŠTĖ;6734936247;Ne;6;4;0;10
3224;Karuselė;VAIVORYKŠTĖ;3082636224;Ne;3;2;1;6
3225;Karuselė;VAIVORYKŠTĖ;4749086136;Ne;5;2;0;7
3226;Karuselė;VAIVORYKŠTĖ;8371081106;Ne;15;0;0;15
3227;Karuselė;"AUKSINĖ ŽUVELĖ";1344025242;Ne;20;0;0;20
3228;Karuselė;"AUKSINĖ ŽUVELĖ";6048980111;Ne;14;1;0;15
3229;Karuselė;"AUKSINĖ ŽUVELĖ";9535490329;Ne;14;1;0;15
3230;Karuselė;"AUKSINĖ ŽUVELĖ";5313839511;Ne;16;1;0;17
3231;Karuselė;"AUKSINĖ ŽUVELĖ";8074453862;Ne;8;2;0;10
3232;Karuselė;"AUKSINĖ ŽUVELĖ";5912561598;Ne;3;0;0;3
3233;Karuselė;"AUKSINĖ ŽUVELĖ";3728662112;Ne;12;1;0;13
3234;Karuselė;"AUKSINĖ ŽUVELĖ";9170947196;Ne;9;2;0;11
3235;Karuselė;"AUKSINĖ ŽUVELĖ";4982029137;Ne;19;0;0;19
3236;Karuselė;"AUKSINĖ ŽUVELĖ";3408146969;Ne;14;0;0;14
3237;Karuselė;"AUKSINĖ ŽUVELĖ";3464711958;Ne;0;20;0;20
3238;Karuselė;"AUKSINĖ ŽUVELĖ";1044597936;Ne;10;0;0;10
3239;Karuselė;RAMUNĖ;6319361312;Ne;4;1;0;5
3240;Karuselė;RAMUNĖ;5666333470;Ne;0;4;0;4
3241;Karuselė;RAMUNĖ;6370060620;Ne;1;0;0;1
3242;Karuselė;RAMUNĖ;6844148347;Ne;4;0;0;4
3243;Karuselė;RAMUNĖ;7250708607;Ne;11;0;0;11
3244;Karuselė;RAMUNĖ;3890681011;Ne;8;2;0;10
3245;Karuselė;RAMUNĖ;6469579272;Ne;20;0;0;20
3246;Karuselė;RAMUNĖ;4707292159;Ne;1;0;0;1
3247;Karuselė;RAMUNĖ;5926712250;Ne;2;0;1;3
3248;Karuselė;RAMUNĖ;1427836663;Taip;0;0;1;1
3249;Karuselė;RAMUNĖ;3008219926;Ne;1;0;0;1
3250;Karuselė;RAMUNĖ;5736966465;Ne;0;4;0;4
3251;Karuselė;RAMUNĖ;9789687336;Ne;20;0;0;20
3252;Karuselė;RAMUNĖ;2843226066;Ne;12;0;1;13
3253;Karuselė;RAMUNĖ;8590035431;Taip;15;0;0;15
3254;Karuselė;RAMUNĖ;3276397300;Ne;5;7;0;12
3255;Karuselė;VILKELIS;6300348828;Taip;0;1;0;1
3256;Karuselė;VILKELIS;3485160781;Ne;0;1;0;1
3257;Karuselė;VILKELIS;2500977616;Ne;5;1;0;6
3258;Karuselė;VILKELIS;8238334389;Ne;3;0;0;3
3259;Karuselė;VILKELIS;5036757881;Ne;13;0;0;13
3260;Karuselė;VILKELIS;7794320463;Ne;6;1;0;7
3261;Karuselė;VILKELIS;7052993128;Ne;20;0;0;20
3262;Karuselė;VILKELIS;7480485777;Ne;6;0;0;6
3263;Karuselė;VILKELIS;6341570221;Ne;10;0;0;10
3264;Karuselė;VILKELIS;8848085495;Ne;0;15;0;15
3265;Karuselė;VILKELIS;8362740639;Ne;0;1;0;1
3266;Karuselė;VILKELIS;2842034472;Ne;3;0;0;3
3267;Karuselė;VILKELIS;4757820179;Ne;4;0;0;4
3268;Karuselė;VILKELIS;9415377698;Ne;0;1;0;1
3269;Karuselė;VILKELIS;2260731421;Ne;4;2;0;6
3270;Karuselė;VILKELIS;4196250786;Ne;4;0;0;4
3271;Karuselė;VILKELIS;3460470459;Ne;0;2;0;2
3272;Kaštonas;NYKŠTUKAI;7703842464;Ne;7;0;0;7
3273;Kaštonas;NYKŠTUKAI;8145965849;Ne;1;0;0;1
3274;Kaštonas;NYKŠTUKAI;2361839733;Ne;1;0;0;1
3275;Kaštonas;NYKŠTUKAI;4782280933;Ne;7;0;0;7
3276;Kaštonas;NYKŠTUKAI;1258105498;Ne;11;0;0;11
3277;Kaštonas;NYKŠTUKAI;8766848385;Ne;9;0;0;9
3278;Kaštonas;NYKŠTUKAI;3251132542;Ne;4;0;0;4
3279;Kaštonas;NYKŠTUKAI;1501441973;Ne;3;0;0;3
3280;Kaštonas;NYKŠTUKAI;5948707303;Taip;20;0;0;20
3281;Kaštonas;NYKŠTUKAI;1027896631;Ne;2;0;0;2
3282;Kaštonas;NYKŠTUKAI;8158855458;Ne;15;0;0;15
3283;Kaštonas;NYKŠTUKAI;4353473162;Ne;13;0;0;13
3284;Kaštonas;NYKŠTUKAI;3456815576;Ne;13;0;0;13
3285;Kaštonas;NYKŠTUKAI;5350239917;Ne;3;0;0;3
3286;Kaštonas;NYKŠTUKAI;6515739350;Ne;2;0;0;2
3287;Kaštonas;NYKŠTUKAI;2281935638;Ne;2;0;0;2
3288;Kaštonas;NYKŠTUKAI;7088197668;Ne;5;0;0;5
3289;Kaštonas;DRUGELIAI;8486955652;Ne;9;0;0;9
3290;Kaštonas;DRUGELIAI;2106924435;Ne;2;0;0;2
3291;Kaštonas;DRUGELIAI;8483888152;Ne;0;2;0;2
3292;Kaštonas;DRUGELIAI;7408901858;Ne;0;16;0;16
3293;Kaštonas;DRUGELIAI;8582453109;Ne;7;0;0;7
3294;Kaštonas;DRUGELIAI;2832688622;Ne;0;6;0;6
3295;Kaštonas;DRUGELIAI;9061158412;Ne;12;0;0;12
3296;Kaštonas;DRUGELIAI;5884427036;Ne;0;3;0;3
3297;Kaštonas;DRUGELIAI;8166925991;Ne;0;3;0;3
3298;Kaštonas;DRUGELIAI;4215759647;Ne;0;4;0;4
3299;Kaštonas;DRUGELIAI;8257643251;Ne;0;3;0;3
3300;Kaštonas;DRUGELIAI;4384907654;Ne;0;3;0;3
3301;Kaštonas;DRUGELIAI;1976138680;Ne;0;1;2;3
3302;Kaštonas;DRUGELIAI;7698074598;Ne;5;3;0;8
3303;Kaštonas;KIŠKUČIAI;4552007726;Ne;13;0;0;13
3304;Kaštonas;KIŠKUČIAI;2020612346;Ne;0;9;0;9
3305;Kaštonas;KIŠKUČIAI;6585977073;Ne;0;6;0;6
3306;Kaštonas;KIŠKUČIAI;7383219978;Ne;0;8;0;8
3307;Kaštonas;KIŠKUČIAI;4641535612;Ne;5;3;0;8
3308;Kaštonas;KIŠKUČIAI;4708114402;Ne;0;2;0;2
3309;Kaštonas;KIŠKUČIAI;6749679348;Ne;0;1;0;1
3310;Kaštonas;KIŠKUČIAI;3860613494;Ne;0;7;0;7
3311;Kaštonas;KIŠKUČIAI;9778140363;Ne;20;0;0;20
3312;Kaštonas;KIŠKUČIAI;7290414209;Ne;0;14;0;14
3313;Kaštonas;KIŠKUČIAI;9356018629;Ne;0;2;2;4
3314;Kaštonas;KIŠKUČIAI;9320223622;Ne;0;5;0;5
3315;Kaštonas;KIŠKUČIAI;6425908247;Taip;2;0;0;2
3316;Kaštonas;KIŠKUČIAI;2874873326;Ne;10;1;0;11
3317;Kaštonas;KIŠKUČIAI;6934262510;Ne;0;6;0;6
3318;Kaštonas;KIŠKUČIAI;9034859988;Ne;10;0;0;10
3319;Kaštonas;KIŠKUČIAI;9249007247;Ne;10;1;0;11
3320;Kaštonas;KIŠKUČIAI;2218450479;Ne;0;5;0;5
3321;Kaštonas;BITUTĖS;2898327157;Ne;5;0;1;6
3322;Kaštonas;BITUTĖS;1207372235;Ne;0;11;0;11
3323;Kaštonas;BITUTĖS;9298372326;Ne;0;2;0;2
3324;Kaštonas;BITUTĖS;4115242811;Ne;10;1;0;11
3325;Kaštonas;BITUTĖS;6896372095;Ne;2;1;0;3
3326;Kaštonas;BITUTĖS;1684641447;Ne;10;0;0;10
3327;Kaštonas;BITUTĖS;1761520786;Ne;16;0;0;16
3328;Kaštonas;BITUTĖS;8250964197;Ne;10;6;0;16
3329;Kaštonas;BITUTĖS;7946379086;Ne;4;0;0;4
3330;Kaštonas;BITUTĖS;9285927858;Ne;0;8;0;8
3331;Kaštonas;BITUTĖS;9903176616;Ne;9;1;0;10
3332;Kaštonas;BITUTĖS;1614180834;Ne;0;0;4;4
3333;Kaštonas;BITUTĖS;2877124424;Ne;0;4;0;4
3334;Kaštonas;BITUTĖS;1031628633;Ne;6;2;0;8
3335;Kaštonas;BITUTĖS;4551111709;Ne;3;2;0;5
3336;Kaštonas;BITUTĖS;7291448857;Ne;0;1;0;1
3337;Kaštonas;BITUTĖS;4837002666;Taip;4;0;4;8
3338;Kaštonas;BITUTĖS;6175014441;Ne;0;1;0;1
3339;Kaštonas;BITUTĖS;1748975865;Ne;0;4;0;4
3340;Kaštonas;MEŠKIUKAI;6613837801;Ne;3;0;0;3
3341;Kaštonas;MEŠKIUKAI;6263544162;Ne;0;6;0;6
3342;Kaštonas;MEŠKIUKAI;8775608339;Ne;0;1;0;1
3343;Kaštonas;MEŠKIUKAI;6289073634;Ne;0;9;0;9
3344;Kaštonas;MEŠKIUKAI;4616084852;Ne;0;1;0;1
3345;Kaštonas;MEŠKIUKAI;5157500600;Ne;6;0;0;6
3346;Kaštonas;MEŠKIUKAI;4308169582;Ne;6;0;0;6
3347;Kaštonas;MEŠKIUKAI;6589898580;Ne;0;7;0;7
3348;Kaštonas;MEŠKIUKAI;4824511567;Ne;8;0;0;8
3349;Kaštonas;MEŠKIUKAI;3961661158;Ne;0;12;0;12
3350;Kaštonas;MEŠKIUKAI;8318869054;Ne;10;0;0;10
3351;Kaštonas;MEŠKIUKAI;8867446698;Ne;5;0;0;5
3352;Kaštonas;MEŠKIUKAI;9379171183;Ne;0;0;4;4
3353;Kaštonas;MEŠKIUKAI;6254250706;Ne;0;1;0;1
3354;Kaštonas;MEŠKIUKAI;1262404954;Ne;0;1;0;1
3355;Kaštonas;MEŠKIUKAI;9014726465;Ne;1;2;0;3
3356;Kaštonas;MEŠKIUKAI;2165890763;Ne;1;0;0;1
3357;Kaštonas;MEŠKIUKAI;3383390078;Ne;0;7;0;7
3358;Kaštonas;BORUŽĖLĖS;8637978949;Ne;20;0;0;20
3359;Kaštonas;BORUŽĖLĖS;6891429484;Ne;8;1;0;9
3360;Kaštonas;BORUŽĖLĖS;6442448667;Ne;7;0;0;7
3361;Kaštonas;BORUŽĖLĖS;2345742465;Ne;5;0;0;5
3362;Kaštonas;BORUŽĖLĖS;3279850526;Ne;3;0;0;3
3363;Kaštonas;BORUŽĖLĖS;8151333699;Ne;5;0;0;5
3364;Kaštonas;BORUŽĖLĖS;4285107537;Ne;8;0;0;8
3365;Kaštonas;BORUŽĖLĖS;3153834010;Ne;8;0;0;8
3366;Kaštonas;BORUŽĖLĖS;8820616057;Ne;0;3;0;3
3367;Kaštonas;BORUŽĖLĖS;3839816548;Ne;0;3;0;3
3368;Kaštonas;BORUŽĖLĖS;5329898590;Ne;5;3;0;8
3369;Kaštonas;BORUŽĖLĖS;2356291627;Ne;0;1;0;1
3370;"Krivūlė (Lydos g. 5)";SPINDULIUKAI;1937803301;Ne;5;0;1;6
3371;"Krivūlė (Lydos g. 5)";SPINDULIUKAI;3913058095;Ne;0;0;5;5
3372;"Krivūlė (Lydos g. 5)";SPINDULIUKAI;1840809151;Ne;0;0;4;4
3373;"Krivūlė (Lydos g. 5)";SPINDULIUKAI;7335245963;Ne;10;0;0;10
3374;"Krivūlė (Lydos g. 5)";SPINDULIUKAI;5802739148;Ne;0;2;3;5
3375;"Krivūlė (Lydos g. 5)";SPINDULIUKAI;7155162698;Ne;0;0;2;2
3376;"Krivūlė (Lydos g. 5)";SPINDULIUKAI;9320613086;Ne;10;0;1;11
3377;"Krivūlė (Lydos g. 5)";SPINDULIUKAI;4750075323;Ne;0;0;1;1
3378;"Krivūlė (Lydos g. 5)";SPINDULIUKAI;3852793979;Taip;7;0;0;7
3379;"Krivūlė (Lydos g. 5)";SPINDULIUKAI;3184820008;Ne;5;0;1;6
3380;"Krivūlė (Lydos g. 5)";SPINDULIUKAI;7025398689;Ne;13;0;0;13
3381;"Krivūlė (Lydos g. 5)";SPINDULIUKAI;4943482123;Ne;0;0;1;1
3382;"Krivūlė (Lydos g. 5)";SPINDULIUKAI;9815421737;Ne;0;0;2;2
3383;"Krivūlė (Lydos g. 5)";SPINDULIUKAI;4619224314;Ne;5;0;13;18
3384;"Krivūlė (Lydos g. 5)";SPINDULIUKAI;3999214263;Ne;0;0;5;5
3385;"Krivūlė (Lydos g. 5)";BORUŽĖLĖS;3357889614;Ne;0;0;2;2
3386;"Krivūlė (Lydos g. 5)";BORUŽĖLĖS;8711082048;Taip;0;0;5;5
3387;"Krivūlė (Lydos g. 5)";BORUŽĖLĖS;2915437387;Ne;0;0;8;8
3388;"Krivūlė (Lydos g. 5)";BORUŽĖLĖS;8304613793;Ne;0;0;2;2
3389;"Krivūlė (Lydos g. 5)";BORUŽĖLĖS;9030517214;Ne;0;0;6;6
3390;"Krivūlė (Lydos g. 5)";BORUŽĖLĖS;3588408699;Ne;0;0;5;5
3391;"Krivūlė (Lydos g. 5)";BORUŽĖLĖS;7102769750;Ne;0;0;1;1
3392;"Krivūlė (Lydos g. 5)";BORUŽĖLĖS;6854278025;Ne;5;1;0;6
3393;"Krivūlė (Lydos g. 5)";BORUŽĖLĖS;4944001828;Ne;0;0;1;1
3394;"Krivūlė (Lydos g. 5)";BORUŽĖLĖS;2240949291;Taip;0;0;1;1
3395;"Krivūlė (Lydos g. 5)";BORUŽĖLĖS;3368847042;Ne;13;0;0;13
3396;"Krivūlė (Lydos g. 5)";BORUŽĖLĖS;6283777399;Ne;9;0;0;9
3397;"Krivūlė (Lydos g. 5)";BORUŽĖLĖS;4454327278;Ne;9;0;2;11
3398;"Krivūlė (Lydos g. 5)";BORUŽĖLĖS;1220698436;Ne;0;20;0;20
3399;"Krivūlė (Lydos g. 5)";DRUGELIŲ;6004925249;Ne;0;0;2;2
3400;"Krivūlė (Lydos g. 5)";DRUGELIŲ;5113297248;Ne;0;0;11;11
3401;"Krivūlė (Lydos g. 5)";DRUGELIŲ;9306686488;Ne;5;0;1;6
3402;"Krivūlė (Lydos g. 5)";DRUGELIŲ;5596874303;Ne;9;0;1;10
3403;"Krivūlė (Lydos g. 5)";DRUGELIŲ;2711010212;Ne;5;2;6;13
3404;"Krivūlė (Lydos g. 5)";DRUGELIŲ;7781918674;Ne;0;1;0;1
3405;"Krivūlė (Lydos g. 5)";DRUGELIŲ;5531566792;Ne;0;0;1;1
3406;"Krivūlė (Lydos g. 5)";DRUGELIŲ;1171226193;Ne;10;0;0;10
3407;"Krivūlė (Lydos g. 5)";DRUGELIŲ;5683183310;Ne;0;0;4;4
3408;"Krivūlė (Lydos g. 5)";DRUGELIŲ;1815336153;Ne;5;2;0;7
3409;"Krivūlė (Lydos g. 5)";DRUGELIŲ;6832582194;Ne;0;0;5;5
3410;"Krivūlė (Lydos g. 5)";"BITUTĖS (VALDOFRO)";3769812444;Ne;0;1;0;1
3411;"Krivūlė (Lydos g. 5)";"BITUTĖS (VALDOFRO)";5128760019;Ne;0;1;0;1
3412;"Krivūlė (Lydos g. 5)";"BITUTĖS (VALDOFRO)";2647149927;Ne;0;1;0;1
3413;"Krivūlė (Lydos g. 5)";"BITUTĖS (VALDOFRO)";9632352765;Ne;0;2;1;3
3414;"Krivūlė (Lydos g. 5)";"BITUTĖS (VALDOFRO)";7848471009;Ne;0;0;1;1
3415;"Krivūlė (Lydos g. 5)";"BITUTĖS (VALDOFRO)";8834855616;Ne;0;1;0;1
3416;"Krivūlė (Lydos g. 5)";"BITUTĖS (VALDOFRO)";1561180871;Ne;0;9;0;9
3417;"Krivūlė (Lydos g. 5)";"BITUTĖS (VALDOFRO)";9702372816;Ne;0;0;4;4
3418;"Krivūlė (Lydos g. 5)";"BITUTĖS (VALDOFRO)";8105688948;Ne;2;0;0;2
3419;"Krivūlė (Lydos g. 5)";"BITUTĖS (VALDOFRO)";1932209134;Ne;0;0;2;2
3420;"Krivūlė (Lydos g. 5)";"BITUTĖS (VALDOFRO)";7768827505;Ne;0;0;2;2
3421;"Krivūlė (Lydos g. 5)";"BITUTĖS (VALDOFRO)";7714519095;Ne;9;0;0;9
3422;"Krivūlė (Lydos g. 5)";"BITUTĖS (VALDOFRO)";8748668583;Ne;0;0;1;1
3423;"Krivūlė (Lydos g. 5)";"BITUTĖS (VALDOFRO)";6830712749;Taip;0;0;4;4
3424;"Krivūlė (Lydos g. 5)";"BITUTĖS (VALDOFRO)";5600651110;Ne;5;0;4;9
3425;"Krivūlė (Lydos g. 5)";"BITUTĖS (VALDOFRO)";8352493729;Taip;0;0;4;4
3426;"Krivūlė (Lydos g. 5)";"BITUTĖS (VALDOFRO)";9229817861;Taip;0;0;6;6
3427;"Krivūlė (Lydos g. 5)";"BITUTĖS (VALDOFRO)";9388352593;Ne;0;0;1;1
3428;"Krivūlė (Lydos g. 5)";"BITUTĖS (VALDOFRO)";4699320250;Ne;0;0;1;1
3429;"Krivūlė (Lydos g. 5)";EŽIUKAI;8042185027;Ne;0;0;5;5
3430;"Krivūlė (Lydos g. 5)";EŽIUKAI;5369083173;Ne;5;1;1;7
3431;"Krivūlė (Lydos g. 5)";EŽIUKAI;9051038248;Ne;0;0;19;19
3432;"Krivūlė (Lydos g. 5)";EŽIUKAI;3144577262;Ne;0;0;2;2
3433;"Krivūlė (Lydos g. 5)";EŽIUKAI;1898389557;Ne;0;0;5;5
3434;"Krivūlė (Lydos g. 5)";EŽIUKAI;2607716072;Ne;0;0;5;5
3435;"Krivūlė (Lydos g. 5)";EŽIUKAI;1893542120;Ne;4;0;0;4
3436;"Krivūlė (Lydos g. 5)";EŽIUKAI;1622229289;Ne;0;0;12;12
3437;"Krivūlė (Lydos g. 5)";EŽIUKAI;2157856704;Ne;0;9;2;11
3438;"Krivūlė (Lydos g. 5)";EŽIUKAI;4547087565;Ne;0;0;1;1
3439;"Krivūlė (Lydos g. 5)";EŽIUKAI;1189206089;Ne;0;0;12;12
3440;"Krivūlė (Lydos g. 5)";EŽIUKAI;1125863541;Ne;5;0;0;5
3441;"Krivūlė (Lydos g. 5)";NYKŠTUKAI;2742783991;Ne;0;0;4;4
3442;"Krivūlė (Lydos g. 5)";NYKŠTUKAI;8713384668;Ne;8;0;1;9
3443;"Krivūlė (Lydos g. 5)";NYKŠTUKAI;9678890051;Ne;5;0;0;5
3444;"Krivūlė (Lydos g. 5)";NYKŠTUKAI;8767554721;Ne;0;1;2;3
3445;"Krivūlė (Lydos g. 5)";NYKŠTUKAI;9529242858;Ne;2;0;1;3
3446;"Krivūlė (Lydos g. 5)";NYKŠTUKAI;8898023612;Ne;0;0;3;3
3447;"Krivūlė (Lydos g. 5)";NYKŠTUKAI;5768244312;Ne;4;0;0;4
3448;"Krivūlė (Lydos g. 5)";NYKŠTUKAI;7540940063;Taip;0;0;1;1
3449;"Krivūlė (Lydos g. 5)";NYKŠTUKAI;6548893885;Ne;0;0;8;8
3450;"Krivūlė (Lydos g. 5)";NYKŠTUKAI;8674468359;Ne;9;0;0;9
3451;"Krivūlė (Lydos g. 5)";NYKŠTUKAI;8047735389;Ne;0;0;2;2
3452;"Krivūlė (Lydos g. 5)";NYKŠTUKAI;1374452129;Ne;0;0;1;1
3453;"Krivūlė (Lydos g. 5)";NYKŠTUKAI;6466188552;Ne;15;0;0;15
3454;"Krivūlė (Lydos g. 5)";NYKŠTUKAI;6506806826;Ne;0;20;0;20
3455;"Kodėlčiukas (Laisvės pr. 59)";Saulutės;1725624698;Ne;0;4;0;4
3456;"Kodėlčiukas (Laisvės pr. 59)";Saulutės;7509476161;Ne;4;0;0;4
3457;"Kodėlčiukas (Laisvės pr. 59)";Saulutės;7327247516;Ne;2;0;0;2
3458;"Kodėlčiukas (Laisvės pr. 59)";Saulutės;1645680526;Ne;2;1;0;3
3459;"Kodėlčiukas (Laisvės pr. 59)";Saulutės;8992265000;Ne;9;0;0;9
3460;"Kodėlčiukas (Laisvės pr. 59)";Saulutės;6285018663;Ne;0;1;0;1
3461;"Kodėlčiukas (Laisvės pr. 59)";Saulutės;1033969800;Ne;0;1;0;1
3462;"Kodėlčiukas (Laisvės pr. 59)";Saulutės;7611485881;Ne;6;0;0;6
3463;"Kodėlčiukas (Laisvės pr. 59)";Saulutės;7561763602;Ne;5;1;0;6
3464;"Kodėlčiukas (Laisvės pr. 59)";Saulutės;2289687766;Ne;8;0;0;8
3465;"Kodėlčiukas (Laisvės pr. 59)";Saulutės;1992569595;Ne;7;0;1;8
3466;"Kodėlčiukas (Laisvės pr. 59)";Saulutės;9527296531;Ne;0;0;15;15
3467;"Kodėlčiukas (Laisvės pr. 59)";Saulutės;8070400563;Ne;0;0;1;1
3468;"Kodėlčiukas (Laisvės pr. 59)";Saulutės;8447045958;Ne;4;0;0;4
3469;"Kodėlčiukas (Laisvės pr. 59)";Saulutės;2542104903;Ne;5;3;0;8
3470;"Kodėlčiukas (Laisvės pr. 59)";Saulutės;2162480212;Ne;0;2;0;2
3471;"Kodėlčiukas (Laisvės pr. 59)";Saulutės;5064171874;Ne;3;0;0;3
3472;"Kodėlčiukas (Laisvės pr. 59)";Nežiniukai;9226992006;Ne;11;0;0;11
3473;"Kodėlčiukas (Laisvės pr. 59)";Nežiniukai;9404369378;Ne;16;0;0;16
3474;"Kodėlčiukas (Laisvės pr. 59)";Nežiniukai;2301454083;Ne;12;0;0;12
3475;"Kodėlčiukas (Laisvės pr. 59)";Nežiniukai;6041087039;Ne;8;0;0;8
3476;"Kodėlčiukas (Laisvės pr. 59)";Nežiniukai;7283028602;Ne;0;1;0;1
3477;"Kodėlčiukas (Laisvės pr. 59)";Nežiniukai;8439867734;Ne;4;0;0;4
3478;"Kodėlčiukas (Laisvės pr. 59)";Nežiniukai;8734412840;Ne;11;0;0;11
3479;"Kodėlčiukas (Laisvės pr. 59)";Nežiniukai;1682040192;Ne;8;1;0;9
3480;"Kodėlčiukas (Laisvės pr. 59)";Nežiniukai;3060543464;Ne;2;0;0;2
3481;"Kodėlčiukas (Laisvės pr. 59)";Nežiniukai;6631435446;Ne;9;0;0;9
3482;"Kodėlčiukas (Laisvės pr. 59)";Nežiniukai;7167508091;Ne;13;0;0;13
3483;"Kodėlčiukas (Laisvės pr. 59)";Nežiniukai;2350656752;Ne;18;0;0;18
3484;"Kodėlčiukas (Laisvės pr. 59)";Nežiniukai;8644416746;Ne;11;0;0;11
3485;"Kodėlčiukas (Laisvės pr. 59)";Nežiniukai;6164851553;Ne;13;0;0;13
3486;"Kodėlčiukas (Laisvės pr. 59)";Nežiniukai;8435298904;Ne;8;0;0;8
3487;"Kodėlčiukas (Laisvės pr. 59)";Gintarėliai;5891546827;Ne;0;0;3;3
3488;"Kodėlčiukas (Laisvės pr. 59)";Gintarėliai;7710811301;Taip;6;0;0;6
3489;"Kodėlčiukas (Laisvės pr. 59)";Gintarėliai;9085395350;Ne;0;0;1;1
3490;"Kodėlčiukas (Laisvės pr. 59)";Gintarėliai;6409157827;Ne;5;0;0;5
3491;"Kodėlčiukas (Laisvės pr. 59)";Gintarėliai;8101197864;Ne;1;3;0;4
3492;"Kodėlčiukas (Laisvės pr. 59)";Gintarėliai;2543628770;Ne;9;0;0;9
3493;"Kodėlčiukas (Laisvės pr. 59)";Gintarėliai;8911944991;Taip;5;0;4;9
3494;"Kodėlčiukas (Laisvės pr. 59)";Gintarėliai;6670171992;Taip;3;1;0;4
3495;"Kodėlčiukas (Laisvės pr. 59)";Gintarėliai;2465920649;Ne;2;0;0;2
3496;"Kodėlčiukas (Laisvės pr. 59)";Gintarėliai;8348024909;Ne;4;0;0;4
3497;"Kodėlčiukas (Laisvės pr. 59)";Gintarėliai;4293763647;Ne;10;0;0;10
3498;"Kodėlčiukas (Laisvės pr. 59)";Gintarėliai;3878358193;Ne;5;0;1;6
3499;"Kodėlčiukas (Laisvės pr. 59)";Gintarėliai;6935233288;Ne;10;0;0;10
3500;"Kodėlčiukas (Laisvės pr. 59)";Gintarėliai;1835522972;Ne;7;1;0;8
3501;"Kodėlčiukas (Laisvės pr. 59)";Gintarėliai;9418778626;Ne;9;0;0;9
3502;"Kodėlčiukas (Laisvės pr. 59)";Gintarėliai;5541555127;Ne;4;1;0;5
3503;"Kodėlčiukas (Laisvės pr. 59)";Gintarėliai;8759498015;Ne;11;0;0;11
3504;"Kodėlčiukas (Laisvės pr. 59)";Gintarėliai;4986413731;Ne;9;0;0;9
3505;"Kodėlčiukas (Laisvės pr. 59)";Gintarėliai;2802895479;Ne;2;8;0;10
3506;"Kodėlčiukas (Laisvės pr. 59)";Gintarėliai;9914565606;Ne;4;3;0;7
3507;"Kodėlčiukas (Laisvės pr. 59)";Gintarėliai;7686420784;Ne;10;1;0;11
3508;"Kodėlčiukas (Laisvės pr. 59)";Gintarėliai;3037267215;Taip;2;0;0;2
3509;"Kodėlčiukas (Laisvės pr. 59)";Šnekučiai;6761903865;Ne;0;1;0;1
3510;"Kodėlčiukas (Laisvės pr. 59)";Šnekučiai;3778271049;Ne;2;0;0;2
3511;"Kodėlčiukas (Laisvės pr. 59)";Šnekučiai;7510273691;Ne;2;9;0;11
3512;"Kodėlčiukas (Laisvės pr. 59)";Šnekučiai;4490196764;Ne;0;2;0;2
3513;"Kodėlčiukas (Laisvės pr. 59)";Šnekučiai;5952121209;Ne;0;9;0;9
3514;"Kodėlčiukas (Laisvės pr. 59)";Šnekučiai;2351468626;Ne;0;0;1;1
3515;"Kodėlčiukas (Laisvės pr. 59)";Šnekučiai;9208137169;Ne;5;4;1;10
3516;"Kodėlčiukas (Laisvės pr. 59)";Šnekučiai;5876187643;Ne;5;9;0;14
3517;"Kodėlčiukas (Laisvės pr. 59)";Šnekučiai;4866089623;Ne;0;3;0;3
3518;"Kodėlčiukas (Laisvės pr. 59)";Šnekučiai;1206798597;Ne;2;0;0;2
3519;"Kodėlčiukas (Laisvės pr. 59)";Šnekučiai;9169500252;Ne;17;0;0;17
3520;"Kodėlčiukas (Laisvės pr. 59)";Šnekučiai;4941186694;Ne;4;2;0;6
3521;"Kodėlčiukas (Laisvės pr. 59)";Šnekučiai;6587593805;Ne;1;0;0;1
3522;"Kodėlčiukas (Laisvės pr. 59)";Šnekučiai;1074477043;Ne;1;6;0;7
3523;"Kodėlčiukas (Laisvės pr. 59)";Šnekučiai;9109362006;Ne;5;0;0;5
3524;"Kodėlčiukas (Laisvės pr. 59)";Šnekučiai;9724373368;Ne;0;6;0;6
3525;"Kodėlčiukas (Laisvės pr. 59)";Šnekučiai;2819860331;Ne;6;0;0;6
3526;"Kodėlčiukas (Laisvės pr. 59)";Šnekučiai;9252478832;Ne;15;0;0;15
3527;"Kodėlčiukas (Laisvės pr. 59)";Šnekučiai;4230906452;Ne;0;2;0;2
3528;"Kodėlčiukas (Laisvės pr. 59)";Šnekučiai;1889809198;Ne;0;0;1;1
3529;"Kodėlčiukas (Laisvės pr. 59)";Pabiručiai;9278139998;Ne;1;1;0;2
3530;"Kodėlčiukas (Laisvės pr. 59)";Pabiručiai;6008027505;Ne;4;0;2;6
3531;"Kodėlčiukas (Laisvės pr. 59)";Pabiručiai;6065858518;Ne;0;0;1;1
3532;"Kodėlčiukas (Laisvės pr. 59)";Pabiručiai;9480926599;Taip;8;0;0;8
3533;"Kodėlčiukas (Laisvės pr. 59)";Pabiručiai;9511144369;Ne;0;2;1;3
3534;"Kodėlčiukas (Laisvės pr. 59)";Pabiručiai;7246943802;Ne;11;0;0;11
3535;"Kodėlčiukas (Laisvės pr. 59)";Pabiručiai;8189938439;Ne;7;5;0;12
3536;"Kodėlčiukas (Laisvės pr. 59)";Pabiručiai;5587200800;Ne;4;0;1;5
3537;"Kodėlčiukas (Laisvės pr. 59)";Pabiručiai;1433623973;Ne;7;0;0;7
3538;"Kodėlčiukas (Laisvės pr. 59)";Pabiručiai;1087808091;Ne;1;0;0;1
3539;"Kodėlčiukas (Laisvės pr. 59)";Pabiručiai;5359866071;Ne;1;0;0;1
3540;"Kodėlčiukas (Laisvės pr. 59)";Pabiručiai;5801430256;Ne;10;2;0;12
3541;"Kodėlčiukas (Laisvės pr. 59)";Pabiručiai;7455949617;Ne;1;0;1;2
3542;"Kodėlčiukas (Laisvės pr. 59)";Pabiručiai;1039982141;Ne;6;0;1;7
3543;"Kodėlčiukas (Laisvės pr. 59)";Pabiručiai;4507928289;Ne;1;0;0;1
3544;"Kodėlčiukas (Laisvės pr. 59)";Pabiručiai;9830842598;Ne;5;0;2;7
3545;"Kodėlčiukas (Laisvės pr. 59)";Pabiručiai;3882838712;Ne;3;0;0;3
3546;"Kodėlčiukas (Laisvės pr. 59)";Pabiručiai;8635107742;Ne;3;0;0;3
3547;"Kodėlčiukas (Laisvės pr. 59)";Pabiručiai;5064526349;Ne;7;1;0;8
3548;"Kodėlčiukas (Laisvės pr. 59)";Smalsučiai;6950802941;Ne;8;0;0;8
3549;"Kodėlčiukas (Laisvės pr. 59)";Smalsučiai;6045564826;Ne;0;1;0;1
3550;"Kodėlčiukas (Laisvės pr. 59)";Smalsučiai;7136890681;Ne;1;0;0;1
3551;"Kodėlčiukas (Laisvės pr. 59)";Smalsučiai;7971932716;Ne;1;0;0;1
3552;"Kodėlčiukas (Laisvės pr. 59)";Smalsučiai;7282579315;Taip;3;0;0;3
3553;"Kodėlčiukas (Laisvės pr. 59)";Smalsučiai;6905424567;Ne;2;0;1;3
3554;"Kodėlčiukas (Laisvės pr. 59)";Smalsučiai;5443377251;Taip;0;0;1;1
3555;"Kodėlčiukas (Laisvės pr. 59)";Smalsučiai;6074758814;Ne;0;7;0;7
3556;"Kodėlčiukas (Laisvės pr. 59)";Smalsučiai;3150006441;Ne;3;0;0;3
3557;"Kodėlčiukas (Laisvės pr. 59)";Smalsučiai;1302383608;Ne;9;0;0;9
3558;"Kodėlčiukas (Laisvės pr. 59)";Smalsučiai;7626940433;Ne;0;1;0;1
3559;"Kodėlčiukas (Laisvės pr. 59)";Smalsučiai;5729391456;Ne;15;1;0;16
3560;"Kodėlčiukas (Laisvės pr. 59)";Smalsučiai;7286497455;Ne;2;1;0;3
3561;"Kodėlčiukas (Laisvės pr. 59)";Smalsučiai;4038168647;Ne;0;5;0;5
3562;"Kodėlčiukas (Laisvės pr. 59)";Smalsučiai;1160612316;Ne;0;2;0;2
3563;"Kodėlčiukas (Laisvės pr. 59)";Smalsučiai;3470151604;Ne;3;0;0;3
3564;"Kodėlčiukas (Laisvės pr. 59)";Smalsučiai;5921714669;Ne;7;1;0;8
3565;"Kodėlčiukas (Laisvės pr. 59)";Smalsučiai;6764015170;Ne;0;3;0;3
3566;"Kodėlčiukas (Laisvės pr. 59)";Giliukai;9754425363;Ne;0;1;0;1
3567;"Kodėlčiukas (Laisvės pr. 59)";Giliukai;5587782917;Ne;0;1;0;1
3568;"Kodėlčiukas (Laisvės pr. 59)";Giliukai;8100861190;Taip;0;3;0;3
3569;"Kodėlčiukas (Laisvės pr. 59)";Giliukai;7639341503;Ne;0;1;0;1
3570;"Kodėlčiukas (Laisvės pr. 59)";Giliukai;8017465692;Ne;7;1;0;8
3571;"Kodėlčiukas (Laisvės pr. 59)";Giliukai;7937365710;Ne;7;0;0;7
3572;"Kodėlčiukas (Laisvės pr. 59)";Giliukai;9733831323;Ne;0;0;2;2
3573;"Kodėlčiukas (Laisvės pr. 59)";Giliukai;7007386353;Ne;8;0;0;8
3574;"Kodėlčiukas (Laisvės pr. 59)";Giliukai;9721353724;Ne;9;0;1;10
3575;"Kodėlčiukas (Laisvės pr. 59)";Giliukai;2943146610;Ne;0;1;0;1
3576;"Kodėlčiukas (Laisvės pr. 59)";Giliukai;5573845415;Taip;0;0;2;2
3577;"Kodėlčiukas (Laisvės pr. 59)";Giliukai;8785157050;Ne;0;15;0;15
3578;"Kodėlčiukas (Laisvės pr. 59)";Giliukai;5770748359;Ne;4;9;0;13
3579;"Kodėlčiukas (Laisvės pr. 59)";Giliukai;9992204262;Ne;10;0;0;10
3580;"Kodėlčiukas (Laisvės pr. 59)";Giliukai;6643473339;Ne;0;1;0;1
3581;"Kodėlčiukas (Laisvės pr. 59)";Giliukai;3130715310;Ne;0;2;0;2
3582;"Kodėlčiukas (Laisvės pr. 59)";Giliukai;3686259290;Ne;5;0;0;5
3583;"Kodėlčiukas (Laisvės pr. 59)";Giliukai;2928885561;Ne;4;0;1;5
3584;"Kodėlčiukas (Laisvės pr. 59)";Gudručiai;1191430672;Ne;4;0;0;4
3585;"Kodėlčiukas (Laisvės pr. 59)";Gudručiai;6988515253;Ne;4;0;0;4
3586;"Kodėlčiukas (Laisvės pr. 59)";Gudručiai;3385551650;Ne;2;0;0;2
3587;"Kodėlčiukas (Laisvės pr. 59)";Gudručiai;9865803714;Ne;5;0;0;5
3588;"Kodėlčiukas (Laisvės pr. 59)";Gudručiai;7430239198;Ne;2;0;2;4
3589;"Kodėlčiukas (Laisvės pr. 59)";Gudručiai;7116594055;Ne;3;0;4;7
3590;"Kodėlčiukas (Laisvės pr. 59)";Gudručiai;9483378853;Ne;3;1;1;5
3591;"Kodėlčiukas (Laisvės pr. 59)";Gudručiai;8890987483;Ne;0;0;5;5
3592;"Kodėlčiukas (Laisvės pr. 59)";Gudručiai;4687333060;Ne;0;2;0;2
3593;"Kodėlčiukas (Laisvės pr. 59)";Gudručiai;1491160730;Ne;0;0;1;1
3594;"Kodėlčiukas (Laisvės pr. 59)";Gudručiai;4543838852;Ne;0;0;1;1
3595;"Kodėlčiukas (Laisvės pr. 59)";Gudručiai;2216791610;Ne;3;0;0;3
3596;"Kodėlčiukas (Laisvės pr. 59)";Gudručiai;2987907651;Ne;0;0;1;1
3597;"Kodėlčiukas (Laisvės pr. 59)";Gudručiai;9028856983;Ne;4;1;0;5
3598;"Kodėlčiukas (Laisvės pr. 59)";Gudručiai;6014084915;Ne;8;1;0;9
3599;"Kodėlčiukas (Laisvės pr. 59)";Gudručiai;3068084704;Ne;7;0;0;7
3600;"Kodėlčiukas (Laisvės pr. 59)";Gudručiai;6985788287;Ne;4;0;0;4
3601;"Kodėlčiukas (Laisvės pr. 59)";Gudručiai;3427610168;Ne;8;0;1;9
3602;"Kodėlčiukas (Laisvės pr. 59)";Žirniukai;2402290604;Ne;9;0;0;9
3603;"Kodėlčiukas (Laisvės pr. 59)";Žirniukai;1050905569;Ne;4;2;0;6
3604;"Kodėlčiukas (Laisvės pr. 59)";Žirniukai;3053949510;Taip;11;0;0;11
3605;"Kodėlčiukas (Laisvės pr. 59)";Žirniukai;5325660102;Ne;0;2;1;3
3606;"Kodėlčiukas (Laisvės pr. 59)";Žirniukai;8429572505;Ne;0;0;3;3
3607;"Kodėlčiukas (Laisvės pr. 59)";Žirniukai;4321485862;Ne;11;0;0;11
3608;"Kodėlčiukas (Laisvės pr. 59)";Žirniukai;1550287298;Ne;1;4;0;5
3609;"Kodėlčiukas (Laisvės pr. 59)";Žirniukai;4341694264;Ne;11;0;0;11
3610;"Kodėlčiukas (Laisvės pr. 59)";Žirniukai;4597473929;Taip;6;0;0;6
3611;"Kodėlčiukas (Laisvės pr. 59)";Žirniukai;9702236745;Ne;3;7;0;10
3612;"Kodėlčiukas (Laisvės pr. 59)";Žirniukai;7189930025;Ne;3;0;0;3
3613;"Kodėlčiukas (Laisvės pr. 59)";Žirniukai;4187856743;Ne;1;0;0;1
3614;"Kodėlčiukas (Laisvės pr. 59)";Žirniukai;4530733149;Ne;3;3;0;6
3615;"Kodėlčiukas (Laisvės pr. 59)";Žirniukai;4896921433;Ne;0;1;0;1
3616;"Kodėlčiukas (Laisvės pr. 59)";Katinėliai;4730433849;Ne;8;0;0;8
3617;"Kodėlčiukas (Laisvės pr. 59)";Katinėliai;4995538090;Ne;0;0;1;1
3618;"Kodėlčiukas (Laisvės pr. 59)";Katinėliai;8045906704;Ne;5;0;0;5
3619;"Kodėlčiukas (Laisvės pr. 59)";Katinėliai;7306085848;Ne;4;0;0;4
3620;"Kodėlčiukas (Laisvės pr. 59)";Katinėliai;5650077893;Ne;7;0;0;7
3621;"Kodėlčiukas (Laisvės pr. 59)";Katinėliai;3239314295;Ne;6;0;0;6
3622;"Kodėlčiukas (Laisvės pr. 59)";Katinėliai;9221561862;Ne;2;0;0;2
3623;"Kodėlčiukas (Laisvės pr. 59)";Katinėliai;6355536268;Ne;0;0;1;1
3624;"Kodėlčiukas (Laisvės pr. 59)";Katinėliai;2147517344;Ne;7;1;0;8
3625;"Kodėlčiukas (Laisvės pr. 59)";Katinėliai;2119041584;Ne;3;0;0;3
3626;"Kodėlčiukas (Laisvės pr. 59)";Katinėliai;1570599010;Ne;7;5;0;12
3627;"Kodėlčiukas (Laisvės pr. 59)";Katinėliai;9670055064;Ne;0;0;1;1
3628;"Kodėlčiukas (Laisvės pr. 59)";Katinėliai;4727546035;Ne;12;0;2;14
3629;"Kodėlčiukas (Laisvės pr. 59)";Katinėliai;6011097577;Taip;14;0;0;14
3630;"Kodėlčiukas (Laisvės pr. 59)";Katinėliai;6334889816;Ne;20;0;0;20
3631;"Kodėlčiukas (Laisvės pr. 59)";Katinėliai;6135628975;Ne;20;0;0;20
3632;"Kodėlčiukas (Laisvės pr. 59)";Katinėliai;4028114251;Ne;7;0;0;7
3633;"Kodėlčiukas (Laisvės pr. 59)";Nykštukai;2722591942;Ne;3;0;0;3
3634;"Kodėlčiukas (Laisvės pr. 59)";Nykštukai;5719244938;Ne;6;0;1;7
3635;"Kodėlčiukas (Laisvės pr. 59)";Nykštukai;4643616472;Ne;3;0;0;3
3636;"Kodėlčiukas (Laisvės pr. 59)";Nykštukai;6498584861;Ne;3;0;0;3
3637;"Kodėlčiukas (Laisvės pr. 59)";Nykštukai;8324804944;Ne;9;1;0;10
3638;"Kodėlčiukas (Laisvės pr. 59)";Nykštukai;1776582488;Ne;1;0;0;1
3639;"Kodėlčiukas (Laisvės pr. 59)";Nykštukai;2394070354;Ne;3;6;0;9
3640;"Kodėlčiukas (Laisvės pr. 59)";Nykštukai;3018381817;Ne;10;0;0;10
3641;"Kodėlčiukas (Laisvės pr. 59)";Nykštukai;9330345860;Ne;3;0;0;3
3642;"Kodėlčiukas (Laisvės pr. 59)";Nykštukai;9645711345;Ne;10;0;0;10
3643;"Kodėlčiukas (Laisvės pr. 59)";Nykštukai;3663726193;Taip;3;0;0;3
3644;"Kodėlčiukas (Laisvės pr. 59)";Nykštukai;3509994698;Ne;11;0;0;11
3645;"Kodėlčiukas (Laisvės pr. 59)";Nykštukai;8943422067;Ne;4;0;0;4
3646;"Kodėlčiukas (Laisvės pr. 59)";Nykštukai;3737512833;Taip;9;0;0;9
3647;"Kodėlčiukas (Laisvės pr. 59)";Nykštukai;8399334364;Ne;6;0;0;6
3648;"Kodėlčiukas (Laisvės pr. 59)";Nykštukai;1498607108;Ne;3;0;1;4
3649;"Kodėlčiukas (Laisvės pr. 59)";Nykštukai;7963235116;Ne;20;0;0;20
3650;"Kodėlčiukas (Laisvės pr. 59)";ŽIOGELIAI;8769409404;Taip;7;0;0;7
3651;"Kodėlčiukas (Laisvės pr. 59)";ŽIOGELIAI;5189091564;Ne;1;0;0;1
3652;"Kodėlčiukas (Laisvės pr. 59)";ŽIOGELIAI;6745245907;Ne;1;0;0;1
3653;"Kodėlčiukas (Laisvės pr. 59)";ŽIOGELIAI;9055399463;Ne;3;0;5;8
3654;"Kodėlčiukas (Laisvės pr. 59)";ŽIOGELIAI;2081199093;Ne;20;0;0;20
3655;"Kodėlčiukas (Laisvės pr. 59)";ŽIOGELIAI;5115939251;Ne;5;0;0;5
3656;"Kodėlčiukas (Laisvės pr. 59)";ŽIOGELIAI;3603781385;Taip;7;4;0;11
3657;"Kodėlčiukas (Laisvės pr. 59)";ŽIOGELIAI;6749972956;Ne;7;0;0;7
3658;"Kodėlčiukas (Laisvės pr. 59)";ŽIOGELIAI;2189949450;Ne;0;0;1;1
3659;"Kodėlčiukas (Laisvės pr. 59)";ŽIOGELIAI;7497358286;Ne;17;0;0;17
3660;"Kodėlčiukas (Laisvės pr. 59)";ŽIOGELIAI;4089558399;Ne;9;0;0;9
3661;"Kodėlčiukas (Laisvės pr. 59)";ŽIOGELIAI;4969181023;Ne;6;0;0;6
3662;"Kodėlčiukas (Laisvės pr. 59)";BITUTĖS;8144034996;Ne;0;0;1;1
3663;"Kodėlčiukas (Laisvės pr. 59)";BITUTĖS;4444145328;Ne;2;0;0;2
3664;"Kodėlčiukas (Laisvės pr. 59)";BITUTĖS;9844479346;Ne;17;0;0;17
3665;"Kodėlčiukas (Laisvės pr. 59)";BITUTĖS;5222125070;Ne;3;1;0;4
3666;"Kodėlčiukas (Laisvės pr. 59)";BITUTĖS;7251390043;Ne;15;0;0;15
3667;"Kodėlčiukas (Laisvės pr. 59)";BITUTĖS;6580462777;Ne;6;0;0;6
3668;"Kodėlčiukas (Laisvės pr. 59)";BITUTĖS;6800848383;Ne;5;0;0;5
3669;"Kodėlčiukas (Laisvės pr. 59)";BITUTĖS;5023273477;Ne;16;0;0;16
3670;"Kodėlčiukas (Laisvės pr. 59)";BITUTĖS;3970337050;Ne;5;0;0;5
3671;"Kodėlčiukas (Laisvės pr. 59)";BITUTĖS;7539430546;Ne;11;0;0;11
3672;"Kodėlčiukas (Laisvės pr. 59)";BITUTĖS;7148837596;Ne;12;0;0;12
3673;"Kodėlčiukas (Laisvės pr. 59)";BITUTĖS;5474194439;Ne;15;0;0;15
3674;"Kodėlčiukas (Laisvės pr. 59)";VYŠNIUKAI;7705057116;Ne;0;4;1;5
3675;"Kodėlčiukas (Laisvės pr. 59)";VYŠNIUKAI;7643398934;Ne;5;0;1;6
3676;"Kodėlčiukas (Laisvės pr. 59)";VYŠNIUKAI;8799798070;Ne;3;0;0;3
3677;"Kodėlčiukas (Laisvės pr. 59)";VYŠNIUKAI;7119815662;Ne;10;0;0;10
3678;"Kodėlčiukas (Laisvės pr. 59)";VYŠNIUKAI;9398732476;Taip;11;0;3;14
3679;"Kodėlčiukas (Laisvės pr. 59)";VYŠNIUKAI;2720748563;Ne;5;1;0;6
3680;"Kodėlčiukas (Laisvės pr. 59)";VYŠNIUKAI;9914322177;Ne;5;0;0;5
3681;"Kodėlčiukas (Laisvės pr. 59)";VYŠNIUKAI;1925590099;Ne;5;0;0;5
3682;"Kodėlčiukas (Laisvės pr. 59)";VYŠNIUKAI;7242653444;Ne;7;0;0;7
3683;"Kodėlčiukas (Laisvės pr. 59)";VYŠNIUKAI;2298734536;Ne;4;1;0;5
3684;"Kodėlčiukas (Laisvės pr. 59)";VYŠNIUKAI;6261333618;Ne;1;0;0;1
3685;"Kodėlčiukas (Laisvės pr. 59)";VYŠNIUKAI;2549153581;Ne;12;0;0;12
3686;"Kodėlčiukas (Laisvės pr. 59)";VYŠNIUKAI;1808211253;Ne;1;9;0;10
3687;"Kodėlčiukas (Laisvės pr. 59)";VYŠNIUKAI;5178305435;Taip;14;0;0;14
3688;"Kodėlčiukas (Laisvės pr. 59)";VYŠNIUKAI;5061852590;Ne;2;6;1;9
3689;"Kodėlčiukas (Laisvės pr. 59)";VYŠNIUKAI;4782931414;Ne;15;5;0;20
3690;"Kodėlčiukas (Laisvės pr. 59)";VYŠNIUKAI;1803320085;Taip;5;0;2;7
3691;"Kodėlčiukas (Laisvės pr. 59)";VYŠNIUKAI;3938536446;Ne;0;0;5;5
3692;"Kodėlčiukas (Laisvės pr. 59)";VYŠNIUKAI;6656558797;Ne;2;0;0;2
3693;"Kodėlčiukas (Laisvės pr. 59)";BORUŽĖLĖS;2340866110;Taip;11;0;1;12
3694;"Kodėlčiukas (Laisvės pr. 59)";BORUŽĖLĖS;6726383331;Ne;8;0;0;8
3695;"Kodėlčiukas (Laisvės pr. 59)";BORUŽĖLĖS;1568628843;Ne;8;6;0;14
3696;"Kodėlčiukas (Laisvės pr. 59)";BORUŽĖLĖS;2438891967;Ne;3;0;0;3
3697;"Kodėlčiukas (Laisvės pr. 59)";BORUŽĖLĖS;3156788328;Ne;1;0;0;1
3698;"Kodėlčiukas (Laisvės pr. 59)";BORUŽĖLĖS;7186835214;Ne;3;0;0;3
3699;"Kodėlčiukas (Laisvės pr. 59)";BORUŽĖLĖS;8829986201;Ne;0;0;2;2
3700;"Kodėlčiukas (Laisvės pr. 59)";BORUŽĖLĖS;4529565626;Ne;2;0;1;3
3701;"Kodėlčiukas (Laisvės pr. 59)";BORUŽĖLĖS;9020265248;Ne;0;0;1;1
3702;"Kodėlčiukas (Laisvės pr. 59)";BORUŽĖLĖS;2313607716;Taip;0;1;0;1
3703;"Kodėlčiukas (Laisvės pr. 59)";BORUŽĖLĖS;9209671311;Ne;7;0;0;7
3704;"Kodėlčiukas (Laisvės pr. 59)";BORUŽĖLĖS;9736751250;Ne;2;1;1;4
3705;"Kodėlčiukas (Laisvės pr. 59)";BORUŽĖLĖS;7227149646;Ne;5;0;2;7
3706;"Kodėlčiukas (Laisvės pr. 59)";BORUŽĖLĖS;1197049907;Ne;5;0;3;8
3707;"Kodėlčiukas (Laisvės pr. 59)";BORUŽĖLĖS;3985455729;Ne;0;0;1;1
3708;"Kodėlčiukas (Laisvės pr. 59)";BORUŽĖLĖS;5068611716;Taip;0;0;1;1
3709;"Kodėlčiukas (Laisvės pr. 59)";BORUŽĖLĖS;7910205296;Ne;0;0;2;2
3710;"Kodėlčiukas (Laisvės pr. 59)";BORUŽĖLĖS;1047209628;Ne;7;0;0;7
3711;"Kodėlčiukas (Laisvės pr. 59)";BORUŽĖLĖS;8932472612;Ne;1;0;0;1
3712;"Kodėlčiukas (Laisvės pr. 59)";VYTURĖLIAI;6714818379;Ne;0;4;0;4
3713;"Kodėlčiukas (Laisvės pr. 59)";VYTURĖLIAI;4218096561;Ne;4;7;0;11
3714;"Kodėlčiukas (Laisvės pr. 59)";VYTURĖLIAI;4514764005;Ne;4;0;0;4
3715;"Kodėlčiukas (Laisvės pr. 59)";VYTURĖLIAI;2169307879;Ne;13;0;0;13
3716;"Kodėlčiukas (Laisvės pr. 59)";VYTURĖLIAI;2448536092;Ne;3;0;0;3
3717;"Kodėlčiukas (Laisvės pr. 59)";VYTURĖLIAI;8263945732;Ne;13;0;0;13
3718;"Kodėlčiukas (Laisvės pr. 59)";VYTURĖLIAI;7612531087;Ne;1;0;0;1
3719;"Kodėlčiukas (Laisvės pr. 59)";VYTURĖLIAI;2904858964;Ne;15;0;0;15
3720;"Kodėlčiukas (Laisvės pr. 59)";VYTURĖLIAI;3413659259;Ne;5;0;0;5
3721;"Kodėlčiukas (Laisvės pr. 59)";VYTURĖLIAI;9673271313;Ne;5;0;0;5
3722;"Kodėlčiukas (Laisvės pr. 59)";VYTURĖLIAI;5710301153;Ne;13;0;0;13
3723;"Kodėlčiukas (Laisvės pr. 59)";VYTURĖLIAI;1746835627;Ne;1;0;0;1
3724;"Kodėlčiukas (Laisvės pr. 59)";VYTURĖLIAI;5474125905;Ne;0;4;0;4
3725;"Kodėlčiukas (Laisvės pr. 59)";VYTURĖLIAI;3472862544;Ne;10;0;0;10
3726;"Kodėlčiukas (Laisvės pr. 59)";VYTURĖLIAI;7778188733;Ne;2;0;0;2
3727;"Kodėlčiukas (Laisvės pr. 59)";VYTURĖLIAI;6476445296;Ne;3;0;0;3
3728;"Kodėlčiukas (Laisvės pr. 59)";DRUGELIAI;4165123345;Taip;5;0;0;5
3729;"Kodėlčiukas (Laisvės pr. 59)";DRUGELIAI;5772071707;Ne;3;0;0;3
3730;"Kodėlčiukas (Laisvės pr. 59)";DRUGELIAI;1149682376;Ne;10;0;0;10
3731;"Kodėlčiukas (Laisvės pr. 59)";DRUGELIAI;2353960861;Ne;5;2;0;7
3732;"Kodėlčiukas (Laisvės pr. 59)";DRUGELIAI;6103959702;Ne;0;0;1;1
3733;"Kodėlčiukas (Laisvės pr. 59)";DRUGELIAI;5505788210;Ne;1;0;1;2
3734;"Kodėlčiukas (Laisvės pr. 59)";DRUGELIAI;5577154148;Ne;1;3;0;4
3735;"Kodėlčiukas (Laisvės pr. 59)";DRUGELIAI;9979034031;Ne;2;1;0;3
3736;"Kodėlčiukas (Laisvės pr. 59)";DRUGELIAI;3240221130;Ne;0;1;0;1
3737;"Kodėlčiukas (Laisvės pr. 59)";DRUGELIAI;9139424911;Ne;2;0;0;2
3738;"Kodėlčiukas (Laisvės pr. 59)";DRUGELIAI;9664432781;Ne;4;0;0;4
3739;"Kodėlčiukas (Laisvės pr. 59)";DRUGELIAI;5197946954;Ne;10;0;0;10
3740;"Kodėlčiukas (Laisvės pr. 59)";DRUGELIAI;8315176054;Ne;8;5;0;13
3741;"Kodėlčiukas (Laisvės pr. 59)";DRUGELIAI;7908217415;Taip;1;0;1;2
3742;"Kodėlčiukas (Laisvės pr. 59)";OBUOLIUKAI;1289342844;Ne;7;0;1;8
3743;"Kodėlčiukas (Laisvės pr. 59)";OBUOLIUKAI;7318196860;Ne;5;0;0;5
3744;"Kodėlčiukas (Laisvės pr. 59)";OBUOLIUKAI;8208448849;Ne;2;0;0;2
3745;"Kodėlčiukas (Laisvės pr. 59)";OBUOLIUKAI;1683506414;Ne;0;0;3;3
3746;"Kodėlčiukas (Laisvės pr. 59)";OBUOLIUKAI;3315862631;Taip;0;5;0;5
3747;"Kodėlčiukas (Laisvės pr. 59)";OBUOLIUKAI;5896726125;Ne;0;0;2;2
3748;"Kodėlčiukas (Laisvės pr. 59)";OBUOLIUKAI;3168418461;Ne;0;5;0;5
3749;"Kodėlčiukas (Laisvės pr. 59)";OBUOLIUKAI;9645987751;Ne;6;4;0;10
3750;"Kodėlčiukas (Laisvės pr. 59)";OBUOLIUKAI;5860975805;Ne;0;0;1;1
3751;"Kodėlčiukas (Laisvės pr. 59)";OBUOLIUKAI;8782155591;Taip;6;1;2;9
3752;"Kodėlčiukas (Laisvės pr. 59)";OBUOLIUKAI;8104220950;Ne;0;1;0;1
3753;"Kodėlčiukas (Laisvės pr. 59)";OBUOLIUKAI;2005453189;Ne;10;0;0;10
3754;"Kodėlčiukas (Laisvės pr. 59)";OBUOLIUKAI;5173730926;Ne;10;1;0;11
3755;"Kodėlčiukas (Laisvės pr. 59)";OBUOLIUKAI;3442449482;Ne;0;0;2;2
3756;"Kodėlčiukas (Laisvės pr. 59)";OBUOLIUKAI;7946010973;Taip;0;11;0;11
3757;"Kodėlčiukas (Laisvės pr. 59)";OBUOLIUKAI;5342852235;Ne;0;6;0;6
3758;"Kodėlčiukas (Laisvės pr. 59)";OBUOLIUKAI;8563412043;Ne;5;1;0;6
3759;"Kodėlčiukas (Laisvės pr. 59)";OBUOLIUKAI;4026784012;Ne;5;1;1;7
3760;"Kodėlčiukas (Laisvės pr. 59)";OBUOLIUKAI;2114176689;Ne;2;0;0;2
3761;"Kodėlčiukas (Laisvės pr. 59)";OBUOLIUKAI;3033687110;Taip;13;0;0;13
3762;"Kodėlčiukas (Laisvės pr. 59)";OBUOLIUKAI;5252261660;Ne;10;2;0;12
3763;"Kodėlčiukas (Laisvės pr. 59)";AITVARIUKAI;9573073973;Ne;2;0;1;3
3764;"Kodėlčiukas (Laisvės pr. 59)";AITVARIUKAI;1029573241;Taip;6;0;0;6
3765;"Kodėlčiukas (Laisvės pr. 59)";AITVARIUKAI;1029573241;Taip;6;0;0;6
3766;"Kodėlčiukas (Laisvės pr. 59)";AITVARIUKAI;2892318767;Taip;14;0;0;14
3767;"Kodėlčiukas (Laisvės pr. 59)";AITVARIUKAI;2892318767;Taip;14;0;0;14
3768;"Kodėlčiukas (Laisvės pr. 59)";AITVARIUKAI;6809202793;Taip;5;0;0;5
3769;"Kodėlčiukas (Laisvės pr. 59)";AITVARIUKAI;6809202793;Taip;5;0;0;5
3770;"Kodėlčiukas (Laisvės pr. 59)";AITVARIUKAI;9389125350;Taip;1;0;0;1
3771;"Kodėlčiukas (Laisvės pr. 59)";AITVARIUKAI;9389125350;Taip;1;0;0;1
3772;"Kodėlčiukas (Laisvės pr. 59)";AITVARIUKAI;1784673088;Taip;5;0;0;5
3773;"Kodėlčiukas (Laisvės pr. 59)";AITVARIUKAI;1784673088;Taip;5;0;0;5
3774;"Kodėlčiukas (Laisvės pr. 59)";AITVARIUKAI;2429997257;Taip;1;0;0;1
3775;"Kodėlčiukas (Laisvės pr. 59)";AITVARIUKAI;2429997257;Taip;1;0;0;1
3776;"Kodėlčiukas (Laisvės pr. 59)";AITVARIUKAI;8707777661;Taip;15;0;0;15
3777;"Kodėlčiukas (Laisvės pr. 59)";AITVARIUKAI;8707777661;Taip;15;0;0;15
3778;"Kodėlčiukas (Laisvės pr. 59)";AITVARIUKAI;4366942357;Taip;1;0;0;1
3779;"Kodėlčiukas (Laisvės pr. 59)";AITVARIUKAI;4366942357;Taip;1;0;0;1
3780;"Kodėlčiukas (Laisvės pr. 59)";AITVARIUKAI;2601561338;Taip;9;0;0;9
3781;"Kodėlčiukas (Laisvės pr. 59)";AITVARIUKAI;3735299373;Ne;0;0;1;1
3782;"Kodėlčiukas (Laisvės pr. 59)";AITVARIUKAI;3071951746;Ne;12;0;0;12
3783;"Kodėlčiukas (Laisvės pr. 59)";DEBESĖLIAI;2048119857;Ne;13;0;0;13
3784;"Kodėlčiukas (Laisvės pr. 59)";DEBESĖLIAI;7141979862;Taip;7;0;0;7
3785;"Kodėlčiukas (Laisvės pr. 59)";DEBESĖLIAI;7141979862;Taip;7;0;0;7
3786;"Kodėlčiukas (Laisvės pr. 59)";DEBESĖLIAI;1725192281;Ne;7;0;1;8
3787;"Kodėlčiukas (Laisvės pr. 59)";DEBESĖLIAI;1725192281;Ne;7;0;1;8
3788;"Kodėlčiukas (Laisvės pr. 59)";DEBESĖLIAI;2914410829;Ne;12;0;0;12
3789;"Kodėlčiukas (Laisvės pr. 59)";DEBESĖLIAI;3662576624;Ne;0;6;0;6
3790;"Kodėlčiukas (Laisvės pr. 59)";DEBESĖLIAI;6567146331;Taip;2;0;0;2
3791;"Kodėlčiukas (Laisvės pr. 59)";DEBESĖLIAI;6567146331;Taip;2;0;0;2
3792;"Kodėlčiukas (Laisvės pr. 59)";DEBESĖLIAI;5786431452;Ne;8;0;0;8
3793;"Kodėlčiukas (Laisvės pr. 59)";DEBESĖLIAI;1056383365;Ne;0;0;13;13
3794;"Kodėlčiukas (Laisvės pr. 59)";DEBESĖLIAI;3609685477;Ne;6;0;0;6
3795;"Kodėlčiukas (Laisvės pr. 59)";EŽIUKAI;3869434109;Ne;1;0;2;3
3796;"Kodėlčiukas (Laisvės pr. 59)";EŽIUKAI;1906930504;Ne;2;0;0;2
3797;"Kodėlčiukas (Laisvės pr. 59)";EŽIUKAI;5925818434;Ne;7;0;0;7
3798;"Kodėlčiukas (Laisvės pr. 59)";EŽIUKAI;5925818434;Ne;7;0;0;7
3799;"Kodėlčiukas (Laisvės pr. 59)";EŽIUKAI;7107700885;Ne;0;2;0;2
3800;"Kodėlčiukas (Laisvės pr. 59)";EŽIUKAI;7107700885;Ne;0;2;0;2
3801;"Kodėlčiukas (Laisvės pr. 59)";EŽIUKAI;4842829705;Ne;0;2;0;2
3802;"Kodėlčiukas (Laisvės pr. 59)";EŽIUKAI;4842829705;Ne;0;2;0;2
3803;"Kodėlčiukas (Laisvės pr. 59)";EŽIUKAI;3529385544;Ne;4;0;0;4
3804;"Kodėlčiukas (Laisvės pr. 59)";EŽIUKAI;2728038596;Ne;2;0;0;2
3805;"Kodėlčiukas (Laisvės pr. 59)";EŽIUKAI;6373705667;Ne;19;0;0;19
3806;"Kodėlčiukas (Laisvės pr. 59)";EŽIUKAI;6373705667;Ne;19;0;0;19
3807;"Kodėlčiukas (Laisvės pr. 59)";EŽIUKAI;7035441207;Taip;7;0;0;7
3808;"Kodėlčiukas (Laisvės pr. 59)";EŽIUKAI;2999381333;Taip;5;0;2;7
3809;"Kodėlčiukas (Laisvės pr. 59)";EŽIUKAI;2999381333;Taip;5;0;2;7
3810;"Kodėlčiukas (Laisvės pr. 59)";EŽIUKAI;5540660080;Ne;6;0;0;6
3811;"Kodėlčiukas (Laisvės pr. 59)";EŽIUKAI;4795230461;Ne;1;0;0;1
3812;"Kodėlčiukas (Laisvės pr. 59)";EŽIUKAI;9092413482;Ne;2;0;0;2
3813;"Kodėlčiukas (Laisvės pr. 59)";EŽIUKAI;9424975662;Taip;0;7;0;7
3814;"Kodėlčiukas (Laisvės pr. 59)";EŽIUKAI;9424975662;Taip;0;7;0;7
3815;"Kodėlčiukas (Laisvės pr. 59)";EŽIUKAI;3598405258;Ne;1;0;0;1
3816;"Kodėlčiukas (Laisvės pr. 59)";EŽIUKAI;3598405258;Ne;1;0;0;1
3817;"Kodėlčiukas (Laisvės pr. 59)";EŽIUKAI;5025581128;Ne;4;0;0;4
3818;"Kodėlčiukas (Laisvės pr. 59)";EŽIUKAI;5025581128;Ne;4;0;0;4
3819;"Kodėlčiukas (Laisvės pr. 59)";EŽIUKAI;1761109453;Ne;5;0;0;5
3820;Kurpaitė;Viščiukų;9825971721;Ne;0;4;0;4
3821;Kurpaitė;Viščiukų;4572559234;Ne;14;0;0;14
3822;Kurpaitė;Viščiukų;1370461809;Taip;6;0;0;6
3823;Kurpaitė;Viščiukų;9299294437;Ne;8;0;0;8
3824;Kurpaitė;Viščiukų;9761100202;Ne;15;0;0;15
3825;Kurpaitė;Viščiukų;1558096975;Ne;0;9;0;9
3826;Kurpaitė;Viščiukų;7973054986;Ne;0;4;0;4
3827;Kurpaitė;Viščiukų;2233142424;Ne;8;0;0;8
3828;Kurpaitė;Viščiukų;5629017875;Ne;3;0;0;3
3829;Kurpaitė;Viščiukų;5234784564;Taip;0;20;0;20
3830;Kurpaitė;Viščiukų;2772566963;Ne;4;0;0;4
3831;Kurpaitė;Gėlyčių;5952306163;Ne;0;8;0;8
3832;Kurpaitė;Gėlyčių;3139272175;Ne;0;15;0;15
3833;Kurpaitė;Gėlyčių;2629958613;Ne;1;0;0;1
3834;Kurpaitė;Gėlyčių;2629958613;Ne;1;0;0;1
3835;Kurpaitė;Gėlyčių;4687182527;Ne;11;0;0;11
3836;Kurpaitė;Gėlyčių;2373582223;Ne;0;20;0;20
3837;Kurpaitė;Gėlyčių;2157581956;Ne;0;9;0;9
3838;Kurpaitė;Gėlyčių;5175919323;Ne;0;15;0;15
3839;Kurpaitė;Gėlyčių;7194351335;Ne;15;0;0;15
3840;Kurpaitė;Gėlyčių;5701318496;Ne;5;2;0;7
3841;Kurpaitė;Gėlyčių;2744439309;Ne;1;0;0;1
3842;Kurpaitė;Gėlyčių;5923694769;Ne;2;0;0;2
3843;Kurpaitė;Gėlyčių;3481813493;Ne;1;0;0;1
3844;Kurpaitė;Gėlyčių;8402747029;Ne;0;2;0;2
3845;Kurpaitė;Gėlyčių;5447826458;Taip;0;8;0;8
3846;Kurpaitė;Gėlyčių;4657523142;Ne;10;1;0;11
3847;Kurpaitė;Gėlyčių;2867842844;Ne;17;0;0;17
3848;Kurpaitė;Gėlyčių;6859316204;Ne;3;0;0;3
3849;Kurpaitė;Drugelių;8868415451;Ne;0;8;0;8
3850;Kurpaitė;Drugelių;1273426668;Ne;0;1;0;1
3851;Kurpaitė;Drugelių;1413326858;Ne;3;0;0;3
3852;Kurpaitė;Drugelių;6568580994;Taip;0;10;0;10
3853;Kurpaitė;Drugelių;1752006477;Ne;11;0;0;11
3854;Kurpaitė;Drugelių;9922582884;Ne;4;0;0;4
3855;Kurpaitė;Drugelių;3989274600;Ne;0;2;0;2
3856;Kurpaitė;Drugelių;1927773278;Ne;0;12;0;12
3857;Kurpaitė;Drugelių;8361612709;Ne;0;4;0;4
3858;Kurpaitė;Drugelių;7703075096;Taip;0;11;0;11
3859;Kurpaitė;Drugelių;4607835570;Ne;2;0;0;2
3860;Kurpaitė;Drugelių;1964193512;Ne;0;2;0;2
3861;Kurpaitė;Pelyčių;7546409044;Ne;0;13;0;13
3862;Kurpaitė;Pelyčių;1209441106;Ne;0;0;10;10
3863;Kurpaitė;Pelyčių;4519369081;Ne;1;0;0;1
3864;Kurpaitė;Pelyčių;7897713994;Ne;0;7;0;7
3865;Kurpaitė;Pelyčių;4188925256;Ne;5;4;0;9
3866;Kurpaitė;Pelyčių;3003517700;Ne;6;0;0;6
3867;Kurpaitė;Pelyčių;3634641300;Ne;2;4;0;6
3868;Kurpaitė;Pelyčių;5844470373;Ne;15;0;0;15
3869;Kurpaitė;Pelyčių;1864484931;Ne;7;0;0;7
3870;Kurpaitė;Pelyčių;8069116180;Ne;5;0;0;5
3871;Kurpaitė;Pelyčių;9384218589;Ne;5;14;0;19
3872;Kurpaitė;Pelyčių;6309468728;Ne;20;0;0;20
3873;Kurpaitė;Pelyčių;4964063637;Ne;0;5;0;5
3874;Kurpaitė;Pelyčių;2827617670;Ne;0;3;0;3
3875;Kurpaitė;Pelyčių;4168882748;Ne;0;10;0;10
3876;"Kūlverstukas (Suvalkų g. 6)";Saulutės;5340239466;Ne;1;0;0;1
3877;"Kūlverstukas (Suvalkų g. 6)";Saulutės;8294873714;Ne;0;5;0;5
3878;"Kūlverstukas (Suvalkų g. 6)";Saulutės;7970898546;Ne;5;0;0;5
3879;"Kūlverstukas (Suvalkų g. 6)";Saulutės;5391554530;Ne;0;3;0;3
3880;"Kūlverstukas (Suvalkų g. 6)";Saulutės;6710735721;Ne;0;3;0;3
3881;"Kūlverstukas (Suvalkų g. 6)";Saulutės;1067182820;Ne;0;2;0;2
3882;"Kūlverstukas (Suvalkų g. 6)";Saulutės;8346712630;Ne;1;0;0;1
3883;"Kūlverstukas (Suvalkų g. 6)";Saulutės;8333084277;Ne;1;0;0;1
3884;"Kūlverstukas (Suvalkų g. 6)";Peledžiukai;4073233921;Ne;0;8;0;8
3885;"Kūlverstukas (Suvalkų g. 6)";Peledžiukai;3238807604;Ne;0;3;0;3
3886;"Kūlverstukas (Suvalkų g. 6)";Peledžiukai;1932066021;Ne;2;0;0;2
3887;"Kūlverstukas (Suvalkų g. 6)";Peledžiukai;9655585527;Ne;4;3;1;8
3888;"Kūlverstukas (Suvalkų g. 6)";Peledžiukai;5345423038;Taip;0;11;0;11
3889;"Kūlverstukas (Suvalkų g. 6)";Peledžiukai;3270176280;Ne;5;0;0;5
3890;"Kūlverstukas (Suvalkų g. 6)";Peledžiukai;6894291912;Ne;7;5;0;12
3891;"Kūlverstukas (Suvalkų g. 6)";Peledžiukai;3224736003;Ne;5;6;0;11
3892;"Kūlverstukas (Suvalkų g. 6)";Peledžiukai;2762230590;Ne;7;0;1;8
3893;"Kūlverstukas (Suvalkų g. 6)";Peledžiukai;2450625415;Ne;9;1;2;12
3894;"Kūlverstukas (Suvalkų g. 6)";Peledžiukai;2101490038;Ne;16;0;0;16
3895;"Kūlverstukas (Suvalkų g. 6)";Peledžiukai;8319255735;Ne;7;0;3;10
3896;"Kūlverstukas (Suvalkų g. 6)";Peledžiukai;1795306946;Ne;10;1;0;11
3897;"Kūlverstukas (Suvalkų g. 6)";Peledžiukai;7118949795;Ne;6;0;0;6
3898;"Kūlverstukas (Suvalkų g. 6)";Peledžiukai;4173514390;Ne;0;1;1;2
3899;"Kūlverstukas (Suvalkų g. 6)";Peledžiukai;3448880105;Ne;2;0;4;6
3900;"Kūlverstukas (Suvalkų g. 6)";Peledžiukai;4532151103;Ne;5;4;0;9
3901;"Kūlverstukas (Suvalkų g. 6)";Gelytės;3811616695;Ne;0;1;0;1
3902;"Kūlverstukas (Suvalkų g. 6)";Gelytės;1939668692;Ne;4;1;0;5
3903;"Kūlverstukas (Suvalkų g. 6)";Gelytės;8618967238;Ne;3;4;0;7
3904;"Kūlverstukas (Suvalkų g. 6)";Gelytės;4945943570;Ne;0;3;0;3
3905;"Kūlverstukas (Suvalkų g. 6)";Gelytės;9777005699;Ne;1;1;0;2
3906;"Kūlverstukas (Suvalkų g. 6)";Gelytės;4694784301;Taip;2;1;0;3
3907;"Kūlverstukas (Suvalkų g. 6)";Gelytės;8599785196;Ne;7;0;0;7
3908;"Kūlverstukas (Suvalkų g. 6)";Gelytės;2082087440;Ne;0;5;0;5
3909;"Kūlverstukas (Suvalkų g. 6)";Gelytės;6916013898;Ne;6;0;0;6
3910;"Kūlverstukas (Suvalkų g. 6)";Gelytės;1985177751;Ne;1;2;0;3
3911;"Kūlverstukas (Suvalkų g. 6)";Gelytės;2924333435;Ne;6;0;0;6
3912;"Kūlverstukas (Suvalkų g. 6)";Gelytės;9787833724;Ne;11;0;0;11
3913;"Kūlverstukas (Suvalkų g. 6)";Bitutės;8510004509;Ne;11;0;0;11
3914;"Kūlverstukas (Suvalkų g. 6)";Bitutės;1710691463;Ne;5;8;0;13
3915;"Kūlverstukas (Suvalkų g. 6)";Bitutės;6820256485;Ne;1;0;0;1
3916;"Kūlverstukas (Suvalkų g. 6)";Bitutės;8630469988;Ne;0;3;0;3
3917;"Kūlverstukas (Suvalkų g. 6)";Bitutės;5359152614;Ne;1;0;0;1
3918;"Kūlverstukas (Suvalkų g. 6)";Bitutės;7536805404;Ne;8;0;0;8
3919;"Kūlverstukas (Suvalkų g. 6)";Bitutės;3603297769;Ne;4;0;0;4
3920;"Kūlverstukas (Suvalkų g. 6)";Bitutės;3667698628;Ne;2;0;0;2
3921;"Kūlverstukas (Suvalkų g. 6)";Bitutės;4211069122;Ne;6;2;0;8
3922;"Kūlverstukas (Suvalkų g. 6)";Bitutės;3348354269;Ne;7;0;0;7
3923;Lakštingala;Saulutės;2156571482;Ne;0;6;0;6
3924;Lakštingala;Saulutės;2084960114;Ne;5;0;1;6
3925;Lakštingala;Saulutės;3911509979;Ne;0;14;0;14
3926;Lakštingala;Saulutės;1598639284;Ne;5;0;0;5
3927;Lakštingala;Saulutės;3723986383;Ne;5;0;0;5
3928;Lakštingala;Saulutės;1243254166;Taip;0;11;0;11
3929;Lakštingala;Saulutės;9457533516;Ne;0;3;1;4
3930;Lakštingala;Saulutės;6567480562;Ne;5;2;0;7
3931;Lakštingala;Saulutės;9495341480;Ne;0;3;0;3
3932;Lakštingala;Saulutės;2543779273;Taip;3;0;0;3
3933;Lakštingala;Saulutės;1074616528;Ne;0;0;2;2
3934;Lakštingala;Saulutės;5432816139;Ne;0;2;0;2
3935;Lakštingala;Saulutės;8679582358;Ne;20;0;0;20
3936;Lakštingala;Saulutės;5815240975;Ne;2;0;0;2
3937;Lakštingala;Saulutės;3369263112;Ne;0;0;1;1
3938;Lakštingala;Saulutės;8717764626;Ne;10;0;0;10
3939;Lakštingala;Saulutės;6780591792;Ne;10;0;0;10
3940;Lakštingala;Saulutės;1220858944;Ne;3;0;0;3
3941;Lakštingala;Saulutės;4032030375;Ne;0;2;0;2
3942;Lakštingala;Saulutės;3839016986;Taip;0;1;0;1
3943;Lakštingala;Saulutės;9628476764;Ne;5;0;0;5
3944;Lakštingala;Saulutės;4344553248;Ne;6;0;0;6
3945;Lakštingala;Nykštukai;6861300785;Ne;1;0;0;1
3946;Lakštingala;Nykštukai;8915978498;Ne;1;1;0;2
3947;Lakštingala;Nykštukai;9578079018;Ne;1;1;0;2
3948;Lakštingala;Nykštukai;5943711793;Ne;0;0;20;20
3949;Lakštingala;Nykštukai;1561903802;Ne;0;0;2;2
3950;Lakštingala;Nykštukai;9420187643;Ne;4;2;0;6
3951;Lakštingala;Nykštukai;4045740078;Ne;0;3;0;3
3952;Lakštingala;Nykštukai;8310446552;Ne;0;0;3;3
3953;Lakštingala;Nykštukai;7396235662;Ne;8;0;0;8
3954;Lakštingala;Nykštukai;3863174791;Taip;0;1;0;1
3955;Lakštingala;Nykštukai;4725848201;Taip;3;0;0;3
3956;Lakštingala;Nykštukai;2165808562;Ne;10;0;2;12
3957;Lakštingala;Nykštukai;5539054769;Ne;0;0;2;2
3958;Lakštingala;Nykštukai;8421786788;Taip;0;0;3;3
3959;Lakštingala;Nykštukai;6974936332;Ne;10;0;1;11
3960;Lakštingala;Nykštukai;8663938939;Taip;0;0;1;1
3961;Lakštingala;Nykštukai;6231045485;Ne;1;0;0;1
3962;Lakštingala;Nykštukai;5965026791;Ne;0;1;0;1
3963;Lakštingala;Bitutės;5051773825;Ne;7;0;0;7
3964;Lakštingala;Bitutės;9390342572;Ne;3;2;0;5
3965;Lakštingala;Bitutės;2130192341;Ne;11;0;0;11
3966;Lakštingala;Bitutės;8171357606;Ne;0;5;0;5
3967;Lakštingala;Bitutės;8165998647;Taip;2;2;0;4
3968;Lakštingala;Bitutės;9774836470;Ne;0;2;0;2
3969;Lakštingala;Bitutės;1958696382;Ne;2;2;0;4
3970;Lakštingala;Bitutės;1587899391;Ne;6;0;0;6
3971;Lakštingala;Bitutės;1458348357;Ne;10;0;0;10
3972;Lakštingala;Bitutės;4542992319;Ne;7;0;0;7
3973;Lakštingala;Bitutės;7272454093;Ne;1;2;0;3
3974;Lakštingala;Bitutės;5949665703;Ne;8;0;0;8
3975;Lakštingala;Bitutės;4722328994;Ne;12;0;0;12
3976;Lakštingala;Bitutės;4465752871;Taip;0;9;0;9
3977;Lakštingala;Bitutės;2593030897;Ne;0;2;0;2
3978;Lakštingala;Bitutės;6565318145;Ne;0;2;0;2
3979;Lakštingala;Bitutės;4384468922;Ne;0;8;0;8
3980;Lakštingala;Bitutės;6908873466;Ne;0;1;0;1
3981;Lakštingala;Bitutės;7929034243;Ne;10;0;0;10
3982;Lakštingala;Bitutės;5854794141;Ne;1;0;0;1
3983;Lakštingala;Bitutės;2423761155;Ne;6;1;0;7
3984;Lakštingala;Bitutės;5920907667;Ne;0;11;0;11
3985;Lakštingala;Pūkeliai;9093654437;Taip;0;0;1;1
3986;Lakštingala;Pūkeliai;3877448215;Ne;6;0;1;7
3987;Lakštingala;Pūkeliai;6148942052;Ne;2;0;0;2
3988;Lakštingala;Pūkeliai;7623917384;Ne;3;0;0;3
3989;Lakštingala;Pūkeliai;6011421835;Ne;4;0;1;5
3990;Lakštingala;Pūkeliai;8861428074;Ne;0;1;0;1
3991;Lakštingala;Pūkeliai;2673030043;Taip;2;0;1;3
3992;Lakštingala;Pūkeliai;2346497467;Ne;0;0;5;5
3993;Lakštingala;Pūkeliai;2010478542;Ne;7;0;2;9
3994;Lakštingala;Pūkeliai;1903292595;Ne;0;0;1;1
3995;Lakštingala;Pūkeliai;9894103692;Ne;11;0;0;11
3996;Lakštingala;Pūkeliai;1371422364;Ne;9;0;0;9
3997;Lakštingala;Pūkeliai;8800538473;Ne;4;0;2;6
3998;Lakštingala;Pūkeliai;6285766353;Ne;0;0;1;1
3999;Lakštingala;Pūkeliai;3752408599;Ne;3;0;0;3
4000;Lakštingala;Pūkeliai;9183206191;Ne;3;0;2;5
4001;Lakštingala;Pūkeliai;2611117446;Ne;5;0;2;7
4002;Lakštingala;Pūkeliai;5524522038;Ne;5;0;2;7
4003;Lakštingala;Pūkeliai;5583075385;Ne;7;0;1;8
4004;Lakštingala;Pūkeliai;4234177812;Ne;6;0;0;6
4005;Lakštingala;Pūkeliai;5903339111;Ne;5;0;3;8
4006;Lakštingala;Aitvariukai;1474796466;Ne;3;0;0;3
4007;Lakštingala;Aitvariukai;9629855134;Ne;5;0;0;5
4008;Lakštingala;Aitvariukai;7876311404;Ne;2;0;0;2
4009;Lakštingala;Aitvariukai;1248909711;Ne;6;0;0;6
4010;Lakštingala;Aitvariukai;9676872125;Ne;5;0;0;5
4011;Lakštingala;Aitvariukai;9083753159;Ne;1;0;0;1
4012;Lakštingala;Aitvariukai;7879280198;Ne;3;6;0;9
4013;Lakštingala;Aitvariukai;4403673558;Taip;7;2;0;9
4014;Lakštingala;Aitvariukai;5693413287;Taip;10;0;0;10
4015;Lakštingala;Aitvariukai;7240426529;Taip;7;1;0;8
4016;Lakštingala;Aitvariukai;8558000223;Ne;13;0;0;13
4017;Lakštingala;Aitvariukai;5602079341;Ne;11;1;0;12
4018;Lakštingala;Aitvariukai;7404386777;Ne;7;0;0;7
4019;Lakštingala;Aitvariukai;3166474163;Ne;2;0;0;2
4020;Lakštingala;Aitvariukai;8609822839;Ne;5;2;0;7
4021;Lakštingala;Aitvariukai;6180443056;Ne;11;0;0;11
4022;Lakštingala;Aitvariukai;6389721877;Ne;11;0;0;11
4023;Lakštingala;Aitvariukai;4211861355;Ne;17;0;0;17
4024;Lakštingala;Aitvariukai;6872095965;Taip;0;10;0;10
4025;Lakštingala;Boružiukai;1898853302;Ne;0;1;0;1
4026;Lakštingala;Boružiukai;8284565948;Ne;1;1;0;2
4027;Lakštingala;Boružiukai;4857448665;Ne;0;2;1;3
4028;Lakštingala;Boružiukai;1863034132;Taip;0;1;0;1
4029;Lakštingala;Boružiukai;9879064676;Ne;0;1;0;1
4030;Lakštingala;Boružiukai;8217315818;Ne;0;1;0;1
4031;Lakštingala;Boružiukai;3509165175;Ne;1;3;0;4
4032;Lakštingala;Boružiukai;4179366572;Ne;9;1;0;10
4033;Lakštingala;Boružiukai;9489982241;Ne;0;1;0;1
4034;Lakštingala;Boružiukai;3993759015;Ne;19;1;0;20
4035;Lakštingala;Boružiukai;5445945319;Ne;5;0;0;5
4036;Lakštingala;Boružiukai;2652305131;Ne;7;2;0;9
4037;Lakštingala;Boružiukai;9725851433;Ne;0;1;0;1
4038;Lakštingala;Boružiukai;9375002191;Ne;2;2;0;4
4039;Lakštingala;Boružiukai;2073818724;Ne;0;1;0;1
4040;Lakštingala;Boružiukai;7994475429;Ne;0;1;0;1
4041;Lakštingala;Boružiukai;2266870318;Ne;4;1;0;5
4042;Lakštingala;Boružiukai;9346986726;Ne;0;1;0;1
4043;Lakštingala;Žiogeliai;8404025659;Taip;12;0;3;15
4044;Lakštingala;Žiogeliai;4113993067;Taip;0;2;0;2
4045;Lakštingala;Žiogeliai;6981178960;Ne;8;0;0;8
4046;Lakštingala;Žiogeliai;3908175786;Ne;13;0;0;13
4047;Lakštingala;Žiogeliai;9860169528;Ne;5;0;2;7
4048;Lakštingala;Žiogeliai;4935753482;Ne;7;0;0;7
4049;Lakštingala;Žiogeliai;5008933316;Ne;2;0;0;2
4050;Lakštingala;Žiogeliai;3439681068;Ne;0;2;0;2
4051;Lakštingala;Žiogeliai;3766986041;Ne;11;0;9;20
4052;Lakštingala;Žiogeliai;1974950823;Ne;5;0;0;5
4053;Lakštingala;Žiogeliai;6561743084;Ne;8;0;0;8
4054;Lakštingala;Žiogeliai;1226908540;Ne;20;0;0;20
4055;Lakštingala;Žiogeliai;3951057865;Ne;6;0;7;13
4056;Lakštingala;Žiogeliai;1494530289;Ne;0;0;4;4
4057;Lakštingala;Žiogeliai;7661973162;Ne;5;0;0;5
4058;Lakštingala;Žiogeliai;7104398627;Ne;5;1;0;6
4059;Lakštingala;Žiogeliai;7361353346;Ne;5;0;0;5
4060;Lakštingala;Žiogeliai;4790291839;Ne;5;0;0;5
4061;Lakštingala;Žiogeliai;8351970017;Taip;5;0;0;5
4062;Lakštingala;Žiogeliai;8333832673;Ne;6;0;0;6
4063;Lakštingala;Žiogeliai;5849662446;Ne;8;0;0;8
4064;Lakštingala;Žiogeliai;5854343571;Ne;3;0;0;3
4065;Lakštingala;SPINDULIUKAI;4365413054;Ne;6;0;0;6
4066;Lakštingala;SPINDULIUKAI;9762500668;Ne;9;1;0;10
4067;Lakštingala;SPINDULIUKAI;7640007392;Ne;0;6;0;6
4068;Lakštingala;SPINDULIUKAI;4784677514;Ne;3;0;0;3
4069;Lakštingala;SPINDULIUKAI;1619201521;Ne;5;2;0;7
4070;Lakštingala;SPINDULIUKAI;2022621678;Ne;0;0;3;3
4071;Lakštingala;SPINDULIUKAI;8429523368;Ne;3;1;0;4
4072;Lakštingala;SPINDULIUKAI;6668075753;Ne;2;0;2;4
4073;Lakštingala;SPINDULIUKAI;8722490845;Taip;10;1;0;11
4074;Lakštingala;SPINDULIUKAI;3823860988;Ne;3;0;0;3
4075;Lakštingala;SPINDULIUKAI;7141840160;Ne;12;0;0;12
4076;Lakštingala;SPINDULIUKAI;3282771613;Ne;3;0;0;3
4077;Lakštingala;SPINDULIUKAI;2795341401;Ne;0;2;6;8
4078;Lakštingala;SPINDULIUKAI;4651600682;Ne;9;0;0;9
4079;Lakštingala;SPINDULIUKAI;8130468345;Ne;15;0;0;15
4080;Lakštingala;SPINDULIUKAI;2626498928;Ne;10;0;0;10
4081;Lakštingala;SPINDULIUKAI;3531056799;Ne;9;0;0;9
4082;Lakštingala;SPINDULIUKAI;9441296489;Ne;7;1;0;8
4083;Lakštingala;SPINDULIUKAI;6606640383;Ne;10;1;0;11
4084;Lakštingala;Pėledžiukai;4774354751;Taip;6;0;1;7
4085;Lakštingala;Pėledžiukai;8375506323;Ne;0;1;0;1
4086;Lakštingala;Pėledžiukai;8075192528;Ne;0;2;2;4
4087;Lakštingala;Pėledžiukai;6161860331;Ne;2;0;0;2
4088;Lakštingala;Pėledžiukai;6866935290;Ne;15;0;0;15
4089;Lakštingala;Pėledžiukai;8787118512;Taip;0;2;3;5
4090;Lakštingala;Pėledžiukai;6805882038;Ne;5;1;0;6
4091;Lakštingala;Pėledžiukai;7139669240;Ne;0;0;7;7
4092;Lakštingala;Pėledžiukai;9431022632;Ne;10;2;0;12
4093;Lakštingala;Pėledžiukai;9856189053;Ne;7;1;0;8
4094;Lakštingala;Pėledžiukai;5391954600;Ne;1;0;0;1
4095;Lakštingala;Pėledžiukai;4608719006;Ne;0;0;1;1
4096;Lakštingala;Pėledžiukai;5812491783;Ne;5;0;0;5
4097;Lakštingala;Pėledžiukai;9899997020;Ne;10;1;0;11
4098;Lakštingala;Pėledžiukai;9297542026;Ne;0;3;0;3
4099;Lakštingala;Katinėliai;7351891043;Ne;6;0;0;6
4100;Lakštingala;Katinėliai;2610113024;Ne;8;0;0;8
4101;Lakštingala;Katinėliai;6685195244;Ne;0;0;2;2
4102;Lakštingala;Katinėliai;8444696089;Ne;2;0;0;2
4103;Lakštingala;Katinėliai;4896401452;Ne;7;0;0;7
4104;Lakštingala;Katinėliai;7987187638;Ne;11;1;0;12
4105;Lakštingala;Katinėliai;8900191763;Ne;11;1;0;12
4106;Lakštingala;Katinėliai;9923491804;Ne;6;1;0;7
4107;Lakštingala;Katinėliai;2599217481;Ne;3;5;0;8
4108;Lakštingala;Katinėliai;2029350217;Ne;3;1;0;4
4109;Lakštingala;Katinėliai;6180366812;Ne;5;0;0;5
4110;Lakštingala;Katinėliai;3899425918;Ne;8;0;0;8
4111;Lakštingala;Katinėliai;4165688458;Ne;9;3;0;12
4112;Lakštingala;Katinėliai;3213575443;Ne;6;0;0;6
4113;Lakštingala;Katinėliai;2841048627;Ne;4;0;1;5
4114;Lakštingala;Katinėliai;1279172936;Ne;0;0;4;4
4115;Lakštingala;Katinėliai;2333102026;Ne;3;0;6;9
4116;Lakštingala;Katinėliai;2662167519;Ne;7;0;0;7
4117;Lakštingala;Katinėliai;3227628813;Ne;9;0;1;10
4118;Lakštingala;Katinėliai;2770661353;Ne;0;0;14;14
4119;Lakštingala;Deimantėliai;2114708431;Ne;10;0;0;10
4120;Lakštingala;Deimantėliai;8074211850;Ne;0;2;0;2
4121;Lakštingala;Deimantėliai;6749980386;Ne;0;1;0;1
4122;Lakštingala;Deimantėliai;8938720617;Ne;2;0;0;2
4123;Lakštingala;Deimantėliai;4903094629;Ne;7;0;0;7
4124;Lakštingala;Deimantėliai;7853382073;Ne;5;0;0;5
4125;Lakštingala;Deimantėliai;1276857151;Ne;15;0;0;15
4126;Lakštingala;Deimantėliai;6971655647;Ne;3;1;0;4
4127;Lakštingala;Deimantėliai;7043519686;Ne;2;0;0;2
4128;Lakštingala;Deimantėliai;4976683143;Taip;2;0;1;3
4129;Lakštingala;Deimantėliai;7078051438;Ne;0;0;1;1
4130;Lakštingala;Deimantėliai;8571415914;Ne;4;2;1;7
4131;Lakštingala;Deimantėliai;8711116860;Ne;0;5;0;5
4132;Lakštingala;Deimantėliai;2886415541;Ne;0;3;0;3
4133;Lakštingala;Deimantėliai;5980402440;Ne;5;0;0;5
4134;Lakštingala;Deimantėliai;9312563560;Ne;5;0;0;5
4135;Lakštingala;Deimantėliai;4199371972;Ne;6;5;0;11
4136;Lakštingala;KIŠKUČIAI;6520436055;Taip;16;0;0;16
4137;Lakštingala;KIŠKUČIAI;3208321841;Taip;14;0;0;14
4138;Lakštingala;KIŠKUČIAI;5464460112;Ne;0;2;0;2
4139;Lakštingala;KIŠKUČIAI;6970022417;Ne;10;0;0;10
4140;Lakštingala;KIŠKUČIAI;5730122965;Ne;15;0;0;15
4141;Lakštingala;KIŠKUČIAI;4140403601;Taip;1;2;0;3
4142;Lakštingala;KIŠKUČIAI;5119365443;Ne;0;2;0;2
4143;Lakštingala;KIŠKUČIAI;6689018476;Ne;1;0;0;1
4144;Lakštingala;KIŠKUČIAI;7017047366;Ne;3;0;0;3
4145;Lakštingala;KIŠKUČIAI;9539081376;Ne;0;7;0;7
4146;Lakštingala;KIŠKUČIAI;4854843534;Ne;5;0;0;5
4147;Lakštingala;KIŠKUČIAI;9162902701;Ne;8;0;0;8
4148;Lakštingala;KIŠKUČIAI;5455119187;Ne;9;0;0;9
4149;Lakštingala;KIŠKUČIAI;1113674539;Ne;8;0;0;8
4150;Lakštingala;KIŠKUČIAI;4370431439;Ne;3;1;0;4
4151;Lakštingala;KIŠKUČIAI;1898108870;Ne;17;1;0;18
4152;Lakštingala;KIŠKUČIAI;6652822827;Ne;0;0;2;2
4153;Lakštingala;KIŠKUČIAI;2998581623;Ne;12;1;0;13
4154;Lakštingala;KIŠKUČIAI;8414220381;Ne;2;0;1;3
4155;Lakštingala;KIŠKUČIAI;7817830649;Ne;6;3;0;9
4156;Lašelis;VIŠČIUKAI;6477439886;Ne;7;0;0;7
4157;Lašelis;VIŠČIUKAI;6912802425;Ne;13;0;0;13
4158;Lašelis;VIŠČIUKAI;6857428142;Ne;0;1;0;1
4159;Lašelis;VIŠČIUKAI;5759317067;Ne;13;1;0;14
4160;Lašelis;VIŠČIUKAI;1367955273;Ne;0;6;0;6
4161;Lašelis;VIŠČIUKAI;2702582486;Ne;10;2;0;12
4162;Lašelis;VIŠČIUKAI;2824852871;Ne;20;0;0;20
4163;Lašelis;VIŠČIUKAI;1294930990;Ne;0;7;0;7
4164;Lašelis;VIŠČIUKAI;2121080776;Taip;6;0;0;6
4165;Lašelis;VIŠČIUKAI;4427263877;Ne;0;13;0;13
4166;Lašelis;VIŠČIUKAI;1168408482;Ne;6;0;0;6
4167;Lašelis;VIŠČIUKAI;4748156580;Ne;4;0;1;5
4168;Lašelis;VIŠČIUKAI;4860925464;Ne;0;0;1;1
4169;Lašelis;VIŠČIUKAI;2915806799;Ne;0;2;0;2
4170;Lašelis;VIŠČIUKAI;2900106941;Ne;6;0;5;11
4171;Lašelis;VIŠČIUKAI;2748888134;Ne;2;0;0;2
4172;Lašelis;ŠYPSENA;4113842551;Ne;0;2;0;2
4173;Lašelis;ŠYPSENA;6317716501;Ne;1;0;0;1
4174;Lašelis;ŠYPSENA;7502668870;Ne;12;0;0;12
4175;Lašelis;ŠYPSENA;8905080707;Taip;0;1;0;1
4176;Lašelis;ŠYPSENA;7784416134;Ne;5;0;0;5
4177;Lašelis;ŠYPSENA;4051058266;Ne;5;0;0;5
4178;Lašelis;ŠYPSENA;2991487552;Ne;7;0;0;7
4179;Lašelis;ŠYPSENA;7418586100;Ne;13;0;0;13
4180;Lašelis;ŠYPSENA;1429188137;Ne;2;0;2;4
4181;Lašelis;ŠYPSENA;1131591230;Ne;17;0;0;17
4182;Lašelis;ŠYPSENA;1343964112;Ne;14;0;0;14
4183;Lašelis;ŠYPSENA;7811809908;Ne;4;0;0;4
4184;Lašelis;ŠYPSENA;1882188961;Taip;2;0;0;2
4185;Lašelis;ŠYPSENA;4893073148;Ne;3;0;0;3
4186;Lašelis;ŠYPSENA;2210081848;Ne;9;0;0;9
4187;Lašelis;ŠYPSENA;1070067484;Taip;15;0;0;15
4188;Lašelis;ŠYPSENA;4805028666;Ne;8;0;0;8
4189;Lašelis;NYKŠTUKAI;1426555166;Ne;20;0;0;20
4190;Lašelis;NYKŠTUKAI;2509469243;Ne;14;0;0;14
4191;Lašelis;NYKŠTUKAI;4832223461;Ne;14;0;0;14
4192;Lašelis;NYKŠTUKAI;5416590600;Ne;14;0;0;14
4193;Lašelis;NYKŠTUKAI;1490179832;Ne;7;4;0;11
4194;Lašelis;NYKŠTUKAI;3995905195;Ne;0;20;0;20
4195;Lašelis;NYKŠTUKAI;1060784180;Taip;6;0;0;6
4196;Lašelis;NYKŠTUKAI;6137626795;Ne;7;0;0;7
4197;Lašelis;NYKŠTUKAI;1635921119;Ne;13;2;0;15
4198;Lašelis;NYKŠTUKAI;6836452490;Ne;0;0;1;1
4199;Lašelis;NYKŠTUKAI;4933598046;Ne;7;0;2;9
4200;Lašelis;NYKŠTUKAI;9664015801;Ne;0;2;0;2
4201;Lašelis;NYKŠTUKAI;1983312896;Ne;0;4;0;4
4202;Lašelis;NYKŠTUKAI;1279052767;Ne;8;0;1;9
4203;Lašelis;NYKŠTUKAI;8906479495;Ne;9;0;1;10
4204;Lašelis;NYKŠTUKAI;2606193652;Ne;0;0;1;1
4205;Lašelis;NYKŠTUKAI;9434932943;Ne;10;1;0;11
4206;Lašelis;NYKŠTUKAI;2593126568;Ne;10;0;2;12
4207;Lašelis;SAULUTĖ;3495676199;Ne;2;0;0;2
4208;Lašelis;SAULUTĖ;1085950130;Taip;0;1;0;1
4209;Lašelis;SAULUTĖ;5931015581;Ne;1;0;0;1
4210;Lašelis;SAULUTĖ;8132517365;Ne;5;0;0;5
4211;Lašelis;SAULUTĖ;1244168190;Ne;1;0;0;1
4212;Lašelis;SAULUTĖ;4566547120;Taip;0;1;0;1
4213;Lašelis;SAULUTĖ;9647340725;Ne;5;5;0;10
4214;Lašelis;SAULUTĖ;1042560186;Taip;0;2;0;2
4215;Lašelis;SAULUTĖ;1035888733;Ne;1;0;0;1
4216;Lašelis;SAULUTĖ;1926439959;Ne;9;0;0;9
4217;Lašelis;SAULUTĖ;4508779926;Ne;2;0;0;2
4218;Lašelis;SAULUTĖ;1415345442;Ne;10;0;0;10
4219;Lašelis;SAULUTĖ;8318512396;Ne;6;0;0;6
4220;Lašelis;SAULUTĖ;8814796010;Ne;11;0;0;11
4221;Lašelis;SAULUTĖ;2223293390;Taip;5;0;0;5
4222;Lašelis;SAULUTĖ;2886967297;Ne;0;2;0;2
4223;Lašelis;SAULUTĖ;3805049682;Ne;11;0;0;11
4224;Lašelis;SAULUTĖ;2401058384;Ne;4;0;1;5
4225;Lašelis;SAULUTĖ;3675606390;Ne;17;0;0;17
4226;Lašelis;BORUŽĖLĖS;3180139334;Ne;0;8;0;8
4227;Lašelis;BORUŽĖLĖS;5000188106;Ne;8;0;0;8
4228;Lašelis;BORUŽĖLĖS;6203027620;Ne;3;0;0;3
4229;Lašelis;BORUŽĖLĖS;7619426839;Ne;8;3;0;11
4230;Lašelis;BORUŽĖLĖS;8718481664;Ne;9;0;0;9
4231;Lašelis;BORUŽĖLĖS;3130271837;Ne;0;2;0;2
4232;Lašelis;BORUŽĖLĖS;2871149756;Ne;10;0;0;10
4233;Lašelis;BORUŽĖLĖS;7920615797;Ne;11;0;0;11
4234;Lašelis;BORUŽĖLĖS;8212250478;Ne;4;4;0;8
4235;Lašelis;BORUŽĖLĖS;1675784376;Ne;18;0;0;18
4236;Lašelis;BORUŽĖLĖS;4734160251;Ne;12;0;0;12
4237;Lašelis;BORUŽĖLĖS;6275226824;Ne;0;5;0;5
4238;Lašelis;BORUŽĖLĖS;6751223169;Ne;2;0;0;2
4239;Lašelis;BORUŽĖLĖS;7432843976;Ne;4;0;0;4
4240;Lašelis;BORUŽĖLĖS;3183193902;Ne;11;0;0;11
4241;Lašelis;BORUŽĖLĖS;9879208797;Ne;11;0;0;11
4242;Lašelis;SKRUZDELIUKAI;5535348173;Ne;10;0;0;10
4243;Lašelis;SKRUZDELIUKAI;7704247097;Taip;13;0;0;13
4244;Lašelis;SKRUZDELIUKAI;4571213887;Ne;7;0;0;7
4245;Lašelis;SKRUZDELIUKAI;7367252046;Ne;13;0;0;13
4246;Lašelis;SKRUZDELIUKAI;9364834089;Ne;14;0;0;14
4247;Lašelis;SKRUZDELIUKAI;6130824517;Ne;12;0;0;12
4248;Lašelis;SKRUZDELIUKAI;9905868465;Ne;12;0;0;12
4249;Lašelis;SKRUZDELIUKAI;6947939251;Ne;15;0;0;15
4250;Lašelis;SKRUZDELIUKAI;9394906598;Ne;13;0;0;13
4251;Lašelis;SKRUZDELIUKAI;9976394850;Ne;12;0;0;12
4252;Lašelis;SKRUZDELIUKAI;7610658433;Ne;7;0;0;7
4253;Lašelis;SKRUZDELIUKAI;4802629905;Ne;16;0;0;16
4254;Lašelis;SKRUZDELIUKAI;4487717519;Ne;15;0;0;15
4255;Lazdynėlis;BITUTĖS;1748260780;Ne;6;0;0;6
4256;Lazdynėlis;BITUTĖS;2044188250;Ne;0;1;1;2
4257;Lazdynėlis;BITUTĖS;2032759165;Taip;0;0;1;1
4258;Lazdynėlis;BITUTĖS;4153294595;Taip;1;7;0;8
4259;Lazdynėlis;BITUTĖS;6963058612;Ne;0;11;0;11
4260;Lazdynėlis;BITUTĖS;6276697479;Ne;3;0;0;3
4261;Lazdynėlis;BITUTĖS;9886856760;Ne;0;20;0;20
4262;Lazdynėlis;BITUTĖS;2998606948;Ne;0;20;0;20
4263;Lazdynėlis;BITUTĖS;6415858184;Ne;0;0;1;1
4264;Lazdynėlis;BITUTĖS;5796381191;Ne;10;0;3;13
4265;Lazdynėlis;BITUTĖS;4771173060;Ne;5;0;0;5
4266;Lazdynėlis;BITUTĖS;1355954767;Ne;4;1;0;5
4267;Lazdynėlis;EŽIUKAI;3040417651;Ne;0;0;1;1
4268;Lazdynėlis;EŽIUKAI;6021387236;Ne;7;0;4;11
4269;Lazdynėlis;EŽIUKAI;7945472048;Ne;9;0;0;9
4270;Lazdynėlis;EŽIUKAI;1168433014;Taip;0;0;5;5
4271;Lazdynėlis;EŽIUKAI;7655218276;Ne;0;1;0;1
4272;Lazdynėlis;EŽIUKAI;6031442797;Ne;0;8;0;8
4273;Lazdynėlis;EŽIUKAI;7561833526;Ne;2;0;0;2
4274;Lazdynėlis;EŽIUKAI;3764854654;Taip;0;0;2;2
4275;Lazdynėlis;EŽIUKAI;5832624944;Ne;3;0;0;3
4276;Lazdynėlis;EŽIUKAI;2911152510;Ne;2;0;0;2
4277;Lazdynėlis;EŽIUKAI;3036055537;Ne;0;0;1;1
4278;Lazdynėlis;EŽIUKAI;4745610579;Ne;0;1;0;1
4279;Lazdynėlis;EŽIUKAI;6817162699;Ne;6;0;3;9
4280;Lazdynėlis;EŽIUKAI;8530159773;Ne;1;0;0;1
4281;Lazdynėlis;EŽIUKAI;7552873109;Ne;14;0;0;14
4282;Lazdynėlis;EŽIUKAI;2933025284;Ne;0;1;0;1
4283;Lazdynėlis;BORUŽIUKAI;8337458289;Ne;0;20;0;20
4284;Lazdynėlis;BORUŽIUKAI;7692056055;Ne;9;1;0;10
4285;Lazdynėlis;BORUŽIUKAI;2009941344;Taip;8;0;0;8
4286;Lazdynėlis;BORUŽIUKAI;4190852647;Taip;8;0;0;8
4287;Lazdynėlis;BORUŽIUKAI;2058909635;Ne;0;20;0;20
4288;Lazdynėlis;BORUŽIUKAI;3105363578;Ne;0;20;0;20
4289;Lazdynėlis;BORUŽIUKAI;5622254334;Ne;9;0;0;9
4290;Lazdynėlis;BORUŽIUKAI;7587041613;Ne;5;0;0;5
4291;Lazdynėlis;BORUŽIUKAI;2632078843;Ne;20;0;0;20
4292;Lazdynėlis;BORUŽIUKAI;1707231039;Ne;0;20;0;20
4293;Lazdynėlis;BORUŽIUKAI;6413861274;Ne;13;0;0;13
4294;Lazdynėlis;BORUŽIUKAI;8030743153;Ne;1;0;0;1
4295;Lazdynėlis;BORUŽIUKAI;4642875037;Ne;5;7;0;12
4296;Lazdynėlis;BORUŽIUKAI;1722503577;Ne;7;0;0;7
4297;Lazdynėlis;BORUŽIUKAI;4595080695;Ne;0;20;0;20
4298;Lazdynėlis;BORUŽIUKAI;4958640516;Ne;4;0;0;4
4299;Lazdynėlis;BORUŽIUKAI;3351966091;Ne;0;20;0;20
4300;Lazdynėlis;BORUŽIUKAI;9548866880;Ne;3;1;2;6
4301;Lazdynėlis;BORUŽIUKAI;4266414341;Ne;9;0;0;9
4302;Lazdynėlis;BORUŽIUKAI;6633585181;Taip;2;0;0;2
4303;Lazdynėlis;KAČIUKAI;2958520599;Ne;0;0;2;2
4304;Lazdynėlis;KAČIUKAI;6657174602;Ne;0;0;3;3
4305;Lazdynėlis;KAČIUKAI;2013752858;Ne;0;0;3;3
4306;Lazdynėlis;KAČIUKAI;2586187455;Ne;2;0;1;3
4307;Lazdynėlis;KAČIUKAI;5562900372;Ne;0;0;4;4
4308;Lazdynėlis;KAČIUKAI;7719697394;Ne;2;1;0;3
4309;Lazdynėlis;KAČIUKAI;4055450300;Ne;11;0;0;11
4310;Lazdynėlis;KAČIUKAI;3667994076;Ne;3;1;1;5
4311;Lazdynėlis;KAČIUKAI;1668899344;Ne;0;1;2;3
4312;Lazdynėlis;KAČIUKAI;4809829190;Ne;0;0;1;1
4313;Lazdynėlis;VOVERIUKAI;1039874409;Ne;4;0;0;4
4314;Lazdynėlis;VOVERIUKAI;9362249595;Ne;3;0;0;3
4315;Lazdynėlis;VOVERIUKAI;7135087818;Ne;1;0;1;2
4316;Lazdynėlis;VOVERIUKAI;3097254722;Ne;1;0;0;1
4317;Lazdynėlis;VOVERIUKAI;6352480127;Ne;1;0;2;3
4318;Lazdynėlis;VOVERIUKAI;6814362584;Ne;0;3;1;4
4319;Lazdynėlis;VOVERIUKAI;7208223612;Ne;1;0;3;4
4320;Lazdynėlis;VOVERIUKAI;4293473176;Ne;4;0;0;4
4321;Lazdynėlis;VOVERIUKAI;2723284353;Ne;5;0;0;5
4322;Lazdynėlis;VOVERIUKAI;9219327706;Ne;3;1;0;4
4323;Lazdynėlis;VOVERIUKAI;6008610525;Ne;0;1;0;1
4324;Lazdynėlis;VOVERIUKAI;3879017767;Ne;5;0;0;5
4325;Lazdynėlis;RIEŠUTĖLIAI;3086059608;Ne;12;0;0;12
4326;Lazdynėlis;RIEŠUTĖLIAI;2478218103;Ne;0;1;0;1
4327;Lazdynėlis;RIEŠUTĖLIAI;5987500024;Ne;0;5;0;5
4328;Lazdynėlis;RIEŠUTĖLIAI;2453740823;Ne;0;3;0;3
4329;Lazdynėlis;RIEŠUTĖLIAI;3239107488;Ne;5;0;0;5
4330;Lazdynėlis;RIEŠUTĖLIAI;8942906327;Ne;3;1;0;4
4331;Lazdynėlis;RIEŠUTĖLIAI;9582702244;Ne;0;1;0;1
4332;Lazdynėlis;RIEŠUTĖLIAI;3062924645;Ne;0;6;0;6
4333;Lazdynėlis;RIEŠUTĖLIAI;4092363029;Ne;0;3;0;3
4334;Lazdynėlis;RIEŠUTĖLIAI;3250913116;Taip;4;0;0;4
4335;Lazdynėlis;RIEŠUTĖLIAI;8529192130;Ne;5;0;0;5
4336;Lazdynėlis;RIEŠUTĖLIAI;5354852979;Ne;2;2;0;4
4337;Lazdynėlis;RIEŠUTĖLIAI;9930553716;Ne;9;0;0;9
4338;Lazdynėlis;RIEŠUTĖLIAI;6831456807;Ne;5;1;0;6
4339;Lazdynėlis;RIEŠUTĖLIAI;4795464133;Ne;15;0;0;15
4340;Lazdynėlis;ANČIUKAI;6575706614;Ne;7;0;0;7
4341;Lazdynėlis;ANČIUKAI;6284781209;Ne;2;1;0;3
4342;Lazdynėlis;ANČIUKAI;7646625115;Ne;11;0;0;11
4343;Lazdynėlis;ANČIUKAI;1246581188;Ne;10;5;0;15
4344;Lazdynėlis;ANČIUKAI;7261983723;Ne;12;0;0;12
4345;Lazdynėlis;ANČIUKAI;9724741469;Ne;18;0;0;18
4346;Lazdynėlis;ANČIUKAI;3060705012;Ne;15;0;0;15
4347;Lazdynėlis;GUDRUČIAI;3357092509;Ne;10;0;1;11
4348;Lazdynėlis;GUDRUČIAI;2514035189;Ne;6;2;1;9
4349;Lazdynėlis;GUDRUČIAI;9231049001;Taip;8;0;0;8
4350;Lazdynėlis;GUDRUČIAI;3779983775;Taip;2;0;0;2
4351;Lazdynėlis;GUDRUČIAI;3365726271;Ne;3;0;0;3
4352;Lazdynėlis;GUDRUČIAI;7941793866;Ne;2;5;0;7
4353;Lazdynėlis;MEŠKIUKAI;4094713096;Ne;11;0;0;11
4354;Lazdynėlis;MEŠKIUKAI;3427972329;Ne;8;0;0;8
4355;Lazdynėlis;MEŠKIUKAI;6941986839;Ne;3;0;0;3
4356;Lazdynėlis;MEŠKIUKAI;2812633983;Ne;0;0;1;1
4357;Lazdynėlis;MEŠKIUKAI;9590507486;Ne;3;0;0;3
4358;Lazdynėlis;MEŠKIUKAI;5982766841;Ne;3;0;0;3
4359;Lazdynėlis;MEŠKIUKAI;1984546310;Ne;5;0;0;5
4360;Lazdynėlis;MEŠKIUKAI;4408660083;Ne;6;0;0;6
4361;Lazdynėlis;MEŠKIUKAI;8567304224;Ne;12;0;0;12
4362;Lazdynėlis;MEŠKIUKAI;4366502064;Taip;5;0;0;5
4363;Lazdynėlis;MEŠKIUKAI;8473007295;Ne;7;0;0;7
4364;Liepsnelė;Žvirbliukai;7925446594;Ne;5;0;0;5
4365;Markučiai;Žirniukų;3525681034;Ne;6;0;0;6
4366;Markučiai;Žirniukų;7312533881;Ne;14;0;0;14
4367;Markučiai;Žirniukų;8934965409;Ne;2;1;0;3
4368;Markučiai;Žirniukų;8360526946;Ne;10;6;0;16
4369;Markučiai;Žirniukų;7244815252;Ne;5;0;0;5
4370;Markučiai;Žirniukų;2096169972;Ne;6;0;0;6
4371;Markučiai;Žirniukų;3073404128;Ne;1;0;0;1
4372;Markučiai;Žirniukų;5614488534;Ne;3;0;0;3
4373;Markučiai;Žirniukų;2367999201;Taip;7;0;0;7
4374;Markučiai;Žirniukų;4242575616;Ne;6;0;0;6
4375;Markučiai;Žirniukų;2099285475;Taip;6;0;0;6
4376;Markučiai;Žirniukų;2344252204;Ne;12;1;0;13
4377;Markučiai;Žirniukų;1395241501;Taip;6;0;0;6
4378;Markučiai;Žirniukų;2539486337;Ne;3;0;0;3
4379;Markučiai;Žirniukų;2060024771;Ne;5;0;0;5
4380;Markučiai;Žirniukų;6815286823;Ne;4;0;0;4
4381;Markučiai;Nykštukų;7507551844;Ne;2;1;0;3
4382;Markučiai;Nykštukų;9545967631;Ne;2;0;0;2
4383;Markučiai;Nykštukų;6898055631;Taip;9;1;0;10
4384;Markučiai;Nykštukų;3378749042;Ne;10;5;0;15
4385;Markučiai;Nykštukų;1884388847;Ne;0;2;0;2
4386;Markučiai;Nykštukų;2170380827;Ne;1;1;0;2
4387;Markučiai;Nykštukų;5183244346;Ne;9;1;0;10
4388;Markučiai;Nykštukų;7624913025;Ne;0;3;0;3
4389;Markučiai;Nykštukų;4679710493;Ne;6;0;0;6
4390;Markučiai;Nykštukų;2994895532;Ne;1;1;0;2
4391;Markučiai;Nykštukų;4920107818;Ne;5;0;0;5
4392;Markučiai;Nykštukų;7680126946;Ne;14;0;0;14
4393;Markučiai;Nykštukų;4222017733;Ne;1;0;0;1
4394;Markučiai;Nykštukų;3414015064;Ne;7;0;0;7
4395;Markučiai;Nykštukų;7642401516;Ne;0;3;0;3
4396;Markučiai;Nykštukų;8055783293;Taip;0;5;0;5
4397;Markučiai;Pelėdžiukų;9180404247;Ne;4;0;0;4
4398;Markučiai;Pelėdžiukų;3386071459;Ne;0;0;1;1
4399;Markučiai;Pelėdžiukų;4653663237;Ne;4;0;0;4
4400;Markučiai;Pelėdžiukų;5727655114;Ne;0;3;0;3
4401;Markučiai;Pelėdžiukų;4418580273;Ne;11;0;0;11
4402;Markučiai;Pelėdžiukų;5522654429;Ne;10;2;0;12
4403;Markučiai;Pelėdžiukų;9219710045;Taip;2;0;0;2
4404;Markučiai;Pelėdžiukų;7539605426;Ne;3;0;0;3
4405;Markučiai;Pelėdžiukų;8888538915;Ne;5;0;0;5
4406;Markučiai;Pelėdžiukų;1799946177;Ne;4;0;0;4
4407;Markučiai;Pelėdžiukų;7809719827;Taip;0;3;0;3
4408;Markučiai;Pelėdžiukų;4860961508;Ne;0;1;1;2
4409;Markučiai;Pelėdžiukų;6569807889;Ne;4;1;0;5
4410;Markučiai;Pelėdžiukų;5269411010;Ne;4;0;1;5
4411;Markučiai;Pelėdžiukų;1622197135;Ne;4;0;1;5
4412;Markučiai;Pelėdžiukų;8839679529;Ne;0;1;0;1
4413;Markučiai;Pelėdžiukų;2372820133;Ne;5;0;0;5
4414;Markučiai;Boružėlių;1171899107;Ne;3;5;0;8
4415;Markučiai;Boružėlių;5981692282;Ne;7;0;0;7
4416;Markučiai;Boružėlių;3739566642;Ne;1;5;0;6
4417;Markučiai;Boružėlių;7634475536;Ne;1;1;0;2
4418;Markučiai;Boružėlių;5663147778;Ne;0;1;1;2
4419;Markučiai;Boružėlių;8271830626;Ne;0;1;0;1
4420;Markučiai;Boružėlių;3315824027;Ne;15;2;0;17
4421;Markučiai;Boružėlių;5562960498;Ne;11;0;0;11
4422;Markučiai;Boružėlių;6740434675;Ne;6;0;1;7
4423;Markučiai;Boružėlių;6707310242;Ne;10;0;0;10
4424;Markučiai;Boružėlių;9631684972;Ne;1;0;0;1
4425;Markučiai;Boružėlių;1587323435;Ne;0;31;0;31
4426;Markučiai;Bitučių;1720541082;Ne;6;1;0;7
4427;Markučiai;Bitučių;8792524832;Ne;2;2;2;6
4428;Markučiai;Bitučių;1717624510;Ne;5;0;1;6
4429;Markučiai;Bitučių;9518247571;Ne;0;1;0;1
4430;Markučiai;Bitučių;4836298058;Ne;2;6;1;9
4431;Markučiai;Bitučių;9027071539;Ne;4;0;0;4
4432;Markučiai;Bitučių;8748794886;Ne;0;0;1;1
4433;Markučiai;Bitučių;8950442843;Ne;12;0;1;13
4434;Markučiai;Bitučių;2840564082;Ne;0;1;0;1
4435;Markučiai;Bitučių;3926993383;Ne;17;0;0;17
4436;Markučiai;Bitučių;6530101961;Ne;2;0;6;8
4437;Markučiai;Bitučių;1908302738;Ne;2;0;3;5
4438;Markučiai;Bitučių;7056367646;Ne;9;0;3;12
4439;Markučiai;Bitučių;2049497686;Ne;10;0;1;11
4440;Markučiai;Bitučių;8541042547;Ne;4;0;1;5
4441;Markučiai;Bitučių;1447116821;Ne;4;0;2;6
4442;Markučiai;Bitučių;2931958829;Ne;0;0;2;2
4443;Markučiai;Bitučių;9303448709;Ne;4;0;3;7
4444;Markučiai;Drugelių;2537459830;Ne;0;0;1;1
4445;Markučiai;Drugelių;2288910885;Ne;10;0;0;10
4446;Markučiai;Drugelių;3544565354;Ne;12;0;1;13
4447;Markučiai;Drugelių;9412129807;Ne;4;6;2;12
4448;Markučiai;Drugelių;6979218594;Ne;17;0;0;17
4449;Markučiai;Drugelių;3491734422;Ne;0;0;7;7
4450;Markučiai;Drugelių;3491734422;Ne;0;0;7;7
4451;Markučiai;Drugelių;3491734422;Ne;0;0;7;7
4452;Markučiai;Drugelių;3832641521;Ne;12;0;3;15
4453;Markučiai;Drugelių;4520724770;Ne;6;0;0;6
4454;Markučiai;Drugelių;9391866085;Ne;3;0;4;7
4455;Markučiai;Drugelių;9073616238;Ne;8;0;0;8
4456;Markučiai;Drugelių;2967726802;Ne;12;0;0;12
4457;Markučiai;Drugelių;6684544229;Taip;5;0;5;10
4458;Markučiai;Drugelių;3487571241;Ne;7;0;2;9
4459;Markučiai;Drugelių;1433469476;Ne;4;7;0;11
4460;Markučiai;Drugelių;7110705287;Ne;7;0;3;10
4461;Markučiai;Drugelių;6055822200;Ne;5;0;0;5
4462;Markučiai;Skruzdėliukų;5566529492;Ne;7;0;0;7
4463;Markučiai;Skruzdėliukų;8105747904;Taip;2;2;0;4
4464;Markučiai;Skruzdėliukų;6617799980;Ne;0;5;0;5
4465;Markučiai;Skruzdėliukų;7580249913;Ne;4;0;0;4
4466;Markučiai;Skruzdėliukų;2246646548;Ne;7;0;0;7
4467;Markučiai;Skruzdėliukų;9921530582;Ne;2;0;0;2
4468;Markučiai;Skruzdėliukų;6759427415;Ne;20;0;0;20
4469;Markučiai;Skruzdėliukų;4820576711;Ne;7;0;0;7
4470;Markučiai;Skruzdėliukų;1527620947;Ne;11;0;0;11
4471;Markučiai;Skruzdėliukų;7881183912;Ne;5;0;0;5
4472;Markučiai;Skruzdėliukų;9338996275;Ne;11;0;0;11
4473;Markučiai;Skruzdėliukų;5180034556;Ne;5;0;0;5
4474;Markučiai;Skruzdėliukų;1929417022;Ne;9;0;0;9
4475;Markučiai;Skruzdėliukų;8679791696;Ne;4;0;0;4
4476;Markučiai;Skruzdėliukų;2647189399;Taip;9;0;0;9
4477;Markučiai;Skruzdėliukų;3077125574;Ne;0;6;0;6
4478;Markučiai;Skruzdėliukų;1711102751;Ne;10;0;0;10
4479;Markučiai;ZUIKUČIŲ;8722494948;Ne;10;0;0;10
4480;Markučiai;ZUIKUČIŲ;8649978914;Ne;6;0;0;6
4481;Markučiai;ZUIKUČIŲ;6415773081;Ne;8;0;0;8
4482;Markučiai;ZUIKUČIŲ;5027052978;Ne;8;0;0;8
4483;Markučiai;ZUIKUČIŲ;9143465340;Ne;1;6;0;7
4484;Markučiai;ZUIKUČIŲ;8921802809;Ne;10;0;0;10
4485;Markučiai;ZUIKUČIŲ;8811544042;Ne;12;0;0;12
4486;Markučiai;ZUIKUČIŲ;7307805203;Ne;5;0;0;5
4487;Markučiai;ZUIKUČIŲ;6385023139;Ne;13;0;0;13
4488;Markučiai;ZUIKUČIŲ;8661268341;Ne;19;0;0;19
4489;Markučiai;ZUIKUČIŲ;1632196228;Ne;4;0;0;4
4490;Markučiai;ZUIKUČIŲ;7704433720;Ne;10;0;0;10
4491;Markučiai;ZUIKUČIŲ;2937486382;Ne;5;0;0;5
4492;Markučiai;ŽIOGELIŲ;3859363657;Ne;6;0;1;7
4493;Markučiai;ŽIOGELIŲ;3306931221;Taip;6;3;0;9
4494;Markučiai;ŽIOGELIŲ;9249362647;Ne;8;2;0;10
4495;Markučiai;ŽIOGELIŲ;7425442727;Ne;9;0;0;9
4496;Markučiai;ŽIOGELIŲ;6293219533;Ne;11;0;0;11
4497;Markučiai;ŽIOGELIŲ;9395009057;Ne;16;0;0;16
4498;Markučiai;ŽIOGELIŲ;4306059458;Ne;9;0;0;9
4499;Markučiai;ŽIOGELIŲ;5934853242;Ne;14;0;0;14
4500;Markučiai;ŽIOGELIŲ;8489604005;Ne;21;0;2;23
4501;Markučiai;ŽIOGELIŲ;1989450429;Ne;18;0;0;18
4502;Markučiai;ŽIOGELIŲ;6469869116;Ne;24;0;0;24
4503;Markučiai;ŽIOGELIŲ;7299207983;Taip;13;0;0;13
4504;Markučiai;ŽIOGELIŲ;5429666204;Taip;12;0;0;12
4505;Markučiai;ŽIOGELIŲ;4590625976;Ne;16;0;0;16
4506;Markučiai;Ežiukių;5474990334;Ne;17;0;0;17
4507;Markučiai;Ežiukių;4829322890;Ne;17;0;1;18
4508;Markučiai;Ežiukių;8045995558;Ne;13;0;7;20
4509;Markučiai;Ežiukių;3864391517;Ne;2;0;0;2
4510;Markučiai;Ežiukių;9448972984;Ne;1;0;5;6
4511;Markučiai;Ežiukių;9462937261;Ne;0;0;6;6
4512;Markučiai;Ežiukių;2109460312;Ne;14;0;1;15
4513;Markučiai;Ežiukių;8085781929;Ne;0;6;0;6
4514;Markučiai;Ežiukių;2222934026;Ne;2;0;3;5
4515;Markučiai;Ežiukių;5096397215;Ne;7;0;2;9
4516;Markučiai;Ežiukių;7266459848;Ne;5;0;3;8
4517;Markučiai;Ežiukių;3942674807;Ne;8;0;2;10
4518;Markučiai;Ežiukių;8338320308;Taip;7;0;3;10
4519;Markučiai;Ežiukių;1376430548;Ne;0;0;2;2
4520;Markučiai;Ežiukių;8670849222;Ne;0;0;1;1
4521;Mažylis;"2 DARŽELIO GR.";1500475643;Ne;0;0;2;2
4522;Mažylis;"2 DARŽELIO GR.";8259994523;Ne;5;0;0;5
4523;Mažylis;"2 DARŽELIO GR.";4347489809;Ne;0;0;3;3
4524;Mažylis;"2 DARŽELIO GR.";4985161657;Ne;5;0;1;6
4525;Mažylis;"2 DARŽELIO GR.";5297935198;Ne;3;0;0;3
4526;Mažylis;"2 DARŽELIO GR.";1993916098;Taip;9;0;0;9
4527;Mažylis;"2 DARŽELIO GR.";4309902086;Ne;0;5;0;5
4528;Mažylis;"2 DARŽELIO GR.";5727207294;Ne;0;0;1;1
4529;Mažylis;"2 DARŽELIO GR.";3064367996;Ne;0;8;0;8
4530;Mažylis;"2 DARŽELIO GR.";6500577246;Ne;1;0;1;2
4531;Mažylis;"2 DARŽELIO GR.";4557902728;Ne;15;0;0;15
4532;Mažylis;"2 DARŽELIO GR.";3098913589;Ne;2;0;0;2
4533;Mažylis;"2 DARŽELIO GR.";4201114033;Ne;10;0;0;10
4534;Mažylis;"2 DARŽELIO GR.";2110320072;Ne;0;0;1;1
4535;Mažylis;"2 DARŽELIO GR.";3911343193;Ne;0;0;4;4
4536;Mažylis;"2 DARŽELIO GR.";5225388496;Ne;0;0;1;1
4537;Mažylis;"4 PRIEŠMOKYKLINĖ GR.";2979849055;Ne;0;0;10;10
4538;Mažylis;"4 PRIEŠMOKYKLINĖ GR.";6162880220;Ne;0;0;3;3
4539;Mažylis;"4 PRIEŠMOKYKLINĖ GR.";6009637985;Ne;1;0;3;4
4540;Mažylis;"4 PRIEŠMOKYKLINĖ GR.";1762105763;Ne;0;0;1;1
4541;Mažylis;"4 PRIEŠMOKYKLINĖ GR.";2672500259;Ne;0;0;2;2
4542;Mažylis;"4 PRIEŠMOKYKLINĖ GR.";2935175014;Ne;0;0;1;1
4543;Mažylis;"4 PRIEŠMOKYKLINĖ GR.";8135596731;Ne;0;0;1;1
4544;Mažylis;"4 PRIEŠMOKYKLINĖ GR.";8297427176;Ne;0;0;1;1
4545;Mažylis;"4 PRIEŠMOKYKLINĖ GR.";5870983755;Ne;1;0;2;3
4546;Mažylis;"4 PRIEŠMOKYKLINĖ GR.";5685988186;Ne;0;0;1;1
4547;Mažylis;"4 PRIEŠMOKYKLINĖ GR.";4280547746;Ne;9;0;0;9
4548;Mažylis;"4 PRIEŠMOKYKLINĖ GR.";9447747294;Taip;10;0;0;10
4549;Mažylis;"4 PRIEŠMOKYKLINĖ GR.";4542742002;Ne;14;0;1;15
4550;Mažylis;"4 PRIEŠMOKYKLINĖ GR.";4553092508;Ne;0;0;1;1
4551;Mažylis;"4 PRIEŠMOKYKLINĖ GR.";2031457519;Ne;0;0;8;8
4552;Mažylis;"4 PRIEŠMOKYKLINĖ GR.";7923522942;Ne;10;0;1;11
4553;Mažylis;"3 DARŽELIO GR.";9401388775;Ne;0;0;2;2
4554;Mažylis;"3 DARŽELIO GR.";6809320247;Ne;0;0;3;3
4555;Mažylis;"3 DARŽELIO GR.";2006289999;Ne;3;0;0;3
4556;Mažylis;"3 DARŽELIO GR.";7652390515;Ne;0;0;4;4
4557;Mažylis;"3 DARŽELIO GR.";8639480781;Ne;0;0;2;2
4558;Mažylis;"3 DARŽELIO GR.";9341935211;Taip;7;0;1;8
4559;Mažylis;"3 DARŽELIO GR.";2989562406;Ne;3;0;0;3
4560;Mažylis;"3 DARŽELIO GR.";1151737098;Ne;17;0;0;17
4561;Mažylis;"3 DARŽELIO GR.";7642914458;Ne;7;2;0;9
4562;Mažylis;"3 DARŽELIO GR.";5938312001;Ne;0;0;2;2
4563;Mažylis;"3 DARŽELIO GR.";2119733659;Ne;0;0;1;1
4564;Mažylis;"3 DARŽELIO GR.";6904083734;Ne;0;4;0;4
4565;Mažylis;"3 DARŽELIO GR.";2319506343;Taip;8;0;1;9
4566;Mažylis;"3 DARŽELIO GR.";4592795281;Ne;1;0;1;2
4567;Mažylis;"6 DARŽELIO GR.";5388105083;Ne;3;0;0;3
4568;Mažylis;"6 DARŽELIO GR.";8589124394;Ne;15;0;2;17
4569;Mažylis;"6 DARŽELIO GR.";1892136590;Ne;0;0;2;2
4570;Mažylis;"6 DARŽELIO GR.";1381828313;Ne;5;0;3;8
4571;Mažylis;"6 DARŽELIO GR.";7725286603;Ne;0;0;4;4
4572;Mažylis;"6 DARŽELIO GR.";3615636349;Ne;4;0;2;6
4573;Mažylis;"6 DARŽELIO GR.";9894955253;Ne;5;0;0;5
4574;Mažylis;"6 DARŽELIO GR.";6270840529;Taip;6;0;1;7
4575;Mažylis;"6 DARŽELIO GR.";4100492642;Ne;0;0;6;6
4576;Mažylis;"6 DARŽELIO GR.";6492768766;Ne;16;0;0;16
4577;Mažylis;"6 DARŽELIO GR.";6423910850;Ne;10;0;0;10
4578;Mažylis;"6 DARŽELIO GR.";1555305826;Ne;4;0;2;6
4579;Mažylis;"6 DARŽELIO GR.";5977423702;Taip;0;0;1;1
4580;Mažylis;"6 DARŽELIO GR.";9562863405;Ne;4;0;2;6
4581;Mažylis;"6 DARŽELIO GR.";5990843024;Ne;2;0;10;12
4582;Mažylis;"6 DARŽELIO GR.";9981751097;Ne;9;0;0;9
4583;Mažylis;"6 DARŽELIO GR.";5137132420;Ne;7;0;1;8
4584;Mažylis;"1 NAUJA (LOPŠELIS)";1233510409;Ne;8;0;0;8
4585;Mažylis;"1 NAUJA (LOPŠELIS)";4688933880;Ne;0;0;2;2
4586;Mažylis;"1 NAUJA (LOPŠELIS)";5683455589;Taip;5;0;0;5
4587;Mažylis;"1 NAUJA (LOPŠELIS)";6441787213;Ne;3;0;1;4
4588;Mažylis;"1 NAUJA (LOPŠELIS)";1578050891;Ne;0;0;10;10
4589;Mažylis;"1 NAUJA (LOPŠELIS)";4828287511;Ne;0;0;4;4
4590;Mažylis;"1 NAUJA (LOPŠELIS)";8084695989;Ne;0;0;4;4
4591;Mažylis;"1 NAUJA (LOPŠELIS)";9416048380;Ne;2;0;1;3
4592;Mažylis;"1 NAUJA (LOPŠELIS)";1174743283;Ne;0;0;5;5
4593;Mažylis;"1 NAUJA (LOPŠELIS)";3898781037;Ne;13;0;0;13
4594;Mažylis;"1 NAUJA (LOPŠELIS)";7940550309;Ne;0;0;6;6
4595;Mažylis;"1 NAUJA (LOPŠELIS)";2331014727;Ne;0;0;1;1
4596;Mažylis;"1 NAUJA (LOPŠELIS)";4373022569;Ne;0;0;1;1
4597;Mažylis;"5 DARŽELIO GR.";8655053217;Ne;5;0;0;5
4598;Mažylis;"5 DARŽELIO GR.";1058725505;Ne;15;0;0;15
4599;Mažylis;"5 DARŽELIO GR.";1219174313;Ne;0;7;0;7
4600;Mažylis;"5 DARŽELIO GR.";9111101357;Ne;0;0;1;1
4601;Mažylis;"5 DARŽELIO GR.";6272047137;Ne;0;0;2;2
4602;Mažylis;"5 DARŽELIO GR.";7255856938;Taip;3;10;4;17
4603;Mažylis;"5 DARŽELIO GR.";2795618410;Ne;0;0;1;1
4604;Mažylis;"5 DARŽELIO GR.";4987487972;Ne;6;0;1;7
4605;Mažylis;"5 DARŽELIO GR.";9727982334;Ne;0;0;1;1
4606;Mažylis;"5 DARŽELIO GR.";2723677422;Ne;10;0;2;12
4607;Mažylis;"5 DARŽELIO GR.";7252955092;Taip;4;0;4;8
4608;Mažylis;"5 DARŽELIO GR.";3072841295;Ne;0;0;1;1
4609;Mažylis;"5 DARŽELIO GR.";4796712246;Ne;5;0;1;6
4610;Mažylis;"5 DARŽELIO GR.";3079202929;Ne;6;0;0;6
4611;Mažylis;"5 DARŽELIO GR.";7933156766;Ne;13;0;0;13
4612;Mažylis;"5 DARŽELIO GR.";2425437724;Ne;8;0;0;8
4613;Medynėlis;BITUTĖS;6238256156;Ne;2;3;0;5
4614;Medynėlis;BITUTĖS;8711567312;Ne;0;0;1;1
4615;Medynėlis;BITUTĖS;2993705115;Ne;0;2;3;5
4616;Medynėlis;BITUTĖS;1504612730;Ne;5;4;0;9
4617;Medynėlis;BITUTĖS;5522261530;Ne;5;0;1;6
4618;Medynėlis;BITUTĖS;6576401514;Ne;7;0;2;9
4619;Medynėlis;BITUTĖS;4107846958;Taip;0;3;0;3
4620;Medynėlis;BITUTĖS;7296044569;Ne;3;1;1;5
4621;Medynėlis;BITUTĖS;6815521895;Taip;4;0;1;5
4622;Medynėlis;BITUTĖS;4374464298;Ne;9;0;0;9
4623;Medynėlis;BITUTĖS;8107171123;Ne;8;2;0;10
4624;Medynėlis;BITUTĖS;4545707752;Ne;0;0;1;1
4625;Medynėlis;BITUTĖS;4419503239;Ne;1;0;0;1
4626;Medynėlis;BITUTĖS;6466874318;Taip;3;2;1;6
4627;Medynėlis;BITUTĖS;2798305000;Ne;1;0;0;1
4628;Medynėlis;BITUTĖS;4598267411;Ne;3;0;0;3
4629;Medynėlis;BITUTĖS;5194220650;Ne;6;0;0;6
4630;Medynėlis;BITUTĖS;4243521511;Ne;6;0;0;6
4631;Medynėlis;DRUGELIAI;5551121950;Ne;3;0;0;3
4632;Medynėlis;DRUGELIAI;2794274146;Ne;6;0;0;6
4633;Medynėlis;DRUGELIAI;9079900803;Taip;5;0;0;5
4634;Medynėlis;DRUGELIAI;5571641847;Ne;1;0;0;1
4635;Medynėlis;DRUGELIAI;6955467123;Ne;2;0;0;2
4636;Medynėlis;DRUGELIAI;5785463517;Ne;1;0;0;1
4637;Medynėlis;DRUGELIAI;9438854582;Ne;3;0;0;3
4638;Medynėlis;DRUGELIAI;5158507933;Ne;5;0;0;5
4639;Medynėlis;DRUGELIAI;4267654911;Ne;2;0;0;2
4640;Medynėlis;SKRUZDĖLIUKAI;2218838971;Ne;3;0;0;3
4641;Medynėlis;SKRUZDĖLIUKAI;1206480760;Ne;5;0;0;5
4642;Medynėlis;SKRUZDĖLIUKAI;3790099536;Ne;9;0;0;9
4643;Medynėlis;SKRUZDĖLIUKAI;9336656351;Ne;5;0;0;5
4644;Medynėlis;SKRUZDĖLIUKAI;7085226543;Ne;9;0;0;9
4645;Medynėlis;SKRUZDĖLIUKAI;5049081242;Taip;13;0;0;13
4646;Medynėlis;SKRUZDĖLIUKAI;4910857912;Ne;1;0;0;1
4647;Medynėlis;SKRUZDĖLIUKAI;6824842361;Ne;0;0;2;2
4648;Medynėlis;SKRUZDĖLIUKAI;1283602655;Ne;0;2;2;4
4649;Medynėlis;SKRUZDĖLIUKAI;4817353132;Ne;0;0;4;4
4650;Medynėlis;SKRUZDĖLIUKAI;7613699868;Ne;4;0;0;4
4651;Medynėlis;SKRUZDĖLIUKAI;3556203620;Ne;0;1;0;1
4652;Medynėlis;SKRUZDĖLIUKAI;4626655069;Ne;0;2;0;2
4653;Medynėlis;SKRUZDĖLIUKAI;5456045449;Ne;0;1;0;1
4654;Medynėlis;SKRUZDĖLIUKAI;8667441678;Ne;0;1;0;1
4655;Medynėlis;SKRUZDĖLIUKAI;6896823412;Ne;0;1;0;1
4656;Medynėlis;SKRUZDĖLIUKAI;5677747582;Ne;0;1;0;1
4657;Medynėlis;SKRUZDĖLIUKAI;3480190692;Taip;8;0;1;9
4658;Medynėlis;SKRUZDĖLIUKAI;5581973770;Ne;0;0;1;1
4659;Medynėlis;VOVERIUKAI;8275097931;Ne;8;0;0;8
4660;Medynėlis;VOVERIUKAI;1026253778;Taip;5;0;0;5
4661;Medynėlis;VOVERIUKAI;2523474347;Ne;17;1;0;18
4662;Medynėlis;VOVERIUKAI;5302122600;Ne;9;0;1;10
4663;Medynėlis;VOVERIUKAI;6609111216;Ne;3;0;0;3
4664;Medynėlis;VOVERIUKAI;6624835214;Ne;2;0;0;2
4665;Medynėlis;VOVERIUKAI;2160081492;Ne;0;4;0;4
4666;Medynėlis;VOVERIUKAI;4035587227;Ne;12;0;0;12
4667;Medynėlis;VOVERIUKAI;8162771849;Ne;10;0;0;10
4668;Medynėlis;VOVERIUKAI;9725019515;Ne;5;0;0;5
4669;Medynėlis;VOVERIUKAI;3185760752;Ne;1;0;0;1
4670;Medynėlis;VOVERIUKAI;1404831377;Taip;8;0;1;9
4671;Medynėlis;VOVERIUKAI;7814008588;Ne;10;0;0;10
4672;Medynėlis;VOVERIUKAI;5610660982;Ne;8;0;0;8
4673;Medynėlis;VOVERIUKAI;6282113738;Ne;1;0;0;1
4674;Medynėlis;VOVERIUKAI;4153545500;Ne;4;0;0;4
4675;Medynėlis;VOVERIUKAI;8299034970;Ne;6;1;0;7
4676;Medynėlis;VOVERIUKAI;7675101600;Taip;2;0;0;2
4677;Medynėlis;VOVERIUKAI;1668143166;Ne;11;4;1;16
4678;Medynėlis;VOVERIUKAI;1608019909;Ne;10;2;0;12
4679;Medynėlis;VOVERIUKAI;4010058673;Ne;4;0;0;4
4680;Medynėlis;VOVERIUKAI;6502531749;Taip;0;0;11;11
4681;Medynėlis;MEŠKIUKAI;7140184593;Ne;13;0;0;13
4682;Medynėlis;MEŠKIUKAI;6107849795;Ne;1;7;0;8
4683;Medynėlis;MEŠKIUKAI;4488439037;Ne;2;0;3;5
4684;Medynėlis;MEŠKIUKAI;1056744101;Ne;4;2;1;7
4685;Medynėlis;MEŠKIUKAI;6485314750;Ne;12;0;0;12
4686;Medynėlis;MEŠKIUKAI;7455041214;Ne;5;1;0;6
4687;Medynėlis;MEŠKIUKAI;5028189785;Ne;6;0;0;6
4688;Medynėlis;MEŠKIUKAI;3761845905;Taip;7;1;0;8
4689;Medynėlis;MEŠKIUKAI;7272017225;Ne;0;6;0;6
4690;Medynėlis;MEŠKIUKAI;4092824377;Ne;8;3;0;11
4691;Medynėlis;MEŠKIUKAI;1475701065;Ne;0;1;0;1
4692;Medynėlis;MEŠKIUKAI;4645171858;Taip;1;1;1;3
4693;Medynėlis;PELĖDŽIUKAI;4222917765;Ne;0;0;1;1
4694;Medynėlis;PELĖDŽIUKAI;6681155625;Ne;2;1;0;3
4695;Medynėlis;PELĖDŽIUKAI;6211076154;Ne;6;0;0;6
4696;Medynėlis;PELĖDŽIUKAI;6975191449;Ne;9;0;3;12
4697;Medynėlis;PELĖDŽIUKAI;3905440176;Ne;0;1;1;2
4698;Medynėlis;PELĖDŽIUKAI;8441629302;Ne;0;2;0;2
4699;Medynėlis;PELĖDŽIUKAI;4783894465;Ne;5;11;0;16
4700;Medynėlis;PELĖDŽIUKAI;3761140697;Ne;15;0;1;16
4701;Medynėlis;PELĖDŽIUKAI;5330900656;Ne;8;0;0;8
4702;Medynėlis;PELĖDŽIUKAI;8719860414;Ne;5;0;0;5
4703;Medynėlis;PELĖDŽIUKAI;4897227188;Ne;7;0;5;12
4704;Medynėlis;PELĖDŽIUKAI;9873696787;Taip;12;0;0;12
4705;Medynėlis;PELĖDŽIUKAI;6802308420;Ne;0;1;0;1
4706;Medynėlis;PELĖDŽIUKAI;2339692406;Ne;8;0;1;9
4707;Medynėlis;PELĖDŽIUKAI;3947494044;Ne;3;0;2;5
4708;Medynėlis;PELĖDŽIUKAI;3295727210;Ne;12;0;0;12
4709;Medynėlis;PELĖDŽIUKAI;2234994999;Ne;1;3;0;4
4710;Medynėlis;BORUŽIUKAI;6622963662;Ne;10;0;0;10
4711;Medynėlis;BORUŽIUKAI;1500986498;Ne;10;0;0;10
4712;Medynėlis;BORUŽIUKAI;6924524346;Ne;5;3;0;8
4713;Medynėlis;BORUŽIUKAI;2877881247;Ne;0;5;0;5
4714;Medynėlis;BORUŽIUKAI;3709984586;Ne;1;0;0;1
4715;Medynėlis;BORUŽIUKAI;6470879334;Ne;6;0;0;6
4716;Medynėlis;BORUŽIUKAI;2379829985;Ne;15;0;0;15
4717;Medynėlis;BORUŽIUKAI;5391199861;Ne;0;6;0;6
4718;Medynėlis;BORUŽIUKAI;2816510180;Ne;4;0;0;4
4719;Medynėlis;BORUŽIUKAI;3538656650;Ne;0;3;0;3
4720;Medynėlis;BORUŽIUKAI;5389909872;Ne;14;1;0;15
4721;Medynėlis;EŽIUKAI;8125271445;Ne;3;4;0;7
4722;Medynėlis;EŽIUKAI;9847006679;Ne;9;0;1;10
4723;Medynėlis;EŽIUKAI;7317307957;Ne;5;1;0;6
4724;Medynėlis;EŽIUKAI;7860869675;Ne;3;0;0;3
4725;Medynėlis;EŽIUKAI;1062269215;Ne;4;4;0;8
4726;Medynėlis;EŽIUKAI;5197757730;Taip;6;0;1;7
4727;Medynėlis;EŽIUKAI;5333502849;Ne;1;0;0;1
4728;Medynėlis;EŽIUKAI;6536626390;Ne;1;0;0;1
4729;Medynėlis;EŽIUKAI;8953622684;Ne;0;6;0;6
4730;Medynėlis;EŽIUKAI;9175884049;Ne;0;0;1;1
4731;Medynėlis;EŽIUKAI;8609650186;Taip;0;6;0;6
4732;Medynėlis;EŽIUKAI;6826409129;Ne;10;0;0;10
4733;Medynėlis;EŽIUKAI;2929100410;Ne;2;0;0;2
4734;Medynėlis;EŽIUKAI;6359536923;Ne;1;1;0;2
4735;Medynėlis;EŽIUKAI;2676262920;Ne;6;0;2;8
4736;Medynėlis;EŽIUKAI;5339084041;Taip;5;0;0;5
4737;Medynėlis;EŽIUKAI;6561927001;Ne;11;0;0;11
4738;Medynėlis;EŽIUKAI;8838774666;Ne;5;0;0;5
4739;Medynėlis;EŽIUKAI;6349817783;Ne;14;0;0;14
4740;Medynėlis;ZUIKUČIAI;9857514451;Ne;15;0;0;15
4741;Medynėlis;ZUIKUČIAI;4498233742;Ne;0;0;1;1
4742;Medynėlis;ZUIKUČIAI;6641009653;Ne;2;0;0;2
4743;Medynėlis;ZUIKUČIAI;2512917914;Ne;0;0;1;1
4744;Medynėlis;ZUIKUČIAI;6888812634;Taip;6;0;0;6
4745;Medynėlis;ZUIKUČIAI;8904493539;Taip;5;0;0;5
4746;Medynėlis;ZUIKUČIAI;1260839046;Ne;2;1;0;3
4747;Medynėlis;ZUIKUČIAI;8542591286;Ne;8;0;0;8
4748;Medynėlis;ZUIKUČIAI;7312016138;Ne;9;0;1;10
4749;Medynėlis;ZUIKUČIAI;6847727830;Ne;10;0;0;10
4750;Medynėlis;ZUIKUČIAI;3048797634;Ne;0;0;2;2
4751;Medynėlis;ZUIKUČIAI;3446378114;Ne;13;0;2;15
4752;Medynėlis;KAČIUKAI;2735961000;Ne;0;11;2;13
4753;Medynėlis;KAČIUKAI;3187000487;Ne;4;0;0;4
4754;Medynėlis;KAČIUKAI;1616551970;Taip;17;0;0;17
4755;Medynėlis;KAČIUKAI;7737665102;Ne;1;1;0;2
4756;Medynėlis;KAČIUKAI;1840127319;Ne;10;0;0;10
4757;Medynėlis;KAČIUKAI;2259408744;Taip;12;0;0;12
4758;Medynėlis;KAČIUKAI;5096386323;Ne;2;0;0;2
4759;Medynėlis;KAČIUKAI;2322666023;Ne;9;0;0;9
4760;Medynėlis;KAČIUKAI;9352913210;Ne;0;3;0;3
4761;Medynėlis;KAČIUKAI;4328794578;Ne;0;0;2;2
4762;Medynėlis;KAČIUKAI;9389418983;Ne;13;0;0;13
4763;Medynėlis;KAČIUKAI;2507106460;Taip;2;0;0;2
4764;Medynėlis;KAČIUKAI;8382537735;Ne;9;0;0;9
4765;Medynėlis;KAČIUKAI;7268418306;Taip;3;0;0;3
4766;Medynėlis;KAČIUKAI;2028112718;Taip;7;0;0;7
4767;Medynėlis;PELIUKAI;6614028601;Ne;14;0;0;14
4768;Medynėlis;PELIUKAI;8439619837;Ne;0;0;7;7
4769;Medynėlis;PELIUKAI;9352391583;Ne;0;0;2;2
4770;Medynėlis;PELIUKAI;4040542730;Ne;0;6;0;6
4771;Medynėlis;PELIUKAI;6989524053;Ne;4;0;1;5
4772;Medynėlis;PELIUKAI;9774213537;Ne;1;0;0;1
4773;Medynėlis;PELIUKAI;9977590259;Ne;6;1;0;7
4774;Medynėlis;PELIUKAI;7170801214;Ne;8;0;0;8
4775;Medynėlis;PELIUKAI;9373849916;Ne;4;0;0;4
4776;Medynėlis;PELIUKAI;8678054784;Ne;0;0;1;1
4777;Medynėlis;PELIUKAI;6569938649;Ne;5;0;3;8
4778;Medynėlis;PELIUKAI;6462589513;Ne;8;0;0;8
4779;Medynėlis;PELIUKAI;4444555055;Taip;0;0;2;2
4780;Medynėlis;PELIUKAI;2231990831;Ne;6;0;0;6
4781;Medynėlis;PELIUKAI;8887092965;Ne;6;1;0;7
4782;Medynėlis;PELIUKAI;3299495310;Ne;13;0;0;13
4783;Medynėlis;ANČIUKAI;8175602822;Ne;6;0;0;6
4784;Medynėlis;ANČIUKAI;9536473088;Ne;11;0;0;11
4785;Medynėlis;ANČIUKAI;4006434252;Ne;5;0;0;5
4786;Medynėlis;ANČIUKAI;8994120910;Ne;7;0;0;7
4787;Medynėlis;ANČIUKAI;6948059114;Ne;7;0;0;7
4788;Medynėlis;ANČIUKAI;9288258906;Ne;10;1;0;11
4789;Medynėlis;ANČIUKAI;4869007055;Ne;17;0;0;17
4790;Medynėlis;ANČIUKAI;9025913427;Ne;17;0;0;17
4791;Medynėlis;ANČIUKAI;7661220337;Ne;10;0;0;10
4792;Medynėlis;ANČIUKAI;3739441317;Taip;5;0;0;5
4793;Medynėlis;ANČIUKAI;6208391418;Ne;7;0;0;7
4794;Medynėlis;ANČIUKAI;1936512553;Ne;1;1;0;2
4795;Medynėlis;ANČIUKAI;1864754712;Ne;20;0;0;20
4796;Molinukas;NYKŠTUKAI;4974513900;Ne;0;2;0;2
4797;Molinukas;NYKŠTUKAI;8313486714;Ne;6;0;0;6
4798;Molinukas;NYKŠTUKAI;8608465121;Ne;7;8;0;15
4799;Molinukas;NYKŠTUKAI;1826463800;Ne;0;0;2;2
4800;Molinukas;NYKŠTUKAI;3043679624;Ne;2;0;4;6
4801;Molinukas;NYKŠTUKAI;4992887072;Ne;3;0;0;3
4802;Molinukas;NYKŠTUKAI;8769667823;Ne;10;0;0;10
4803;Molinukas;NYKŠTUKAI;1651103318;Ne;8;0;0;8
4804;Molinukas;NYKŠTUKAI;6947938890;Ne;3;0;0;3
4805;Molinukas;NYKŠTUKAI;1970929144;Ne;4;0;0;4
4806;Molinukas;NYKŠTUKAI;1292778118;Ne;10;0;0;10
4807;Molinukas;NYKŠTUKAI;3510936830;Ne;7;0;0;7
4808;Molinukas;NYKŠTUKAI;1907287249;Ne;0;0;1;1
4809;Molinukas;NYKŠTUKAI;5172948843;Ne;8;0;0;8
4810;Molinukas;NYKŠTUKAI;7825545164;Ne;6;0;0;6
4811;Molinukas;NYKŠTUKAI;6190443233;Ne;5;0;2;7
4812;Molinukas;NYKŠTUKAI;6531106368;Ne;8;0;0;8
4813;Molinukas;NYKŠTUKAI;4122429163;Ne;5;5;0;10
4814;Molinukas;NYKŠTUKAI;8660958288;Taip;14;0;0;14
4815;Molinukas;NYKŠTUKAI;2862680065;Ne;9;1;0;10
4816;Molinukas;NYKŠTUKAI;3382913312;Ne;9;0;0;9
4817;Molinukas;NYKŠTUKAI;3331982964;Ne;3;0;0;3
4818;Molinukas;NYKŠTUKAI;2842168450;Ne;5;0;0;5
4819;Molinukas;NYKŠTUKAI;4044289280;Ne;5;0;0;5
4820;Molinukas;ZUIKUČIŲ;9203375647;Ne;0;1;0;1
4821;Molinukas;ZUIKUČIŲ;2982968605;Ne;5;0;0;5
4822;Molinukas;ZUIKUČIŲ;8479427729;Ne;0;1;0;1
4823;Molinukas;ZUIKUČIŲ;4225457772;Ne;10;0;0;10
4824;Molinukas;ZUIKUČIŲ;5597119459;Ne;0;9;0;9
4825;Molinukas;ZUIKUČIŲ;8582985479;Ne;8;0;0;8
4826;Molinukas;ZUIKUČIŲ;8490020853;Ne;8;0;0;8
4827;Molinukas;ZUIKUČIŲ;2651732418;Ne;2;0;0;2
4828;Molinukas;ZUIKUČIŲ;8988478990;Ne;4;0;0;4
4829;Molinukas;ZUIKUČIŲ;1059002689;Ne;3;2;0;5
4830;Molinukas;ZUIKUČIŲ;5302191209;Ne;10;0;0;10
4831;Molinukas;ZUIKUČIŲ;1605039166;Ne;4;1;0;5
4832;Molinukas;ZUIKUČIŲ;6804127471;Ne;4;1;0;5
4833;Molinukas;ZUIKUČIŲ;2878262979;Ne;6;0;0;6
4834;Molinukas;ZUIKUČIŲ;7441251480;Ne;4;0;0;4
4835;Molinukas;ZUIKUČIŲ;4733315902;Ne;6;0;0;6
4836;Molinukas;ZUIKUČIŲ;2595941277;Ne;5;0;0;5
4837;Molinukas;ZUIKUČIŲ;3516132254;Ne;1;0;0;1
4838;Molinukas;ZUIKUČIŲ;4718396549;Ne;13;0;0;13
4839;Molinukas;ZUIKUČIŲ;3577613732;Ne;2;0;0;2
4840;Molinukas;ZUIKUČIŲ;9972204424;Ne;5;0;0;5
4841;Molinukas;ZUIKUČIŲ;3419958136;Ne;6;0;0;6
4842;Molinukas;SRAIGIUKŲ;4806350914;Taip;10;0;0;10
4843;Molinukas;SRAIGIUKŲ;2757744826;Ne;8;0;2;10
4844;Molinukas;SRAIGIUKŲ;7451224160;Ne;0;6;0;6
4845;Molinukas;SRAIGIUKŲ;4475594896;Ne;15;1;0;16
4846;Molinukas;SRAIGIUKŲ;7623051674;Ne;0;1;0;1
4847;Molinukas;SRAIGIUKŲ;9448910819;Ne;2;5;0;7
4848;Molinukas;SRAIGIUKŲ;4101644021;Ne;0;4;0;4
4849;Molinukas;SRAIGIUKŲ;5580968328;Ne;1;0;0;1
4850;Molinukas;SRAIGIUKŲ;6353165459;Ne;0;4;0;4
4851;Molinukas;SRAIGIUKŲ;9293819449;Ne;0;0;2;2
4852;Molinukas;SRAIGIUKŲ;6087698882;Ne;7;0;0;7
4853;Molinukas;SRAIGIUKŲ;1849018608;Ne;5;0;0;5
4854;Molinukas;SRAIGIUKŲ;4171978721;Ne;13;0;0;13
4855;Molinukas;SRAIGIUKŲ;6681397435;Ne;5;0;0;5
4856;Molinukas;SRAIGIUKŲ;5525772579;Ne;6;0;0;6
4857;Molinukas;SRAIGIUKŲ;5876669121;Ne;8;0;0;8
4858;Molinukas;SRAIGIUKŲ;8053608348;Ne;0;3;0;3
4859;Molinukas;SRAIGIUKŲ;6014990150;Ne;0;0;1;1
4860;Molinukas;VOVERIUKAI;3469196411;Ne;2;0;1;3
4861;Molinukas;VOVERIUKAI;4583155940;Ne;0;0;3;3
4862;Molinukas;VOVERIUKAI;8541456847;Ne;0;0;2;2
4863;Molinukas;VOVERIUKAI;2286586693;Ne;4;1;0;5
4864;Molinukas;VOVERIUKAI;9413396859;Ne;0;0;2;2
4865;Molinukas;VOVERIUKAI;6898958282;Ne;3;0;10;13
4866;Molinukas;VOVERIUKAI;4000190261;Ne;0;0;1;1
4867;Molinukas;VOVERIUKAI;5685582215;Ne;0;2;0;2
4868;Molinukas;VOVERIUKAI;2356814145;Ne;0;0;1;1
4869;Molinukas;VOVERIUKAI;7446607510;Ne;0;6;0;6
4870;Molinukas;VOVERIUKAI;9667704959;Ne;4;1;4;9
4871;Molinukas;VOVERIUKAI;8516451290;Ne;3;0;1;4
4872;Molinukas;VOVERIUKAI;4950808381;Ne;0;10;2;12
4873;Molinukas;VOVERIUKAI;2779700726;Ne;3;0;2;5
4874;Molinukas;VOVERIUKAI;6832647220;Ne;0;0;1;1
4875;Molinukas;ŽVIRBLIUKŲ;2935945686;Ne;4;0;0;4
4876;Molinukas;ŽVIRBLIUKŲ;2090783609;Ne;1;0;0;1
4877;Molinukas;ŽVIRBLIUKŲ;9850656596;Ne;13;0;0;13
4878;Molinukas;ŽVIRBLIUKŲ;7052683028;Ne;6;1;0;7
4879;Molinukas;ŽVIRBLIUKŲ;6324308817;Ne;9;0;0;9
4880;Molinukas;ŽVIRBLIUKŲ;8578781383;Taip;2;0;0;2
4881;Molinukas;ŽVIRBLIUKŲ;1768984445;Ne;12;0;0;12
4882;Molinukas;ŽVIRBLIUKŲ;5040258188;Ne;5;0;0;5
4883;Molinukas;ŽVIRBLIUKŲ;9936048965;Ne;9;1;0;10
4884;Molinukas;KAČIUKŲ;4356610282;Ne;14;0;6;20
4885;Molinukas;KAČIUKŲ;5166540248;Ne;13;0;0;13
4886;Molinukas;KAČIUKŲ;5834614345;Ne;13;0;0;13
4887;Molinukas;KAČIUKŲ;5665993086;Ne;3;0;0;3
4888;Molinukas;KAČIUKŲ;7349691727;Ne;10;1;0;11
4889;Molinukas;KAČIUKŲ;7192221243;Ne;4;0;0;4
4890;Molinukas;KAČIUKŲ;2866461509;Ne;10;0;2;12
4891;Molinukas;KAČIUKŲ;6096244346;Ne;13;0;0;13
4892;Molinukas;KAČIUKŲ;2537694744;Ne;10;0;1;11
4893;"Naminukas (Smėlio g. 13)";Drugeliai;6776805494;Ne;5;0;0;5
4894;"Naminukas (Smėlio g. 13)";Drugeliai;2395070574;Ne;5;0;0;5
4895;"Naminukas (Smėlio g. 13)";Drugeliai;5534073614;Ne;0;1;0;1
4896;"Naminukas (Smėlio g. 13)";Drugeliai;2132345627;Ne;0;7;0;7
4897;"Naminukas (Smėlio g. 13)";Drugeliai;2864905392;Ne;4;12;1;17
4898;"Naminukas (Smėlio g. 13)";Drugeliai;7406775925;Ne;13;0;0;13
4899;"Naminukas (Smėlio g. 13)";Drugeliai;1333462200;Ne;0;0;2;2
4900;"Naminukas (Smėlio g. 13)";Drugeliai;5468218968;Ne;1;0;0;1
4901;"Naminukas (Smėlio g. 13)";Drugeliai;5713661641;Ne;0;2;0;2
4902;"Naminukas (Smėlio g. 13)";Drugeliai;2198493034;Ne;0;2;1;3
4903;"Naminukas (Smėlio g. 13)";Drugeliai;8141324449;Ne;5;0;1;6
4904;"Naminukas (Smėlio g. 13)";Drugeliai;3236525642;Ne;0;0;1;1
4905;"Naminukas (Smėlio g. 13)";Drugeliai;7347998152;Ne;0;8;0;8
4906;"Naminukas (Smėlio g. 13)";Drugeliai;7272465847;Ne;12;0;0;12
4907;"Naminukas (Smėlio g. 13)";Drugeliai;7471964981;Ne;9;2;0;11
4908;"Naminukas (Smėlio g. 13)";Drugeliai;8760638670;Ne;3;0;1;4
4909;"Naminukas (Smėlio g. 13)";Drugeliai;1648466517;Ne;3;0;0;3
4910;"Naminukas (Smėlio g. 13)";Bitutės;6057391542;Ne;15;0;0;15
4911;"Naminukas (Smėlio g. 13)";Bitutės;3546140753;Ne;9;0;0;9
4912;"Naminukas (Smėlio g. 13)";Bitutės;6351199828;Ne;7;0;0;7
4913;"Naminukas (Smėlio g. 13)";Bitutės;4624191456;Ne;7;0;0;7
4914;"Naminukas (Smėlio g. 13)";Bitutės;4671626416;Ne;4;1;0;5
4915;"Naminukas (Smėlio g. 13)";Bitutės;4941814027;Ne;0;2;1;3
4916;"Naminukas (Smėlio g. 13)";Bitutės;2179061425;Taip;0;3;0;3
4917;"Naminukas (Smėlio g. 13)";Bitutės;1095955939;Ne;0;1;0;1
4918;"Naminukas (Smėlio g. 13)";Bitutės;4422173848;Taip;16;1;0;17
4919;"Naminukas (Smėlio g. 13)";Bitutės;5741698937;Ne;0;7;0;7
4920;"Naminukas (Smėlio g. 13)";Bitutės;7717132979;Ne;9;2;1;12
4921;"Naminukas (Smėlio g. 13)";Bitutės;9357758815;Ne;3;0;0;3
4922;"Naminukas (Smėlio g. 13)";Bitutės;7807791056;Ne;5;1;0;6
4923;"Naminukas (Smėlio g. 13)";Bitutės;1217359876;Ne;0;9;0;9
4924;"Naminukas (Smėlio g. 13)";Bitutės;5465843371;Ne;4;0;0;4
4925;"Naminukas (Smėlio g. 13)";Paukšteliai;3501921619;Ne;0;1;0;1
4926;"Naminukas (Smėlio g. 13)";Paukšteliai;7297661383;Ne;0;1;0;1
4927;"Naminukas (Smėlio g. 13)";Paukšteliai;5056487802;Ne;0;2;0;2
4928;"Naminukas (Smėlio g. 13)";Paukšteliai;3438010199;Ne;0;0;5;5
4929;"Naminukas (Smėlio g. 13)";Paukšteliai;4998565160;Ne;5;7;0;12
4930;"Naminukas (Smėlio g. 13)";Paukšteliai;9405784626;Ne;0;0;5;5
4931;"Naminukas (Smėlio g. 13)";Paukšteliai;2583886896;Ne;0;6;0;6
4932;"Naminukas (Smėlio g. 13)";Paukšteliai;4778385421;Ne;5;0;5;10
4933;"Naminukas (Smėlio g. 13)";Paukšteliai;6178500478;Ne;0;0;2;2
4934;"Naminukas (Smėlio g. 13)";Paukšteliai;9440685520;Ne;0;2;0;2
4935;"Naminukas (Smėlio g. 13)";Paukšteliai;1406418130;Ne;4;0;1;5
4936;"Naminukas (Smėlio g. 13)";Paukšteliai;2012656186;Ne;4;0;0;4
4937;"Naminukas (Smėlio g. 13)";Paukšteliai;8470716196;Ne;0;0;1;1
4938;"Naminukas (Smėlio g. 13)";Paukšteliai;3727828033;Ne;0;3;0;3
4939;"Naminukas (Smėlio g. 13)";Paukšteliai;2652538212;Ne;0;2;1;3
4940;"Naminukas (Smėlio g. 13)";Paukšteliai;5280419144;Ne;0;3;0;3
4941;"Naminukas (Smėlio g. 13)";Paukšteliai;3018465520;Ne;9;0;0;9
4942;"Naminukas (Smėlio g. 13)";"NYKŠTUKAI ";5519447152;Ne;0;6;0;6
4943;"Naminukas (Smėlio g. 13)";"NYKŠTUKAI ";1286329245;Ne;10;5;0;15
4944;"Naminukas (Smėlio g. 13)";"NYKŠTUKAI ";1618802271;Ne;5;0;1;6
4945;"Naminukas (Smėlio g. 13)";"NYKŠTUKAI ";1591540165;Ne;6;1;0;7
4946;"Naminukas (Smėlio g. 13)";"NYKŠTUKAI ";1118193598;Ne;0;0;2;2
4947;"Naminukas (Smėlio g. 13)";"NYKŠTUKAI ";8102805098;Ne;5;0;0;5
4948;"Naminukas (Smėlio g. 13)";"NYKŠTUKAI ";2168486597;Ne;0;1;0;1
4949;"Naminukas (Smėlio g. 13)";"NYKŠTUKAI ";5984789325;Ne;8;2;0;10
4950;"Naminukas (Smėlio g. 13)";"NYKŠTUKAI ";9891722891;Ne;2;3;1;6
4951;"Naminukas (Smėlio g. 13)";"NYKŠTUKAI ";7703842464;Ne;0;0;3;3
4952;Nykštukas;SMAGURIAI;1148800623;Taip;3;0;0;3
4953;Nykštukas;SMAGURIAI;7320458031;Ne;6;0;0;6
4954;Nykštukas;SMAGURIAI;7432373335;Ne;6;0;0;6
4955;Nykštukas;SMAGURIAI;6337924089;Ne;3;3;0;6
4956;Nykštukas;SMAGURIAI;2748970206;Ne;10;0;0;10
4957;Nykštukas;SMAGURIAI;3441133631;Ne;0;5;0;5
4958;Nykštukas;SMAGURIAI;7562216310;Ne;0;5;0;5
4959;Nykštukas;SMAGURIAI;6594118834;Ne;5;0;0;5
4960;Nykštukas;SMAGURIAI;2455221957;Ne;0;0;2;2
4961;Nykštukas;SMAGURIAI;5429377807;Ne;5;5;4;14
4962;Nykštukas;SMAGURIAI;4071479304;Ne;4;0;0;4
4963;Nykštukas;SMAGURIAI;2910587300;Ne;13;0;0;13
4964;Nykštukas;SMAGURIAI;2770385957;Ne;4;0;0;4
4965;Nykštukas;SMAGURIAI;8695794490;Ne;5;1;0;6
4966;Nykštukas;SMAGURIAI;5281616311;Ne;0;1;0;1
4967;Nykštukas;SMAGURIAI;8372380734;Ne;3;1;1;5
4968;Nykštukas;SMAGURIAI;6672148719;Ne;0;11;0;11
4969;Nykštukas;SMAGURIAI;9790322329;Ne;0;1;0;1
4970;Nykštukas;SMAGURIAI;5718555692;Ne;5;1;0;6
4971;Nykštukas;SMALSIUKAI;6285425127;Ne;1;0;0;1
4972;Nykštukas;SMALSIUKAI;2947976429;Taip;6;0;0;6
4973;Nykštukas;SMALSIUKAI;6883272732;Ne;5;0;0;5
4974;Nykštukas;SMALSIUKAI;8919778025;Ne;0;8;0;8
4975;Nykštukas;SMALSIUKAI;8827094160;Ne;0;1;1;2
4976;Nykštukas;SMALSIUKAI;9887096503;Ne;10;1;0;11
4977;Nykštukas;SMALSIUKAI;4323166473;Ne;0;1;0;1
4978;Nykštukas;SMALSIUKAI;4955003100;Ne;8;0;0;8
4979;Nykštukas;SMALSIUKAI;5103512898;Ne;2;0;1;3
4980;Nykštukas;SMALSIUKAI;8667489439;Ne;0;1;0;1
4981;Nykštukas;SMALSIUKAI;7266550834;Ne;0;2;0;2
4982;Nykštukas;SMALSIUKAI;6563871327;Ne;6;1;0;7
4983;Nykštukas;SMALSIUKAI;8819485547;Ne;5;0;2;7
4984;Nykštukas;SMALSIUKAI;5010715255;Ne;0;1;3;4
4985;Nykštukas;SMALSIUKAI;4499337321;Ne;5;0;0;5
4986;Nykštukas;SMALSIUKAI;4445045176;Ne;1;0;3;4
4987;Nykštukas;AITVARIUKAI;6923345088;Taip;3;0;0;3
4988;Nykštukas;AITVARIUKAI;8580777381;Ne;5;0;0;5
4989;Nykštukas;AITVARIUKAI;9319066179;Ne;5;1;0;6
4990;Nykštukas;AITVARIUKAI;2177539882;Ne;1;0;1;2
4991;Nykštukas;AITVARIUKAI;9894698453;Ne;5;10;0;15
4992;Nykštukas;AITVARIUKAI;2232317366;Ne;4;1;0;5
4993;Nykštukas;AITVARIUKAI;7332769878;Taip;8;0;0;8
4994;Nykštukas;AITVARIUKAI;7896338372;Ne;2;0;0;2
4995;Nykštukas;AITVARIUKAI;2208319289;Ne;0;4;0;4
4996;Nykštukas;AITVARIUKAI;8548820023;Ne;3;0;1;4
4997;Nykštukas;AITVARIUKAI;4177690371;Ne;4;0;0;4
4998;Nykštukas;AITVARIUKAI;5292127770;Ne;9;0;1;10
4999;Nykštukas;DAINORĖLIAI;7730918105;Ne;5;1;0;6
5000;Nykštukas;DAINORĖLIAI;8475127245;Ne;3;0;0;3
5001;Nykštukas;DAINORĖLIAI;5434220008;Ne;1;0;0;1
5002;Nykštukas;DAINORĖLIAI;9776630115;Ne;0;2;0;2
5003;Nykštukas;DAINORĖLIAI;9524639831;Ne;0;2;0;2
5004;Nykštukas;DAINORĖLIAI;3367348573;Ne;0;4;0;4
5005;Nykštukas;DAINORĖLIAI;5961945345;Ne;3;1;0;4
5006;Nykštukas;DAINORĖLIAI;6561696818;Ne;10;0;0;10
5007;Nykštukas;DAINORĖLIAI;1283453188;Ne;8;2;0;10
5008;Nykštukas;DAINORĖLIAI;7473124310;Taip;0;1;0;1
5009;Nykštukas;DAINORĖLIAI;1174618721;Ne;0;2;0;2
5010;Nykštukas;DAINORĖLIAI;5255726742;Ne;6;0;0;6
5011;Nykštukas;DAINORĖLIAI;9027355399;Ne;0;6;0;6
5012;Nykštukas;DAINORĖLIAI;4893494144;Ne;0;2;0;2
5013;Nykštukas;DAINORĖLIAI;8318089070;Taip;15;0;0;15
5014;Nykštukas;DAINORĖLIAI;2727074729;Ne;0;1;0;1
5015;Nykštukas;DAINORĖLIAI;9437700329;Ne;0;5;0;5
5016;Nykštukas;POKŠTUKAI;7382271765;Ne;8;0;0;8
5017;Nykštukas;POKŠTUKAI;1655428422;Ne;5;2;0;7
5018;Nykštukas;POKŠTUKAI;2649916049;Ne;5;5;0;10
5019;Nykštukas;POKŠTUKAI;1796016501;Ne;15;5;0;20
5020;Nykštukas;POKŠTUKAI;5958711585;Ne;6;1;0;7
5021;Nykštukas;POKŠTUKAI;3999004312;Ne;10;0;0;10
5022;Nykštukas;POKŠTUKAI;6719999304;Ne;7;7;0;14
5023;Nykštukas;POKŠTUKAI;8148163137;Ne;0;5;0;5
5024;Nykštukas;POKŠTUKAI;8708184278;Ne;0;3;0;3
5025;Nykštukas;POKŠTUKAI;5699671696;Ne;8;0;0;8
5026;Nykštukas;POKŠTUKAI;3843163586;Ne;0;5;0;5
5027;Nykštukas;POKŠTUKAI;3507649457;Taip;6;0;0;6
5028;Nykštukas;POKŠTUKAI;3428031037;Ne;5;1;0;6
5029;Nykštukas;POKŠTUKAI;4508625009;Ne;0;4;0;4
5030;Nykštukas;POKŠTUKAI;6698622575;Ne;5;0;0;5
5031;Nykštukas;POKŠTUKAI;2982662650;Ne;0;3;0;3
5032;Nykštukas;POKŠTUKAI;2627736026;Ne;0;12;0;12
5033;Nykštukas;POKŠTUKAI;4401103119;Taip;10;0;0;10
5034;Nykštukas;POKŠTUKAI;5287713634;Ne;0;2;0;2
5035;Nykštukas;POKŠTUKAI;9703895923;Ne;15;0;0;15
5036;Nykštukas;KODĖLČIUKAI;8168579152;Ne;7;0;0;7
5037;Nykštukas;KODĖLČIUKAI;9285820767;Ne;5;0;1;6
5038;Nykštukas;KODĖLČIUKAI;2685400939;Ne;14;0;0;14
5039;Nykštukas;KODĖLČIUKAI;3278960733;Ne;0;0;1;1
5040;Nykštukas;KODĖLČIUKAI;5934979528;Ne;16;0;0;16
5041;Nykštukas;KODĖLČIUKAI;3760617860;Ne;0;3;0;3
5042;Nykštukas;KODĖLČIUKAI;6927545099;Ne;0;2;0;2
5043;Nykštukas;KODĖLČIUKAI;8042479133;Ne;13;0;0;13
5044;Nykštukas;KODĖLČIUKAI;6345791450;Ne;0;0;5;5
5045;Nykštukas;KODĖLČIUKAI;6999380958;Ne;8;0;0;8
5046;Nykštukas;KODĖLČIUKAI;6794885966;Ne;2;0;0;2
5047;Nykštukas;KODĖLČIUKAI;7616459970;Ne;4;0;0;4
5048;Nykštukas;KODĖLČIUKAI;2623254163;Ne;5;1;0;6
5049;Nykštukas;KODĖLČIUKAI;9296449928;Ne;6;0;1;7
5050;Nykštukas;KODĖLČIUKAI;2992219360;Ne;20;0;0;20
5051;Nykštukas;KODĖLČIUKAI;4667303597;Ne;1;0;0;1
5052;Nykštukas;KODĖLČIUKAI;3552386621;Taip;14;0;0;14
5053;Nykštukas;KODĖLČIUKAI;3990260342;Ne;4;0;0;4
5054;Nykštukas;KODĖLČIUKAI;2692551262;Ne;0;6;0;6
5055;Nykštukas;KODĖLČIUKAI;6607025451;Ne;0;4;7;11
5056;Nykštukas;PASAKORIAI;2661110617;Ne;3;7;0;10
5057;Nykštukas;PASAKORIAI;3040001373;Ne;0;1;0;1
5058;Nykštukas;PASAKORIAI;1855278809;Ne;3;0;0;3
5059;Nykštukas;PASAKORIAI;8640715657;Ne;0;4;0;4
5060;Nykštukas;PASAKORIAI;5504584349;Ne;4;0;0;4
5061;Nykštukas;PASAKORIAI;7990462246;Ne;9;1;0;10
5062;Nykštukas;PASAKORIAI;1379378120;Ne;5;0;0;5
5063;Nykštukas;PASAKORIAI;9413198245;Ne;9;0;0;9
5064;Nykštukas;PASAKORIAI;7828733135;Ne;0;1;0;1
5065;Nykštukas;PASAKORIAI;4480184458;Ne;0;1;0;1
5066;Nykštukas;PASAKORIAI;4090494707;Ne;0;1;0;1
5067;Nykštukas;PASAKORIAI;3026598985;Ne;2;0;0;2
5068;Nykštukas;PASAKORIAI;9714310539;Ne;0;4;0;4
5069;Nykštukas;PASAKORIAI;4795301170;Ne;0;1;0;1
5070;Nykštukas;PASAKORIAI;1579064341;Ne;11;0;0;11
5071;Nykštukas;PASAKORIAI;4992654449;Ne;5;0;4;9
5072;Nykštukas;PASAKORIAI;5337728911;Ne;6;2;0;8
5073;Nykštukas;PASAKORIAI;3496434361;Ne;5;0;0;5
5074;Nykštukas;GUDRUČIAI;4559818614;Ne;0;1;0;1
5075;Nykštukas;GUDRUČIAI;9250827058;Taip;0;1;0;1
5076;Nykštukas;GUDRUČIAI;7447202642;Ne;0;4;0;4
5077;Nykštukas;GUDRUČIAI;1714708754;Ne;0;1;0;1
5078;Nykštukas;GUDRUČIAI;5157799354;Ne;7;0;0;7
5079;Nykštukas;GUDRUČIAI;4325369395;Ne;10;5;0;15
5080;Nykštukas;GUDRUČIAI;6630804505;Ne;0;2;0;2
5081;Nykštukas;GUDRUČIAI;7326535810;Ne;0;8;0;8
5082;Nykštukas;GUDRUČIAI;9941937734;Ne;4;0;0;4
5083;Nykštukas;GUDRUČIAI;3619459404;Ne;0;1;0;1
5084;Nykštukas;GUDRUČIAI;7604740418;Ne;3;1;0;4
5085;Nykštukas;GUDRUČIAI;2970293467;Ne;6;6;0;12
5086;Nykštukas;GUDRUČIAI;2881323571;Ne;5;1;0;6
5087;Nykštukas;GUDRUČIAI;9940519259;Ne;4;0;0;4
5088;Nykštukas;GUDRUČIAI;9023823445;Ne;2;0;0;2
5089;Nykštukas;GUDRUČIAI;8361758895;Ne;0;1;0;1
5090;Nykštukas;NAMINUKAI;2440574056;Ne;5;2;0;7
5091;Nykštukas;NAMINUKAI;9054070492;Ne;0;2;0;2
5092;Nykštukas;NAMINUKAI;6519078450;Ne;3;0;0;3
5093;Nykštukas;NAMINUKAI;5032283848;Taip;3;0;2;5
5094;Nykštukas;NAMINUKAI;7494444468;Ne;10;1;0;11
5095;Nykštukas;NAMINUKAI;3925958632;Ne;8;1;0;9
5096;Nykštukas;NAMINUKAI;6338717583;Ne;1;1;0;2
5097;Nykštukas;NAMINUKAI;7976689381;Ne;0;5;0;5
5098;Nykštukas;NAMINUKAI;9686815141;Ne;0;5;0;5
5099;Nykštukas;NAMINUKAI;9575291096;Ne;0;1;0;1
5100;Nykštukas;NAMINUKAI;4503830456;Ne;6;0;0;6
5101;Nykštukas;NAMINUKAI;4040123876;Ne;0;9;0;9
5102;Nykštukas;NAMINUKAI;1088633575;Ne;0;1;0;1
5103;Nykštukas;NAMINUKAI;8874850019;Ne;4;0;0;4
5104;Nykštukas;NAMINUKAI;1510338621;Ne;16;0;0;16
5105;Nykštukas;NAMINUKAI;3405633312;Taip;0;7;0;7
5106;Nykštukas;KŪLVERSTUKAI;7078264994;Ne;5;0;0;5
5107;Nykštukas;KŪLVERSTUKAI;3660330885;Ne;9;3;0;12
5108;Nykštukas;KŪLVERSTUKAI;4897443402;Ne;0;2;0;2
5109;Nykštukas;KŪLVERSTUKAI;6778384400;Ne;7;0;0;7
5110;Nykštukas;KŪLVERSTUKAI;6888025109;Ne;11;1;0;12
5111;Nykštukas;KŪLVERSTUKAI;8642152911;Taip;5;0;0;5
5112;Nykštukas;KŪLVERSTUKAI;6071938183;Taip;3;0;0;3
5113;Nykštukas;KŪLVERSTUKAI;7310647095;Ne;3;0;0;3
5114;Nykštukas;KŪLVERSTUKAI;5297046545;Ne;3;0;0;3
5115;Nykštukas;KŪLVERSTUKAI;8414521116;Ne;11;0;0;11
5116;Nykštukas;KŪLVERSTUKAI;1666098441;Ne;5;2;0;7
5117;Nykštukas;KŪLVERSTUKAI;9177683618;Ne;15;0;0;15
5118;Nykštukas;KŪLVERSTUKAI;1077620433;Ne;2;2;0;4
5119;Nykštukas;TREPSIUKAI;8701731017;Ne;2;0;1;3
5120;Nykštukas;TREPSIUKAI;2995258838;Ne;0;1;0;1
5121;Nykštukas;TREPSIUKAI;1355881784;Ne;4;0;0;4
5122;Nykštukas;TREPSIUKAI;1721306926;Ne;8;0;0;8
5123;Nykštukas;TREPSIUKAI;2974110726;Ne;10;0;0;10
5124;Nykštukas;TREPSIUKAI;7311244803;Ne;0;1;0;1
5125;Nykštukas;TREPSIUKAI;8194411836;Ne;1;0;0;1
5126;Nykštukas;TREPSIUKAI;5183022629;Ne;0;0;2;2
5127;Nykštukas;TREPSIUKAI;2759786932;Ne;4;0;0;4
5128;Nykštukas;ŽIRNIUKAI;9661862689;Ne;7;0;0;7
5129;Nykštukas;ŽIRNIUKAI;1594734231;Ne;3;0;0;3
5130;Nykštukas;ŽIRNIUKAI;3339707558;Taip;0;1;0;1
5131;Nykštukas;ŽIRNIUKAI;7908029688;Ne;0;5;0;5
5132;Nykštukas;ŽIRNIUKAI;7299329150;Ne;5;0;0;5
5133;Nykštukas;ŽIRNIUKAI;9174636607;Ne;5;0;0;5
5134;Nykštukas;ŽIRNIUKAI;1218443707;Taip;4;0;0;4
5135;Nykštukas;ŽIRNIUKAI;7535385367;Taip;5;0;0;5
5136;Nykštukas;ŽIRNIUKAI;6709760898;Taip;2;0;0;2
5137;Nykštukas;ŽIRNIUKAI;2800783215;Ne;11;0;0;11
5138;Nykštukas;ŽIRNIUKAI;2620150024;Taip;6;0;0;6
5139;Nykštukas;ŽIRNIUKAI;3032028847;Taip;13;0;0;13
5140;Nykštukas;ŽIRNIUKAI;4144437365;Ne;1;0;0;1
5141;Nykštukas;ŽIRNIUKAI;6884714823;Ne;5;1;0;6
5142;Nykštukas;ŽIRNIUKAI;1616644404;Ne;8;0;0;8
5143;Nykštukas;ŽIRNIUKAI;9270615518;Taip;3;0;0;3
5144;Nykštukas;ŽIRNIUKAI;2078586374;Ne;6;0;0;6
5145;Nykštukas;ŽIRNIUKAI;1102203704;Ne;1;0;0;1
5146;Ozas;Smalsučiai;4066900299;Ne;10;0;0;10
5147;Ozas;Smalsučiai;4694561135;Taip;7;0;0;7
5148;Ozas;Smalsučiai;4792735767;Ne;0;1;0;1
5149;Ozas;Smalsučiai;5651665799;Ne;0;0;1;1
5150;Ozas;Smalsučiai;7756424421;Ne;13;0;0;13
5151;Ozas;Smalsučiai;4334162942;Ne;7;1;0;8
5152;Ozas;Smalsučiai;1507372220;Ne;2;0;1;3
5153;Ozas;Smalsučiai;7884934528;Ne;18;0;0;18
5154;Ozas;Smalsučiai;7298628220;Ne;0;0;1;1
5155;Ozas;Smalsučiai;1112829748;Ne;8;0;0;8
5156;Ozas;Smalsučiai;1699412266;Ne;10;0;1;11
5157;Ozas;Smalsučiai;8833452950;Ne;4;0;0;4
5158;Ozas;Smalsučiai;2189280675;Ne;16;0;0;16
5159;Ozas;Smalsučiai;6922447926;Ne;9;0;0;9
5160;Ozas;Smalsučiai;8860029000;Ne;17;0;0;17
5161;Ozas;Smalsučiai;4022390983;Taip;10;0;0;10
5162;Ozas;Smalsučiai;7786745329;Ne;0;0;1;1
5163;Ozas;Smalsučiai;1398871402;Ne;0;0;1;1
5164;Ozas;Drugeliai;6419221599;Taip;7;0;0;7
5165;Ozas;Drugeliai;4673128698;Ne;2;0;0;2
5166;Ozas;Drugeliai;7870419810;Ne;11;0;0;11
5167;Ozas;Drugeliai;2869987587;Ne;5;3;0;8
5168;Ozas;Drugeliai;5926100815;Ne;8;1;0;9
5169;Ozas;Drugeliai;9178967858;Ne;15;0;0;15
5170;Ozas;Drugeliai;2454569369;Ne;0;0;4;4
5171;Ozas;Drugeliai;8713970306;Ne;2;0;0;2
5172;Ozas;Drugeliai;1803782282;Taip;15;0;0;15
5173;Ozas;Drugeliai;2819545359;Taip;13;0;0;13
5174;Ozas;Drugeliai;3994760698;Ne;6;0;0;6
5175;Ozas;Drugeliai;7922667688;Ne;10;1;0;11
5176;Ozas;Drugeliai;1536889312;Ne;9;0;0;9
5177;Ozas;Drugeliai;8897904793;Ne;10;0;0;10
5178;Ozas;Drugeliai;3723247420;Ne;13;0;0;13
5179;Ozas;Drugeliai;1489355274;Ne;5;1;0;6
5180;Ozas;Drugeliai;9655492678;Ne;9;0;1;10
5181;Ozas;Drugeliai;1062591107;Taip;10;0;1;11
5182;Ozas;Drugeliai;3967307153;Ne;13;0;0;13
5183;Ozas;Boružėlės;3037323341;Ne;8;0;0;8
5184;Ozas;Boružėlės;6346123124;Ne;13;0;1;14
5185;Ozas;Boružėlės;3133776891;Ne;2;0;1;3
5186;Ozas;Boružėlės;2139224651;Ne;5;0;0;5
5187;Ozas;Boružėlės;9506090620;Ne;0;1;0;1
5188;Ozas;Boružėlės;8923372952;Ne;3;0;0;3
5189;Ozas;Boružėlės;7617839839;Ne;10;7;0;17
5190;Ozas;Boružėlės;6392066805;Taip;5;0;0;5
5191;Ozas;Boružėlės;8781771299;Ne;5;0;0;5
5192;Ozas;Boružėlės;3817138493;Ne;5;1;0;6
5193;Ozas;Boružėlės;8371368881;Ne;7;0;0;7
5194;Ozas;Boružėlės;6476147361;Taip;3;0;0;3
5195;Ozas;Boružėlės;4994121247;Ne;10;1;0;11
5196;Ozas;Boružėlės;6315443248;Ne;6;4;0;10
5197;Ozas;Boružėlės;3139289643;Ne;0;5;0;5
5198;Ozas;Boružėlės;6186850614;Ne;10;0;0;10
5199;Ozas;Boružėlės;6318419889;Taip;10;0;0;10
5200;Ozas;Boružėlės;7787473586;Ne;11;0;0;11
5201;Ozas;Žiogeliai;7461521320;Ne;0;2;0;2
5202;Ozas;Žiogeliai;7402290524;Taip;4;0;2;6
5203;Ozas;Žiogeliai;5682027094;Ne;6;3;8;17
5204;Ozas;Žiogeliai;4966355020;Ne;0;1;0;1
5205;Ozas;Žiogeliai;9324647606;Taip;7;0;0;7
5206;Ozas;Žiogeliai;4942550213;Ne;6;0;2;8
5207;Ozas;Žiogeliai;5420952391;Ne;5;0;4;9
5208;Ozas;Žiogeliai;2837228320;Ne;0;2;0;2
5209;Ozas;Žiogeliai;2617258206;Ne;0;11;1;12
5210;Ozas;Žiogeliai;4030056504;Ne;0;1;0;1
5211;Ozas;Žiogeliai;3770045761;Ne;0;0;1;1
5212;Ozas;Žiogeliai;9768754737;Ne;0;0;1;1
5213;Ozas;Žiogeliai;7264789334;Ne;5;1;0;6
5214;Ozas;Žiogeliai;7165299220;Ne;9;1;0;10
5215;Ozas;Bitutės;4220780257;Ne;0;0;1;1
5216;Ozas;Bitutės;1161776624;Ne;0;0;1;1
5217;Ozas;Bitutės;4227555342;Taip;6;0;1;7
5218;Ozas;Bitutės;7499756171;Ne;14;0;0;14
5219;Ozas;Bitutės;4254601638;Ne;3;0;0;3
5220;Ozas;Bitutės;8304671844;Taip;2;0;0;2
5221;Ozas;Bitutės;9772085405;Ne;6;0;0;6
5222;Ozas;Bitutės;7051699003;Ne;12;0;0;12
5223;Ozas;Bitutės;5383877034;Ne;3;0;0;3
5224;Ozas;Bitutės;6811181735;Taip;6;2;0;8
5225;Ozas;Bitutės;8622621570;Ne;7;0;0;7
5226;Ozas;Bitutės;4260123123;Ne;11;0;0;11
5227;Ozas;Bitutės;1895519949;Ne;1;0;0;1
5228;Ozas;Bitutės;1475005204;Ne;0;2;0;2
5229;Ozas;Bitutės;4286058360;Ne;6;0;0;6
5230;Ozas;Aitvarėliai;1144679735;Ne;8;0;0;8
5231;Ozas;Aitvarėliai;2773182934;Ne;7;0;2;9
5232;Ozas;Aitvarėliai;4357737538;Ne;0;1;0;1
5233;Ozas;Aitvarėliai;5642468671;Ne;7;0;0;7
5234;Ozas;Aitvarėliai;1045890394;Ne;6;0;0;6
5235;Ozas;Aitvarėliai;7686706482;Ne;11;1;0;12
5236;Ozas;Aitvarėliai;2395567376;Ne;10;0;0;10
5237;Ozas;Aitvarėliai;4583818638;Ne;9;0;0;9
5238;Ozas;Aitvarėliai;1543683077;Ne;6;0;0;6
5239;Ozas;Aitvarėliai;2165291778;Ne;0;8;0;8
5240;Ozas;Aitvarėliai;8754244281;Ne;12;1;0;13
5241;Ozas;Aitvarėliai;6646671212;Ne;4;0;0;4
5242;Ozas;Aitvarėliai;9443843603;Ne;5;0;0;5
5243;Ozas;Aitvarėliai;3238019756;Ne;11;2;0;13
5244;Ozas;Aitvarėliai;8987796218;Ne;10;0;0;10
5245;Ozas;Aitvarėliai;3783477511;Ne;8;0;0;8
5246;Ozas;Aitvarėliai;6778987483;Ne;11;0;0;11
5247;Ozas;Aitvarėliai;7009893338;Taip;15;0;0;15
5248;Ozas;Aitvarėliai;4891451748;Ne;11;1;0;12
5249;Ozas;Aitvarėliai;9813020279;Ne;3;0;0;3
5250;Ozas;Aitvarėliai;2922370952;Ne;0;7;1;8
5251;Ozas;Aitvarėliai;2544858937;Ne;11;0;0;11
5252;Ozas;Voveraitės;8178298861;Ne;0;1;0;1
5253;Ozas;Voveraitės;6263062055;Ne;5;1;0;6
5254;Ozas;Voveraitės;9195536968;Ne;2;2;0;4
5255;Ozas;Voveraitės;2991511872;Ne;5;2;0;7
5256;Ozas;Voveraitės;2511477658;Ne;0;2;1;3
5257;Ozas;Voveraitės;1240233169;Ne;9;0;1;10
5258;Ozas;Voveraitės;6088757991;Ne;0;1;0;1
5259;Ozas;Voveraitės;6499549095;Ne;0;2;0;2
5260;Ozas;Voveraitės;6666591428;Ne;7;1;0;8
5261;Ozas;Voveraitės;2297650260;Ne;10;0;0;10
5262;Ozas;Voveraitės;9762737217;Ne;0;1;0;1
5263;Ozas;Voveraitės;7421484648;Ne;20;0;0;20
5264;Ozas;Voveraitės;5751808248;Taip;9;0;0;9
5265;Ozas;Voveraitės;4556076744;Ne;6;0;3;9
5266;Ozas;Kodelčiukai;8743467101;Ne;2;6;0;8
5267;Ozas;Kodelčiukai;2964318343;Ne;3;0;0;3
5268;Ozas;Kodelčiukai;8696127374;Ne;2;1;0;3
5269;Ozas;Kodelčiukai;3704303636;Ne;4;2;0;6
5270;Ozas;Kodelčiukai;2573702751;Ne;0;1;0;1
5271;Ozas;Kodelčiukai;3412369198;Ne;11;1;0;12
5272;Ozas;Kodelčiukai;7305274617;Ne;5;0;0;5
5273;Ozas;Kodelčiukai;9306887706;Ne;5;2;0;7
5274;Ozas;Kodelčiukai;1348751454;Ne;14;0;1;15
5275;Ozas;Kodelčiukai;9322080266;Ne;9;0;0;9
5276;Ozas;Kodelčiukai;6809992664;Taip;5;2;0;7
5277;Ozas;Kodelčiukai;4516291572;Taip;0;2;0;2
5278;Ozas;Kodelčiukai;4287719751;Ne;0;5;0;5
5279;Ozas;Kodelčiukai;9620747099;Ne;3;0;0;3
5280;Ozas;Kodelčiukai;5216695220;Ne;5;0;0;5
5281;Ozas;Kodelčiukai;6783755555;Taip;0;1;0;1
5282;Ozas;Kodelčiukai;8222112564;Ne;5;3;0;8
5283;Ozas;Kodelčiukai;8797919230;Ne;4;2;0;6
5284;Ozas;Kodelčiukai;4573329075;Ne;7;0;0;7
5285;Ozas;Pelėdžiukai;9277208213;Ne;4;0;0;4
5286;Ozas;Pelėdžiukai;8040293681;Ne;5;0;1;6
5287;Ozas;Pelėdžiukai;1856258542;Ne;5;0;1;6
5288;Ozas;Pelėdžiukai;7640409923;Ne;1;0;0;1
5289;Ozas;Pelėdžiukai;4601869799;Ne;5;0;0;5
5290;Ozas;Pelėdžiukai;5958055645;Ne;5;0;2;7
5291;Ozas;Pelėdžiukai;7125754645;Ne;6;0;0;6
5292;Ozas;Pelėdžiukai;2824133388;Ne;10;0;0;10
5293;Ozas;Pelėdžiukai;2637531106;Taip;3;0;0;3
5294;Ozas;Pelėdžiukai;7287989663;Ne;5;0;0;5
5295;Ozas;Pelėdžiukai;6819000895;Ne;5;0;0;5
5296;Ozas;Pelėdžiukai;5950860889;Ne;11;0;0;11
5297;Ozas;Pelėdžiukai;4886045470;Ne;5;0;0;5
5298;Ozas;Pelėdžiukai;3212050416;Ne;0;1;0;1
5299;Ozas;Pelėdžiukai;3725141591;Ne;5;0;0;5
5300;Ozas;Pelėdžiukai;3711403511;Ne;4;0;1;5
5301;Ozas;Pelėdžiukai;5392929222;Ne;20;0;0;20
5302;Ozas;Pelėdžiukai;7038928164;Taip;5;0;0;5
5303;Ozas;Pelėdžiukai;2281337233;Taip;2;0;0;2
5304;Ozas;Pelėdžiukai;4247941696;Ne;0;1;0;1
5305;Ozas;Pelėdžiukai;9334268998;Ne;14;0;0;14
5306;Ozas;"Kačiukai ";7776754188;Ne;14;0;0;14
5307;Ozas;"Kačiukai ";5097380041;Taip;14;0;1;15
5308;Ozas;"Kačiukai ";3109261153;Ne;6;0;0;6
5309;Ozas;"Kačiukai ";9781398468;Taip;9;0;0;9
5310;Ozas;"Kačiukai ";5421245991;Ne;4;0;0;4
5311;Ozas;"Kačiukai ";9781527964;Ne;14;4;0;18
5312;Ozas;"Kačiukai ";4514798132;Ne;15;0;2;17
5313;Ozas;"Kačiukai ";2729524188;Ne;6;0;0;6
5314;Ozas;"Kačiukai ";5866709636;Ne;5;7;0;12
5315;Ozas;"Kačiukai ";6632795981;Ne;3;0;0;3
5316;Ozas;"Kačiukai ";2599175140;Ne;1;1;0;2
5317;Ozas;"Kačiukai ";2030429825;Taip;10;0;0;10
5318;Ozas;"Kačiukai ";7885855133;Ne;8;0;0;8
5319;Ozas;"Kačiukai ";5761120671;Ne;7;0;0;7
5320;Ozas;Ančiukų;3472468379;Ne;9;0;0;9
5321;Ozas;Ančiukų;6512655578;Ne;14;0;0;14
5322;Ozas;Ančiukų;1092988354;Ne;8;0;0;8
5323;Ozas;Ančiukų;5811261087;Ne;11;0;0;11
5324;Ozas;Ančiukų;4424628807;Ne;4;0;0;4
5325;Ozas;Ančiukų;6894358457;Ne;16;0;0;16
5326;Ozas;Ančiukų;1671756798;Ne;11;0;0;11
5327;Ozas;Ančiukų;5163358861;Ne;1;0;0;1
5328;Ozas;Ančiukų;6653963888;Ne;8;0;0;8
5329;Ozas;Ančiukų;7611417346;Ne;13;0;0;13
5330;Ozas;Ančiukų;6305438823;Ne;7;0;0;7
5331;Ozas;Ančiukų;4941588023;Ne;6;0;0;6
5332;Ozas;Ančiukų;8772165816;Ne;7;0;0;7
5333;Ozas;Ančiukų;4910534724;Ne;5;0;0;5
5334;Ozas;Nykškukų;9319720476;Ne;10;0;0;10
5335;Ozas;Nykškukų;3540922740;Ne;8;0;0;8
5336;Ozas;Nykškukų;2794839285;Ne;5;0;1;6
5337;Ozas;Nykškukų;2326431805;Ne;7;2;0;9
5338;Ozas;Nykškukų;2334870680;Ne;10;0;0;10
5339;Ozas;Nykškukų;7005571081;Ne;10;0;0;10
5340;Ozas;Nykškukų;5126356120;Ne;11;1;0;12
5341;Ozas;Nykškukų;2490578190;Ne;9;2;0;11
5342;Ozas;Nykškukų;3310335918;Ne;5;0;0;5
5343;Ozas;Nykškukų;7789232957;Ne;10;0;0;10
5344;Ozas;Nykškukų;2531635671;Ne;1;1;0;2
5345;Ozas;Nykškukų;7556190089;Taip;3;0;0;3
5346;Ozas;Nykškukų;9685593404;Ne;15;0;0;15
5347;Ozas;Nykškukų;5008732127;Ne;7;0;0;7
5348;Pabiručiai;Voveriukų;4539246865;Ne;0;2;0;2
5349;Pabiručiai;Voveriukų;9564303781;Ne;13;0;0;13
5350;Pabiručiai;Voveriukų;4312364951;Ne;8;2;0;10
5351;Pabiručiai;Voveriukų;3756731363;Ne;0;0;5;5
5352;Pabiručiai;Voveriukų;7985360502;Ne;0;0;1;1
5353;Pabiručiai;Voveriukų;3936426174;Ne;0;0;1;1
5354;Pabiručiai;Voveriukų;4069564285;Ne;0;1;0;1
5355;Pabiručiai;Voveriukų;7278334800;Ne;0;1;0;1
5356;Pabiručiai;Voveriukų;9468698553;Ne;0;0;1;1
5357;Pabiručiai;Voveriukų;5549851164;Ne;5;0;0;5
5358;Pabiručiai;Voveriukų;4040533883;Ne;0;2;0;2
5359;Pabiručiai;Voveriukų;2514312233;Ne;0;6;0;6
5360;Pabiručiai;Voveriukų;7606274875;Ne;0;6;0;6
5361;Pabiručiai;Voveriukų;9356327400;Ne;0;1;0;1
5362;Pabiručiai;Voveriukų;4813206044;Ne;8;4;0;12
5363;Pabiručiai;Boružiukų;1673473814;Taip;7;0;0;7
5364;Pabiručiai;Boružiukų;5686769648;Taip;8;2;1;11
5365;Pabiručiai;Boružiukų;7524993271;Taip;0;2;3;5
5366;Pabiručiai;Boružiukų;5708597471;Ne;1;2;0;3
5367;Pabiručiai;Boružiukų;4006783343;Ne;0;1;0;1
5368;Pabiručiai;Boružiukų;8175565139;Ne;0;2;0;2
5369;Pabiručiai;Boružiukų;8236964683;Ne;0;1;0;1
5370;Pabiručiai;Boružiukų;1240057541;Ne;0;9;0;9
5371;Pabiručiai;Boružiukų;1671027282;Ne;1;3;0;4
5372;Pabiručiai;Boružiukų;3759350345;Ne;0;3;0;3
5373;Pabiručiai;Boružiukų;3151360288;Ne;0;2;0;2
5374;Pabiručiai;Boružiukų;9299393363;Ne;0;3;0;3
5375;Pabiručiai;Boružiukų;1484291546;Ne;0;1;0;1
5376;Pabiručiai;Boružiukų;2771769336;Ne;0;3;0;3
5377;Pabiručiai;Boružiukų;4681771534;Ne;4;0;0;4
5378;Pabiručiai;Boružiukų;7050339198;Ne;4;1;0;5
5379;Pabiručiai;Boružiukų;4798503931;Ne;7;0;2;9
5380;Pabiručiai;Katinėlių;8649685325;Ne;9;0;1;10
5381;Pabiručiai;Katinėlių;5737214746;Ne;0;0;1;1
5382;Pabiručiai;Katinėlių;4929129093;Ne;0;14;0;14
5383;Pabiručiai;Katinėlių;2141365015;Ne;13;0;0;13
5384;Pabiručiai;Katinėlių;1099080685;Ne;10;8;0;18
5385;Pabiručiai;Katinėlių;3011601512;Taip;11;0;0;11
5386;Pabiručiai;Katinėlių;4852287574;Ne;6;0;0;6
5387;Pabiručiai;Katinėlių;3826505104;Taip;0;0;1;1
5388;Pabiručiai;Katinėlių;6678717039;Taip;8;0;0;8
5389;Pabiručiai;Katinėlių;7798837336;Ne;15;0;0;15
5390;Pabiručiai;Katinėlių;7339565412;Taip;0;1;1;2
5391;Pabiručiai;Katinėlių;6742744014;Ne;0;2;0;2
5392;Pabiručiai;Katinėlių;1206012259;Ne;0;1;0;1
5393;Pabiručiai;Katinėlių;9790360371;Ne;0;1;0;1
5394;Pabiručiai;Katinėlių;9890225918;Ne;6;2;0;8
5395;Pabiručiai;Katinėlių;7980170279;Ne;0;0;2;2
5396;Pabiručiai;Katinėlių;5923385276;Ne;5;0;1;6
5397;Pabiručiai;Katinėlių;1138743823;Ne;0;15;0;15
5398;Pabiručiai;Katinėlių;1652633130;Ne;0;0;1;1
5399;Pabiručiai;Katinėlių;9813153308;Ne;10;0;1;11
5400;Pabiručiai;Katinėlių;6508093808;Ne;3;1;1;5
5401;Pabiručiai;Žiogelių;3531292373;Ne;0;10;0;10
5402;Pabiručiai;Žiogelių;1247522345;Ne;5;0;0;5
5403;Pabiručiai;Žiogelių;9878655387;Ne;5;0;0;5
5404;Pabiručiai;Žiogelių;8092886420;Ne;8;1;0;9
5405;Pabiručiai;Žiogelių;4012537474;Ne;6;0;0;6
5406;Pabiručiai;Žiogelių;7561916887;Ne;2;0;0;2
5407;Pabiručiai;Žiogelių;9651695086;Ne;7;6;0;13
5408;Pabiručiai;Žiogelių;5050966784;Ne;1;0;0;1
5409;Pabiručiai;Žiogelių;4096412988;Ne;6;0;0;6
5410;Pabiručiai;Žiogelių;4876140467;Ne;5;0;0;5
5411;Pabiručiai;Žiogelių;5862643827;Ne;12;0;0;12
5412;Pabiručiai;Žiogelių;6014791534;Ne;1;0;0;1
5413;Pabiručiai;Žiogelių;5704073222;Ne;11;0;0;11
5414;Pabiručiai;Žiogelių;5019580409;Taip;7;0;0;7
5415;Pabiručiai;Žiogelių;8870657682;Ne;10;0;0;10
5416;Pabiručiai;Žiogelių;2924005478;Ne;8;0;0;8
5417;Pabiručiai;Žiogelių;6513943228;Ne;1;0;0;1
5418;Pabiručiai;Žiogelių;5184688482;Ne;1;0;0;1
5419;Pabiručiai;Žiogelių;7873575929;Ne;13;0;0;13
5420;Pabiručiai;Smalsiukai;2869383175;Ne;3;0;0;3
5421;Pabiručiai;Smalsiukai;9676561758;Taip;0;5;0;5
5422;Pabiručiai;Smalsiukai;7090116276;Ne;0;0;2;2
5423;Pabiručiai;Smalsiukai;9093137227;Ne;0;0;1;1
5424;Pabiručiai;Smalsiukai;6935913132;Ne;0;6;0;6
5425;Pabiručiai;Smalsiukai;1344711015;Ne;0;4;0;4
5426;Pabiručiai;Smalsiukai;7663581089;Ne;2;0;0;2
5427;Pabiručiai;Smalsiukai;7248314871;Ne;9;0;0;9
5428;Pabiručiai;Smalsiukai;9610623364;Ne;0;3;0;3
5429;Pabiručiai;Smalsiukai;8897462614;Ne;4;0;0;4
5430;Pabiručiai;Smalsiukai;2332338995;Ne;7;0;1;8
5431;Pabiručiai;Smalsiukai;4258226042;Ne;0;1;0;1
5432;Pabiručiai;Smalsiukai;3511851810;Ne;8;0;0;8
5433;Pabiručiai;Smalsiukai;6686039601;Ne;15;0;1;16
5434;Pabiručiai;Smalsiukai;5420231066;Ne;0;1;0;1
5435;Pabiručiai;Smalsiukai;8840885039;Ne;2;0;2;4
5436;Pabiručiai;Smalsiukai;9779260044;Ne;9;0;0;9
5437;Pabiručiai;Smalsiukai;2771891999;Ne;7;0;3;10
5438;Pabiručiai;Smalsiukai;6834663627;Ne;11;4;0;15
5439;Pabiručiai;Kiškučiai;9589005897;Ne;4;0;0;4
5440;Pabiručiai;Kiškučiai;9353062804;Ne;0;1;0;1
5441;Pabiručiai;Kiškučiai;1582754284;Ne;20;0;0;20
5442;Pabiručiai;Kiškučiai;4462744848;Ne;12;3;0;15
5443;Pabiručiai;Kiškučiai;5621183663;Ne;0;6;0;6
5444;Pabiručiai;Kiškučiai;5497318373;Ne;0;1;0;1
5445;Pabiručiai;Kiškučiai;9417138573;Ne;3;3;0;6
5446;Pabiručiai;Kiškučiai;1515270273;Ne;0;4;0;4
5447;Pabiručiai;Kiškučiai;2688728915;Ne;10;4;0;14
5448;Pabiručiai;Kiškučiai;5166525832;Ne;0;2;0;2
5449;Pabiručiai;Kiškučiai;8409455566;Ne;0;6;0;6
5450;Pabiručiai;Kiškučiai;1028312285;Ne;2;0;0;2
5451;Pabiručiai;Kiškučiai;5717534175;Ne;0;1;0;1
5452;Pabiručiai;Kiškučiai;3408518493;Ne;0;4;0;4
5453;Pabiručiai;Kiškučiai;7653129291;Ne;16;0;0;16
5454;Pabiručiai;Kiškučiai;7073230645;Taip;7;1;0;8
5455;Pabiručiai;Kiškučiai;8820585407;Ne;0;1;0;1
5456;Pabiručiai;Kiškučiai;7572077461;Ne;0;3;0;3
5457;Pabiručiai;Kiškučiai;6073797962;Ne;5;0;0;5
5458;Pabiručiai;"Pėledžiukai ";9834824219;Taip;0;5;0;5
5459;Pabiručiai;"Pėledžiukai ";1683369842;Ne;0;0;1;1
5460;Pabiručiai;"Pėledžiukai ";7961879916;Ne;0;6;0;6
5461;Pabiručiai;"Pėledžiukai ";9050994322;Ne;3;0;0;3
5462;Pabiručiai;"Pėledžiukai ";6697518151;Ne;0;2;0;2
5463;Pabiručiai;"Pėledžiukai ";2596301235;Ne;5;2;1;8
5464;Pabiručiai;"Pėledžiukai ";4333645528;Ne;0;3;0;3
5465;Pabiručiai;"Pėledžiukai ";6289025538;Ne;2;7;0;9
5466;Pabiručiai;"Pėledžiukai ";2343561322;Ne;0;1;0;1
5467;Pabiručiai;"Pėledžiukai ";3674583662;Ne;1;1;0;2
5468;Pabiručiai;"Pėledžiukai ";8268101318;Ne;9;8;0;17
5469;Pabiručiai;"Pėledžiukai ";2147165934;Ne;3;1;0;4
5470;Pabiručiai;"Pėledžiukai ";7385149524;Ne;0;4;0;4
5471;Pabiručiai;"Pėledžiukai ";7203091216;Ne;0;0;9;9
5472;Pabiručiai;"Pėledžiukai ";3224195892;Taip;1;2;0;3
5473;Pabiručiai;"Pėledžiukai ";1852744763;Ne;1;0;3;4
5474;Pabiručiai;"Pėledžiukai ";5899880680;Ne;2;0;0;2
5475;Pabiručiai;"Pėledžiukai ";1971996148;Ne;1;2;0;3
5476;Pabiručiai;"Kodelčiūkai ";8775727677;Ne;0;3;0;3
5477;Pabiručiai;"Kodelčiūkai ";2295503584;Ne;0;10;0;10
5478;Pabiručiai;"Kodelčiūkai ";4595458527;Ne;2;0;0;2
5479;Pabiručiai;"Kodelčiūkai ";8716879106;Ne;4;2;0;6
5480;Pabiručiai;"Kodelčiūkai ";9067653417;Ne;6;0;0;6
5481;Pabiručiai;"Kodelčiūkai ";5247780866;Ne;5;0;0;5
5482;Pabiručiai;"Kodelčiūkai ";3433419710;Ne;16;0;0;16
5483;Pabiručiai;"Kodelčiūkai ";6386335808;Taip;12;0;0;12
5484;Pabiručiai;"Kodelčiūkai ";5010271037;Ne;0;1;0;1
5485;Pabiručiai;"Kodelčiūkai ";9538339883;Ne;1;0;0;1
5486;Pabiručiai;"Kodelčiūkai ";8149732126;Ne;3;0;0;3
5487;Pabiručiai;"Kodelčiūkai ";7289131864;Ne;7;0;0;7
5488;Pabiručiai;"Kodelčiūkai ";6209553290;Ne;1;0;0;1
5489;Pabiručiai;"Kodelčiūkai ";3497466298;Ne;3;5;0;8
5490;Pabiručiai;"Kodelčiūkai ";8179285338;Ne;0;5;0;5
5491;Pabiručiai;"Kodelčiūkai ";1234230729;Ne;15;0;0;15
5492;Pabiručiai;"Kodelčiūkai ";2519371211;Ne;10;0;0;10
5493;Pabiručiai;"Kodelčiūkai ";5211115955;Taip;4;0;0;4
5494;Pabiručiai;"Kodelčiūkai ";2433997383;Ne;8;0;0;8
5495;Pabiručiai;"Peliukų ";3702521810;Ne;0;6;0;6
5496;Pabiručiai;"Peliukų ";4894380231;Ne;1;0;0;1
5497;Pabiručiai;"Peliukų ";1947729077;Ne;5;0;0;5
5498;Pabiručiai;"Peliukų ";1776325000;Ne;6;0;0;6
5499;Pabiručiai;"Peliukų ";5990497129;Ne;0;4;0;4
5500;Pabiručiai;"Peliukų ";7644854044;Ne;0;1;0;1
5501;Pabiručiai;"Peliukų ";9806520732;Taip;6;0;0;6
5502;Pabiručiai;"Peliukų ";2765716248;Ne;1;0;0;1
5503;Pabiručiai;"Peliukų ";8551913254;Ne;15;0;0;15
5504;Pabiručiai;"Peliukų ";1638037202;Taip;2;0;0;2
5505;Pabiručiai;"Peliukų ";6603404126;Ne;2;0;0;2
5506;Pabiručiai;"Peliukų ";1414752034;Ne;0;1;0;1
5507;Pabiručiai;"Peliukų ";2860703696;Ne;0;6;0;6
5508;Pabiručiai;"Peliukų ";3128998397;Ne;1;0;0;1
5509;Pabiručiai;"Peliukų ";1707526401;Ne;7;0;0;7
5510;Pabiručiai;"Peliukų ";5980457097;Taip;20;0;0;20
5511;Pabiručiai;"Viščiukų ";8048012241;Ne;13;0;0;13
5512;Pabiručiai;"Viščiukų ";2757879842;Ne;7;0;0;7
5513;Pabiručiai;"Viščiukų ";7101741906;Ne;11;0;0;11
5514;Pabiručiai;"Viščiukų ";3372218487;Ne;15;0;0;15
5515;Pabiručiai;"Viščiukų ";6044682613;Ne;2;0;0;2
5516;Pabiručiai;"Viščiukų ";7537470611;Ne;6;2;0;8
5517;Pabiručiai;"Viščiukų ";6581286069;Ne;17;0;0;17
5518;Pabiručiai;"Viščiukų ";3400423825;Ne;5;0;2;7
5519;Pabiručiai;"Viščiukų ";2116533837;Ne;5;0;0;5
5520;Pabiručiai;"Viščiukų ";4078487035;Ne;0;0;2;2
5521;Pabiručiai;"Viščiukų ";7183696280;Ne;0;1;0;1
5522;Pabiručiai;"Viščiukų ";6547174468;Ne;4;0;0;4
5523;Pabiručiai;"Viščiukų ";4554910957;Ne;10;0;0;10
5524;Pabiručiai;"Viščiukų ";8571325340;Ne;3;3;0;6
5525;Pabiručiai;"Drugelių ";9890868992;Ne;9;0;0;9
5526;Pabiručiai;"Drugelių ";2556330147;Ne;7;8;0;15
5527;Pabiručiai;"Drugelių ";3004152898;Ne;5;5;0;10
5528;Pabiručiai;"Drugelių ";6481162347;Ne;4;0;0;4
5529;Pabiručiai;"Drugelių ";4701982784;Ne;1;0;0;1
5530;Pabiručiai;"Drugelių ";5147367745;Ne;5;0;0;5
5531;Pabiručiai;"Drugelių ";6612530931;Ne;6;0;0;6
5532;Pabiručiai;"Drugelių ";3189763918;Ne;2;5;0;7
5533;Pabiručiai;"Drugelių ";8268444485;Ne;12;7;0;19
5534;Pabiručiai;"Drugelių ";8066935182;Ne;9;0;0;9
5535;Pabiručiai;"Drugelių ";8822799881;Ne;1;7;0;8
5536;Pabiručiai;"Drugelių ";6831781849;Ne;4;0;0;4
5537;Pabiručiai;"Drugelių ";9297511341;Ne;4;0;0;4
5538;Pabiručiai;"Drugelių ";3486322043;Ne;4;0;0;4
5539;Pabiručiai;ŽIRNIUKŲ;9507212682;Ne;4;0;0;4
5540;Pabiručiai;ŽIRNIUKŲ;3239143202;Ne;20;0;0;20
5541;Pabiručiai;ŽIRNIUKŲ;8756826405;Ne;6;1;0;7
5542;Pabiručiai;ŽIRNIUKŲ;6059282085;Ne;1;0;0;1
5543;Pabiručiai;ŽIRNIUKŲ;4600476221;Taip;14;0;0;14
5544;Pabiručiai;ŽIRNIUKŲ;9042431134;Ne;4;0;0;4
5545;Pabiručiai;ŽIRNIUKŲ;1537534207;Ne;3;0;0;3
5546;Pabiručiai;ŽIRNIUKŲ;2142523078;Ne;0;3;0;3
5547;Pabiručiai;ŽIRNIUKŲ;3370660254;Taip;17;0;0;17
5548;Pabiručiai;ŽIRNIUKŲ;4229089612;Ne;9;0;0;9
5549;Pabiručiai;ŽIRNIUKŲ;8834001928;Ne;11;1;0;12
5550;Pabiručiai;ŽIRNIUKŲ;9185016818;Ne;15;0;0;15
5551;Pabiručiai;ŽIRNIUKŲ;2141466782;Ne;17;0;0;17
5552;Pabiručiai;ŽIRNIUKŲ;9748002526;Ne;3;0;0;3
5553;Pabiručiai;ŽIRNIUKŲ;5436055219;Ne;2;0;0;2
5554;Pabiručiai;ŽIRNIUKŲ;6601800828;Ne;6;0;0;6
5555;Pabiručiai;ŽIRNIUKŲ;8074555646;Ne;15;0;0;15
5556;Pagrandukas;Saulytės;6915087488;Ne;0;1;0;1
5557;Pagrandukas;Saulytės;6349387692;Ne;8;1;0;9
5558;Pagrandukas;Saulytės;8186092469;Ne;0;5;0;5
5559;Pagrandukas;Saulytės;2934300533;Ne;0;7;0;7
5560;Pagrandukas;Saulytės;1548697124;Taip;2;5;0;7
5561;Pagrandukas;Saulytės;7146697128;Taip;0;7;0;7
5562;Pagrandukas;Saulytės;7511097160;Ne;0;8;0;8
5563;Pagrandukas;Saulytės;7454863899;Ne;4;0;0;4
5564;Pagrandukas;Saulytės;5560372136;Ne;0;4;0;4
5565;Pagrandukas;Saulytės;1766912463;Taip;0;2;0;2
5566;Pagrandukas;Saulytės;9849054467;Ne;1;1;0;2
5567;Pagrandukas;Saulytės;8024910647;Ne;2;0;0;2
5568;Pagrandukas;Saulytės;8481502330;Ne;3;0;0;3
5569;Pagrandukas;Saulytės;7160305478;Ne;5;1;0;6
5570;Pagrandukas;Saulytės;6388805960;Ne;5;3;0;8
5571;Pagrandukas;Saulytės;8836178193;Ne;5;3;0;8
5572;Pagrandukas;Saulytės;7157549179;Ne;0;1;0;1
5573;Pagrandukas;Saulytės;3494047045;Ne;0;3;0;3
5574;Pagrandukas;Zuikučiai;7834436515;Ne;0;2;0;2
5575;Pagrandukas;Zuikučiai;7435609306;Ne;7;0;1;8
5576;Pagrandukas;Zuikučiai;5903416384;Ne;7;0;0;7
5577;Pagrandukas;Zuikučiai;2439891231;Ne;0;0;6;6
5578;Pagrandukas;Zuikučiai;6710887776;Ne;0;0;6;6
5579;Pagrandukas;Zuikučiai;7665811353;Ne;3;0;0;3
5580;Pagrandukas;Zuikučiai;2212787835;Ne;7;2;0;9
5581;Pagrandukas;Zuikučiai;2711590019;Ne;0;0;2;2
5582;Pagrandukas;Zuikučiai;6449029299;Ne;4;0;2;6
5583;Pagrandukas;Zuikučiai;1405820070;Ne;7;0;0;7
5584;Pagrandukas;Zuikučiai;1054107640;Ne;5;2;0;7
5585;Pagrandukas;Zuikučiai;1885539883;Ne;0;5;0;5
5586;Pagrandukas;Zuikučiai;1795582354;Ne;9;0;0;9
5587;Pagrandukas;Zuikučiai;2822538227;Ne;4;0;1;5
5588;Pagrandukas;Zuikučiai;1587839122;Ne;11;0;0;11
5589;Pagrandukas;Zuikučiai;2101505576;Ne;4;3;1;8
5590;Pagrandukas;Zuikučiai;6765346578;Ne;15;0;0;15
5591;Pagrandukas;Zuikučiai;5922595170;Ne;0;0;1;1
5592;Pagrandukas;Zuikučiai;5030928303;Ne;0;5;0;5
5593;Pagrandukas;Zuikučiai;9139212151;Ne;0;5;3;8
5594;Pagrandukas;Zuikučiai;8643993939;Taip;5;4;0;9
5595;Pagrandukas;Zuikučiai;5021106231;Ne;0;1;0;1
5596;Pagrandukas;Boružėlių;5330598431;Ne;6;0;0;6
5597;Pagrandukas;Boružėlių;3643271023;Ne;10;0;0;10
5598;Pagrandukas;Boružėlių;7897742424;Ne;11;0;0;11
5599;Pagrandukas;Boružėlių;3313757952;Ne;1;0;0;1
5600;Pagrandukas;Boružėlių;4013188468;Ne;6;10;0;16
5601;Pagrandukas;Boružėlių;8812047984;Ne;13;0;0;13
5602;Pagrandukas;Boružėlių;2893099852;Ne;10;2;0;12
5603;Pagrandukas;Boružėlių;7219415600;Ne;5;0;0;5
5604;Pagrandukas;Boružėlių;1552515788;Ne;0;2;0;2
5605;Pagrandukas;Boružėlių;6506518248;Ne;0;15;0;15
5606;Pagrandukas;Boružėlių;4730178155;Ne;16;0;0;16
5607;Pagrandukas;Boružėlių;8869609106;Ne;15;0;1;16
5608;Pagrandukas;Boružėlių;2752197975;Ne;6;1;0;7
5609;Pagrandukas;Boružėlių;9390682686;Ne;5;0;0;5
5610;Pagrandukas;Bitutės;9188382746;Ne;12;0;0;12
5611;Pagrandukas;Bitutės;1583104760;Ne;5;0;0;5
5612;Pagrandukas;Bitutės;5649084353;Ne;9;0;0;9
5613;Pagrandukas;Bitutės;5821945401;Ne;3;0;2;5
5614;Pagrandukas;Bitutės;7675694987;Ne;5;0;0;5
5615;Pagrandukas;Bitutės;3709131197;Ne;3;1;0;4
5616;Pagrandukas;Bitutės;2764732768;Ne;7;0;0;7
5617;Pagrandukas;Bitutės;9987717045;Ne;10;2;1;13
5618;Pagrandukas;Bitutės;4771506131;Ne;6;0;2;8
5619;Pagrandukas;Bitutės;9798727946;Ne;6;0;0;6
5620;Pagrandukas;Bitutės;5464426019;Ne;1;0;0;1
5621;Pagrandukas;Bitutės;6845210200;Ne;0;3;0;3
5622;Pagrandukas;Bitutės;6090721838;Ne;5;0;1;6
5623;Pagrandukas;Bitutės;6129335910;Ne;8;0;0;8
5624;Pagrandukas;Bitutės;1780452241;Ne;1;1;1;3
5625;Pagrandukas;Bitutės;3795172018;Taip;0;5;0;5
5626;Pagrandukas;Bitutės;5604315555;Ne;0;1;0;1
5627;Pagrandukas;Bitutės;7784155503;Ne;0;1;0;1
5628;Pagrandukas;Bitutės;7605508460;Ne;0;7;0;7
5629;Pagrandukas;Bitutės;5511396314;Ne;0;9;0;9
5630;Pagrandukas;Bitutės;2481532396;Ne;9;1;0;10
5631;Pagrandukas;Pelėdžiukai;1714449109;Ne;11;0;0;11
5632;Pagrandukas;Pelėdžiukai;2877401332;Ne;10;0;0;10
5633;Pagrandukas;Pelėdžiukai;8167118045;Ne;6;0;0;6
5634;Pagrandukas;Pelėdžiukai;3390664086;Ne;0;8;0;8
5635;Pagrandukas;Pelėdžiukai;1733723373;Ne;0;1;0;1
5636;Pagrandukas;Pelėdžiukai;1077792535;Ne;10;0;0;10
5637;Pagrandukas;Pelėdžiukai;9583471280;Ne;10;0;0;10
5638;Pagrandukas;Pelėdžiukai;4398016119;Ne;4;1;0;5
5639;Pagrandukas;Pelėdžiukai;2640777376;Ne;17;0;0;17
5640;Pagrandukas;Pelėdžiukai;4910151924;Ne;3;2;0;5
5641;Pagrandukas;Pelėdžiukai;9431513632;Ne;0;4;0;4
5642;Pagrandukas;Pelėdžiukai;1977974235;Ne;13;0;0;13
5643;Pagrandukas;Pelėdžiukai;7238694532;Ne;2;1;0;3
5644;Pagrandukas;Pelėdžiukai;4014238120;Ne;12;0;0;12
5645;Pagrandukas;Pelėdžiukai;8789320226;Ne;6;0;0;6
5646;Pagrandukas;Pelėdžiukai;1308066299;Ne;6;0;0;6
5647;Pagrandukas;Pelėdžiukai;3569618725;Ne;10;0;0;10
5648;Pagrandukas;Pelėdžiukai;7498372078;Ne;6;0;0;6
5649;Pagrandukas;ŠYPSENĖLIŲ;4627387596;Ne;10;0;0;10
5650;Pagrandukas;ŠYPSENĖLIŲ;7173561328;Ne;5;1;0;6
5651;Pagrandukas;ŠYPSENĖLIŲ;1101989969;Ne;1;0;0;1
5652;Pagrandukas;ŠYPSENĖLIŲ;5701479990;Ne;1;0;0;1
5653;Pagrandukas;ŠYPSENĖLIŲ;9981610798;Ne;1;0;0;1
5654;Pagrandukas;ŠYPSENĖLIŲ;8027783692;Taip;5;0;0;5
5655;Pagrandukas;ŠYPSENĖLIŲ;2904880156;Ne;6;0;0;6
5656;Pagrandukas;ŠYPSENĖLIŲ;6057078416;Ne;5;0;0;5
5657;Pagrandukas;ŠYPSENĖLIŲ;1855833141;Ne;10;0;0;10
5658;Pagrandukas;ŠYPSENĖLIŲ;1475375452;Ne;4;0;0;4
5659;Pagrandukas;ŠYPSENĖLIŲ;8475724797;Ne;1;0;0;1
5660;Pagrandukas;ŠYPSENĖLIŲ;5272914210;Ne;4;0;0;4
5661;Pagrandukas;ŠYPSENĖLIŲ;6517393406;Ne;2;0;0;2
5662;Pagrandukas;ŠYPSENĖLIŲ;4094086585;Ne;6;0;0;6
5663;Pagrandukas;ŠYPSENĖLIŲ;6306635507;Ne;1;0;0;1
5664;Pagrandukas;ŠYPSENĖLIŲ;5060059491;Ne;12;0;0;12
5665;Pagrandukas;ŠYPSENĖLIŲ;1728795744;Ne;10;0;0;10
5666;Pagrandukas;ŠYPSENĖLIŲ;8638429638;Ne;10;0;0;10
5667;Pakalnutė;Pagrandukai;7475119623;Ne;0;2;0;2
5668;Pakalnutė;Pagrandukai;9677810607;Ne;5;0;0;5
5669;Pakalnutė;Pagrandukai;5275833872;Ne;5;1;0;6
5670;Pakalnutė;Pagrandukai;2296079246;Ne;11;0;0;11
5671;Pakalnutė;Pagrandukai;9313588621;Ne;12;0;0;12
5672;Pakalnutė;Pagrandukai;5180015882;Ne;14;0;0;14
5673;Pakalnutė;Pagrandukai;7477188659;Ne;1;1;0;2
5674;Pakalnutė;Pagrandukai;8522585063;Ne;2;0;0;2
5675;Pakalnutė;Pagrandukai;2642359967;Ne;13;0;0;13
5676;Pakalnutė;Pagrandukai;7417131378;Taip;5;0;0;5
5677;Pakalnutė;Pagrandukai;6396963609;Ne;3;0;0;3
5678;Pakalnutė;Pagrandukai;1883500676;Ne;3;0;0;3
5679;Pakalnutė;Pagrandukai;7669135310;Ne;2;0;0;2
5680;Pakalnutė;"Pelėdžiukų ";8730363504;Ne;7;0;0;7
5681;Pakalnutė;"Pelėdžiukų ";6002425101;Ne;8;0;0;8
5682;Pakalnutė;"Pelėdžiukų ";6592271501;Ne;13;0;0;13
5683;Pakalnutė;"Pelėdžiukų ";7028010813;Ne;12;0;0;12
5684;Pakalnutė;"Pelėdžiukų ";6981958616;Ne;15;0;0;15
5685;Pakalnutė;"Pelėdžiukų ";3139358443;Ne;9;0;0;9
5686;Pakalnutė;"Pelėdžiukų ";1999933222;Ne;7;0;0;7
5687;Pakalnutė;"Pelėdžiukų ";1783674258;Ne;4;0;0;4
5688;Pakalnutė;"Pelėdžiukų ";9624523658;Ne;13;0;0;13
5689;Pakalnutė;"Pelėdžiukų ";1307260377;Ne;1;0;0;1
5690;Pakalnutė;"Pelėdžiukų ";6555749105;Ne;10;0;0;10
5691;Pakalnutė;"Pelėdžiukų ";9253328160;Ne;13;0;0;13
5692;Pakalnutė;"Pelėdžiukų ";6866535420;Ne;4;0;0;4
5693;Pakalnutė;"Pelėdžiukų ";8996675127;Ne;5;0;0;5
5694;Pakalnutė;Ežiukai;4052166895;Ne;1;0;0;1
5695;Pakalnutė;Ežiukai;9323200833;Ne;2;0;0;2
5696;Pakalnutė;Ežiukai;9781993614;Ne;0;5;0;5
5697;Pakalnutė;Ežiukai;7734657452;Ne;1;0;0;1
5698;Pakalnutė;Ežiukai;8081932074;Ne;7;0;0;7
5699;Pakalnutė;Ežiukai;9706455707;Ne;4;0;0;4
5700;Pakalnutė;Ežiukai;7881545979;Ne;0;11;0;11
5701;Pakalnutė;Ežiukai;8080989574;Ne;9;0;0;9
5702;Pakalnutė;Ežiukai;5911381706;Ne;2;2;0;4
5703;Pakalnutė;Ežiukai;2755412687;Ne;4;0;0;4
5704;Pakalnutė;Ežiukai;3064391379;Ne;10;0;0;10
5705;Pakalnutė;Ežiukai;2015778005;Ne;4;0;0;4
5706;Pakalnutė;Ežiukai;8329725085;Taip;2;0;0;2
5707;Pakalnutė;Ežiukai;1662773049;Ne;8;0;0;8
5708;Pakalnutė;Ežiukai;5685361033;Ne;0;1;0;1
5709;Pakalnutė;Skruzdėliukų;4033813807;Ne;16;0;0;16
5710;Pakalnutė;Skruzdėliukų;7503936754;Ne;0;2;0;2
5711;Pakalnutė;Skruzdėliukų;5409476517;Ne;5;6;0;11
5712;Pakalnutė;Skruzdėliukų;2670302354;Ne;6;0;0;6
5713;Pakalnutė;Skruzdėliukų;7105369111;Ne;5;0;1;6
5714;Pakalnutė;Skruzdėliukų;6944726166;Ne;8;0;0;8
5715;Pakalnutė;Skruzdėliukų;3211633472;Ne;7;0;0;7
5716;Pakalnutė;Skruzdėliukų;4423348418;Ne;0;1;0;1
5717;Pakalnutė;Skruzdėliukų;6055727963;Taip;3;1;0;4
5718;Pakalnutė;Skruzdėliukų;3215438452;Ne;5;0;0;5
5719;Pakalnutė;Skruzdėliukų;9681515221;Ne;6;0;0;6
5720;Pakalnutė;Skruzdėliukų;9336711927;Taip;5;4;0;9
5721;Pakalnutė;Skruzdėliukų;5356902834;Ne;5;0;0;5
5722;Pakalnutė;Skruzdėliukų;1540045675;Ne;0;2;0;2
5723;Pakalnutė;Skruzdėliukų;8768704484;Taip;14;0;0;14
5724;Pakalnutė;Skruzdėliukų;6675588261;Taip;9;0;0;9
5725;Pakalnutė;Bitučių;2765220889;Ne;0;2;0;2
5726;Pakalnutė;Bitučių;5532458706;Ne;0;1;0;1
5727;Pakalnutė;Bitučių;5941955322;Ne;1;0;0;1
5728;Pakalnutė;Bitučių;3306334576;Ne;1;0;0;1
5729;Pakalnutė;Bitučių;5342592825;Ne;0;2;0;2
5730;Pakalnutė;Bitučių;5464143742;Ne;20;0;0;20
5731;Pakalnutė;Bitučių;6351193702;Ne;2;0;0;2
5732;Pakalnutė;Bitučių;2070744110;Ne;6;0;0;6
5733;Pakalnutė;Bitučių;3965390135;Ne;0;4;0;4
5734;Pakalnutė;Bitučių;5355198213;Ne;1;0;0;1
5735;Pakalnutė;Bitučių;4523766424;Ne;2;0;0;2
5736;Pakalnutė;Bitučių;4452372238;Taip;11;0;0;11
5737;Pakalnutė;Bitučių;2992768162;Ne;8;0;0;8
5738;Pakalnutė;Bitučių;9505524183;Ne;11;0;0;11
5739;Pakalnutė;Bitučių;1330092247;Ne;15;0;0;15
5740;Pakalnutė;Bitučių;3267680599;Ne;6;0;0;6
5741;Pakalnutė;Boružiukų;6798939288;Ne;0;1;0;1
5742;Pakalnutė;Boružiukų;7357431226;Ne;4;0;0;4
5743;Pakalnutė;Boružiukų;5039000154;Ne;0;1;0;1
5744;Pakalnutė;Boružiukų;7672252382;Ne;3;0;0;3
5745;Pakalnutė;Boružiukų;4927086034;Ne;1;0;0;1
5746;Pakalnutė;Boružiukų;3677709759;Taip;8;0;0;8
5747;Pakalnutė;Boružiukų;2597900983;Ne;1;0;0;1
5748;Pakalnutė;Boružiukų;1340022702;Ne;4;0;0;4
5749;Pakalnutė;Boružiukų;6228196996;Ne;11;0;0;11
5750;Pakalnutė;Boružiukų;7563201788;Ne;0;15;0;15
5751;Pakalnutė;Boružiukų;3840499737;Ne;2;0;0;2
5752;Pakalnutė;Boružiukų;4220368864;Ne;0;3;0;3
5753;Pakalnutė;Boružiukų;7151877991;Taip;7;0;0;7
5754;Pakalnutė;Boružiukų;4353883274;Ne;10;0;0;10
5755;Pakalnutė;Boružiukų;8823232039;Ne;1;0;0;1
5756;Pakalnutė;Meškiukų;2101821362;Taip;0;11;0;11
5757;Pakalnutė;Meškiukų;4069910346;Ne;0;9;0;9
5758;Pakalnutė;Meškiukų;7084798190;Ne;8;0;0;8
5759;Pakalnutė;Meškiukų;3693337607;Ne;17;0;0;17
5760;Pakalnutė;Meškiukų;8576580816;Taip;3;0;0;3
5761;Pakalnutė;Meškiukų;6082998947;Ne;15;0;0;15
5762;Pakalnutė;Meškiukų;7696196458;Ne;5;0;0;5
5763;Pakalnutė;Meškiukų;9327477300;Ne;0;9;0;9
5764;Pakalnutė;Nykštukai;2063766287;Ne;0;2;0;2
5765;Pakalnutė;Nykštukai;8217779439;Ne;0;1;0;1
5766;Pakalnutė;Nykštukai;6206296685;Ne;5;0;0;5
5767;Pakalnutė;Nykštukai;8855237588;Taip;2;0;0;2
5768;Pakalnutė;Nykštukai;1561411767;Ne;4;0;0;4
5769;Pakalnutė;Nykštukai;7024440142;Ne;5;1;0;6
5770;Pakalnutė;Nykštukai;2578170222;Ne;2;0;0;2
5771;Pakalnutė;Nykštukai;5377715404;Ne;15;0;0;15
5772;Pakalnutė;Nykštukai;3938091521;Ne;12;0;0;12
5773;Pakalnutė;"Zuikučių ";3992958274;Taip;5;1;0;6
5774;Pakalnutė;"Zuikučių ";7665013940;Ne;9;0;0;9
5775;Pakalnutė;"Zuikučių ";5366218312;Ne;1;0;0;1
5776;Pakalnutė;"Zuikučių ";9093281442;Ne;12;0;0;12
5777;Pakalnutė;"Zuikučių ";5712352356;Ne;9;0;0;9
5778;Pakalnutė;"Zuikučių ";6346936964;Ne;3;0;0;3
5779;Pakalnutė;"Zuikučių ";8678783379;Ne;1;0;0;1
5780;Pakalnutė;"Zuikučių ";7200174700;Ne;3;0;0;3
5781;Pakalnutė;"Zuikučių ";2364777781;Ne;8;0;0;8
5782;Pakalnutė;"Zuikučių ";6817504559;Ne;1;0;0;1
5783;Pakalnutė;"Zuikučių ";4926207043;Ne;5;3;0;8
5784;Pakalnutė;"Zuikučių ";9324190244;Taip;5;0;0;5
5785;Pakalnutė;"Zuikučių ";1044084070;Ne;3;1;0;4
5786;Pakalnutė;"Zuikučių ";4587376166;Ne;11;0;0;11
5787;Pakalnutė;"Zuikučių ";7696333378;Ne;18;0;0;18
5788;Pakalnutė;"Zuikučių ";5285591409;Taip;5;0;0;5
5789;Pakalnutė;"Zuikučių ";5328042222;Ne;0;20;0;20
5790;Pakalnutė;"Drugelių ";5441477374;Ne;0;11;0;11
5791;Pakalnutė;"Drugelių ";5135811550;Ne;5;0;0;5
5792;Pakalnutė;"Drugelių ";7766653114;Ne;5;0;0;5
5793;Pakalnutė;"Drugelių ";7709684372;Ne;6;0;0;6
5794;Pakalnutė;"Drugelių ";9620000116;Taip;4;0;0;4
5795;Pakalnutė;"Drugelių ";5502444590;Ne;5;0;0;5
5796;Pakalnutė;"Drugelių ";3730712580;Ne;5;0;0;5
5797;Pakalnutė;"Drugelių ";1824418095;Ne;4;0;0;4
5798;Pakalnutė;"Drugelių ";9461133636;Ne;8;0;0;8
5799;Pakalnutė;"Drugelių ";4220406978;Ne;3;0;0;3
5800;Pakalnutė;"Drugelių ";5069038636;Ne;0;20;0;20
5801;Pakalnutė;"Drugelių ";7047587606;Ne;0;17;0;17
5802;Pakalnutė;"Drugelių ";2653667596;Ne;8;0;0;8
5803;Pakalnutė;"Drugelių ";2026242407;Ne;4;0;0;4
5804;Pakalnutė;"Drugelių ";2197533802;Ne;4;0;0;4
5805;Pakalnutė;"Drugelių ";1791607977;Taip;3;0;0;3
5806;Pakalnutė;"Drugelių ";4127500142;Ne;2;0;0;2
5807;Pakalnutė;"Drugelių ";9295709508;Taip;16;0;0;16
5808;Pakalnutė;"Drugelių ";6924023022;Ne;4;0;0;4
5809;Pakalnutė;"Drugelių ";8105507156;Ne;4;3;0;7
5810;Pakalnutė;Žvirbliukų;7421275778;Ne;2;0;0;2
5811;Pakalnutė;Žvirbliukų;3190067149;Taip;0;8;0;8
5812;Pakalnutė;Žvirbliukų;7548659665;Taip;0;1;0;1
5813;Pakalnutė;Žvirbliukų;8010667913;Ne;20;0;0;20
5814;Pakalnutė;Žvirbliukų;5531209454;Ne;20;0;0;20
5815;Pakalnutė;Žvirbliukų;7258417347;Taip;12;1;0;13
5816;Pakalnutė;Žvirbliukų;5878352514;Ne;2;0;0;2
5817;Pakalnutė;Žvirbliukų;7782295402;Ne;5;1;0;6
5818;Pakalnutė;Žvirbliukų;7547661599;Taip;2;0;0;2
5819;Pakalnutė;Žvirbliukų;6159955311;Ne;0;2;0;2
5820;Pakalnutė;Žvirbliukų;3903972025;Ne;0;1;0;1
5821;Pakalnutė;Žvirbliukų;3458404368;Taip;10;0;0;10
5822;Pakalnutė;Žvirbliukų;8394290574;Ne;5;0;0;5
5823;Pakalnutė;Žvirbliukų;8104124782;Ne;15;0;0;15
5824;Pakalnutė;Žvirbliukų;1368254053;Ne;16;0;0;16
5825;Pakalnutė;Žvirbliukų;6361966325;Ne;10;0;0;10
5826;Panerių;Rūtelė;2333355325;Taip;0;0;1;1
5827;Panerių;Rūtelė;4867297993;Ne;0;0;1;1
5828;Panerių;Rūtelė;3190117304;Taip;0;10;0;10
5829;Panerių;Rūtelė;8693113275;Taip;4;0;5;9
5830;Panerių;Rūtelė;6468190149;Ne;0;0;1;1
5831;Panerių;Rūtelė;3057714143;Ne;0;0;1;1
5832;Panerių;Rūtelė;9432171719;Ne;7;0;0;7
5833;Panerių;Rūtelė;1717129076;Ne;16;0;0;16
5834;Panerių;Rūtelė;2035822976;Ne;4;0;0;4
5835;Panerių;Rūtelė;3550194241;Ne;4;0;1;5
5836;Panerių;Rūtelė;9729731866;Ne;0;0;3;3
5837;Panerių;Rūtelė;8447920373;Ne;0;0;4;4
5838;Panerių;Rūtelė;6583134855;Ne;0;0;6;6
5839;Panerių;Rūtelė;4161189870;Taip;8;0;1;9
5840;Panerių;Rūtelė;3948776877;Ne;2;0;1;3
5841;Panerių;Rūtelė;2751334281;Ne;2;0;2;4
5842;Panerių;Rūtelė;1339256258;Ne;2;0;3;5
5843;Panerių;Gėlytės;5452996791;Ne;4;0;0;4
5844;Panerių;Gėlytės;3112608087;Taip;3;0;1;4
5845;Panerių;Gėlytės;5100874548;Taip;5;0;1;6
5846;Panerių;Gėlytės;9955613696;Ne;3;0;0;3
5847;Panerių;Gėlytės;7166964095;Ne;5;0;0;5
5848;Panerių;Gėlytės;7657860513;Taip;7;5;0;12
5849;Panerių;Gėlytės;4716214117;Ne;0;2;0;2
5850;Panerių;Gėlytės;4369979548;Taip;9;0;0;9
5851;Panerių;Gėlytės;9014387764;Ne;0;1;0;1
5852;Panerių;Gėlytės;3273655606;Ne;13;0;0;13
5853;Panerių;Gėlytės;8067240250;Ne;12;0;0;12
5854;Panerių;Gėlytės;3502494751;Ne;10;0;3;13
5855;Panerių;Gėlytės;6574858142;Ne;6;0;2;8
5856;Panerių;Gėlytės;4957564440;Ne;4;0;0;4
5857;Panerių;Gėlytės;7976634590;Taip;7;0;0;7
5858;Panerių;Gėlytės;1985780685;Ne;5;0;0;5
5859;Panerių;Boružė;5938568445;Ne;10;0;0;10
5860;Panerių;Boružė;6067429637;Ne;1;0;0;1
5861;Panerių;Boružė;8204542330;Ne;20;0;0;20
5862;Panerių;Boružė;9834947195;Ne;4;0;1;5
5863;Panerių;Boružė;7665286465;Ne;14;0;1;15
5864;Panerių;Boružė;7674680327;Ne;9;0;1;10
5865;Panerių;Boružė;2411155582;Ne;1;0;0;1
5866;Panerių;Boružė;9658945394;Ne;20;0;0;20
5867;Panerių;Boružė;5243109212;Ne;4;0;2;6
5868;Panerių;Boružė;7516118069;Taip;2;0;0;2
5869;Panerių;Boružė;5836583423;Ne;7;0;1;8
5870;Panerių;Boružė;6903412424;Ne;2;0;0;2
5871;Panerių;Boružė;7200320230;Ne;0;4;0;4
5872;Papartis;ZUIKUČIAI;8874222586;Taip;4;2;0;6
5873;Papartis;ZUIKUČIAI;2446379598;Ne;12;0;0;12
5874;Papartis;ZUIKUČIAI;1191546794;Ne;6;0;0;6
5875;Papartis;ZUIKUČIAI;7619963429;Ne;0;1;0;1
5876;Papartis;ZUIKUČIAI;8958880558;Ne;0;3;0;3
5877;Papartis;ZUIKUČIAI;4380030213;Ne;8;1;0;9
5878;Papartis;ZUIKUČIAI;4906248064;Taip;6;0;0;6
5879;Papartis;ZUIKUČIAI;1919362027;Ne;3;1;0;4
5880;Papartis;ZUIKUČIAI;5361925390;Ne;0;1;0;1
5881;Papartis;ZUIKUČIAI;5786648402;Ne;1;0;0;1
5882;Papartis;ZUIKUČIAI;5776038830;Ne;5;0;0;5
5883;Papartis;ZUIKUČIAI;5579899922;Ne;11;0;0;11
5884;Papartis;ZUIKUČIAI;9358310527;Ne;0;4;0;4
5885;Papartis;ZUIKUČIAI;5363926529;Taip;0;3;0;3
5886;Papartis;ZUIKUČIAI;1722192450;Ne;4;0;0;4
5887;Papartis;ZUIKUČIAI;8897061283;Ne;11;0;1;12
5888;Papartis;DRUGELIAI;8005876431;Ne;4;0;0;4
5889;Papartis;DRUGELIAI;7384518191;Ne;1;0;0;1
5890;Papartis;DRUGELIAI;6664178454;Ne;2;4;0;6
5891;Papartis;DRUGELIAI;2432516496;Ne;9;2;0;11
5892;Papartis;DRUGELIAI;7742769931;Ne;7;2;0;9
5893;Papartis;DRUGELIAI;8305560946;Ne;1;0;0;1
5894;Papartis;DRUGELIAI;4778327620;Ne;0;8;0;8
5895;Papartis;DRUGELIAI;7486667034;Ne;0;2;0;2
5896;Papartis;DRUGELIAI;7331682622;Ne;11;0;0;11
5897;Papartis;DRUGELIAI;2824078830;Ne;10;0;0;10
5898;Papartis;DRUGELIAI;1405767603;Ne;5;0;0;5
5899;Papartis;DRUGELIAI;6435625940;Ne;4;1;0;5
5900;Papartis;DRUGELIAI;3411472740;Ne;11;0;0;11
5901;Papartis;DRUGELIAI;3209105694;Ne;6;0;0;6
5902;Papartis;DRUGELIAI;1759982543;Ne;0;3;0;3
5903;Papartis;DRUGELIAI;4689046394;Ne;2;0;0;2
5904;Papartis;DRUGELIAI;5430993785;Ne;15;0;0;15
5905;Papartis;ŽVIRBLIUKAI;9380951144;Ne;15;0;0;15
5906;Papartis;ŽVIRBLIUKAI;2812347963;Ne;0;5;0;5
5907;Papartis;ŽVIRBLIUKAI;3685642787;Ne;5;0;0;5
5908;Papartis;ŽVIRBLIUKAI;8420752169;Taip;3;0;1;4
5909;Papartis;ŽVIRBLIUKAI;4016297254;Ne;12;0;0;12
5910;Papartis;ŽVIRBLIUKAI;6585372451;Ne;6;0;0;6
5911;Papartis;ŽVIRBLIUKAI;6734567714;Ne;0;1;0;1
5912;Papartis;ŽVIRBLIUKAI;1352401881;Ne;0;3;0;3
5913;Papartis;ŽVIRBLIUKAI;5465955537;Ne;2;0;1;3
5914;Papartis;ŽVIRBLIUKAI;6346776139;Taip;20;0;0;20
5915;Papartis;ŽVIRBLIUKAI;3595627659;Ne;1;0;0;1
5916;Papartis;ŽVIRBLIUKAI;6977513472;Ne;2;0;0;2
5917;Papartis;ŽVIRBLIUKAI;5323875279;Ne;0;3;0;3
5918;Papartis;ŽVIRBLIUKAI;6136213985;Ne;2;2;0;4
5919;Papartis;ŽVIRBLIUKAI;7107692314;Ne;1;2;0;3
5920;Papartis;ŽVIRBLIUKAI;5070767260;Ne;4;0;0;4
5921;Papartis;PELĖDŽIUKAI;9502229005;Ne;7;0;1;8
5922;Papartis;PELĖDŽIUKAI;1559196767;Ne;7;0;0;7
5923;Papartis;PELĖDŽIUKAI;5652560002;Ne;1;1;0;2
5924;Papartis;PELĖDŽIUKAI;6360881137;Ne;9;1;0;10
5925;Papartis;PELĖDŽIUKAI;6794076631;Ne;0;1;0;1
5926;Papartis;PELĖDŽIUKAI;6941978169;Ne;0;1;1;2
5927;Papartis;PELĖDŽIUKAI;4203241118;Ne;1;0;0;1
5928;Papartis;PELĖDŽIUKAI;9285319899;Ne;5;1;0;6
5929;Papartis;PELĖDŽIUKAI;5942160584;Ne;1;0;0;1
5930;Papartis;PELĖDŽIUKAI;9922091482;Ne;5;1;1;7
5931;Papartis;PELĖDŽIUKAI;8932290803;Ne;6;0;0;6
5932;Papartis;PELĖDŽIUKAI;1680412204;Taip;0;0;3;3
5933;Papartis;PELĖDŽIUKAI;4509843536;Ne;0;0;5;5
5934;Papartis;PELĖDŽIUKAI;6883101103;Taip;0;0;3;3
5935;Papartis;PELĖDŽIUKAI;4878190663;Ne;6;0;0;6
5936;Papartis;PELĖDŽIUKAI;9704930584;Ne;0;6;0;6
5937;Papartis;PELĖDŽIUKAI;9072635586;Ne;6;0;1;7
5938;Papartis;PELĖDŽIUKAI;1442806517;Ne;1;0;0;1
5939;Papartis;SAULUTĖS;8836419340;Ne;4;0;0;4
5940;Papartis;SAULUTĖS;8187136860;Ne;14;0;0;14
5941;Papartis;SAULUTĖS;6408828474;Ne;20;0;0;20
5942;Papartis;SAULUTĖS;1428163291;Ne;7;0;0;7
5943;Papartis;SAULUTĖS;6436061438;Ne;3;0;0;3
5944;Papartis;SAULUTĖS;8423259604;Ne;11;1;0;12
5945;Papartis;SAULUTĖS;4887468138;Ne;10;0;0;10
5946;Papartis;SAULUTĖS;8866437550;Ne;11;0;0;11
5947;Papartis;SAULUTĖS;9731930047;Ne;5;0;0;5
5948;Papartis;SAULUTĖS;3948323728;Ne;12;0;0;12
5949;Papartis;SAULUTĖS;2004327439;Ne;5;0;0;5
5950;Papartis;SAULUTĖS;6199807321;Ne;18;0;0;18
5951;Papartis;SAULUTĖS;4767287348;Ne;12;0;0;12
5952;Papartis;SAULUTĖS;4983959118;Ne;10;0;0;10
5953;Papartis;SAULUTĖS;6352542412;Ne;16;0;0;16
5954;Papartis;GANDRIUKAI;4969807705;Ne;8;2;0;10
5955;Papartis;GANDRIUKAI;5383936595;Ne;0;5;0;5
5956;Papartis;GANDRIUKAI;1698871014;Ne;0;8;0;8
5957;Papartis;GANDRIUKAI;6274608449;Ne;13;0;0;13
5958;Papartis;GANDRIUKAI;6664773988;Ne;4;2;0;6
5959;Papartis;GANDRIUKAI;8875490564;Ne;6;0;0;6
5960;Papartis;GANDRIUKAI;7149853209;Ne;5;0;0;5
5961;Papartis;GANDRIUKAI;2921187615;Ne;5;0;0;5
5962;Papartis;GANDRIUKAI;5128663521;Ne;5;0;0;5
5963;Papartis;GANDRIUKAI;4500675679;Ne;0;3;0;3
5964;Papartis;GANDRIUKAI;7203919287;Ne;5;1;0;6
5965;Papartis;GANDRIUKAI;1486770896;Ne;4;0;0;4
5966;Papartis;GANDRIUKAI;5132031416;Ne;7;0;0;7
5967;Papartis;GANDRIUKAI;3395306653;Ne;6;6;0;12
5968;Papartis;GANDRIUKAI;1616537800;Ne;5;3;0;8
5969;Papartis;GANDRIUKAI;8303599213;Taip;8;0;0;8
5970;Papartis;GANDRIUKAI;9326439257;Ne;11;0;0;11
5971;Papartis;GANDRIUKAI;1656161309;Ne;2;0;0;2
5972;Papartis;GANDRIUKAI;8410744610;Ne;10;0;0;10
5973;Papartis;AITVARELIAI;8891856856;Ne;10;0;0;10
5974;Papartis;AITVARELIAI;6889782462;Taip;13;0;0;13
5975;Papartis;AITVARELIAI;8532558577;Ne;0;4;3;7
5976;Papartis;AITVARELIAI;4918854899;Ne;4;1;0;5
5977;Papartis;AITVARELIAI;5252947502;Ne;15;2;0;17
5978;Papartis;AITVARELIAI;7018190169;Ne;0;3;0;3
5979;Papartis;AITVARELIAI;7803854703;Ne;0;1;0;1
5980;Papartis;AITVARELIAI;4261270064;Ne;5;2;0;7
5981;Papartis;AITVARELIAI;6416605464;Ne;1;0;0;1
5982;Papartis;AITVARELIAI;1266338760;Ne;0;2;1;3
5983;Papartis;AITVARELIAI;7504793827;Ne;13;0;1;14
5984;Papartis;AITVARELIAI;7156767639;Ne;12;0;0;12
5985;Papartis;AITVARELIAI;5268226380;Ne;0;1;0;1
5986;Papartis;AITVARELIAI;2116140075;Ne;0;3;0;3
5987;Papartis;AITVARELIAI;3896803048;Ne;5;0;0;5
5988;Papartis;AITVARELIAI;4138926711;Taip;0;0;1;1
5989;Papartis;AITVARELIAI;8989172483;Ne;5;0;13;18
5990;Papartis;SMALSUČIAI;5660932637;Ne;2;0;0;2
5991;Papartis;SMALSUČIAI;3576856223;Ne;0;1;0;1
5992;Papartis;SMALSUČIAI;5259754395;Ne;5;1;0;6
5993;Papartis;SMALSUČIAI;1157298413;Ne;5;1;0;6
5994;Papartis;SMALSUČIAI;3107245976;Ne;5;0;0;5
5995;Papartis;SMALSUČIAI;5959006739;Ne;4;0;0;4
5996;Papartis;SMALSUČIAI;6776383676;Ne;9;0;0;9
5997;Papartis;SMALSUČIAI;9838432144;Ne;9;4;0;13
5998;Papartis;SMALSUČIAI;9884399306;Ne;7;3;0;10
5999;Papartis;SMALSUČIAI;1511111597;Ne;6;0;0;6
6000;Papartis;SMALSUČIAI;8055310718;Ne;9;0;0;9
6001;Papartis;SMALSUČIAI;7492923318;Ne;12;0;0;12
6002;Papartis;SMALSUČIAI;3490370261;Ne;16;0;0;16
6003;Papartis;SMALSUČIAI;1566259150;Ne;6;0;0;6
6004;Papartis;SMALSUČIAI;4087823915;Ne;12;0;0;12
6005;Papartis;SMALSUČIAI;1293528737;Ne;20;0;0;20
6006;Papartis;"ŽIRNIUKAI ";1073755384;Ne;6;0;0;6
6007;Papartis;"ŽIRNIUKAI ";7647225316;Ne;3;1;0;4
6008;Papartis;"ŽIRNIUKAI ";1210592579;Ne;0;0;1;1
6009;Papartis;"ŽIRNIUKAI ";1519815331;Ne;9;1;0;10
6010;Papartis;"ŽIRNIUKAI ";4158525314;Ne;10;0;0;10
6011;Papartis;"ŽIRNIUKAI ";4978398085;Ne;7;1;0;8
6012;Papartis;"ŽIRNIUKAI ";9746397380;Ne;3;0;2;5
6013;Papartis;"ŽIRNIUKAI ";4952279543;Taip;0;4;0;4
6014;Papartis;"ŽIRNIUKAI ";5276806556;Ne;10;0;0;10
6015;Papartis;"ŽIRNIUKAI ";2521609574;Taip;0;0;2;2
6016;Papartis;"ŽIRNIUKAI ";7617558492;Ne;0;0;3;3
6017;Papartis;"ŽIRNIUKAI ";8412962815;Ne;2;0;0;2
6018;Papartis;"ŽIRNIUKAI ";2772758899;Ne;4;0;5;9
6019;Papartis;"ŽIRNIUKAI ";1183123161;Taip;4;0;0;4
6020;Papartis;"ŽIRNIUKAI ";1614261572;Ne;0;2;0;2
6021;Papartis;BORUŽĖLĖS;4156776066;Ne;9;0;0;9
6022;Papartis;BORUŽĖLĖS;4394324806;Ne;0;20;0;20
6023;Papartis;BORUŽĖLĖS;4128791207;Ne;0;20;0;20
6024;Papartis;BORUŽĖLĖS;1713966292;Taip;13;1;0;14
6025;Papartis;BORUŽĖLĖS;6512648672;Ne;19;0;0;19
6026;Papartis;BORUŽĖLĖS;1229841021;Ne;4;0;0;4
6027;Papartis;BORUŽĖLĖS;6971029839;Ne;9;0;0;9
6028;Papartis;BORUŽĖLĖS;3671248088;Ne;3;2;0;5
6029;Papartis;BORUŽĖLĖS;3033128518;Ne;1;1;0;2
6030;Papartis;BORUŽĖLĖS;3138701373;Ne;8;0;0;8
6031;Papartis;BORUŽĖLĖS;4800482635;Ne;12;0;0;12
6032;Papartis;BORUŽĖLĖS;2833918272;Ne;13;0;0;13
6033;Papartis;BORUŽĖLĖS;5459468987;Ne;15;0;0;15
6034;Papartis;VARPELIAI;8501388069;Taip;3;0;0;3
6035;Papartis;VARPELIAI;3639299679;Ne;1;4;0;5
6036;Papartis;VARPELIAI;5796633935;Ne;17;0;0;17
6037;Papartis;VARPELIAI;9141478403;Ne;8;0;0;8
6038;Papartis;VARPELIAI;5073439000;Ne;1;1;0;2
6039;Papartis;VARPELIAI;1390187546;Ne;9;0;0;9
6040;Papartis;VARPELIAI;6559847250;Ne;10;0;0;10
6041;Papartis;VARPELIAI;6053981340;Ne;10;0;0;10
6042;Papartis;VARPELIAI;5038105723;Taip;10;0;0;10
6043;Papartis;VARPELIAI;3327404107;Ne;5;0;0;5
6044;Papartis;VARPELIAI;3535455931;Ne;0;0;1;1
6045;Papartis;VARPELIAI;4839033346;Ne;7;0;0;7
6046;Papartis;VARPELIAI;5063367652;Ne;13;0;0;13
6047;Papartis;VARPELIAI;4620041887;Ne;4;0;0;4
6048;Papartis;VARPELIAI;1032653411;Ne;5;0;0;5
6049;Papartis;NYKŠTUKAI;9581159294;Taip;2;0;0;2
6050;Papartis;NYKŠTUKAI;6710049689;Ne;4;0;0;4
6051;Papartis;NYKŠTUKAI;2777359899;Taip;7;0;0;7
6052;Papartis;NYKŠTUKAI;1993893368;Ne;4;0;0;4
6053;Papartis;NYKŠTUKAI;3345085436;Ne;9;0;0;9
6054;Papartis;NYKŠTUKAI;7189999679;Ne;8;0;0;8
6055;Papartis;NYKŠTUKAI;4256878733;Ne;6;0;0;6
6056;Papartis;NYKŠTUKAI;8443731277;Ne;6;0;0;6
6057;Papartis;NYKŠTUKAI;3419374226;Taip;13;0;0;13
6058;Papartis;NYKŠTUKAI;8642079824;Ne;7;0;0;7
6059;Papartis;NYKŠTUKAI;2421158534;Ne;3;0;0;3
6060;Papartis;NYKŠTUKAI;2600724041;Ne;10;0;0;10
6061;Papartis;NYKŠTUKAI;8872914372;Ne;11;0;0;11
6062;Papartis;NYKŠTUKAI;2053568874;Ne;0;3;0;3
6063;Papartis;NYKŠTUKAI;3173271837;Ne;1;0;0;1
6064;Papartis;NYKŠTUKAI;4952700737;Ne;5;0;0;5
6065;Papartis;NYKŠTUKAI;9881509036;Taip;11;0;0;11
6066;Pasaka;Drugelių;2308992563;Ne;3;2;0;5
6067;Pasaka;Drugelių;7955645490;Taip;8;0;0;8
6068;Pasaka;Drugelių;9249389876;Ne;5;0;0;5
6069;Pasaka;Drugelių;2961210575;Taip;10;0;0;10
6070;Pasaka;Drugelių;2383607612;Taip;4;2;0;6
6071;Pasaka;Drugelių;9737445077;Ne;4;0;0;4
6072;Pasaka;Drugelių;9136521759;Ne;0;1;0;1
6073;Pasaka;Drugelių;8400549247;Ne;2;0;0;2
6074;Pasaka;Drugelių;6326056771;Ne;1;2;0;3
6075;Pasaka;Drugelių;4175157894;Ne;5;0;0;5
6076;Pasaka;Drugelių;7252498738;Ne;10;0;0;10
6077;Pasaka;Drugelių;4183646305;Ne;5;0;0;5
6078;Pasaka;Nykštukų;5768958388;Ne;6;0;2;8
6079;Pasaka;Nykštukų;2797217440;Ne;0;1;0;1
6080;Pasaka;Nykštukų;7292437626;Ne;0;1;0;1
6081;Pasaka;Nykštukų;2211744442;Ne;2;0;0;2
6082;Pasaka;Nykštukų;5912306325;Ne;0;2;0;2
6083;Pasaka;Nykštukų;2217868951;Ne;2;0;0;2
6084;Pasaka;Nykštukų;2217868951;Ne;2;0;0;2
6085;Pasaka;Nykštukų;2217868951;Ne;2;0;0;2
6086;Pasaka;Nykštukų;3066438231;Ne;2;0;0;2
6087;Pasaka;Nykštukų;3066438231;Ne;2;0;0;2
6088;Pasaka;Nykštukų;3066438231;Ne;2;0;0;2
6089;Pasaka;Nykštukų;3424189866;Ne;0;10;3;13
6090;Pasaka;Nykštukų;6821289069;Ne;0;0;3;3
6091;Pasaka;Montesori;5240642967;Taip;3;0;0;3
6092;Pasaka;Montesori;6625690696;Ne;5;0;0;5
6093;Pasaka;Montesori;4548601585;Taip;0;2;0;2
6094;Pasaka;Montesori;7887326763;Ne;0;0;1;1
6095;Pasaka;Montesori;9850592463;Ne;2;0;0;2
6096;Pasaka;Montesori;2995831258;Ne;2;0;0;2
6097;Pasaka;Montesori;6248810027;Taip;2;0;0;2
6098;Pasaka;Montesori;3620395122;Ne;3;0;0;3
6099;Pasaka;Montesori;5689164477;Ne;5;0;0;5
6100;Pasaka;Montesori;7751618911;Ne;2;0;0;2
6101;Pasaka;Montesori;5230621839;Ne;6;0;1;7
6102;Pasaka;Montesori;9471447977;Taip;0;1;0;1
6103;Pasaka;Montesori;4222952044;Ne;4;0;0;4
6104;Pasaka;Montesori;5194285627;Ne;5;0;0;5
6105;Pasaka;Montesori;9488089168;Ne;2;0;0;2
6106;Pasaka;Montesori;2558448927;Taip;4;0;1;5
6107;Pasaka;Montesori;9567521319;Ne;3;0;0;3
6108;Pasaka;Žirniukų;9867183480;Ne;6;0;1;7
6109;Pasaka;Žirniukų;2815348652;Taip;0;0;2;2
6110;Pasaka;Žirniukų;2422958320;Ne;4;1;0;5
6111;Pasaka;Žirniukų;9136524816;Ne;3;0;0;3
6112;Pasaka;Žirniukų;9766432049;Ne;3;3;0;6
6113;Pasaka;Žirniukų;6668421711;Ne;0;0;1;1
6114;Pasaka;Žirniukų;6387972576;Ne;5;0;0;5
6115;Pasaka;Žirniukų;4948174745;Ne;6;0;1;7
6116;Pasaka;Žirniukų;2144975281;Ne;3;0;0;3
6117;Pasaka;Žirniukų;8519108324;Ne;2;2;0;4
6118;Pasaka;Žirniukų;9654507441;Ne;0;0;1;1
6119;Pasaka;Žirniukų;9654507441;Ne;0;0;1;1
6120;Pasaka;Žirniukų;9654507441;Ne;0;0;1;1
6121;Pasaka;Žirniukų;5921553817;Ne;3;0;0;3
6122;Pasaka;Žirniukų;2569560383;Ne;3;0;3;6
6123;Pasaka;Žirniukų;9780490338;Ne;5;0;0;5
6124;Pasaka;"Voveriukų ";3606141216;Ne;0;7;0;7
6125;Pasaka;"Voveriukų ";5217688848;Ne;0;7;0;7
6126;Pasaka;"Voveriukų ";4171004263;Ne;3;10;0;13
6127;Pasaka;"Voveriukų ";1488711275;Ne;0;1;0;1
6128;Pasaka;"Voveriukų ";2854919649;Ne;2;0;0;2
6129;Pasaka;"Voveriukų ";1950145441;Ne;10;0;0;10
6130;Pasaka;"Voveriukų ";4466963221;Ne;10;0;2;12
6131;Pasaka;"Voveriukų ";9588247759;Taip;0;2;1;3
6132;Pasaka;"Voveriukų ";3536862796;Ne;0;1;0;1
6133;Pasaka;"Voveriukų ";8899289832;Ne;5;0;0;5
6134;Pasaka;"Voveriukų ";4915357646;Ne;2;0;0;2
6135;Pasaka;"Voveriukų ";7176272684;Ne;4;0;1;5
6136;Pasaka;"Voveriukų ";9687385445;Ne;2;0;0;2
6137;Pasaka;"Voveriukų ";4799036184;Ne;5;0;0;5
6138;Pasaka;"Voveriukų ";6684234474;Taip;0;10;10;20
6139;Pasaka;"Voveriukų ";6925961600;Ne;2;0;0;2
6140;Pasaka;"Voveriukų ";1745181416;Ne;0;5;4;9
6141;Pasaka;"VALDOFRO 12";1305541319;Ne;0;4;1;5
6142;Pasaka;"VALDOFRO 12";7682903999;Ne;0;0;1;1
6143;Pasaka;"VALDOFRO 12";6448940090;Ne;5;0;0;5
6144;Pasaka;"VALDOFRO 12";8411025450;Ne;3;1;0;4
6145;Pasaka;"VALDOFRO 12";1756831961;Ne;9;1;0;10
6146;Pasaka;"VALDOFRO 12";3840053722;Ne;5;4;0;9
6147;Pasaka;"VALDOFRO 12";8995205555;Ne;5;0;0;5
6148;Pasaka;"VALDOFRO 12";4548945364;Ne;5;0;2;7
6149;Pasaka;"VALDOFRO 12";8912822936;Taip;1;0;0;1
6150;Pasaka;"VALDOFRO 12";5244582148;Ne;10;0;0;10
6151;Pasaka;"VALDOFRO 12";2650797982;Ne;1;0;0;1
6152;Pasaka;"VALDOFRO 12";9809498406;Ne;1;0;0;1
6153;Pasaka;"VALDOFRO 12";6920718870;Ne;6;0;2;8
6154;Pasaka;"VALDOFRO 12";1791565631;Ne;10;0;0;10
6155;Pasaka;"VALDOFRO 12";5601416284;Ne;0;0;2;2
6156;Pasaka;"VALDOFRO 12";9324220807;Ne;0;0;1;1
6157;Pasaka;"VALDORFO 2";4825373152;Ne;0;0;1;1
6158;Pasaka;"VALDORFO 2";9462745431;Ne;0;0;3;3
6159;Pasaka;"VALDORFO 2";5399148997;Ne;0;1;0;1
6160;Pasaka;"VALDORFO 2";1799326151;Ne;1;4;1;6
6161;Pasaka;"VALDORFO 2";2273629510;Ne;1;4;1;6
6162;Pasaka;"VALDORFO 2";5742479853;Ne;0;0;2;2
6163;Pasaka;"VALDORFO 2";9150761761;Ne;13;0;0;13
6164;Pasaka;"VALDORFO 2";1648043715;Ne;0;0;1;1
6165;Pasaka;"VALDORFO 2";8855436141;Ne;0;1;0;1
6166;Pasaka;"VALDORFO 2";3796844193;Ne;13;0;0;13
6167;Pasaka;"VALDORFO 2";1940341287;Ne;0;0;2;2
6168;Pasaka;Gudručiai;3151916774;Ne;1;2;0;3
6169;Pasaka;Gudručiai;4773893970;Ne;2;0;0;2
6170;Pasaka;Gudručiai;7546205285;Ne;0;1;0;1
6171;Pasaka;Gudručiai;4082752808;Taip;5;0;0;5
6172;Pasaka;Gudručiai;6139825302;Ne;3;0;0;3
6173;Pasaka;Gudručiai;7248640367;Ne;0;1;0;1
6174;Pasaka;Gudručiai;8277245475;Ne;7;0;0;7
6175;Pasaka;Gudručiai;1720511696;Ne;1;0;0;1
6176;Pasaka;Gudručiai;4970812899;Ne;1;0;0;1
6177;Pasaka;Gudručiai;8873115041;Ne;5;0;0;5
6178;Pasaka;Gudručiai;3351338617;Ne;3;0;0;3
6179;Pasaka;Gudručiai;3367346582;Ne;0;1;0;1
6180;Pasaka;Bitelių;7696383564;Ne;1;1;1;3
6181;Pasaka;Bitelių;4910817298;Ne;7;5;0;12
6182;Pasaka;Bitelių;7127138831;Ne;2;0;0;2
6183;Pasaka;Bitelių;9813397639;Ne;3;0;0;3
6184;Pasaka;Bitelių;9770811826;Ne;0;0;1;1
6185;Pasaka;Bitelių;8558563996;Ne;9;0;0;9
6186;Pasaka;Bitelių;3735117473;Ne;3;0;0;3
6187;Pasaka;Bitelių;7101898684;Taip;0;1;3;4
6188;Pasaka;Bitelių;9120786116;Ne;0;0;1;1
6189;Pasaka;Bitelių;7960739321;Ne;7;0;0;7
6190;Pasaka;"Pabiručių ";5111195289;Ne;3;1;0;4
6191;Pasaka;"Pabiručių ";6182223896;Ne;3;1;0;4
6192;Pasaka;"Pabiručių ";4982900413;Ne;6;0;0;6
6193;Pasaka;"Pabiručių ";8276520594;Ne;0;9;2;11
6194;Pasaka;"Pabiručių ";3192466285;Ne;0;0;1;1
6195;Pasaka;"Pabiručių ";3730173516;Ne;0;0;6;6
6196;Pasaka;"Pabiručių ";4572517095;Ne;0;1;1;2
6197;Pasaka;"Pabiručių ";8662703330;Ne;6;0;1;7
6198;Pasaka;"Pabiručių ";6189170713;Ne;0;0;1;1
6199;Pasaka;Šnekučių;3709664132;Ne;5;0;0;5
6200;Pasaka;Šnekučių;1512874567;Ne;0;2;0;2
6201;Pasaka;Šnekučių;1793176485;Ne;0;2;0;2
6202;Pasaka;Šnekučių;4296539838;Taip;5;0;2;7
6203;Pasaka;Šnekučių;1590306118;Ne;5;0;0;5
6204;Pasaka;Šnekučių;4215568107;Ne;2;0;0;2
6205;Pasaka;Šnekučių;8365256755;Ne;6;2;0;8
6206;Pasaka;Šnekučių;4816441219;Ne;11;0;2;13
6207;Pasaka;Šnekučių;1795497567;Ne;0;3;0;3
6208;Pasaka;Šnekučių;8347051587;Ne;6;0;0;6
6209;Pasaka;Šnekučių;4975045894;Ne;7;0;0;7
6210;Pasaka;Šnekučių;3588073618;Ne;8;0;0;8
6211;Pasaka;Šnekučių;1194745876;Ne;1;0;0;1
6212;Pasaka;Šnekučių;1749821746;Ne;7;0;0;7
6213;Pasaka;Šnekučių;1723076060;Ne;0;7;0;7
6214;Pasaka;Šnekučių;8475365713;Taip;5;1;3;9
6215;Pasaka;Šnekučių;5656511105;Ne;7;0;0;7
6216;Pasaka;"KIŠKUČIŲ (Žirmūnų g. 92)";7311929329;Ne;7;0;0;7
6217;Pasaka;"KIŠKUČIŲ (Žirmūnų g. 92)";2368681819;Ne;6;0;0;6
6218;Pasaka;"KIŠKUČIŲ (Žirmūnų g. 92)";5134067973;Taip;5;0;0;5
6219;Pasaka;"KIŠKUČIŲ (Žirmūnų g. 92)";2135527938;Ne;5;0;0;5
6220;Pasaka;"KIŠKUČIŲ (Žirmūnų g. 92)";5073970913;Ne;2;0;0;2
6221;Pasaka;"KIŠKUČIŲ (Žirmūnų g. 92)";5255764606;Ne;0;0;13;13
6222;Pasaka;"KIŠKUČIŲ (Žirmūnų g. 92)";6950137606;Ne;9;0;0;9
6223;Pasaka;"KIŠKUČIŲ (Žirmūnų g. 92)";2575986215;Ne;8;0;0;8
6224;Pasaka;"KIŠKUČIŲ (Žirmūnų g. 92)";4924664211;Ne;2;0;0;2
6225;Pasaka;"KIŠKUČIŲ (Žirmūnų g. 92)";5632714212;Ne;15;0;1;16
6226;Pasaka;"KIŠKUČIŲ (Žirmūnų g. 92)";9928518840;Ne;4;8;0;12
6227;Pasaka;"KIŠKUČIŲ (Žirmūnų g. 92)";7699290051;Ne;8;0;0;8
6228;Pasaka;"KIŠKUČIŲ (Žirmūnų g. 92)";1780063295;Ne;8;0;0;8
6229;Pasaka;"EŽIUKŲ (Žirmūnų g. 92)";4389337333;Taip;10;0;0;10
6230;Pasaka;"EŽIUKŲ (Žirmūnų g. 92)";1527027437;Ne;0;0;3;3
6231;Pasaka;"EŽIUKŲ (Žirmūnų g. 92)";7811540398;Ne;14;0;0;14
6232;Pasaka;"EŽIUKŲ (Žirmūnų g. 92)";7964569326;Ne;14;0;0;14
6233;Pasaka;"EŽIUKŲ (Žirmūnų g. 92)";4061808534;Ne;11;0;0;11
6234;Pasaka;"EŽIUKŲ (Žirmūnų g. 92)";4458246330;Ne;4;0;3;7
6235;Pasaka;"EŽIUKŲ (Žirmūnų g. 92)";5450477466;Ne;0;0;1;1
6236;Pasaka;"EŽIUKŲ (Žirmūnų g. 92)";9409030208;Ne;10;0;0;10
6237;Pasaka;"EŽIUKŲ (Žirmūnų g. 92)";9717417413;Ne;0;0;2;2
6238;Pasaka;"EŽIUKŲ (Žirmūnų g. 92)";6780585061;Ne;8;0;0;8
6239;Pasaka;"EŽIUKŲ (Žirmūnų g. 92)";2313200719;Ne;5;0;1;6
6240;Pasaka;"SAULUČIŲ (Žirmūnų g. 92)";6991062262;Ne;0;0;1;1
6241;Pasaka;"SAULUČIŲ (Žirmūnų g. 92)";1214817944;Ne;7;0;1;8
6242;Pasaka;"SAULUČIŲ (Žirmūnų g. 92)";6087447128;Ne;8;0;0;8
6243;Pasaka;"SAULUČIŲ (Žirmūnų g. 92)";6157459742;Taip;9;0;0;9
6244;Pasaka;"SAULUČIŲ (Žirmūnų g. 92)";9369336996;Ne;5;0;0;5
6245;Pasaka;"SAULUČIŲ (Žirmūnų g. 92)";8866484797;Taip;4;0;2;6
6246;Pasaka;"SAULUČIŲ (Žirmūnų g. 92)";3587648653;Ne;4;1;1;6
6247;Pasaka;"SAULUČIŲ (Žirmūnų g. 92)";6388657745;Ne;4;1;1;6
6248;Pasaka;"SAULUČIŲ (Žirmūnų g. 92)";6280303158;Ne;2;0;2;4
6249;Pasaka;"SAULUČIŲ (Žirmūnų g. 92)";9403892434;Ne;0;0;8;8
6250;Pasaka;"SAULUČIŲ (Žirmūnų g. 92)";8837340945;Ne;3;0;4;7
6251;Pasaka;"SAULUČIŲ (Žirmūnų g. 92)";1083785206;Taip;2;0;0;2
6252;Paslaptis;MONTIKI;1780728941;Ne;1;0;0;1
6253;Paslaptis;MONTIKI;4962917136;Ne;2;0;0;2
6254;Paslaptis;MONTIKI;5908641161;Ne;6;1;1;8
6255;Paslaptis;MONTIKI;3822422339;Ne;5;1;0;6
6256;Paslaptis;MONTIKI;1869254264;Ne;1;0;0;1
6257;Paslaptis;MONTIKI;3463582845;Ne;8;0;0;8
6258;Paslaptis;MONTIKI;7867852953;Ne;8;0;0;8
6259;Paslaptis;MONTIKI;4038980805;Ne;5;0;0;5
6260;Paslaptis;FRUTIKI;4130010071;Ne;0;1;0;1
6261;Paslaptis;FRUTIKI;2105441745;Ne;10;1;0;11
6262;Paslaptis;FRUTIKI;6686352764;Ne;5;0;6;11
6263;Paslaptis;FRUTIKI;8457752288;Ne;4;0;0;4
6264;Paslaptis;FRUTIKI;4159590988;Ne;5;0;0;5
6265;Paslaptis;FRUTIKI;9929877115;Taip;0;6;0;6
6266;Paslaptis;FRUTIKI;6860366087;Taip;0;1;2;3
6267;Paslaptis;FRUTIKI;3572102816;Ne;8;0;0;8
6268;Paslaptis;FRUTIKI;2927014406;Taip;14;0;0;14
6269;Paslaptis;FRUTIKI;7053452493;Ne;0;1;1;2
6270;Paslaptis;FRUTIKI;3963816472;Ne;0;0;1;1
6271;Paslaptis;FRUTIKI;5809630456;Ne;0;6;0;6
6272;Paslaptis;FRUTIKI;6764142182;Ne;6;1;0;7
6273;Paslaptis;FRUTIKI;9299390190;Ne;0;0;1;1
6274;Paslaptis;FRUTIKI;9497654214;Ne;3;0;0;3
6275;Paslaptis;FRUTIKI;5480407965;Ne;14;0;0;14
6276;Paslaptis;KALAMBURIKI;5852939221;Ne;0;1;2;3
6277;Paslaptis;KALAMBURIKI;3104525540;Taip;1;0;0;1
6278;Paslaptis;KALAMBURIKI;3398729758;Ne;2;0;0;2
6279;Paslaptis;KALAMBURIKI;7672102974;Ne;4;0;0;4
6280;Paslaptis;KALAMBURIKI;9100003209;Ne;0;2;0;2
6281;Paslaptis;KALAMBURIKI;3984799090;Taip;0;1;2;3
6282;Paslaptis;KALAMBURIKI;5886364670;Ne;2;0;0;2
6283;Paslaptis;KALAMBURIKI;9066462355;Ne;5;0;0;5
6284;Paslaptis;KALAMBURIKI;2675089401;Ne;2;1;0;3
6285;Paslaptis;KALAMBURIKI;1557783684;Ne;10;0;0;10
6286;Paslaptis;KALAMBURIKI;5206529350;Ne;0;1;1;2
6287;Paslaptis;KALAMBURIKI;5456011928;Ne;0;1;0;1
6288;Paslaptis;KALAMBURIKI;5646806136;Ne;0;0;2;2
6289;Paslaptis;KALAMBURIKI;6098345982;Ne;0;1;0;1
6290;Paslaptis;KALAMBURIKI;4810686225;Ne;0;1;1;2
6291;Paslaptis;KALAMBURIKI;8296575784;Ne;7;1;0;8
6292;Paslaptis;KALAMBURIKI;7638521198;Ne;0;1;3;4
6293;Pasakaitė;Vieversėlių;5162170061;Ne;9;0;1;10
6294;Pasakaitė;Vieversėlių;4316883215;Ne;0;2;0;2
6295;Pasakaitė;Vieversėlių;6682010485;Ne;4;0;0;4
6296;Pasakaitė;Vieversėlių;8478538959;Ne;0;20;0;20
6297;Pasakaitė;Vieversėlių;4098119950;Ne;0;0;1;1
6298;Pasakaitė;Vieversėlių;6160327808;Ne;0;0;2;2
6299;Pasakaitė;Vieversėlių;1705913604;Ne;4;0;0;4
6300;Pasakaitė;Vieversėlių;4898974534;Ne;10;0;0;10
6301;Pasakaitė;Vieversėlių;7885958426;Ne;3;0;0;3
6302;Pasakaitė;Vieversėlių;2041179927;Ne;0;0;1;1
6303;Pasakaitė;Vieversėlių;7965916747;Ne;5;0;2;7
6304;Pasakaitė;Vieversėlių;1279728451;Ne;1;0;0;1
6305;Pasakaitė;Vieversėlių;2584717150;Ne;6;0;2;8
6306;Pasakaitė;Vieversėlių;4397797616;Ne;11;5;0;16
6307;Pasakaitė;Vieversėlių;4659277297;Ne;0;0;7;7
6308;Pasakaitė;Vieversėlių;2899659479;Ne;0;0;2;2
6309;Pasakaitė;Vieversėlių;8160163060;Ne;9;0;2;11
6310;Pasakaitė;Vieversėlių;8350808883;Ne;3;0;0;3
6311;Pasakaitė;Vieversėlių;1122248122;Ne;0;12;0;12
6312;Pasakaitė;Vieversėlių;2801785334;Taip;8;0;1;9
6313;Pasakaitė;Spindulėlių;1697755753;Ne;0;4;0;4
6314;Pasakaitė;Spindulėlių;5791927811;Taip;0;21;0;21
6315;Pasakaitė;Spindulėlių;5094404397;Taip;0;21;0;21
6316;Pasakaitė;Spindulėlių;9870015737;Ne;15;1;0;16
6317;Pasakaitė;Spindulėlių;7474100735;Taip;0;9;0;9
6318;Pasakaitė;Spindulėlių;3381303531;Ne;3;0;1;4
6319;Pasakaitė;Spindulėlių;3652896053;Ne;3;0;0;3
6320;Pasakaitė;Spindulėlių;7265623955;Ne;9;1;1;11
6321;Pasakaitė;Spindulėlių;1564611671;Ne;11;0;0;11
6322;Pasakaitė;Spindulėlių;3283593388;Ne;8;0;0;8
6323;Pasakaitė;Spindulėlių;4268438476;Ne;10;0;0;10
6324;Pasakaitė;Spindulėlių;2340908210;Ne;5;8;0;13
6325;Pasakaitė;Spindulėlių;6229020982;Ne;0;0;2;2
6326;Pasakaitė;Spindulėlių;2278658674;Ne;2;0;0;2
6327;Pasakaitė;Spindulėlių;9982451343;Ne;0;14;0;14
6328;Pasakaitė;Spindulėlių;5745073940;Ne;0;8;0;8
6329;Pasakaitė;Spindulėlių;5180059311;Ne;5;13;1;19
6330;Pasakaitė;Spindulėlių;6745120294;Ne;0;8;0;8
6331;Pasakaitė;Pasagėlių;9895144528;Ne;1;8;0;9
6332;Pasakaitė;Pasagėlių;9409907631;Ne;5;0;3;8
6333;Pasakaitė;Pasagėlių;5589440439;Ne;5;2;0;7
6334;Pasakaitė;Pasagėlių;5959875562;Ne;0;0;3;3
6335;Pasakaitė;Pasagėlių;3355268509;Ne;0;1;0;1
6336;Pasakaitė;Pasagėlių;1959599606;Ne;0;0;3;3
6337;Pasakaitė;Pasagėlių;9238905834;Taip;0;9;0;9
6338;Pasakaitė;Pasagėlių;7666033916;Ne;5;3;0;8
6339;Pasakaitė;Pasagėlių;7219080600;Ne;0;6;0;6
6340;Pasakaitė;Pasagėlių;8264189678;Ne;5;0;1;6
6341;Pasakaitė;Pasagėlių;2341175137;Ne;0;0;1;1
6342;Pasakaitė;Pasagėlių;8905681529;Ne;0;0;1;1
6343;Pasakaitė;Pasagėlių;8165055476;Ne;0;4;0;4
6344;Pasakaitė;Pasagėlių;9645230615;Ne;8;0;0;8
6345;Pasakaitė;Švyturėlių;7702359586;Ne;5;1;0;6
6346;Pasakaitė;Švyturėlių;6847782430;Ne;0;7;0;7
6347;Pasakaitė;Švyturėlių;2404448954;Ne;0;0;1;1
6348;Pasakaitė;Švyturėlių;9821617981;Ne;6;0;2;8
6349;Pasakaitė;Švyturėlių;2329827275;Ne;0;0;1;1
6350;Pasakaitė;Švyturėlių;5498393070;Ne;7;0;1;8
6351;Pasakaitė;Švyturėlių;9012098645;Ne;10;0;0;10
6352;Pasakaitė;Švyturėlių;3417077517;Ne;0;0;1;1
6353;Pasakaitė;Švyturėlių;1793453325;Ne;0;0;2;2
6354;Pasakaitė;Švyturėlių;4694818333;Ne;0;0;1;1
6355;Pasakaitė;Švyturėlių;5115067331;Ne;0;5;0;5
6356;Pasakaitė;Švyturėlių;6522727154;Ne;3;1;3;7
6357;Pasakaitė;Švyturėlių;4977052991;Ne;2;0;0;2
6358;Pasakaitė;Švyturėlių;7604996145;Ne;20;0;0;20
6359;Pasakaitė;Švyturėlių;4144569088;Ne;0;0;1;1
6360;Pasakaitė;Švyturėlių;7539851375;Ne;10;0;0;10
6361;Pasakaitė;Švyturėlių;2546550685;Ne;0;0;1;1
6362;Pasakaitė;Švyturėlių;8381083251;Ne;20;0;0;20
6363;Pasakaitė;Švyturėlių;9606533767;Ne;0;0;2;2
6364;Pasakaitė;Švyturėlių;2902368705;Ne;5;0;0;5
6365;Pasakaitė;Švyturėlių;3659371923;Ne;2;0;0;2
6366;Pasakaitė;Kodėlčiukų;8662488739;Ne;0;0;1;1
6367;Pasakaitė;Kodėlčiukų;9972985920;Taip;0;7;0;7
6368;Pasakaitė;Kodėlčiukų;5699688792;Ne;9;0;1;10
6369;Pasakaitė;Kodėlčiukų;9441990175;Taip;5;0;5;10
6370;Pasakaitė;Kodėlčiukų;4485053261;Ne;0;0;4;4
6371;Pasakaitė;Kodėlčiukų;9351971114;Ne;0;0;1;1
6372;Pasakaitė;Kodėlčiukų;2303884875;Ne;5;0;1;6
6373;Pasakaitė;Kodėlčiukų;4878562841;Ne;11;0;4;15
6374;Pasakaitė;Kodėlčiukų;2994653871;Ne;0;0;3;3
6375;Pasakaitė;Kodėlčiukų;4881361200;Ne;0;0;2;2
6376;Pasakaitė;Kodėlčiukų;2389832646;Ne;0;8;0;8
6377;Pasakaitė;Kodėlčiukų;7138417196;Ne;5;0;1;6
6378;Pasakaitė;Kodėlčiukų;5581264184;Ne;0;2;0;2
6379;Pasakaitė;Kodėlčiukų;8037316673;Ne;9;0;0;9
6380;Pasakaitė;Kodėlčiukų;5732009054;Ne;0;6;0;6
6381;Pasakaitė;Kodėlčiukų;6755983130;Ne;5;0;1;6
6382;Pasakaitė;Kodėlčiukų;2476010561;Ne;5;3;0;8
6383;Pasakaitė;Kodėlčiukų;3925034196;Ne;5;3;0;8
6384;Pasakaitė;Kodėlčiukų;9512782063;Ne;1;0;1;2
6385;Pasakaitė;Gudručių;1513903341;Ne;0;2;0;2
6386;Pasakaitė;Gudručių;6736879757;Ne;20;0;0;20
6387;Pasakaitė;Gudručių;2194313054;Taip;0;11;0;11
6388;Pasakaitė;Gudručių;7963057831;Ne;0;1;0;1
6389;Pasakaitė;Gudručių;3444442287;Ne;0;0;2;2
6390;Pasakaitė;Gudručių;4191875802;Ne;0;0;6;6
6391;Pasakaitė;Gudručių;4882856664;Ne;0;0;1;1
6392;Pasakaitė;Gudručių;5485965486;Ne;5;6;0;11
6393;Pasakaitė;Gudručių;7685647972;Ne;5;0;0;5
6394;Pasakaitė;Gudručių;2849753418;Ne;5;0;0;5
6395;Pasakaitė;Gudručių;9018830962;Ne;0;4;0;4
6396;Pasakaitė;Gudručių;6459145539;Ne;0;1;0;1
6397;Pasakaitė;Gudručių;5948958906;Ne;0;1;0;1
6398;Pasakaitė;Gudručių;1060914693;Ne;0;1;2;3
6399;Pasakaitė;Gudručių;4864779439;Taip;0;0;1;1
6400;Pasakaitė;Gudručių;8223662339;Ne;0;0;2;2
6401;Pasakaitė;Čiulbonėlių;7526264241;Ne;0;0;2;2
6402;Pasakaitė;Čiulbonėlių;4974486850;Ne;0;0;2;2
6403;Pasakaitė;Čiulbonėlių;7607522887;Ne;0;0;3;3
6404;Pasakaitė;Čiulbonėlių;3606601644;Ne;0;6;0;6
6405;Pasakaitė;Čiulbonėlių;3579498202;Ne;0;0;4;4
6406;Pasakaitė;Čiulbonėlių;1220619991;Ne;0;0;4;4
6407;Pasakaitė;Čiulbonėlių;7790937149;Ne;7;0;0;7
6408;Pasakaitė;Čiulbonėlių;3400305768;Ne;7;0;0;7
6409;Pasakaitė;Čiulbonėlių;4604843442;Ne;0;5;0;5
6410;Pasakaitė;Čiulbonėlių;1056358241;Ne;9;3;0;12
6411;Pasakaitė;Čiulbonėlių;2652882309;Ne;0;5;0;5
6412;Pasakaitė;Čiulbonėlių;1449037968;Ne;5;5;0;10
6413;Pasakaitė;Čiulbonėlių;6714500298;Ne;0;6;0;6
6414;Pasakaitė;Čiulbonėlių;1184513606;Ne;0;0;2;2
6415;Pasakaitė;"Verpstelių ";4946855684;Ne;0;4;0;4
6416;Pasakaitė;"Verpstelių ";5556362727;Ne;0;0;3;3
6417;Pasakaitė;"Verpstelių ";7451624229;Ne;0;0;1;1
6418;Pasakaitė;"Verpstelių ";7759051761;Taip;4;4;0;8
6419;Pasakaitė;"Verpstelių ";8315840473;Ne;0;0;2;2
6420;Pasakaitė;"Verpstelių ";1425166722;Ne;7;0;0;7
6421;Pasakaitė;"Verpstelių ";7813221735;Ne;5;15;0;20
6422;Pasakaitė;"Verpstelių ";4246461594;Ne;0;0;3;3
6423;Pasakaitė;"Verpstelių ";1963102227;Ne;0;0;4;4
6424;Pasakaitė;"Verpstelių ";8267725352;Ne;4;0;0;4
6425;Pasakaitė;"Verpstelių ";8562284745;Taip;11;2;0;13
6426;Pasakaitė;"Verpstelių ";1041405418;Ne;0;5;0;5
6427;Pasakaitė;"Verpstelių ";7976921380;Ne;0;2;0;2
6428;Pasakaitė;"Verpstelių ";2505815026;Ne;11;0;1;12
6429;Pasakaitė;"Verpstelių ";5413457806;Ne;0;2;0;2
6430;Pasakaitė;"Verpstelių ";1115383380;Ne;5;0;9;14
6431;Pasakaitė;"Verpstelių ";2714905466;Ne;0;0;3;3
6432;Pasakaitė;"Verpstelių ";9226989209;Ne;11;1;0;12
6433;Pasakaitė;"Verpstelių ";8927014508;Ne;0;0;2;2
6434;Pasakaitė;Smalsučiai;7994712153;Ne;1;0;4;5
6435;Pasakaitė;Smalsučiai;1271645870;Ne;15;0;2;17
6436;Pasakaitė;Smalsučiai;6266150515;Taip;0;20;0;20
6437;Pasakaitė;Smalsučiai;7193659817;Ne;0;5;0;5
6438;Pasakaitė;Smalsučiai;3359676586;Ne;4;0;2;6
6439;Pasakaitė;Smalsučiai;3041099329;Ne;5;0;2;7
6440;Pasakaitė;Smalsučiai;6446178994;Ne;15;0;0;15
6441;Pasakaitė;Smalsučiai;6803651332;Ne;3;0;0;3
6442;Pasakaitė;Smalsučiai;3191302999;Ne;0;0;1;1
6443;Pasakaitė;Smalsučiai;2301346026;Ne;3;0;1;4
6444;Pasakaitė;Smalsučiai;7515747335;Taip;0;17;0;17
6445;Pasakaitė;Smalsučiai;8398100438;Taip;16;0;0;16
6446;Pasakaitė;Smalsučiai;4413770207;Ne;15;0;0;15
6447;Pasakaitė;Smalsučiai;8181710494;Ne;7;0;0;7
6448;Pasakaitė;"Čiauškučiai ";7585900157;Ne;15;0;0;15
6449;Pasakaitė;"Čiauškučiai ";2182900696;Ne;0;20;0;20
6450;Pasakaitė;"Čiauškučiai ";7378144738;Ne;15;3;0;18
6451;Pasakaitė;"Čiauškučiai ";9335770325;Ne;7;0;0;7
6452;Pasakaitė;"Čiauškučiai ";2780813752;Ne;10;6;0;16
6453;Pasakaitė;"Čiauškučiai ";5202153993;Taip;0;20;0;20
6454;Pasakaitė;"Čiauškučiai ";3329580710;Ne;3;0;0;3
6455;Pasakaitė;"Čiauškučiai ";4189572117;Ne;12;1;0;13
6456;Pasakaitė;"Čiauškučiai ";6756484192;Ne;11;0;0;11
6457;Pasakaitė;"Čiauškučiai ";6033454938;Taip;7;0;0;7
6458;Pasakaitė;"Čiauškučiai ";7118164408;Ne;11;6;0;17
6459;Pasakaitė;"Čiauškučiai ";9823031346;Ne;11;6;0;17
6460;Pasakaitė;"Čiauškučiai ";1400956305;Ne;5;0;0;5
6461;Pasakaitė;Pabiručiai;9790988677;Ne;0;9;0;9
6462;Pasakaitė;Pabiručiai;5439936572;Ne;0;6;0;6
6463;Pasakaitė;Pabiručiai;3466308130;Ne;4;0;0;4
6464;Pasakaitė;Pabiručiai;9402238675;Ne;0;1;0;1
6465;Pasakaitė;Pabiručiai;4852610052;Ne;0;10;0;10
6466;Pasakaitė;Pabiručiai;9285254916;Ne;9;0;0;9
6467;Pasakaitė;Pabiručiai;6025275102;Ne;6;2;0;8
6468;Pasakaitė;Pabiručiai;7902661691;Ne;0;0;1;1
6469;Pasakaitė;Pabiručiai;2398839782;Ne;8;0;0;8
6470;Pasakaitė;Pabiručiai;3552340609;Ne;10;0;0;10
6471;Pasakaitė;Pabiručiai;2332609415;Taip;12;0;1;13
6472;Pasakaitė;Pabiručiai;4081701824;Ne;10;4;0;14
6473;Pasakaitė;Pabiručiai;8340813023;Ne;0;0;1;1
6474;Pasakaitė;Pabiručiai;3070478547;Ne;0;12;0;12
6475;Pasakaitė;Linksmučiai;8252123824;Ne;14;0;0;14
6476;Pasakaitė;Linksmučiai;4444725869;Taip;5;0;0;5
6477;Pasakaitė;Linksmučiai;3049219840;Ne;11;0;1;12
6478;Pasakaitė;Linksmučiai;9190078546;Ne;0;0;2;2
6479;Pasakaitė;Linksmučiai;5274145775;Ne;0;0;5;5
6480;Pasakaitė;Linksmučiai;9690867215;Ne;7;0;0;7
6481;Pasakaitė;Linksmučiai;1117035233;Ne;6;0;2;8
6482;Pasakaitė;Linksmučiai;8055084637;Ne;0;0;1;1
6483;Pasakaitė;Linksmučiai;5058070480;Taip;15;0;0;15
6484;Pasakaitė;Linksmučiai;9311649698;Ne;0;2;1;3
6485;Pasakaitė;Linksmučiai;5499373802;Ne;0;2;0;2
6486;Pasakaitė;Linksmučiai;4307883488;Ne;15;2;0;17
6487;Pasakaitė;Linksmučiai;3691817711;Ne;4;0;0;4
6488;Pelenė;Varpelis;2647876561;Ne;5;1;0;6
6489;Pelenė;Varpelis;8807342148;Ne;3;0;4;7
6490;Pelenė;Varpelis;5697826755;Ne;3;0;0;3
6491;Pelenė;Varpelis;4004975235;Ne;7;0;0;7
6492;Pelenė;Varpelis;8790613872;Ne;8;0;0;8
6493;Pelenė;Varpelis;2487632125;Ne;0;0;2;2
6494;Pelenė;Varpelis;5228983908;Ne;3;0;0;3
6495;Pelenė;Varpelis;3174009848;Ne;0;0;3;3
6496;Pelenė;Varpelis;6524101295;Ne;6;0;0;6
6497;Pelenė;Varpelis;4373886054;Ne;6;1;0;7
6498;Pelenė;Varpelis;8038559319;Ne;1;0;0;1
6499;Pelenė;Varpelis;7578318198;Ne;3;1;0;4
6500;Pelenė;Varpelis;9447223913;Ne;2;0;2;4
6501;Pelenė;Varpelis;6894978459;Ne;11;1;0;12
6502;Pelenė;Varpelis;6864263698;Ne;17;0;0;17
6503;Pelenė;Saulutės;8718308575;Ne;0;20;0;20
6504;Pelenė;Saulutės;6867256280;Ne;2;0;0;2
6505;Pelenė;Saulutės;4396011355;Ne;4;0;0;4
6506;Pelenė;Saulutės;6304818782;Ne;0;2;0;2
6507;Pelenė;Saulutės;1975574464;Ne;4;0;0;4
6508;Pelenė;Saulutės;5024793693;Ne;0;1;0;1
6509;Pelenė;Saulutės;2952739501;Ne;0;2;3;5
6510;Pelenė;Saulutės;6567413229;Ne;0;0;1;1
6511;Pelenė;Saulutės;6231387335;Ne;0;16;0;16
6512;Pelenė;Saulutės;4068236246;Ne;14;0;0;14
6513;Pelenė;Saulutės;3700618977;Ne;6;0;0;6
6514;Pelenė;Saulutės;5872711862;Ne;5;0;0;5
6515;Pelenė;Saulutės;3060502977;Ne;0;0;1;1
6516;Pelenė;Saulutės;2083848693;Ne;5;1;0;6
6517;Pelenė;Raktelis;4023923887;Ne;16;0;0;16
6518;Pelenė;Raktelis;4859437855;Ne;0;18;0;18
6519;Pelenė;Raktelis;5028095861;Ne;9;2;0;11
6520;Pelenė;Raktelis;5926700157;Ne;12;0;0;12
6521;Pelenė;Raktelis;5762403752;Ne;0;1;0;1
6522;Pelenė;Raktelis;7926586349;Ne;6;0;0;6
6523;Pelenė;Raktelis;2986690431;Ne;5;0;0;5
6524;Pelenė;Raktelis;4660385383;Ne;16;0;0;16
6525;Pelenė;Raktelis;4305733824;Ne;0;4;0;4
6526;Pelenė;Raktelis;8862429244;Taip;19;0;0;19
6527;Pelenė;Raktelis;9505945890;Ne;2;0;0;2
6528;Pelenė;Raktelis;8961082265;Ne;0;1;0;1
6529;Pelenė;Raktelis;2882716674;Ne;5;0;0;5
6530;Pelenė;Raktelis;4051874126;Ne;0;1;0;1
6531;Pelenė;Raktelis;5970146724;Ne;15;0;0;15
6532;Pelenė;Raktelis;1424479862;Ne;9;0;0;9
6533;Pelenė;Raktelis;1197137607;Ne;8;0;0;8
6534;Pelenė;Raktelis;9769835612;Ne;1;0;0;1
6535;Pelenė;Žvaigždutės;7064742769;Ne;0;0;1;1
6536;Pelenė;Žvaigždutės;9473901831;Ne;4;0;1;5
6537;Pelenė;Žvaigždutės;5548367924;Ne;0;0;8;8
6538;Pelenė;Žvaigždutės;5031778158;Ne;0;6;0;6
6539;Pelenė;Žvaigždutės;4056676361;Ne;0;0;5;5
6540;Pelenė;Žvaigždutės;4602503400;Ne;0;6;0;6
6541;Pelenė;Žvaigždutės;2555464779;Ne;0;1;0;1
6542;Pelenė;Žvaigždutės;9530531472;Ne;10;3;0;13
6543;Pelenė;Žvaigždutės;7640768043;Ne;0;0;1;1
6544;Pelenė;Žvaigždutės;4856039707;Ne;0;5;0;5
6545;Pelenė;Žvaigždutės;4109516555;Ne;0;6;0;6
6546;Pelenė;Žvaigždutės;5357701072;Ne;0;0;13;13
6547;Pelenė;Žvaigždutės;7426299485;Ne;0;0;3;3
6548;Pelenė;Žvaigždutės;1136986980;Ne;9;0;0;9
6549;Pelenė;Nykštukas;1060619471;Ne;4;1;0;5
6550;Pelenė;Nykštukas;9195113444;Ne;0;0;3;3
6551;Pelenė;Nykštukas;4448592497;Ne;4;0;0;4
6552;Pelenė;Nykštukas;5333802902;Ne;0;10;0;10
6553;Pelenė;Nykštukas;4591637887;Ne;0;0;2;2
6554;Pelenė;Nykštukas;4090532624;Ne;10;3;0;13
6555;Pelenė;Nykštukas;8123162647;Ne;0;0;3;3
6556;Pelenė;Nykštukas;7659625628;Ne;0;0;4;4
6557;Pelenė;Nykštukas;6375060159;Ne;0;7;0;7
6558;Pelenė;Nykštukas;6419661741;Ne;7;0;1;8
6559;Pelenė;Nykštukas;5063098703;Taip;4;0;0;4
6560;Pelenė;Nykštukas;4089199552;Ne;0;0;3;3
6561;Pelenė;Nykštukas;6038229659;Ne;8;0;0;8
6562;Pelenė;Nykštukas;2241816838;Ne;5;0;0;5
6563;Pelenė;Nykštukas;5389865440;Ne;6;0;0;6
6564;Pelenė;Žirniukai;2270989478;Ne;0;19;0;19
6565;Pelenė;Žirniukai;6661371876;Ne;8;0;0;8
6566;Pelenė;Žirniukai;2590035984;Ne;0;2;0;2
6567;Pelenė;Žirniukai;9601582419;Ne;13;0;0;13
6568;Pelenė;Žirniukai;7959433937;Taip;11;0;0;11
6569;Pelenė;Žirniukai;7057752202;Ne;4;0;0;4
6570;Pelenė;Žirniukai;7399112026;Ne;0;11;0;11
6571;Pelenė;Žirniukai;5686182866;Ne;1;0;0;1
6572;Pelenė;Žirniukai;2443906444;Ne;1;0;0;1
6573;Pelenė;Žirniukai;3863839750;Taip;6;0;0;6
6574;Pelenė;Žirniukai;5922348478;Ne;5;0;0;5
6575;Pelenė;Žirniukai;1313425695;Ne;0;1;0;1
6576;Pelenė;Žirniukai;2068793184;Ne;0;11;0;11
6577;Pelenė;Žirniukai;7383544475;Ne;0;16;0;16
6578;Pelenė;Žirniukai;1595627222;Ne;0;8;0;8
6579;Pelenė;Žirniukai;2438266396;Ne;0;3;0;3
6580;Pelenė;Žirniukai;1486025741;Ne;5;0;0;5
6581;Pelenė;Žirniukai;8685140364;Taip;0;4;0;4
6582;Pelenė;Lašeliai;7017031073;Ne;3;0;0;3
6583;Pelenė;Lašeliai;9313153383;Ne;0;10;0;10
6584;Pelenė;Lašeliai;6316640679;Ne;14;0;0;14
6585;Pelenė;Lašeliai;1711603372;Ne;15;3;0;18
6586;Pelenė;Lašeliai;1944933777;Ne;0;11;0;11
6587;Pelenė;Lašeliai;2303618074;Ne;10;0;0;10
6588;Pelenė;Lašeliai;6167965418;Ne;7;0;1;8
6589;Pelenė;Lašeliai;2765650058;Ne;0;0;1;1
6590;Pelenė;Lašeliai;4431474395;Ne;8;0;0;8
6591;Pelenė;Lašeliai;9097123374;Ne;9;1;0;10
6592;Pelenė;Lašeliai;9162252512;Ne;5;0;0;5
6593;Pelenė;Lašeliai;4695104609;Ne;0;5;0;5
6594;Pelenė;Lašeliai;7148956863;Ne;0;1;0;1
6595;Pelenė;Lašeliai;1303066945;Ne;10;0;0;10
6596;Pelenė;Lašeliai;3563882751;Ne;0;1;0;1
6597;Pelenė;Grūdelis;6790396551;Ne;6;0;0;6
6598;Pelenė;Grūdelis;6221703608;Ne;5;0;0;5
6599;Pelenė;Grūdelis;7880284433;Ne;4;0;0;4
6600;Pelenė;Grūdelis;4989239822;Ne;0;0;1;1
6601;Pelenė;Grūdelis;6481466282;Ne;0;0;2;2
6602;Pelenė;Grūdelis;6267178572;Ne;0;5;0;5
6603;Pelenė;Grūdelis;1468658102;Ne;9;0;0;9
6604;Pelenė;Grūdelis;1573848786;Ne;5;0;0;5
6605;Pelenė;Grūdelis;7985634731;Ne;2;0;1;3
6606;Pelenė;Grūdelis;1555782878;Ne;6;0;1;7
6607;Pelenė;Grūdelis;7858530013;Taip;0;9;0;9
6608;Pelenė;Grūdelis;7702502252;Ne;0;1;0;1
6609;Pelenė;Grūdelis;6678273450;Ne;2;0;0;2
6610;Pelenė;Grūdelis;6648966721;Ne;0;0;2;2
6611;Pelenė;Grūdelis;2544725334;Ne;0;0;1;1
6612;Pelenė;Braškytė;8504675439;Ne;0;8;0;8
6613;Pelenė;Braškytė;6306403720;Ne;7;1;0;8
6614;Pelenė;Braškytė;5243889672;Ne;6;0;0;6
6615;Pelenė;Braškytė;6213281783;Ne;3;0;0;3
6616;Pelenė;Braškytė;9123459933;Ne;10;0;0;10
6617;Pelenė;Braškytė;6325462265;Ne;0;0;1;1
6618;Pelenė;Braškytė;1124834153;Ne;0;0;1;1
6619;Pelenė;Braškytė;2425992275;Ne;20;0;0;20
6620;Pelenė;Braškytė;5215324103;Ne;20;0;0;20
6621;Pelenė;Braškytė;1783529770;Ne;9;4;0;13
6622;Pelenė;Braškytė;6181640181;Ne;12;0;0;12
6623;Pelenė;Braškytė;7143533875;Ne;1;0;0;1
6624;Pelenė;Braškytė;8977625247;Ne;9;0;0;9
6625;Pelenė;Braškytė;6154342149;Ne;0;0;1;1
6626;Pelenė;Braškytė;7171545733;Ne;17;2;0;19
6627;Pelenė;Braškytė;6025404134;Ne;0;12;0;12
6628;Pelenė;Boružėlės;4955162765;Ne;10;0;0;10
6629;Pelenė;Boružėlės;3200796745;Ne;4;0;0;4
6630;Pelenė;Boružėlės;6427008429;Ne;4;0;0;4
6631;Pelenė;Boružėlės;1075220572;Ne;5;0;0;5
6632;Pelenė;Boružėlės;8325318483;Ne;4;0;0;4
6633;Pelenė;Boružėlės;8732297405;Ne;2;0;0;2
6634;Pelenė;Boružėlės;5845118981;Taip;9;0;0;9
6635;Pelenė;Boružėlės;8942422475;Ne;5;0;3;8
6636;Pelenė;Boružėlės;9554893953;Taip;20;0;0;20
6637;Pelenė;Boružėlės;7320738947;Ne;4;0;0;4
6638;Pelenė;Boružėlės;3004297722;Ne;16;0;0;16
6639;Pelenė;Boružėlės;7794147237;Ne;7;0;0;7
6640;Pelenė;Boružėlės;9772543894;Ne;3;0;0;3
6641;Pelenė;Boružėlės;6226160316;Ne;2;1;0;3
6642;Pelenė;Saldainiukai;2689903631;Ne;0;11;0;11
6643;Pelenė;Saldainiukai;3499827987;Ne;4;0;0;4
6644;Pelenė;Saldainiukai;8165766331;Ne;5;0;0;5
6645;Pelenė;Saldainiukai;2096373376;Ne;0;7;0;7
6646;Pelenė;Saldainiukai;1384382692;Ne;6;0;0;6
6647;Pelenė;Saldainiukai;4734502322;Ne;4;2;0;6
6648;Pelenė;Saldainiukai;7602432318;Ne;5;0;1;6
6649;Pelenė;Saldainiukai;8861981715;Ne;0;0;2;2
6650;Pelenė;Saldainiukai;7599381657;Taip;5;0;0;5
6651;Pelenė;Saldainiukai;2123466599;Ne;4;0;0;4
6652;Pelenė;Saldainiukai;2661260892;Ne;0;18;0;18
6653;Pelenė;Saldainiukai;2824244303;Ne;6;0;0;6
6654;Pelenė;Saldainiukai;1081582842;Ne;0;0;1;1
6655;Pelenė;Drugeliai;2540405047;Ne;10;0;1;11
6656;Pelenė;Drugeliai;3603352172;Ne;8;0;3;11
6657;Pelenė;Drugeliai;5084452088;Ne;0;11;0;11
6658;Pelenė;Drugeliai;6834792589;Ne;3;1;0;4
6659;Pelenė;Drugeliai;9810123679;Ne;0;8;0;8
6660;Pelenė;Drugeliai;1048899958;Ne;0;0;3;3
6661;Pelenė;Drugeliai;3327213856;Ne;7;0;0;7
6662;Pelenė;Drugeliai;1274729537;Ne;0;0;1;1
6663;Pelenė;Drugeliai;3205331614;Ne;5;0;0;5
6664;Pelenė;Drugeliai;2163737781;Ne;0;11;0;11
6665;Pelenė;Drugeliai;9004080625;Ne;0;11;0;11
6666;Pelenė;Drugeliai;7565331966;Taip;3;2;0;5
6667;Pelenė;Drugeliai;5074054534;Ne;0;7;0;7
6668;Pelenė;Drugeliai;8194354176;Ne;0;4;0;4
6669;Pelenė;Drugeliai;5579900958;Ne;0;0;3;3
6670;Pipiras;EŽIUKAI;5512049762;Ne;0;1;0;1
6671;Pipiras;EŽIUKAI;1711168196;Ne;0;1;0;1
6672;Pipiras;EŽIUKAI;4017042461;Ne;0;6;0;6
6673;Pipiras;EŽIUKAI;4725221169;Ne;0;3;0;3
6674;Pipiras;EŽIUKAI;8422419380;Ne;0;2;0;2
6675;Pipiras;EŽIUKAI;4811029230;Taip;0;1;6;7
6676;Pipiras;EŽIUKAI;6363349541;Taip;0;1;0;1
6677;Pipiras;EŽIUKAI;4426479971;Taip;3;1;0;4
6678;Pipiras;BITUTĖS;3851239592;Ne;15;0;0;15
6679;Pipiras;BITUTĖS;1645482584;Ne;0;2;0;2
6680;Pipiras;BITUTĖS;9050423801;Ne;0;1;0;1
6681;Pipiras;BITUTĖS;5047070127;Ne;5;0;0;5
6682;Pipiras;BITUTĖS;9394456452;Ne;18;0;0;18
6683;Pipiras;BITUTĖS;9610070604;Ne;0;1;0;1
6684;Pipiras;BITUTĖS;7009194986;Ne;20;0;0;20
6685;Pipiras;BITUTĖS;9950318827;Ne;0;1;0;1
6686;Pipiras;BITUTĖS;9733577233;Ne;18;0;0;18
6687;Pipiras;BITUTĖS;8983392098;Ne;6;1;0;7
6688;Pipiras;BITUTĖS;2337751973;Ne;0;13;0;13
6689;Pipiras;BITUTĖS;9540765088;Taip;1;0;0;1
6690;Pipiras;BITUTĖS;5735018704;Ne;3;0;0;3
6691;Pipiras;NYKŠTUKAI;6696824728;Taip;6;0;0;6
6692;Pipiras;NYKŠTUKAI;1169481984;Ne;2;0;3;5
6693;Pipiras;NYKŠTUKAI;4198534687;Ne;0;4;0;4
6694;Pipiras;NYKŠTUKAI;4458730479;Ne;12;0;0;12
6695;Pipiras;NYKŠTUKAI;3980950261;Ne;0;2;0;2
6696;Pipiras;NYKŠTUKAI;7828638329;Ne;2;0;1;3
6697;Pipiras;NYKŠTUKAI;6775489564;Ne;8;0;3;11
6698;Pipiras;NYKŠTUKAI;7747049622;Ne;5;5;0;10
6699;Pipiras;NYKŠTUKAI;9892201598;Ne;5;4;0;9
6700;Pipiras;NYKŠTUKAI;7371386368;Ne;0;1;0;1
6701;Pipiras;NYKŠTUKAI;1019753152;Ne;0;2;0;2
6702;Pipiras;NYKŠTUKAI;9499869533;Ne;0;0;1;1
6703;Pipiras;NYKŠTUKAI;5141447649;Ne;0;0;2;2
6704;Pipiras;NYKŠTUKAI;9877682150;Ne;0;1;0;1
6705;Pipiras;NYKŠTUKAI;9248925267;Ne;0;2;0;2
6706;Pipiras;NYKŠTUKAI;9711147855;Ne;0;0;3;3
6707;Pipiras;NYKŠTUKAI;2120810457;Ne;0;20;0;20
6708;Pipiras;PELĖDŽIUKAI;8985065850;Ne;9;1;1;11
6709;Pipiras;PELĖDŽIUKAI;3647356600;Ne;7;0;0;7
6710;Pipiras;PELĖDŽIUKAI;6465109403;Taip;6;0;0;6
6711;Pipiras;PELĖDŽIUKAI;6905506774;Ne;20;0;0;20
6712;Pipiras;PELĖDŽIUKAI;7446225835;Ne;14;2;0;16
6713;Pipiras;PELĖDŽIUKAI;8800890503;Ne;5;1;0;6
6714;Pipiras;PELĖDŽIUKAI;6184943213;Ne;0;1;0;1
6715;Pipiras;PELĖDŽIUKAI;3299099535;Ne;4;1;0;5
6716;Pipiras;PELĖDŽIUKAI;5502186385;Ne;5;0;0;5
6717;Pipiras;PELĖDŽIUKAI;8707560610;Ne;2;1;2;5
6718;Pipiras;PELĖDŽIUKAI;4282267631;Ne;0;0;1;1
6719;Pipiras;PELĖDŽIUKAI;4940053409;Ne;6;0;0;6
6720;Pipiras;PELĖDŽIUKAI;2588075386;Ne;0;3;0;3
6721;Pipiras;PELĖDŽIUKAI;6666112357;Ne;0;1;0;1
6722;Pipiras;PELĖDŽIUKAI;9473056714;Ne;5;15;0;20
6723;Pipiras;DRUGELIAI;6018174577;Ne;5;0;1;6
6724;Pipiras;DRUGELIAI;1393570307;Ne;6;0;1;7
6725;Pipiras;DRUGELIAI;3216664984;Ne;0;20;0;20
6726;Pipiras;DRUGELIAI;9307622469;Ne;0;5;0;5
6727;Pipiras;DRUGELIAI;6925577945;Ne;0;2;1;3
6728;Pipiras;DRUGELIAI;9422467047;Ne;0;0;4;4
6729;Pipiras;DRUGELIAI;4743474665;Ne;0;16;0;16
6730;Pipiras;DRUGELIAI;9552763906;Ne;1;2;1;4
6731;Pipiras;DRUGELIAI;2159315426;Ne;5;2;0;7
6732;Pipiras;DRUGELIAI;3641496225;Ne;0;4;0;4
6733;Pipiras;DRUGELIAI;5035593032;Ne;0;0;1;1
6734;Pipiras;DRUGELIAI;6361544649;Ne;0;1;0;1
6735;Pipiras;DRUGELIAI;1079088070;Ne;0;1;0;1
6736;Pipiras;GĖLYTĖS;2095794125;Ne;6;0;0;6
6737;Pipiras;GĖLYTĖS;8675473349;Ne;2;0;0;2
6738;Pipiras;GĖLYTĖS;4945164161;Ne;11;4;0;15
6739;Pipiras;GĖLYTĖS;5150723052;Taip;3;0;0;3
6740;Pipiras;GĖLYTĖS;3755824911;Ne;0;2;3;5
6741;Pipiras;GĖLYTĖS;6453274205;Ne;5;1;0;6
6742;Pipiras;GĖLYTĖS;4559954910;Ne;0;12;0;12
6743;Pipiras;GĖLYTĖS;7157187063;Ne;0;14;0;14
6744;Pipiras;GĖLYTĖS;4021613243;Ne;0;1;0;1
6745;Pipiras;GĖLYTĖS;1611488078;Ne;1;6;2;9
6746;Pipiras;GĖLYTĖS;4236597883;Ne;10;0;1;11
6747;Pipiras;GĖLYTĖS;4289497197;Ne;0;3;0;3
6748;Pipiras;GĖLYTĖS;2474548836;Taip;5;2;0;7
6749;Pipiras;GĖLYTĖS;8553422709;Ne;7;0;0;7
6750;Pipiras;GĖLYTĖS;5738334591;Ne;0;1;0;1
6751;Pipiras;GĖLYTĖS;6428525902;Ne;11;0;3;14
6752;Pipiras;GĖLYTĖS;8354158722;Ne;0;4;0;4
6753;Pipiras;BORUŽĖLĖS;4707794599;Ne;2;2;0;4
6754;Pipiras;BORUŽĖLĖS;8673271201;Ne;0;0;1;1
6755;Pipiras;BORUŽĖLĖS;8508292428;Ne;0;1;0;1
6756;Pipiras;BORUŽĖLĖS;1210940213;Ne;0;1;0;1
6757;Pipiras;BORUŽĖLĖS;9097987789;Taip;0;5;0;5
6758;Pipiras;BORUŽĖLĖS;8959946514;Taip;13;0;0;13
6759;Pipiras;BORUŽĖLĖS;8443786510;Ne;0;1;0;1
6760;Pipiras;BORUŽĖLĖS;1146369304;Ne;0;5;0;5
6761;Pipiras;BORUŽĖLĖS;9970587185;Ne;4;0;0;4
6762;Pipiras;BORUŽĖLĖS;6344932171;Ne;0;0;2;2
6763;Pipiras;BORUŽĖLĖS;9425682286;Ne;0;1;0;1
6764;Pipiras;SKRUZDĖLIUKAI;2483867901;Ne;8;2;0;10
6765;Pipiras;SKRUZDĖLIUKAI;1315372873;Ne;0;3;0;3
6766;Pipiras;SKRUZDĖLIUKAI;9372109848;Ne;4;12;0;16
6767;Pipiras;SKRUZDĖLIUKAI;3768825314;Ne;8;0;0;8
6768;Pipiras;SKRUZDĖLIUKAI;4309096743;Ne;4;0;1;5
6769;Pipiras;SKRUZDĖLIUKAI;2399588759;Ne;0;1;0;1
6770;Pipiras;SKRUZDĖLIUKAI;8081343184;Ne;0;10;0;10
6771;Pipiras;SKRUZDĖLIUKAI;9852475056;Ne;6;2;0;8
6772;Pipiras;SKRUZDĖLIUKAI;6176818802;Ne;7;0;1;8
6773;Pipiras;SKRUZDĖLIUKAI;1215623527;Ne;0;3;0;3
6774;Pipiras;SKRUZDĖLIUKAI;7211189491;Ne;0;17;0;17
6775;Pipiras;SKRUZDĖLIUKAI;6092576917;Ne;2;0;0;2
6776;Pipiras;SKRUZDĖLIUKAI;4321420201;Ne;0;17;0;17
6777;Pipiras;ŽVIRBLIUKŲ;6342044341;Ne;0;1;0;1
6778;Pipiras;ŽVIRBLIUKŲ;5725956659;Ne;0;2;0;2
6779;Pipiras;ŽVIRBLIUKŲ;3852848863;Taip;0;1;0;1
6780;Pipiras;ŽVIRBLIUKŲ;3554786173;Ne;3;0;0;3
6781;Pipiras;ŽVIRBLIUKŲ;1034182352;Ne;1;0;0;1
6782;Pipiras;ŽVIRBLIUKŲ;6792777396;Ne;0;1;0;1
6783;Pipiras;ŽVIRBLIUKŲ;6780333972;Ne;10;1;0;11
6784;Pipiras;ŽVIRBLIUKŲ;7934365114;Ne;8;1;0;9
6785;Pipiras;ŽVIRBLIUKŲ;9770780973;Ne;12;0;0;12
6786;Pipiras;ŽVIRBLIUKŲ;5845498558;Ne;5;5;0;10
6787;Pipiras;ŽVIRBLIUKŲ;9840040112;Ne;0;2;0;2
6788;Pipiras;ŽVIRBLIUKŲ;1784839485;Ne;0;2;0;2
6789;Pipiras;ŽVIRBLIUKŲ;3775916247;Ne;5;0;0;5
6790;Pipiras;ŽVIRBLIUKŲ;7350131214;Ne;6;0;0;6
6791;Pipiras;ZUIKUČIŲ;7202983046;Taip;17;0;0;17
6792;Pipiras;ZUIKUČIŲ;6392620549;Taip;14;1;0;15
6793;Pipiras;ZUIKUČIŲ;4017133866;Ne;0;4;0;4
6794;Pipiras;ZUIKUČIŲ;1443705808;Taip;18;0;0;18
6795;Pipiras;ZUIKUČIŲ;5273904507;Ne;17;0;0;17
6796;Pipiras;ZUIKUČIŲ;3779938901;Taip;10;0;1;11
6797;Pipiras;ZUIKUČIŲ;8364071068;Ne;14;0;0;14
6798;Pipiras;ZUIKUČIŲ;9206586291;Ne;4;0;0;4
6799;Pipiras;ZUIKUČIŲ;1326532597;Ne;14;0;0;14
6800;Pipiras;ZUIKUČIŲ;3759775049;Taip;13;0;0;13
6801;Pipiras;ZUIKUČIŲ;8716061709;Ne;0;2;0;2
6802;Pipiras;ZUIKUČIŲ;6700688846;Ne;0;20;0;20
6803;Pipiras;ZUIKUČIŲ;3390710493;Ne;3;0;0;3
6804;Pipiras;ZUIKUČIŲ;5065567026;Ne;20;0;0;20
6805;Pipiras;VARLIUKŲ;8952109131;Ne;10;0;0;10
6806;Pipiras;VARLIUKŲ;1419011066;Ne;1;0;0;1
6807;Pipiras;VARLIUKŲ;3553431200;Taip;13;0;0;13
6808;Pipiras;VARLIUKŲ;7262747212;Ne;0;2;2;4
6809;Pipiras;VARLIUKŲ;3219349754;Ne;0;14;0;14
6810;Pipiras;VARLIUKŲ;1254069142;Taip;9;0;0;9
6811;Pipiras;VARLIUKŲ;3548414064;Ne;7;0;1;8
6812;Pipiras;VARLIUKŲ;5735835403;Ne;7;0;0;7
6813;Pipiras;VARLIUKŲ;2248789873;Ne;5;0;0;5
6814;Pipiras;VARLIUKŲ;1995619760;Taip;19;0;0;19
6815;Pipiras;VARLIUKŲ;8128573827;Ne;0;5;7;12
6816;Pipiras;VARLIUKŲ;7209844964;Ne;15;0;0;15
6817;Pipiras;VARLIUKŲ;7689406983;Ne;9;0;0;9
6818;Pipiras;ŽIOGELIŲ;7510719254;Ne;10;0;0;10
6819;Pipiras;ŽIOGELIŲ;7802812858;Taip;0;5;3;8
6820;Pipiras;ŽIOGELIŲ;8697732892;Ne;12;0;0;12
6821;Pipiras;ŽIOGELIŲ;1466527534;Ne;0;0;1;1
6822;Pipiras;ŽIOGELIŲ;3825960148;Ne;12;0;0;12
6823;Pipiras;ŽIOGELIŲ;9747219629;Ne;5;1;0;6
6824;Pipiras;ŽIOGELIŲ;8445608419;Taip;1;0;0;1
6825;Pipiras;ŽIOGELIŲ;6602780166;Ne;10;0;0;10
6826;Pipiras;ŽIOGELIŲ;4229548366;Ne;20;0;0;20
6827;Pipiras;ŽIOGELIŲ;8666908143;Ne;15;0;0;15
6828;Pipiras;ŽIOGELIŲ;3701585967;Ne;6;0;0;6
6829;Pipiras;ŽIOGELIŲ;5274511724;Ne;14;0;0;14
6830;Pipiras;ŽIOGELIŲ;8852386906;Ne;1;0;4;5
6831;Pipiras;ŽIOGELIŲ;1417118390;Ne;10;0;0;10
6832;Pipiras;ŽIOGELIŲ;8364783015;Ne;20;0;0;20
6833;Pipiras;ŽIOGELIŲ;8351469544;Ne;12;0;0;12
6834;"Prie pasakų parko";ZUIKUČIAI;8493622886;Taip;1;0;0;1
6835;"Prie pasakų parko";ZUIKUČIAI;3998970024;Ne;6;0;0;6
6836;"Prie pasakų parko";ZUIKUČIAI;3907016976;Ne;12;0;0;12
6837;"Prie pasakų parko";ZUIKUČIAI;5394554484;Ne;5;0;0;5
6838;"Prie pasakų parko";ZUIKUČIAI;7220229641;Ne;0;4;0;4
6839;"Prie pasakų parko";ZUIKUČIAI;8616467675;Ne;2;0;0;2
6840;"Prie pasakų parko";ZUIKUČIAI;9742058853;Ne;7;0;0;7
6841;"Prie pasakų parko";ZUIKUČIAI;3038164555;Taip;1;0;0;1
6842;"Prie pasakų parko";ZUIKUČIAI;4183640714;Ne;15;0;0;15
6843;"Prie pasakų parko";ZUIKUČIAI;5326765354;Taip;4;0;0;4
6844;"Prie pasakų parko";PAUKŠČIUKŲ;7330033315;Ne;5;0;0;5
6845;"Prie pasakų parko";PAUKŠČIUKŲ;9061639276;Ne;15;0;0;15
6846;"Prie pasakų parko";PAUKŠČIUKŲ;1476515947;Ne;10;0;0;10
6847;"Prie pasakų parko";PAUKŠČIUKŲ;6601363351;Ne;3;0;0;3
6848;"Prie pasakų parko";PAUKŠČIUKŲ;7693728136;Taip;3;1;0;4
6849;"Prie pasakų parko";PAUKŠČIUKŲ;8882083855;Ne;7;0;0;7
6850;"Prie pasakų parko";PAUKŠČIUKŲ;8627379659;Ne;5;0;0;5
6851;"Prie pasakų parko";PAUKŠČIUKŲ;1644560882;Ne;13;0;0;13
6852;"Prie pasakų parko";PAUKŠČIUKŲ;4643624588;Ne;17;0;0;17
6853;"Prie pasakų parko";PAUKŠČIUKŲ;7349726598;Ne;11;0;0;11
6854;"Prie pasakų parko";PAUKŠČIUKŲ;9571177184;Taip;11;0;0;11
6855;"Prie pasakų parko";PAUKŠČIUKŲ;1435069282;Ne;15;0;0;15
6856;"Prie pasakų parko";PAUKŠČIUKŲ;2088585478;Ne;6;0;3;9
6857;"Prie pasakų parko";"LINKSMOJI ŠEIMYNĖLĖ (SPEC)";1427487116;Ne;2;0;0;2
6858;"Prie pasakų parko";"LINKSMOJI ŠEIMYNĖLĖ (SPEC)";1112142035;Ne;14;0;0;14
6859;"Prie pasakų parko";"LINKSMOJI ŠEIMYNĖLĖ (SPEC)";4895744524;Ne;1;0;0;1
6860;"Prie pasakų parko";"LINKSMOJI ŠEIMYNĖLĖ (SPEC)";2760980480;Ne;1;0;0;1
6861;"Prie pasakų parko";"LINKSMOJI ŠEIMYNĖLĖ (SPEC)";2272661119;Ne;3;0;0;3
6862;"Prie pasakų parko";NYKŠTUKŲ;2287711014;Ne;0;0;1;1
6863;"Prie pasakų parko";NYKŠTUKŲ;6491435655;Ne;5;6;0;11
6864;"Prie pasakų parko";NYKŠTUKŲ;1743429440;Ne;6;0;0;6
6865;"Prie pasakų parko";NYKŠTUKŲ;7739970115;Ne;6;0;0;6
6866;"Prie pasakų parko";NYKŠTUKŲ;6700916147;Ne;9;0;0;9
6867;"Prie pasakų parko";NYKŠTUKŲ;6733793491;Taip;14;0;0;14
6868;"Prie pasakų parko";NYKŠTUKŲ;4674683653;Taip;0;0;1;1
6869;"Prie pasakų parko";NYKŠTUKŲ;2515928623;Ne;0;0;1;1
6870;"Prie pasakų parko";NYKŠTUKŲ;4726737519;Taip;3;0;2;5
6871;"Prie pasakų parko";NYKŠTUKŲ;1316127369;Ne;10;0;0;10
6872;"Prie pasakų parko";NYKŠTUKŲ;2654978735;Ne;5;0;2;7
6873;"Prie pasakų parko";NYKŠTUKŲ;3202292611;Ne;7;0;0;7
6874;"Prie pasakų parko";NYKŠTUKŲ;9225775914;Ne;3;0;0;3
6875;"Prie pasakų parko";NYKŠTUKŲ;4457827262;Ne;6;0;0;6
6876;"Prie pasakų parko";NYKŠTUKŲ;6171021539;Ne;12;0;0;12
6877;"Prie pasakų parko";NYKŠTUKŲ;4860316199;Ne;7;0;0;7
6878;"Prie pasakų parko";NYKŠTUKŲ;9784398441;Ne;5;0;0;5
6879;"Prie pasakų parko";NYKŠTUKŲ;4891232161;Ne;9;0;0;9
6880;"Prie pasakų parko";NYKŠTUKŲ;9550985822;Ne;8;0;0;8
6881;"Prie pasakų parko";NYKŠTUKŲ;1811994592;Taip;10;0;2;12
6882;"Prie pasakų parko";LAŠELIŲ;8574432191;Ne;6;0;0;6
6883;"Prie pasakų parko";LAŠELIŲ;4181676762;Ne;3;0;0;3
6884;"Prie pasakų parko";LAŠELIŲ;4548803933;Ne;4;0;1;5
6885;"Prie pasakų parko";LAŠELIŲ;2216634402;Ne;5;0;2;7
6886;"Prie pasakų parko";LAŠELIŲ;2731544174;Ne;10;0;0;10
6887;"Prie pasakų parko";LAŠELIŲ;2350325153;Ne;2;0;1;3
6888;"Prie pasakų parko";LAŠELIŲ;6762267582;Ne;5;0;1;6
6889;"Prie pasakų parko";LAŠELIŲ;2952868428;Ne;8;0;0;8
6890;"Prie pasakų parko";LAŠELIŲ;6074218082;Ne;15;0;0;15
6891;"Prie pasakų parko";LAŠELIŲ;4351705573;Ne;2;0;0;2
6892;"Prie pasakų parko";"KAČIUKAI (SPEC)";2590693851;Ne;6;0;0;6
6893;"Prie pasakų parko";"KAČIUKAI (SPEC)";3949671257;Ne;13;0;0;13
6894;"Prie pasakų parko";"KAČIUKAI (SPEC)";2583331243;Ne;2;0;0;2
6895;"Prie pasakų parko";"KAČIUKAI (SPEC)";1370201372;Ne;0;5;0;5
6896;"Prie pasakų parko";"KAČIUKAI (SPEC)";5594531224;Ne;4;0;0;4
6897;"Prie pasakų parko";"ŽVAIGŽDUTĖS  (SPEC)";7216751216;Ne;5;0;0;5
6898;"Prie pasakų parko";"ŽVAIGŽDUTĖS  (SPEC)";5006152810;Ne;10;0;0;10
6899;"Prie pasakų parko";"ŽVAIGŽDUTĖS  (SPEC)";6989235061;Ne;9;0;4;13
6900;"Prie pasakų parko";"ŽVAIGŽDUTĖS  (SPEC)";6585504578;Taip;20;0;0;20
6901;"Prie pasakų parko";"ŽVAIGŽDUTĖS  (SPEC)";1621710265;Ne;11;0;0;11
6902;"Prie pasakų parko";"ŽVAIGŽDUTĖS  (SPEC)";8203595449;Ne;15;0;0;15
6903;"Prie pasakų parko";"ŽVAIGŽDUTĖS  (SPEC)";7476984763;Ne;2;0;4;6
6904;"Prie pasakų parko";"ŽVAIGŽDUTĖS  (SPEC)";7449993309;Ne;5;0;0;5
6905;"Prie pasakų parko";"ANČIUKAI (SPEC)";6802898184;Ne;5;0;0;5
6906;"Prie pasakų parko";"ANČIUKAI (SPEC)";9529949992;Ne;0;0;1;1
6907;"Prie pasakų parko";"ANČIUKAI (SPEC)";4309482351;Ne;0;2;0;2
6908;"Prie pasakų parko";"ANČIUKAI (SPEC)";7200571639;Ne;0;0;1;1
6909;"Prie pasakų parko";"ANČIUKAI (SPEC)";2047018335;Ne;0;0;2;2
6910;"Prie pasakų parko";"ANČIUKAI (SPEC)";2731902356;Ne;15;0;0;15
6911;"Prie pasakų parko";"ANČIUKAI (SPEC)";5627477370;Ne;8;0;1;9
6912;"Prie pasakų parko";"ANČIUKAI (SPEC)";9999109437;Ne;6;2;0;8
6913;"Prie pasakų parko";"ANČIUKAI (SPEC)";9741985709;Ne;5;0;0;5
6914;"Prie pasakų parko";TIGRIUKAI;3918269702;Taip;10;0;2;12
6915;"Prie pasakų parko";TIGRIUKAI;6446562388;Ne;0;4;0;4
6916;"Prie pasakų parko";TIGRIUKAI;2168919559;Taip;6;3;0;9
6917;"Prie pasakų parko";TIGRIUKAI;9476448601;Ne;2;0;1;3
6918;"Prie pasakų parko";TIGRIUKAI;8029428034;Ne;0;1;0;1
6919;"Prie pasakų parko";TIGRIUKAI;8715851643;Ne;4;0;0;4
6920;"Prie pasakų parko";TIGRIUKAI;3617673265;Ne;5;0;1;6
6921;"Prie pasakų parko";TIGRIUKAI;1704679306;Ne;2;0;0;2
6922;"Prie pasakų parko";TIGRIUKAI;7776961789;Ne;0;0;1;1
6923;"Prie pasakų parko";TIGRIUKAI;3373275644;Ne;4;0;3;7
6924;"Prie pasakų parko";TIGRIUKAI;5518041213;Taip;0;0;4;4
6925;"Prie pasakų parko";TIGRIUKAI;8738488104;Taip;0;0;4;4
6926;"Prie pasakų parko";TIGRIUKAI;6606867989;Ne;15;0;0;15
6927;"Prie pasakų parko";TIGRIUKAI;2263419475;Ne;4;0;0;4
6928;"Prie pasakų parko";TIGRIUKAI;6784471792;Ne;0;0;1;1
6929;"Prie pasakų parko";TIGRIUKAI;6110226958;Ne;14;0;0;14
6930;"Prie pasakų parko";TIGRIUKAI;8338549157;Ne;18;0;0;18
6931;"Prie pasakų parko";TIGRIUKAI;3436003531;Ne;2;0;0;2
6932;"Prie pasakų parko";"EŽIUKŲ (SPEC)";5944113879;Ne;10;0;0;10
6933;"Prie pasakų parko";"EŽIUKŲ (SPEC)";4950143153;Ne;10;1;1;12
6934;"Prie pasakų parko";"EŽIUKŲ (SPEC)";4799789212;Taip;5;0;0;5
6935;"Prie pasakų parko";"EŽIUKŲ (SPEC)";5834070970;Ne;11;0;0;11
6936;"Prie pasakų parko";"EŽIUKŲ (SPEC)";3579773269;Ne;0;1;2;3
6937;"Prie pasakų parko";"BORUŽIUKŲ (SPEC)";9715586563;Ne;6;0;6;12
6938;"Prie pasakų parko";"BORUŽIUKŲ (SPEC)";2104412442;Ne;0;0;1;1
6939;"Prie pasakų parko";"BORUŽIUKŲ (SPEC)";4504147902;Ne;0;0;1;1
6940;"Prie pasakų parko";"BORUŽIUKŲ (SPEC)";6051760219;Ne;8;0;0;8
6941;"Prie pasakų parko";"BORUŽIUKŲ (SPEC)";5821107898;Ne;11;0;0;11
6942;"Prie pasakų parko";"BORUŽIUKŲ (SPEC)";6772736175;Ne;15;0;0;15
6943;"Prie pasakų parko";"BORUŽIUKŲ (SPEC)";5847625697;Ne;7;0;0;7
6944;"Prie pasakų parko";SAULYTĖS;4827245401;Ne;7;0;0;7
6945;"Prie pasakų parko";SAULYTĖS;7404885669;Ne;7;0;0;7
6946;"Prie pasakų parko";SAULYTĖS;3430128279;Ne;20;0;0;20
6947;"Prie pasakų parko";SAULYTĖS;5039094555;Ne;8;0;0;8
6948;"Prie pasakų parko";SAULYTĖS;4580377882;Ne;6;0;0;6
6949;"Prie pasakų parko";SAULYTĖS;9464727980;Ne;2;0;0;2
6950;"Prie pasakų parko";SAULYTĖS;8621403184;Ne;12;0;0;12
6951;"Prie pasakų parko";SAULYTĖS;4844984321;Ne;10;0;0;10
6952;"Prie pasakų parko";SAULYTĖS;6955061957;Ne;0;8;0;8
6953;"Pumpurėlis (Kalvarijų g. 186)";RAMUNĖLIŲ;7652642088;Taip;2;1;0;3
6954;"Pumpurėlis (Kalvarijų g. 186)";RAMUNĖLIŲ;4249039048;Ne;0;1;0;1
6955;"Pumpurėlis (Kalvarijų g. 186)";RAMUNĖLIŲ;1082775039;Ne;1;0;0;1
6956;"Pumpurėlis (Kalvarijų g. 186)";RAMUNĖLIŲ;6982600785;Ne;1;0;2;3
6957;"Pumpurėlis (Kalvarijų g. 186)";RAMUNĖLIŲ;1667602636;Ne;5;0;0;5
6958;"Pumpurėlis (Kalvarijų g. 186)";RAMUNĖLIŲ;8212403350;Ne;2;0;0;2
6959;"Pumpurėlis (Kalvarijų g. 186)";RAMUNĖLIŲ;6795405194;Ne;5;0;0;5
6960;"Pumpurėlis (Kalvarijų g. 186)";RAMUNĖLIŲ;7443152469;Ne;0;0;20;20
6961;"Pumpurėlis (Kalvarijų g. 186)";RAMUNĖLIŲ;8458676611;Taip;0;0;1;1
6962;"Pumpurėlis (Kalvarijų g. 186)";RAMUNĖLIŲ;1856558407;Ne;0;0;1;1
6963;"Pumpurėlis (Kalvarijų g. 186)";RAMUNĖLIŲ;7002569226;Ne;4;0;0;4
6964;"Pumpurėlis (Kalvarijų g. 186)";RAMUNĖLIŲ;8534897580;Taip;0;5;1;6
6965;"Pumpurėlis (Kalvarijų g. 186)";RAMUNĖLIŲ;5208799121;Ne;6;0;0;6
6966;"Pumpurėlis (Kalvarijų g. 186)";VARPELIŲ;5326000400;Ne;20;0;0;20
6967;"Pumpurėlis (Kalvarijų g. 186)";VARPELIŲ;7998027741;Taip;7;0;1;8
6968;"Pumpurėlis (Kalvarijų g. 186)";VARPELIŲ;9395698760;Taip;9;1;4;14
6969;"Pumpurėlis (Kalvarijų g. 186)";VARPELIŲ;9903981454;Ne;5;0;0;5
6970;"Pumpurėlis (Kalvarijų g. 186)";VARPELIŲ;6647331393;Ne;5;0;3;8
6971;"Pumpurėlis (Kalvarijų g. 186)";VARPELIŲ;3001331278;Ne;5;0;0;5
6972;"Pumpurėlis (Kalvarijų g. 186)";VARPELIŲ;9735493140;Ne;8;0;0;8
6973;"Pumpurėlis (Kalvarijų g. 186)";VARPELIŲ;3964441086;Ne;7;0;0;7
6974;"Pumpurėlis (Kalvarijų g. 186)";VARPELIŲ;8550119831;Taip;0;1;0;1
6975;"Pumpurėlis (Kalvarijų g. 186)";VARPELIŲ;6860128064;Ne;5;0;0;5
6976;"Pumpurėlis (Kalvarijų g. 186)";VARPELIŲ;2282966743;Ne;1;0;0;1
6977;"Pumpurėlis (Kalvarijų g. 186)";VARPELIŲ;5968577443;Ne;11;0;1;12
6978;"Pumpurėlis (Kalvarijų g. 186)";VARPELIŲ;8083674991;Ne;5;0;1;6
6979;"Pumpurėlis (Kalvarijų g. 186)";VARPELIŲ;6422203618;Ne;0;0;1;1
6980;"Pumpurėlis (Kalvarijų g. 186)";VARPELIŲ;1782842327;Ne;9;0;0;9
6981;"Pumpurėlis (Kalvarijų g. 186)";VARPELIŲ;9750242149;Taip;6;0;1;7
6982;"Pumpurėlis (Kalvarijų g. 186)";VARPELIŲ;5420222684;Ne;2;1;0;3
6983;"Pumpurėlis (Kalvarijų g. 186)";DRUGELIŲ;5928552565;Taip;2;0;1;3
6984;"Pumpurėlis (Kalvarijų g. 186)";DRUGELIŲ;7055989095;Ne;0;14;0;14
6985;"Pumpurėlis (Kalvarijų g. 186)";DRUGELIŲ;7078621340;Ne;0;2;1;3
6986;"Pumpurėlis (Kalvarijų g. 186)";DRUGELIŲ;1538548768;Ne;3;0;2;5
6987;"Pumpurėlis (Kalvarijų g. 186)";DRUGELIŲ;9640790401;Taip;0;0;4;4
6988;"Pumpurėlis (Kalvarijų g. 186)";DRUGELIŲ;8644853849;Ne;0;1;1;2
6989;"Pumpurėlis (Kalvarijų g. 186)";DRUGELIŲ;9417688597;Ne;3;0;2;5
6990;"Pumpurėlis (Kalvarijų g. 186)";DRUGELIŲ;9032255874;Ne;14;0;0;14
6991;"Pumpurėlis (Kalvarijų g. 186)";DRUGELIŲ;9996789041;Ne;0;0;2;2
6992;"Pumpurėlis (Kalvarijų g. 186)";DRUGELIŲ;5835115428;Ne;5;0;0;5
6993;"Pumpurėlis (Kalvarijų g. 186)";DRUGELIŲ;2132563531;Ne;5;0;0;5
6994;"Pumpurėlis (Kalvarijų g. 186)";DRUGELIŲ;4506063812;Ne;0;4;1;5
6995;"Pumpurėlis (Kalvarijų g. 186)";DRUGELIŲ;8671697745;Ne;4;0;0;4
6996;"Pumpurėlis (Kalvarijų g. 186)";DRUGELIŲ;3187815703;Ne;14;0;2;16
6997;"Pumpurėlis (Kalvarijų g. 186)";KODĖLČIUKŲ;8214602054;Ne;4;0;2;6
6998;"Pumpurėlis (Kalvarijų g. 186)";KODĖLČIUKŲ;9654958302;Ne;5;0;0;5
6999;"Pumpurėlis (Kalvarijų g. 186)";KODĖLČIUKŲ;5564844211;Ne;10;0;0;10
7000;"Pumpurėlis (Kalvarijų g. 186)";KODĖLČIUKŲ;1215117598;Ne;5;4;0;9
7001;"Pumpurėlis (Kalvarijų g. 186)";KODĖLČIUKŲ;6978091765;Ne;1;0;1;2
7002;"Pumpurėlis (Kalvarijų g. 186)";KODĖLČIUKŲ;6433757421;Ne;0;0;4;4
7003;"Pumpurėlis (Kalvarijų g. 186)";KODĖLČIUKŲ;3328647987;Ne;10;0;3;13
7004;"Pumpurėlis (Kalvarijų g. 186)";KODĖLČIUKŲ;6004234378;Ne;0;0;2;2
7005;"Pumpurėlis (Kalvarijų g. 186)";KODĖLČIUKŲ;4196409137;Ne;9;0;0;9
7006;"Pumpurėlis (Kalvarijų g. 186)";KODĖLČIUKŲ;6117720533;Ne;1;0;0;1
7007;"Pumpurėlis (Kalvarijų g. 186)";KODĖLČIUKŲ;8070486897;Ne;16;0;0;16
7008;"Pumpurėlis (Kalvarijų g. 186)";KODĖLČIUKŲ;3534133061;Ne;0;5;0;5
7009;"Pumpurėlis (Kalvarijų g. 186)";KODĖLČIUKŲ;9650395309;Ne;4;0;0;4
7010;"Pumpurėlis (Kalvarijų g. 186)";KODĖLČIUKŲ;6702744879;Ne;4;1;0;5
7011;"Pumpurėlis (Kalvarijų g. 186)";KODĖLČIUKŲ;2890596967;Ne;5;0;0;5
7012;"Pumpurėlis (Kalvarijų g. 186)";KODĖLČIUKŲ;9839285886;Taip;0;2;0;2
7013;"Pumpurėlis (Kalvarijų g. 186)";LINELIS;6780042929;Ne;12;1;0;13
7014;"Pumpurėlis (Kalvarijų g. 186)";LINELIS;8667762689;Ne;0;3;0;3
7015;"Pumpurėlis (Kalvarijų g. 186)";LINELIS;3953103488;Taip;0;2;0;2
7016;"Pumpurėlis (Kalvarijų g. 186)";LINELIS;6977710645;Ne;2;1;0;3
7017;"Pumpurėlis (Kalvarijų g. 186)";LINELIS;6511527480;Ne;4;1;0;5
7018;"Pumpurėlis (Kalvarijų g. 186)";LINELIS;9431295796;Ne;0;2;0;2
7019;"Pumpurėlis (Kalvarijų g. 186)";LINELIS;3838705973;Ne;8;0;0;8
7020;"Pumpurėlis (Kalvarijų g. 186)";LINELIS;1395380236;Ne;2;1;0;3
7021;"Pumpurėlis (Kalvarijų g. 186)";LINELIS;9424449290;Ne;9;0;0;9
7022;"Pumpurėlis (Kalvarijų g. 186)";LINELIS;6955168163;Ne;0;0;2;2
7023;"Pumpurėlis (Kalvarijų g. 186)";LINELIS;9726028397;Ne;0;0;1;1
7024;"Pumpurėlis (Kalvarijų g. 186)";LINELIS;7229289985;Ne;0;1;0;1
7025;"Pumpurėlis (Kalvarijų g. 186)";LINELIS;7619709360;Ne;5;1;0;6
7026;"Pumpurėlis (Kalvarijų g. 186)";LINELIS;6726875853;Ne;5;2;0;7
7027;"Pumpurėlis (Kalvarijų g. 186)";LINELIS;7559071945;Ne;5;0;0;5
7028;"Pumpurėlis (Kalvarijų g. 186)";LINELIS;9117809080;Taip;0;1;0;1
7029;"Pumpurėlis (Kalvarijų g. 186)";SAULUTĖS;7182107790;Taip;2;0;2;4
7030;"Pumpurėlis (Kalvarijų g. 186)";SAULUTĖS;3101133244;Ne;5;0;0;5
7031;"Pumpurėlis (Kalvarijų g. 186)";SAULUTĖS;5023658988;Ne;0;0;10;10
7032;"Pumpurėlis (Kalvarijų g. 186)";SAULUTĖS;2668855786;Ne;0;12;2;14
7033;"Pumpurėlis (Kalvarijų g. 186)";SAULUTĖS;2103139845;Ne;0;0;1;1
7034;"Pumpurėlis (Kalvarijų g. 186)";SAULUTĖS;9612924972;Ne;0;1;0;1
7035;"Pumpurėlis (Kalvarijų g. 186)";SAULUTĖS;9884099545;Taip;5;1;0;6
7036;"Pumpurėlis (Kalvarijų g. 186)";SAULUTĖS;3733509497;Ne;0;0;2;2
7037;"Pumpurėlis (Kalvarijų g. 186)";SAULUTĖS;2247300456;Ne;0;2;1;3
7038;"Pumpurėlis (Kalvarijų g. 186)";SAULUTĖS;9224879966;Ne;0;0;4;4
7039;"Pumpurėlis (Kalvarijų g. 186)";SAULUTĖS;5564680653;Ne;0;0;2;2
7040;"Pumpurėlis (Kalvarijų g. 186)";SAULUTĖS;4508966729;Ne;0;5;0;5
7041;"Pumpurėlis (Kalvarijų g. 186)";SAULUTĖS;5196733185;Ne;2;0;1;3
7042;"Pumpurėlis (Kalvarijų g. 186)";SAULUTĖS;4629544683;Ne;0;0;1;1
7043;"Pumpurėlis (Kalvarijų g. 186)";BITUTĖS;4419940231;Ne;6;5;0;11
7044;"Pumpurėlis (Kalvarijų g. 186)";BITUTĖS;4985045047;Taip;4;0;0;4
7045;"Pumpurėlis (Kalvarijų g. 186)";BITUTĖS;2651037375;Ne;4;0;0;4
7046;"Pumpurėlis (Kalvarijų g. 186)";BITUTĖS;1768239820;Ne;0;0;1;1
7047;"Pumpurėlis (Kalvarijų g. 186)";BITUTĖS;2566557351;Taip;0;6;0;6
7048;"Pumpurėlis (Kalvarijų g. 186)";BITUTĖS;4426697956;Taip;1;0;1;2
7049;"Pumpurėlis (Kalvarijų g. 186)";BITUTĖS;7363814444;Ne;5;0;7;12
7050;"Pumpurėlis (Kalvarijų g. 186)";BITUTĖS;3405169131;Ne;0;0;1;1
7051;"Pumpurėlis (Kalvarijų g. 186)";BITUTĖS;3951445693;Ne;4;0;2;6
7052;"Pumpurėlis (Kalvarijų g. 186)";BITUTĖS;9612924316;Ne;0;19;0;19
7053;"Pumpurėlis (Kalvarijų g. 186)";BITUTĖS;3842632260;Ne;2;0;0;2
7054;"Pumpurėlis (Kalvarijų g. 186)";BITUTĖS;1933502038;Ne;0;0;2;2
7055;"Pumpurėlis (Kalvarijų g. 186)";BITUTĖS;2230191718;Ne;5;0;0;5
7056;"Pumpurėlis (Kalvarijų g. 186)";BITUTĖS;7062090879;Ne;5;15;0;20
7057;"Pumpurėlis (Kalvarijų g. 186)";BITUTĖS;9245739052;Ne;2;0;0;2
7058;"Pumpurėlis (Kalvarijų g. 186)";BITUTĖS;8470433743;Ne;10;0;7;17
7059;"Pumpurėlis (Kalvarijų g. 186)";BITUTĖS;6474918016;Ne;0;1;0;1
7060;"Pumpurėlis (Kalvarijų g. 186)";DOBILIUKAI;9179780392;Ne;3;0;0;3
7061;"Pumpurėlis (Kalvarijų g. 186)";DOBILIUKAI;1839505206;Ne;10;0;0;10
7062;"Pumpurėlis (Kalvarijų g. 186)";DOBILIUKAI;3970253545;Ne;2;0;1;3
7063;"Pumpurėlis (Kalvarijų g. 186)";DOBILIUKAI;6968264923;Ne;10;2;0;12
7064;"Pumpurėlis (Kalvarijų g. 186)";DOBILIUKAI;2700017433;Ne;4;0;0;4
7065;"Pumpurėlis (Kalvarijų g. 186)";DOBILIUKAI;7038597556;Ne;5;10;0;15
7066;"Pumpurėlis (Kalvarijų g. 186)";DOBILIUKAI;4130539703;Ne;6;1;0;7
7067;"Pumpurėlis (Kalvarijų g. 186)";DOBILIUKAI;3398517047;Ne;0;1;0;1
7068;"Pumpurėlis (Kalvarijų g. 186)";DOBILIUKAI;1961282282;Ne;0;0;1;1
7069;"Pumpurėlis (Kalvarijų g. 186)";DOBILIUKAI;7276322999;Ne;0;1;0;1
7070;"Pumpurėlis (Kalvarijų g. 186)";DOBILIUKAI;5587118874;Ne;3;0;0;3
7071;"Pumpurėlis (Kalvarijų g. 186)";DOBILIUKAI;3214652626;Ne;1;0;0;1
7072;"Pumpurėlis (Kalvarijų g. 186)";DOBILIUKAI;2028068230;Ne;0;0;2;2
7073;"Pumpurėlis (Kalvarijų g. 186)";DOBILIUKAI;5444879430;Taip;15;0;0;15
7074;"Pumpurėlis (Kalvarijų g. 186)";DOBILIUKAI;7825190756;Ne;13;0;0;13
7075;"Pumpurėlis (Kalvarijų g. 186)";DOBILIUKAI;1438740562;Ne;0;1;0;1
7076;"Pumpurėlis (Kalvarijų g. 186)";DOBILIUKAI;9740660699;Ne;17;0;0;17
7077;"Pumpurėlis (Kalvarijų g. 186)";PUPYČIŲ;9317274035;Ne;5;0;0;5
7078;"Pumpurėlis (Kalvarijų g. 186)";PUPYČIŲ;1555441484;Ne;5;0;0;5
7079;"Pumpurėlis (Kalvarijų g. 186)";PUPYČIŲ;5238756058;Ne;11;0;1;12
7080;"Pumpurėlis (Kalvarijų g. 186)";PUPYČIŲ;1945615416;Ne;4;0;5;9
7081;"Pumpurėlis (Kalvarijų g. 186)";PUPYČIŲ;5228548329;Ne;11;0;0;11
7082;"Pumpurėlis (Kalvarijų g. 186)";PUPYČIŲ;9789187163;Ne;0;0;6;6
7083;"Pumpurėlis (Kalvarijų g. 186)";PUPYČIŲ;7114896633;Ne;0;0;1;1
7084;"Pumpurėlis (Kalvarijų g. 186)";PUPYČIŲ;4133819653;Ne;0;0;1;1
7085;"Pumpurėlis (Kalvarijų g. 186)";PUPYČIŲ;8215233820;Ne;0;0;12;12
7086;"Pumpurėlis (Kalvarijų g. 186)";PUPYČIŲ;1413673339;Ne;17;0;0;17
7087;"Pumpurėlis (Kalvarijų g. 186)";PUPYČIŲ;1084209625;Ne;0;0;2;2
7088;"Pumpurėlis (Kalvarijų g. 186)";PUPYČIŲ;9164586359;Ne;6;0;1;7
7089;"Pumpurėlis (Kalvarijų g. 186)";PUPYČIŲ;9316908064;Ne;6;0;1;7
7090;"Pumpurėlis (Kalvarijų g. 186)";PUPYČIŲ;1082943651;Ne;11;0;0;11
7091;"Pumpurėlis (Kalvarijų g. 186)";ŽIRNIUKŲ;4198532140;Ne;5;0;0;5
7092;"Pumpurėlis (Kalvarijų g. 186)";ŽIRNIUKŲ;6162279957;Ne;5;0;3;8
7093;"Pumpurėlis (Kalvarijų g. 186)";ŽIRNIUKŲ;6602860291;Ne;10;0;0;10
7094;"Pumpurėlis (Kalvarijų g. 186)";ŽIRNIUKŲ;6535225429;Ne;2;0;1;3
7095;"Pumpurėlis (Kalvarijų g. 186)";ŽIRNIUKŲ;6606861732;Ne;10;0;2;12
7096;"Pumpurėlis (Kalvarijų g. 186)";ŽIRNIUKŲ;8057222613;Ne;6;0;2;8
7097;"Pumpurėlis (Kalvarijų g. 186)";ŽIRNIUKŲ;9704396561;Ne;5;0;1;6
7098;"Pumpurėlis (Kalvarijų g. 186)";ŽIRNIUKŲ;9033360796;Ne;5;0;1;6
7099;"Pumpurėlis (Kalvarijų g. 186)";ŽIRNIUKŲ;1550949005;Ne;0;1;0;1
7100;"Pumpurėlis (Kalvarijų g. 186)";ŽIRNIUKŲ;3438212768;Ne;2;0;1;3
7101;"Pumpurėlis (Kalvarijų g. 186)";ŽIRNIUKŲ;4686840292;Ne;4;0;0;4
7102;"Pumpurėlis (Kalvarijų g. 186)";ŽIRNIUKŲ;4195060928;Ne;1;0;0;1
7103;"Pumpurėlis (Kalvarijų g. 186)";ŽIRNIUKŲ;4446088965;Ne;16;0;1;17
7104;"Pumpurėlis (Kalvarijų g. 186)";ŽIRNIUKŲ;7994376089;Ne;0;1;1;2
7105;"Pumpurėlis (Kalvarijų g. 186)";ŽIRNIUKŲ;5765942106;Ne;18;0;0;18
7106;"Pumpurėlis (Kalvarijų g. 186)";ŽIRNIUKŲ;8978637291;Taip;5;0;0;5
7107;"Pumpurėlis (Kalvarijų g. 186)";BORUŽĖLIŲ;2269864490;Ne;8;0;0;8
7108;"Pumpurėlis (Kalvarijų g. 186)";BORUŽĖLIŲ;6223338814;Ne;10;0;0;10
7109;"Pumpurėlis (Kalvarijų g. 186)";BORUŽĖLIŲ;5998858670;Ne;8;0;1;9
7110;"Pumpurėlis (Kalvarijų g. 186)";BORUŽĖLIŲ;7398363498;Ne;5;0;0;5
7111;"Pumpurėlis (Kalvarijų g. 186)";BORUŽĖLIŲ;5835545051;Ne;0;2;0;2
7112;"Pumpurėlis (Kalvarijų g. 186)";BORUŽĖLIŲ;6256781298;Ne;0;4;0;4
7113;"Pumpurėlis (Kalvarijų g. 186)";BORUŽĖLIŲ;9136771401;Ne;5;0;0;5
7114;"Pumpurėlis (Kalvarijų g. 186)";BORUŽĖLIŲ;7045349032;Ne;9;0;2;11
7115;"Pumpurėlis (Kalvarijų g. 186)";BORUŽĖLIŲ;1017838338;Ne;4;0;1;5
7116;"Pumpurėlis (Kalvarijų g. 186)";BORUŽĖLIŲ;3531862496;Ne;0;1;1;2
7117;"Pumpurėlis (Kalvarijų g. 186)";BORUŽĖLIŲ;1441993078;Ne;12;0;1;13
7118;"Pumpurėlis (Kalvarijų g. 186)";BORUŽĖLIŲ;2768082342;Ne;6;0;1;7
7119;"Pumpurėlis (Kalvarijų g. 186)";BORUŽĖLIŲ;3407251558;Ne;4;0;2;6
7120;"Pumpurėlis (Kalvarijų g. 186)";BORUŽĖLIŲ;4355867863;Ne;0;0;1;1
7121;"Pumpurėlis (Kalvarijų g. 186)";BORUŽĖLIŲ;6386699443;Ne;1;0;0;1
7122;"Pumpurėlis (Kalvarijų g. 186)";SMALSUČIŲ;6212212516;Taip;11;0;0;11
7123;"Pumpurėlis (Kalvarijų g. 186)";SMALSUČIŲ;6604801631;Ne;7;0;2;9
7124;"Pumpurėlis (Kalvarijų g. 186)";SMALSUČIŲ;6988369637;Ne;1;0;1;2
7125;"Pumpurėlis (Kalvarijų g. 186)";SMALSUČIŲ;9363610488;Ne;1;0;0;1
7126;"Pumpurėlis (Kalvarijų g. 186)";SMALSUČIŲ;8380689261;Taip;0;0;1;1
7127;"Pumpurėlis (Kalvarijų g. 186)";SMALSUČIŲ;3492977569;Ne;3;0;0;3
7128;"Pumpurėlis (Kalvarijų g. 186)";SMALSUČIŲ;6959214331;Ne;1;0;0;1
7129;"Pumpurėlis (Kalvarijų g. 186)";SMALSUČIŲ;4964949574;Ne;1;0;0;1
7130;"Pumpurėlis (Kalvarijų g. 186)";SMALSUČIŲ;2026021360;Ne;12;0;0;12
7131;"Pumpurėlis (Kalvarijų g. 186)";SMALSUČIŲ;6557857672;Ne;9;0;0;9
7132;"Pumpurėlis (Kalvarijų g. 186)";SMALSUČIŲ;5212827184;Ne;7;0;0;7
7133;"Pumpurėlis (Kalvarijų g. 186)";SMALSUČIŲ;6614797909;Ne;5;0;0;5
7134;"Pumpurėlis (Kalvarijų g. 186)";SMALSUČIŲ;5278250113;Taip;6;0;0;6
7135;"Pumpurėlis (Kalvarijų g. 186)";SMALSUČIŲ;5236515914;Taip;5;0;0;5
7136;"Pumpurėlis (Kalvarijų g. 186)";SMALSUČIŲ;8886730333;Ne;2;0;0;2
7137;Puriena;Ančiukų;6158842119;Ne;11;0;0;11
7138;Puriena;Ančiukų;3557013127;Ne;0;1;0;1
7139;Puriena;Ančiukų;4100466337;Ne;6;0;0;6
7140;Puriena;Ančiukų;3681811493;Ne;0;2;0;2
7141;Puriena;Ančiukų;4060087185;Taip;10;0;0;10
7142;Puriena;Ančiukų;6280465748;Ne;7;2;0;9
7143;Puriena;Ančiukų;3033562627;Ne;0;4;0;4
7144;Puriena;Ančiukų;5777076971;Ne;0;6;0;6
7145;Puriena;Ančiukų;8310231540;Ne;0;1;4;5
7146;Puriena;Ančiukų;4460575818;Ne;0;5;0;5
7147;Puriena;Ančiukų;8120597514;Ne;0;2;0;2
7148;Puriena;Ančiukų;7967288875;Ne;0;0;6;6
7149;Puriena;Ančiukų;4605662701;Ne;0;5;0;5
7150;Puriena;Ančiukų;1819876614;Ne;0;0;4;4
7151;Puriena;Ančiukų;4776745276;Ne;0;2;0;2
7152;Puriena;Ančiukų;7769252165;Ne;0;1;0;1
7153;Puriena;Ančiukų;3772941726;Ne;0;2;0;2
7154;Puriena;Ančiukų;1428098802;Ne;0;2;0;2
7155;Puriena;Ančiukų;6416145396;Ne;5;0;1;6
7156;Puriena;Drugeliai;4016228982;Ne;4;0;1;5
7157;Puriena;Drugeliai;9671916745;Ne;2;3;1;6
7158;Puriena;Drugeliai;8195902319;Ne;0;1;0;1
7159;Puriena;Drugeliai;5797970231;Ne;5;1;0;6
7160;Puriena;Drugeliai;3382737176;Ne;2;0;1;3
7161;Puriena;Drugeliai;4587892949;Ne;2;0;0;2
7162;Puriena;Drugeliai;3440488785;Ne;2;0;3;5
7163;Puriena;Drugeliai;8284860687;Ne;7;0;0;7
7164;Puriena;Drugeliai;6941251095;Ne;20;0;0;20
7165;Puriena;Drugeliai;5927216569;Ne;3;0;1;4
7166;Puriena;Drugeliai;8474426340;Ne;6;0;0;6
7167;Puriena;Drugeliai;6308393533;Ne;7;1;2;10
7168;Puriena;Drugeliai;9907972536;Taip;8;0;0;8
7169;Puriena;Drugeliai;8239919265;Taip;0;0;1;1
7170;Puriena;Drugeliai;7634536770;Ne;5;0;0;5
7171;Puriena;Drugeliai;9176303276;Ne;2;6;0;8
7172;Puriena;Drugeliai;3604094165;Ne;9;0;4;13
7173;Puriena;Drugeliai;8110665629;Ne;7;0;0;7
7174;Puriena;Pelėdžiukai;8874823029;Ne;3;0;0;3
7175;Puriena;Pelėdžiukai;3149718901;Ne;0;2;3;5
7176;Puriena;Pelėdžiukai;5619637663;Ne;0;0;2;2
7177;Puriena;Pelėdžiukai;2579402981;Ne;0;0;2;2
7178;Puriena;Pelėdžiukai;3671297035;Ne;5;0;0;5
7179;Puriena;Pelėdžiukai;2701942325;Ne;0;5;0;5
7180;Puriena;Pelėdžiukai;4858971990;Ne;0;2;0;2
7181;Puriena;Pelėdžiukai;1417566073;Ne;8;2;0;10
7182;Puriena;Pelėdžiukai;6463129806;Ne;0;1;0;1
7183;Puriena;Pelėdžiukai;4501239330;Ne;0;0;1;1
7184;Puriena;Pelėdžiukai;5341228269;Ne;12;1;0;13
7185;Puriena;Pelėdžiukai;6786694796;Ne;8;0;1;9
7186;Puriena;Pelėdžiukai;5080805225;Taip;7;0;1;8
7187;Puriena;Pelėdžiukai;1158768017;Ne;0;1;0;1
7188;Puriena;Pelėdžiukai;1658720269;Ne;5;0;0;5
7189;Puriena;Voveriukai;8772936125;Ne;13;0;2;15
7190;Puriena;Voveriukai;6428413592;Ne;4;0;3;7
7191;Puriena;Voveriukai;8242140541;Taip;5;0;3;8
7192;Puriena;Voveriukai;1455237224;Taip;0;1;0;1
7193;Puriena;Voveriukai;3094722037;Ne;0;0;2;2
7194;Puriena;Voveriukai;4193710604;Ne;2;0;0;2
7195;Puriena;Voveriukai;6227990580;Ne;5;0;0;5
7196;Puriena;Voveriukai;4165800035;Ne;6;0;0;6
7197;Puriena;Voveriukai;7334787183;Ne;4;1;0;5
7198;Puriena;Voveriukai;8412041946;Ne;9;0;1;10
7199;Puriena;Voveriukai;3287725982;Ne;20;0;0;20
7200;Puriena;Voveriukai;6496077328;Ne;18;0;0;18
7201;Puriena;Voveriukai;8845361962;Ne;0;20;0;20
7202;Puriena;Voveriukai;9965834233;Ne;6;0;1;7
7203;Puriena;Voveriukai;5841409384;Taip;8;0;2;10
7204;Puriena;Voveriukai;9934831745;Ne;0;10;0;10
7205;Puriena;Voveriukai;8310464710;Ne;20;0;0;20
7206;Puriena;Voveriukai;1614993691;Taip;0;2;0;2
7207;Puriena;Voveriukai;2172109284;Ne;10;1;0;11
7208;Puriena;Bitučių;1621772702;Ne;0;5;0;5
7209;Puriena;Bitučių;9413672989;Ne;0;1;0;1
7210;Puriena;Bitučių;6853706997;Ne;2;1;0;3
7211;Puriena;Bitučių;1339162214;Ne;13;2;0;15
7212;Puriena;Bitučių;9543884311;Ne;0;3;0;3
7213;Puriena;Bitučių;6656013805;Ne;0;0;1;1
7214;Puriena;Bitučių;8022809059;Ne;3;0;1;4
7215;Puriena;Bitučių;5395382717;Ne;0;2;0;2
7216;Puriena;Bitučių;8237149969;Ne;0;1;0;1
7217;Puriena;Bitučių;7481642656;Ne;0;20;0;20
7218;Puriena;Bitučių;8512814466;Ne;0;7;0;7
7219;Puriena;Bitučių;4017644414;Ne;0;2;0;2
7220;Puriena;Bitučių;8416003733;Ne;0;2;1;3
7221;Puriena;Bitučių;8199607793;Ne;0;0;4;4
7222;Puriena;Bitučių;6780164845;Ne;5;0;0;5
7223;Puriena;Bitučių;6413337915;Ne;0;0;7;7
7224;Puriena;Zylutės;4760827000;Ne;0;1;1;2
7225;Puriena;Zylutės;1521955898;Ne;0;2;0;2
7226;Puriena;Zylutės;8881337164;Ne;0;1;0;1
7227;Puriena;Zylutės;5478026060;Ne;5;0;1;6
7228;Puriena;Zylutės;6914613438;Ne;2;0;0;2
7229;Puriena;Zylutės;1121312813;Ne;0;1;0;1
7230;Puriena;Zylutės;2321753665;Ne;11;0;0;11
7231;Puriena;Zylutės;7021756459;Ne;0;1;0;1
7232;Puriena;Zylutės;1564155036;Taip;7;0;0;7
7233;Puriena;Zylutės;9098291788;Ne;0;5;0;5
7234;Puriena;Zylutės;6613654824;Ne;6;0;1;7
7235;Puriena;Zylutės;3738277048;Ne;10;0;0;10
7236;Puriena;Zylutės;7562458336;Ne;3;1;0;4
7237;Puriena;Zylutės;3579008577;Ne;0;9;0;9
7238;Puriena;Zylutės;7477278612;Ne;0;5;0;5
7239;Puriena;Zylutės;9847768390;Ne;10;0;0;10
7240;Puriena;Zylutės;9150157724;Ne;15;0;0;15
7241;Puriena;Meškučių;6234132927;Ne;2;2;1;5
7242;Puriena;Meškučių;4563681164;Ne;0;2;0;2
7243;Puriena;Meškučių;3153330970;Ne;0;1;0;1
7244;Puriena;Meškučių;9500729561;Ne;3;0;0;3
7245;Puriena;Meškučių;1238475246;Ne;3;0;0;3
7246;Puriena;Meškučių;5591189546;Ne;5;1;0;6
7247;Puriena;Meškučių;9748726934;Ne;5;0;0;5
7248;Puriena;Meškučių;7466163131;Ne;2;8;0;10
7249;Puriena;Meškučių;2466609635;Ne;2;0;10;12
7250;Puriena;Meškučių;3309219271;Ne;0;5;0;5
7251;Puriena;Meškučių;9509041179;Ne;0;4;0;4
7252;Puriena;Meškučių;5176663365;Ne;0;1;0;1
7253;Puriena;Meškučių;9961074983;Ne;0;2;0;2
7254;Puriena;Meškučių;3011629747;Ne;4;1;0;5
7255;Puriena;Meškučių;6185080390;Ne;4;0;0;4
7256;Puriena;Meškučių;3526684967;Ne;3;1;0;4
7257;Puriena;Meškučių;1513909923;Ne;8;0;2;10
7258;Puriena;Meškučių;7556975480;Ne;0;6;5;11
7259;Puriena;Meškučių;2711642252;Taip;0;1;0;1
7260;Puriena;Meškučių;8093664167;Taip;0;2;0;2
7261;Puriena;Nykštukų;1053386081;Taip;6;1;0;7
7262;Puriena;Nykštukų;5469827031;Taip;7;0;0;7
7263;Puriena;Nykštukų;7649596096;Taip;17;0;0;17
7264;Puriena;Nykštukų;2762325241;Taip;11;1;2;14
7265;Puriena;Nykštukų;9907142348;Ne;9;0;0;9
7266;Puriena;Nykštukų;9369786639;Ne;11;0;0;11
7267;Puriena;Nykštukų;4728991133;Ne;5;0;0;5
7268;Puriena;Nykštukų;2344061847;Taip;5;2;0;7
7269;Puriena;Nykštukų;9438604106;Ne;0;1;1;2
7270;Puriena;Nykštukų;9379314578;Ne;9;0;1;10
7271;Puriena;Nykštukų;4211784186;Ne;10;0;0;10
7272;Puriena;Nykštukų;2146727759;Ne;10;0;0;10
7273;Puriena;Nykštukų;1988826809;Ne;5;0;0;5
7274;Puriena;Nykštukų;6605817147;Ne;7;0;0;7
7275;Puriena;Nykštukų;6271951373;Ne;0;11;0;11
7276;Puriena;Nykštukų;7869104640;Ne;7;1;0;8
7277;Puriena;Nykštukų;9497287421;Ne;0;1;0;1
7278;Puriena;Nykštukų;4006267650;Taip;0;8;0;8
7279;Puriena;Nykštukų;3215364967;Ne;2;2;0;4
7280;Puriena;Ežiukai;6612468095;Taip;5;1;0;6
7281;Puriena;Ežiukai;7913847170;Ne;7;1;0;8
7282;Puriena;Ežiukai;8089081251;Ne;5;4;0;9
7283;Puriena;Ežiukai;2830409862;Ne;0;5;0;5
7284;Puriena;Ežiukai;5550321808;Ne;0;0;1;1
7285;Puriena;Ežiukai;8038573068;Ne;0;2;0;2
7286;Puriena;Ežiukai;2624283930;Ne;2;0;0;2
7287;Puriena;Ežiukai;6001659356;Ne;0;1;2;3
7288;Puriena;Ežiukai;5539708916;Ne;2;1;0;3
7289;Puriena;Ežiukai;3204824116;Ne;4;0;0;4
7290;Puriena;Ežiukai;7720549981;Ne;8;0;2;10
7291;Puriena;Ežiukai;5555076926;Ne;10;0;0;10
7292;Puriena;Ežiukai;2312297583;Ne;4;0;1;5
7293;Puriena;Ežiukai;3232981406;Ne;9;0;0;9
7294;Puriena;Ežiukai;9228372078;Ne;10;7;0;17
7295;Puriena;Ežiukai;5374864513;Ne;16;0;0;16
7296;Puriena;Ežiukai;6991740430;Ne;3;0;0;3
7297;Puriena;"Boružiukų ";9600515308;Taip;0;0;2;2
7298;Puriena;"Boružiukų ";7985332838;Ne;0;20;0;20
7299;Puriena;"Boružiukų ";2818282875;Ne;0;1;1;2
7300;Puriena;"Boružiukų ";1796123753;Ne;7;0;1;8
7301;Puriena;"Boružiukų ";9489913940;Taip;15;0;0;15
7302;Puriena;"Boružiukų ";7350776605;Ne;1;0;0;1
7303;Puriena;"Boružiukų ";3521550682;Ne;17;0;0;17
7304;Puriena;"Boružiukų ";7554505121;Taip;6;1;0;7
7305;Puriena;"Boružiukų ";9728603155;Ne;0;2;0;2
7306;Puriena;"Boružiukų ";9715082990;Taip;10;1;0;11
7307;Puriena;"Boružiukų ";1453976004;Ne;13;0;0;13
7308;Puriena;"Boružiukų ";9402161115;Ne;2;0;0;2
7309;Puriena;"Boružiukų ";6966564224;Ne;18;0;0;18
7310;Puriena;"Boružiukų ";3888242345;Ne;18;0;0;18
7311;Puriena;"Boružiukų ";9085439508;Ne;6;0;2;8
7312;Puriena;"Zuikučių ";6549867740;Ne;0;1;0;1
7313;Puriena;"Zuikučių ";9102891844;Ne;9;0;0;9
7314;Puriena;"Zuikučių ";4946887007;Ne;0;20;0;20
7315;Puriena;"Zuikučių ";8607005504;Ne;0;0;2;2
7316;Puriena;"Zuikučių ";9553026735;Ne;12;0;0;12
7317;Puriena;"Zuikučių ";5257520238;Ne;0;2;0;2
7318;Puriena;"Zuikučių ";4549244705;Ne;2;1;0;3
7319;Puriena;"Zuikučių ";4102059769;Ne;13;0;0;13
7320;Puriena;"Zuikučių ";4257334383;Ne;7;1;0;8
7321;Puriena;"Zuikučių ";2736255661;Ne;8;1;0;9
7322;Puriena;"Zuikučių ";4363865643;Ne;4;1;0;5
7323;Puriena;"Zuikučių ";6084041374;Ne;10;2;0;12
7324;Puriena;"Zuikučių ";1877494111;Ne;3;1;1;5
7325;Puriena;"Zuikučių ";3510157302;Ne;0;20;0;20
7326;Puriena;Skruzdėliukai;9729644429;Ne;0;0;1;1
7327;Puriena;Skruzdėliukai;3826282438;Taip;6;0;0;6
7328;Puriena;Skruzdėliukai;4283608124;Ne;7;2;0;9
7329;Puriena;Skruzdėliukai;8144488922;Ne;2;0;3;5
7330;Puriena;Skruzdėliukai;8476986855;Ne;0;2;3;5
7331;Puriena;Skruzdėliukai;3627403517;Ne;3;0;0;3
7332;Puriena;Skruzdėliukai;6140294839;Ne;16;0;0;16
7333;Puriena;Skruzdėliukai;2813562677;Ne;0;1;0;1
7334;Puriena;Skruzdėliukai;9453994213;Ne;1;0;0;1
7335;Puriena;Skruzdėliukai;4653085762;Ne;0;11;0;11
7336;Puriena;Skruzdėliukai;3542374463;Ne;4;0;0;4
7337;Puriena;Skruzdėliukai;8497070167;Taip;12;0;0;12
7338;Puriena;Skruzdėliukai;4498919764;Ne;9;0;1;10
7339;Puriena;Skruzdėliukai;4517020977;Taip;2;0;0;2
7340;Puriena;Skruzdėliukai;6150437624;Ne;0;0;1;1
7341;Puriena;Skruzdėliukai;3455291312;Ne;10;0;2;12
7342;Puriena;Skruzdėliukai;9911792407;Ne;11;2;0;13
7343;Puriena;Skruzdėliukai;6352605894;Ne;1;0;0;1
7344;Pušaitė;Kodėlčiukai;8702361596;Ne;0;1;1;2
7345;Pušaitė;Kodėlčiukai;3832434608;Ne;5;0;0;5
7346;Pušaitė;Kodėlčiukai;7068451014;Ne;5;0;0;5
7347;Pušaitė;Kodėlčiukai;6275090953;Ne;3;6;0;9
7348;Pušaitė;Kodėlčiukai;4198571222;Ne;0;0;2;2
7349;Pušaitė;Kodėlčiukai;9391350218;Ne;5;2;0;7
7350;Pušaitė;Kodėlčiukai;9364887123;Ne;3;0;0;3
7351;Pušaitė;Kodėlčiukai;4326967247;Ne;0;6;0;6
7352;Pušaitė;Kodėlčiukai;5922053969;Ne;3;0;0;3
7353;Pušaitė;Kodėlčiukai;4473930703;Ne;0;2;0;2
7354;Pušaitė;Kodėlčiukai;6775428321;Ne;0;0;1;1
7355;Pušaitė;Kodėlčiukai;4615270419;Ne;4;1;0;5
7356;Pušaitė;Kodėlčiukai;7117784038;Ne;5;2;0;7
7357;Pušaitė;Kodėlčiukai;8754286143;Ne;5;0;0;5
7358;Pušaitė;Kodėlčiukai;6186545163;Ne;2;0;0;2
7359;Pušaitė;Kodėlčiukai;6189116357;Taip;12;0;3;15
7360;Pušaitė;Saulutės;2254269292;Ne;6;0;0;6
7361;Pušaitė;Saulutės;5306237557;Ne;15;0;1;16
7362;Pušaitė;Saulutės;7480846917;Taip;6;0;0;6
7363;Pušaitė;Saulutės;8355083823;Ne;3;0;2;5
7364;Pušaitė;Saulutės;8914668904;Ne;8;0;0;8
7365;Pušaitė;Saulutės;2396217546;Ne;0;1;1;2
7366;Pušaitė;Saulutės;3126709123;Ne;9;0;1;10
7367;Pušaitė;Saulutės;5469990058;Ne;8;0;3;11
7368;Pušaitė;Saulutės;1044902638;Ne;6;0;0;6
7369;Pušaitė;Saulutės;6784729764;Ne;0;20;0;20
7370;Pušaitė;Saulutės;6215522656;Ne;1;0;0;1
7371;Pušaitė;Saulutės;2675136958;Ne;4;2;0;6
7372;Pušaitė;Saulutės;6261355186;Ne;0;0;14;14
7373;Pušaitė;Saulutės;7888103890;Ne;5;0;1;6
7374;Pušaitė;Saulutės;6848340140;Taip;4;1;0;5
7375;Pušaitė;Zuikučiai;7291412329;Ne;4;0;0;4
7376;Pušaitė;Zuikučiai;8931688329;Ne;12;0;0;12
7377;Pušaitė;Zuikučiai;5981944481;Ne;17;0;0;17
7378;Pušaitė;Zuikučiai;4511258460;Taip;4;0;0;4
7379;Pušaitė;Zuikučiai;5422616450;Ne;3;1;1;5
7380;Pušaitė;Zuikučiai;5819186055;Ne;2;0;0;2
7381;Pušaitė;Zuikučiai;1384820994;Ne;5;0;0;5
7382;Pušaitė;Zuikučiai;7237345427;Ne;0;0;1;1
7383;Pušaitė;Zuikučiai;9180309936;Taip;5;1;0;6
7384;Pušaitė;Zuikučiai;4754791489;Ne;1;0;1;2
7385;Pušaitė;Zuikučiai;4082173648;Ne;10;1;0;11
7386;Pušaitė;Zuikučiai;2264047794;Ne;5;2;0;7
7387;Pušaitė;Zuikučiai;3052743933;Ne;0;20;0;20
7388;Pušaitė;Zuikučiai;4278699624;Ne;5;0;0;5
7389;Pušaitė;Zuikučiai;8244793037;Taip;11;0;1;12
7390;Pušaitė;Zuikučiai;5002710062;Taip;0;12;0;12
7391;Pušaitė;Zuikučiai;3508664946;Ne;0;3;0;3
7392;Pušaitė;Zuikučiai;2887576870;Ne;3;0;1;4
7393;Pušaitė;Zuikučiai;7583243031;Ne;4;0;1;5
7394;Pušaitė;Zuikučiai;1180343204;Ne;4;4;1;9
7395;Pušaitė;Vėžliukai;8412276797;Ne;0;2;0;2
7396;Pušaitė;Vėžliukai;1326581025;Ne;0;5;0;5
7397;Pušaitė;Vėžliukai;8135552679;Ne;5;0;0;5
7398;Pušaitė;Vėžliukai;5161142520;Ne;6;0;0;6
7399;Pušaitė;Vėžliukai;3485234259;Ne;2;1;1;4
7400;Pušaitė;Vėžliukai;3014867515;Ne;0;2;0;2
7401;Pušaitė;Vėžliukai;6739253961;Ne;0;4;0;4
7402;Pušaitė;Vėžliukai;7890577174;Ne;4;0;0;4
7403;Pušaitė;Vėžliukai;5318602924;Ne;5;2;0;7
7404;Pušaitė;Vėžliukai;6794867560;Ne;0;0;1;1
7405;Pušaitė;Vėžliukai;5296435012;Taip;0;0;2;2
7406;Pušaitė;Vėžliukai;6833083982;Ne;0;3;1;4
7407;Pušaitė;Vėžliukai;5512786073;Ne;10;3;0;13
7408;Pušaitė;Vėžliukai;8399589954;Ne;0;1;0;1
7409;Pušaitė;Vėžliukai;4281125486;Ne;0;0;3;3
7410;Pušaitė;Vėžliukai;2777222076;Ne;0;1;0;1
7411;Pušaitė;"Linksmieji nykštukai";9033615485;Taip;3;2;0;5
7412;Pušaitė;"Linksmieji nykštukai";1781601521;Ne;0;0;1;1
7413;Pušaitė;"Linksmieji nykštukai";1024996364;Ne;1;0;0;1
7414;Pušaitė;"Linksmieji nykštukai";4662871524;Ne;0;10;0;10
7415;Pušaitė;"Linksmieji nykštukai";8438652029;Ne;0;10;0;10
7416;Pušaitė;"Linksmieji nykštukai";6578483902;Ne;7;0;0;7
7417;Pušaitė;"Linksmieji nykštukai";4175909754;Ne;0;1;1;2
7418;Pušaitė;"Linksmieji nykštukai";3788392895;Ne;5;1;0;6
7419;Pušaitė;"Linksmieji nykštukai";9127444013;Ne;5;1;0;6
7420;Pušaitė;"Linksmieji nykštukai";5422784898;Ne;9;0;0;9
7421;Pušaitė;"Linksmieji nykštukai";5104111840;Ne;0;10;0;10
7422;Pušaitė;"Linksmieji nykštukai";9866431097;Ne;5;1;0;6
7423;Pušaitė;"Linksmieji nykštukai";8378313810;Ne;7;0;0;7
7424;Pušaitė;"Kačiukų trobelė";7983115812;Ne;1;0;0;1
7425;Pušaitė;"Kačiukų trobelė";1122112207;Ne;0;3;0;3
7426;Pušaitė;"Kačiukų trobelė";2837439334;Ne;2;0;0;2
7427;Pušaitė;"Kačiukų trobelė";7014914682;Taip;7;2;0;9
7428;Pušaitė;"Kačiukų trobelė";1624587173;Ne;0;4;0;4
7429;Pušaitė;"Kačiukų trobelė";8793102437;Ne;5;5;0;10
7430;Pušaitė;"Kačiukų trobelė";9056933586;Ne;4;2;0;6
7431;Pušaitė;"Kačiukų trobelė";7898355721;Ne;2;0;0;2
7432;Pušaitė;"Kačiukų trobelė";5191894075;Ne;0;2;0;2
7433;Pušaitė;"Kačiukų trobelė";8822285103;Ne;0;5;0;5
7434;Pušaitė;"Kačiukų trobelė";9313564235;Ne;5;0;0;5
7435;Pušaitė;"Kačiukų trobelė";2430891944;Ne;5;0;1;6
7436;Pušaitė;"Kačiukų trobelė";1978339054;Ne;0;1;0;1
7437;Pušaitė;"Kačiukų trobelė";5461822909;Taip;3;0;0;3
7438;Pušaitė;Ežiukai;5013833636;Ne;0;1;6;7
7439;Pušaitė;Ežiukai;7891007708;Ne;0;5;0;5
7440;Pušaitė;Ežiukai;3732377309;Ne;5;0;0;5
7441;Pušaitė;Ežiukai;6511940816;Ne;14;0;0;14
7442;Pušaitė;Ežiukai;9546541248;Ne;0;0;6;6
7443;Pušaitė;Ežiukai;4769806128;Ne;8;0;0;8
7444;Pušaitė;Ežiukai;4529006786;Ne;20;0;0;20
7445;Pušaitė;Ežiukai;5270528758;Ne;3;0;2;5
7446;Pušaitė;Ežiukai;6767281906;Taip;0;1;0;1
7447;Pušaitė;Ežiukai;7210529114;Ne;0;2;2;4
7448;Pušaitė;Ežiukai;9164927041;Ne;0;2;6;8
7449;Pušaitė;Ežiukai;9867041220;Ne;1;0;2;3
7450;Pušaitė;Ežiukai;9031289300;Ne;10;0;0;10
7451;Pušaitė;Ežiukai;2758026755;Ne;0;2;0;2
7452;Pušaitė;Ežiukai;6059415475;Ne;0;0;6;6
7453;Pušaitė;Ežiukai;6851908671;Ne;7;0;0;7
7454;Pušaitė;Ežiukai;7737524017;Taip;0;1;0;1
7455;Pušaitė;Ežiukai;1069369636;Ne;3;4;0;7
7456;Pušaitė;Ežiukai;2454348536;Taip;6;0;1;7
7457;Pušaitė;Ežiukai;4883211957;Ne;0;0;4;4
7458;Pušaitė;"Gudručių šalis";8763667682;Ne;6;0;1;7
7459;Pušaitė;"Gudručių šalis";5488507646;Taip;0;20;0;20
7460;Pušaitė;"Gudručių šalis";1305526154;Ne;5;0;1;6
7461;Pušaitė;"Gudručių šalis";6205900423;Ne;0;20;0;20
7462;Pušaitė;"Gudručių šalis";8790959900;Ne;0;2;0;2
7463;Pušaitė;"Gudručių šalis";2397106198;Ne;6;1;0;7
7464;Pušaitė;"Gudručių šalis";8343949011;Ne;2;0;1;3
7465;Pušaitė;"Gudručių šalis";4101285889;Ne;4;0;5;9
7466;Pušaitė;"Gudručių šalis";3959838346;Ne;0;1;0;1
7467;Pušaitė;"Gudručių šalis";6356263503;Ne;0;0;4;4
7468;Pušaitė;"Gudručių šalis";4918124423;Ne;4;0;2;6
7469;Pušaitė;"Gudručių šalis";6734504906;Ne;0;12;0;12
7470;Pušaitė;"Lapučių mokyklėlė";2666541612;Ne;9;1;0;10
7471;Pušaitė;"Lapučių mokyklėlė";8343225451;Ne;0;2;3;5
7472;Pušaitė;"Lapučių mokyklėlė";8218991320;Ne;4;0;0;4
7473;Pušaitė;"Lapučių mokyklėlė";1994898058;Ne;0;1;2;3
7474;Pušaitė;"Lapučių mokyklėlė";8551426938;Ne;7;0;0;7
7475;Pušaitė;"Lapučių mokyklėlė";4444972517;Ne;3;0;0;3
7476;Pušaitė;"Lapučių mokyklėlė";4138386134;Ne;5;0;0;5
7477;Pušaitė;"Lapučių mokyklėlė";4103149433;Ne;0;1;0;1
7478;Pušaitė;"Lapučių mokyklėlė";3387165403;Ne;0;1;0;1
7479;Pušaitė;"Lapučių mokyklėlė";5339878948;Ne;0;1;0;1
7480;Pušaitė;"Lapučių mokyklėlė";3610256789;Ne;0;2;6;8
7481;Pušaitė;"Lapučių mokyklėlė";6576647982;Taip;17;0;0;17
7482;Pušaitė;"Lapučių mokyklėlė";1534764228;Ne;0;4;0;4
7483;Pušaitė;"Lapučių mokyklėlė";5328083339;Taip;2;0;0;2
7484;Pušaitė;"Lapučių mokyklėlė";3200968850;Ne;0;11;0;11
7485;Pušaitė;"Lapučių mokyklėlė";5270684456;Ne;7;0;0;7
7486;Pušaitė;"VOVERIUKAI ";1665030028;Taip;0;12;0;12
7487;Pušaitė;"VOVERIUKAI ";8876092901;Taip;5;0;0;5
7488;Pušaitė;"VOVERIUKAI ";4767321724;Ne;8;0;1;9
7489;Pušaitė;"VOVERIUKAI ";1542239525;Ne;4;0;0;4
7490;Pušaitė;"VOVERIUKAI ";7971556404;Ne;10;0;0;10
7491;Pušaitė;"VOVERIUKAI ";6643741885;Ne;10;0;0;10
7492;Pušaitė;"VOVERIUKAI ";1439721280;Ne;2;0;1;3
7493;Pušaitė;"VOVERIUKAI ";6891217457;Ne;10;0;0;10
7494;Pušaitė;"VOVERIUKAI ";6786313527;Ne;3;0;0;3
7495;Pušaitė;"VOVERIUKAI ";8739461926;Ne;0;20;0;20
7496;Pušaitė;"VOVERIUKAI ";8967363762;Ne;0;20;0;20
7497;Pušaitė;"VOVERIUKAI ";2699657569;Ne;5;0;0;5
7498;Pušaitė;"VOVERIUKAI ";5191447724;Ne;8;0;0;8
7499;Pušaitė;MEŠKUČIAI;9872317190;Ne;3;0;0;3
7500;Pušaitė;MEŠKUČIAI;6754402783;Taip;12;0;0;12
7501;Pušaitė;MEŠKUČIAI;3239486674;Taip;5;0;0;5
7502;Pušaitė;MEŠKUČIAI;9339706754;Taip;0;1;0;1
7503;Pušaitė;MEŠKUČIAI;9418440677;Ne;2;1;0;3
7504;Pušaitė;MEŠKUČIAI;9887693476;Ne;2;3;0;5
7505;Pušaitė;MEŠKUČIAI;1034005054;Ne;13;0;1;14
7506;Pušaitė;MEŠKUČIAI;8916214448;Ne;6;0;0;6
7507;Pušaitė;MEŠKUČIAI;3238080908;Ne;3;1;0;4
7508;Pušaitė;MEŠKUČIAI;4331500545;Ne;6;0;0;6
7509;Pušaitė;MEŠKUČIAI;7278950473;Ne;5;0;1;6
7510;Pušaitė;MEŠKUČIAI;3994799424;Ne;7;0;0;7
7511;Pušaitė;MEŠKUČIAI;5686927118;Ne;0;20;0;20
7512;Pušaitė;PELIUKAI;9177861202;Taip;0;2;0;2
7513;Pušaitė;PELIUKAI;6645711171;Ne;6;4;0;10
7514;Pušaitė;PELIUKAI;2618038364;Ne;6;0;0;6
7515;Pušaitė;PELIUKAI;5112517007;Ne;4;0;0;4
7516;Pušaitė;PELIUKAI;7285450755;Ne;8;0;0;8
7517;Pušaitė;PELIUKAI;7204853123;Ne;5;3;0;8
7518;Pušaitė;PELIUKAI;4802860079;Ne;16;0;0;16
7519;Pušaitė;PELIUKAI;2772351972;Ne;6;0;0;6
7520;Pušaitė;PELIUKAI;1450204608;Ne;0;20;0;20
7521;Pušaitė;PELIUKAI;7553389781;Ne;8;0;0;8
7522;Pušaitė;PELIUKAI;4420904389;Ne;0;20;0;20
7523;Pušaitė;PELIUKAI;8273198870;Ne;1;1;0;2
7524;Pušaitė;PELIUKAI;3245931596;Ne;0;20;0;20
7525;"Pušynėlis (Miglos g. 53)";PUMPURĖLIAI;7689524787;Ne;10;0;0;10
7526;"Pušynėlis (Miglos g. 53)";PUMPURĖLIAI;1517104634;Ne;0;4;0;4
7527;"Pušynėlis (Miglos g. 53)";PUMPURĖLIAI;8933840402;Ne;2;0;0;2
7528;"Pušynėlis (Miglos g. 53)";PUMPURĖLIAI;1439408620;Ne;8;0;0;8
7529;"Pušynėlis (Miglos g. 53)";PUMPURĖLIAI;3682719098;Ne;0;6;1;7
7530;"Pušynėlis (Miglos g. 53)";PUMPURĖLIAI;4449613959;Ne;20;0;0;20
7531;"Pušynėlis (Miglos g. 53)";PUMPURĖLIAI;3125802067;Ne;10;3;1;14
7532;"Pušynėlis (Miglos g. 53)";PUMPURĖLIAI;1508282873;Ne;0;0;1;1
7533;"Pušynėlis (Miglos g. 53)";PUMPURĖLIAI;5670094788;Ne;1;5;0;6
7534;"Pušynėlis (Miglos g. 53)";PUMPURĖLIAI;5264481173;Ne;5;0;2;7
7535;"Pušynėlis (Miglos g. 53)";SAULUTĖS;5501281051;Ne;8;0;0;8
7536;"Pušynėlis (Miglos g. 53)";SAULUTĖS;2135996648;Ne;14;0;0;14
7537;"Pušynėlis (Miglos g. 53)";SAULUTĖS;9454407638;Ne;14;0;0;14
7538;"Pušynėlis (Miglos g. 53)";SAULUTĖS;2553444832;Ne;3;0;0;3
7539;"Pušynėlis (Miglos g. 53)";SAULUTĖS;2509111066;Ne;3;0;0;3
7540;"Pušynėlis (Miglos g. 53)";SAULUTĖS;3483639540;Ne;2;0;0;2
7541;"Pušynėlis (Miglos g. 53)";SAULUTĖS;2861000826;Taip;0;1;0;1
7542;"Pušynėlis (Miglos g. 53)";SAULUTĖS;5802582694;Ne;0;1;0;1
7543;"Pušynėlis (Miglos g. 53)";SAULUTĖS;3882064516;Ne;3;0;0;3
7544;"Pušynėlis (Miglos g. 53)";SAULUTĖS;9081582524;Ne;3;0;0;3
7545;"Pušynėlis (Miglos g. 53)";SAULUTĖS;9883505094;Ne;7;0;0;7
7546;"Pušynėlis (Miglos g. 53)";SAULUTĖS;4526807309;Ne;4;0;0;4
7547;"Pušynėlis (Miglos g. 53)";SAULUTĖS;7787646910;Ne;1;0;0;1
7548;"Pušynėlis (Miglos g. 53)";SAULUTĖS;7438923710;Ne;8;0;0;8
7549;"Pušynėlis (Miglos g. 53)";SAULUTĖS;6110878898;Ne;7;0;0;7
7550;"Pušynėlis (Miglos g. 53)";SAULUTĖS;8462742834;Ne;1;1;0;2
7551;"Pušynėlis (Miglos g. 53)";SAULUTĖS;6962705842;Ne;5;0;0;5
7552;"Pušynėlis (Miglos g. 53)";SAULUTĖS;2744665477;Ne;1;0;0;1
7553;"Pušynėlis (Miglos g. 53)";PRIEŠMOKYKLINĖ;4030500100;Ne;0;1;0;1
7554;"Pušynėlis (Miglos g. 53)";PRIEŠMOKYKLINĖ;8172450090;Ne;0;1;0;1
7555;"Pušynėlis (Miglos g. 53)";PRIEŠMOKYKLINĖ;9483417104;Ne;6;0;0;6
7556;"Pušynėlis (Miglos g. 53)";PRIEŠMOKYKLINĖ;1891728904;Ne;2;0;0;2
7557;"Pušynėlis (Miglos g. 53)";PRIEŠMOKYKLINĖ;2508640229;Ne;1;0;0;1
7558;"Pušynėlis (Miglos g. 53)";PRIEŠMOKYKLINĖ;1251787066;Ne;17;0;0;17
7559;"Pušynėlis (Miglos g. 53)";PRIEŠMOKYKLINĖ;5236219294;Ne;3;1;0;4
7560;"Pušynėlis (Miglos g. 53)";PRIEŠMOKYKLINĖ;6709692748;Ne;0;1;0;1
7561;"Pušynėlis (Miglos g. 53)";PRIEŠMOKYKLINĖ;8799095053;Ne;0;5;0;5
7562;"Pušynėlis (Miglos g. 53)";PRIEŠMOKYKLINĖ;5318223378;Ne;0;1;0;1
7563;"Pušynėlis (Miglos g. 53)";PRIEŠMOKYKLINĖ;3100230874;Ne;6;3;0;9
7564;"Pušynėlis (Miglos g. 53)";PRIEŠMOKYKLINĖ;7896617995;Ne;5;0;2;7
7565;"Pušynėlis (Miglos g. 53)";PRIEŠMOKYKLINĖ;5897839636;Ne;0;1;0;1
7566;"Pušynėlis (Miglos g. 53)";PRIEŠMOKYKLINĖ;1034336110;Ne;3;1;0;4
7567;"Pušynėlis (Miglos g. 53)";PRIEŠMOKYKLINĖ;3483007385;Ne;0;2;0;2
7568;"Pušynėlis (Miglos g. 53)";"TREPSIUKAI (2018.09)";5748126562;Taip;10;10;0;20
7569;"Pušynėlis (Miglos g. 53)";"TREPSIUKAI (2018.09)";7752614074;Ne;0;0;6;6
7570;"Pušynėlis (Miglos g. 53)";"TREPSIUKAI (2018.09)";9665045009;Ne;0;0;1;1
7571;"Pušynėlis (Miglos g. 53)";"TREPSIUKAI (2018.09)";1318218735;Ne;0;0;7;7
7572;"Pušynėlis (Miglos g. 53)";"TREPSIUKAI (2018.09)";5723212271;Ne;16;0;0;16
7573;Raktelis;LAŠIUKAI;9230053040;Ne;10;7;0;17
7574;Raktelis;LAŠIUKAI;9139322116;Ne;0;0;2;2
7575;Raktelis;LAŠIUKAI;5627179884;Ne;0;0;2;2
7576;Raktelis;LAŠIUKAI;9965855682;Ne;0;1;0;1
7577;Raktelis;LAŠIUKAI;7265543701;Ne;3;0;0;3
7578;Raktelis;LAŠIUKAI;4319176525;Ne;0;2;1;3
7579;Raktelis;LAŠIUKAI;5218387088;Ne;0;1;0;1
7580;Raktelis;LAŠIUKAI;5820028619;Ne;0;0;2;2
7581;Raktelis;LAŠIUKAI;5405322552;Ne;18;0;0;18
7582;Raktelis;LAŠIUKAI;3821849812;Ne;5;0;2;7
7583;Raktelis;LAŠIUKAI;4905982507;Ne;0;1;0;1
7584;Raktelis;LAŠIUKAI;7170546710;Ne;8;0;3;11
7585;Raktelis;LAŠIUKAI;9355380341;Ne;0;0;2;2
7586;Raktelis;LAŠIUKAI;9593639791;Ne;3;0;1;4
7587;Raktelis;LAŠIUKAI;6608224825;Ne;4;5;0;9
7588;Raktelis;LAŠIUKAI;6199212999;Ne;0;4;0;4
7589;Raktelis;LAŠIUKAI;1622504968;Ne;3;0;0;3
7590;Raktelis;BITUTĖS;3308623522;Ne;3;1;0;4
7591;Raktelis;BITUTĖS;4059286631;Ne;2;1;0;3
7592;Raktelis;BITUTĖS;6974263764;Ne;6;3;0;9
7593;Raktelis;BITUTĖS;2410682193;Ne;3;0;0;3
7594;Raktelis;BITUTĖS;4615337759;Ne;2;1;0;3
7595;Raktelis;BITUTĖS;4962251215;Ne;5;0;0;5
7596;Raktelis;BITUTĖS;8282429202;Ne;5;0;0;5
7597;Raktelis;BITUTĖS;7222856683;Ne;0;1;0;1
7598;Raktelis;BITUTĖS;7479542200;Ne;2;0;0;2
7599;Raktelis;BITUTĖS;6703168910;Ne;0;2;1;3
7600;Raktelis;BITUTĖS;1026592738;Ne;9;2;0;11
7601;Raktelis;BITUTĖS;7900644404;Ne;20;0;0;20
7602;Raktelis;BITUTĖS;6685891017;Ne;5;0;0;5
7603;Raktelis;BITUTĖS;3484991718;Ne;10;1;0;11
7604;Raktelis;BITUTĖS;6358227532;Ne;0;5;0;5
7605;Raktelis;BITUTĖS;9718355271;Ne;5;1;0;6
7606;Raktelis;BITUTĖS;8608093349;Ne;0;1;0;1
7607;Raktelis;BITUTĖS;6855863189;Ne;10;0;0;10
7608;Raktelis;BITUTĖS;7605822626;Ne;8;1;0;9
7609;Raktelis;BITUTĖS;9169797346;Ne;7;1;0;8
7610;Raktelis;BITUTĖS;2383174152;Ne;9;4;0;13
7611;Raktelis;BITUTĖS;7046291082;Ne;0;1;0;1
7612;Raktelis;BORUŽĖLĖS;7068061170;Ne;5;0;0;5
7613;Raktelis;BORUŽĖLĖS;2361477092;Ne;4;2;0;6
7614;Raktelis;BORUŽĖLĖS;4226277600;Ne;8;0;0;8
7615;Raktelis;BORUŽĖLĖS;2599670832;Ne;5;0;0;5
7616;Raktelis;BORUŽĖLĖS;1757601091;Ne;8;2;0;10
7617;Raktelis;BORUŽĖLĖS;5865484633;Ne;2;1;0;3
7618;Raktelis;BORUŽĖLĖS;4936637343;Ne;0;1;0;1
7619;Raktelis;BORUŽĖLĖS;4333191842;Ne;5;0;1;6
7620;Raktelis;BORUŽĖLĖS;4442395100;Ne;5;4;2;11
7621;Raktelis;BORUŽĖLĖS;5150954686;Ne;9;0;0;9
7622;Raktelis;BORUŽĖLĖS;3490428062;Ne;1;3;0;4
7623;Raktelis;BORUŽĖLĖS;1314972335;Ne;0;7;0;7
7624;Raktelis;BORUŽĖLĖS;3343352568;Ne;0;0;5;5
7625;Raktelis;BORUŽĖLĖS;7459272209;Ne;5;0;0;5
7626;Raktelis;BORUŽĖLĖS;5046450478;Ne;2;2;0;4
7627;Raktelis;BORUŽĖLĖS;1141447274;Ne;6;3;0;9
7628;Raktelis;BORUŽĖLĖS;5576511314;Ne;5;1;0;6
7629;Raktelis;BORUŽĖLĖS;9567582066;Ne;10;0;0;10
7630;Raktelis;BORUŽĖLĖS;3456093273;Ne;0;2;0;2
7631;Raktelis;BORUŽĖLĖS;8647112887;Taip;5;2;0;7
7632;Raktelis;KAČIUKAI;5270430511;Ne;6;0;0;6
7633;Raktelis;KAČIUKAI;4622683599;Ne;0;1;0;1
7634;Raktelis;KAČIUKAI;8600632097;Ne;5;4;0;9
7635;Raktelis;KAČIUKAI;7630501672;Ne;0;1;0;1
7636;Raktelis;KAČIUKAI;6007823584;Ne;0;1;0;1
7637;Raktelis;KAČIUKAI;4676213966;Ne;0;10;0;10
7638;Raktelis;KAČIUKAI;4631375439;Ne;0;5;0;5
7639;Raktelis;KAČIUKAI;6265489540;Ne;3;6;0;9
7640;Raktelis;KAČIUKAI;4160091258;Ne;1;1;0;2
7641;Raktelis;KAČIUKAI;3775306030;Ne;4;1;0;5
7642;Raktelis;KAČIUKAI;6550851582;Ne;4;2;0;6
7643;Raktelis;KAČIUKAI;4009105487;Ne;3;0;0;3
7644;Raktelis;KAČIUKAI;1843086151;Ne;6;1;0;7
7645;Raktelis;KAČIUKAI;2295251060;Ne;0;1;0;1
7646;Raktelis;KAČIUKAI;1983808547;Ne;5;0;0;5
7647;Raktelis;KAČIUKAI;5042538956;Ne;0;2;0;2
7648;Raktelis;KAČIUKAI;7260767942;Ne;10;0;0;10
7649;Raktelis;KAČIUKAI;1123693990;Ne;11;1;0;12
7650;Raktelis;KAČIUKAI;4979657165;Taip;0;1;0;1
7651;Raktelis;KAČIUKAI;2700148968;Ne;0;5;0;5
7652;Raktelis;KAČIUKAI;9264550987;Ne;1;0;0;1
7653;Raktelis;KAČIUKAI;8767785444;Ne;3;0;0;3
7654;Raktelis;KIŠKUČIAI;1810732707;Ne;5;1;0;6
7655;Raktelis;KIŠKUČIAI;5293558630;Ne;4;0;0;4
7656;Raktelis;KIŠKUČIAI;6473692639;Ne;4;1;0;5
7657;Raktelis;KIŠKUČIAI;1668164327;Ne;4;1;0;5
7658;Raktelis;KIŠKUČIAI;1058482540;Ne;5;1;0;6
7659;Raktelis;KIŠKUČIAI;6222364306;Ne;16;0;0;16
7660;Raktelis;KIŠKUČIAI;6451056434;Ne;11;0;0;11
7661;Raktelis;KIŠKUČIAI;1129962966;Ne;0;2;0;2
7662;Raktelis;KIŠKUČIAI;5213015670;Ne;3;0;0;3
7663;Raktelis;KIŠKUČIAI;7931502610;Ne;13;0;0;13
7664;Raktelis;KIŠKUČIAI;2976675359;Ne;12;6;0;18
7665;Raktelis;KIŠKUČIAI;9203811388;Ne;11;1;0;12
7666;Raktelis;KIŠKUČIAI;1511932941;Ne;15;0;0;15
7667;Raktelis;KIŠKUČIAI;5053933317;Ne;16;0;0;16
7668;Raktelis;KIŠKUČIAI;1664533959;Taip;15;1;0;16
7669;Raktelis;NYKŠTUKAI;4252867688;Ne;0;0;1;1
7670;Raktelis;NYKŠTUKAI;8817859592;Ne;7;0;0;7
7671;Raktelis;NYKŠTUKAI;4578445282;Ne;5;2;2;9
7672;Raktelis;NYKŠTUKAI;9164539135;Ne;3;0;0;3
7673;Raktelis;NYKŠTUKAI;4147382341;Ne;0;1;0;1
7674;Raktelis;NYKŠTUKAI;3968555691;Ne;0;5;0;5
7675;Raktelis;NYKŠTUKAI;2234892629;Ne;4;0;1;5
7676;Raktelis;NYKŠTUKAI;8507551381;Ne;3;0;0;3
7677;Raktelis;NYKŠTUKAI;4764915486;Ne;3;0;0;3
7678;Raktelis;NYKŠTUKAI;4765483387;Ne;0;0;1;1
7679;Raktelis;NYKŠTUKAI;2803146830;Ne;10;6;0;16
7680;Raktelis;NYKŠTUKAI;1002851704;Ne;13;0;0;13
7681;Raktelis;NYKŠTUKAI;7202523804;Ne;3;7;0;10
7682;Raktelis;NYKŠTUKAI;6718159439;Ne;8;0;0;8
7683;Raktelis;NYKŠTUKAI;7058612493;Ne;7;0;1;8
7684;Raktelis;NYKŠTUKAI;9390692206;Ne;10;2;0;12
7685;Raktelis;NYKŠTUKAI;8992797384;Ne;3;0;0;3
7686;Raktelis;NYKŠTUKAI;9803505110;Ne;8;2;0;10
7687;Raktelis;NYKŠTUKAI;6587878165;Ne;0;1;0;1
7688;Raktelis;NYKŠTUKAI;2262854947;Ne;8;1;0;9
7689;Raktelis;NYKŠTUKAI;2278227649;Ne;5;1;0;6
7690;Raktelis;NYKŠTUKAI;3493159224;Ne;0;0;1;1
7691;Raktelis;PELIUKAI;2044812301;Ne;0;3;0;3
7692;Raktelis;PELIUKAI;7389910330;Ne;0;2;0;2
7693;Raktelis;PELIUKAI;8698736569;Taip;0;1;0;1
7694;Raktelis;PELIUKAI;4834301832;Ne;0;1;0;1
7695;Raktelis;PELIUKAI;9983004779;Taip;11;1;0;12
7696;Raktelis;PELIUKAI;6346741475;Ne;0;5;0;5
7697;Raktelis;PELIUKAI;4100807708;Ne;7;0;0;7
7698;Raktelis;PELIUKAI;9778807678;Ne;5;1;0;6
7699;Raktelis;PELIUKAI;2928040174;Ne;16;0;0;16
7700;Raktelis;PELIUKAI;4139932945;Ne;3;1;0;4
7701;Raktelis;PELIUKAI;8581379659;Ne;5;0;1;6
7702;Raktelis;PELIUKAI;7892633426;Ne;3;0;0;3
7703;Raktelis;PELIUKAI;7847787737;Ne;1;1;0;2
7704;Raktelis;AGUONOS;9039234219;Ne;7;0;0;7
7705;Raktelis;AGUONOS;3811586185;Ne;12;0;0;12
7706;Raktelis;AGUONOS;1714731965;Taip;13;0;0;13
7707;Raktelis;AGUONOS;9666909207;Ne;11;0;0;11
7708;Raktelis;AGUONOS;9992920721;Ne;6;0;0;6
7709;Raktelis;AGUONOS;6499798110;Ne;7;0;0;7
7710;Raktelis;AGUONOS;2949132578;Ne;4;0;0;4
7711;Raktelis;AGUONOS;4828942464;Ne;8;0;0;8
7712;Raktelis;AGUONOS;5686613002;Ne;7;0;0;7
7713;Raktelis;AGUONOS;5362472918;Ne;3;0;0;3
7714;Raktelis;AGUONOS;9205511475;Ne;7;0;0;7
7715;Raktelis;AGUONOS;1197236154;Ne;12;0;0;12
7716;Raktelis;AGUONOS;2666984428;Ne;1;0;0;1
7717;Raktelis;AGUONOS;6019423312;Ne;6;0;0;6
7718;Raktelis;AGUONOS;2550528342;Ne;10;0;0;10
7719;Raktelis;AGUONOS;1356784453;Ne;18;0;0;18
7720;Raktelis;LAPIUKŲ;3517484891;Ne;10;0;0;10
7721;Raktelis;LAPIUKŲ;2731096860;Ne;7;0;0;7
7722;Raktelis;LAPIUKŲ;1263150004;Taip;0;1;0;1
7723;Raktelis;LAPIUKŲ;1120263625;Ne;5;1;0;6
7724;Raktelis;LAPIUKŲ;5688795147;Ne;0;1;0;1
7725;Raktelis;LAPIUKŲ;8035618134;Ne;0;17;0;17
7726;Raktelis;LAPIUKŲ;8700012974;Ne;0;0;2;2
7727;Raktelis;LAPIUKŲ;1445359221;Ne;4;0;0;4
7728;Raktelis;LAPIUKŲ;1604357851;Ne;6;0;0;6
7729;Raktelis;LAPIUKŲ;5758873229;Ne;7;0;0;7
7730;Raktelis;LAPIUKŲ;9599034285;Ne;4;0;0;4
7731;Raktelis;LAPIUKŲ;3311870918;Ne;5;1;0;6
7732;Raktelis;LAPIUKŲ;6826993779;Ne;5;1;0;6
7733;Raktelis;LAPIUKŲ;2141128125;Ne;13;0;0;13
7734;Raktelis;LAPIUKŲ;4502236264;Ne;0;1;0;1
7735;Raktelis;LAPIUKŲ;2301442262;Ne;1;0;0;1
7736;Raktelis;LAPIUKŲ;6853881405;Ne;0;2;0;2
7737;Raktelis;LAPIUKŲ;4513031164;Ne;2;0;0;2
7738;Raktelis;LAPIUKŲ;4014822452;Ne;7;0;0;7
7739;Raktelis;PELĖDŽIUKAI;4583377785;Ne;2;1;0;3
7740;Raktelis;PELĖDŽIUKAI;9716191639;Ne;0;2;3;5
7741;Raktelis;PELĖDŽIUKAI;8869030487;Taip;0;0;4;4
7742;Raktelis;PELĖDŽIUKAI;1322912585;Ne;7;0;3;10
7743;Raktelis;PELĖDŽIUKAI;6877934219;Taip;1;1;0;2
7744;Raktelis;PELĖDŽIUKAI;9130613710;Ne;3;0;0;3
7745;Raktelis;PELĖDŽIUKAI;9151796053;Ne;0;0;1;1
7746;Raktelis;PELĖDŽIUKAI;5925441742;Ne;5;0;0;5
7747;Raktelis;PELĖDŽIUKAI;5082785025;Ne;0;1;0;1
7748;Raktelis;PELĖDŽIUKAI;3395720463;Ne;0;5;0;5
7749;Raktelis;PELĖDŽIUKAI;4167194960;Taip;0;1;0;1
7750;Raktelis;PELĖDŽIUKAI;2809458453;Ne;8;0;0;8
7751;Raktelis;PELĖDŽIUKAI;6894769625;Ne;0;1;0;1
7752;Raktelis;PELĖDŽIUKAI;2967941870;Taip;6;0;0;6
7753;Raktelis;PELĖDŽIUKAI;9048412613;Ne;4;0;0;4
7754;Raktelis;PELĖDŽIUKAI;7440866459;Ne;5;0;0;5
7755;Raktelis;PELĖDŽIUKAI;4755892641;Taip;2;3;0;5
7756;Raktelis;MEŠKIUKAI;8851021346;Ne;8;0;0;8
7757;Raktelis;MEŠKIUKAI;4185763817;Ne;0;1;0;1
7758;Raktelis;MEŠKIUKAI;8341026400;Ne;0;1;0;1
7759;Raktelis;MEŠKIUKAI;2103900090;Ne;6;0;0;6
7760;Raktelis;MEŠKIUKAI;5718804414;Ne;3;0;0;3
7761;Raktelis;MEŠKIUKAI;6409457833;Ne;5;0;0;5
7762;Raktelis;MEŠKIUKAI;8515886073;Ne;6;0;0;6
7763;Raktelis;MEŠKIUKAI;3956151570;Ne;8;0;0;8
7764;Raktelis;MEŠKIUKAI;1740426946;Ne;9;0;0;9
7765;Raktelis;MEŠKIUKAI;6992649778;Ne;1;0;0;1
7766;Raktelis;MEŠKIUKAI;7090016772;Ne;14;0;0;14
7767;Raktelis;MEŠKIUKAI;1304479190;Ne;16;0;0;16
7768;Raktelis;MEŠKIUKAI;6391559356;Ne;1;5;0;6
7769;Raktelis;MEŠKIUKAI;5358970156;Ne;14;0;0;14
7770;Rasa;Nykštukai;5176175108;Ne;6;1;0;7
7771;Rasa;Nykštukai;1223962374;Ne;9;0;0;9
7772;Rasa;Nykštukai;3200377629;Ne;5;1;0;6
7773;Rasa;Nykštukai;1336291828;Ne;0;4;0;4
7774;Rasa;Nykštukai;5861229664;Ne;2;0;0;2
7775;Rasa;Nykštukai;1386880644;Ne;3;0;0;3
7776;Rasa;Nykštukai;7228037580;Ne;0;1;0;1
7777;Rasa;Nykštukai;5363748728;Ne;0;2;3;5
7778;Rasa;Nykštukai;7520665472;Taip;0;6;0;6
7779;Rasa;Nykštukai;7534306402;Ne;0;1;0;1
7780;Rasa;Nykštukai;3755794133;Ne;0;2;0;2
7781;Rasa;Nykštukai;8424049317;Ne;0;9;0;9
7782;Rasa;Nykštukai;2190948879;Ne;5;1;0;6
7783;Rasa;Nykštukai;4010262461;Ne;0;0;1;1
7784;Rasa;Nykštukai;8236464670;Ne;0;3;0;3
7785;Rasa;Nykštukai;6976298054;Ne;5;0;0;5
7786;Rasa;Meškiukai;8378755600;Ne;0;10;0;10
7787;Rasa;Meškiukai;3073804713;Ne;0;1;0;1
7788;Rasa;Meškiukai;8740659600;Ne;0;20;0;20
7789;Rasa;Meškiukai;4127921417;Ne;2;0;1;3
7790;Rasa;Meškiukai;7357915584;Ne;0;1;0;1
7791;Rasa;Meškiukai;8314522373;Ne;0;4;0;4
7792;Rasa;Meškiukai;3548008659;Ne;0;18;0;18
7793;Rasa;Meškiukai;3773600344;Ne;14;0;0;14
7794;Rasa;Meškiukai;2371282781;Ne;14;0;0;14
7795;Rasa;Meškiukai;2555108465;Ne;2;0;1;3
7796;Rasa;Meškiukai;1992726664;Ne;9;2;0;11
7797;Rasa;Meškiukai;5165588335;Ne;5;0;0;5
7798;Rasa;Meškiukai;7637404588;Ne;1;7;0;8
7799;Rasa;Meškiukai;7502435359;Ne;12;2;0;14
7800;Rasa;Meškiukai;6853285570;Taip;3;0;0;3
7801;Rasa;Meškiukai;8674133653;Ne;20;0;0;20
7802;Rasa;Meškiukai;2840437821;Ne;0;1;0;1
7803;Rasa;Sauliukai;6891623055;Taip;12;0;0;12
7804;Rasa;Sauliukai;9010812748;Ne;5;0;0;5
7805;Rasa;Sauliukai;7220007488;Ne;0;2;0;2
7806;Rasa;Sauliukai;4734775151;Ne;10;4;0;14
7807;Rasa;Sauliukai;8235869241;Ne;8;0;0;8
7808;Rasa;Sauliukai;3428261829;Ne;6;2;0;8
7809;Rasa;Sauliukai;5426981046;Ne;5;2;0;7
7810;Rasa;Sauliukai;5885520521;Ne;0;1;0;1
7811;Rasa;Sauliukai;3631124501;Taip;0;1;0;1
7812;Rasa;Sauliukai;2477057223;Ne;0;2;0;2
7813;Rasa;Sauliukai;2984661168;Ne;0;1;0;1
7814;Rasa;Sauliukai;4913483444;Taip;15;0;0;15
7815;Rasa;Sauliukai;9343039995;Ne;0;2;0;2
7816;Rasa;Sauliukai;4758138905;Ne;0;3;0;3
7817;Rasa;Sauliukai;6411372006;Ne;13;0;0;13
7818;Rasa;Sauliukai;9157136735;Ne;0;0;6;6
7819;Rasa;Smalsučiai;9288967646;Ne;20;0;0;20
7820;Rasa;Smalsučiai;6307149426;Ne;0;0;1;1
7821;Rasa;Smalsučiai;8350239611;Ne;12;0;1;13
7822;Rasa;Smalsučiai;3867443155;Ne;5;0;0;5
7823;Rasa;Smalsučiai;4828855802;Ne;7;0;1;8
7824;Rasa;Smalsučiai;7250512345;Ne;6;0;1;7
7825;Rasa;Smalsučiai;8204386619;Ne;6;0;1;7
7826;Rasa;Smalsučiai;8888344226;Ne;5;0;0;5
7827;Rasa;Smalsučiai;1683652129;Taip;12;0;1;13
7828;Rasa;Smalsučiai;2368671762;Ne;9;0;0;9
7829;Rasa;Smalsučiai;7335907373;Ne;7;0;1;8
7830;Rasa;Smalsučiai;2647048529;Ne;8;0;0;8
7831;Rasa;Smalsučiai;7901163117;Ne;20;0;0;20
7832;Rasa;"Pelėdžiukai ";3387615841;Ne;2;1;0;3
7833;Rasa;"Pelėdžiukai ";8816116600;Ne;1;0;0;1
7834;Rasa;"Pelėdžiukai ";8455168346;Ne;3;0;0;3
7835;Rasa;"Pelėdžiukai ";9056416308;Ne;0;1;0;1
7836;Rasa;"Pelėdžiukai ";5141906920;Ne;6;0;0;6
7837;Rasa;"Pelėdžiukai ";3381468321;Ne;0;3;0;3
7838;Rasa;"Pelėdžiukai ";1261868339;Ne;5;1;2;8
7839;Rasa;"Pelėdžiukai ";6553479199;Taip;0;1;1;2
7840;Rasa;"Pelėdžiukai ";5816940902;Taip;4;0;0;4
7841;Rasa;"Pelėdžiukai ";8403268732;Ne;8;1;0;9
7842;Rasa;"Pelėdžiukai ";4661651050;Ne;0;1;0;1
7843;Rasa;"Pelėdžiukai ";4453855861;Ne;2;0;0;2
7844;Rasa;"Pelėdžiukai ";4234198467;Taip;11;1;0;12
7845;Rasa;"Pelėdžiukai ";6874601830;Ne;16;0;0;16
7846;Rasa;Katinėliai;8574946856;Taip;2;1;0;3
7847;Rasa;Katinėliai;1477018184;Ne;0;0;4;4
7848;Rasa;Katinėliai;1521328997;Ne;0;1;2;3
7849;Rasa;Katinėliai;4018241056;Ne;0;0;2;2
7850;Rasa;Katinėliai;7568880413;Ne;0;1;1;2
7851;Rasa;Katinėliai;4762348187;Ne;0;1;0;1
7852;Rasa;Katinėliai;3884782148;Ne;10;0;1;11
7853;Rasa;Katinėliai;9230334839;Taip;3;1;0;4
7854;Rasa;Katinėliai;4979105526;Ne;0;1;1;2
7855;Rasa;Katinėliai;6755131948;Ne;7;0;0;7
7856;Rasa;Katinėliai;6442933249;Ne;0;0;1;1
7857;Rasa;Katinėliai;1736903037;Ne;0;0;3;3
7858;Rasa;Katinėliai;6656230158;Ne;11;0;5;16
7859;Rasa;Katinėliai;7029860782;Ne;4;0;0;4
7860;Rasa;Katinėliai;6640475278;Ne;0;0;1;1
7861;Rasa;Katinėliai;6856440701;Ne;0;20;0;20
7862;Rasa;Katinėliai;1263070686;Ne;1;2;0;3
7863;Rasa;Katinėliai;5370449148;Ne;0;3;0;3
7864;Rasa;Ančiukai;5260636074;Ne;17;0;0;17
7865;Rasa;Ančiukai;3898763654;Ne;10;0;3;13
7866;Rasa;Ančiukai;4427497247;Ne;9;0;0;9
7867;Rasa;Ančiukai;5128743872;Ne;18;0;0;18
7868;Rasa;Ančiukai;6044145252;Ne;0;1;0;1
7869;Rasa;Ančiukai;5407988663;Ne;10;0;0;10
7870;Rasa;Ančiukai;2683337738;Ne;15;0;0;15
7871;Rasa;Ančiukai;5580054434;Ne;10;0;0;10
7872;Rasa;Ančiukai;9392162542;Taip;11;0;1;12
7873;Rasa;Ančiukai;3559964630;Ne;15;5;0;20
7874;Rasa;Ančiukai;6403716333;Ne;0;0;1;1
7875;Rasa;Ančiukai;3569945230;Ne;11;0;0;11
7876;Rasa;Ančiukai;4872698495;Ne;5;0;1;6
7877;Rasa;Ančiukai;8159424999;Ne;2;0;3;5
7878;Rasa;"Vyturiukai ";7028605422;Taip;4;0;0;4
7879;Rasa;"Vyturiukai ";9599510902;Ne;2;0;1;3
7880;Rasa;"Vyturiukai ";5869253167;Ne;6;2;0;8
7881;Rasa;"Vyturiukai ";7037958994;Ne;1;0;0;1
7882;Rasa;"Vyturiukai ";8236785255;Ne;6;1;0;7
7883;Rasa;"Vyturiukai ";6887471189;Ne;6;0;0;6
7884;Rasa;"Vyturiukai ";2347639286;Ne;1;0;0;1
7885;Rasa;"Vyturiukai ";1206005039;Ne;8;0;0;8
7886;Rasa;"Vyturiukai ";9788282861;Ne;2;0;0;2
7887;Rasa;"Vyturiukai ";2711923397;Ne;8;0;0;8
7888;Rasa;"Vyturiukai ";2769096357;Ne;13;0;0;13
7889;Rasa;"Vyturiukai ";6883073764;Ne;8;0;0;8
7890;Rasa;"Vyturiukai ";9706428782;Ne;0;4;0;4
7891;Rasa;"Vyturiukai ";6575864256;Taip;7;0;0;7
7892;Rasa;"Vyturiukai ";8296425777;Ne;1;0;0;1
7893;Rasa;"Vyturiukai ";7284349651;Ne;1;0;0;1
7894;Rasa;"Vyturiukai ";7265752821;Ne;0;0;2;2
7895;Rasa;"Vyturiukai ";5686873929;Ne;3;0;0;3
7896;Rasa;Voveriukai;4111850024;Ne;0;3;0;3
7897;Rasa;Voveriukai;1978999728;Ne;11;0;1;12
7898;Rasa;Voveriukai;3546684695;Ne;9;4;0;13
7899;Rasa;Voveriukai;5740754301;Ne;0;0;2;2
7900;Rasa;Voveriukai;5977524939;Ne;6;0;1;7
7901;Rasa;Voveriukai;1592174114;Ne;5;0;0;5
7902;Rasa;Voveriukai;1564194649;Ne;9;0;0;9
7903;Rasa;Voveriukai;1764959761;Ne;4;0;1;5
7904;Rasa;Voveriukai;1733179752;Ne;0;0;1;1
7905;Rasa;Voveriukai;2895124729;Taip;10;0;1;11
7906;Rasa;Voveriukai;5622110823;Ne;0;1;0;1
7907;Rasa;Voveriukai;6221754830;Ne;0;0;1;1
7908;Rasa;Voveriukai;7218250981;Ne;8;3;0;11
7909;Rasa;Voveriukai;7152769140;Taip;7;0;1;8
7910;Rasa;"DRUGELIAI ";6621628020;Ne;0;1;0;1
7911;Rasa;"DRUGELIAI ";9959160342;Ne;0;1;0;1
7912;Rasa;"DRUGELIAI ";5761013588;Ne;3;2;0;5
7913;Rasa;"DRUGELIAI ";7220103314;Ne;0;0;1;1
7914;Rasa;"DRUGELIAI ";9506388242;Ne;0;4;0;4
7915;Rasa;"DRUGELIAI ";4188303400;Ne;0;1;0;1
7916;Rasa;"DRUGELIAI ";5483943978;Taip;0;2;0;2
7917;Rasa;"DRUGELIAI ";7251815682;Taip;17;0;0;17
7918;Rasa;"DRUGELIAI ";8702962863;Ne;3;3;0;6
7919;Rasa;"DRUGELIAI ";6291089659;Taip;0;11;2;13
7920;Rasa;"DRUGELIAI ";1575522555;Ne;10;1;0;11
7921;Rasa;"DRUGELIAI ";1610581364;Ne;4;0;0;4
7922;Rasa;"DRUGELIAI ";2881055956;Ne;20;0;0;20
7923;Rasa;"DRUGELIAI ";3113010641;Ne;5;2;4;11
7924;Rasa;"DRUGELIAI ";9938323938;Ne;5;1;0;6
7925;Rasa;Zuikučiai;8027532547;Ne;3;3;0;6
7926;Rasa;Zuikučiai;3470054190;Taip;7;0;0;7
7927;Rasa;Zuikučiai;8180141204;Ne;1;0;0;1
7928;Rasa;Zuikučiai;7253736220;Ne;0;1;0;1
7929;Rasa;Zuikučiai;7091899236;Ne;11;0;0;11
7930;Rasa;Zuikučiai;6574998939;Ne;0;2;0;2
7931;Rasa;Zuikučiai;4212798846;Ne;0;3;0;3
7932;Rasa;Zuikučiai;6505001743;Ne;3;2;0;5
7933;Rasa;Zuikučiai;6780996150;Taip;4;4;0;8
7934;Rasa;Zuikučiai;8159411349;Ne;18;0;0;18
7935;Rasa;Zuikučiai;8992548689;Ne;4;2;0;6
7936;Rasa;Zuikučiai;1983112873;Ne;5;0;0;5
7937;Rasa;Zuikučiai;6650473677;Ne;1;0;0;1
7938;Rasa;Zuikučiai;4508356130;Ne;5;0;0;5
7939;Rasa;Zuikučiai;8503010505;Ne;15;2;0;17
7940;Rasa;Zuikučiai;1843058886;Ne;0;9;0;9
7941;Rasa;Zuikučiai;2935957834;Ne;7;0;0;7
7942;Rasa;Širdelė;5719253028;Ne;4;8;0;12
7943;Rasa;Širdelė;9140875020;Ne;7;4;0;11
7944;Rasa;Širdelė;4694382836;Ne;1;0;0;1
7945;Rasa;Širdelė;1796573723;Ne;5;0;0;5
7946;Rasa;Širdelė;3535655117;Ne;0;3;0;3
7947;Rasa;Širdelė;4361959446;Ne;2;1;0;3
7948;Rasa;Širdelė;3215464914;Ne;8;0;0;8
7949;Rasa;Širdelė;6760723624;Ne;12;0;0;12
7950;Rasa;Širdelė;1447258806;Ne;1;0;0;1
7951;Rasa;Širdelė;1627996663;Ne;0;12;0;12
7952;Rasa;Širdelė;3965976031;Ne;1;0;0;1
7953;Rasa;Širdelė;4982146852;Taip;2;0;0;2
7954;Rasa;Širdelė;4248042049;Taip;4;0;0;4
7955;Rasa;Širdelė;7604145882;Ne;1;0;0;1
7956;Rasa;Širdelė;9713743149;Ne;5;0;0;5
7957;Riešutėlis;Viščiukų;8413887888;Ne;4;1;0;5
7958;Riešutėlis;Viščiukų;7142412042;Ne;3;0;0;3
7959;Riešutėlis;Viščiukų;5659054276;Ne;5;0;0;5
7960;Riešutėlis;Viščiukų;7985174814;Ne;8;1;0;9
7961;Riešutėlis;Viščiukų;3508479107;Ne;4;4;0;8
7962;Riešutėlis;Viščiukų;6398881485;Ne;10;0;0;10
7963;Riešutėlis;Viščiukų;3040811647;Ne;1;5;0;6
7964;Riešutėlis;Viščiukų;3109659339;Ne;12;0;0;12
7965;Riešutėlis;Viščiukų;4554875389;Ne;4;2;0;6
7966;Riešutėlis;Viščiukų;4533005769;Ne;5;4;0;9
7967;Riešutėlis;Viščiukų;3883149010;Taip;5;0;0;5
7968;Riešutėlis;Viščiukų;9952450993;Ne;10;0;0;10
7969;Riešutėlis;Viščiukų;8049449033;Taip;1;7;0;8
7970;Riešutėlis;Viščiukų;1389302927;Ne;13;0;0;13
7971;Riešutėlis;Viščiukų;6105142818;Ne;3;1;0;4
7972;Riešutėlis;"Riešutėliai ";3800733442;Ne;1;0;0;1
7973;Riešutėlis;"Riešutėliai ";2117939721;Ne;1;0;0;1
7974;Riešutėlis;"Riešutėliai ";1343776985;Ne;2;0;0;2
7975;Riešutėlis;"Riešutėliai ";5915019363;Ne;6;3;0;9
7976;Riešutėlis;"Riešutėliai ";2207907790;Ne;3;1;0;4
7977;Riešutėlis;"Riešutėliai ";9699503472;Ne;8;0;0;8
7978;Riešutėlis;"Riešutėliai ";2098369052;Ne;5;0;0;5
7979;Riešutėlis;"Riešutėliai ";1426700414;Ne;6;1;0;7
7980;Riešutėlis;"Riešutėliai ";5873443383;Ne;4;0;0;4
7981;Riešutėlis;"Riešutėliai ";2301247729;Ne;0;6;0;6
7982;Riešutėlis;"Riešutėliai ";3602707130;Ne;3;1;0;4
7983;Riešutėlis;"Riešutėliai ";8991963843;Ne;3;0;0;3
7984;Riešutėlis;"Riešutėliai ";9318640304;Taip;0;1;0;1
7985;Riešutėlis;"Riešutėliai ";4293402095;Ne;0;1;0;1
7986;Riešutėlis;"Riešutėliai ";8917451081;Taip;4;2;0;6
7987;Riešutėlis;"Riešutėliai ";4698338374;Ne;8;0;0;8
7988;Riešutėlis;"Riešutėliai ";3345064565;Ne;2;0;0;2
7989;Riešutėlis;"Riešutėliai ";9078282526;Ne;7;1;0;8
7990;Riešutėlis;Ežiukai;5758442826;Taip;2;0;0;2
7991;Riešutėlis;Ežiukai;9888470246;Taip;2;0;0;2
7992;Riešutėlis;Ežiukai;4042719626;Ne;7;0;0;7
7993;Riešutėlis;Ežiukai;1858791074;Ne;5;1;0;6
7994;Riešutėlis;Ežiukai;1006119133;Ne;0;9;0;9
7995;Riešutėlis;Ežiukai;3759837057;Ne;1;0;0;1
7996;Riešutėlis;Ežiukai;3249196007;Ne;5;0;0;5
7997;Riešutėlis;Ežiukai;4740516426;Taip;1;0;0;1
7998;Riešutėlis;Ežiukai;5078051087;Ne;2;0;0;2
7999;Riešutėlis;Ežiukai;3150141050;Ne;1;0;0;1
8000;Riešutėlis;Ežiukai;6580050526;Ne;1;0;0;1
8001;Riešutėlis;Ežiukai;4810919435;Ne;3;1;0;4
8002;Riešutėlis;Ežiukai;2736824231;Ne;10;0;0;10
8003;Riešutėlis;Ežiukai;2378301886;Ne;0;3;0;3
8004;Riešutėlis;Ežiukai;5262881964;Ne;12;0;0;12
8005;Riešutėlis;Ežiukai;4328166135;Ne;1;2;0;3
8006;Riešutėlis;Ežiukai;9052991215;Ne;5;2;0;7
8007;Riešutėlis;Pelėdžiukai;1705599429;Ne;7;0;0;7
8008;Riešutėlis;Pelėdžiukai;2467739101;Ne;4;0;0;4
8009;Riešutėlis;Pelėdžiukai;2587460110;Ne;5;0;0;5
8010;Riešutėlis;Pelėdžiukai;6147780439;Ne;0;1;0;1
8011;Riešutėlis;Pelėdžiukai;3287685792;Ne;7;0;0;7
8012;Riešutėlis;Pelėdžiukai;1811701628;Ne;10;0;0;10
8013;Riešutėlis;Pelėdžiukai;5183264581;Ne;0;1;0;1
8014;Riešutėlis;Pelėdžiukai;6121386391;Ne;6;0;0;6
8015;Riešutėlis;Pelėdžiukai;4448024452;Ne;4;0;0;4
8016;Riešutėlis;Pelėdžiukai;3251066115;Ne;6;0;0;6
8017;Riešutėlis;Pelėdžiukai;4897581681;Ne;13;0;0;13
8018;Riešutėlis;Pelėdžiukai;7256075146;Ne;3;1;0;4
8019;Riešutėlis;Pelėdžiukai;5443448616;Ne;8;5;0;13
8020;Riešutėlis;Pelėdžiukai;8839482370;Ne;12;0;0;12
8021;Riešutėlis;Pelėdžiukai;4692384639;Ne;8;0;0;8
8022;Riešutėlis;Meškiukai;7030346495;Ne;15;1;0;16
8023;Riešutėlis;Meškiukai;9750713954;Ne;9;1;0;10
8024;Riešutėlis;Meškiukai;3577669231;Ne;5;2;0;7
8025;Riešutėlis;Meškiukai;8066712255;Ne;2;0;0;2
8026;Riešutėlis;Meškiukai;2837471235;Ne;11;0;0;11
8027;Riešutėlis;Meškiukai;7601776182;Taip;9;0;0;9
8028;Riešutėlis;Meškiukai;7050440691;Ne;10;1;0;11
8029;Riešutėlis;Meškiukai;6259158270;Ne;2;0;0;2
8030;Riešutėlis;Meškiukai;7381623086;Ne;3;2;0;5
8031;Riešutėlis;Meškiukai;6284614328;Ne;20;0;0;20
8032;Riešutėlis;Meškiukai;1548585448;Ne;6;2;0;8
8033;Riešutėlis;Meškiukai;5728858361;Ne;9;2;0;11
8034;Riešutėlis;Meškiukai;1818130297;Ne;5;0;0;5
8035;Riešutėlis;Meškiukai;8954127616;Ne;6;2;0;8
8036;Riešutėlis;Meškiukai;2092933906;Ne;0;7;0;7
8037;Riešutėlis;Meškiukai;6813024366;Ne;3;2;0;5
8038;Riešutėlis;Meškiukai;3460145784;Ne;3;1;0;4
8039;Riešutėlis;Meškiukai;8480059272;Ne;10;1;0;11
8040;Riešutėlis;Meškiukai;8751571852;Ne;4;0;0;4
8041;Riešutėlis;Kiškučiai;9297835044;Taip;2;0;0;2
8042;Riešutėlis;Kiškučiai;9086474785;Ne;8;0;0;8
8043;Riešutėlis;Kiškučiai;3363757821;Ne;6;0;0;6
8044;Riešutėlis;Kiškučiai;2581250615;Ne;5;0;0;5
8045;Riešutėlis;Kiškučiai;8445984114;Taip;12;0;0;12
8046;Riešutėlis;Kiškučiai;5266946070;Ne;6;0;0;6
8047;Riešutėlis;Kiškučiai;9357375649;Ne;10;0;0;10
8048;Riešutėlis;Kiškučiai;9548551553;Ne;10;0;0;10
8049;Riešutėlis;Kiškučiai;9500744921;Ne;7;0;0;7
8050;Riešutėlis;Kiškučiai;4851336076;Ne;2;0;0;2
8051;Riešutėlis;Kiškučiai;6705754238;Ne;6;5;0;11
8052;Riešutėlis;Kiškučiai;1111543507;Ne;3;0;0;3
8053;Riešutėlis;Kiškučiai;9964105252;Ne;10;0;0;10
8054;Riešutėlis;Kiškučiai;6693197006;Ne;10;0;0;10
8055;Riešutėlis;Kiškučiai;5846061115;Ne;1;0;0;1
8056;Riešutėlis;Kiškučiai;9995814717;Ne;6;0;0;6
8057;Riešutėlis;Kiškučiai;3165015754;Ne;4;0;0;4
8058;Riešutėlis;Kiškučiai;5738764214;Ne;7;0;0;7
8059;Riešutėlis;Kiškučiai;1494363200;Ne;7;0;0;7
8060;Riešutėlis;Voveriukų;9864636983;Ne;0;2;0;2
8061;Riešutėlis;Voveriukų;5662911204;Ne;7;0;0;7
8062;Riešutėlis;Voveriukų;7663823906;Ne;10;0;0;10
8063;Riešutėlis;Voveriukų;1282121190;Ne;2;2;0;4
8064;Riešutėlis;Voveriukų;5336618381;Ne;12;1;0;13
8065;Riešutėlis;Voveriukų;7327578507;Ne;6;0;0;6
8066;Riešutėlis;Voveriukų;6368610810;Ne;10;0;0;10
8067;Riešutėlis;Voveriukų;2875416610;Ne;1;0;0;1
8068;Riešutėlis;Voveriukų;7313602281;Ne;9;0;0;9
8069;Riešutėlis;Voveriukų;9815988800;Ne;5;0;0;5
8070;Riešutėlis;Voveriukų;2352984379;Ne;13;2;0;15
8071;Riešutėlis;Voveriukų;3152100512;Ne;10;0;0;10
8072;Riešutėlis;Voveriukų;2238641969;Ne;11;1;0;12
8073;Riešutėlis;Voveriukų;1058206787;Taip;10;0;0;10
8074;Riešutėlis;Voveriukų;9198289423;Ne;7;0;0;7
8075;Riešutėlis;Voveriukų;3340831522;Ne;20;0;0;20
8076;Riešutėlis;Saulutės;7177632315;Ne;0;3;0;3
8077;Riešutėlis;Saulutės;6721758785;Ne;5;2;0;7
8078;Riešutėlis;Saulutės;1748151109;Ne;2;0;0;2
8079;Riešutėlis;Saulutės;8504832383;Ne;0;1;0;1
8080;Riešutėlis;Saulutės;6292679662;Ne;2;0;1;3
8081;Riešutėlis;Saulutės;8738716660;Ne;5;1;0;6
8082;Riešutėlis;Saulutės;4828635362;Ne;0;1;0;1
8083;Riešutėlis;Saulutės;1196740726;Ne;9;0;0;9
8084;Riešutėlis;Saulutės;8415858895;Taip;6;0;0;6
8085;Riešutėlis;Saulutės;4498718519;Taip;0;1;0;1
8086;Riešutėlis;Saulutės;5753609922;Ne;20;0;0;20
8087;Riešutėlis;Saulutės;5013754772;Taip;0;1;2;3
8088;Riešutėlis;Saulutės;6468871352;Ne;6;0;1;7
8089;Riešutėlis;Saulutės;7154361660;Ne;0;5;0;5
8090;Riešutėlis;Saulutės;2572642260;Ne;0;0;1;1
8091;Riešutėlis;Saulutės;3544780386;Ne;8;0;1;9
8092;Riešutėlis;"Boruželės ";7666200219;Ne;15;1;0;16
8093;Riešutėlis;"Boruželės ";6626441225;Ne;1;0;0;1
8094;Riešutėlis;"Boruželės ";4426750525;Ne;3;0;0;3
8095;Riešutėlis;"Boruželės ";6906373822;Ne;3;0;0;3
8096;Riešutėlis;"Boruželės ";2493171003;Ne;0;0;2;2
8097;Riešutėlis;"Boruželės ";5133625078;Ne;0;1;0;1
8098;Riešutėlis;"Boruželės ";9341748384;Ne;0;1;0;1
8099;Riešutėlis;"Boruželės ";2235912189;Ne;4;1;0;5
8100;Riešutėlis;"Boruželės ";4429903561;Ne;16;0;0;16
8101;Riešutėlis;"Boruželės ";7795124495;Ne;2;0;0;2
8102;Riešutėlis;"Boruželės ";2832538856;Ne;0;4;0;4
8103;Riešutėlis;"Boruželės ";3730909181;Ne;5;0;0;5
8104;Riešutėlis;"Bitutės ";2498093110;Taip;5;1;0;6
8105;Riešutėlis;"Bitutės ";2459494071;Ne;1;0;0;1
8106;Riešutėlis;"Bitutės ";3931422170;Ne;8;0;0;8
8107;Riešutėlis;"Bitutės ";8265627960;Ne;10;0;0;10
8108;Riešutėlis;"Bitutės ";9285782325;Ne;0;1;0;1
8109;Riešutėlis;"Bitutės ";7473054556;Ne;2;1;0;3
8110;Riešutėlis;"Bitutės ";3475897400;Ne;7;0;0;7
8111;Riešutėlis;"Bitutės ";3592271009;Taip;1;6;0;7
8112;Riešutėlis;"Bitutės ";6815804556;Ne;0;3;0;3
8113;Riešutėlis;"Bitutės ";4358354602;Ne;4;1;0;5
8114;Riešutėlis;"Bitutės ";9903170301;Ne;7;0;0;7
8115;Riešutėlis;"Bitutės ";1842107341;Ne;13;0;0;13
8116;Riešutėlis;"Bitutės ";1033490929;Ne;7;0;0;7
8117;Riešutėlis;"Bitutės ";4211273525;Ne;3;0;1;4
8118;Riešutėlis;Drugelių;5811657782;Ne;1;0;0;1
8119;Riešutėlis;Drugelių;4221375847;Ne;0;2;0;2
8120;Riešutėlis;Drugelių;8845709386;Ne;0;2;0;2
8121;Riešutėlis;Drugelių;5412882446;Ne;9;0;0;9
8122;Riešutėlis;Drugelių;1164273595;Ne;4;1;0;5
8123;Riešutėlis;Drugelių;8918753084;Ne;0;9;0;9
8124;Riešutėlis;Drugelių;3836374000;Ne;2;0;0;2
8125;Riešutėlis;Drugelių;4845447863;Ne;0;20;0;20
8126;Riešutėlis;Drugelių;7225365172;Ne;0;1;0;1
8127;Riešutėlis;Nykštukų;3208422211;Ne;6;1;0;7
8128;Riešutėlis;Nykštukų;9445000826;Ne;7;0;0;7
8129;Riešutėlis;Nykštukų;2133207806;Ne;1;0;0;1
8130;Riešutėlis;Nykštukų;2965742701;Ne;5;0;0;5
8131;Riešutėlis;Nykštukų;8965323622;Ne;5;0;0;5
8132;Riešutėlis;Nykštukų;3304849985;Ne;6;0;0;6
8133;Riešutėlis;Nykštukų;4996921259;Ne;4;0;0;4
8134;Riešutėlis;Nykštukų;2380936705;Ne;2;0;0;2
8135;Riešutėlis;Nykštukų;1227857842;Ne;8;1;0;9
8136;Riešutėlis;Nykštukų;8857997445;Ne;15;0;0;15
8137;Riešutėlis;Nykštukų;5296617022;Ne;13;0;0;13
8138;Riešutėlis;Nykštukų;9445150366;Ne;0;2;0;2
8139;Riešutėlis;Nykštukų;9977733313;Ne;17;0;0;17
8140;Riešutėlis;Nykštukų;4746769566;Ne;5;0;0;5
8141;Riešutėlis;Nykštukų;9415334673;Ne;10;1;0;11
8142;Ramunėlė;SAULUTĖS;1192743154;Ne;2;2;0;4
8143;Ramunėlė;SAULUTĖS;5714771643;Ne;0;1;0;1
8144;Ramunėlė;SAULUTĖS;1483391590;Ne;0;1;0;1
8145;Ramunėlė;SAULUTĖS;9927068798;Ne;5;2;0;7
8146;Ramunėlė;SAULUTĖS;8929122197;Ne;0;1;0;1
8147;Ramunėlė;SAULUTĖS;7219400182;Taip;0;4;0;4
8148;Ramunėlė;SAULUTĖS;3779769727;Ne;0;1;0;1
8149;Ramunėlė;SAULUTĖS;8912978935;Ne;0;1;0;1
8150;Ramunėlė;SAULUTĖS;1618282165;Ne;5;0;0;5
8151;Ramunėlė;SAULUTĖS;9533155706;Ne;0;2;0;2
8152;Ramunėlė;SAULUTĖS;3109623760;Ne;1;0;0;1
8153;Ramunėlė;SAULUTĖS;6329943991;Ne;3;1;0;4
8154;Ramunėlė;SAULUTĖS;4677819736;Ne;2;0;0;2
8155;Ramunėlė;SAULUTĖS;6310921755;Ne;0;1;0;1
8156;Ramunėlė;SAULUTĖS;1568531299;Taip;2;2;0;4
8157;Ramunėlė;SAULUTĖS;4605161267;Ne;1;3;0;4
8158;Ramunėlė;ŽIBUTĖ;4715809064;Ne;0;3;0;3
8159;Ramunėlė;ŽIBUTĖ;5315953299;Ne;4;1;0;5
8160;Ramunėlė;ŽIBUTĖ;2173425836;Ne;0;2;0;2
8161;Ramunėlė;ŽIBUTĖ;2686455030;Ne;0;2;0;2
8162;Ramunėlė;ŽIBUTĖ;5650659504;Ne;8;2;0;10
8163;Ramunėlė;ŽIBUTĖ;6627399830;Ne;0;2;0;2
8164;Ramunėlė;ŽIBUTĖ;8726443989;Ne;0;3;0;3
8165;Ramunėlė;ŽIBUTĖ;5801760033;Ne;5;0;0;5
8166;Ramunėlė;ŽIBUTĖ;6389008823;Ne;5;0;0;5
8167;Ramunėlė;ŽIBUTĖ;6040461460;Ne;7;0;0;7
8168;Ramunėlė;ŽIBUTĖ;2605941371;Ne;1;2;0;3
8169;Ramunėlė;ŽIBUTĖ;7010828978;Ne;0;1;0;1
8170;Ramunėlė;ŽIBUTĖ;3879563193;Ne;0;4;0;4
8171;Ramunėlė;ŽIBUTĖ;2591052434;Ne;0;3;0;3
8172;Ramunėlė;ŽIBUTĖ;2446375037;Ne;1;1;0;2
8173;Ramunėlė;ŽIBUTĖ;5304803880;Ne;0;2;0;2
8174;Ramunėlė;ŽIBUTĖ;3525444906;Ne;0;2;0;2
8175;Ramunėlė;ŽIBUTĖ;8055844166;Ne;12;0;0;12
8176;Ramunėlė;ŽIRNIUKAI;7721421570;Ne;0;7;0;7
8177;Ramunėlė;ŽIRNIUKAI;8942483792;Ne;20;0;0;20
8178;Ramunėlė;ŽIRNIUKAI;6674467484;Ne;0;8;0;8
8179;Ramunėlė;ŽIRNIUKAI;7593855877;Ne;0;1;0;1
8180;Ramunėlė;ŽIRNIUKAI;2177200537;Ne;1;2;0;3
8181;Ramunėlė;ŽIRNIUKAI;4076525701;Ne;3;0;0;3
8182;Ramunėlė;ŽIRNIUKAI;4139935502;Ne;0;0;1;1
8183;Ramunėlė;ŽIRNIUKAI;4875011312;Ne;10;2;0;12
8184;Ramunėlė;ŽIRNIUKAI;4084046207;Ne;5;1;0;6
8185;Ramunėlė;ŽIRNIUKAI;5017020616;Ne;0;1;0;1
8186;Ramunėlė;ŽIRNIUKAI;6225605784;Taip;3;0;0;3
8187;Ramunėlė;ŽIRNIUKAI;4805808663;Ne;0;2;0;2
8188;Ramunėlė;ŽIRNIUKAI;7250951221;Ne;0;8;0;8
8189;Ramunėlė;BITUTĖS;5865482869;Taip;0;13;0;13
8190;Ramunėlė;BITUTĖS;7692958269;Ne;6;0;0;6
8191;Ramunėlė;BITUTĖS;6342801407;Ne;8;0;0;8
8192;Ramunėlė;BITUTĖS;4022818032;Ne;5;5;0;10
8193;Ramunėlė;BITUTĖS;1916520056;Ne;0;8;0;8
8194;Ramunėlė;BITUTĖS;2245564567;Ne;3;0;0;3
8195;Ramunėlė;BITUTĖS;6870110390;Ne;3;0;0;3
8196;Ramunėlė;BITUTĖS;6892481929;Ne;0;2;0;2
8197;Ramunėlė;BITUTĖS;6881228078;Ne;0;8;0;8
8198;Ramunėlė;BITUTĖS;9326288662;Ne;0;2;0;2
8199;Ramunėlė;BITUTĖS;3045477012;Ne;0;5;0;5
8200;Ramunėlė;BITUTĖS;8643188779;Ne;20;0;0;20
8201;Ramunėlė;BITUTĖS;3106987206;Ne;1;0;0;1
8202;Ramunėlė;BITUTĖS;1797997937;Ne;2;0;0;2
8203;Ramunėlė;BITUTĖS;4329292281;Ne;10;0;0;10
8204;Ramunėlė;BITUTĖS;9928703066;Ne;4;1;0;5
8205;Ramunėlė;BITUTĖS;4756689520;Ne;9;0;0;9
8206;Ramunėlė;BITUTĖS;3742982547;Ne;4;2;0;6
8207;Ramunėlė;DRUGELIAI;9984243153;Ne;10;0;0;10
8208;Ramunėlė;DRUGELIAI;4392309015;Ne;3;2;3;8
8209;Ramunėlė;DRUGELIAI;5049415445;Ne;8;0;0;8
8210;Ramunėlė;DRUGELIAI;8460527225;Ne;5;3;0;8
8211;Ramunėlė;DRUGELIAI;6809164145;Ne;0;3;0;3
8212;Ramunėlė;DRUGELIAI;6981729247;Ne;13;0;0;13
8213;Ramunėlė;DRUGELIAI;3683181174;Ne;0;5;0;5
8214;Ramunėlė;DRUGELIAI;7364976547;Ne;0;1;0;1
8215;Ramunėlė;DRUGELIAI;2983986428;Ne;10;0;0;10
8216;Ramunėlė;DRUGELIAI;2427399083;Ne;0;1;0;1
8217;Ramunėlė;DRUGELIAI;8623311748;Ne;0;1;0;1
8218;Ramunėlė;DRUGELIAI;6849205606;Ne;7;0;0;7
8219;Ramunėlė;DRUGELIAI;2422656007;Ne;0;0;2;2
8220;Ramunėlė;DRUGELIAI;7829765488;Ne;5;0;0;5
8221;Ramunėlė;DRUGELIAI;5153948802;Ne;0;3;0;3
8222;Ramunėlė;DRUGELIAI;4233978236;Ne;0;9;0;9
8223;Ramunėlė;DRUGELIAI;2558296296;Ne;8;0;0;8
8224;Ramunėlė;DRUGELIAI;4400154355;Ne;0;0;4;4
8225;Ramunėlė;NEUŽMIRŠTUOLĖS;2070729684;Ne;0;3;0;3
8226;Ramunėlė;NEUŽMIRŠTUOLĖS;6613469006;Ne;0;6;0;6
8227;Ramunėlė;NEUŽMIRŠTUOLĖS;9012749913;Ne;0;8;0;8
8228;Ramunėlė;NEUŽMIRŠTUOLĖS;1728034615;Ne;4;0;0;4
8229;Ramunėlė;NEUŽMIRŠTUOLĖS;1579527330;Ne;5;1;0;6
8230;Ramunėlė;NEUŽMIRŠTUOLĖS;7519551613;Ne;0;1;0;1
8231;Ramunėlė;NEUŽMIRŠTUOLĖS;2880352109;Ne;11;0;0;11
8232;Ramunėlė;NEUŽMIRŠTUOLĖS;3949246652;Ne;12;0;0;12
8233;Ramunėlė;NEUŽMIRŠTUOLĖS;5267145991;Ne;0;5;0;5
8234;Ramunėlė;NEUŽMIRŠTUOLĖS;6849227110;Ne;0;2;0;2
8235;Ramunėlė;NEUŽMIRŠTUOLĖS;3792795591;Ne;0;3;0;3
8236;Ramunėlė;NEUŽMIRŠTUOLĖS;4862989594;Ne;0;2;0;2
8237;Ramunėlė;NEUŽMIRŠTUOLĖS;9758688249;Ne;2;0;0;2
8238;Ramunėlė;NEUŽMIRŠTUOLĖS;9945561827;Ne;8;0;0;8
8239;Ramunėlė;OBUOLIUKAI;8617271247;Ne;6;2;0;8
8240;Ramunėlė;OBUOLIUKAI;6413888803;Ne;4;0;0;4
8241;Ramunėlė;OBUOLIUKAI;5610672420;Taip;0;1;0;1
8242;Ramunėlė;OBUOLIUKAI;9861069932;Ne;0;1;0;1
8243;Ramunėlė;OBUOLIUKAI;4806844761;Taip;19;0;0;19
8244;Ramunėlė;OBUOLIUKAI;7639613472;Ne;10;1;0;11
8245;Ramunėlė;OBUOLIUKAI;4040520907;Ne;1;5;0;6
8246;Ramunėlė;OBUOLIUKAI;5573083546;Ne;13;0;0;13
8247;Ramunėlė;OBUOLIUKAI;1215510902;Ne;5;1;0;6
8248;Ramunėlė;OBUOLIUKAI;8218201930;Taip;15;0;0;15
8249;Ramunėlė;OBUOLIUKAI;2760710235;Ne;4;0;0;4
8250;Ramunėlė;OBUOLIUKAI;4788062781;Ne;4;3;0;7
8251;Ramunėlė;OBUOLIUKAI;3166386231;Ne;3;3;0;6
8252;Ramunėlė;OBUOLIUKAI;4642590173;Ne;0;1;0;1
8253;Ramunėlė;OBUOLIUKAI;4491147309;Ne;19;0;0;19
8254;Ramunėlė;OBUOLIUKAI;9549605315;Ne;4;1;0;5
8255;Ramunėlė;OBUOLIUKAI;1277413234;Ne;0;2;0;2
8256;Ramunėlė;SAULĖGRĄŽA;2458101652;Ne;5;0;0;5
8257;Ramunėlė;SAULĖGRĄŽA;9663304288;Ne;5;0;0;5
8258;Ramunėlė;SAULĖGRĄŽA;5398069413;Ne;3;0;0;3
8259;Ramunėlė;SAULĖGRĄŽA;3793779715;Ne;0;1;0;1
8260;Ramunėlė;SAULĖGRĄŽA;6775947111;Ne;10;0;2;12
8261;Ramunėlė;SAULĖGRĄŽA;1102946363;Ne;8;0;0;8
8262;Ramunėlė;SAULĖGRĄŽA;3801952385;Ne;3;7;0;10
8263;Ramunėlė;SAULĖGRĄŽA;9120142666;Taip;3;0;0;3
8264;Ramunėlė;SAULĖGRĄŽA;6942789511;Ne;6;0;1;7
8265;Ramunėlė;SAULĖGRĄŽA;2415377154;Ne;0;2;1;3
8266;Ramunėlė;SAULĖGRĄŽA;9076692864;Ne;5;2;0;7
8267;Ramunėlė;SAULĖGRĄŽA;3744140961;Ne;0;8;0;8
8268;Ramunėlė;SAULĖGRĄŽA;1071166494;Ne;6;0;0;6
8269;Ramunėlė;SAULĖGRĄŽA;9656732273;Ne;6;0;0;6
8270;Ramunėlė;SAULĖGRĄŽA;6983139076;Taip;7;0;0;7
8271;Ramunėlė;SAULĖGRĄŽA;8045080504;Ne;6;2;0;8
8272;Ramunėlė;BORUŽĖLĖS;1818513881;Ne;7;0;0;7
8273;Ramunėlė;BORUŽĖLĖS;4581826404;Ne;4;0;0;4
8274;Ramunėlė;BORUŽĖLĖS;8310875815;Ne;3;2;0;5
8275;Ramunėlė;BORUŽĖLĖS;1491688322;Ne;3;2;0;5
8276;Ramunėlė;BORUŽĖLĖS;6606966969;Ne;3;0;0;3
8277;Ramunėlė;BORUŽĖLĖS;5703289545;Ne;6;0;0;6
8278;Ramunėlė;BORUŽĖLĖS;9292235402;Taip;5;0;0;5
8279;Ramunėlė;BORUŽĖLĖS;3461269451;Ne;0;1;0;1
8280;Ramunėlė;BORUŽĖLĖS;3474578046;Ne;9;0;0;9
8281;Ramunėlė;BORUŽĖLĖS;7544671346;Ne;3;0;0;3
8282;Ramunėlė;BORUŽĖLĖS;5544992493;Ne;0;7;0;7
8283;Ramunėlė;BORUŽĖLĖS;6433856416;Ne;0;6;0;6
8284;Ramunėlė;BORUŽĖLĖS;3542912372;Ne;15;0;0;15
8285;Ramunėlė;BORUŽĖLĖS;3735308599;Ne;5;2;0;7
8286;Ramunėlė;BORUŽĖLĖS;3272747656;Ne;0;2;0;2
8287;Ramunėlė;BORUŽĖLĖS;1811931985;Ne;0;4;0;4
8288;Ramunėlė;NYKŠTUKAS;7542328641;Ne;6;0;0;6
8289;Ramunėlė;NYKŠTUKAS;1802650607;Ne;5;0;0;5
8290;Ramunėlė;NYKŠTUKAS;7715458376;Ne;10;0;0;10
8291;Ramunėlė;NYKŠTUKAS;1212737814;Ne;0;1;0;1
8292;Ramunėlė;NYKŠTUKAS;5011852981;Ne;6;0;0;6
8293;Ramunėlė;NYKŠTUKAS;7049941095;Taip;0;1;0;1
8294;Ramunėlė;NYKŠTUKAS;7958270513;Ne;2;0;0;2
8295;Ramunėlė;NYKŠTUKAS;9005050527;Ne;8;0;0;8
8296;Ramunėlė;NYKŠTUKAS;2521516332;Ne;4;0;0;4
8297;Ramunėlė;NYKŠTUKAS;7248072779;Ne;8;2;0;10
8298;Ramunėlė;UOGELĖ;2361409931;Taip;8;1;0;9
8299;Ramunėlė;UOGELĖ;9765904825;Ne;5;0;1;6
8300;Ramunėlė;UOGELĖ;5934414699;Ne;6;0;0;6
8301;Ramunėlė;UOGELĖ;3097478921;Ne;5;3;0;8
8302;Ramunėlė;UOGELĖ;1962502699;Ne;15;0;0;15
8303;Ramunėlė;UOGELĖ;9603368652;Ne;7;0;0;7
8304;Ramunėlė;UOGELĖ;5468189903;Ne;6;0;0;6
8305;Ramunėlė;UOGELĖ;9834640538;Ne;5;0;0;5
8306;Ramunėlė;UOGELĖ;3838004754;Ne;7;0;0;7
8307;Ramunėlė;UOGELĖ;3037286125;Ne;7;0;0;7
8308;Ramunėlė;UOGELĖ;5196627958;Taip;0;9;0;9
8309;Ramunėlė;UOGELĖ;1346734609;Ne;5;0;0;5
8310;Ramunėlė;UOGELĖ;8538153845;Ne;14;3;0;17
8311;Ramunėlė;VARPELIAI;8023404173;Taip;6;0;0;6
8312;Ramunėlė;VARPELIAI;7005354909;Ne;0;3;0;3
8313;Ramunėlė;VARPELIAI;5665429647;Ne;0;1;0;1
8314;Ramunėlė;VARPELIAI;4946797276;Ne;0;1;0;1
8315;Ramunėlė;VARPELIAI;9180197156;Ne;0;1;0;1
8316;Ramunėlė;VARPELIAI;5108864184;Ne;0;1;0;1
8317;Ramunėlė;VARPELIAI;4321527067;Taip;0;2;0;2
8318;Ramunėlė;VARPELIAI;2202879286;Ne;0;2;0;2
8319;Ramunėlė;VARPELIAI;1666033483;Ne;4;2;0;6
8320;Ramunėlė;VARPELIAI;7896711579;Ne;0;2;5;7
8321;Ramunėlė;VARPELIAI;9994601365;Taip;14;0;0;14
8322;Ramunėlė;VARPELIAI;2620747378;Ne;6;0;1;7
8323;Ramunėlė;VARPELIAI;5726947811;Ne;5;0;0;5
8324;Ramunėlė;VARPELIAI;8764042799;Ne;2;1;0;3
8325;Ramunėlė;VARPELIAI;7926168752;Taip;8;0;0;8
8326;Ramunėlė;VARPELIAI;5498856861;Ne;13;0;0;13
8327;Ramunėlė;VARPELIAI;3024065664;Ne;5;3;0;8
8328;Ramunėlė;VARPELIAI;4397072823;Ne;3;0;2;5
8329;Rūta;SMALSUČIAI;2601011765;Taip;12;0;2;14
8330;Rūta;SMALSUČIAI;5902965224;Ne;2;4;0;6
8331;Rūta;SMALSUČIAI;5579794648;Ne;15;3;0;18
8332;Rūta;SMALSUČIAI;7837861265;Taip;0;0;1;1
8333;Rūta;SMALSUČIAI;9471291067;Taip;0;2;0;2
8334;Rūta;SMALSUČIAI;4165080541;Ne;12;0;0;12
8335;Rūta;SMALSUČIAI;8012225409;Ne;8;0;2;10
8336;Rūta;SMALSUČIAI;3877807687;Taip;10;0;0;10
8337;Rūta;SMALSUČIAI;8483916287;Ne;12;0;0;12
8338;Rūta;SMALSUČIAI;1290867375;Ne;0;5;0;5
8339;Rūta;SMALSUČIAI;4780828296;Ne;0;0;2;2
8340;Rūta;SMALSUČIAI;2084935094;Ne;8;0;0;8
8341;Rūta;SMALSUČIAI;7724451685;Ne;0;3;0;3
8342;Rūta;SMALSUČIAI;8320791295;Taip;2;0;0;2
8343;Rūta;SMALSUČIAI;3109709043;Ne;15;0;0;15
8344;Rūta;SMALSUČIAI;2733932207;Taip;12;3;0;15
8345;Rūta;SMALSUČIAI;3498596516;Taip;2;0;1;3
8346;Rūta;KŪLVERSTUKAI;4440148328;Ne;5;2;0;7
8347;Rūta;KŪLVERSTUKAI;1059126758;Ne;0;3;0;3
8348;Rūta;KŪLVERSTUKAI;6417693659;Ne;10;0;0;10
8349;Rūta;KŪLVERSTUKAI;3352007694;Ne;3;0;0;3
8350;Rūta;KŪLVERSTUKAI;4090915728;Ne;5;0;0;5
8351;Rūta;KŪLVERSTUKAI;4466522924;Ne;16;0;0;16
8352;Rūta;KŪLVERSTUKAI;7905893575;Ne;11;0;0;11
8353;Rūta;KŪLVERSTUKAI;4776631890;Ne;9;0;0;9
8354;Rūta;KŪLVERSTUKAI;4436482805;Ne;0;1;0;1
8355;Rūta;KŪLVERSTUKAI;1260386759;Ne;4;0;0;4
8356;Rūta;KŪLVERSTUKAI;8935780480;Ne;0;1;0;1
8357;Rūta;KŪLVERSTUKAI;6044060646;Ne;0;2;0;2
8358;Rūta;KŪLVERSTUKAI;1671179652;Ne;14;1;0;15
8359;Rūta;KŪLVERSTUKAI;9012256437;Ne;1;0;0;1
8360;Rūta;KŪLVERSTUKAI;1152453609;Ne;6;0;0;6
8361;Rūta;KŪLVERSTUKAI;3081348981;Ne;0;1;0;1
8362;Rūta;KODĖLČIUKAI;5962981130;Ne;5;0;0;5
8363;Rūta;KODĖLČIUKAI;4347678781;Ne;5;0;0;5
8364;Rūta;KODĖLČIUKAI;3736279705;Ne;10;0;1;11
8365;Rūta;KODĖLČIUKAI;8416455711;Ne;0;0;1;1
8366;Rūta;KODĖLČIUKAI;8668510009;Ne;7;0;0;7
8367;Rūta;KODĖLČIUKAI;2547849837;Ne;3;0;1;4
8368;Rūta;KODĖLČIUKAI;9501101073;Taip;6;0;6;12
8369;Rūta;KODĖLČIUKAI;8883578144;Ne;9;0;0;9
8370;Rūta;KODĖLČIUKAI;4546082355;Ne;0;9;0;9
8371;Rūta;KODĖLČIUKAI;5766392854;Ne;0;5;0;5
8372;Rūta;KODĖLČIUKAI;4944413811;Ne;0;0;2;2
8373;Rūta;KODĖLČIUKAI;1605412505;Taip;16;0;0;16
8374;Rūta;KODĖLČIUKAI;4533816630;Ne;3;0;0;3
8375;Rūta;KODĖLČIUKAI;8455941633;Ne;0;2;0;2
8376;Rūta;KODĖLČIUKAI;8120157087;Ne;5;0;0;5
8377;Rūta;BORUŽĖLĖS;7712500278;Ne;0;3;0;3
8378;Rūta;BORUŽĖLĖS;8945868791;Taip;0;1;6;7
8379;Rūta;BORUŽĖLĖS;3348066709;Ne;0;0;1;1
8380;Rūta;BORUŽĖLĖS;4279367893;Taip;0;0;1;1
8381;Rūta;BORUŽĖLĖS;5141290453;Taip;5;0;0;5
8382;Rūta;BORUŽĖLĖS;7006165453;Ne;3;0;0;3
8383;Rūta;BORUŽĖLĖS;8303314520;Ne;2;0;0;2
8384;Rūta;BORUŽĖLĖS;3470052541;Ne;7;1;0;8
8385;Rūta;BORUŽĖLĖS;2625691851;Ne;2;0;1;3
8386;Rūta;BORUŽĖLĖS;1804222979;Taip;0;0;1;1
8387;Rūta;BORUŽĖLĖS;2373746441;Ne;3;0;0;3
8388;Rūta;BORUŽĖLĖS;2724625200;Ne;2;0;0;2
8389;Rūta;BORUŽĖLĖS;2492891254;Ne;0;0;6;6
8390;Rūta;BORUŽĖLĖS;4204930257;Ne;0;0;1;1
8391;Rūta;VYTURĖLIAI;7680605199;Taip;4;4;0;8
8392;Rūta;VYTURĖLIAI;6075632046;Ne;2;0;0;2
8393;Rūta;VYTURĖLIAI;9386595365;Ne;3;0;0;3
8394;Rūta;VYTURĖLIAI;6285841968;Ne;0;0;1;1
8395;Rūta;VYTURĖLIAI;7649756034;Ne;0;0;1;1
8396;Rūta;VYTURĖLIAI;1346124133;Ne;5;0;0;5
8397;Rūta;VYTURĖLIAI;4728904136;Ne;0;1;0;1
8398;Rūta;VYTURĖLIAI;9791861646;Ne;8;0;0;8
8399;Rūta;VYTURĖLIAI;2928803089;Ne;0;1;0;1
8400;Rūta;VYTURĖLIAI;1951202550;Taip;5;0;1;6
8401;Rūta;VYTURĖLIAI;3875136625;Ne;0;1;0;1
8402;Rūta;VYTURĖLIAI;9911151238;Ne;0;0;1;1
8403;Rūta;VYTURĖLIAI;7434152435;Ne;0;1;0;1
8404;Rūta;VYTURĖLIAI;1035527190;Ne;3;0;0;3
8405;Rūta;VYTURĖLIAI;3843325181;Ne;5;0;2;7
8406;Rūta;VYTURĖLIAI;8182243701;Ne;0;1;0;1
8407;Rūta;VYTURĖLIAI;8763382361;Ne;5;0;2;7
8408;Rūta;VYTURĖLIAI;8277677952;Taip;0;0;1;1
8409;Rūta;"PABIRUČIAI (LOGOPEDINĖ)";5211104903;Ne;1;0;0;1
8410;Rūta;"PABIRUČIAI (LOGOPEDINĖ)";1734479058;Ne;5;1;3;9
8411;Rūta;"PABIRUČIAI (LOGOPEDINĖ)";2164103114;Ne;7;0;0;7
8412;Rūta;"PABIRUČIAI (LOGOPEDINĖ)";6088978998;Ne;0;0;4;4
8413;Rūta;"PABIRUČIAI (LOGOPEDINĖ)";6849928601;Ne;6;0;3;9
8414;Rūta;"PABIRUČIAI (LOGOPEDINĖ)";4151633786;Taip;2;0;0;2
8415;Rūta;GUDRUČIAI;4044349935;Ne;6;0;0;6
8416;Rūta;GUDRUČIAI;3998791775;Ne;5;1;1;7
8417;Rūta;GUDRUČIAI;3043164521;Ne;2;8;0;10
8418;Rūta;GUDRUČIAI;3462986405;Ne;0;2;0;2
8419;Rūta;GUDRUČIAI;8548089843;Taip;4;0;2;6
8420;Rūta;GUDRUČIAI;4473591998;Ne;0;3;0;3
8421;Rūta;GUDRUČIAI;9589117921;Ne;3;1;1;5
8422;Rūta;GUDRUČIAI;3044976169;Ne;3;0;0;3
8423;Rūta;GUDRUČIAI;2546023973;Ne;0;0;1;1
8424;Rūta;GUDRUČIAI;8963959004;Ne;4;2;0;6
8425;Rūta;GUDRUČIAI;1811055786;Ne;0;1;0;1
8426;Rūta;GUDRUČIAI;1510268514;Ne;0;1;0;1
8427;Rūta;GUDRUČIAI;6814051598;Taip;0;3;1;4
8428;Rūta;GUDRUČIAI;2702537976;Ne;2;1;0;3
8429;Rūta;GUDRUČIAI;2772130413;Ne;6;0;0;6
8430;Rūta;GUDRUČIAI;1623968580;Ne;3;1;0;4
8431;Rūta;GUDRUČIAI;8592528906;Ne;5;0;1;6
8432;Rūta;GUDRUČIAI;1182222976;Ne;5;0;0;5
8433;Rūta;SEKLYTĖLĖ;4423305209;Ne;5;1;0;6
8434;Rūta;SEKLYTĖLĖ;9245618776;Ne;5;1;0;6
8435;Rūta;SEKLYTĖLĖ;1216786487;Ne;0;3;0;3
8436;Rūta;SEKLYTĖLĖ;7222494215;Ne;0;2;0;2
8437;Rūta;SEKLYTĖLĖ;7519931138;Ne;0;1;0;1
8438;Rūta;SEKLYTĖLĖ;4880804625;Ne;6;0;0;6
8439;Rūta;SEKLYTĖLĖ;9638495757;Taip;2;3;0;5
8440;Rūta;SEKLYTĖLĖ;1962172243;Ne;2;0;0;2
8441;Rūta;SEKLYTĖLĖ;8605070655;Ne;0;1;0;1
8442;Rūta;SEKLYTĖLĖ;7553844890;Ne;8;4;0;12
8443;Rūta;SEKLYTĖLĖ;3964922552;Ne;0;3;0;3
8444;Rūta;SEKLYTĖLĖ;8395765508;Ne;0;1;0;1
8445;Rūta;SEKLYTĖLĖ;9400586178;Ne;0;5;0;5
8446;Rūta;SEKLYTĖLĖ;3956912957;Ne;0;2;0;2
8447;Rūta;SEKLYTĖLĖ;2890569107;Ne;3;1;0;4
8448;Rūta;SEKLYTĖLĖ;2474991135;Ne;0;3;0;3
8449;Rūta;"VARPELIAI (LOGOPEDINĖ)";9171781646;Ne;3;0;0;3
8450;Rūta;"VARPELIAI (LOGOPEDINĖ)";6221528830;Ne;0;1;1;2
8451;Rūta;"VARPELIAI (LOGOPEDINĖ)";5871960113;Ne;0;1;0;1
8452;Rūta;"VARPELIAI (LOGOPEDINĖ)";3814794448;Ne;0;2;0;2
8453;Rūta;"VARPELIAI (LOGOPEDINĖ)";6572172779;Ne;0;1;0;1
8454;Rūta;"VARPELIAI (LOGOPEDINĖ)";7946139474;Ne;0;11;0;11
8455;Rūta;"VARPELIAI (LOGOPEDINĖ)";4931253729;Ne;2;0;1;3
8456;Rūta;KIŠKUČIŲ;6587625933;Ne;18;0;0;18
8457;Rūta;KIŠKUČIŲ;9526121339;Ne;7;0;0;7
8458;Rūta;KIŠKUČIŲ;3805738277;Ne;14;0;0;14
8459;Rūta;KIŠKUČIŲ;6019344201;Taip;9;0;1;10
8460;Rūta;KIŠKUČIŲ;4712457100;Ne;12;0;0;12
8461;Rūta;KIŠKUČIŲ;8370305271;Ne;0;3;0;3
8462;Rūta;KIŠKUČIŲ;4244665683;Ne;2;1;0;3
8463;Rūta;KIŠKUČIŲ;1504057906;Ne;0;1;1;2
8464;Rūta;KIŠKUČIŲ;9842173401;Ne;2;1;1;4
8465;Rūta;KIŠKUČIŲ;2895194578;Taip;4;0;0;4
8466;Rūta;KIŠKUČIŲ;1893871283;Ne;0;18;0;18
8467;Rūta;KIŠKUČIŲ;8711505500;Ne;0;1;0;1
8468;Rūta;KIŠKUČIŲ;2534754132;Ne;0;1;0;1
8469;Rūta;ŽVIRBLIUKAI;6778088225;Ne;7;0;0;7
8470;Rūta;ŽVIRBLIUKAI;1397028236;Ne;6;0;2;8
8471;Rūta;ŽVIRBLIUKAI;6567603848;Ne;6;0;2;8
8472;Rūta;ŽVIRBLIUKAI;9803391980;Ne;8;0;0;8
8473;Rūta;ŽVIRBLIUKAI;4512761439;Ne;5;1;0;6
8474;Rūta;ŽVIRBLIUKAI;9695283747;Ne;15;0;0;15
8475;Rūta;ŽVIRBLIUKAI;1184265720;Ne;0;17;0;17
8476;Rūta;ŽVIRBLIUKAI;5868983105;Ne;0;1;0;1
8477;Rūta;ŽVIRBLIUKAI;8423092171;Ne;0;18;0;18
8478;Rūta;ŽVIRBLIUKAI;5375565821;Ne;0;0;5;5
8479;Rūta;SAULUTĖS;6869693434;Ne;3;0;1;4
8480;Rūta;SAULUTĖS;6585842434;Ne;15;0;1;16
8481;Rūta;SAULUTĖS;6620957022;Taip;11;0;0;11
8482;Rūta;SAULUTĖS;8806743371;Ne;6;0;0;6
8483;Rūta;SAULUTĖS;8320521011;Ne;5;0;1;6
8484;Rūta;SAULUTĖS;2391120026;Ne;9;0;0;9
8485;Rūta;SAULUTĖS;3765741047;Ne;0;0;4;4
8486;Rūta;SAULUTĖS;7762509383;Ne;10;0;0;10
8487;Rūta;SAULUTĖS;2685515977;Ne;15;0;0;15
8488;Rūta;SAULUTĖS;5512946296;Ne;4;0;0;4
8489;Rūta;SAULUTĖS;9308127402;Ne;0;0;1;1
8490;Rūta;SAULUTĖS;7422059414;Taip;5;6;0;11
8491;Rūta;SAULUTĖS;6186413364;Ne;0;5;0;5
8492;Rūta;SAULUTĖS;8479424939;Ne;14;0;1;15
8493;Rūta;SAULUTĖS;9014433476;Ne;0;1;0;1
8494;Rūta;SAULUTĖS;1207463357;Ne;11;0;1;12
8495;Rūta;SAULUTĖS;8715921452;Ne;0;2;0;2
8496;Rūta;SAULUTĖS;9243332756;Ne;0;1;0;1
8497;Rūta;SAULUTĖS;4785878572;Ne;0;0;1;1
8498;Sadutė;Kiškučiai;6645848193;Ne;2;0;0;2
8499;Sadutė;Kiškučiai;3568132830;Ne;8;0;0;8
8500;Sadutė;Kiškučiai;4135398332;Ne;4;0;0;4
8501;Sadutė;Kiškučiai;1860645542;Taip;0;4;0;4
8502;Sadutė;Kiškučiai;8841564884;Ne;10;0;0;10
8503;Sadutė;Kiškučiai;8350900604;Ne;7;1;0;8
8504;Sadutė;Kiškučiai;6784030565;Ne;4;0;0;4
8505;Sadutė;Kiškučiai;3510450761;Taip;0;14;0;14
8506;Sadutė;Kiškučiai;2807949826;Ne;0;0;4;4
8507;Sadutė;Boružėlės;9115304973;Ne;0;0;2;2
8508;Sadutė;Boružėlės;1273355194;Ne;3;2;0;5
8509;Sadutė;Boružėlės;3119547420;Ne;3;2;0;5
8510;Sadutė;Boružėlės;6994383907;Ne;0;0;1;1
8511;Sadutė;Boružėlės;8914509685;Ne;3;0;5;8
8512;Sadutė;Boružėlės;3875265137;Ne;4;0;2;6
8513;Sadutė;Boružėlės;5992119777;Ne;0;2;3;5
8514;Sadutė;Boružėlės;5682745869;Ne;1;0;1;2
8515;Sadutė;Boružėlės;7072437339;Ne;1;0;0;1
8516;Sadutė;Boružėlės;3362830536;Ne;1;0;4;5
8517;Sadutė;Boružėlės;5395676303;Ne;0;0;3;3
8518;Sadutė;Boružėlės;1923014145;Ne;0;0;8;8
8519;Sadutė;Boružėlės;5698462283;Taip;5;0;1;6
8520;Sadutė;Boružėlės;3845369333;Ne;11;0;0;11
8521;Sadutė;Boružėlės;8200891038;Ne;7;0;0;7
8522;Sadutė;Boružėlės;4696990344;Ne;3;0;1;4
8523;Sadutė;Boružėlės;1753849762;Ne;0;0;2;2
8524;Sadutė;Boružėlės;7580736252;Taip;0;0;4;4
8525;Sadutė;Bitutės;1759479328;Ne;0;1;3;4
8526;Sadutė;Bitutės;4245873513;Ne;2;0;0;2
8527;Sadutė;Bitutės;5866461096;Ne;17;0;0;17
8528;Sadutė;Bitutės;2020766695;Taip;0;20;0;20
8529;Sadutė;Bitutės;5011320850;Ne;3;0;3;6
8530;Sadutė;Bitutės;5973513916;Ne;3;0;0;3
8531;Sadutė;Bitutės;3361904803;Ne;7;0;0;7
8532;Sadutė;Bitutės;1231048342;Ne;4;0;0;4
8533;Sadutė;Bitutės;6066145909;Ne;0;5;3;8
8534;Sadutė;Bitutės;5142566738;Ne;5;0;5;10
8535;Sadutė;Bitutės;8662375739;Taip;5;0;3;8
8536;Sadutė;Bitutės;9107727583;Ne;0;0;3;3
8537;Sadutė;Bitutės;3339522259;Ne;2;0;0;2
8538;Sadutė;Bitutės;9005989501;Ne;3;0;0;3
8539;Sadutė;Drugeliai;2965270548;Ne;10;0;0;10
8540;Sadutė;Drugeliai;7533550197;Ne;6;0;0;6
8541;Sadutė;Drugeliai;8308487263;Ne;4;0;0;4
8542;Sadutė;Drugeliai;4753735028;Ne;0;10;0;10
8543;Sadutė;Drugeliai;6039555589;Ne;13;0;1;14
8544;Sadutė;Drugeliai;4132174495;Ne;4;3;0;7
8545;Sadutė;Drugeliai;4862514558;Ne;1;0;1;2
8546;Sadutė;Drugeliai;4866469773;Ne;0;20;0;20
8547;Sadutė;Drugeliai;3450873020;Ne;6;0;0;6
8548;Sadutė;Drugeliai;5133144667;Ne;4;0;0;4
8549;Sadutė;Drugeliai;9224321056;Ne;7;0;0;7
8550;Sadutė;Drugeliai;3895799244;Ne;0;20;0;20
8551;Sadutė;Drugeliai;3337178609;Ne;2;0;0;2
8552;Sadutė;Drugeliai;3540727678;Ne;14;0;0;14
8553;Sadutė;Pėledžiukai;2705458480;Ne;9;0;1;10
8554;Sadutė;Pėledžiukai;6314488650;Taip;0;0;3;3
8555;Sadutė;Pėledžiukai;6126235707;Ne;6;0;0;6
8556;Sadutė;Pėledžiukai;1537482438;Ne;2;0;0;2
8557;Sadutė;Pėledžiukai;6716550703;Ne;5;0;0;5
8558;Sadutė;Pėledžiukai;7730645448;Ne;0;0;2;2
8559;Sadutė;Pėledžiukai;7551299839;Ne;5;0;1;6
8560;Sadutė;Pėledžiukai;8914706717;Ne;12;0;0;12
8561;Sadutė;Pėledžiukai;6379705269;Ne;0;0;1;1
8562;Sadutė;Pėledžiukai;5385678913;Taip;3;1;1;5
8563;Sadutė;Pėledžiukai;2747256989;Ne;0;0;2;2
8564;Sadutė;Pėledžiukai;3277826759;Ne;3;0;1;4
8565;Sadutė;Pėledžiukai;2003300961;Ne;2;1;0;3
8566;Sadutė;Pėledžiukai;5580870821;Ne;10;0;0;10
8567;Sadutė;Pėledžiukai;6430493524;Ne;5;0;1;6
8568;Sadutė;Pėledžiukai;1510498753;Ne;5;0;1;6
8569;Sadutė;Kačiukų;2890916313;Ne;2;0;0;2
8570;Sadutė;Kačiukų;2733633163;Ne;0;3;0;3
8571;Sadutė;Kačiukų;2466024649;Ne;0;5;0;5
8572;Sadutė;Kačiukų;2426974464;Ne;0;1;0;1
8573;Sadutė;Kačiukų;8974374101;Ne;0;1;0;1
8574;Sadutė;Kačiukų;4401870028;Ne;0;2;0;2
8575;Sadutė;Kačiukų;8714168144;Ne;0;2;0;2
8576;Sadutė;Kačiukų;3927044011;Taip;0;1;0;1
8577;Sadutė;Kačiukų;8770727233;Ne;0;1;0;1
8578;Sadutė;Kačiukų;8556218971;Ne;0;2;1;3
8579;Sadutė;Kačiukų;5267093203;Ne;20;0;0;20
8580;Sadutė;Kačiukų;5614758320;Ne;0;20;0;20
8581;Sadutė;Kačiukų;2194387139;Ne;0;6;0;6
8582;Sakalėlis;GIRINUKŲ;6597274376;Ne;3;0;0;3
8583;Sakalėlis;GIRINUKŲ;5500248048;Ne;4;0;0;4
8584;Sakalėlis;GIRINUKŲ;8562164673;Ne;0;1;0;1
8585;Sakalėlis;GIRINUKŲ;1121818878;Ne;0;1;0;1
8586;Sakalėlis;GIRINUKŲ;2537030533;Ne;0;0;2;2
8587;Sakalėlis;GIRINUKŲ;3719351129;Ne;0;1;0;1
8588;Sakalėlis;GIRINUKŲ;3570413330;Ne;7;0;3;10
8589;Sakalėlis;GIRINUKŲ;6889888573;Ne;3;0;2;5
8590;Sakalėlis;GIRINUKŲ;5465596207;Taip;2;0;0;2
8591;Sakalėlis;GIRINUKŲ;7852255204;Ne;14;0;0;14
8592;Sakalėlis;GIRINUKŲ;9926328835;Ne;0;1;0;1
8593;Sakalėlis;GIRINUKŲ;1253452975;Ne;10;0;0;10
8594;Sakalėlis;GIRINUKŲ;7480286509;Ne;9;0;0;9
8595;Sakalėlis;GIRINUKŲ;2250828607;Ne;6;1;0;7
8596;Sakalėlis;GIRINUKŲ;2672429406;Ne;6;1;0;7
8597;Sakalėlis;GIRINUKŲ;2233966176;Ne;0;0;1;1
8598;Sakalėlis;GIRINUKŲ;7079300418;Ne;0;0;1;1
8599;Sakalėlis;GIRINUKŲ;8501785305;Ne;5;0;0;5
8600;Sakalėlis;GIRINUKŲ;2649804066;Ne;16;0;0;16
8601;Sakalėlis;VYTURIUKŲ;2352118061;Ne;0;0;1;1
8602;Sakalėlis;VYTURIUKŲ;4862004373;Ne;0;1;0;1
8603;Sakalėlis;VYTURIUKŲ;8422299669;Ne;0;0;1;1
8604;Sakalėlis;VYTURIUKŲ;6579827280;Ne;0;0;2;2
8605;Sakalėlis;VYTURIUKŲ;8381310908;Ne;3;0;2;5
8606;Sakalėlis;VYTURIUKŲ;6840368824;Ne;6;0;2;8
8607;Sakalėlis;VYTURIUKŲ;5795250727;Ne;0;0;2;2
8608;Sakalėlis;VYTURIUKŲ;3351218789;Ne;0;0;3;3
8609;Sakalėlis;VYTURIUKŲ;4136266629;Ne;0;0;8;8
8610;Sakalėlis;VYTURIUKŲ;5991029760;Taip;0;0;4;4
8611;Sakalėlis;VYTURIUKŲ;1200252225;Ne;0;5;0;5
8612;Sakalėlis;VYTURIUKŲ;7280513854;Ne;3;0;1;4
8613;Sakalėlis;VYTURIUKŲ;1806698668;Ne;0;0;3;3
8614;Sakalėlis;DRUGELIŲ;7706606275;Ne;8;0;1;9
8615;Sakalėlis;DRUGELIŲ;5911341542;Ne;1;0;0;1
8616;Sakalėlis;DRUGELIŲ;9272347788;Ne;0;0;1;1
8617;Sakalėlis;DRUGELIŲ;8331612396;Ne;2;0;0;2
8618;Sakalėlis;DRUGELIŲ;2898006208;Ne;8;0;0;8
8619;Sakalėlis;DRUGELIŲ;7542322748;Ne;12;0;0;12
8620;Sakalėlis;DRUGELIŲ;1201086815;Ne;7;0;0;7
8621;Sakalėlis;DRUGELIŲ;3934295338;Ne;2;0;1;3
8622;Sakalėlis;DRUGELIŲ;1117800518;Ne;3;0;0;3
8623;Sakalėlis;DRUGELIŲ;9836193857;Ne;3;0;0;3
8624;Sakalėlis;DRUGELIŲ;4004006771;Ne;0;0;1;1
8625;Sakalėlis;DRUGELIŲ;1833573491;Ne;0;0;1;1
8626;Sakalėlis;DRUGELIŲ;8713298648;Ne;0;0;4;4
8627;Sakalėlis;DRUGELIŲ;2889638745;Ne;5;0;3;8
8628;Sakalėlis;DRUGELIŲ;7540098033;Taip;8;0;1;9
8629;Sakalėlis;DRUGELIŲ;7285833058;Ne;1;0;0;1
8630;Sakalėlis;GENIUKŲ;5865993835;Ne;13;0;0;13
8631;Sakalėlis;GENIUKŲ;6328924318;Ne;19;0;0;19
8632;Sakalėlis;GENIUKŲ;2003090775;Ne;3;0;2;5
8633;Sakalėlis;GENIUKŲ;8228039819;Ne;9;0;0;9
8634;Sakalėlis;GENIUKŲ;4611384179;Taip;0;2;1;3
8635;Sakalėlis;GENIUKŲ;4490632523;Ne;7;0;0;7
8636;Sakalėlis;GENIUKŲ;8868588637;Taip;8;0;0;8
8637;Sakalėlis;GENIUKŲ;5052638078;Ne;20;0;0;20
8638;Sakalėlis;GENIUKŲ;5327382009;Ne;20;0;0;20
8639;Sakalėlis;GENIUKŲ;6897550418;Ne;10;0;0;10
8640;Sakalėlis;GENIUKŲ;9642519454;Ne;6;0;0;6
8641;Sakalėlis;GENIUKŲ;4295210323;Taip;5;0;0;5
8642;Sakalėlis;GENIUKŲ;6300266321;Ne;11;0;0;11
8643;Sakalėlis;GENIUKŲ;8659925528;Ne;2;0;0;2
8644;Sakalėlis;VOVERIUKŲ;5172421763;Ne;9;0;2;11
8645;Sakalėlis;VOVERIUKŲ;5233697077;Ne;5;0;2;7
8646;Sakalėlis;VOVERIUKŲ;6414564366;Taip;0;0;4;4
8647;Sakalėlis;VOVERIUKŲ;6806170544;Taip;0;0;3;3
8648;Sakalėlis;VOVERIUKŲ;2557089391;Ne;7;0;3;10
8649;Sakalėlis;VOVERIUKŲ;8133985842;Ne;0;0;1;1
8650;Sakalėlis;VOVERIUKŲ;3574956316;Ne;0;1;0;1
8651;Sakalėlis;VOVERIUKŲ;1403384561;Ne;0;0;6;6
8652;Sakalėlis;VOVERIUKŲ;3927363997;Ne;4;1;0;5
8653;Sakalėlis;VOVERIUKŲ;6293226507;Ne;17;0;0;17
8654;Sakalėlis;VOVERIUKŲ;2699844937;Taip;4;2;0;6
8655;Sakalėlis;VOVERIUKŲ;1669610397;Taip;0;0;10;10
8656;Sakalėlis;VOVERIUKŲ;6016854405;Ne;0;5;0;5
8657;Sakalėlis;VOVERIUKŲ;2531146677;Ne;19;0;0;19
8658;Sakalėlis;VOVERIUKŲ;4968216193;Ne;0;0;3;3
8659;Sakalėlis;PĖLEDŽIUKŲ;5405669698;Ne;1;0;3;4
8660;Sakalėlis;PĖLEDŽIUKŲ;2474164013;Ne;0;1;0;1
8661;Sakalėlis;PĖLEDŽIUKŲ;9566176151;Ne;6;0;0;6
8662;Sakalėlis;PĖLEDŽIUKŲ;5496044442;Ne;3;0;0;3
8663;Sakalėlis;PĖLEDŽIUKŲ;6603105354;Ne;0;0;2;2
8664;Sakalėlis;PĖLEDŽIUKŲ;3418702674;Ne;0;0;2;2
8665;Sakalėlis;PĖLEDŽIUKŲ;8606714134;Ne;0;6;0;6
8666;Sakalėlis;PĖLEDŽIUKŲ;8790189865;Ne;2;0;0;2
8667;Sakalėlis;PĖLEDŽIUKŲ;4209146744;Ne;0;0;3;3
8668;Sakalėlis;PĖLEDŽIUKŲ;6217643065;Ne;2;0;2;4
8669;Sakalėlis;PĖLEDŽIUKŲ;4344537391;Ne;0;0;1;1
8670;Sakalėlis;PĖLEDŽIUKŲ;9368758708;Ne;3;9;0;12
8671;Sakalėlis;PĖLEDŽIUKŲ;8326977226;Ne;0;0;2;2
8672;Sakalėlis;PĖLEDŽIUKŲ;4576495786;Taip;0;1;0;1
8673;Sakalėlis;"BITUČIŲ (LOGOPEDINĖ)";3079900548;Taip;9;0;0;9
8674;Sakalėlis;"BITUČIŲ (LOGOPEDINĖ)";2669711574;Ne;5;0;0;5
8675;Sakalėlis;"BITUČIŲ (LOGOPEDINĖ)";8638720071;Ne;6;0;0;6
8676;Sakalėlis;"BITUČIŲ (LOGOPEDINĖ)";4442027941;Ne;5;0;0;5
8677;Sakalėlis;"BITUČIŲ (LOGOPEDINĖ)";1208798798;Ne;2;0;0;2
8678;Sakalėlis;"BITUČIŲ (LOGOPEDINĖ)";2748400429;Taip;0;10;0;10
8679;Sakalėlis;"BORUŽIUKŲ (LOGOPEDINĖ)";6222204020;Ne;5;0;0;5
8680;Sakalėlis;"BORUŽIUKŲ (LOGOPEDINĖ)";7602249339;Ne;0;0;2;2
8681;Sakalėlis;"BORUŽIUKŲ (LOGOPEDINĖ)";8263169658;Ne;3;0;4;7
8682;Sakalėlis;"BORUŽIUKŲ (LOGOPEDINĖ)";9776767584;Ne;4;0;2;6
8683;Sakalėlis;"BORUŽIUKŲ (LOGOPEDINĖ)";7620944079;Ne;2;0;3;5
8684;Sakalėlis;"BORUŽIUKŲ (LOGOPEDINĖ)";2732572235;Ne;4;0;1;5
8685;Sakalėlis;"BORUŽIUKŲ (LOGOPEDINĖ)";5677280944;Taip;2;0;5;7
8686;Sakalėlis;MEŠKUČIŲ;9546779717;Ne;16;0;0;16
8687;Sakalėlis;MEŠKUČIŲ;8535457018;Ne;1;4;0;5
8688;Sakalėlis;MEŠKUČIŲ;7154383856;Ne;6;0;0;6
8689;Sakalėlis;MEŠKUČIŲ;5082756444;Taip;5;0;0;5
8690;Sakalėlis;MEŠKUČIŲ;7839893402;Ne;0;5;0;5
8691;Sakalėlis;MEŠKUČIŲ;3092760315;Ne;5;1;0;6
8692;Sakalėlis;MEŠKUČIŲ;3524545708;Ne;0;7;0;7
8693;Sakalėlis;MEŠKUČIŲ;5961207419;Ne;5;0;0;5
8694;Sakalėlis;MEŠKUČIŲ;5961861760;Ne;1;0;0;1
8695;Sakalėlis;MEŠKUČIŲ;2389541483;Taip;2;4;0;6
8696;Sakalėlis;MEŠKUČIŲ;4063074948;Ne;4;0;1;5
8697;Sakalėlis;MEŠKUČIŲ;8108456923;Ne;4;0;1;5
8698;Sakalėlis;MEŠKUČIŲ;7285230768;Ne;14;3;0;17
8699;Sakalėlis;MEŠKUČIŲ;2090313887;Ne;0;6;0;6
8700;Sakalėlis;MEŠKUČIŲ;9794245922;Ne;8;0;0;8
8701;Sakalėlis;MEŠKUČIŲ;8106231242;Ne;4;4;0;8
8702;Sakalėlis;MEŠKUČIŲ;4520212128;Ne;6;4;0;10
8703;Sakalėlis;MEŠKUČIŲ;7228559861;Ne;0;10;0;10
8704;Sakalėlis;MEŠKUČIŲ;8000744698;Taip;2;0;0;2
8705;Sakalėlis;MEŠKUČIŲ;7664863335;Ne;5;0;0;5
8706;Sakalėlis;KIŠKUČIŲ;6029443196;Ne;9;0;1;10
8707;Sakalėlis;KIŠKUČIŲ;8036737782;Ne;10;6;2;18
8708;Sakalėlis;KIŠKUČIŲ;9621137382;Ne;12;0;0;12
8709;Sakalėlis;KIŠKUČIŲ;3941949117;Ne;2;0;0;2
8710;Sakalėlis;KIŠKUČIŲ;2117073621;Ne;2;0;0;2
8711;Sakalėlis;KIŠKUČIŲ;7796882816;Ne;7;0;1;8
8712;Sakalėlis;KIŠKUČIŲ;8788790889;Ne;2;0;2;4
8713;Sakalėlis;KIŠKUČIŲ;1270977572;Taip;17;0;0;17
8714;Sakalėlis;KIŠKUČIŲ;6682017840;Ne;10;0;0;10
8715;Sakalėlis;KIŠKUČIŲ;1913818905;Ne;5;0;0;5
8716;Sakalėlis;KIŠKUČIŲ;1969584481;Ne;19;0;0;19
8717;Sakalėlis;KIŠKUČIŲ;7764732694;Ne;4;0;0;4
8718;Sakalėlis;KIŠKUČIŲ;8461873822;Ne;7;0;0;7
8719;Sakalėlis;KIŠKUČIŲ;9172210601;Ne;0;7;0;7
8720;Sakalėlis;SVIRPLIUKŲ;1981444595;Ne;9;0;0;9
8721;Sakalėlis;SVIRPLIUKŲ;8562206323;Ne;0;0;2;2
8722;Sakalėlis;SVIRPLIUKŲ;5494452779;Ne;5;0;1;6
8723;Sakalėlis;SVIRPLIUKŲ;3294479203;Ne;8;0;0;8
8724;Sakalėlis;SVIRPLIUKŲ;9423279756;Taip;13;0;0;13
8725;Sakalėlis;SVIRPLIUKŲ;3205403024;Ne;6;0;0;6
8726;Sakalėlis;SVIRPLIUKŲ;3963251786;Ne;0;0;4;4
8727;Sakalėlis;SVIRPLIUKŲ;8386308690;Ne;10;0;0;10
8728;Sakalėlis;SVIRPLIUKŲ;8959937912;Ne;0;0;1;1
8729;Sakalėlis;SVIRPLIUKŲ;5649630720;Ne;5;0;0;5
8730;Sakalėlis;SVIRPLIUKŲ;5740175023;Ne;6;0;0;6
8731;Sakalėlis;SVIRPLIUKŲ;6476563646;Ne;0;13;0;13
8732;Sakalėlis;GANDRIUKŲ;7384400795;Ne;0;9;4;13
8733;Sakalėlis;GANDRIUKŲ;3644413861;Ne;0;1;0;1
8734;Sakalėlis;GANDRIUKŲ;4230762388;Taip;17;0;0;17
8735;Sakalėlis;GANDRIUKŲ;3228617971;Ne;11;0;0;11
8736;Sakalėlis;GANDRIUKŲ;5748438461;Taip;3;0;0;3
8737;Sakalėlis;GANDRIUKŲ;2734462553;Ne;8;0;0;8
8738;Sakalėlis;GANDRIUKŲ;6069544792;Taip;0;0;5;5
8739;Sakalėlis;GANDRIUKŲ;8869621812;Ne;3;0;0;3
8740;Sakalėlis;GANDRIUKŲ;1560077883;Taip;3;0;0;3
8741;Sakalėlis;GANDRIUKŲ;5387119771;Taip;17;0;0;17
8742;Sakalėlis;GANDRIUKŲ;9599801230;Ne;15;0;0;15
8743;Sakalėlis;GANDRIUKŲ;3611884072;Ne;0;0;1;1
8744;Sakalėlis;GANDRIUKŲ;7321913487;Ne;0;0;2;2
8745;Sakalėlis;GANDRIUKŲ;1820886350;Ne;14;0;0;14
8746;Sakalėlis;GANDRIUKŲ;4307106905;Ne;0;0;3;3
8747;Sakalėlis;GANDRIUKŲ;2889517278;Ne;15;0;0;15
8748;Salininkų;BORUŽIUKAI;1315946153;Ne;0;0;2;2
8749;Salininkų;BORUŽIUKAI;4251420816;Ne;0;8;0;8
8750;Salininkų;BORUŽIUKAI;4753007411;Ne;0;2;0;2
8751;Salininkų;BORUŽIUKAI;5023856698;Ne;4;1;0;5
8752;Salininkų;BORUŽIUKAI;9802972916;Ne;9;1;3;13
8753;Salininkų;BORUŽIUKAI;1198469626;Ne;4;1;1;6
8754;Salininkų;BORUŽIUKAI;3168392325;Ne;5;1;0;6
8755;Salininkų;BORUŽIUKAI;6477136976;Ne;16;1;0;17
8756;Salininkų;BORUŽIUKAI;6903692351;Ne;10;1;0;11
8757;Salininkų;BORUŽIUKAI;1161889732;Ne;0;1;0;1
8758;Salininkų;BORUŽIUKAI;8049341629;Ne;0;1;2;3
8759;Salininkų;BORUŽIUKAI;7022231494;Ne;0;0;2;2
8760;Salininkų;BORUŽIUKAI;4726550395;Ne;0;1;0;1
8761;Salininkų;BORUŽIUKAI;4742529598;Ne;0;2;0;2
8762;Salininkų;BORUŽIUKAI;4866786238;Ne;4;2;0;6
8763;Salininkų;BORUŽIUKAI;3710734769;Taip;5;3;0;8
8764;Salininkų;GĖLYTĖS;8718514114;Ne;17;1;0;18
8765;Salininkų;GĖLYTĖS;8329495685;Taip;12;0;0;12
8766;Salininkų;GĖLYTĖS;8930622266;Ne;0;1;0;1
8767;Salininkų;GĖLYTĖS;5447236646;Ne;7;2;0;9
8768;Salininkų;GĖLYTĖS;8911016037;Ne;10;2;0;12
8769;Salininkų;GĖLYTĖS;1647401700;Ne;10;0;1;11
8770;Salininkų;GĖLYTĖS;9817285587;Ne;8;0;0;8
8771;Salininkų;GĖLYTĖS;2146404021;Ne;0;1;0;1
8772;Salininkų;GĖLYTĖS;8823595510;Ne;7;0;0;7
8773;Salininkų;GĖLYTĖS;9416926474;Ne;11;0;0;11
8774;Salininkų;GĖLYTĖS;5671229613;Ne;3;0;0;3
8775;Salininkų;GĖLYTĖS;1005025619;Taip;0;5;0;5
8776;Salininkų;GĖLYTĖS;9855014750;Ne;1;0;0;1
8777;Salininkų;GĖLYTĖS;1254843449;Ne;0;8;0;8
8778;Salininkų;GĖLYTĖS;6315595048;Ne;0;1;0;1
8779;Salininkų;GĖLYTĖS;2056560837;Ne;8;1;0;9
8780;Salininkų;DRUGELIAI;2684868661;Ne;7;0;0;7
8781;Salininkų;DRUGELIAI;8063397588;Ne;1;0;0;1
8782;Salininkų;DRUGELIAI;4333027447;Ne;9;1;0;10
8783;Salininkų;DRUGELIAI;3115232507;Ne;0;5;0;5
8784;Salininkų;DRUGELIAI;2009246885;Ne;0;1;2;3
8785;Salininkų;DRUGELIAI;3420217477;Ne;0;0;1;1
8786;Salininkų;DRUGELIAI;3890914603;Ne;13;1;0;14
8787;Salininkų;DRUGELIAI;3181932118;Ne;0;4;0;4
8788;Salininkų;DRUGELIAI;5017068344;Ne;7;0;0;7
8789;Salininkų;DRUGELIAI;3761217912;Taip;5;0;0;5
8790;Salininkų;DRUGELIAI;2208607684;Ne;0;3;0;3
8791;Salininkų;DRUGELIAI;3963410827;Ne;6;2;0;8
8792;Salininkų;DRUGELIAI;5539560359;Taip;7;0;3;10
8793;Salininkų;DRUGELIAI;5587577036;Ne;0;0;3;3
8794;Salininkų;DRUGELIAI;5375668400;Ne;0;5;0;5
8795;Salininkų;DRUGELIAI;4529253958;Ne;5;0;1;6
8796;Salininkų;DRUGELIAI;5583804491;Ne;10;0;0;10
8797;Salininkų;DRUGELIAI;7063718023;Ne;3;0;0;3
8798;Salininkų;DRUGELIAI;9018366347;Ne;10;1;0;11
8799;Salininkų;ŽIRNIUKAI;7643665643;Ne;6;4;0;10
8800;Salininkų;ŽIRNIUKAI;9198411540;Ne;13;0;0;13
8801;Salininkų;ŽIRNIUKAI;6885580632;Ne;0;9;0;9
8802;Salininkų;ŽIRNIUKAI;7409604480;Taip;0;5;0;5
8803;Salininkų;ŽIRNIUKAI;3677558828;Ne;0;1;0;1
8804;Salininkų;ŽIRNIUKAI;8095820690;Ne;7;1;0;8
8805;Salininkų;ŽIRNIUKAI;6482437251;Ne;0;3;0;3
8806;Salininkų;ŽIRNIUKAI;1380797788;Ne;2;2;0;4
8807;Salininkų;ŽIRNIUKAI;2495782496;Ne;4;1;0;5
8808;Salininkų;ŽIRNIUKAI;9896357816;Ne;6;0;0;6
8809;Salininkų;ŽIRNIUKAI;4568462071;Ne;19;0;0;19
8810;Salininkų;ŽIRNIUKAI;9137783249;Ne;4;3;0;7
8811;Salininkų;ŽIRNIUKAI;8524400656;Ne;4;3;0;7
8812;Salininkų;ŽIRNIUKAI;7463713798;Ne;0;3;0;3
8813;Salininkų;ŽIRNIUKAI;9617873735;Taip;7;0;0;7
8814;Salininkų;ŽIRNIUKAI;1111197633;Ne;1;0;0;1
8815;Salininkų;ŽIRNIUKAI;6143967744;Ne;10;0;0;10
8816;Salininkų;ŽIRNIUKAI;8552427446;Ne;5;0;0;5
8817;Salininkų;ŽIRNIUKAI;6586988786;Ne;6;0;0;6
8818;Salininkų;ŽIRNIUKAI;1587485662;Ne;7;0;0;7
8819;Salininkų;PAUKŠČIUKAI;2895782373;Ne;0;3;0;3
8820;Salininkų;PAUKŠČIUKAI;4971070998;Ne;4;0;0;4
8821;Salininkų;PAUKŠČIUKAI;9893985732;Ne;0;6;0;6
8822;Salininkų;PAUKŠČIUKAI;1284909139;Ne;0;3;0;3
8823;Salininkų;PAUKŠČIUKAI;3686372180;Ne;0;0;1;1
8824;Salininkų;PAUKŠČIUKAI;5164367382;Ne;9;0;0;9
8825;Salininkų;PAUKŠČIUKAI;3338213592;Ne;0;2;0;2
8826;Salininkų;PAUKŠČIUKAI;6506819265;Ne;5;0;0;5
8827;Salininkų;PAUKŠČIUKAI;6510096414;Ne;0;8;0;8
8828;Salininkų;PAUKŠČIUKAI;2491796874;Ne;5;0;0;5
8829;Salininkų;PAUKŠČIUKAI;3464228778;Ne;5;0;0;5
8830;Salininkų;PAUKŠČIUKAI;2440831687;Ne;10;1;0;11
8831;Salininkų;PAUKŠČIUKAI;2726813574;Ne;12;0;0;12
8832;Salininkų;PAUKŠČIUKAI;8141168894;Ne;5;1;0;6
8833;Salininkų;PAUKŠČIUKAI;2798153926;Taip;0;4;0;4
8834;Salininkų;PAUKŠČIUKAI;8602489420;Ne;0;3;0;3
8835;Salininkų;PAUKŠČIUKAI;1453214735;Ne;6;1;0;7
8836;Salininkų;PAUKŠČIUKAI;8336855920;Ne;0;2;0;2
8837;Salininkų;BITUTĖS;3252151974;Ne;4;1;0;5
8838;Salininkų;BITUTĖS;6845471044;Ne;6;0;2;8
8839;Salininkų;BITUTĖS;2467926286;Ne;5;0;0;5
8840;Salininkų;BITUTĖS;9902751686;Ne;0;1;1;2
8841;Salininkų;BITUTĖS;6125152143;Taip;0;1;0;1
8842;Salininkų;BITUTĖS;2095952937;Taip;0;1;1;2
8843;Salininkų;BITUTĖS;6551489987;Ne;4;3;0;7
8844;Salininkų;BITUTĖS;1928897962;Ne;0;0;1;1
8845;Salininkų;BITUTĖS;3527495230;Ne;0;1;0;1
8846;Salininkų;BITUTĖS;5582091833;Taip;2;0;0;2
8847;Salininkų;BITUTĖS;9996809930;Taip;0;0;4;4
8848;Salininkų;BITUTĖS;3915336062;Ne;5;0;0;5
8849;Salininkų;BITUTĖS;7115888747;Ne;0;0;3;3
8850;Salininkų;BITUTĖS;7639362434;Ne;5;0;2;7
8851;Salininkų;BITUTĖS;2370778977;Ne;3;0;0;3
8852;Salininkų;BITUTĖS;1020073382;Ne;0;0;1;1
8853;Salininkų;BITUTĖS;4480303856;Ne;3;1;0;4
8854;Salininkų;BITUTĖS;7383557807;Ne;0;6;0;6
8855;Salvija;Daigelis(šatil);5805537864;Ne;0;1;0;1
8856;Salvija;Daigelis(šatil);6323383244;Ne;8;2;0;10
8857;Salvija;Daigelis(šatil);3857916185;Ne;0;0;2;2
8858;Salvija;Daigelis(šatil);1168900211;Ne;5;0;0;5
8859;Salvija;Daigelis(šatil);7410091250;Ne;8;0;0;8
8860;Salvija;Daigelis(šatil);5761622263;Ne;0;0;1;1
8861;Salvija;Daigelis(šatil);6797777730;Ne;4;0;0;4
8862;Salvija;Daigelis(šatil);1850688392;Ne;1;0;1;2
8863;Salvija;Daigelis(šatil);2959140033;Ne;10;1;0;11
8864;Salvija;Daigelis(šatil);9129939185;Ne;10;0;0;10
8865;Salvija;Daigelis(šatil);3856024521;Ne;4;0;0;4
8866;Salvija;Daigelis(šatil);2161008233;Ne;5;0;0;5
8867;Salvija;Daigelis(šatil);6690635579;Ne;2;0;0;2
8868;Salvija;Daigelis(šatil);1959861292;Ne;15;0;0;15
8869;Salvija;Daigelis(šatil);6260496597;Ne;19;0;0;19
8870;Salvija;Daigelis(šatil);1019409172;Ne;3;0;0;3
8871;Salvija;"Pienė (savjon)";8981331532;Ne;11;0;1;12
8872;Salvija;"Pienė (savjon)";8013023311;Ne;5;0;2;7
8873;Salvija;"Pienė (savjon)";4325636377;Ne;5;0;1;6
8874;Salvija;"Pienė (savjon)";7477171133;Ne;12;0;0;12
8875;Salvija;"Pienė (savjon)";6706565915;Ne;0;0;2;2
8876;Salvija;"Pienė (savjon)";8853389268;Ne;10;0;0;10
8877;Salvija;"Pienė (savjon)";3856351749;Taip;10;0;0;10
8878;Salvija;"Pienė (savjon)";3487446998;Ne;5;0;0;5
8879;Salvija;"Pienė (savjon)";4373711097;Ne;4;0;1;5
8880;Salvija;"Pienė (savjon)";5816893736;Ne;9;0;0;9
8881;Salvija;"Pienė (savjon)";1975032693;Ne;4;0;0;4
8882;Salvija;"Pienė (savjon)";5327735648;Ne;10;0;1;11
8883;Salvija;"Pienė (savjon)";4665919836;Ne;0;0;1;1
8884;Salvija;"Pienė (savjon)";4577248630;Ne;11;1;0;12
8885;Salvija;"Pienė (savjon)";6509829735;Ne;0;0;2;2
8886;Salvija;"Pienė (savjon)";1062662192;Ne;0;0;2;2
8887;Salvija;"Pienė (savjon)";9978634888;Ne;7;0;0;7
8888;Salvija;"Pienė (savjon)";1511271658;Ne;0;0;1;1
8889;Saulėtekis;BERŽELIS;3493175211;Ne;0;2;0;2
8890;Saulėtekis;BERŽELIS;8086451893;Ne;13;0;0;13
8891;Saulėtekis;BERŽELIS;9351122147;Ne;1;0;0;1
8892;Saulėtekis;BERŽELIS;5468364505;Ne;3;0;0;3
8893;Saulėtekis;BERŽELIS;4704426104;Ne;5;0;0;5
8894;Saulėtekis;BERŽELIS;7407540257;Ne;7;0;1;8
8895;Saulėtekis;BERŽELIS;6920619390;Ne;1;0;0;1
8896;Saulėtekis;BERŽELIS;5194925689;Ne;3;0;0;3
8897;Saulėtekis;BERŽELIS;9579088485;Ne;1;0;0;1
8898;Saulėtekis;BERŽELIS;7436158953;Ne;6;0;0;6
8899;Saulėtekis;BERŽELIS;7165739418;Ne;5;0;0;5
8900;Saulėtekis;BERŽELIS;1917500190;Ne;2;1;0;3
8901;Saulėtekis;BERŽELIS;2935641362;Ne;10;0;0;10
8902;Saulėtekis;BERŽELIS;7598254324;Ne;11;0;0;11
8903;Saulėtekis;BERŽELIS;8468491266;Ne;5;0;0;5
8904;Saulėtekis;BERŽELIS;6181992249;Taip;2;0;0;2
8905;Saulėtekis;BERŽELIS;5824537129;Ne;20;0;0;20
8906;Saulėtekis;BERŽELIS;8427457478;Ne;1;0;0;1
8907;Saulėtekis;ŠYPSENA;4975294724;Ne;11;0;0;11
8908;Saulėtekis;ŠYPSENA;2946991447;Taip;2;0;0;2
8909;Saulėtekis;ŠYPSENA;7780877703;Ne;0;0;1;1
8910;Saulėtekis;ŠYPSENA;2282128335;Ne;10;0;0;10
8911;Saulėtekis;ŠYPSENA;7759917109;Ne;0;0;2;2
8912;Saulėtekis;ŠYPSENA;4391887095;Ne;6;0;0;6
8913;Saulėtekis;ŠYPSENA;1278985938;Ne;0;0;1;1
8914;Saulėtekis;ŠYPSENA;4765756650;Taip;15;0;0;15
8915;Saulėtekis;ŠYPSENA;8173628625;Ne;0;0;4;4
8916;Saulėtekis;ŠYPSENA;1237869114;Ne;8;0;0;8
8917;Saulėtekis;ŠYPSENA;1515580716;Ne;10;1;0;11
8918;Saulėtekis;ŠYPSENA;6831161042;Ne;10;1;0;11
8919;Saulėtekis;ŠYPSENA;4433821698;Ne;4;0;1;5
8920;Saulėtekis;NYKŠTUKAI;1896847801;Ne;1;0;0;1
8921;Saulėtekis;NYKŠTUKAI;7849181976;Ne;5;0;0;5
8922;Saulėtekis;NYKŠTUKAI;5748816813;Taip;15;0;0;15
8923;Saulėtekis;NYKŠTUKAI;1416983683;Ne;4;0;0;4
8924;Saulėtekis;NYKŠTUKAI;4758423356;Ne;3;0;0;3
8925;Saulėtekis;NYKŠTUKAI;9270109327;Ne;1;0;0;1
8926;Saulėtekis;NYKŠTUKAI;5183297420;Ne;0;5;0;5
8927;Saulėtekis;NYKŠTUKAI;8007704080;Ne;10;0;0;10
8928;Saulėtekis;NYKŠTUKAI;9481578412;Taip;3;0;0;3
8929;Saulėtekis;NYKŠTUKAI;8167740525;Ne;12;0;0;12
8930;Saulėtekis;NYKŠTUKAI;7273354670;Ne;15;0;0;15
8931;Saulėtekis;NYKŠTUKAI;3371045145;Ne;8;0;0;8
8932;Saulėtekis;NYKŠTUKAI;9818660340;Ne;15;0;0;15
8933;Saulėtekis;NYKŠTUKAI;3729811521;Ne;11;0;0;11
8934;Saulėtekis;NYKŠTUKAI;5888979911;Ne;5;0;0;5
8935;Saulėtekis;NYKŠTUKAI;8090571664;Ne;2;0;0;2
8936;Saulėtekis;NYKŠTUKAI;3957655772;Ne;10;0;0;10
8937;Saulėtekis;NYKŠTUKAI;1331793286;Ne;12;4;0;16
8938;Saulėtekis;PAGRANDUKAS;8098047919;Ne;6;1;0;7
8939;Saulėtekis;PAGRANDUKAS;8240764949;Ne;3;0;1;4
8940;Saulėtekis;PAGRANDUKAS;6763015593;Ne;5;0;0;5
8941;Saulėtekis;PAGRANDUKAS;5970957754;Ne;7;0;1;8
8942;Saulėtekis;PAGRANDUKAS;5252265065;Taip;13;0;0;13
8943;Saulėtekis;PAGRANDUKAS;3903728416;Ne;4;0;1;5
8944;Saulėtekis;PAGRANDUKAS;3096623181;Ne;10;0;0;10
8945;Saulėtekis;PAGRANDUKAS;6029401583;Ne;17;0;0;17
8946;Saulėtekis;PAGRANDUKAS;6008705995;Ne;6;0;1;7
8947;Saulėtekis;PAGRANDUKAS;5173602064;Ne;0;2;0;2
8948;Saulėtekis;PAGRANDUKAS;3142594542;Ne;0;2;0;2
8949;Saulėtekis;PAGRANDUKAS;1734813803;Ne;0;0;1;1
8950;Saulėtekis;PAGRANDUKAS;6966791665;Ne;5;0;0;5
8951;Saulėtekis;PAGRANDUKAS;7293735126;Ne;7;0;0;7
8952;Saulėtekis;PAGRANDUKAS;4066394876;Ne;3;0;0;3
8953;Saulėtekis;PAGRANDUKAS;9575338070;Ne;5;0;3;8
8954;Saulėtekis;RAMUNĖLIŲ;4681031693;Ne;10;0;0;10
8955;Saulėtekis;RAMUNĖLIŲ;2316817605;Ne;11;0;0;11
8956;Saulėtekis;RAMUNĖLIŲ;3987535802;Ne;6;1;0;7
8957;Saulėtekis;RAMUNĖLIŲ;6979741482;Ne;0;0;1;1
8958;Saulėtekis;RAMUNĖLIŲ;8348456528;Ne;6;0;1;7
8959;Saulėtekis;RAMUNĖLIŲ;3430209353;Ne;5;0;1;6
8960;Saulėtekis;RAMUNĖLIŲ;5980690239;Ne;6;0;0;6
8961;Saulėtekis;RAMUNĖLIŲ;2786112846;Ne;8;0;0;8
8962;Saulėtekis;RAMUNĖLIŲ;8876580678;Ne;8;0;0;8
8963;Saulėtekis;RAMUNĖLIŲ;1427323748;Ne;3;0;0;3
8964;Saulėtekis;RAMUNĖLIŲ;3224110585;Ne;20;0;0;20
8965;Saulėtekis;RAMUNĖLIŲ;2002180753;Ne;7;0;2;9
8966;Saulėtekis;RAMUNĖLIŲ;5685176596;Ne;1;0;0;1
8967;Saulėtekis;RAMUNĖLIŲ;9668125862;Ne;2;0;1;3
8968;Saulėtekis;RAMUNĖLIŲ;4736430248;Ne;5;0;1;6
8969;Saulėtekis;RAMUNĖLIŲ;1108736588;Taip;13;0;0;13
8970;Saulėtekis;RAMUNĖLIŲ;3680199463;Ne;6;0;2;8
8971;Saulėtekis;RAMUNĖLIŲ;2383861394;Ne;0;1;0;1
8972;Saulėtekis;RAMUNĖLIŲ;7494641077;Ne;3;1;0;4
8973;Saulėtekis;RAMUNĖLIŲ;1577609727;Ne;3;1;0;4
8974;Saulėtekis;PASAKAITĖ;8033763960;Ne;5;0;0;5
8975;Saulėtekis;PASAKAITĖ;5086871001;Ne;0;1;0;1
8976;Saulėtekis;PASAKAITĖ;9226317303;Ne;2;2;0;4
8977;Saulėtekis;PASAKAITĖ;9267790598;Ne;3;1;0;4
8978;Saulėtekis;PASAKAITĖ;6670590135;Ne;1;0;0;1
8979;Saulėtekis;PASAKAITĖ;6720758829;Taip;11;0;0;11
8980;Saulėtekis;PASAKAITĖ;7966714585;Ne;2;1;0;3
8981;Saulėtekis;PASAKAITĖ;3224883243;Ne;1;1;0;2
8982;Saulėtekis;PASAKAITĖ;9382031144;Ne;0;4;0;4
8983;Saulėtekis;PASAKAITĖ;3371914339;Ne;3;1;0;4
8984;Saulėtekis;PASAKAITĖ;6214539956;Ne;3;1;0;4
8985;Saulėtekis;PASAKAITĖ;9584556476;Ne;0;4;0;4
8986;Saulėtekis;PASAKAITĖ;9799880235;Ne;4;0;0;4
8987;Saulėtekis;PASAKAITĖ;2469458604;Ne;0;2;0;2
8988;Saulėtekis;PASAKAITĖ;3499575148;Ne;0;1;0;1
8989;Saulėtekis;PASAKAITĖ;2206038658;Ne;4;1;0;5
8990;Saulėtekis;PASAKAITĖ;7826554599;Ne;2;0;0;2
8991;Saulėtekis;VARPELIAI;3303064486;Ne;9;0;1;10
8992;Saulėtekis;VARPELIAI;1355354514;Ne;1;0;0;1
8993;Saulėtekis;VARPELIAI;5997903066;Ne;7;0;0;7
8994;Saulėtekis;VARPELIAI;7171550857;Ne;0;0;1;1
8995;Saulėtekis;VARPELIAI;3157110037;Ne;15;0;0;15
8996;Saulėtekis;VARPELIAI;8331659142;Taip;8;0;0;8
8997;Saulėtekis;VARPELIAI;1479530265;Ne;0;0;7;7
8998;Saulėtekis;VARPELIAI;1164913351;Taip;9;0;0;9
8999;Saulėtekis;VARPELIAI;3780019474;Ne;15;0;0;15
9000;Saulėtekis;VARPELIAI;9615110873;Ne;3;0;0;3
9001;Saulėtekis;VARPELIAI;7423380888;Ne;0;0;1;1
9002;Saulėtekis;VARPELIAI;2621773226;Ne;10;0;1;11
9003;Saulėtekis;VARPELIAI;3832717108;Ne;4;1;0;5
9004;Saulėtekis;VARPELIAI;1240595768;Ne;5;0;0;5
9005;Saulėtekis;GRŪDELIS;1864236745;Ne;6;0;0;6
9006;Saulėtekis;GRŪDELIS;7171048750;Ne;5;0;1;6
9007;Saulėtekis;GRŪDELIS;6535620172;Ne;5;1;0;6
9008;Saulėtekis;GRŪDELIS;8252953405;Taip;1;0;1;2
9009;Saulėtekis;GRŪDELIS;5161940030;Ne;4;0;0;4
9010;Saulėtekis;GRŪDELIS;5218345414;Ne;4;0;0;4
9011;Saulėtekis;GRŪDELIS;9646060606;Ne;7;0;0;7
9012;Saulėtekis;GRŪDELIS;1934900185;Ne;8;0;0;8
9013;Saulėtekis;GRŪDELIS;9995919137;Ne;5;1;0;6
9014;Saulėtekis;GRŪDELIS;6928825133;Ne;5;2;0;7
9015;Saulėtekis;GRŪDELIS;8138047893;Ne;9;0;0;9
9016;Saulėtekis;GRŪDELIS;3953501167;Ne;0;0;1;1
9017;Saulėtekis;GRŪDELIS;2646213073;Ne;5;0;0;5
9018;Saulėtekis;GRŪDELIS;6482182524;Ne;0;5;0;5
9019;Saulėtekis;GRŪDELIS;6779891385;Ne;8;0;0;8
9020;Saulėtekis;GRŪDELIS;7666624373;Ne;0;0;1;1
9021;Saulėtekis;GRŪDELIS;8061477303;Ne;0;0;2;2
9022;Saulėtekis;GRŪDELIS;2568544418;Taip;5;0;1;6
9023;Saulėtekis;GRŪDELIS;9734188792;Ne;20;0;0;20
9024;Saulėtekis;GRŪDELIS;6983324115;Ne;2;0;1;3
9025;Saulėtekis;GRŪDELIS;9787534807;Ne;3;0;0;3
9026;Saulėtekis;JONVABALIS;8239855620;Taip;0;0;1;1
9027;Saulėtekis;JONVABALIS;8603952810;Ne;3;0;1;4
9028;Saulėtekis;JONVABALIS;8881524909;Ne;4;0;0;4
9029;Saulėtekis;JONVABALIS;7673965242;Ne;17;0;0;17
9030;Saulėtekis;JONVABALIS;7730889108;Ne;11;0;2;13
9031;Saulėtekis;JONVABALIS;2686041419;Ne;5;0;3;8
9032;Saulėtekis;JONVABALIS;3166959569;Ne;0;4;0;4
9033;Saulėtekis;JONVABALIS;9972687066;Taip;6;0;0;6
9034;Saulėtekis;JONVABALIS;7346852524;Ne;6;0;1;7
9035;Saulėtekis;JONVABALIS;5518726567;Ne;6;0;1;7
9036;Saulėtekis;JONVABALIS;6072030240;Ne;2;0;0;2
9037;Saulėtekis;JONVABALIS;7435424899;Ne;9;0;0;9
9038;Saulėtekis;JONVABALIS;2177470008;Ne;0;4;0;4
9039;Saulėtekis;JONVABALIS;7803735686;Ne;5;0;0;5
9040;Saulėtekis;JONVABALIS;7505040675;Ne;4;0;0;4
9041;Saulėtekis;JONVABALIS;8143793642;Ne;0;1;0;1
9042;Saulėtekis;JONVABALIS;9694119292;Taip;0;0;1;1
9043;Saulėtekis;JONVABALIS;9791926936;Ne;2;0;0;2
9044;Saulėtekis;JONVABALIS;6608831217;Ne;0;1;0;1
9045;Saulėtekis;JONVABALIS;8023603198;Ne;8;0;0;8
9046;Saulėtekis;SMALSUČIAI;9941731250;Ne;2;0;0;2
9047;Saulėtekis;SMALSUČIAI;8102360466;Ne;0;0;1;1
9048;Saulėtekis;SMALSUČIAI;1020209414;Ne;4;0;0;4
9049;Saulėtekis;SMALSUČIAI;2728836108;Ne;6;0;0;6
9050;Saulėtekis;SMALSUČIAI;7164579375;Ne;0;0;1;1
9051;Saulėtekis;SMALSUČIAI;8390615573;Ne;6;0;0;6
9052;Saulėtekis;SMALSUČIAI;4152255439;Ne;6;0;0;6
9053;Saulėtekis;SMALSUČIAI;8574702901;Taip;1;0;0;1
9054;Saulėtekis;SMALSUČIAI;2209156661;Ne;0;0;1;1
9055;Saulėtekis;SMALSUČIAI;5552614092;Ne;2;0;0;2
9056;Saulėtekis;SMALSUČIAI;9497129509;Ne;6;0;0;6
9057;Saulėtekis;SMALSUČIAI;3366064429;Ne;4;0;0;4
9058;Saulėtekis;SMALSUČIAI;9870595577;Ne;3;0;0;3
9059;Saulėtekis;SMALSUČIAI;2154590089;Ne;2;0;0;2
9060;Saulėtekis;SMALSUČIAI;3220993253;Ne;0;0;1;1
9061;Saulėtekis;BITUTĖS;4252302344;Ne;6;0;0;6
9062;Saulėtekis;BITUTĖS;9382796391;Ne;8;0;0;8
9063;Saulėtekis;BITUTĖS;2095103400;Ne;8;0;0;8
9064;Saulėtekis;BITUTĖS;7614555277;Ne;4;0;0;4
9065;Saulėtekis;BITUTĖS;7308749675;Ne;1;3;0;4
9066;Saulėtekis;BITUTĖS;3768954974;Ne;0;0;2;2
9067;Saulėtekis;BITUTĖS;2939151459;Ne;11;0;0;11
9068;Saulėtekis;BITUTĖS;9892315045;Taip;3;0;1;4
9069;Saulėtekis;BITUTĖS;8890060293;Ne;5;0;0;5
9070;Saulėtekis;BITUTĖS;3349025533;Ne;5;0;0;5
9071;Saulėtekis;BITUTĖS;6945891800;Ne;9;0;0;9
9072;Saulėtekis;BITUTĖS;6468360941;Ne;11;0;1;12
9073;Saulėtekis;RIEŠUTĖLIAI;8767786444;Ne;13;0;0;13
9074;Saulėtekis;RIEŠUTĖLIAI;2224626144;Ne;9;0;0;9
9075;Saulėtekis;RIEŠUTĖLIAI;5898051775;Ne;0;0;1;1
9076;Saulėtekis;RIEŠUTĖLIAI;3356705340;Ne;10;0;0;10
9077;Saulėtekis;RIEŠUTĖLIAI;7824492464;Ne;5;0;0;5
9078;Saulėtekis;RIEŠUTĖLIAI;3935935671;Ne;0;0;2;2
9079;Saulėtekis;RIEŠUTĖLIAI;7807096583;Ne;0;0;2;2
9080;Saulėtekis;RIEŠUTĖLIAI;2908714227;Ne;0;0;9;9
9081;Saulėtekis;RIEŠUTĖLIAI;7305619721;Ne;0;0;13;13
9082;Saulėtekis;RIEŠUTĖLIAI;9516841263;Ne;13;0;3;16
9083;Saulėtekis;RIEŠUTĖLIAI;6557482092;Ne;5;0;1;6
9084;Saulėtekis;RIEŠUTĖLIAI;6183384994;Taip;9;0;0;9
9085;Saulėtekis;RIEŠUTĖLIAI;3559882322;Ne;5;0;0;5
9086;Saulėtekis;RIEŠUTĖLIAI;9351147084;Taip;0;0;1;1
9087;Saulėtekis;RIEŠUTĖLIAI;7338301696;Taip;2;2;0;4
9088;Saulėtekis;RIEŠUTĖLIAI;3206247299;Ne;16;0;0;16
9089;Skroblinukas;SVIRPLIUKŲ;2195112297;Taip;24;0;0;24
9090;Skroblinukas;SVIRPLIUKŲ;4198512202;Ne;14;0;0;14
9091;Skroblinukas;SVIRPLIUKŲ;7750501815;Ne;6;6;4;16
9092;Skroblinukas;SVIRPLIUKŲ;1544598440;Ne;3;1;0;4
9093;Skroblinukas;SVIRPLIUKŲ;6574558658;Ne;0;1;0;1
9094;Skroblinukas;SVIRPLIUKŲ;4861971439;Ne;5;1;1;7
9095;Skroblinukas;SVIRPLIUKŲ;7817632987;Ne;8;0;0;8
9096;Skroblinukas;SVIRPLIUKŲ;7675772872;Ne;1;5;0;6
9097;Skroblinukas;SVIRPLIUKŲ;4266945644;Taip;15;0;6;21
9098;Skroblinukas;SVIRPLIUKŲ;7216760382;Ne;3;0;2;5
9099;Skroblinukas;SVIRPLIUKŲ;5154111867;Ne;5;1;0;6
9100;Skroblinukas;SVIRPLIUKŲ;8622930871;Ne;13;0;6;19
9101;Skroblinukas;SVIRPLIUKŲ;3260267388;Ne;0;9;0;9
9102;Skroblinukas;SVIRPLIUKŲ;7761972818;Ne;5;1;0;6
9103;Skroblinukas;SVIRPLIUKŲ;9629502585;Ne;3;0;0;3
9104;Skroblinukas;SVIRPLIUKŲ;6461678336;Ne;5;0;0;5
9105;Skroblinukas;GANDRIUKŲ;2406619611;Ne;0;1;0;1
9106;Skroblinukas;GANDRIUKŲ;1851920334;Ne;0;5;0;5
9107;Skroblinukas;GANDRIUKŲ;9377215921;Ne;2;15;0;17
9108;Skroblinukas;GANDRIUKŲ;6489976163;Ne;10;0;0;10
9109;Skroblinukas;GANDRIUKŲ;1159546580;Ne;0;2;1;3
9110;Skroblinukas;GANDRIUKŲ;2310750833;Ne;0;2;0;2
9111;Skroblinukas;GANDRIUKŲ;9888115079;Ne;0;1;0;1
9112;Skroblinukas;GANDRIUKŲ;9475514959;Ne;0;1;0;1
9113;Skroblinukas;GANDRIUKŲ;9031598603;Ne;2;1;0;3
9114;Skroblinukas;GANDRIUKŲ;5251903769;Ne;3;14;0;17
9115;Skroblinukas;GANDRIUKŲ;7385271438;Ne;6;0;0;6
9116;Skroblinukas;GANDRIUKŲ;9541682085;Ne;2;0;0;2
9117;Skroblinukas;GANDRIUKŲ;1369962422;Ne;0;0;5;5
9118;Skroblinukas;VYTURIUKŲ;3954228349;Ne;0;0;6;6
9119;Skroblinukas;VYTURIUKŲ;4560580022;Ne;0;0;1;1
9120;Skroblinukas;VYTURIUKŲ;3065235192;Taip;7;6;0;13
9121;Skroblinukas;VYTURIUKŲ;5902713448;Ne;14;4;0;18
9122;Skroblinukas;VYTURIUKŲ;3594000419;Ne;3;5;0;8
9123;Skroblinukas;VYTURIUKŲ;3512297435;Ne;3;5;0;8
9124;Skroblinukas;VYTURIUKŲ;2481980627;Ne;10;10;1;21
9125;Skroblinukas;VYTURIUKŲ;9725125130;Ne;2;0;1;3
9126;Skroblinukas;VYTURIUKŲ;2978284436;Ne;9;0;1;10
9127;Skroblinukas;VYTURIUKŲ;7068452970;Ne;7;0;0;7
9128;Skroblinukas;VYTURIUKŲ;3292517112;Ne;7;2;0;9
9129;Skroblinukas;VYTURIUKŲ;4129726208;Ne;0;0;3;3
9130;Skroblinukas;VYTURIUKŲ;3351309750;Ne;0;0;2;2
9131;Skroblinukas;VYTURIUKŲ;5101136022;Ne;4;0;0;4
9132;Skroblinukas;VYTURIUKŲ;9828486832;Ne;3;0;0;3
9133;Skroblinukas;VYTURIUKŲ;2263955772;Ne;0;14;0;14
9134;Skroblinukas;VYTURIUKŲ;9731326488;Ne;12;0;0;12
9135;Skroblinukas;GENIUKŲ;6011466024;Ne;8;0;0;8
9136;Skroblinukas;GENIUKŲ;8544069746;Ne;3;4;0;7
9137;Skroblinukas;GENIUKŲ;6475609065;Ne;20;0;8;28
9138;Skroblinukas;GENIUKŲ;4091852305;Ne;0;11;0;11
9139;Skroblinukas;GENIUKŲ;1820748152;Ne;9;0;0;9
9140;Skroblinukas;GENIUKŲ;3705638869;Ne;6;0;5;11
9141;Skroblinukas;GENIUKŲ;2511496284;Ne;12;0;0;12
9142;Skroblinukas;GENIUKŲ;7045587415;Ne;8;4;6;18
9143;Skroblinukas;GENIUKŲ;5946356374;Ne;13;0;1;14
9144;Skroblinukas;GENIUKŲ;5274898590;Ne;9;5;0;14
9145;Skroblinukas;GENIUKŲ;1167332689;Taip;0;4;0;4
9146;Skroblinukas;GENIUKŲ;4491947846;Ne;3;1;0;4
9147;Skroblinukas;GENIUKŲ;7955574061;Ne;5;5;0;10
9148;Skroblinukas;GENIUKŲ;1014993354;Ne;11;1;0;12
9149;Skroblinukas;GENIUKŲ;1232121301;Ne;0;6;0;6
9150;Skroblinukas;GENIUKŲ;8680329175;Ne;2;0;0;2
9151;Skroblinukas;BITUČIŲ;4639384934;Ne;5;1;0;6
9152;Skroblinukas;BITUČIŲ;5206925237;Ne;4;0;1;5
9153;Skroblinukas;BITUČIŲ;7581372511;Ne;5;2;0;7
9154;Skroblinukas;BITUČIŲ;6717008836;Ne;10;6;0;16
9155;Skroblinukas;BITUČIŲ;8998236911;Ne;0;4;0;4
9156;Skroblinukas;BITUČIŲ;6791969485;Ne;2;2;0;4
9157;Skroblinukas;BITUČIŲ;2363368201;Ne;15;13;0;28
9158;Skroblinukas;BITUČIŲ;2885814517;Ne;0;3;0;3
9159;Skroblinukas;BITUČIŲ;3689247672;Ne;2;1;0;3
9160;Skroblinukas;BITUČIŲ;5354832150;Ne;0;0;1;1
9161;Skroblinukas;BITUČIŲ;5841866621;Ne;0;0;4;4
9162;Skroblinukas;BITUČIŲ;4688496560;Ne;5;4;0;9
9163;Skroblinukas;BITUČIŲ;9341501143;Ne;0;2;1;3
9164;Skroblinukas;BITUČIŲ;3490684777;Ne;0;1;0;1
9165;Skroblinukas;BITUČIŲ;2717586232;Taip;0;5;0;5
9166;Skroblinukas;BITUČIŲ;4840767748;Ne;5;2;0;7
9167;Skroblinukas;BITUČIŲ;9513546028;Ne;9;1;6;16
9168;Skroblinukas;BITUČIŲ;8715188878;Ne;10;4;0;14
9169;Skroblinukas;BITUČIŲ;7407601996;Ne;0;2;3;5
9170;Skroblinukas;BITUČIŲ;4631657273;Ne;5;0;1;6
9171;Skroblinukas;BITUČIŲ;7255510731;Ne;8;0;0;8
9172;Skroblinukas;BITUČIŲ;5694105568;Ne;0;0;1;1
9173;Skroblinukas;BORUŽĖLIŲ;2523742608;Ne;8;0;0;8
9174;Skroblinukas;BORUŽĖLIŲ;2311459579;Ne;7;0;0;7
9175;Skroblinukas;BORUŽĖLIŲ;7771969055;Ne;0;0;1;1
9176;Skroblinukas;BORUŽĖLIŲ;8711201474;Ne;4;0;0;4
9177;Skroblinukas;BORUŽĖLIŲ;2166244766;Ne;11;0;0;11
9178;Skroblinukas;BORUŽĖLIŲ;7729612420;Ne;28;0;0;28
9179;Skroblinukas;BORUŽĖLIŲ;5082212661;Ne;7;0;1;8
9180;Skroblinukas;BORUŽĖLIŲ;4904084567;Ne;0;0;1;1
9181;Skroblinukas;BORUŽĖLIŲ;1357700154;Ne;24;0;0;24
9182;Skroblinukas;BORUŽĖLIŲ;2095608208;Ne;5;0;0;5
9183;Skroblinukas;BORUŽĖLIŲ;7446262781;Ne;16;0;0;16
9184;Skroblinukas;BORUŽĖLIŲ;6005897181;Ne;10;0;0;10
9185;Skroblinukas;BORUŽĖLIŲ;1547123058;Taip;7;3;0;10
9186;Skroblinukas;SKRUZDĖLIUKŲ;5688453546;Ne;3;1;0;4
9187;Skroblinukas;SKRUZDĖLIUKŲ;6890306112;Ne;0;2;0;2
9188;Skroblinukas;SKRUZDĖLIUKŲ;6445065388;Ne;0;3;0;3
9189;Skroblinukas;SKRUZDĖLIUKŲ;9448253468;Ne;2;0;0;2
9190;Skroblinukas;SKRUZDĖLIUKŲ;3771045336;Ne;0;7;0;7
9191;Skroblinukas;SKRUZDĖLIUKŲ;4424763028;Ne;21;0;0;21
9192;Skroblinukas;SKRUZDĖLIUKŲ;5252389111;Ne;2;0;0;2
9193;Skroblinukas;SKRUZDĖLIUKŲ;2883593274;Ne;0;1;0;1
9194;Skroblinukas;SKRUZDĖLIUKŲ;5157913924;Ne;0;7;0;7
9195;Skroblinukas;SKRUZDĖLIUKŲ;9368764758;Ne;6;2;0;8
9196;Skroblinukas;SKRUZDĖLIUKŲ;8576448571;Ne;0;6;0;6
9197;Skroblinukas;SKRUZDĖLIUKŲ;3290115134;Ne;0;5;0;5
9198;Skroblinukas;SKRUZDĖLIUKŲ;9813249677;Ne;0;4;0;4
9199;Skroblinukas;SKRUZDĖLIUKŲ;2101748012;Ne;2;0;0;2
9200;Skroblinukas;SKRUZDĖLIUKŲ;5915278745;Ne;0;1;0;1
9201;Skroblinukas;SKRUZDĖLIUKŲ;6640062847;Ne;9;0;0;9
9202;Skroblinukas;ŽVIRBLIUKŲ;3041669079;Ne;8;0;0;8
9203;Skroblinukas;ŽVIRBLIUKŲ;6068248705;Ne;13;0;0;13
9204;Skroblinukas;ŽVIRBLIUKŲ;3117532423;Ne;6;0;1;7
9205;Skroblinukas;ŽVIRBLIUKŲ;8124086303;Ne;7;0;0;7
9206;Skroblinukas;ŽVIRBLIUKŲ;7640540309;Ne;0;11;0;11
9207;Skroblinukas;ŽVIRBLIUKŲ;3858667425;Ne;11;0;0;11
9208;Skroblinukas;ŽVIRBLIUKŲ;1996484086;Ne;20;1;0;21
9209;Skroblinukas;ŽVIRBLIUKŲ;7527177120;Ne;0;3;0;3
9210;Skroblinukas;ŽVIRBLIUKŲ;6135412007;Taip;15;0;0;15
9211;Skroblinukas;ŽVIRBLIUKŲ;2312400921;Taip;16;0;0;16
9212;Skroblinukas;ŽVIRBLIUKŲ;7804920443;Ne;16;0;0;16
9213;Skroblinukas;ŽVIRBLIUKŲ;4197050176;Ne;2;8;0;10
9214;Skroblinukas;ŽVIRBLIUKŲ;4390614970;Taip;12;0;0;12
9215;Skroblinukas;ŽIOGELIŲ;6279909049;Ne;12;0;1;13
9216;Skroblinukas;ŽIOGELIŲ;9737310101;Ne;4;0;2;6
9217;Skroblinukas;ŽIOGELIŲ;8118284793;Ne;13;0;1;14
9218;Skroblinukas;ŽIOGELIŲ;1844211217;Ne;6;0;3;9
9219;Skroblinukas;ŽIOGELIŲ;4266029484;Ne;0;6;0;6
9220;Skroblinukas;ŽIOGELIŲ;9191337531;Ne;26;0;0;26
9221;Skroblinukas;ŽIOGELIŲ;2941319404;Ne;0;0;3;3
9222;Skroblinukas;ŽIOGELIŲ;7912986106;Ne;0;0;3;3
9223;Skroblinukas;ŽIOGELIŲ;3909811358;Ne;5;0;0;5
9224;Skroblinukas;ŽIOGELIŲ;7650915045;Ne;8;0;0;8
9225;Skroblinukas;ŽIOGELIŲ;6444788760;Ne;0;3;0;3
9226;Skroblinukas;ŽIOGELIŲ;6070633607;Ne;8;0;0;8
9227;Skroblinukas;STRAZDELIŲ;4799600999;Ne;3;0;0;3
9228;Skroblinukas;STRAZDELIŲ;8898971191;Ne;8;0;0;8
9229;Skroblinukas;STRAZDELIŲ;7480868540;Taip;8;0;0;8
9230;Skroblinukas;STRAZDELIŲ;5804217824;Ne;9;0;0;9
9231;Skroblinukas;STRAZDELIŲ;1762416639;Ne;3;1;1;5
9232;Skroblinukas;STRAZDELIŲ;7483556761;Ne;0;0;1;1
9233;Skroblinukas;STRAZDELIŲ;1306489851;Ne;10;0;0;10
9234;Skroblinukas;STRAZDELIŲ;1846830752;Ne;9;0;0;9
9235;Skroblinukas;STRAZDELIŲ;4500841908;Taip;14;0;1;15
9236;Skroblinukas;STRAZDELIŲ;8734405028;Ne;5;3;0;8
9237;Skroblinukas;STRAZDELIŲ;2132271995;Ne;10;5;0;15
9238;Skroblinukas;STRAZDELIŲ;9524875796;Ne;5;0;0;5
9239;Skroblinukas;STRAZDELIŲ;9753194124;Ne;15;0;0;15
9240;Skroblinukas;DRUGELIŲ;7400908711;Ne;3;8;0;11
9241;Skroblinukas;DRUGELIŲ;3889890374;Ne;0;6;0;6
9242;Skroblinukas;DRUGELIŲ;9481718833;Ne;5;0;0;5
9243;Skroblinukas;DRUGELIŲ;8864594520;Ne;7;0;1;8
9244;Skroblinukas;DRUGELIŲ;2772360168;Ne;9;2;0;11
9245;Skroblinukas;DRUGELIŲ;3624518310;Ne;0;1;0;1
9246;Skroblinukas;DRUGELIŲ;5957417413;Ne;0;7;0;7
9247;Skroblinukas;DRUGELIŲ;3226115050;Ne;2;0;0;2
9248;Skroblinukas;DRUGELIŲ;2887161771;Ne;7;0;0;7
9249;Skroblinukas;DRUGELIŲ;4737605061;Ne;0;10;2;12
9250;Skroblinukas;DRUGELIŲ;8390240445;Ne;4;0;2;6
9251;Skroblinukas;DRUGELIŲ;2948231687;Ne;3;0;0;3
9252;Skroblinukas;DRUGELIŲ;5912771080;Ne;12;4;0;16
9253;Skroblinukas;DRUGELIŲ;7528824951;Taip;0;0;6;6
9254;Skroblinukas;DRUGELIŲ;2987938909;Ne;8;5;0;13
9255;Skroblinukas;DRUGELIŲ;8286842648;Ne;0;0;1;1
9256;Skroblinukas;DRUGELIŲ;1453029732;Taip;5;3;0;8
9257;Skroblinukas;PELĖDŽIUKŲ;8953844650;Ne;4;0;0;4
9258;Skroblinukas;PELĖDŽIUKŲ;5813075721;Ne;11;0;0;11
9259;Skroblinukas;PELĖDŽIUKŲ;3646325903;Ne;0;3;0;3
9260;Skroblinukas;PELĖDŽIUKŲ;9292990596;Taip;5;10;0;15
9261;Skroblinukas;PELĖDŽIUKŲ;8202855376;Ne;5;0;24;29
9262;Skroblinukas;PELĖDŽIUKŲ;8312341293;Taip;5;1;0;6
9263;Skroblinukas;PELĖDŽIUKŲ;3658815079;Ne;3;0;0;3
9264;Skroblinukas;PELĖDŽIUKŲ;5418212729;Ne;0;0;1;1
9265;Skroblinukas;PELĖDŽIUKŲ;4168542339;Ne;2;5;0;7
9266;Skroblinukas;PELĖDŽIUKŲ;8958893525;Ne;3;0;10;13
9267;Skroblinukas;PELĖDŽIUKŲ;6675716937;Ne;5;0;0;5
9268;Skroblinukas;PELĖDŽIUKŲ;1009065470;Taip;14;3;0;17
9269;Skroblinukas;PELĖDŽIUKŲ;9553242594;Ne;3;4;0;7
9270;Skroblinukas;PELĖDŽIUKŲ;4802801867;Ne;5;0;0;5
9271;Skroblinukas;PELĖDŽIUKŲ;1758987652;Ne;1;0;0;1
9272;Skroblinukas;PELĖDŽIUKŲ;8465074037;Ne;4;1;2;7
9273;Skroblinukas;PELĖDŽIUKŲ;2071093890;Ne;6;0;0;6
9274;Skroblinukas;PELĖDŽIUKŲ;9523720873;Ne;10;3;8;21
9275;Skroblinukas;PELĖDŽIUKŲ;7920117036;Ne;9;1;0;10
9276;Skroblinukas;PELĖDŽIUKŲ;2215428081;Ne;4;0;0;4
9277;Smalsučiai;Žibuoklės;6535494814;Ne;15;0;2;17
9278;Smalsučiai;Žibuoklės;3309134310;Ne;0;3;0;3
9279;Smalsučiai;Žibuoklės;2326167599;Ne;0;0;1;1
9280;Smalsučiai;Žibuoklės;4094037708;Ne;3;0;2;5
9281;Smalsučiai;Žibuoklės;5482692473;Ne;0;0;1;1
9282;Smalsučiai;Žibuoklės;2742992400;Ne;0;0;4;4
9283;Smalsučiai;Žibuoklės;3877274360;Ne;0;2;0;2
9284;Smalsučiai;Žibuoklės;9988599126;Ne;5;0;0;5
9285;Smalsučiai;Žibuoklės;5900294530;Taip;0;0;2;2
9286;Smalsučiai;Žibuoklės;6931092874;Ne;2;0;2;4
9287;Smalsučiai;Žibuoklės;7070240693;Ne;0;1;0;1
9288;Smalsučiai;Žibuoklės;8259056296;Ne;0;0;5;5
9289;Smalsučiai;Žibuoklės;9637877396;Ne;10;0;0;10
9290;Smalsučiai;Aitvarų;3349726106;Ne;5;0;0;5
9291;Smalsučiai;Aitvarų;2219168902;Ne;4;0;0;4
9292;Smalsučiai;Aitvarų;9305837033;Ne;6;0;0;6
9293;Smalsučiai;Aitvarų;9305837033;Ne;6;0;0;6
9294;Smalsučiai;Aitvarų;9305837033;Ne;6;0;0;6
9295;Smalsučiai;Aitvarų;3888093640;Taip;6;1;0;7
9296;Smalsučiai;Aitvarų;8284740122;Taip;3;3;0;6
9297;Smalsučiai;Aitvarų;8985656809;Ne;1;0;0;1
9298;Smalsučiai;Aitvarų;4054278651;Ne;0;0;2;2
9299;Smalsučiai;Aitvarų;6232068532;Ne;0;15;0;15
9300;Smalsučiai;Aitvarų;3157534923;Ne;8;0;0;8
9301;Smalsučiai;Aitvarų;4832292565;Ne;0;6;0;6
9302;Smalsučiai;Aitvarų;2835117069;Ne;8;0;0;8
9303;Smalsučiai;Aitvarų;2350539797;Ne;5;0;0;5
9304;Smalsučiai;Aitvarų;1126565862;Taip;9;0;0;9
9305;Smalsučiai;Aitvarų;1162035522;Ne;12;2;0;14
9306;Smalsučiai;Sraigiukų;7933302912;Ne;0;2;0;2
9307;Smalsučiai;Sraigiukų;1458544456;Taip;0;2;0;2
9308;Smalsučiai;Sraigiukų;5406430393;Ne;7;0;0;7
9309;Smalsučiai;Sraigiukų;9604182559;Taip;0;5;0;5
9310;Smalsučiai;Sraigiukų;4364810458;Ne;2;0;0;2
9311;Smalsučiai;Sraigiukų;4566816316;Ne;0;2;0;2
9312;Smalsučiai;Sraigiukų;5184903287;Ne;0;1;0;1
9313;Smalsučiai;Sraigiukų;4134975456;Ne;0;0;1;1
9314;Smalsučiai;Sraigiukų;7396172351;Ne;0;1;0;1
9315;Smalsučiai;Sraigiukų;6358800570;Ne;5;1;0;6
9316;Smalsučiai;Sraigiukų;2327930850;Ne;0;2;0;2
9317;Smalsučiai;Sraigiukų;3787937467;Ne;0;5;0;5
9318;Smalsučiai;Sraigiukų;4824786207;Taip;0;4;0;4
9319;Smalsučiai;Sraigiukų;3399798448;Ne;1;0;0;1
9320;Smalsučiai;Sraigiukų;1997966082;Ne;3;0;0;3
9321;Smalsučiai;Sraigiukų;8193410963;Taip;0;1;0;1
9322;Smalsučiai;Saulučių;1776385691;Ne;0;0;1;1
9323;Smalsučiai;Saulučių;2259361924;Ne;5;0;1;6
9324;Smalsučiai;Saulučių;1162964613;Taip;2;0;3;5
9325;Smalsučiai;Saulučių;9934952886;Ne;3;1;0;4
9326;Smalsučiai;Saulučių;9743116843;Ne;0;0;1;1
9327;Smalsučiai;Saulučių;2392217952;Taip;0;0;1;1
9328;Smalsučiai;Saulučių;1447512509;Ne;16;0;1;17
9329;Smalsučiai;Saulučių;7423419934;Ne;0;0;1;1
9330;Smalsučiai;Saulučių;7049101015;Ne;6;0;0;6
9331;Smalsučiai;Saulučių;9183519167;Ne;10;0;1;11
9332;Smalsučiai;Saulučių;8630411244;Ne;4;0;0;4
9333;Smalsučiai;Saulučių;6927421427;Ne;18;0;0;18
9334;Smalsučiai;Saulučių;7874635165;Taip;0;0;1;1
9335;Smalsučiai;Saulučių;5536697307;Ne;0;0;20;20
9336;Smalsučiai;Viščiukų;4760366724;Ne;2;2;0;4
9337;Smalsučiai;Viščiukų;2045283348;Ne;1;0;0;1
9338;Smalsučiai;Viščiukų;9710944054;Ne;2;0;0;2
9339;Smalsučiai;Viščiukų;5213319192;Taip;6;1;0;7
9340;Smalsučiai;Viščiukų;8210141253;Ne;10;0;0;10
9341;Smalsučiai;Viščiukų;3782502443;Ne;0;2;0;2
9342;Smalsučiai;Viščiukų;6358968221;Ne;3;0;0;3
9343;Smalsučiai;Viščiukų;4075656060;Taip;0;1;0;1
9344;Smalsučiai;Viščiukų;4030955447;Ne;3;0;0;3
9345;Smalsučiai;Viščiukų;6131743288;Ne;0;4;0;4
9346;Smalsučiai;Viščiukų;9984878984;Ne;0;2;0;2
9347;Smalsučiai;Viščiukų;8724759192;Ne;1;0;0;1
9348;Smalsučiai;Viščiukų;2662588310;Ne;0;1;0;1
9349;Smalsučiai;Viščiukų;7318218997;Taip;5;0;0;5
9350;Smalsučiai;Viščiukų;2668720481;Ne;1;1;0;2
9351;Smalsučiai;Viščiukų;2369569130;Ne;4;0;0;4
9352;Smalsučiai;Boružėlių;8606216911;Ne;0;0;1;1
9353;Smalsučiai;Boružėlių;1023255628;Taip;10;0;0;10
9354;Smalsučiai;Boružėlių;9181601713;Taip;0;2;0;2
9355;Smalsučiai;Boružėlių;6642882883;Ne;10;0;0;10
9356;Smalsučiai;Boružėlių;7637630200;Ne;0;1;1;2
9357;Smalsučiai;Boružėlių;1247774684;Ne;6;0;0;6
9358;Smalsučiai;Boružėlių;1224857159;Ne;0;2;1;3
9359;Smalsučiai;Boružėlių;4457317471;Taip;7;0;0;7
9360;Smalsučiai;Boružėlių;8893480054;Taip;4;0;0;4
9361;Smalsučiai;Boružėlių;3646740184;Ne;2;1;0;3
9362;Smalsučiai;Boružėlių;9378696084;Ne;13;0;0;13
9363;Smalsučiai;Boružėlių;7267389695;Ne;3;0;0;3
9364;Smalsučiai;Boružėlių;1344461213;Ne;0;0;5;5
9365;Smalsučiai;Boružėlių;4847212069;Ne;8;0;1;9
9366;Smalsučiai;Boružėlių;8690626891;Ne;0;0;5;5
9367;Smalsučiai;Zuikių;8128348060;Ne;10;0;0;10
9368;Smalsučiai;Zuikių;3757955200;Ne;3;0;0;3
9369;Smalsučiai;Zuikių;4847584492;Ne;8;0;0;8
9370;Smalsučiai;Zuikių;4379645417;Ne;0;3;0;3
9371;Smalsučiai;Zuikių;9732075162;Ne;0;0;2;2
9372;Smalsučiai;Zuikių;6090391818;Ne;6;0;0;6
9373;Smalsučiai;Zuikių;5098291946;Ne;0;0;20;20
9374;Smalsučiai;Zuikių;7137550663;Ne;0;0;1;1
9375;Smalsučiai;Zuikių;8578693978;Ne;0;4;0;4
9376;Smalsučiai;Zuikių;7713078413;Ne;0;6;0;6
9377;Smalsučiai;Zuikių;3627324317;Ne;0;0;1;1
9378;Smalsučiai;Zuikių;4506058735;Ne;8;0;0;8
9379;Smalsučiai;Nykštukų;3254574278;Ne;0;2;0;2
9380;Smalsučiai;Nykštukų;6279850475;Ne;8;0;0;8
9381;Smalsučiai;Nykštukų;6589139999;Ne;0;0;1;1
9382;Smalsučiai;Nykštukų;8461139523;Ne;11;0;0;11
9383;Smalsučiai;Nykštukų;3162567266;Ne;10;0;0;10
9384;Smalsučiai;Nykštukų;8405943289;Ne;0;0;1;1
9385;Smalsučiai;Nykštukų;7231947961;Ne;5;0;0;5
9386;Smalsučiai;Nykštukų;5205336476;Ne;5;0;0;5
9387;Smalsučiai;Nykštukų;5537437823;Ne;0;2;0;2
9388;Smalsučiai;Nykštukų;7257857454;Taip;8;3;0;11
9389;Smalsučiai;Nykštukų;9299524862;Ne;17;0;0;17
9390;Smalsučiai;Nykštukų;6372742288;Ne;10;0;0;10
9391;Smalsučiai;Katinėlių;3636314894;Ne;16;0;0;16
9392;Smalsučiai;Katinėlių;8527953002;Ne;11;4;0;15
9393;Smalsučiai;Katinėlių;4306056807;Ne;0;15;0;15
9394;Smalsučiai;Katinėlių;7094624971;Ne;16;0;0;16
9395;Smalsučiai;Katinėlių;1956492436;Ne;0;17;0;17
9396;Smalsučiai;Katinėlių;2505732707;Ne;10;0;0;10
9397;Smalsučiai;Katinėlių;4517950062;Ne;7;0;1;8
9398;Smalsučiai;Katinėlių;7567134320;Ne;10;0;0;10
9399;Smalsučiai;Katinėlių;3325151724;Ne;13;0;0;13
9400;Smalsučiai;Katinėlių;5390381543;Ne;0;0;1;1
9401;Smalsučiai;Katinėlių;3104627678;Ne;11;0;0;11
9402;Smalsučiai;Katinėlių;4989144093;Ne;1;0;1;2
9403;Smalsučiai;Katinėlių;4275309820;Ne;3;6;0;9
9404;Smalsučiai;Katinėlių;9482651454;Taip;19;0;0;19
9405;Smalsučiai;Katinėlių;7123127278;Ne;3;0;1;4
9406;Smalsučiai;PELĖDŽIUKAI;9222858199;Ne;5;0;0;5
9407;Smalsučiai;PELĖDŽIUKAI;7400990599;Ne;9;0;0;9
9408;Smalsučiai;PELĖDŽIUKAI;8615110249;Ne;2;0;0;2
9409;Smalsučiai;PELĖDŽIUKAI;2673224420;Ne;0;0;2;2
9410;Smalsučiai;PELĖDŽIUKAI;9771532192;Ne;0;17;0;17
9411;Smalsučiai;PELĖDŽIUKAI;8402519872;Ne;4;0;0;4
9412;Smalsučiai;PELĖDŽIUKAI;1305808180;Ne;0;2;0;2
9413;Smalsučiai;PELĖDŽIUKAI;6393203986;Ne;0;3;0;3
9414;Smalsučiai;PELĖDŽIUKAI;8499612926;Ne;1;0;0;1
9415;Smalsučiai;PELĖDŽIUKAI;3625628040;Taip;4;0;1;5
9416;Smalsučiai;PELĖDŽIUKAI;6128134712;Ne;0;2;2;4
9417;Smalsučiai;PELĖDŽIUKAI;3045521655;Ne;5;0;0;5
9418;Smalsučiai;PELĖDŽIUKAI;5789420793;Ne;11;0;1;12
9419;Smalsučiai;PELĖDŽIUKAI;7973827402;Ne;0;0;4;4
9420;Smalsučiai;PELĖDŽIUKAI;5104153092;Ne;1;0;4;5
9421;Smalsučiai;Pingvinukai;2054305125;Ne;11;0;0;11
9422;Smalsučiai;Pingvinukai;7731862348;Ne;15;0;0;15
9423;Smalsučiai;Pingvinukai;7266585367;Taip;2;0;0;2
9424;Smalsučiai;Pingvinukai;4557510634;Ne;4;2;0;6
9425;Smalsučiai;Pingvinukai;3340929454;Ne;18;0;0;18
9426;Smalsučiai;Pingvinukai;1381962216;Ne;17;0;0;17
9427;Smalsučiai;Pingvinukai;7065180174;Taip;7;0;0;7
9428;Smalsučiai;Pingvinukai;8493312040;Ne;4;5;0;9
9429;Smalsučiai;Pingvinukai;6430983316;Ne;4;6;0;10
9430;Smalsučiai;Pingvinukai;6380199558;Ne;2;0;0;2
9431;Smalsučiai;Voverikų;4811022648;Ne;8;0;0;8
9432;Smalsučiai;Voverikų;4973651632;Ne;0;6;0;6
9433;Smalsučiai;Voverikų;3509573985;Ne;0;4;0;4
9434;Smalsučiai;Voverikų;1485450504;Ne;7;0;0;7
9435;Smalsučiai;Voverikų;3042578767;Ne;0;6;0;6
9436;Smalsučiai;Voverikų;2070248478;Ne;8;0;0;8
9437;Smalsučiai;Voverikų;7205498813;Taip;2;0;0;2
9438;Smalsučiai;Voverikų;2612579099;Ne;0;19;0;19
9439;Smalsučiai;Voverikų;1559069582;Ne;8;0;0;8
9440;Smalsučiai;Voverikų;2885279828;Ne;0;2;0;2
9441;Smalsučiai;Voverikų;5964344820;Ne;6;3;1;10
9442;Smalsučiai;Voverikų;4105866680;Taip;8;0;0;8
9443;Smalsučiai;Voverikų;4611852575;Ne;0;6;0;6
9444;Smalsučiai;Voverikų;7988779202;Taip;0;6;0;6
9445;Smalsučiai;Voverikų;2583712404;Ne;4;0;0;4
9446;Smalsučiai;Voverikų;6984861531;Ne;6;1;3;10
9447;Smalsučiai;Voverikų;4233687544;Ne;5;7;0;12
9448;Smalsučiai;Voverikų;5710530457;Ne;2;0;0;2
9449;Spragtukas;NYKŠTUKAI;4527798635;Ne;2;1;0;3
9450;Spragtukas;NYKŠTUKAI;8551195766;Ne;1;2;1;4
9451;Spragtukas;NYKŠTUKAI;8297700739;Ne;9;0;0;9
9452;Spragtukas;NYKŠTUKAI;9595221494;Ne;0;2;0;2
9453;Spragtukas;NYKŠTUKAI;1710184531;Ne;0;0;1;1
9454;Spragtukas;NYKŠTUKAI;2076126173;Ne;0;8;0;8
9455;Spragtukas;NYKŠTUKAI;3012345413;Ne;4;0;0;4
9456;Spragtukas;NYKŠTUKAI;8698492694;Ne;9;3;0;12
9457;Spragtukas;NYKŠTUKAI;1150002524;Ne;0;4;0;4
9458;Spragtukas;NYKŠTUKAI;8288793522;Ne;0;7;0;7
9459;Spragtukas;NYKŠTUKAI;6986034864;Ne;0;0;1;1
9460;Spragtukas;NYKŠTUKAI;9665371858;Ne;0;1;0;1
9461;Spragtukas;NYKŠTUKAI;9308064461;Ne;6;2;1;9
9462;Spragtukas;SAULUTĖ;3337355440;Taip;1;1;0;2
9463;Spragtukas;SAULUTĖ;4669257062;Ne;2;0;0;2
9464;Spragtukas;SAULUTĖ;3692960591;Ne;0;1;0;1
9465;Spragtukas;SAULUTĖ;4586034709;Taip;3;4;0;7
9466;Spragtukas;SAULUTĖ;3948232692;Ne;6;2;1;9
9467;Spragtukas;SAULUTĖ;9149954373;Ne;0;6;0;6
9468;Spragtukas;SAULUTĖ;7511680722;Ne;0;5;0;5
9469;Spragtukas;SAULUTĖ;8235791891;Ne;10;0;0;10
9470;Spragtukas;SAULUTĖ;2987638580;Ne;0;2;1;3
9471;Spragtukas;SAULUTĖ;5687853390;Taip;3;2;2;7
9472;Spragtukas;SAULUTĖ;6679886985;Ne;6;9;0;15
9473;Spragtukas;SAULUTĖ;2879077913;Ne;0;4;0;4
9474;Spragtukas;SAULUTĖ;1998148708;Taip;15;1;0;16
9475;Spragtukas;SAULUTĖ;8227086854;Ne;7;2;0;9
9476;Spragtukas;SAULUTĖ;5697451914;Ne;5;2;0;7
9477;Spragtukas;SAULUTĖ;3086399458;Ne;0;0;1;1
9478;Spragtukas;SAULUTĖ;2879614195;Taip;0;16;0;16
9479;Spragtukas;SAULUTĖ;4929866385;Taip;5;2;0;7
9480;Spragtukas;SAULUTĖ;8912031554;Taip;7;13;0;20
9481;Spragtukas;SPINDULĖLIAI;7515307409;Ne;1;0;0;1
9482;Spragtukas;SPINDULĖLIAI;4527531194;Ne;13;0;0;13
9483;Spragtukas;SPINDULĖLIAI;8083960192;Ne;0;2;0;2
9484;Spragtukas;SPINDULĖLIAI;6228634157;Ne;0;2;0;2
9485;Spragtukas;SPINDULĖLIAI;5902286196;Ne;10;0;0;10
9486;Spragtukas;SPINDULĖLIAI;5998318402;Ne;17;0;0;17
9487;Spragtukas;SPINDULĖLIAI;9074266444;Ne;16;0;0;16
9488;Spragtukas;SPINDULĖLIAI;6313941560;Ne;3;0;0;3
9489;Spragtukas;SPINDULĖLIAI;3323280861;Ne;8;0;0;8
9490;Spragtukas;SPINDULĖLIAI;8856554286;Ne;1;0;0;1
9491;Spragtukas;SPINDULĖLIAI;3367731738;Ne;5;5;0;10
9492;Spragtukas;GINTARĖLIAI;8339926929;Ne;0;1;0;1
9493;Spragtukas;GINTARĖLIAI;5724874569;Ne;0;4;0;4
9494;Spragtukas;GINTARĖLIAI;1430632638;Ne;10;3;0;13
9495;Spragtukas;GINTARĖLIAI;8625143071;Ne;8;0;0;8
9496;Spragtukas;GINTARĖLIAI;2255007161;Ne;11;1;0;12
9497;Spragtukas;GINTARĖLIAI;2316071393;Ne;1;2;0;3
9498;Spragtukas;GINTARĖLIAI;8698469979;Ne;0;2;0;2
9499;Spragtukas;GINTARĖLIAI;1747417905;Ne;3;3;0;6
9500;Spragtukas;GINTARĖLIAI;6388163866;Ne;11;4;0;15
9501;Spragtukas;GINTARĖLIAI;8191270443;Ne;11;0;0;11
9502;Spragtukas;GINTARĖLIAI;7806145224;Ne;0;1;0;1
9503;Spragtukas;GINTARĖLIAI;2992201984;Ne;6;0;0;6
9504;Spragtukas;GINTARĖLIAI;2217627240;Taip;0;3;0;3
9505;Spragtukas;GINTARĖLIAI;1150727381;Ne;7;2;0;9
9506;Spragtukas;GINTARĖLIAI;2706473182;Ne;5;1;0;6
9507;Spragtukas;ČIPOLINO;9951226210;Ne;0;2;0;2
9508;Spragtukas;ČIPOLINO;8473814776;Ne;7;0;0;7
9509;Spragtukas;ČIPOLINO;4461217748;Ne;0;10;0;10
9510;Spragtukas;ČIPOLINO;2087416420;Ne;4;0;0;4
9511;Spragtukas;ČIPOLINO;9579825533;Ne;6;1;0;7
9512;Spragtukas;ČIPOLINO;9443091032;Ne;2;12;0;14
9513;Spragtukas;ČIPOLINO;7412489884;Ne;14;0;0;14
9514;Spragtukas;ČIPOLINO;9294770557;Ne;2;5;0;7
9515;Spragtukas;ČIPOLINO;8110631015;Ne;0;1;0;1
9516;Spragtukas;ČIPOLINO;2963449719;Ne;9;1;0;10
9517;Spragtukas;ČIPOLINO;8710910167;Ne;5;2;0;7
9518;Spragtukas;ČIPOLINO;7692148513;Ne;5;1;0;6
9519;Spragtukas;ČIPOLINO;2599579491;Ne;5;3;0;8
9520;Spragtukas;ČIPOLINO;7402797271;Ne;9;0;0;9
9521;Spragtukas;ČIPOLINO;8560471564;Ne;15;1;0;16
9522;Spragtukas;BORUŽĖLĖS;8614890958;Ne;0;5;0;5
9523;Spragtukas;BORUŽĖLĖS;2356476212;Ne;1;1;0;2
9524;Spragtukas;BORUŽĖLĖS;8287102733;Taip;0;3;0;3
9525;Spragtukas;BORUŽĖLĖS;6584145176;Ne;0;3;0;3
9526;Spragtukas;BORUŽĖLĖS;6824861247;Ne;0;2;0;2
9527;Spragtukas;BORUŽĖLĖS;7264683147;Ne;12;0;0;12
9528;Spragtukas;BORUŽĖLĖS;6547167325;Ne;4;0;0;4
9529;Spragtukas;BORUŽĖLĖS;7073092344;Ne;11;3;0;14
9530;Spragtukas;BORUŽĖLĖS;7042345781;Ne;3;1;0;4
9531;Spragtukas;BORUŽĖLĖS;1046613540;Ne;5;1;0;6
9532;Spragtukas;BORUŽĖLĖS;1180285187;Taip;12;1;0;13
9533;Spragtukas;BORUŽĖLĖS;2268649859;Ne;6;1;0;7
9534;Spragtukas;BORUŽĖLĖS;3110077272;Ne;0;1;0;1
9535;Spragtukas;BORUŽĖLĖS;3225684296;Ne;4;0;0;4
9536;Spragtukas;BORUŽĖLĖS;5940679759;Ne;17;0;0;17
9537;Spragtukas;DRUGELIAI;7058848570;Ne;11;0;0;11
9538;Spragtukas;DRUGELIAI;7271482702;Ne;0;2;0;2
9539;Spragtukas;DRUGELIAI;4441290823;Taip;5;0;1;6
9540;Spragtukas;DRUGELIAI;8307801987;Taip;10;0;0;10
9541;Spragtukas;DRUGELIAI;9310818975;Ne;0;0;1;1
9542;Spragtukas;DRUGELIAI;1493711333;Ne;2;0;0;2
9543;Spragtukas;DRUGELIAI;4742132709;Taip;4;3;0;7
9544;Spragtukas;DRUGELIAI;2026249018;Taip;0;4;0;4
9545;Spragtukas;DRUGELIAI;1487259291;Ne;13;0;0;13
9546;Spragtukas;DRUGELIAI;5225669850;Ne;0;1;0;1
9547;Spragtukas;DRUGELIAI;8109894184;Ne;5;0;0;5
9548;Spragtukas;DRUGELIAI;8396134652;Ne;8;0;3;11
9549;Spragtukas;DRUGELIAI;1784758799;Ne;7;0;0;7
9550;Spragtukas;GAIDELIAI;2541126095;Ne;0;5;0;5
9551;Spragtukas;GAIDELIAI;4097458544;Ne;2;0;0;2
9552;Spragtukas;GAIDELIAI;8957903306;Ne;7;2;0;9
9553;Spragtukas;GAIDELIAI;1326714513;Ne;7;1;0;8
9554;Spragtukas;GAIDELIAI;7108640957;Ne;1;0;0;1
9555;Spragtukas;GAIDELIAI;7911124524;Ne;3;0;0;3
9556;Spragtukas;GAIDELIAI;3216796441;Ne;2;0;0;2
9557;Spragtukas;GAIDELIAI;8440836721;Taip;6;0;0;6
9558;Spragtukas;GAIDELIAI;4535021524;Ne;0;2;0;2
9559;Spragtukas;GAIDELIAI;2679834328;Taip;5;0;0;5
9560;Spragtukas;GAIDELIAI;7912840514;Ne;6;2;0;8
9561;Spragtukas;GAIDELIAI;1748358240;Ne;0;2;0;2
9562;Spragtukas;ŽUVELĖS;9078163633;Ne;3;0;0;3
9563;Spragtukas;ŽUVELĖS;8762832644;Ne;0;1;0;1
9564;Spragtukas;ŽUVELĖS;8652973900;Ne;10;0;0;10
9565;Spragtukas;ŽUVELĖS;3261213140;Ne;0;8;0;8
9566;Spragtukas;ŽUVELĖS;5689392663;Ne;13;2;0;15
9567;Spragtukas;ŽUVELĖS;1272075883;Ne;0;2;0;2
9568;Spragtukas;ŽUVELĖS;6503842956;Ne;2;2;0;4
9569;Spragtukas;ŽUVELĖS;3139748724;Ne;13;1;0;14
9570;Spragtukas;ŽUVELĖS;8640877497;Taip;5;2;0;7
9571;Spragtukas;ŽUVELĖS;2025314314;Ne;2;0;0;2
9572;Spragtukas;ŽUVELĖS;4848647219;Taip;1;1;2;4
9573;Spragtukas;ŽUVELĖS;3491418162;Ne;2;1;0;3
9574;Spragtukas;ŽUVELĖS;5704941595;Ne;0;4;0;4
9575;Spragtukas;ŽUVELĖS;3286456855;Ne;1;0;0;1
9576;Spragtukas;ŽUVELĖS;9662188102;Ne;4;0;0;4
9577;Spragtukas;ŽUVELĖS;2539660577;Ne;0;2;0;2
9578;Spragtukas;ŽUVELĖS;6757604305;Ne;0;0;1;1
9579;Spragtukas;ŽUVELĖS;1627243902;Ne;3;0;0;3
9580;Spragtukas;RIEŠUTĖLIAI;8684246143;Ne;1;0;0;1
9581;Spragtukas;RIEŠUTĖLIAI;1977526177;Ne;0;5;0;5
9582;Spragtukas;RIEŠUTĖLIAI;7615522850;Taip;10;0;0;10
9583;Spragtukas;RIEŠUTĖLIAI;9204569123;Ne;0;1;0;1
9584;Spragtukas;RIEŠUTĖLIAI;1992850470;Taip;4;0;0;4
9585;Spragtukas;RIEŠUTĖLIAI;6158327941;Ne;8;2;0;10
9586;Spragtukas;RIEŠUTĖLIAI;4134127256;Ne;6;0;0;6
9587;Spragtukas;RIEŠUTĖLIAI;3009567338;Ne;3;0;0;3
9588;Spragtukas;RIEŠUTĖLIAI;2648358901;Ne;3;4;0;7
9589;Spragtukas;RIEŠUTĖLIAI;3822599790;Ne;0;11;0;11
9590;Spragtukas;RIEŠUTĖLIAI;7767940027;Ne;2;1;0;3
9591;Spragtukas;RIEŠUTĖLIAI;4625065223;Ne;2;0;0;2
9592;Spragtukas;RIEŠUTĖLIAI;6963190259;Ne;0;12;0;12
9593;Spragtukas;RIEŠUTĖLIAI;8732886749;Ne;3;0;0;3
9594;Spragtukas;RIEŠUTĖLIAI;1946493379;Ne;12;0;0;12
9595;Spragtukas;RIEŠUTĖLIAI;9975308171;Taip;7;0;0;7
9596;Spragtukas;VIŠČIUKAI;8291401010;Ne;20;0;0;20
9597;Spragtukas;VIŠČIUKAI;6219915771;Ne;15;0;0;15
9598;Spragtukas;VIŠČIUKAI;5497023448;Ne;0;1;0;1
9599;Spragtukas;VIŠČIUKAI;2359209112;Ne;2;0;2;4
9600;Spragtukas;VIŠČIUKAI;8371817233;Ne;11;6;0;17
9601;Spragtukas;VIŠČIUKAI;4489637427;Ne;13;0;0;13
9602;Spragtukas;VIŠČIUKAI;6804843816;Taip;10;0;0;10
9603;Spragtukas;VIŠČIUKAI;7883446348;Ne;11;0;0;11
9604;Spragtukas;VIŠČIUKAI;9617355214;Ne;10;0;0;10
9605;Spragtukas;VIŠČIUKAI;1878079499;Ne;6;0;0;6
9606;Spragtukas;VIŠČIUKAI;9198638303;Ne;4;0;0;4
9607;Spragtukas;VIŠČIUKAI;1572602399;Ne;4;0;0;4
9608;Spragtukas;MEŠKIUKAI;6477635199;Ne;10;0;0;10
9609;Spragtukas;MEŠKIUKAI;7730786172;Ne;5;0;0;5
9610;Spragtukas;MEŠKIUKAI;2422384041;Ne;6;0;0;6
9611;Spragtukas;MEŠKIUKAI;1411972930;Ne;8;0;0;8
9612;Spragtukas;MEŠKIUKAI;9313536781;Taip;5;0;0;5
9613;Spragtukas;MEŠKIUKAI;9616402367;Ne;3;0;0;3
9614;Spragtukas;MEŠKIUKAI;1869458751;Ne;6;1;0;7
9615;Spragtukas;MEŠKIUKAI;4332445650;Ne;3;0;1;4
9616;Spragtukas;MEŠKIUKAI;4900860607;Ne;7;0;0;7
9617;Spragtukas;MEŠKIUKAI;6073139322;Ne;6;0;0;6
9618;Strazdelis;Žiogelių;5346485534;Ne;1;0;0;1
9619;Strazdelis;Žiogelių;9933042249;Ne;0;10;0;10
9620;Strazdelis;Žiogelių;8581533423;Ne;5;0;0;5
9621;Strazdelis;Žiogelių;8209625399;Ne;10;2;0;12
9622;Strazdelis;Žiogelių;1141752802;Ne;11;0;0;11
9623;Strazdelis;Žiogelių;3596394112;Taip;5;1;0;6
9624;Strazdelis;Žiogelių;4563247013;Ne;15;0;0;15
9625;Strazdelis;Žiogelių;6437928004;Ne;0;7;0;7
9626;Strazdelis;Žiogelių;8971395173;Ne;5;0;0;5
9627;Strazdelis;Žiogelių;4955907851;Ne;4;0;0;4
9628;Strazdelis;Žiogelių;7425818775;Ne;3;1;0;4
9629;Strazdelis;Žiogelių;9567476872;Ne;4;1;0;5
9630;Strazdelis;Žiogelių;3028208428;Ne;4;0;0;4
9631;Strazdelis;Žiogelių;2753635198;Taip;4;2;1;7
9632;Strazdelis;Žiogelių;6651360492;Ne;6;4;0;10
9633;Strazdelis;Žiogelių;7913526787;Ne;1;0;0;1
9634;Strazdelis;Žiogelių;5742215922;Ne;2;0;0;2
9635;Strazdelis;Šeimynėlės;6570504154;Ne;0;1;0;1
9636;Strazdelis;Šeimynėlės;3848288765;Ne;3;1;0;4
9637;Strazdelis;Šeimynėlės;5033799225;Ne;0;1;0;1
9638;Strazdelis;Šeimynėlės;1683900907;Ne;1;0;0;1
9639;Strazdelis;Šeimynėlės;2990771887;Ne;0;5;0;5
9640;Strazdelis;Šeimynėlės;2185364583;Ne;3;1;0;4
9641;Strazdelis;Šeimynėlės;7905687363;Ne;3;2;0;5
9642;Strazdelis;Šeimynėlės;4501391298;Ne;0;7;0;7
9643;Strazdelis;Šeimynėlės;1012692326;Ne;7;1;0;8
9644;Strazdelis;Šeimynėlės;8899530711;Ne;7;1;0;8
9645;Strazdelis;Šeimynėlės;5784406335;Ne;0;2;0;2
9646;Strazdelis;Šeimynėlės;5296218650;Ne;2;0;0;2
9647;Strazdelis;Šeimynėlės;9806107189;Ne;8;1;0;9
9648;Strazdelis;Šeimynėlės;8295035233;Ne;0;7;0;7
9649;Strazdelis;Genelio;3084249678;Ne;0;4;0;4
9650;Strazdelis;Genelio;5499310072;Ne;0;1;0;1
9651;Strazdelis;Genelio;8333151969;Ne;0;5;0;5
9652;Strazdelis;Genelio;7083940713;Ne;0;6;0;6
9653;Strazdelis;Genelio;6480803618;Ne;3;0;2;5
9654;Strazdelis;Genelio;9490861272;Ne;0;5;0;5
9655;Strazdelis;Genelio;6071502600;Ne;9;1;0;10
9656;Strazdelis;Genelio;3713797440;Ne;9;1;0;10
9657;Strazdelis;Genelio;2459718449;Ne;3;2;0;5
9658;Strazdelis;Genelio;8956634754;Ne;4;1;0;5
9659;Strazdelis;Genelio;8762859576;Ne;0;0;1;1
9660;Strazdelis;Genelio;2306665561;Ne;0;3;0;3
9661;Strazdelis;Vikruolių;8287554571;Ne;3;2;0;5
9662;Strazdelis;Vikruolių;8637386316;Ne;0;1;0;1
9663;Strazdelis;Vikruolių;5892430004;Taip;0;5;0;5
9664;Strazdelis;Vikruolių;4617237063;Ne;5;1;0;6
9665;Strazdelis;Vikruolių;3036380561;Ne;0;2;1;3
9666;Strazdelis;Vikruolių;8371999002;Ne;5;1;0;6
9667;Strazdelis;Vikruolių;4562530311;Ne;6;0;4;10
9668;Strazdelis;Vikruolių;4004930488;Ne;6;0;0;6
9669;Strazdelis;Vikruolių;5768674837;Ne;2;0;2;4
9670;Strazdelis;Vikruolių;6046139859;Ne;2;0;0;2
9671;Strazdelis;Vikruolių;7349106795;Ne;5;0;1;6
9672;Strazdelis;Vikruolių;7876385010;Ne;1;1;0;2
9673;Strazdelis;Vikruolių;8854150040;Ne;1;0;0;1
9674;Strazdelis;Vyturėlių;7471890377;Ne;2;0;0;2
9675;Strazdelis;Vyturėlių;2848984531;Ne;0;5;0;5
9676;Strazdelis;Vyturėlių;4159072583;Ne;4;0;0;4
9677;Strazdelis;Vyturėlių;2662549392;Ne;0;6;0;6
9678;Strazdelis;Vyturėlių;7469848482;Ne;1;0;0;1
9679;Strazdelis;Vyturėlių;2251157025;Ne;6;0;0;6
9680;Strazdelis;Vyturėlių;1841285441;Taip;0;1;0;1
9681;Strazdelis;Vyturėlių;5904388732;Ne;0;13;0;13
9682;Strazdelis;Vyturėlių;3460993302;Ne;1;3;0;4
9683;Strazdelis;Vyturėlių;7393083827;Ne;3;0;0;3
9684;Strazdelis;Vyturėlių;6555803164;Ne;0;5;0;5
9685;Strazdelis;Vyturėlių;1955166372;Ne;5;0;0;5
9686;Strazdelis;Vyturėlių;4873707286;Ne;1;1;0;2
9687;Strazdelis;Vyturėlių;6527855940;Taip;0;2;0;2
9688;Strazdelis;Vyturėlių;2824416350;Ne;0;1;0;1
9689;Strazdelis;Vyturėlių;3610250359;Ne;0;2;0;2
9690;Strazdelis;Vyturėlių;1173067724;Ne;1;6;0;7
9691;Strazdelis;Varpelio;9502341478;Ne;0;11;0;11
9692;Strazdelis;Varpelio;5924324241;Ne;9;0;0;9
9693;Strazdelis;Varpelio;6954336739;Ne;6;5;0;11
9694;Strazdelis;Varpelio;3456287323;Taip;2;2;0;4
9695;Strazdelis;Varpelio;2990465012;Ne;3;0;0;3
9696;Strazdelis;Varpelio;2438598773;Ne;15;0;0;15
9697;Strazdelis;Varpelio;5425585036;Ne;1;0;0;1
9698;Strazdelis;Varpelio;5314676261;Ne;6;0;0;6
9699;Strazdelis;Varpelio;5683969627;Ne;5;1;0;6
9700;Strazdelis;Varpelio;2398220397;Ne;4;0;0;4
9701;Strazdelis;Varpelio;1787432390;Ne;11;0;0;11
9702;Strazdelis;Varpelio;3106135598;Ne;0;1;0;1
9703;Strazdelis;Varpelio;1455467186;Ne;0;2;0;2
9704;Strazdelis;Varpelio;9955443967;Ne;1;1;0;2
9705;Strazdelis;Varpelio;6522639028;Ne;0;1;0;1
9706;Strazdelis;Pelėdžiukų;7087235151;Ne;10;1;0;11
9707;Strazdelis;Pelėdžiukų;4461728361;Ne;10;0;0;10
9708;Strazdelis;Pelėdžiukų;1770338988;Ne;9;0;0;9
9709;Strazdelis;Pelėdžiukų;3030445367;Ne;7;0;0;7
9710;Strazdelis;Pelėdžiukų;4966668662;Ne;3;1;0;4
9711;Strazdelis;Pelėdžiukų;8484672456;Ne;5;0;0;5
9712;Strazdelis;Pelėdžiukų;6457478289;Ne;5;0;0;5
9713;Strazdelis;Pelėdžiukų;8953577585;Ne;4;2;0;6
9714;Strazdelis;Pelėdžiukų;3426039979;Ne;15;1;0;16
9715;Strazdelis;Pelėdžiukų;4715198107;Ne;2;0;0;2
9716;Strazdelis;Pelėdžiukų;8677659019;Ne;5;1;0;6
9717;Strazdelis;Pelėdžiukų;7716476995;Ne;5;0;0;5
9718;Strazdelis;Pelėdžiukų;8356680705;Ne;5;1;0;6
9719;Strazdelis;Pelėdžiukų;4174940099;Ne;5;1;0;6
9720;Strazdelis;Pelėdžiukų;8554043784;Taip;0;13;0;13
9721;Strazdelis;Pelėdžiukų;1952086370;Taip;7;0;0;7
9722;Strazdelis;Pelėdžiukų;7802337169;Ne;7;0;0;7
9723;Strazdelis;Saulutės;5604313206;Ne;0;1;0;1
9724;Strazdelis;Saulutės;8877104963;Ne;20;0;0;20
9725;Strazdelis;Saulutės;4726043862;Ne;0;1;0;1
9726;Strazdelis;Saulutės;8686828982;Taip;0;2;0;2
9727;Strazdelis;Saulutės;1228651165;Ne;5;0;0;5
9728;Strazdelis;Saulutės;7768700192;Ne;0;1;0;1
9729;Strazdelis;Saulutės;2589303722;Ne;0;3;0;3
9730;Strazdelis;Saulutės;5232064496;Ne;3;2;0;5
9731;Strazdelis;Saulutės;2081538505;Ne;7;3;0;10
9732;Strazdelis;Saulutės;9776075027;Ne;2;0;0;2
9733;Strazdelis;Saulutės;1021364759;Ne;3;0;0;3
9734;Strazdelis;Saulutės;2061515101;Taip;5;0;0;5
9735;Strazdelis;Bitutės;8485509145;Ne;0;1;0;1
9736;Strazdelis;Bitutės;6508933324;Ne;0;1;0;1
9737;Strazdelis;Bitutės;8753316532;Ne;0;6;0;6
9738;Strazdelis;Bitutės;9435593972;Ne;10;1;0;11
9739;Strazdelis;Bitutės;9555240419;Ne;1;1;0;2
9740;Strazdelis;Bitutės;3043580835;Ne;3;2;0;5
9741;Strazdelis;Bitutės;1539984888;Ne;0;2;0;2
9742;Strazdelis;Bitutės;4400849922;Ne;3;2;0;5
9743;Strazdelis;Bitutės;7890064837;Ne;10;0;0;10
9744;Strazdelis;Bitutės;1881071425;Taip;1;0;0;1
9745;Strazdelis;Bitutės;2908567982;Ne;8;0;0;8
9746;Strazdelis;Bitutės;9548465554;Ne;0;1;0;1
9747;Strazdelis;Bitutės;4369569609;Ne;0;8;0;8
9748;Strazdelis;Bitutės;8277333786;Ne;0;4;0;4
9749;Strazdelis;Mažylių;5256750516;Ne;0;4;0;4
9750;Strazdelis;Mažylių;4965049621;Ne;5;1;0;6
9751;Strazdelis;Mažylių;9383398775;Ne;0;1;0;1
9752;Strazdelis;Mažylių;2378910473;Ne;9;4;0;13
9753;Strazdelis;Mažylių;4699373769;Ne;2;0;0;2
9754;Strazdelis;Mažylių;3648883435;Ne;11;1;0;12
9755;Strazdelis;Mažylių;7039347901;Ne;0;0;1;1
9756;Strazdelis;Mažylių;4904388387;Ne;5;0;0;5
9757;Strazdelis;Mažylių;3082900425;Ne;1;2;0;3
9758;Strazdelis;Mažylių;1265557971;Ne;0;2;0;2
9759;Strazdelis;Mažylių;3900225484;Ne;2;0;0;2
9760;Strazdelis;Mažylių;8734458997;Ne;3;0;2;5
9761;Strazdelis;Mažylių;3561551193;Ne;0;1;0;1
9762;Strazdelis;Mažylių;2871841427;Ne;5;4;0;9
9763;Strazdelis;Pabiručių;1823053560;Ne;13;0;0;13
9764;Strazdelis;Pabiručių;4740153387;Ne;0;1;0;1
9765;Strazdelis;Pabiručių;5326864534;Ne;4;1;0;5
9766;Strazdelis;Pabiručių;9870463329;Ne;0;0;2;2
9767;Strazdelis;Pabiručių;3124550569;Ne;0;1;0;1
9768;Strazdelis;Pabiručių;4356218766;Ne;0;1;0;1
9769;Strazdelis;Žvirbliukai;4435530603;Taip;2;0;0;2
9770;Strazdelis;Smalsučiai;2353001006;Ne;2;0;0;2
9771;Strazdelis;Zuikučiai;5709610161;Ne;0;2;0;2
9772;Strazdelis;Gandriukai;5327428351;Ne;1;0;0;1
9773;Šermukšnėlė;MOLINUKAI;9746313951;Ne;4;0;0;4
9774;Šermukšnėlė;MOLINUKAI;4638109666;Taip;5;0;2;7
9775;Šermukšnėlė;MOLINUKAI;2714018690;Ne;10;0;0;10
9776;Šermukšnėlė;MOLINUKAI;5262882873;Ne;8;0;0;8
9777;Šermukšnėlė;MOLINUKAI;2985284699;Ne;0;1;0;1
9778;Šermukšnėlė;MOLINUKAI;4983510683;Ne;0;1;0;1
9779;Šermukšnėlė;MOLINUKAI;7385114026;Ne;11;0;0;11
9780;Šermukšnėlė;MOLINUKAI;2784732759;Taip;0;0;2;2
9781;Šermukšnėlė;MOLINUKAI;3342919832;Ne;3;0;0;3
9782;Šermukšnėlė;MOLINUKAI;9337047371;Ne;10;0;0;10
9783;Šermukšnėlė;MOLINUKAI;2098090763;Ne;0;1;0;1
9784;Šermukšnėlė;MOLINUKAI;5835100042;Taip;0;0;2;2
9785;Šermukšnėlė;MOLINUKAI;8000479161;Ne;3;0;0;3
9786;Šermukšnėlė;MOLINUKAI;4952285322;Ne;0;1;0;1
9787;Šermukšnėlė;MOLINUKAI;6608458145;Ne;0;6;0;6
9788;Šermukšnėlė;MOLINUKAI;8104182167;Ne;3;0;1;4
9789;Šermukšnėlė;MOLINUKAI;6988120570;Ne;0;9;0;9
9790;Šermukšnėlė;MOLINUKAI;8728441474;Ne;10;0;0;10
9791;Šermukšnėlė;MOLINUKAI;4075151928;Ne;0;0;2;2
9792;Šermukšnėlė;MOLINUKAI;9527382390;Ne;0;0;2;2
9793;Šermukšnėlė;MOLINUKAI;4968522498;Ne;0;4;0;4
9794;Šermukšnėlė;ŠIAUDINUKAI;7002917737;Ne;1;0;0;1
9795;Šermukšnėlė;ŠIAUDINUKAI;3637882900;Ne;0;9;0;9
9796;Šermukšnėlė;ŠIAUDINUKAI;1159472154;Ne;0;0;2;2
9797;Šermukšnėlė;ŠIAUDINUKAI;4956414941;Ne;3;4;0;7
9798;Šermukšnėlė;ŠIAUDINUKAI;3499394539;Ne;0;5;1;6
9799;Šermukšnėlė;ŠIAUDINUKAI;1157979179;Ne;0;5;0;5
9800;Šermukšnėlė;ŠIAUDINUKAI;3082272196;Taip;4;0;3;7
9801;Šermukšnėlė;ŠIAUDINUKAI;9012757607;Ne;1;0;0;1
9802;Šermukšnėlė;ŠIAUDINUKAI;5627334876;Ne;4;0;1;5
9803;Šermukšnėlė;ŠIAUDINUKAI;3550736579;Ne;11;0;0;11
9804;Šermukšnėlė;ŠIAUDINUKAI;5993599994;Taip;6;0;2;8
9805;Šermukšnėlė;ŠIAUDINUKAI;3522028983;Ne;0;8;2;10
9806;Šermukšnėlė;ŠIAUDINUKAI;6077798297;Ne;0;0;1;1
9807;Šermukšnėlė;ŠIAUDINUKAI;2351386211;Ne;0;0;4;4
9808;Šermukšnėlė;TOŠINUKAI;3994316729;Ne;1;0;0;1
9809;Šermukšnėlė;TOŠINUKAI;7229632099;Ne;5;0;0;5
9810;Šermukšnėlė;TOŠINUKAI;7038705221;Ne;0;1;0;1
9811;Šermukšnėlė;TOŠINUKAI;9035625467;Taip;7;0;0;7
9812;Šermukšnėlė;TOŠINUKAI;9442514813;Ne;2;0;0;2
9813;Šermukšnėlė;TOŠINUKAI;9585435700;Taip;7;0;1;8
9814;Šermukšnėlė;TOŠINUKAI;1131780941;Taip;2;0;0;2
9815;Šermukšnėlė;TOŠINUKAI;6286039101;Ne;6;0;0;6
9816;Šermukšnėlė;TOŠINUKAI;9584702487;Ne;2;0;0;2
9817;Šermukšnėlė;TOŠINUKAI;8691777167;Ne;2;0;0;2
9818;Šermukšnėlė;TOŠINUKAI;2534758615;Ne;3;1;0;4
9819;Šermukšnėlė;TOŠINUKAI;1622834854;Ne;5;0;0;5
9820;Šermukšnėlė;TOŠINUKAI;4945395564;Ne;5;0;1;6
9821;Šermukšnėlė;TOŠINUKAI;2163955454;Ne;7;0;0;7
9822;Šermukšnėlė;TOŠINUKAI;7106405983;Ne;11;0;0;11
9823;Šermukšnėlė;ODINUKAI;4422415026;Taip;8;0;0;8
9824;Šermukšnėlė;ODINUKAI;5545018656;Ne;4;3;0;7
9825;Šermukšnėlė;ODINUKAI;5733540837;Ne;0;0;2;2
9826;Šermukšnėlė;ODINUKAI;7262199284;Ne;0;2;0;2
9827;Šermukšnėlė;ODINUKAI;5159461963;Ne;0;0;2;2
9828;Šermukšnėlė;ODINUKAI;5354978646;Ne;0;0;5;5
9829;Šermukšnėlė;ODINUKAI;1882432812;Ne;0;0;3;3
9830;Šermukšnėlė;ODINUKAI;3949629658;Ne;0;1;0;1
9831;Šermukšnėlė;ODINUKAI;7667114310;Ne;7;0;0;7
9832;Šermukšnėlė;ODINUKAI;5397385093;Ne;0;0;2;2
9833;Šermukšnėlė;ODINUKAI;4331948700;Ne;0;4;0;4
9834;Šermukšnėlė;ODINUKAI;6718242890;Ne;4;0;0;4
9835;Šermukšnėlė;ODINUKAI;9664249364;Taip;0;0;2;2
9836;Šermukšnėlė;ODINUKAI;1064222922;Ne;21;0;0;21
9837;Šermukšnėlė;ODINUKAI;7770630580;Ne;5;0;1;6
9838;Šermukšnėlė;ODINUKAI;6194188831;Ne;0;0;1;1
9839;Šermukšnėlė;KRIAUKLELĖS;4256630681;Ne;0;0;1;1
9840;Šermukšnėlė;KRIAUKLELĖS;8117261716;Ne;11;0;0;11
9841;Šermukšnėlė;KRIAUKLELĖS;6342714998;Ne;4;0;0;4
9842;Šermukšnėlė;KRIAUKLELĖS;9074111563;Taip;0;1;0;1
9843;Šermukšnėlė;KRIAUKLELĖS;9783673534;Ne;1;0;0;1
9844;Šermukšnėlė;KRIAUKLELĖS;5408843906;Ne;8;1;0;9
9845;Šermukšnėlė;KRIAUKLELĖS;4810571143;Taip;14;0;0;14
9846;Šermukšnėlė;KRIAUKLELĖS;4219655802;Ne;10;0;0;10
9847;Šermukšnėlė;KRIAUKLELĖS;6797936390;Ne;8;1;0;9
9848;Šermukšnėlė;KRIAUKLELĖS;6286235756;Ne;4;11;0;15
9849;Šermukšnėlė;KRIAUKLELĖS;9246072554;Ne;9;1;0;10
9850;Šermukšnėlė;KRIAUKLELĖS;9080074486;Ne;2;1;1;4
9851;Šermukšnėlė;KRIAUKLELĖS;5456669766;Ne;0;1;0;1
9852;Šermukšnėlė;KRIAUKLELĖS;7098953763;Ne;7;2;0;9
9853;Šermukšnėlė;VYTINUKAI;2235123503;Ne;12;0;0;12
9854;Šermukšnėlė;VYTINUKAI;6928863055;Ne;0;0;1;1
9855;Šermukšnėlė;VYTINUKAI;8558117857;Taip;14;0;0;14
9856;Šermukšnėlė;VYTINUKAI;6531113007;Ne;0;1;0;1
9857;Šermukšnėlė;VYTINUKAI;8437052600;Ne;9;0;0;9
9858;Šermukšnėlė;VYTINUKAI;1318170904;Taip;1;0;1;2
9859;Šermukšnėlė;VYTINUKAI;8200175951;Ne;14;1;0;15
9860;Šermukšnėlė;VYTINUKAI;6149973884;Taip;18;0;0;18
9861;Šermukšnėlė;VYTINUKAI;5874725607;Ne;14;0;0;14
9862;Šermukšnėlė;VYTINUKAI;7532979465;Taip;22;0;0;22
9863;Šermukšnėlė;VYTINUKAI;7834844175;Ne;3;0;0;3
9864;Šermukšnėlė;VYTINUKAI;7211488009;Ne;3;0;1;4
9865;Šermukšnėlė;VYTINUKAI;7546040491;Ne;19;0;0;19
9866;Šermukšnėlė;VYTINUKAI;2698741674;Ne;0;2;0;2
9867;Šermukšnėlė;VYTINUKAI;3359398381;Ne;2;0;0;2
9868;Šermukšnėlė;VYTINUKAI;9872479998;Ne;10;5;0;15
9869;Šermukšnėlė;VYTINUKAI;1312471779;Taip;7;0;0;7
9870;Šermukšnėlė;VYTINUKAI;8632561799;Ne;2;0;0;2
9871;Šermukšnėlė;GINTARĖLIAI;8249749948;Ne;6;0;2;8
9872;Šermukšnėlė;GINTARĖLIAI;2989011150;Ne;0;1;1;2
9873;Šermukšnėlė;GINTARĖLIAI;3747531232;Ne;4;1;0;5
9874;Šermukšnėlė;GINTARĖLIAI;4176986876;Ne;0;8;0;8
9875;Šermukšnėlė;GINTARĖLIAI;7036078780;Taip;10;0;0;10
9876;Šermukšnėlė;GINTARĖLIAI;1994737857;Ne;0;5;0;5
9877;Šermukšnėlė;GINTARĖLIAI;4619811264;Ne;0;4;0;4
9878;Šermukšnėlė;GINTARĖLIAI;5886893562;Ne;17;0;0;17
9879;Šermukšnėlė;GINTARĖLIAI;4783726095;Ne;5;2;0;7
9880;Šermukšnėlė;GINTARĖLIAI;5172187141;Ne;0;4;0;4
9881;Šermukšnėlė;GINTARĖLIAI;3688946505;Ne;10;0;0;10
9882;Šermukšnėlė;GINTARĖLIAI;1636944853;Ne;0;12;0;12
9883;Šermukšnėlė;GINTARĖLIAI;7053319091;Taip;6;0;1;7
9884;Šermukšnėlė;GINTARĖLIAI;6351841889;Taip;6;0;2;8
9885;Šermukšnėlė;GINTARĖLIAI;7305013368;Ne;0;4;0;4
9886;Šermukšnėlė;GINTARĖLIAI;6698650179;Ne;0;0;1;1
9887;Šermukšnėlė;GINTARĖLIAI;8639470631;Ne;0;0;2;2
9888;Šermukšnėlė;GINTARĖLIAI;8541743148;Ne;5;10;0;15
9889;Šermukšnėlė;AKMENUKAI;8407947566;Ne;0;0;1;1
9890;Šermukšnėlė;AKMENUKAI;8669676262;Ne;0;4;0;4
9891;Šermukšnėlė;AKMENUKAI;3148857617;Ne;0;9;0;9
9892;Šermukšnėlė;AKMENUKAI;4965640386;Ne;0;0;3;3
9893;Šermukšnėlė;AKMENUKAI;3639954786;Ne;9;0;11;20
9894;Šermukšnėlė;AKMENUKAI;7843128263;Ne;4;1;0;5
9895;Šermukšnėlė;AKMENUKAI;9805841777;Ne;0;3;0;3
9896;Šermukšnėlė;AKMENUKAI;3945291560;Taip;0;2;0;2
9897;Šermukšnėlė;AKMENUKAI;5660238634;Ne;9;6;0;15
9898;Šermukšnėlė;AKMENUKAI;5678559268;Ne;18;0;1;19
9899;Šermukšnėlė;AKMENUKAI;8479230675;Ne;6;5;0;11
9900;Šermukšnėlė;AKMENUKAI;6162830167;Ne;6;0;0;6
9901;Šermukšnėlė;AKMENUKAI;2913363351;Taip;12;0;3;15
9902;Šermukšnėlė;AKMENUKAI;3613456202;Taip;0;0;6;6
9903;Šermukšnėlė;AKMENUKAI;2506945279;Ne;0;0;1;1
9904;Šermukšnėlė;AKMENUKAI;8709426669;Ne;0;16;0;16
9905;Šermukšnėlė;AKMENUKAI;6585484701;Ne;11;1;0;12
9906;Šermukšnėlė;AKMENUKAI;6599779539;Ne;0;10;0;10
9907;Šermukšnėlė;AKMENUKAI;9876533442;Ne;0;0;7;7
9908;Šermukšnėlė;AKMENUKAI;3653792683;Ne;0;0;2;2
9909;Šermukšnėlė;SIŪLINUKAI;2740644605;Ne;8;0;0;8
9910;Šermukšnėlė;SIŪLINUKAI;8454298610;Ne;0;0;1;1
9911;Šermukšnėlė;SIŪLINUKAI;6429038861;Ne;8;0;0;8
9912;Šermukšnėlė;SIŪLINUKAI;6429038861;Ne;8;0;0;8
9913;Šermukšnėlė;SIŪLINUKAI;6429038861;Ne;8;0;0;8
9914;Šermukšnėlė;SIŪLINUKAI;6429038861;Ne;8;0;0;8
9915;Šermukšnėlė;SIŪLINUKAI;1819553019;Ne;11;0;2;13
9916;Šermukšnėlė;SIŪLINUKAI;7568969509;Ne;4;0;1;5
9917;Šermukšnėlė;SIŪLINUKAI;4390650081;Taip;2;0;1;3
9918;Šermukšnėlė;SIŪLINUKAI;5072021867;Ne;2;0;1;3
9919;Šermukšnėlė;SIŪLINUKAI;7934772640;Ne;5;7;0;12
9920;Šermukšnėlė;SIŪLINUKAI;3994075596;Ne;0;0;3;3
9921;Šermukšnėlė;SIŪLINUKAI;3098629992;Ne;0;0;1;1
9922;Šermukšnėlė;SIŪLINUKAI;6231057889;Ne;8;0;0;8
9923;Šermukšnėlė;SIŪLINUKAI;3106890807;Ne;6;0;2;8
9924;Šermukšnėlė;SIŪLINUKAI;9534316724;Ne;0;18;3;21
9925;Šermukšnėlė;SIŪLINUKAI;2705569653;Taip;11;0;0;11
9926;Šermukšnėlė;SIŪLINUKAI;9703804879;Ne;6;2;0;8
9927;Šermukšnėlė;SIŪLINUKAI;1754181467;Ne;4;0;1;5
9928;Šermukšnėlė;SIŪLINUKAI;6030012939;Ne;3;0;1;4
9929;Šermukšnėlė;MEDINUKAi;2568480087;Ne;15;0;0;15
9930;Šermukšnėlė;MEDINUKAi;2868258867;Ne;0;6;0;6
9931;Šermukšnėlė;MEDINUKAi;5483843510;Ne;6;0;1;7
9932;Šermukšnėlė;MEDINUKAi;7832178585;Ne;10;0;0;10
9933;Šermukšnėlė;MEDINUKAi;7523588943;Ne;0;3;0;3
9934;Šermukšnėlė;MEDINUKAi;1931894084;Ne;1;0;0;1
9935;Šermukšnėlė;MEDINUKAi;9535836301;Ne;3;0;2;5
9936;Šermukšnėlė;MEDINUKAi;3138507073;Ne;11;0;0;11
9937;Šermukšnėlė;MEDINUKAi;1502704170;Ne;2;0;1;3
9938;Šermukšnėlė;MEDINUKAi;9247356229;Ne;7;10;0;17
9939;Šermukšnėlė;MEDINUKAi;3206222470;Ne;11;0;1;12
9940;Šermukšnėlė;MEDINUKAi;5751303170;Ne;2;2;0;4
9941;Šermukšnėlė;MEDINUKAi;2810624440;Ne;10;0;0;10
9942;Šermukšnėlė;MEDINUKAi;3955219247;Ne;10;2;0;12
9943;Šermukšnėlė;MEDINUKAi;5564759354;Taip;11;0;0;11
9944;Šermukšnėlė;MEDINUKAi;5081685546;Taip;12;1;0;13
9945;Šermukšnėlė;SKUDURINUKAI;5162694179;Ne;11;0;0;11
9946;Šermukšnėlė;SKUDURINUKAI;4323596263;Ne;0;0;1;1
9947;Šermukšnėlė;SKUDURINUKAI;9005316719;Ne;0;7;0;7
9948;Šermukšnėlė;SKUDURINUKAI;7353340444;Ne;6;0;0;6
9949;Šermukšnėlė;SKUDURINUKAI;6618875999;Ne;8;0;0;8
9950;Šermukšnėlė;SKUDURINUKAI;9258544213;Taip;2;0;0;2
9951;Šermukšnėlė;SKUDURINUKAI;4839548718;Ne;3;0;0;3
9952;Šermukšnėlė;SKUDURINUKAI;2154197839;Ne;8;0;1;9
9953;Šermukšnėlė;SKUDURINUKAI;2156273039;Ne;8;0;1;9
9954;Šermukšnėlė;SKUDURINUKAI;9777470572;Ne;0;3;0;3
9955;Šermukšnėlė;SKUDURINUKAI;3024192802;Ne;5;0;0;5
9956;Šermukšnėlė;SKUDURINUKAI;1208356789;Ne;8;0;0;8
9957;Šermukšnėlė;SKUDURINUKAI;6437380493;Ne;5;0;0;5
9958;Šermukšnėlė;SKUDURINUKAI;8726532739;Ne;2;0;0;2
9959;Šermukšnėlė;PAGRANDUKAI;6185588116;Taip;0;0;2;2
9960;Šermukšnėlė;PAGRANDUKAI;1209135668;Ne;14;0;1;15
9961;Šermukšnėlė;PAGRANDUKAI;8641098720;Taip;14;0;0;14
9962;Šermukšnėlė;PAGRANDUKAI;8130815072;Ne;0;13;0;13
9963;Šermukšnėlė;PAGRANDUKAI;9246403711;Taip;11;0;0;11
9964;Šermukšnėlė;PAGRANDUKAI;3105388312;Ne;3;0;1;4
9965;Šermukšnėlė;PAGRANDUKAI;2300950399;Taip;14;2;0;16
9966;Šermukšnėlė;PAGRANDUKAI;7570038521;Ne;8;0;1;9
9967;Šermukšnėlė;PAGRANDUKAI;4627034424;Ne;14;0;1;15
9968;Šermukšnėlė;PAGRANDUKAI;4776535014;Ne;3;0;0;3
9969;Šermukšnėlė;PAGRANDUKAI;1761737605;Ne;20;0;0;20
9970;Šermukšnėlė;PAGRANDUKAI;5397987456;Ne;28;0;0;28
9971;Šermukšnėlė;PAGRANDUKAI;3705620362;Ne;0;0;2;2
9972;Šypsena;NYKŠTUKAI;3806651280;Ne;0;13;0;13
9973;Šypsena;NYKŠTUKAI;4330797734;Ne;0;0;1;1
9974;Šypsena;NYKŠTUKAI;7876871684;Ne;0;0;2;2
9975;Šypsena;NYKŠTUKAI;6055482561;Ne;20;0;0;20
9976;Šypsena;NYKŠTUKAI;6028006499;Ne;4;2;0;6
9977;Šypsena;NYKŠTUKAI;3724483762;Ne;1;0;0;1
9978;Šypsena;NYKŠTUKAI;7817486488;Ne;18;0;0;18
9979;Šypsena;NYKŠTUKAI;9862387726;Ne;14;0;0;14
9980;Šypsena;NYKŠTUKAI;8001187137;Ne;4;0;0;4
9981;Šypsena;NYKŠTUKAI;5446516798;Ne;4;0;0;4
9982;Šypsena;NYKŠTUKAI;5094556499;Ne;9;0;0;9
9983;Šypsena;NYKŠTUKAI;4496704989;Ne;13;0;1;14
9984;Šypsena;NYKŠTUKAI;7471913547;Ne;0;0;1;1
9985;Šypsena;NYKŠTUKAI;7174068697;Ne;1;0;0;1
9986;Šypsena;NYKŠTUKAI;7905089772;Ne;0;1;8;9
9987;Šypsena;NYKŠTUKAI;7960872132;Ne;8;2;1;11
9988;Šypsena;NYKŠTUKAI;4260693029;Ne;0;3;0;3
9989;Šypsena;SPINDULIUKAI;8627994583;Ne;12;0;0;12
9990;Šypsena;SPINDULIUKAI;9363618080;Ne;0;0;1;1
9991;Šypsena;SPINDULIUKAI;9702364620;Ne;8;3;0;11
9992;Šypsena;SPINDULIUKAI;8508569167;Ne;1;0;0;1
9993;Šypsena;SPINDULIUKAI;3733757483;Ne;0;0;1;1
9994;Šypsena;SPINDULIUKAI;2179657619;Ne;0;1;0;1
9995;Šypsena;SPINDULIUKAI;2900195046;Ne;2;0;0;2
9996;Šypsena;SPINDULIUKAI;3724645162;Ne;2;0;1;3
9997;Šypsena;SPINDULIUKAI;8665786789;Ne;13;0;1;14
9998;Šypsena;SPINDULIUKAI;3003901966;Ne;12;2;0;14
9999;Šypsena;SPINDULIUKAI;2182189246;Ne;14;0;0;14
10000;Šypsena;SPINDULIUKAI;1431850136;Ne;2;0;0;2
10001;Šypsena;SPINDULIUKAI;1716274053;Ne;16;0;5;21
10002;Šypsena;SPINDULIUKAI;8439694239;Ne;0;2;0;2
10003;Šypsena;SPINDULIUKAI;6377979434;Ne;7;1;1;9
10004;Šypsena;SPINDULIUKAI;6724776618;Ne;7;0;1;8
10005;Šypsena;SPINDULIUKAI;2790906806;Ne;4;0;0;4
10006;Šypsena;SKRUZDELIUKAI;1324902555;Ne;4;0;0;4
10007;Šypsena;SKRUZDELIUKAI;5222603743;Ne;3;0;0;3
10008;Šypsena;SKRUZDELIUKAI;7120597034;Ne;0;0;2;2
10009;Šypsena;SKRUZDELIUKAI;3823623458;Ne;1;0;0;1
10010;Šypsena;SKRUZDELIUKAI;3429836513;Ne;0;0;24;24
10011;Šypsena;SKRUZDELIUKAI;4695547847;Ne;0;0;1;1
10012;Šypsena;SKRUZDELIUKAI;3901424559;Ne;5;7;0;12
10013;Šypsena;SKRUZDELIUKAI;6713182218;Ne;0;2;0;2
10014;Šypsena;SKRUZDELIUKAI;8215278033;Ne;4;0;1;5
10015;Šypsena;SKRUZDELIUKAI;7537442618;Ne;0;2;1;3
10016;Šypsena;SKRUZDELIUKAI;8566236342;Ne;11;0;0;11
10017;Šypsena;SKRUZDELIUKAI;2584574423;Ne;0;0;4;4
10018;Šypsena;SKRUZDELIUKAI;9704350208;Ne;0;0;2;2
10019;Šypsena;SKRUZDELIUKAI;6951845385;Ne;0;0;1;1
10020;Šypsena;SKRUZDELIUKAI;7877396588;Ne;0;5;4;9
10021;Šypsena;SKRUZDELIUKAI;8765509994;Ne;0;0;5;5
10022;Šypsena;SKRUZDELIUKAI;4520148322;Ne;14;4;0;18
10023;Šypsena;Bitutės;2312828770;Ne;5;0;0;5
10024;Šypsena;Bitutės;3810433774;Ne;12;4;1;17
10025;Šypsena;Bitutės;9623451754;Ne;2;0;0;2
10026;Šypsena;Bitutės;5611440056;Ne;1;0;0;1
10027;Šypsena;Bitutės;1558614852;Ne;2;0;0;2
10028;Šypsena;Bitutės;1897176871;Ne;4;0;0;4
10029;Šypsena;Bitutės;1181590127;Ne;1;9;0;10
10030;Šypsena;Bitutės;4808041625;Ne;0;0;1;1
10031;Šypsena;Bitutės;5834057370;Ne;0;2;0;2
10032;Šypsena;Bitutės;3809171499;Ne;3;0;0;3
10033;Šypsena;Bitutės;5928432220;Ne;3;0;0;3
10034;Šypsena;Bitutės;5504570516;Ne;2;0;0;2
10035;Šypsena;MEŠKIUKAI;9696633725;Taip;0;0;6;6
10036;Šypsena;MEŠKIUKAI;7234904026;Ne;15;1;0;16
10037;Šypsena;MEŠKIUKAI;3951000812;Ne;8;6;0;14
10038;Šypsena;MEŠKIUKAI;2177181171;Ne;1;0;0;1
10039;Šypsena;MEŠKIUKAI;4960714853;Ne;8;0;0;8
10040;Šypsena;MEŠKIUKAI;6224937025;Ne;7;0;0;7
10041;Šypsena;MEŠKIUKAI;8109877136;Ne;5;0;0;5
10042;Šypsena;MEŠKIUKAI;9841955736;Ne;2;0;3;5
10043;Šypsena;MEŠKIUKAI;2692869989;Ne;3;0;1;4
10044;Šypsena;MEŠKIUKAI;3205854107;Taip;1;0;0;1
10045;Šypsena;BORUŽĖLĖS;3563748951;Ne;5;0;0;5
10046;Šypsena;BORUŽĖLĖS;8456684826;Ne;7;0;0;7
10047;Šypsena;BORUŽĖLĖS;1307377636;Ne;2;0;0;2
10048;Šypsena;BORUŽĖLĖS;1153036896;Ne;11;0;0;11
10049;Šypsena;BORUŽĖLĖS;3624678823;Ne;6;0;0;6
10050;Šypsena;BORUŽĖLĖS;9232229854;Ne;7;0;0;7
10051;Šypsena;BORUŽĖLĖS;3285293143;Ne;4;0;0;4
10052;Šypsena;BORUŽĖLĖS;6905376170;Ne;2;0;0;2
10053;Šypsena;BORUŽĖLĖS;3643736553;Ne;5;0;0;5
10054;Šnekutis;DRUGELIŲ;9543014297;Ne;10;0;0;10
10055;Šnekutis;DRUGELIŲ;3096125224;Ne;5;2;0;7
10056;Šnekutis;DRUGELIŲ;3386995244;Taip;1;0;1;2
10057;Šnekutis;DRUGELIŲ;8984597121;Ne;5;0;0;5
10058;Šnekutis;DRUGELIŲ;8810371475;Ne;7;0;0;7
10059;Šnekutis;DRUGELIŲ;7680962037;Ne;20;0;0;20
10060;Šnekutis;DRUGELIŲ;3611064172;Taip;6;1;0;7
10061;Šnekutis;DRUGELIŲ;8209686459;Ne;1;0;0;1
10062;Šnekutis;DRUGELIŲ;8036600501;Ne;4;1;0;5
10063;Šnekutis;DRUGELIŲ;1556960616;Ne;1;0;0;1
10064;Šnekutis;DRUGELIŲ;7954240439;Ne;20;0;0;20
10065;Šnekutis;DRUGELIŲ;6330033887;Ne;0;1;0;1
10066;Šnekutis;DRUGELIŲ;6071004512;Ne;0;1;0;1
10067;Šnekutis;DRUGELIŲ;1504945841;Ne;12;5;0;17
10068;Šnekutis;DRUGELIŲ;3177449195;Ne;7;1;0;8
10069;Šnekutis;DRUGELIŲ;6305168453;Ne;2;0;0;2
10070;Šnekutis;DRUGELIŲ;1902486846;Ne;4;0;1;5
10071;Šnekutis;DRUGELIŲ;2131948397;Taip;2;0;0;2
10072;Šnekutis;Kačiukų;2914145045;Ne;10;0;1;11
10073;Šnekutis;Kačiukų;2656152037;Ne;8;1;0;9
10074;Šnekutis;Kačiukų;5521822696;Ne;6;0;2;8
10075;Šnekutis;Kačiukų;2144568225;Ne;7;0;0;7
10076;Šnekutis;Kačiukų;4624075875;Ne;3;0;4;7
10077;Šnekutis;Kačiukų;5828953086;Ne;4;0;0;4
10078;Šnekutis;Kačiukų;3635781445;Ne;10;0;3;13
10079;Šnekutis;Kačiukų;7109850241;Ne;0;2;0;2
10080;Šnekutis;Kačiukų;2386547087;Ne;3;0;0;3
10081;Šnekutis;Kačiukų;6072420827;Ne;14;0;1;15
10082;Šnekutis;Kačiukų;2626247219;Ne;5;0;1;6
10083;Šnekutis;Kačiukų;7707897830;Ne;4;0;0;4
10084;Šnekutis;Kačiukų;2852111627;Ne;2;0;0;2
10085;Šnekutis;Kačiukų;3214549246;Ne;5;0;0;5
10086;Šnekutis;Kačiukų;9574210410;Ne;2;0;0;2
10087;Šnekutis;Kačiukų;5727476284;Ne;10;0;0;10
10088;Šnekutis;Pėlėdžiukų;4835202527;Ne;0;1;0;1
10089;Šnekutis;Pėlėdžiukų;9326455786;Ne;4;0;1;5
10090;Šnekutis;Pėlėdžiukų;2843483435;Ne;13;0;0;13
10091;Šnekutis;Pėlėdžiukų;6405894763;Ne;0;7;0;7
10092;Šnekutis;Pėlėdžiukų;3889176018;Ne;0;0;2;2
10093;Šnekutis;Pėlėdžiukų;9054899440;Ne;0;0;2;2
10094;Šnekutis;Pėlėdžiukų;7307895397;Ne;0;0;2;2
10095;Šnekutis;Pėlėdžiukų;3371393656;Ne;6;0;1;7
10096;Šnekutis;Pėlėdžiukų;5597629090;Ne;0;1;1;2
10097;Šnekutis;Pėlėdžiukų;3344425033;Ne;12;0;2;14
10098;Šnekutis;Pėlėdžiukų;6544973632;Ne;10;0;0;10
10099;Šnekutis;Pėlėdžiukų;8219465079;Ne;3;5;0;8
10100;Šnekutis;Pėlėdžiukų;2779793970;Ne;0;3;0;3
10101;Šnekutis;Pėlėdžiukų;6146988521;Taip;0;3;0;3
10102;Šnekutis;Pėlėdžiukų;3628210526;Ne;5;0;0;5
10103;Šnekutis;Pėlėdžiukų;7344776758;Taip;0;0;3;3
10104;Šnekutis;Pėlėdžiukų;3937465849;Ne;4;0;0;4
10105;Šnekutis;Boružėlių;9887692849;Ne;3;0;0;3
10106;Šnekutis;Boružėlių;3115675798;Ne;5;0;0;5
10107;Šnekutis;Boružėlių;1805259980;Ne;9;0;0;9
10108;Šnekutis;Boružėlių;9790241725;Ne;5;0;0;5
10109;Šnekutis;Boružėlių;5934631354;Ne;3;0;1;4
10110;Šnekutis;Boružėlių;7006343288;Ne;10;0;0;10
10111;Šnekutis;Boružėlių;9322106995;Ne;1;0;1;2
10112;Šnekutis;Boružėlių;1248466603;Ne;7;0;0;7
10113;Šnekutis;Boružėlių;3842436406;Ne;14;0;0;14
10114;Šnekutis;Boružėlių;9772257715;Taip;0;3;0;3
10115;Šnekutis;Boružėlių;3593766968;Ne;5;0;0;5
10116;Šnekutis;Boružėlių;5919317274;Ne;4;0;0;4
10117;Šnekutis;Boružėlių;7200356364;Ne;9;0;0;9
10118;Šnekutis;Boružėlių;9709701441;Ne;5;0;0;5
10119;Šnekutis;Boružėlių;6306269165;Taip;4;0;0;4
10120;Šnekutis;Boružėlių;2761479685;Taip;2;0;0;2
10121;Šnekutis;Boružėlių;8456957469;Taip;4;0;0;4
10122;Šnekutis;Boružėlių;1475304511;Ne;1;0;0;1
10123;Šnekutis;Meškučių;1219175855;Ne;5;0;0;5
10124;Šnekutis;Meškučių;7980166125;Ne;6;5;0;11
10125;Šnekutis;Meškučių;6041045276;Ne;5;0;0;5
10126;Šnekutis;Meškučių;2134556666;Ne;10;0;0;10
10127;Šnekutis;Meškučių;7775818807;Ne;5;1;0;6
10128;Šnekutis;Meškučių;9752334636;Ne;7;0;0;7
10129;Šnekutis;Meškučių;7704236799;Taip;3;0;0;3
10130;Šnekutis;Meškučių;8612528998;Ne;0;13;0;13
10131;Šnekutis;Meškučių;6915324469;Ne;3;1;0;4
10132;Šnekutis;Meškučių;5785972840;Ne;2;0;0;2
10133;Šnekutis;Meškučių;4963132460;Ne;3;0;0;3
10134;Šnekutis;Meškučių;1772197145;Ne;6;0;0;6
10135;Šnekutis;Meškučių;4452941417;Ne;7;0;0;7
10136;Šnekutis;Meškučių;8332860563;Ne;5;0;0;5
10137;Šnekutis;Meškučių;3173995001;Ne;3;0;0;3
10138;Šnekutis;Meškučių;2615956847;Ne;15;0;0;15
10139;Šnekutis;Viščiukų;3588737003;Ne;2;7;0;9
10140;Šnekutis;Viščiukų;4848437026;Ne;4;1;0;5
10141;Šnekutis;Viščiukų;5059417996;Ne;0;0;1;1
10142;Šnekutis;Viščiukų;7914683654;Taip;7;0;0;7
10143;Šnekutis;Viščiukų;8061450452;Ne;2;0;0;2
10144;Šnekutis;Viščiukų;9238064074;Ne;9;0;0;9
10145;Šnekutis;Viščiukų;2258811969;Ne;10;0;1;11
10146;Šnekutis;Viščiukų;3852214850;Ne;8;0;0;8
10147;Šnekutis;Viščiukų;3869428583;Taip;2;0;0;2
10148;Šnekutis;Viščiukų;5185096482;Ne;5;0;0;5
10149;Šnekutis;Viščiukų;8900769157;Ne;2;1;0;3
10150;Šnekutis;Viščiukų;1811580823;Ne;0;3;0;3
10151;Šnekutis;Viščiukų;9385583890;Ne;13;5;2;20
10152;Užupiukas;VYTURĖLIŲ;9807212956;Ne;0;0;7;7
10153;Užupiukas;VYTURĖLIŲ;5182110542;Ne;2;0;0;2
10154;Užupiukas;VYTURĖLIŲ;3690562985;Ne;10;0;0;10
10155;Užupiukas;VYTURĖLIŲ;4449466321;Ne;3;0;2;5
10156;Užupiukas;VYTURĖLIŲ;9872846882;Ne;6;0;3;9
10157;Užupiukas;VYTURĖLIŲ;5694960072;Ne;0;0;3;3
10158;Užupiukas;VYTURĖLIŲ;3879735445;Taip;16;0;0;16
10159;Užupiukas;VYTURĖLIŲ;2377079878;Ne;7;3;0;10
10160;Užupiukas;VYTURĖLIŲ;3474990673;Ne;0;0;3;3
10161;Užupiukas;VYTURĖLIŲ;5851602817;Ne;6;0;1;7
10162;Užupiukas;VYTURĖLIŲ;8601594247;Ne;5;0;1;6
10163;Užupiukas;VYTURĖLIŲ;9556937880;Taip;11;1;0;12
10164;Užupiukas;VYTURĖLIŲ;4055044580;Taip;5;0;3;8
10165;Užupiukas;VYTURĖLIŲ;3654349639;Ne;6;0;0;6
10166;Užupiukas;VYTURĖLIŲ;3275112189;Ne;9;0;1;10
10167;Užupiukas;VYTURĖLIŲ;5280778870;Ne;0;0;1;1
10168;Užupiukas;VYTURĖLIŲ;7735497084;Ne;0;0;6;6
10169;Užupiukas;VYTURĖLIŲ;9278445367;Ne;17;0;0;17
10170;Užupiukas;VYTURĖLIŲ;8931872728;Ne;12;0;0;12
10171;Užupiukas;KAČIUKŲ;3567963511;Ne;0;0;2;2
10172;Užupiukas;KAČIUKŲ;9991552624;Ne;0;8;0;8
10173;Užupiukas;KAČIUKŲ;3048959458;Ne;5;0;2;7
10174;Užupiukas;KAČIUKŲ;1809036046;Ne;4;0;0;4
10175;Užupiukas;KAČIUKŲ;1102468034;Ne;1;0;0;1
10176;Užupiukas;KAČIUKŲ;1464016943;Ne;3;0;1;4
10177;Užupiukas;KAČIUKŲ;4485435274;Ne;5;0;1;6
10178;Užupiukas;KAČIUKŲ;1102293237;Ne;7;0;0;7
10179;Užupiukas;KAČIUKŲ;9386211193;Ne;0;0;1;1
10180;Užupiukas;KAČIUKŲ;9333587467;Ne;8;0;0;8
10181;Užupiukas;KAČIUKŲ;3543913063;Ne;6;0;2;8
10182;Užupiukas;KAČIUKŲ;4920190785;Ne;4;3;0;7
10183;Užupiukas;KAČIUKŲ;1414888906;Ne;0;0;1;1
10184;Užupiukas;KAČIUKŲ;5436401811;Ne;2;0;0;2
10185;Užupiukas;KAČIUKŲ;3001874900;Taip;4;0;0;4
10186;Užupiukas;KAČIUKŲ;3794021404;Ne;10;0;0;10
10187;Užupiukas;KAČIUKŲ;6685567970;Ne;1;0;0;1
10188;Užupiukas;DRUGELIŲ;8876174256;Ne;6;1;0;7
10189;Užupiukas;DRUGELIŲ;5239006321;Ne;5;1;1;7
10190;Užupiukas;DRUGELIŲ;7581152903;Ne;6;2;0;8
10191;Užupiukas;DRUGELIŲ;3419182422;Ne;4;0;0;4
10192;Užupiukas;DRUGELIŲ;4854016957;Ne;0;1;1;2
10193;Užupiukas;DRUGELIŲ;4595291532;Ne;6;1;0;7
10194;Užupiukas;DRUGELIŲ;3383643388;Ne;0;1;2;3
10195;Užupiukas;DRUGELIŲ;3961733676;Ne;11;1;0;12
10196;Užupiukas;DRUGELIŲ;5006880916;Ne;11;0;0;11
10197;Užupiukas;DRUGELIŲ;9715624372;Taip;5;1;3;9
10198;Užupiukas;DRUGELIŲ;1108429907;Taip;7;1;2;10
10199;Užupiukas;DRUGELIŲ;9295230331;Ne;0;0;4;4
10200;Užupiukas;DRUGELIŲ;9577167600;Taip;0;1;0;1
10201;Užupiukas;DRUGELIŲ;8692826414;Ne;3;1;0;4
10202;Užupiukas;DRUGELIŲ;4680027403;Ne;0;0;2;2
10203;Užupiukas;EŽIUKŲ;8936209423;Taip;5;0;1;6
10204;Užupiukas;EŽIUKŲ;2522356285;Ne;0;5;0;5
10205;Užupiukas;EŽIUKŲ;5055376157;Ne;9;0;0;9
10206;Užupiukas;EŽIUKŲ;3235855849;Ne;0;0;2;2
10207;Užupiukas;EŽIUKŲ;4788900708;Ne;5;0;4;9
10208;Užupiukas;EŽIUKŲ;4670096314;Ne;10;0;0;10
10209;Užupiukas;EŽIUKŲ;7914295007;Ne;5;0;0;5
10210;Užupiukas;EŽIUKŲ;7671705684;Ne;0;0;1;1
10211;Užupiukas;EŽIUKŲ;6016947840;Ne;5;0;1;6
10212;Užupiukas;EŽIUKŲ;8443732431;Ne;10;0;0;10
10213;Užupiukas;EŽIUKŲ;4583779329;Ne;5;0;1;6
10214;Užupiukas;EŽIUKŲ;1757695746;Ne;5;0;1;6
10215;Užupiukas;EŽIUKŲ;4357253574;Taip;10;0;3;13
10216;Užupiukas;EŽIUKŲ;7299810108;Ne;14;0;0;14
10217;Užupiukas;EŽIUKŲ;1989125835;Ne;0;0;20;20
10218;Užupiukas;EŽIUKŲ;5866437622;Taip;10;0;2;12
10219;Užupiukas;EŽIUKŲ;5784908270;Ne;8;0;1;9
10220;Užupiukas;EŽIUKŲ;9163947073;Ne;5;0;0;5
10221;Užupiukas;EŽIUKŲ;4034821342;Ne;8;1;0;9
10222;Užupiukas;EŽIUKŲ;7589905741;Ne;0;0;3;3
10223;Užupiukas;BORUŽĖLIŲ;8467502933;Ne;11;0;0;11
10224;Užupiukas;BORUŽĖLIŲ;2804115700;Taip;3;0;0;3
10225;Užupiukas;BORUŽĖLIŲ;4151757682;Ne;14;0;0;14
10226;Užupiukas;BORUŽĖLIŲ;3014087333;Ne;0;3;0;3
10227;Užupiukas;BORUŽĖLIŲ;3811750547;Ne;6;0;1;7
10228;Užupiukas;BORUŽĖLIŲ;2158976125;Ne;5;0;1;6
10229;Užupiukas;BORUŽĖLIŲ;1891855020;Ne;0;0;1;1
10230;Užupiukas;BORUŽĖLIŲ;1473606331;Ne;9;0;0;9
10231;Užupiukas;BORUŽĖLIŲ;9312234251;Ne;0;1;0;1
10232;Užupiukas;BORUŽĖLIŲ;5381329362;Taip;7;1;0;8
10233;Užupiukas;BORUŽĖLIŲ;4570457987;Ne;8;0;0;8
10234;Užupiukas;BORUŽĖLIŲ;4841475687;Ne;0;1;0;1
10235;Užupiukas;BORUŽĖLIŲ;9714322911;Ne;9;0;0;9
10236;Užupiukas;BORUŽĖLIŲ;7107441792;Ne;16;0;0;16
10237;Užupiukas;BORUŽĖLIŲ;7105857162;Ne;0;1;0;1
10238;Užupiukas;BORUŽĖLIŲ;7895825571;Ne;2;0;0;2
10239;Užupiukas;BORUŽĖLIŲ;8518137669;Ne;2;0;0;2
10240;Užupiukas;BORUŽĖLIŲ;7169272175;Ne;12;0;0;12
10241;Užupiukas;BORUŽĖLIŲ;7716893423;Ne;5;0;0;5
10242;Užupiukas;BORUŽĖLIŲ;6857321547;Ne;7;0;1;8
10243;Užupiukas;SPINDULIUKŲ;7443013255;Ne;0;0;1;1
10244;Užupiukas;SPINDULIUKŲ;5718382826;Ne;6;0;3;9
10245;Užupiukas;SPINDULIUKŲ;1791922219;Ne;2;0;1;3
10246;Užupiukas;SPINDULIUKŲ;3829013911;Ne;5;0;1;6
10247;Užupiukas;SPINDULIUKŲ;8001099421;Ne;9;0;0;9
10248;Užupiukas;SPINDULIUKŲ;4401569800;Ne;0;0;2;2
10249;Užupiukas;SPINDULIUKŲ;1391826582;Ne;0;0;2;2
10250;Užupiukas;SPINDULIUKŲ;9132605734;Taip;4;0;1;5
10251;Užupiukas;SPINDULIUKŲ;8347350503;Ne;5;0;1;6
10252;Užupiukas;SPINDULIUKŲ;7532497390;Ne;0;0;1;1
10253;Užupiukas;SPINDULIUKŲ;9209209113;Taip;13;0;1;14
10254;Užupiukas;SPINDULIUKŲ;5116564840;Ne;3;0;5;8
10255;Užupiukas;SPINDULIUKŲ;8519118225;Ne;6;0;0;6
10256;Užupiukas;SPINDULIUKŲ;7549628277;Ne;6;0;0;6
10257;Užupiukas;ŽVIRBLIUKŲ;5085660507;Ne;3;3;0;6
10258;Užupiukas;ŽVIRBLIUKŲ;2273766308;Ne;2;0;0;2
10259;Užupiukas;ŽVIRBLIUKŲ;9925592494;Ne;6;0;1;7
10260;Užupiukas;ŽVIRBLIUKŲ;4710910251;Ne;0;7;0;7
10261;Užupiukas;ŽVIRBLIUKŲ;9428884149;Ne;0;3;0;3
10262;Užupiukas;ŽVIRBLIUKŲ;2210437775;Ne;0;1;0;1
10263;Užupiukas;ŽVIRBLIUKŲ;1995228207;Ne;0;1;0;1
10264;Užupiukas;ŽVIRBLIUKŲ;1496541880;Taip;7;1;7;15
10265;Užupiukas;ŽVIRBLIUKŲ;6001766518;Ne;10;0;0;10
10266;Užupiukas;ŽVIRBLIUKŲ;4785494419;Ne;6;1;0;7
10267;Užupiukas;ŽVIRBLIUKŲ;8119142600;Ne;0;4;2;6
10268;Užupiukas;ŽVIRBLIUKŲ;2362568676;Ne;6;0;0;6
10269;Užupiukas;ŽVIRBLIUKŲ;7530856195;Ne;6;0;0;6
10270;Užupiukas;ŽVIRBLIUKŲ;4054724625;Ne;0;1;0;1
10271;Užupiukas;ŽVIRBLIUKŲ;1843171673;Ne;10;0;0;10
10272;Užupiukas;ŽVIRBLIUKŲ;9719845726;Ne;4;1;2;7
10273;Užupiukas;ŽVIRBLIUKŲ;1647271985;Ne;0;2;0;2
10274;Užupiukas;PELĖDŽIUKŲ;6699322898;Ne;16;0;0;16
10275;Užupiukas;PELĖDŽIUKŲ;5204808398;Ne;7;0;0;7
10276;Užupiukas;PELĖDŽIUKŲ;6512355340;Ne;0;0;1;1
10277;Užupiukas;PELĖDŽIUKŲ;9906475253;Ne;5;0;1;6
10278;Užupiukas;PELĖDŽIUKŲ;3171528288;Ne;0;0;3;3
10279;Užupiukas;PELĖDŽIUKŲ;7860601571;Ne;9;0;0;9
10280;Užupiukas;PELĖDŽIUKŲ;3611922301;Ne;5;0;0;5
10281;Užupiukas;PELĖDŽIUKŲ;9774124589;Ne;7;0;2;9
10282;Užupiukas;PELĖDŽIUKŲ;2724216446;Taip;0;0;2;2
10283;Užupiukas;PELĖDŽIUKŲ;9446562736;Ne;0;0;2;2
10284;Užupiukas;PELĖDŽIUKŲ;5072363435;Ne;0;0;2;2
10285;Užupiukas;PELĖDŽIUKŲ;5538327364;Ne;0;0;1;1
10286;Užupiukas;PELĖDŽIUKŲ;1526296386;Ne;3;0;3;6
10287;Užupiukas;PELĖDŽIUKŲ;3057147440;Ne;6;0;3;9
10288;Užupiukas;PELĖDŽIUKŲ;6370918943;Ne;0;0;3;3
10289;Užupiukas;PELĖDŽIUKŲ;1100574872;Ne;0;0;1;1
10290;Užupiukas;PELĖDŽIUKŲ;9357101972;Ne;0;0;2;2
10291;Užupiukas;VARPELIŲ;5941280824;Ne;0;0;7;7
10292;Užupiukas;VARPELIŲ;2485426055;Ne;9;0;1;10
10293;Užupiukas;VARPELIŲ;7314085267;Ne;0;0;2;2
10294;Užupiukas;VARPELIŲ;2752139377;Ne;1;0;2;3
10295;Užupiukas;VARPELIŲ;1407429980;Ne;0;0;1;1
10296;Užupiukas;VARPELIŲ;4811619739;Ne;0;1;0;1
10297;Užupiukas;VARPELIŲ;9523512906;Ne;16;0;0;16
10298;Užupiukas;VARPELIŲ;5148672602;Ne;0;0;6;6
10299;Užupiukas;VARPELIŲ;2769924857;Ne;8;0;1;9
10300;Užupiukas;VARPELIŲ;4112143599;Ne;8;0;0;8
10301;Užupiukas;VARPELIŲ;7628420639;Ne;10;0;1;11
10302;Užupiukas;VARPELIŲ;6736111909;Ne;0;0;3;3
10303;Užupiukas;VARPELIŲ;4206519159;Ne;0;0;1;1
10304;Užupiukas;VARPELIŲ;3394103404;Ne;7;0;2;9
10305;Užupiukas;VARPELIŲ;4446988239;Ne;0;0;6;6
10306;Užupiukas;SAULUČIŲ;5704945892;Ne;0;0;3;3
10307;Užupiukas;SAULUČIŲ;3684774901;Ne;0;0;1;1
10308;Užupiukas;SAULUČIŲ;1976775494;Taip;0;3;0;3
10309;Užupiukas;SAULUČIŲ;5874450724;Ne;0;11;1;12
10310;Užupiukas;SAULUČIŲ;3341292382;Ne;8;0;1;9
10311;Užupiukas;SAULUČIŲ;2211595125;Ne;0;0;2;2
10312;Užupiukas;SAULUČIŲ;5570569874;Ne;0;0;3;3
10313;Užupiukas;SAULUČIŲ;7643286183;Ne;0;0;2;2
10314;Užupiukas;SAULUČIŲ;2814556305;Ne;3;0;0;3
10315;Užupiukas;SAULUČIŲ;7209853233;Ne;6;0;0;6
10316;Užupiukas;SAULUČIŲ;9953994943;Ne;0;3;0;3
10317;Užupiukas;SAULUČIŲ;5469735455;Ne;5;1;0;6
10318;Užupiukas;SAULUČIŲ;8489545569;Ne;5;0;1;6
10319;Užupiukas;SAULUČIŲ;4691413468;Ne;4;0;0;4
10320;Užupiukas;SAULUČIŲ;7423292334;Ne;10;6;0;16
10321;Užupiukas;SAULUČIŲ;9216626936;Ne;0;1;4;5
10322;Užupiukas;SAULUČIŲ;9709440406;Ne;8;0;0;8
10323;Užupiukas;SAULUČIŲ;9434907771;Ne;0;0;5;5
10324;Užupiukas;LAPIUKŲ;9833934299;Ne;8;0;0;8
10325;Užupiukas;LAPIUKŲ;4963679583;Ne;13;0;0;13
10326;Užupiukas;LAPIUKŲ;2679915982;Ne;0;1;1;2
10327;Užupiukas;LAPIUKŲ;6004467875;Ne;0;1;0;1
10328;Užupiukas;LAPIUKŲ;1718048938;Ne;13;0;0;13
10329;Užupiukas;LAPIUKŲ;7986962850;Ne;5;1;0;6
10330;Užupiukas;LAPIUKŲ;2517606394;Ne;12;0;0;12
10331;Užupiukas;LAPIUKŲ;5965564175;Ne;6;0;0;6
10332;Užupiukas;LAPIUKŲ;7161001771;Ne;5;0;0;5
10333;Užupiukas;LAPIUKŲ;1886792898;Ne;3;0;0;3
10334;Užupiukas;LAPIUKŲ;6967184410;Ne;5;0;0;5
10335;Užupiukas;LAPIUKŲ;1178152392;Ne;9;0;0;9
10336;Užupiukas;LAPIUKŲ;1041972540;Ne;0;1;1;2
10337;Užupiukas;LAPIUKŲ;4467470795;Ne;0;1;2;3
10338;Užupiukas;LAPIUKŲ;3333547785;Ne;5;0;0;5
10339;Užupiukas;LAPIUKŲ;8529259340;Ne;0;1;0;1
10340;Užupiukas;LAPIUKŲ;8252575784;Ne;7;0;0;7
10341;Užupiukas;LAPIUKŲ;4900699267;Ne;0;1;1;2
10342;Užupiukas;LAPIUKŲ;7247347675;Ne;0;1;0;1
10343;Užupiukas;NYKŠTUKŲ;1399112659;Ne;7;2;0;9
10344;Užupiukas;NYKŠTUKŲ;4379182756;Ne;0;18;0;18
10345;Užupiukas;NYKŠTUKŲ;9785674147;Ne;0;19;0;19
10346;Užupiukas;NYKŠTUKŲ;3094320206;Ne;0;18;0;18
10347;Užupiukas;NYKŠTUKŲ;9118614894;Ne;0;0;1;1
10348;Užupiukas;NYKŠTUKŲ;1358906847;Ne;0;0;1;1
10349;Užupiukas;NYKŠTUKŲ;6628511386;Ne;0;0;3;3
10350;Užupiukas;NYKŠTUKŲ;5343951688;Ne;14;0;0;14
10351;Užupiukas;NYKŠTUKŲ;5556719499;Taip;9;0;0;9
10352;Užupiukas;NYKŠTUKŲ;6716173079;Ne;5;0;0;5
10353;Užupiukas;NYKŠTUKŲ;4441941216;Ne;9;2;0;11
10354;Užupiukas;NYKŠTUKŲ;4489962171;Ne;16;0;0;16
10355;Užupiukas;NYKŠTUKŲ;1139748215;Ne;10;0;0;10
10356;Vaidilutė;Žiogelis;9568450630;Ne;10;0;0;10
10357;Vaidilutė;Žiogelis;7319037375;Ne;1;0;1;2
10358;Vaidilutė;Žiogelis;7494818866;Ne;1;0;2;3
10359;Vaidilutė;Žiogelis;7306768961;Ne;0;1;1;2
10360;Vaidilutė;Žiogelis;7532115462;Ne;0;6;4;10
10361;Vaidilutė;Žiogelis;1140011879;Ne;5;0;2;7
10362;Vaidilutė;Žiogelis;9563257771;Ne;0;0;3;3
10363;Vaidilutė;Žiogelis;3059654988;Ne;0;0;2;2
10364;Vaidilutė;Žiogelis;1341696594;Ne;0;0;2;2
10365;Vaidilutė;Žiogelis;1141947715;Ne;4;0;2;6
10366;Vaidilutė;Žiogelis;5482030284;Ne;0;0;1;1
10367;Vaidilutė;Žiogelis;8505156287;Ne;3;0;0;3
10368;Vaidilutė;Žiogelis;2189753894;Ne;0;0;1;1
10369;Vaidilutė;Rūtelė;6449710777;Ne;0;0;1;1
10370;Vaidilutė;Rūtelė;4887753072;Ne;5;0;0;5
10371;Vaidilutė;Rūtelė;7726116370;Ne;2;0;1;3
10372;Vaidilutė;Rūtelė;2876157676;Ne;5;0;0;5
10373;Vaidilutė;Rūtelė;3557654689;Ne;1;0;0;1
10374;Vaidilutė;Rūtelė;8257746012;Ne;1;0;0;1
10375;Vaidilutė;Rūtelė;8444010416;Ne;3;0;1;4
10376;Vaidilutė;Rūtelė;4568108299;Ne;0;0;1;1
10377;Vaidilutė;Rūtelė;1998966302;Ne;4;0;0;4
10378;Vaidilutė;Rūtelė;5026620305;Ne;0;0;1;1
10379;Vaidilutė;Rūtelė;3826303389;Ne;0;0;2;2
10380;Vaidilutė;Rūtelė;4469754560;Ne;3;0;1;4
10381;Vaidilutė;Rūtelė;5918039529;Ne;6;0;1;7
10382;Vaidilutė;Rūtelė;3850868701;Ne;1;0;0;1
10383;Vaidilutė;Rūtelė;7660273021;Ne;6;1;2;9
10384;Vaidilutė;Rūtelė;6795083491;Ne;0;0;3;3
10385;Vaidilutė;Rūtelė;6604575848;Ne;0;0;3;3
10386;Vaidilutė;Rūtelė;7649954695;Ne;5;0;2;7
10387;Vaidilutė;Rūtelė;5797505797;Ne;12;0;0;12
10388;Vaidilutė;Voveraitė;3248203941;Ne;0;0;1;1
10389;Vaidilutė;Voveraitė;1608646909;Ne;11;0;0;11
10390;Vaidilutė;Voveraitė;9429544108;Taip;0;0;3;3
10391;Vaidilutė;Voveraitė;5652381296;Taip;4;0;0;4
10392;Vaidilutė;Voveraitė;8377824920;Ne;0;6;0;6
10393;Vaidilutė;Voveraitė;5296146822;Ne;5;0;0;5
10394;Vaidilutė;Voveraitė;3299081380;Taip;6;0;5;11
10395;Vaidilutė;Voveraitė;3634285869;Taip;6;0;10;16
10396;Vaidilutė;Voveraitė;7703578508;Ne;10;0;7;17
10397;Vaidilutė;Voveraitė;5855762068;Ne;0;1;0;1
10398;Vaidilutė;Voveraitė;8177787790;Taip;3;0;0;3
10399;Vaidilutė;Voveraitė;7327131165;Ne;0;2;7;9
10400;Vaidilutė;Voveraitė;2318578603;Ne;0;0;9;9
10401;Vaidilutė;Voveraitė;9372280434;Ne;5;1;0;6
10402;Vaidilutė;Voveraitė;1372767364;Ne;7;0;0;7
10403;Vaidilutė;Voveraitė;7478943531;Ne;5;1;0;6
10404;Vaidilutė;Voveraitė;4738318120;Ne;0;9;0;9
10405;Vaidilutė;Voveraitė;3319615121;Ne;0;0;10;10
10406;Vaidilutė;Voveraitė;6299324271;Ne;0;1;1;2
10407;Vaidilutė;Voveraitė;4186708502;Taip;0;0;2;2
10408;Vaidilutė;Voveraitė;2855672500;Taip;9;3;0;12
10409;Vaidilutė;Voveraitė;8053548602;Ne;0;0;20;20
10410;Vaidilutė;Saulutė;2164241264;Ne;5;1;0;6
10411;Vaidilutė;Saulutė;4648985217;Ne;8;0;0;8
10412;Vaidilutė;Saulutė;4348206726;Taip;10;0;0;10
10413;Vaidilutė;Saulutė;5008411199;Taip;3;0;0;3
10414;Vaidilutė;Saulutė;5405461987;Ne;0;1;1;2
10415;Vaidilutė;Saulutė;6928815317;Ne;7;0;0;7
10416;Vaidilutė;Saulutė;1283676263;Ne;8;0;6;14
10417;Vaidilutė;Saulutė;6239494382;Ne;0;3;0;3
10418;Vaidilutė;Saulutė;8629789128;Ne;5;0;6;11
10419;Vaidilutė;Saulutė;8413764934;Ne;0;2;0;2
10420;Vaidilutė;Saulutė;2315322608;Ne;0;1;13;14
10421;Vaidilutė;Saulutė;7019245743;Ne;8;0;0;8
10422;Vaidilutė;Saulutė;7075509397;Ne;5;0;0;5
10423;Vaidilutė;Saulutė;8012451263;Ne;0;1;2;3
10424;Vaidilutė;Saulutė;4760330697;Taip;5;0;0;5
10425;Vaidilutė;Saulutė;5205356977;Ne;0;1;0;1
10426;Vaidilutė;Saulutė;5095161432;Ne;0;0;1;1
10427;Vaidilutė;Saulutė;7572407329;Ne;5;1;0;6
10428;Vaidilutė;Saulutė;4963577351;Ne;6;0;0;6
10429;Vaidilutė;Saulutė;6527155865;Ne;0;1;3;4
10430;Vaidilutė;Žibutė;4085959509;Taip;0;6;0;6
10431;Vaidilutė;Žibutė;1001320466;Ne;0;0;1;1
10432;Vaidilutė;Žibutė;3051006765;Ne;1;0;2;3
10433;Vaidilutė;Žibutė;9189713003;Ne;0;1;0;1
10434;Vaidilutė;Žibutė;7903242996;Ne;11;0;2;13
10435;Vaidilutė;Žibutė;3980894528;Ne;9;0;1;10
10436;Vaidilutė;Žibutė;1362256314;Ne;0;2;0;2
10437;Vaidilutė;Žibutė;7940581813;Ne;5;0;1;6
10438;Vaidilutė;Žibutė;2767482145;Ne;2;0;2;4
10439;Vaidilutė;Žibutė;8769601956;Ne;5;0;0;5
10440;Vaidilutė;Žibutė;1726638921;Ne;0;0;2;2
10441;Vaidilutė;Žibutė;5415279154;Ne;3;0;0;3
10442;Vaidilutė;Žibutė;4124217264;Ne;9;0;1;10
10443;Vaidilutė;Žibutė;7429825620;Ne;2;0;0;2
10444;Vaidilutė;Žibutė;7690470762;Ne;12;0;0;12
10445;Vaidilutė;Žibutė;1606864068;Ne;2;0;0;2
10446;Vaidilutė;"Ąžuoliukas ";3730573432;Ne;0;5;2;7
10447;Vaidilutė;"Ąžuoliukas ";6586072228;Ne;0;2;0;2
10448;Vaidilutė;"Ąžuoliukas ";4954285515;Ne;0;1;0;1
10449;Vaidilutė;"Ąžuoliukas ";5439973183;Ne;0;0;1;1
10450;Vaidilutė;"Ąžuoliukas ";4761992071;Ne;0;0;2;2
10451;Vaidilutė;"Ąžuoliukas ";1440819171;Ne;0;0;1;1
10452;Vaidilutė;"Ąžuoliukas ";4901387311;Ne;0;1;0;1
10453;Vaidilutė;"Ąžuoliukas ";2997948252;Ne;1;1;2;4
10454;Vaidilutė;"Ąžuoliukas ";9723156071;Ne;0;1;6;7
10455;Vaidilutė;"Ąžuoliukas ";4193108560;Ne;0;0;3;3
10456;Vaidilutė;"Ąžuoliukas ";3782651091;Ne;5;0;4;9
10457;Vaidilutė;"Ąžuoliukas ";6637224510;Ne;0;0;4;4
10458;Vaidilutė;"Ąžuoliukas ";6067801976;Ne;0;0;1;1
10459;Vaidilutė;"Žemuogėlė ";2131127298;Ne;0;0;1;1
10460;Vaidilutė;"Žemuogėlė ";2014160468;Ne;0;0;4;4
10461;Vaidilutė;"Žemuogėlė ";4680645841;Ne;0;0;2;2
10462;Vaidilutė;"Žemuogėlė ";2662468804;Ne;7;0;1;8
10463;Vaidilutė;"Žemuogėlė ";5217609332;Ne;0;0;2;2
10464;Vaidilutė;"Žemuogėlė ";8492055287;Ne;0;0;7;7
10465;Vaidilutė;"Žemuogėlė ";5945744595;Taip;9;0;0;9
10466;Vaidilutė;"Žemuogėlė ";2864731541;Ne;10;0;0;10
10467;Vaidilutė;"Žemuogėlė ";1998872078;Ne;3;0;0;3
10468;Vaidilutė;"Žemuogėlė ";2468220275;Ne;0;0;2;2
10469;Vaidilutė;"Žemuogėlė ";6844372910;Ne;5;0;1;6
10470;Vaidilutė;"Žemuogėlė ";4972645715;Ne;0;0;8;8
10471;Vaidilutė;"Žemuogėlė ";1610262589;Ne;4;0;3;7
10472;Vaidilutė;"Žemuogėlė ";2356037175;Ne;0;1;0;1
10473;Vaidilutė;"Žemuogėlė ";5054640268;Ne;5;0;1;6
10474;Vaidilutė;"Žemuogėlė ";2294802783;Ne;0;7;1;8
10475;Vaidilutė;"Žemuogėlė ";2419903023;Ne;6;0;0;6
10476;Vaidilutė;"Vyturėlis ";3121914268;Ne;10;0;0;10
10477;Vaidilutė;"Vyturėlis ";5050251048;Ne;1;1;0;2
10478;Vaidilutė;"Vyturėlis ";7106410219;Ne;0;0;1;1
10479;Vaidilutė;"Vyturėlis ";5326935037;Ne;0;10;0;10
10480;Vaidilutė;"Vyturėlis ";1539700521;Ne;12;0;0;12
10481;Vaidilutė;"Vyturėlis ";4230076320;Ne;2;0;0;2
10482;Vaidilutė;"Vyturėlis ";8628545847;Ne;0;3;0;3
10483;Vaidilutė;"Vyturėlis ";4388069915;Ne;2;0;0;2
10484;Vaidilutė;"Vyturėlis ";1401180999;Ne;0;0;1;1
10485;Vaidilutė;"Vyturėlis ";5651628204;Ne;0;1;0;1
10486;Vaidilutė;"Vyturėlis ";2251608691;Ne;10;0;0;10
10487;Vaidilutė;"Vyturėlis ";7914006128;Ne;14;0;1;15
10488;Vaidilutė;"Vyturėlis ";7131561558;Ne;0;0;2;2
10489;Vaidilutė;"Vyturėlis ";2194984060;Ne;16;0;0;16
10490;Vaidilutė;"Vyturėlis ";3351968717;Taip;0;1;0;1
10491;Vaidilutė;"Vyturėlis ";1732848786;Ne;6;0;0;6
10492;Vaidilutė;"Varpelis ";6250831269;Ne;0;3;0;3
10493;Vaidilutė;"Varpelis ";2763266518;Ne;0;1;0;1
10494;Vaidilutė;"Varpelis ";6037349527;Ne;3;0;0;3
10495;Vaidilutė;"Varpelis ";5867501558;Ne;0;3;0;3
10496;Vaidilutė;"Varpelis ";3832349858;Ne;0;0;6;6
10497;Vaidilutė;"Varpelis ";9317774960;Ne;5;0;0;5
10498;Vaidilutė;"Varpelis ";5448014291;Ne;0;1;0;1
10499;Vaidilutė;"Varpelis ";3497795848;Ne;4;0;0;4
10500;Vaidilutė;"Varpelis ";4280822951;Ne;0;1;1;2
10501;Vaidilutė;"Varpelis ";6107554047;Ne;4;5;0;9
10502;Vaidilutė;"Varpelis ";6022130248;Ne;0;0;1;1
10503;Vaidilutė;"Varpelis ";5101104226;Ne;2;0;0;2
10504;Vaidilutė;"Varpelis ";5594121340;Ne;1;3;0;4
10505;Vaidilutė;"Varpelis ";1882829340;Ne;8;0;0;8
10506;Vaidilutė;"Varpelis ";3353827105;Ne;6;1;1;8
10507;Vaidilutė;"Varpelis ";4362797606;Ne;0;5;0;5
10508;Vaidilutė;"Varpelis ";2058071219;Ne;3;0;0;3
10509;Vaidilutė;"Boružėlių ";2401619665;Ne;6;0;0;6
10510;Vaidilutė;"Boružėlių ";7992756674;Taip;5;3;2;10
10511;Vaidilutė;"Boružėlių ";4202779406;Ne;9;0;0;9
10512;Vaidilutė;"Boružėlių ";9206804444;Ne;5;0;0;5
10513;Vaidilutė;"Boružėlių ";1736009458;Ne;11;0;0;11
10514;Vaidilutė;"Boružėlių ";7163100596;Ne;6;0;1;7
10515;Vaidilutė;"Boružėlių ";1924346626;Ne;15;0;3;18
10516;Vaidilutė;"Boružėlių ";7535557733;Ne;15;0;3;18
10517;Vaidilutė;"Boružėlių ";7082436875;Ne;6;0;0;6
10518;Vaidilutė;"Boružėlių ";1224632280;Ne;5;0;0;5
10519;Vaidilutė;"Boružėlių ";7916111396;Ne;5;1;0;6
10520;Vaidilutė;"Boružėlių ";7605835683;Ne;10;0;0;10
10521;Vaidilutė;"Boružėlių ";2194687285;Ne;8;0;1;9
10522;Vaidilutė;"Malūnelis ";7406210603;Ne;10;2;8;20
10523;Vaidilutė;"Malūnelis ";5166331829;Taip;2;0;0;2
10524;Vaidilutė;"Malūnelis ";3509892176;Ne;4;0;0;4
10525;Vaidilutė;"Malūnelis ";9183056003;Taip;3;0;2;5
10526;Vaidilutė;"Malūnelis ";6001198563;Ne;4;1;0;5
10527;Vaidilutė;"Malūnelis ";7109743847;Ne;15;0;5;20
10528;Vaidilutė;"Malūnelis ";7036611507;Ne;9;0;0;9
10529;Vaidilutė;"Malūnelis ";9007565120;Ne;5;0;0;5
10530;Vaidilutė;"Malūnelis ";8042617129;Ne;5;0;0;5
10531;Vaidilutė;"Malūnelis ";5415659432;Ne;3;0;0;3
10532;Vaidilutė;"Malūnelis ";6541442524;Taip;2;0;1;3
10533;Vaidilutė;"Riešutėlis ";1161455376;Ne;12;0;0;12
10534;Vaidilutė;"Riešutėlis ";4518002596;Ne;3;0;3;6
10535;Vaidilutė;"Riešutėlis ";4657952465;Ne;0;0;2;2
10536;Vaidilutė;"Riešutėlis ";8756807918;Ne;14;0;2;16
10537;Vaidilutė;"Riešutėlis ";9782176726;Ne;10;0;0;10
10538;Vaidilutė;"Riešutėlis ";1206696843;Ne;4;1;0;5
10539;Vaidilutė;"Riešutėlis ";9872915544;Ne;5;0;0;5
10540;Vaidilutė;"Riešutėlis ";2976615414;Ne;6;0;1;7
10541;Vaidilutė;"Riešutėlis ";4709977896;Ne;9;0;0;9
10542;Vaidilutė;"Riešutėlis ";2409760986;Ne;0;0;1;1
10543;Vaidilutė;"Riešutėlis ";2564536281;Ne;4;0;0;4
10544;Vaidilutė;"Riešutėlis ";4051575845;Ne;0;0;3;3
10545;Vaidilutė;"Riešutėlis ";9025469107;Ne;0;0;7;7
10546;Vaidilutė;"Riešutėlis ";3862444839;Ne;5;0;0;5
10547;Vaidilutė;"Riešutėlis ";3321127541;Ne;1;0;0;1
10548;Vaidilutė;"Riešutėlis ";3064988592;Taip;12;0;0;12
10549;Vaidilutė;"Riešutėlis ";8296567629;Ne;2;0;1;3
10550;Vaidilutė;"Riešutėlis ";7871629009;Ne;0;0;2;2
10551;Vandenis;ŽUVĖDRŲ;6784010746;Taip;6;2;0;8
10552;Vandenis;ŽUVĖDRŲ;2238926097;Ne;2;0;0;2
10553;Vandenis;ŽUVĖDRŲ;7646133208;Ne;5;0;0;5
10554;Vandenis;ŽUVĖDRŲ;2649542586;Ne;0;2;0;2
10555;Vandenis;ŽUVĖDRŲ;1144490168;Ne;6;3;0;9
10556;Vandenis;ŽUVĖDRŲ;7948161881;Ne;6;0;0;6
10557;Vandenis;ŽUVĖDRŲ;9335319713;Ne;6;3;0;9
10558;Vandenis;ŽUVĖDRŲ;6068154206;Ne;2;2;0;4
10559;Vandenis;ŽUVĖDRŲ;4117091634;Ne;5;2;0;7
10560;Vandenis;ŽUVĖDRŲ;2276497021;Ne;0;5;0;5
10561;Vandenis;ŽUVĖDRŲ;6661117114;Ne;4;6;0;10
10562;Vandenis;ŽUVĖDRŲ;5112768778;Ne;0;7;0;7
10563;Vandenis;ŽUVĖDRŲ;6456557095;Ne;10;0;0;10
10564;Vandenis;RUONIUKŲ;9756270419;Ne;8;0;0;8
10565;Vandenis;RUONIUKŲ;6851036864;Ne;9;0;0;9
10566;Vandenis;RUONIUKŲ;2144282854;Ne;6;0;0;6
10567;Vandenis;RUONIUKŲ;1969144957;Ne;2;0;0;2
10568;Vandenis;RUONIUKŲ;4319584977;Ne;20;0;0;20
10569;Vandenis;RUONIUKŲ;7950837626;Ne;5;0;0;5
10570;Vandenis;RUONIUKŲ;6882874044;Taip;15;0;0;15
10571;Vandenis;RUONIUKŲ;9178978753;Ne;9;0;0;9
10572;Vandenis;RUONIUKŲ;9095152994;Ne;8;0;0;8
10573;Vandenis;RUONIUKŲ;9756750533;Ne;11;0;0;11
10574;Vandenis;RUONIUKŲ;9316297713;Ne;18;0;0;18
10575;Vandenis;RUONIUKŲ;3101289470;Ne;0;6;0;6
10576;Vandenis;RUONIUKŲ;6134775528;Ne;2;0;0;2
10577;Vandenis;RUONIUKŲ;9542360827;Ne;2;0;0;2
10578;Vandenis;RUONIUKŲ;5516720117;Ne;3;0;0;3
10579;Vandenis;RUONIUKŲ;6008552395;Ne;1;0;0;1
10580;Vandenis;ŽUVYČIŲ;7565308536;Ne;0;8;0;8
10581;Vandenis;ŽUVYČIŲ;1120907086;Ne;0;1;0;1
10582;Vandenis;ŽUVYČIŲ;1563710105;Ne;1;0;0;1
10583;Vandenis;ŽUVYČIŲ;6330187732;Ne;0;2;0;2
10584;Vandenis;ŽUVYČIŲ;6158299885;Ne;1;0;0;1
10585;Vandenis;ŽUVYČIŲ;9688954631;Ne;0;3;0;3
10586;Vandenis;ŽUVYČIŲ;9162936403;Ne;0;3;0;3
10587;Vandenis;ŽUVYČIŲ;1051281257;Ne;14;0;0;14
10588;Vandenis;ŽUVYČIŲ;2422642232;Ne;0;4;0;4
10589;Vandenis;ŽUVYČIŲ;6986724058;Ne;1;1;0;2
10590;Vandenis;ŽUVYČIŲ;9731729915;Ne;1;0;0;1
10591;Vandenis;PERLIUKŲ;8239664149;Ne;10;0;0;10
10592;Vandenis;PERLIUKŲ;2451901210;Ne;5;0;0;5
10593;Vandenis;PERLIUKŲ;6724626527;Ne;13;0;0;13
10594;Vandenis;PERLIUKŲ;1799139825;Ne;9;0;0;9
10595;Vandenis;PERLIUKŲ;6570331247;Ne;0;1;0;1
10596;Vandenis;PERLIUKŲ;3038533882;Ne;15;0;0;15
10597;Vandenis;PERLIUKŲ;3393306645;Ne;5;0;0;5
10598;Vandenis;PERLIUKŲ;2506411643;Ne;5;0;0;5
10599;Vandenis;PERLIUKŲ;8841954633;Ne;3;0;0;3
10600;Vandenis;PERLIUKŲ;7001613448;Ne;3;0;0;3
10601;Vandenis;PERLIUKŲ;2661339448;Ne;6;0;0;6
10602;Vandenis;PERLIUKŲ;5675840354;Ne;0;5;0;5
10603;Vandenis;PERLIUKŲ;3173213991;Ne;0;5;0;5
10604;Vandenis;PERLIUKŲ;6067408982;Ne;8;2;0;10
10605;Vandenis;ANČIUKŲ;9763300020;Ne;12;0;0;12
10606;Vandenis;ANČIUKŲ;9968877035;Ne;0;2;0;2
10607;Vandenis;ANČIUKŲ;3639160500;Ne;0;1;0;1
10608;Vandenis;ANČIUKŲ;9458613523;Ne;0;15;0;15
10609;Vandenis;ANČIUKŲ;1213743099;Ne;0;2;0;2
10610;Vandenis;ANČIUKŲ;4954121871;Ne;5;0;0;5
10611;Vandenis;ANČIUKŲ;4978712442;Ne;3;1;0;4
10612;Vandenis;ANČIUKŲ;7581114286;Ne;5;0;0;5
10613;Vandenis;ANČIUKŲ;9679010239;Ne;5;2;0;7
10614;Vandenis;ANČIUKŲ;1132534461;Ne;5;0;0;5
10615;Vandenis;ANČIUKŲ;3544764716;Ne;15;1;0;16
10616;Vandenis;ANČIUKŲ;4530824157;Ne;0;1;0;1
10617;Vandenis;ANČIUKŲ;4954787474;Ne;6;0;0;6
10618;Vandenis;ANČIUKŲ;8967191975;Ne;4;0;0;4
10619;Vandenis;ANČIUKŲ;9784116399;Ne;0;2;0;2
10620;Vandenis;VĖŽLIUKŲ;2309166304;Ne;2;1;0;3
10621;Vandenis;VĖŽLIUKŲ;2872343656;Ne;0;0;1;1
10622;Vandenis;VĖŽLIUKŲ;5454049563;Ne;3;0;1;4
10623;Vandenis;VĖŽLIUKŲ;9805578141;Ne;3;0;1;4
10624;Vandenis;VĖŽLIUKŲ;7069369080;Ne;2;0;0;2
10625;Vandenis;VĖŽLIUKŲ;7924399684;Ne;0;7;0;7
10626;Vandenis;VĖŽLIUKŲ;1187395353;Ne;2;0;0;2
10627;Vandenis;VĖŽLIUKŲ;7091356848;Ne;3;0;0;3
10628;Vandenis;VĖŽLIUKŲ;5126732658;Ne;0;1;0;1
10629;Vandenis;VĖŽLIUKŲ;7059385610;Ne;0;1;1;2
10630;Vandenis;VĖŽLIUKŲ;1707354287;Taip;3;0;0;3
10631;Vandenis;VĖŽLIUKŲ;4177166475;Ne;0;1;0;1
10632;Vandenis;VĖŽLIUKŲ;5218101579;Ne;3;0;0;3
10633;Vandenis;VĖŽLIUKŲ;8416839037;Ne;1;0;0;1
10634;Vandenis;VĖŽLIUKŲ;8879608849;Ne;3;0;4;7
10635;Vandenis;AŠTUNKOJŲ;3429495073;Ne;0;1;0;1
10636;Vandenis;AŠTUNKOJŲ;6896047075;Ne;3;0;0;3
10637;Vandenis;AŠTUNKOJŲ;3239754791;Ne;0;6;0;6
10638;Vandenis;AŠTUNKOJŲ;7598257845;Ne;2;0;0;2
10639;Vandenis;AŠTUNKOJŲ;5323428164;Ne;0;1;0;1
10640;Vandenis;AŠTUNKOJŲ;2576575249;Ne;13;0;0;13
10641;Vandenis;AŠTUNKOJŲ;7832674282;Ne;5;0;0;5
10642;Vandenis;AŠTUNKOJŲ;1975385430;Ne;3;1;0;4
10643;Vandenis;AŠTUNKOJŲ;3061606138;Ne;0;1;0;1
10644;Vandenis;AŠTUNKOJŲ;8117385209;Ne;2;4;0;6
10645;Vandenis;AŠTUNKOJŲ;5613067534;Ne;8;2;0;10
10646;Vandenis;AŠTUNKOJŲ;2321919298;Taip;3;0;0;3
10647;Vandenis;GANDRIUKŲ;4753416316;Ne;10;2;0;12
10648;Vandenis;GANDRIUKŲ;8264797886;Ne;10;0;0;10
10649;Vandenis;GANDRIUKŲ;6153669587;Ne;15;0;0;15
10650;Vandenis;GANDRIUKŲ;1919577714;Taip;7;2;0;9
10651;Vandenis;GANDRIUKŲ;7019646962;Ne;3;4;0;7
10652;Vandenis;GANDRIUKŲ;2078767085;Ne;10;0;0;10
10653;Vandenis;GANDRIUKŲ;2976505868;Ne;5;0;0;5
10654;Vandenis;GANDRIUKŲ;6691874473;Ne;2;0;0;2
10655;Vandenis;GANDRIUKŲ;6483030616;Ne;5;0;0;5
10656;Vandenis;GANDRIUKŲ;8144830789;Ne;4;1;0;5
10657;Vandenis;GANDRIUKŲ;2381566229;Ne;3;0;0;3
10658;Vandenis;GANDRIUKŲ;1606103904;Ne;5;6;0;11
10659;Vandenis;GANDRIUKŲ;1753180703;Ne;6;0;0;6
10660;Vandenis;GANDRIUKŲ;7303512055;Ne;4;0;0;4
10661;Vandenis;GANDRIUKŲ;7311677107;Ne;9;0;0;9
10662;Vandenis;GANDRIUKŲ;6586215199;Ne;0;5;0;5
10663;Vandenis;ŽĄSIUKAI;8034690071;Ne;1;0;0;1
10664;Vandenis;ŽĄSIUKAI;9937317687;Ne;5;0;0;5
10665;Vandenis;ŽĄSIUKAI;2004158593;Ne;0;1;0;1
10666;Vandenis;ŽĄSIUKAI;4984723792;Taip;2;0;0;2
10667;Vandenis;ŽĄSIUKAI;7071349847;Ne;0;9;0;9
10668;Vandenis;ŽĄSIUKAI;4072405890;Ne;0;1;0;1
10669;Vandenis;ŽĄSIUKAI;4349464804;Ne;5;0;0;5
10670;Vandenis;ŽĄSIUKAI;7596199296;Ne;0;6;0;6
10671;Vandenis;ŽĄSIUKAI;6876019354;Taip;0;1;0;1
10672;Vandenis;ŽĄSIUKAI;5607412408;Ne;1;0;0;1
10673;Vandenis;ŽĄSIUKAI;1925178245;Ne;5;0;0;5
10674;Vandenis;ŽĄSIUKAI;5641929490;Ne;0;1;0;1
10675;Vandenis;ŽĄSIUKAI;7058441500;Ne;1;0;0;1
10676;Vandenis;ŽĄSIUKAI;1850352131;Ne;5;0;0;5
10677;Vandenis;ŽĄSIUKAI;9801593009;Ne;4;0;0;4
10678;Vandenis;ŽĄSIUKAI;9093048795;Ne;2;0;0;2
10679;Vandenis;PURIENŲ;6851178154;Ne;3;2;0;5
10680;Vandenis;PURIENŲ;4455886780;Ne;0;2;0;2
10681;Vandenis;PURIENŲ;1031451445;Ne;2;0;0;2
10682;Vandenis;PURIENŲ;3337286021;Ne;3;2;0;5
10683;Vandenis;PURIENŲ;7020534318;Ne;2;0;0;2
10684;Vandenis;PURIENŲ;6027680514;Ne;3;2;0;5
10685;Vandenis;PURIENŲ;2960005490;Ne;6;0;0;6
10686;Vandenis;PURIENŲ;1180322026;Ne;6;0;0;6
10687;Vandenis;PURIENŲ;3633805607;Ne;0;1;0;1
10688;Vandenis;PURIENŲ;6332179750;Ne;0;1;0;1
10689;Vandenis;PURIENŲ;2315167746;Ne;4;0;0;4
10690;Vandenis;PURIENŲ;2719678617;Ne;5;2;0;7
10691;Vandenis;PURIENŲ;7171302906;Ne;6;2;0;8
10692;Vandenis;PURIENŲ;8085633453;Ne;6;2;0;8
10693;Vandenis;PURIENŲ;2614561762;Ne;0;1;0;1
10694;Vandenis;PURIENŲ;9158541919;Ne;5;0;0;5
10695;Vandenis;PURIENŲ;5959181898;Ne;5;0;0;5
10696;Vandenis;VARLIUKAI;3851301038;Ne;3;0;0;3
10697;Vandenis;VARLIUKAI;1557924470;Ne;4;0;0;4
10698;Vandenis;VARLIUKAI;4467604017;Ne;4;0;0;4
10699;Vandenis;VARLIUKAI;1586318209;Ne;5;2;0;7
10700;Vandenis;VARLIUKAI;1713088739;Ne;9;0;0;9
10701;Vandenis;VARLIUKAI;6348714341;Ne;1;0;0;1
10702;Vandenis;VARLIUKAI;1926484881;Ne;9;1;0;10
10703;Vandenis;VARLIUKAI;8866969905;Ne;2;0;0;2
10704;Vandenis;VARLIUKAI;1587789226;Ne;0;1;0;1
10705;Vandenis;VARLIUKAI;4220080362;Ne;17;0;0;17
10706;Vandenis;VARLIUKAI;8642524068;Ne;14;0;0;14
10707;Vandenis;VARLIUKAI;8184314532;Ne;13;1;0;14
10708;Vandenis;VARLIUKAI;6499309064;Ne;8;0;0;8
10709;Vandenis;VARLIUKAI;1321803758;Ne;6;0;0;6
10710;Vandenis;VARLIUKAI;5310917664;Ne;5;2;0;7
10711;Vandenis;VARLIUKAI;3048168468;Ne;10;0;0;10
10712;Vandenis;PINGVINAI;9856199548;Taip;11;1;0;12
10713;Vandenis;PINGVINAI;2665865704;Ne;10;0;0;10
10714;Vandenis;PINGVINAI;1780124964;Ne;0;1;0;1
10715;Vandenis;PINGVINAI;9609168578;Ne;0;2;0;2
10716;Vandenis;PINGVINAI;2156775779;Ne;5;0;0;5
10717;Vandenis;PINGVINAI;3360623444;Ne;0;1;0;1
10718;Vandenis;PINGVINAI;5191604973;Ne;0;1;0;1
10719;Vandenis;PINGVINAI;2757376962;Ne;4;0;0;4
10720;Vandenis;PINGVINAI;6992750701;Ne;0;1;0;1
10721;Vandenis;PINGVINAI;3933306911;Ne;5;2;0;7
10722;Vandenis;PINGVINAI;2534991705;Ne;5;0;0;5
10723;Vandenis;PINGVINAI;7770227772;Ne;6;8;0;14
10724;Vandenis;PINGVINAI;8560123112;Ne;4;0;0;4
10725;Vandenis;Debesėlių;3163423293;Ne;5;1;0;6
10726;Vandenis;Debesėlių;6555465114;Ne;1;0;0;1
10727;Vandenis;Debesėlių;4226028904;Taip;14;1;0;15
10728;Vandenis;Debesėlių;2844636823;Ne;5;0;2;7
10729;Vandenis;Debesėlių;2426003664;Ne;0;0;1;1
10730;Vandenis;Debesėlių;8299531021;Taip;1;0;1;2
10731;Vandenis;Debesėlių;9521927635;Ne;8;1;0;9
10732;Vandenis;Debesėlių;6494266251;Ne;13;0;0;13
10733;Vandenis;Debesėlių;3835819023;Ne;8;0;0;8
10734;Vandenis;Debesėlių;2953842982;Taip;5;1;1;7
10735;Vandenis;Debesėlių;2645775090;Ne;0;1;0;1
10736;Vandenis;Debesėlių;8678508812;Ne;7;2;0;9
10737;Vandenis;Debesėlių;5609737826;Ne;7;0;1;8
10738;Vandenis;Debesėlių;6327478049;Ne;0;0;20;20
10739;Vandenis;Debesėlių;3231434944;Taip;0;0;20;20
10740;Vandenis;Debesėlių;6003491409;Ne;5;0;0;5
10741;Vandenis;Debesėlių;3701053997;Ne;3;0;0;3
10742;Vandenis;Debesėlių;1081283323;Ne;2;0;0;2
10743;Vandenis;Debesėlių;1081283323;Ne;2;0;0;2
10744;Vandenis;Debesėlių;1081283323;Ne;2;0;0;2
10745;Vandenis;Gintarėlių;1542662577;Taip;5;0;0;5
10746;Vandenis;Gintarėlių;5683829836;Ne;10;0;0;10
10747;Vandenis;Gintarėlių;5560529824;Ne;5;2;0;7
10748;Vandenis;Gintarėlių;5874429309;Ne;17;0;0;17
10749;Vandenis;Gintarėlių;7318344804;Ne;9;0;0;9
10750;Vandenis;Gintarėlių;7884422309;Taip;3;2;0;5
10751;Vandenis;Gintarėlių;8420609325;Ne;7;0;2;9
10752;Vandenis;Gintarėlių;5081501601;Ne;0;7;0;7
10753;Vandenis;Gintarėlių;9498231306;Ne;4;0;0;4
10754;Vandenis;Gintarėlių;3968719760;Ne;6;0;0;6
10755;Vandenis;Gintarėlių;4565893472;Ne;9;0;1;10
10756;Vandenis;Gintarėlių;3342147138;Ne;16;0;0;16
10757;Vandenis;Gintarėlių;7959438279;Ne;13;0;0;13
10758;Vandenis;Gintarėlių;4459177302;Ne;5;0;0;5
10759;Vandenis;Gintarėlių;3672852524;Ne;13;0;0;13
10760;Vandenis;Gintarėlių;9899621226;Ne;5;0;0;5
10761;Vandenis;Lašelių;1233236350;Ne;5;0;0;5
10762;Vandenis;Lašelių;5459023317;Ne;14;0;0;14
10763;Vandenis;Lašelių;2475761158;Ne;7;0;0;7
10764;Vandenis;Lašelių;6869501724;Ne;0;3;0;3
10765;Vandenis;Lašelių;8609549799;Ne;4;0;0;4
10766;Vandenis;Lašelių;5434744285;Ne;3;0;0;3
10767;Vandenis;Lašelių;5207600083;Ne;11;1;0;12
10768;Vandenis;Lašelių;2440317162;Ne;3;0;0;3
10769;Vandenis;Lašelių;7544597355;Ne;7;0;0;7
10770;Vandenis;Lašelių;7095534371;Ne;8;0;0;8
10771;Vandenis;Lašelių;1636387018;Ne;16;0;0;16
10772;Vandenis;Lašelių;6025496917;Ne;1;0;0;1
10773;Vandenis;Burbuliukų;5144953316;Ne;4;0;0;4
10774;Vandenis;Burbuliukų;3750162497;Ne;23;0;0;23
10775;Vandenis;Burbuliukų;6068144373;Ne;3;0;1;4
10776;Vandenis;Burbuliukų;2783738727;Ne;8;1;0;9
10777;Vandenis;Burbuliukų;2998970043;Ne;9;0;0;9
10778;Vandenis;Burbuliukų;7080129095;Ne;3;1;0;4
10779;Vandenis;Burbuliukų;7856148436;Ne;6;0;1;7
10780;Vandenis;Burbuliukų;1035549424;Ne;14;1;0;15
10781;Vandenis;Burbuliukų;7492804255;Ne;13;0;0;13
10782;Vandenis;Burbuliukų;4483401826;Ne;4;0;0;4
10783;Vandenis;Burbuliukų;9314410776;Ne;17;1;0;18
10784;Vandenis;Burbuliukų;5545019790;Ne;19;0;0;19
10785;Vandenis;Burbuliukų;9128547685;Ne;17;0;0;17
10786;Vandenis;Burbuliukų;6731336385;Ne;10;0;0;10
10787;Vandenis;Kriauklyčių;9130870495;Taip;19;0;0;19
10788;Vandenis;Kriauklyčių;2578294768;Ne;10;0;0;10
10789;Vandenis;Kriauklyčių;7736505435;Ne;14;0;0;14
10790;Vandenis;Kriauklyčių;5362018982;Ne;16;0;1;17
10791;Vandenis;Kriauklyčių;4219981694;Ne;1;0;1;2
10792;Vandenis;Kriauklyčių;8703465445;Ne;14;1;0;15
10793;Vandenis;Kriauklyčių;5983635986;Ne;8;0;0;8
10794;Vandenis;Kriauklyčių;4373688502;Ne;7;0;0;7
10795;Vandenis;Kriauklyčių;8921398489;Ne;10;5;2;17
10796;Vandenis;Kriauklyčių;6112591131;Ne;2;2;0;4
10797;Vandenis;Kriauklyčių;2528214535;Ne;19;0;0;19
10798;Vandenis;Kriauklyčių;6848032146;Ne;13;0;0;13
10799;Vandenis;Kriauklyčių;1836082819;Ne;4;0;0;4
10800;Vandenis;Kriauklyčių;2945086818;Ne;8;0;1;9
10801;Vandenis;Kriauklyčių;3262634002;Ne;16;0;0;16
10802;Vandenis;Kriauklyčių;3820448467;Taip;4;0;0;4
10803;Vandenis;Kriauklyčių;4168391832;Ne;0;2;0;2
10804;Vandenis;Kriauklyčių;2883058280;Ne;5;0;0;5
10805;Vandenis;Kriauklyčių;2997649372;Ne;21;0;0;21
10806;Vandenis;Kriauklyčių;9400150352;Ne;9;1;0;10
10807;Vėjelis;Pumpurėliai;2541077369;Ne;0;1;0;1
10808;Vėjelis;Pumpurėliai;3125815427;Ne;4;1;0;5
10809;Vėjelis;Pumpurėliai;5516672613;Ne;6;0;0;6
10810;Vėjelis;Pumpurėliai;3206025676;Ne;3;0;0;3
10811;Vėjelis;Pumpurėliai;5611813359;Ne;5;0;0;5
10812;Vėjelis;Pumpurėliai;9583495324;Ne;5;0;0;5
10813;Vėjelis;Pumpurėliai;7539681314;Ne;10;1;0;11
10814;Vėjelis;Pumpurėliai;6840643273;Ne;5;6;0;11
10815;Vėjelis;Pumpurėliai;9824130744;Ne;8;0;0;8
10816;Vėjelis;Pumpurėliai;1842552329;Ne;9;0;0;9
10817;Vėjelis;Pumpurėliai;8994680698;Ne;0;1;0;1
10818;Vėjelis;Pumpurėliai;2656895893;Ne;5;0;0;5
10819;Vėjelis;Pumpurėliai;2734891342;Taip;6;3;0;9
10820;Vėjelis;Pumpurėliai;7748975870;Taip;0;0;3;3
10821;Vėjelis;Drugeliai;1331334220;Ne;8;2;0;10
10822;Vėjelis;Drugeliai;2151737048;Ne;0;8;0;8
10823;Vėjelis;Drugeliai;4988352741;Ne;0;0;1;1
10824;Vėjelis;Drugeliai;4473677352;Ne;9;2;0;11
10825;Vėjelis;Drugeliai;4506243333;Ne;0;1;0;1
10826;Vėjelis;Drugeliai;6061966626;Ne;6;0;0;6
10827;Vėjelis;Drugeliai;6891260701;Ne;0;2;0;2
10828;Vėjelis;Drugeliai;9986867356;Ne;4;0;0;4
10829;Vėjelis;Drugeliai;1876663813;Ne;0;1;0;1
10830;Vėjelis;Drugeliai;8467887788;Ne;0;9;0;9
10831;Vėjelis;Drugeliai;5619026707;Ne;10;0;0;10
10832;Vėjelis;Drugeliai;1073818739;Taip;6;0;0;6
10833;Vėjelis;Drugeliai;6775556050;Ne;0;0;7;7
10834;Vėjelis;Drugeliai;5888429623;Ne;5;0;1;6
10835;Vėjelis;Drugeliai;9592852011;Ne;0;1;2;3
10836;Vėjelis;Drugeliai;7247057946;Ne;5;0;13;18
10837;Vėjelis;Drugeliai;8986581196;Ne;0;0;11;11
10838;Vėjelis;Malūnėlis;1994035417;Ne;0;5;0;5
10839;Vėjelis;Malūnėlis;7097474285;Ne;10;0;0;10
10840;Vėjelis;Malūnėlis;1448699738;Ne;3;2;0;5
10841;Vėjelis;Malūnėlis;3275186042;Ne;5;0;0;5
10842;Vėjelis;Malūnėlis;1882750621;Taip;9;0;1;10
10843;Vėjelis;Malūnėlis;5109441799;Ne;8;0;0;8
10844;Vėjelis;Malūnėlis;4171024976;Ne;6;0;0;6
10845;Vėjelis;Malūnėlis;1871467392;Ne;2;0;0;2
10846;Vėjelis;Malūnėlis;6600504736;Ne;4;0;0;4
10847;Vėjelis;Malūnėlis;8063276082;Ne;0;1;0;1
10848;Vėjelis;Malūnėlis;6244227830;Ne;11;0;0;11
10849;Vėjelis;Malūnėlis;1417987860;Ne;0;0;2;2
10850;Vėjelis;Malūnėlis;9636946669;Ne;14;0;0;14
10851;Vėjelis;Malūnėlis;8822873586;Ne;15;0;0;15
10852;Vėjelis;Malūnėlis;6823103188;Ne;0;4;0;4
10853;Vėjelis;Malūnėlis;2887703782;Ne;5;1;0;6
10854;Vėjelis;Žvaigždutės;4868574574;Ne;4;0;0;4
10855;Vėjelis;Žvaigždutės;3495322620;Ne;0;4;0;4
10856;Vėjelis;Žvaigždutės;1956418258;Ne;0;12;0;12
10857;Vėjelis;Žvaigždutės;7203026860;Ne;6;1;0;7
10858;Vėjelis;Žvaigždutės;7860576967;Ne;6;0;0;6
10859;Vėjelis;Žvaigždutės;1075188861;Ne;4;1;0;5
10860;Vėjelis;Žvaigždutės;9451358807;Ne;18;0;0;18
10861;Vėjelis;Žvaigždutės;8995478684;Ne;0;1;0;1
10862;Vėjelis;Žvaigždutės;8281508498;Ne;0;2;0;2
10863;Vėjelis;Žvaigždutės;6909799367;Ne;0;16;0;16
10864;Vėjelis;Žvaigždutės;9546928491;Ne;10;0;0;10
10865;Vėjelis;Žvaigždutės;9675488924;Ne;0;1;0;1
10866;Vėjelis;Žvaigždutės;9202471939;Ne;0;6;0;6
10867;Vėjelis;Žvaigždutės;1615837863;Ne;0;6;0;6
10868;Vėjelis;Žvaigždutės;9403445317;Ne;8;0;0;8
10869;Vėjelis;Varpeliai;7507448059;Ne;3;0;0;3
10870;Vėjelis;Varpeliai;9492690970;Ne;0;1;0;1
10871;Vėjelis;Varpeliai;4353239658;Ne;0;1;0;1
10872;Vėjelis;Varpeliai;9135807341;Ne;0;2;0;2
10873;Vėjelis;Varpeliai;2117924725;Ne;5;0;0;5
10874;Vėjelis;Varpeliai;2132551615;Ne;18;0;0;18
10875;Vėjelis;Varpeliai;4101161670;Ne;0;2;0;2
10876;Vėjelis;Varpeliai;1549518622;Ne;2;0;0;2
10877;Vėjelis;Varpeliai;6386092350;Ne;0;5;0;5
10878;Vėjelis;Varpeliai;7046938604;Ne;0;3;0;3
10879;Vėjelis;Varpeliai;6777528441;Ne;0;1;0;1
10880;Vėjelis;Varpeliai;6844704326;Ne;0;0;2;2
10881;Vėjelis;Varpeliai;3315240387;Taip;0;11;0;11
10882;Vėjelis;Varpeliai;8300497094;Ne;0;2;0;2
10883;Vėjelis;Varpeliai;3453119286;Ne;3;0;0;3
10884;Vėjelis;Pelėdžiukų;3067215309;Ne;7;0;0;7
10885;Vėjelis;Pelėdžiukų;7211756910;Ne;6;4;0;10
10886;Vėjelis;Pelėdžiukų;4852532740;Taip;18;0;0;18
10887;Vėjelis;Pelėdžiukų;4450739919;Ne;0;1;0;1
10888;Vėjelis;Pelėdžiukų;9852892338;Ne;0;2;0;2
10889;Vėjelis;Pelėdžiukų;8433853523;Ne;5;0;0;5
10890;Vėjelis;Pelėdžiukų;4746355716;Ne;15;0;0;15
10891;Vėjelis;Pelėdžiukų;5507017221;Ne;0;2;0;2
10892;Vėjelis;Pelėdžiukų;1259743374;Ne;13;0;0;13
10893;Vėjelis;Pelėdžiukų;6226234271;Taip;18;0;0;18
10894;Vėjelis;Pelėdžiukų;7559733997;Ne;5;0;0;5
10895;Vėjelis;Pelėdžiukų;3764096742;Ne;5;0;1;6
10896;Vėjelis;Pelėdžiukų;8067153728;Ne;7;0;0;7
10897;Vėjelis;Pelėdžiukų;2283628712;Taip;4;6;0;10
10898;Vėjelis;Pelėdžiukų;9769871497;Ne;8;0;0;8
10899;Vėjelis;Pelėdžiukų;4318295503;Ne;11;0;0;11
10900;Vėjelis;Pelėdžiukų;9867392835;Ne;10;2;0;12
10901;Vėjelis;Pelėdžiukų;5662728912;Ne;10;0;0;10
10902;Vėjelis;Skruzdeliukų;3096861110;Ne;12;0;0;12
10903;Vėjelis;Skruzdeliukų;1938557472;Ne;7;1;0;8
10904;Vėjelis;Skruzdeliukų;9964641007;Ne;10;0;0;10
10905;Vėjelis;Skruzdeliukų;7577991381;Ne;9;0;0;9
10906;Vėjelis;Skruzdeliukų;2928489724;Ne;0;20;0;20
10907;Vėjelis;Skruzdeliukų;2238139120;Ne;5;1;0;6
10908;Vėjelis;Skruzdeliukų;4531125902;Ne;2;0;0;2
10909;Vėjelis;Skruzdeliukų;9528142262;Ne;1;0;0;1
10910;Vėjelis;Skruzdeliukų;4758209854;Ne;15;0;0;15
10911;Vėjelis;Skruzdeliukų;2486741803;Ne;6;0;0;6
10912;Vėjelis;Skruzdeliukų;1793991609;Ne;3;1;0;4
10913;Vėjelis;Skruzdeliukų;2987292658;Ne;3;1;0;4
10914;Vėjelis;Skruzdeliukų;4605288262;Ne;8;0;0;8
10915;Vėjelis;Pieštukų;7854614677;Ne;10;0;0;10
10916;Vėjelis;Pieštukų;6453605110;Ne;12;0;0;12
10917;Vėjelis;Pieštukų;2720886612;Ne;0;2;0;2
10918;Vėjelis;Pieštukų;6520167840;Ne;20;0;0;20
10919;Vėjelis;Pieštukų;3691974508;Ne;1;0;1;2
10920;Vėjelis;Pieštukų;7613786936;Ne;2;0;1;3
10921;Vėjelis;Pieštukų;2912640999;Ne;5;0;0;5
10922;Vėjelis;Pieštukų;6839116451;Ne;16;0;0;16
10923;Vėjelis;Pieštukų;6938777118;Ne;6;0;0;6
10924;Vėjelis;Pieštukų;2553724469;Ne;20;0;0;20
10925;Vėjelis;Pieštukų;3012722334;Ne;13;0;0;13
10926;Vėjelis;Pieštukų;7889625599;Ne;5;1;0;6
10927;Vėjelis;Pieštukų;7763996061;Ne;0;9;0;9
10928;Vėjelis;Pieštukų;7553070848;Ne;6;0;0;6
10929;Vėjelis;Pieštukų;8310513436;Ne;6;0;0;6
10930;Vėjelis;Pieštukų;1291592424;Ne;8;0;0;8
10931;Vėjelis;Ramunėlių;5331895599;Ne;0;7;0;7
10932;Vėjelis;Ramunėlių;4450872985;Ne;1;0;0;1
10933;Vėjelis;Ramunėlių;1506416880;Ne;8;0;0;8
10934;Vėjelis;Ramunėlių;6576149860;Ne;3;0;0;3
10935;Vėjelis;Ramunėlių;4843434827;Ne;7;0;0;7
10936;Vėjelis;Ramunėlių;1452685229;Ne;1;0;0;1
10937;Vėjelis;Ramunėlių;6573481399;Ne;0;1;0;1
10938;Vėjelis;Ramunėlių;2534737343;Ne;8;0;0;8
10939;Vėjelis;Ramunėlių;2195618699;Taip;19;0;0;19
10940;Vėjelis;Ramunėlių;8505186157;Ne;10;0;0;10
10941;Vėjelis;Ramunėlių;5452294829;Ne;1;0;0;1
10942;Vėjelis;Ramunėlių;4717248684;Ne;13;0;0;13
10943;Vėjelis;Ramunėlių;5291321394;Ne;5;2;0;7
10944;Vėjelis;Nykštukai;6741600874;Ne;8;0;0;8
10945;Vėjelis;Nykštukai;9957614551;Ne;0;3;0;3
10946;Vėjelis;Nykštukai;7233448544;Ne;0;2;0;2
10947;Vėjelis;Nykštukai;5339200991;Ne;0;1;0;1
10948;Vėjelis;Nykštukai;6602964509;Ne;0;3;0;3
10949;Vėjelis;Nykštukai;2573683778;Ne;8;3;0;11
10950;Vėjelis;Nykštukai;3843601190;Ne;6;0;0;6
10951;Vėjelis;Nykštukai;3574432129;Ne;2;0;0;2
10952;Vėjelis;Nykštukai;4713754452;Ne;0;4;0;4
10953;Vėjelis;Nykštukai;3813509637;Ne;0;5;0;5
10954;Vėjelis;Nykštukai;8755889077;Ne;1;0;0;1
10955;Vėjelis;Nykštukai;9979979480;Ne;20;0;0;20
10956;Vėjelis;Nykštukai;6581265682;Ne;4;10;0;14
10957;Vėjelis;Nykštukai;8452132066;Ne;0;20;0;20
10958;Vėjelis;Nykštukai;7552365055;Ne;4;0;3;7
10959;Vėjelis;Nykštukai;6389449089;Ne;1;0;0;1
10960;Vėjelis;Nykštukai;9351658311;Ne;0;12;0;12
10961;Vėjelis;Nykštukai;1074246375;Ne;4;0;0;4
10962;Vėjelis;BITUTĖS;6824919005;Ne;3;0;0;3
10963;Vėjelis;BITUTĖS;4276237884;Taip;10;3;0;13
10964;Vėjelis;BITUTĖS;3772706363;Ne;0;2;0;2
10965;Vėjelis;BITUTĖS;1834203833;Ne;2;2;1;5
10966;Vėjelis;BITUTĖS;6283428333;Ne;8;0;0;8
10967;Vėjelis;BITUTĖS;3767625080;Ne;0;1;0;1
10968;Vėjelis;BITUTĖS;6569848405;Ne;8;0;0;8
10969;Vėjelis;BITUTĖS;1457373815;Taip;15;0;0;15
10970;Vėjelis;BITUTĖS;1022888418;Ne;0;2;0;2
10971;Vėjelis;BITUTĖS;1116238331;Ne;6;6;0;12
10972;Vėjelis;BITUTĖS;8286070405;Ne;0;7;0;7
10973;Vėjelis;BITUTĖS;1674810054;Ne;3;0;1;4
10974;Vėjelis;BITUTĖS;1070853175;Ne;0;0;1;1
10975;Vėjelis;BITUTĖS;6660799519;Ne;5;0;0;5
10976;Vėjelis;BITUTĖS;1235788079;Ne;4;0;0;4
10977;Vėjelis;BITUTĖS;4745262277;Ne;5;1;0;6
10978;Vėjelis;BITUTĖS;7790713917;Taip;0;2;1;3
10979;Vėjelis;Boruželės;2199680661;Ne;0;1;0;1
10980;Vėjelis;Boruželės;1429496839;Ne;0;6;2;8
10981;Vėjelis;Boruželės;6108049183;Taip;0;8;0;8
10982;Vėjelis;Boruželės;1494531065;Ne;0;0;1;1
10983;Vėjelis;Boruželės;3276062426;Ne;4;0;0;4
10984;Vėjelis;Boruželės;4132824111;Ne;8;0;3;11
10985;Vėjelis;Boruželės;7752923796;Ne;0;0;6;6
10986;Vėjelis;Boruželės;8957653216;Ne;10;0;1;11
10987;Vėjelis;Boruželės;6431589805;Ne;3;0;1;4
10988;Vėjelis;Boruželės;4746932126;Ne;0;1;0;1
10989;Vėjelis;Boruželės;2416832899;Ne;2;0;0;2
10990;Vėjelis;Boruželės;7594586198;Ne;0;1;0;1
10991;Vėjelis;Boruželės;7981032872;Ne;0;0;7;7
10992;Vėjelis;Boruželės;7697394469;Ne;3;0;0;3
10993;Vėjelis;Boruželės;2788205363;Ne;0;0;5;5
10994;Vėtrungė;Debesėlių;6439014588;Ne;0;0;9;9
10995;Vėtrungė;Debesėlių;9423361592;Ne;3;0;0;3
10996;Vėtrungė;Debesėlių;1191007983;Ne;3;0;2;5
10997;Vėtrungė;Debesėlių;3745680607;Ne;3;1;0;4
10998;Vėtrungė;Debesėlių;9359012317;Ne;5;0;0;5
10999;Vėtrungė;Debesėlių;1807742144;Taip;0;0;5;5
11000;Vėtrungė;Debesėlių;3433811829;Ne;0;5;1;6
11001;Vėtrungė;Debesėlių;2447851565;Ne;9;0;3;12
11002;Vėtrungė;Debesėlių;5939537473;Taip;5;2;0;7
11003;Vėtrungė;Debesėlių;1871358961;Ne;0;0;4;4
11004;Vėtrungė;Debesėlių;7632969321;Ne;5;0;0;5
11005;Vėtrungė;Debesėlių;9642541034;Ne;0;0;2;2
11006;Vėtrungė;Debesėlių;6115556675;Ne;2;0;0;2
11007;Vėtrungė;Zuikių;9332362038;Taip;1;0;0;1
11008;Vėtrungė;Zuikių;9407558097;Ne;0;4;0;4
11009;Vėtrungė;Zuikių;7573021445;Ne;0;8;1;9
11010;Vėtrungė;Zuikių;3335047815;Ne;2;1;0;3
11011;Vėtrungė;Zuikių;8157356569;Ne;2;1;0;3
11012;Vėtrungė;Zuikių;9742099165;Ne;2;1;0;3
11013;Vėtrungė;Zuikių;1215953192;Ne;10;0;0;10
11014;Vėtrungė;Zuikių;1729819557;Ne;2;1;0;3
11015;Vėtrungė;Zuikių;4916692634;Ne;0;2;0;2
11016;Vėtrungė;Zuikių;1007578933;Ne;0;5;0;5
11017;Vėtrungė;Zuikių;7558548846;Ne;0;5;0;5
11018;Vėtrungė;Zuikių;8742161467;Ne;5;1;0;6
11019;Vėtrungė;Zuikių;2537221101;Ne;7;1;0;8
11020;Vėtrungė;Zuikių;7342250921;Ne;0;10;0;10
11021;Vėtrungė;Zuikių;7435005821;Ne;3;0;0;3
11022;Vėtrungė;Zuikių;1280823326;Ne;9;5;0;14
11023;Vėtrungė;Zuikių;4508176017;Taip;6;0;0;6
11024;Vėtrungė;Zuikių;8958748086;Ne;1;0;0;1
11025;Vėtrungė;Drugelių;7943682529;Ne;0;1;0;1
11026;Vėtrungė;Drugelių;9090873546;Ne;1;0;0;1
11027;Vėtrungė;Drugelių;2124476787;Ne;1;0;0;1
11028;Vėtrungė;Drugelių;2970067995;Ne;0;1;0;1
11029;Vėtrungė;Drugelių;8729505032;Ne;2;0;0;2
11030;Vėtrungė;Drugelių;5251308945;Taip;2;1;0;3
11031;Vėtrungė;Drugelių;9812496068;Ne;0;2;0;2
11032;Vėtrungė;Drugelių;8753387108;Ne;2;1;0;3
11033;Vėtrungė;Drugelių;3634995652;Ne;13;1;0;14
11034;Vėtrungė;Drugelių;3744377479;Ne;2;0;0;2
11035;Vėtrungė;Drugelių;7186353024;Ne;0;6;0;6
11036;Vėtrungė;Drugelių;2933312366;Taip;5;7;0;12
11037;Vėtrungė;Drugelių;2508501223;Ne;0;2;0;2
11038;Vėtrungė;Drugelių;6538402680;Ne;1;1;0;2
11039;Vėtrungė;Drugelių;5887245282;Ne;5;2;0;7
11040;Vėtrungė;Drugelių;7974212517;Ne;0;1;0;1
11041;Vėtrungė;Drugelių;9423979719;Ne;0;1;0;1
11042;Vėtrungė;Drugelių;1611114179;Ne;7;0;0;7
11043;Vėtrungė;Do-re-mi;7752842285;Ne;10;0;0;10
11044;Vėtrungė;Do-re-mi;1408629891;Ne;14;0;0;14
11045;Vėtrungė;Do-re-mi;7411180918;Ne;4;3;0;7
11046;Vėtrungė;Do-re-mi;2832753464;Ne;11;0;0;11
11047;Vėtrungė;Do-re-mi;2643851525;Ne;15;0;0;15
11048;Vėtrungė;Do-re-mi;6782673546;Ne;7;1;0;8
11049;Vėtrungė;Do-re-mi;3885409650;Ne;15;1;0;16
11050;Vėtrungė;Do-re-mi;4944115709;Taip;15;1;0;16
11051;Vėtrungė;Do-re-mi;7175547800;Ne;3;1;0;4
11052;Vėtrungė;Do-re-mi;1185643576;Ne;1;1;0;2
11053;Vėtrungė;Do-re-mi;9158760410;Ne;20;0;0;20
11054;Vėtrungė;Do-re-mi;3000030998;Ne;7;0;0;7
11055;Vėtrungė;Do-re-mi;4602351198;Ne;0;1;0;1
11056;Vėtrungė;Smalsučių;1020095914;Ne;0;12;0;12
11057;Vėtrungė;Smalsučių;2510763357;Ne;0;1;2;3
11058;Vėtrungė;Smalsučių;4713420194;Ne;0;1;2;3
11059;Vėtrungė;Smalsučių;9313438768;Ne;0;4;0;4
11060;Vėtrungė;Smalsučių;2226654309;Ne;0;1;0;1
11061;Vėtrungė;Smalsučių;1766599777;Ne;6;0;0;6
11062;Vėtrungė;Smalsučių;3328447991;Ne;4;0;0;4
11063;Vėtrungė;Smalsučių;7143997258;Ne;2;0;0;2
11064;Vėtrungė;Smalsučių;5832298824;Ne;0;1;0;1
11065;Vėtrungė;Smalsučių;2136966687;Ne;6;6;0;12
11066;Vėtrungė;Smalsučių;2207041148;Ne;4;2;0;6
11067;Vėtrungė;Smalsučių;5836190044;Ne;0;0;2;2
11068;Vėtrungė;Smalsučių;6374739740;Taip;1;1;0;2
11069;Vėtrungė;Gudručių;9079483362;Ne;1;0;2;3
11070;Vėtrungė;Gudručių;8956375453;Ne;1;1;2;4
11071;Vėtrungė;Gudručių;7807708310;Ne;6;0;2;8
11072;Vėtrungė;Gudručių;9271869305;Ne;4;0;2;6
11073;Vėtrungė;Gudručių;2883254822;Ne;5;1;0;6
11074;Vėtrungė;Gudručių;7895027909;Ne;0;0;1;1
11075;Vėtrungė;Gudručių;5452337780;Ne;2;0;0;2
11076;Vėtrungė;Gudručių;3200251047;Ne;0;0;4;4
11077;Vėtrungė;Gudručių;5430818470;Ne;0;0;3;3
11078;Vėtrungė;Gudručių;9324733839;Ne;7;0;0;7
11079;Vėtrungė;Gudručių;9865628172;Ne;3;0;2;5
11080;Vėtrungė;Kodėlčių;9172488122;Taip;0;3;3;6
11081;Vėtrungė;Kodėlčių;2739382736;Ne;7;2;2;11
11082;Vėtrungė;Kodėlčių;3903604247;Ne;5;0;0;5
11083;Vėtrungė;Kodėlčių;3500551575;Ne;0;5;0;5
11084;Vėtrungė;Kodėlčių;7872043253;Taip;0;1;0;1
11085;Vėtrungė;Kodėlčių;7862615352;Ne;0;3;1;4
11086;Vėtrungė;Kodėlčių;5385880910;Ne;6;0;0;6
11087;Vėtrungė;Kodėlčių;9211406129;Ne;0;2;0;2
11088;Vėtrungė;Kodėlčių;1032730549;Ne;16;4;0;20
11089;Vėtrungė;Kodėlčių;9127735773;Ne;5;1;0;6
11090;Vėtrungė;Kodėlčių;4756863295;Ne;0;1;0;1
11091;Vėtrungė;Kodėlčių;8985054558;Ne;0;1;0;1
11092;Vėtrungė;Kodėlčių;3922749661;Ne;6;0;0;6
11093;Vėtrungė;Kodėlčių;8013249618;Taip;0;2;3;5
11094;Vėtrungė;Kodėlčių;3887230224;Ne;0;3;0;3
11095;Vėtrungė;Kodėlčių;7740260264;Ne;6;0;0;6
11096;Vėtrungė;Kodėlčių;6807838878;Ne;5;1;0;6
11097;Vėtrungė;Kodėlčių;3638303693;Ne;9;1;0;10
11098;Vėtrungė;Paukštelių;6983172988;Ne;0;2;0;2
11099;Vėtrungė;Paukštelių;3957148270;Ne;4;2;0;6
11100;Vėtrungė;Paukštelių;7258995031;Ne;0;1;0;1
11101;Vėtrungė;Paukštelių;5338424871;Ne;0;2;0;2
11102;Vėtrungė;Paukštelių;6812588777;Ne;0;1;0;1
11103;Vėtrungė;Paukštelių;2798915063;Ne;8;2;0;10
11104;Vėtrungė;Paukštelių;2981610749;Ne;0;0;15;15
11105;Vėtrungė;Paukštelių;6146327857;Ne;1;2;1;4
11106;Vėtrungė;Paukštelių;2786721399;Ne;0;0;3;3
11107;Vėtrungė;Paukštelių;9461365083;Ne;3;3;0;6
11108;Vėtrungė;Paukštelių;9822462988;Ne;7;0;0;7
11109;Vėtrungė;Paukštelių;2741119142;Ne;2;1;0;3
11110;Vėtrungė;Viščiukų;2725607774;Ne;0;4;0;4
11111;Vėtrungė;Viščiukų;4597361099;Ne;1;0;2;3
11112;Vėtrungė;Viščiukų;2490075899;Ne;0;0;1;1
11113;Vėtrungė;Viščiukų;8761701511;Ne;0;0;1;1
11114;Vėtrungė;Viščiukų;3527585648;Ne;3;0;0;3
11115;Vėtrungė;Viščiukų;4145172377;Ne;5;2;1;8
11116;Vėtrungė;Viščiukų;3859501564;Ne;1;1;0;2
11117;Vėtrungė;Viščiukų;3917214308;Ne;5;0;2;7
11118;Vėtrungė;Viščiukų;9862408289;Ne;0;0;1;1
11119;Vėtrungė;Viščiukų;7065114742;Ne;9;0;1;10
11120;Vėtrungė;Viščiukų;2558088727;Ne;11;4;0;15
11121;Vėtrungė;Viščiukų;8276160906;Ne;0;0;20;20
11122;Vėtrungė;Viščiukų;4516633703;Ne;6;0;0;6
11123;Vėtrungė;Viščiukų;6279761125;Ne;6;0;0;6
11124;Vėtrungė;Nykštukų;9696984346;Taip;0;4;4;8
11125;Vėtrungė;Nykštukų;7819147751;Ne;0;2;0;2
11126;Vėtrungė;Nykštukų;6990506209;Ne;14;0;0;14
11127;Vėtrungė;Nykštukų;2348557463;Ne;0;10;0;10
11128;Vėtrungė;Nykštukų;7733472482;Ne;1;0;0;1
11129;Vėtrungė;Nykštukų;2309821873;Ne;0;3;0;3
11130;Vėtrungė;Nykštukų;8059553343;Ne;0;4;0;4
11131;Vėtrungė;Nykštukų;9569555731;Ne;5;3;5;13
11132;Vėtrungė;Nykštukų;7699392279;Ne;0;2;0;2
11133;Vėtrungė;Nykštukų;9773838651;Ne;0;2;0;2
11134;Vėtrungė;Nykštukų;6783756347;Ne;0;1;1;2
11135;Vėtrungė;Nykštukų;4289435509;Ne;0;5;0;5
11136;Vėtrungė;Nykštukų;5132419026;Ne;6;2;1;9
11137;Vėtrungė;Nykštukų;7647363322;Ne;6;2;1;9
11138;Vėtrungė;Nykštukų;3046782145;Ne;7;0;1;8
11139;Vėtrungė;Nykštukų;7037942782;Ne;0;5;0;5
11140;Vėtrungė;Nykštukų;2205455847;Ne;0;10;1;11
11141;Vėtrungė;Ąžuoliukų;8775969909;Ne;0;0;2;2
11142;Vėtrungė;Ąžuoliukų;1034537691;Ne;7;0;0;7
11143;Vėtrungė;Ąžuoliukų;6363761237;Ne;4;1;0;5
11144;Vėtrungė;Ąžuoliukų;8913748584;Ne;0;1;4;5
11145;Vėtrungė;Ąžuoliukų;3073965379;Ne;12;0;0;12
11146;Vėtrungė;Ąžuoliukų;3938684888;Ne;11;2;0;13
11147;Vėtrungė;Ąžuoliukų;6073563461;Ne;0;9;0;9
11148;Vėtrungė;Ąžuoliukų;2977116563;Ne;0;1;0;1
11149;Vėtrungė;Ąžuoliukų;4925843510;Ne;9;0;0;9
11150;Vėtrungė;Ąžuoliukų;7096106273;Taip;5;0;8;13
11151;Vėtrungė;Ąžuoliukų;8026065367;Ne;0;1;0;1
11152;Vėtrungė;Ąžuoliukų;6476717645;Ne;5;5;0;10
11153;Vėtrungė;Ąžuoliukų;5167580818;Ne;2;0;0;2
11154;Vėtrungė;Ąžuoliukų;1169648551;Ne;7;0;0;7
11155;Vėtrungė;Ąžuoliukų;4489937085;Ne;5;1;1;7
11156;Vėtrungė;Ąžuoliukų;4740985408;Ne;3;0;3;6
11157;Vėtrungė;Ąžuoliukų;9684184905;Ne;5;0;0;5
11158;Vėtrungė;Ąžuoliukų;5021830780;Taip;8;0;1;9
11159;Vėtrungė;Ąžuoliukų;1568598938;Ne;5;0;0;5
11160;Vėtrungė;Ąžuoliukų;9459062715;Ne;9;1;0;10
11161;Vėtrungė;"&quot;MEŠKIUKŲ&quot;";9667227707;Taip;14;0;0;14
11162;Vėtrungė;"&quot;MEŠKIUKŲ&quot;";4529215724;Taip;14;0;0;14
11163;Vėtrungė;"&quot;MEŠKIUKŲ&quot;";7900887923;Ne;8;4;0;12
11164;Vėtrungė;"&quot;MEŠKIUKŲ&quot;";4550285483;Ne;3;0;0;3
11165;Vėtrungė;"&quot;MEŠKIUKŲ&quot;";3019474140;Ne;11;0;0;11
11166;Vėtrungė;"&quot;MEŠKIUKŲ&quot;";6529918013;Ne;12;0;0;12
11167;Vėtrungė;"&quot;MEŠKIUKŲ&quot;";2711203550;Ne;9;0;0;9
11168;Vėtrungė;"&quot;MEŠKIUKŲ&quot;";8632209474;Ne;18;0;0;18
11169;Vilnelė;Lakštutė;8843094480;Ne;1;2;1;4
11170;Vilnelė;Lakštutė;5786086401;Ne;0;1;2;3
11171;Vilnelė;Lakštutė;6249731759;Ne;18;0;0;18
11172;Vilnelė;Lakštutė;6837850601;Ne;0;2;0;2
11173;Vilnelė;Lakštutė;5554451335;Ne;1;2;0;3
11174;Vilnelė;Lakštutė;1762024490;Taip;10;2;0;12
11175;Vilnelė;Lakštutė;8201829887;Ne;10;0;0;10
11176;Vilnelė;Lakštutė;7702217893;Ne;3;0;0;3
11177;Vilnelė;Lakštutė;4427383755;Ne;0;8;0;8
11178;Vilnelė;Lakštutė;1547117566;Ne;0;8;0;8
11179;Vilnelė;Lakštutė;3231387543;Ne;5;0;0;5
11180;Vilnelė;Lakštutė;1734277231;Taip;8;2;0;10
11181;Vilnelė;Lakštutė;3900484348;Ne;0;1;1;2
11182;Vilnelė;Lakštutė;5498574366;Taip;0;1;0;1
11183;Vilnelė;Lakštutė;6686896190;Ne;0;2;3;5
11184;Vilnelė;Lakštutė;3032273912;Ne;0;9;0;9
11185;Vilnelė;Lakštutė;4017436910;Ne;6;1;0;7
11186;Vilnelė;Lakštutė;9843449060;Taip;0;2;7;9
11187;Vilnelė;Lakštutė;2803880424;Ne;0;2;0;2
11188;Vilnelė;Lakštutė;2418216191;Ne;10;0;0;10
11189;Vilnelė;Lakštutė;5913967803;Ne;1;0;2;3
11190;Vilnelė;Vyturėlis;7536603663;Ne;0;2;2;4
11191;Vilnelė;Vyturėlis;3503461211;Ne;0;4;0;4
11192;Vilnelė;Vyturėlis;1574809879;Ne;0;2;1;3
11193;Vilnelė;Vyturėlis;3558073399;Ne;0;0;1;1
11194;Vilnelė;Vyturėlis;6083082959;Ne;0;2;0;2
11195;Vilnelė;Vyturėlis;3993826389;Ne;3;0;0;3
11196;Vilnelė;Vyturėlis;2923012145;Ne;10;1;0;11
11197;Vilnelė;Vyturėlis;8667403338;Ne;0;0;4;4
11198;Vilnelė;Vyturėlis;4166351390;Ne;0;0;2;2
11199;Vilnelė;Vyturėlis;1351798589;Ne;4;0;1;5
11200;Vilnelė;Vyturėlis;2841315531;Ne;0;3;4;7
11201;Vilnelė;Vyturėlis;9162681538;Ne;0;3;0;3
11202;Vilnelė;Vyturėlis;3075681823;Ne;0;3;0;3
11203;Vilnelė;Vyturėlis;9804772168;Ne;2;1;1;4
11204;Vilnelė;Vyturėlis;7338573817;Ne;0;1;3;4
11205;Vilnelė;Vyturėlis;8121075430;Taip;14;2;0;16
11206;Vilnelė;Vyturėlis;3843064564;Ne;0;1;1;2
11207;Vilnelė;Vyturėlis;9674145631;Ne;0;0;3;3
11208;Vilnelė;Pagrandukas;5508759323;Ne;0;2;0;2
11209;Vilnelė;Pagrandukas;2144925171;Ne;5;2;0;7
11210;Vilnelė;Pagrandukas;3844066232;Ne;0;11;0;11
11211;Vilnelė;Pagrandukas;6659537454;Ne;0;6;0;6
11212;Vilnelė;Pagrandukas;4448413194;Ne;4;0;0;4
11213;Vilnelė;Pagrandukas;6830433856;Ne;0;1;0;1
11214;Vilnelė;Pagrandukas;4664946923;Ne;0;2;0;2
11215;Vilnelė;Pagrandukas;6982847450;Ne;0;2;0;2
11216;Vilnelė;Pagrandukas;7560124407;Ne;0;0;2;2
11217;Vilnelė;Pagrandukas;3685294539;Taip;2;0;0;2
11218;Vilnelė;Pagrandukas;7348404699;Taip;0;7;0;7
11219;Vilnelė;Pagrandukas;3323738649;Ne;0;3;0;3
11220;Vilnelė;Pagrandukas;8116613831;Ne;0;4;0;4
11221;Vilnelė;Pagrandukas;6466321228;Ne;0;13;0;13
11222;Vilnelė;Pagrandukas;4478847902;Ne;0;11;0;11
11223;Vilnelė;Pagrandukas;9635159885;Ne;0;1;0;1
11224;Vilnelė;Bitutė;4718994967;Ne;10;10;0;20
11225;Vilnelė;Bitutė;3529718234;Ne;0;5;0;5
11226;Vilnelė;Bitutė;1880318663;Ne;8;2;0;10
11227;Vilnelė;Bitutė;9589410276;Ne;8;2;0;10
11228;Vilnelė;Bitutė;9879688569;Ne;0;5;0;5
11229;Vilnelė;Bitutė;5473379559;Ne;0;1;0;1
11230;Vilnelė;Bitutė;3781595939;Ne;0;4;0;4
11231;Vilnelė;Bitutė;6132739519;Ne;8;5;0;13
11232;Vilnelė;Bitutė;1730149127;Ne;0;8;0;8
11233;Vilnelė;Bitutė;9884955712;Ne;0;3;0;3
11234;Vilnelė;Bitutė;5778176840;Ne;0;3;0;3
11235;Vilnelė;Bitutė;8162191913;Ne;5;0;0;5
11236;Vilnelė;Bitutė;6355912551;Ne;0;11;0;11
11237;Vilnelė;Bitutė;3945921490;Ne;0;14;0;14
11238;Vilnelė;Bitutė;7976798775;Ne;0;4;0;4
11239;Vilnelė;Bitutė;1975954784;Ne;5;2;0;7
11240;Vilnelė;Bitutė;7199490431;Ne;10;1;0;11
11241;Vilnelė;Bitutė;3811289758;Ne;0;9;0;9
11242;Vilnelė;Bitutė;3856917286;Ne;9;2;0;11
11243;Vilnelė;Bitutė;7883724600;Ne;0;2;2;4
11244;Vilnelė;Šaltinėlis;5487729159;Taip;4;4;0;8
11245;Vilnelė;Šaltinėlis;1108529953;Ne;5;0;0;5
11246;Vilnelė;Šaltinėlis;7949990857;Ne;7;0;0;7
11247;Vilnelė;Šaltinėlis;8267286482;Ne;11;0;0;11
11248;Vilnelė;Šaltinėlis;3579253910;Ne;4;0;0;4
11249;Vilnelė;Šaltinėlis;4973214588;Ne;0;20;0;20
11250;Vilnelė;Šaltinėlis;4939435139;Ne;5;5;0;10
11251;Vilnelė;Šaltinėlis;6858955752;Ne;10;1;0;11
11252;Vilnelė;Šaltinėlis;9578062060;Taip;15;0;0;15
11253;Vilnelė;Šaltinėlis;5341996342;Ne;12;0;0;12
11254;Vilnelė;Šaltinėlis;2639194662;Ne;10;0;0;10
11255;Vilnelė;Šaltinėlis;5625236416;Ne;18;0;0;18
11256;Vilnelė;Šaltinėlis;9774791340;Ne;17;0;0;17
11257;Vilnelė;Šaltinėlis;1893356606;Taip;16;0;0;16
11258;Vilnelė;Šaltinėlis;2835124257;Ne;3;2;0;5
11259;Vilnelė;Šaltinėlis;7924367229;Ne;16;0;0;16
11260;Vilnelė;Riešutėllis;1027463000;Ne;0;2;0;2
11261;Vilnelė;Riešutėllis;7020707723;Ne;13;0;0;13
11262;Vilnelė;Riešutėllis;4203549404;Ne;11;0;2;13
11263;Vilnelė;Riešutėllis;3290952017;Taip;0;1;0;1
11264;Vilnelė;Riešutėllis;8588430578;Ne;0;9;0;9
11265;Vilnelė;Riešutėllis;8750705826;Ne;0;0;2;2
11266;Vilnelė;Riešutėllis;4780827432;Ne;0;1;0;1
11267;Vilnelė;Riešutėllis;4455099179;Ne;5;2;0;7
11268;Vilnelė;Riešutėllis;2367127222;Ne;0;1;0;1
11269;Vilnelė;Riešutėllis;3670613082;Taip;0;2;6;8
11270;Vilnelė;Riešutėllis;9016866597;Ne;0;5;0;5
11271;Vilnelė;Riešutėllis;7087798406;Ne;0;2;0;2
11272;Vilnelė;Riešutėllis;4254744025;Ne;0;8;0;8
11273;Vilnelė;Riešutėllis;3730997665;Taip;8;2;0;10
11274;Vilnelė;Riešutėllis;2706699572;Ne;2;2;0;4
11275;Vilnelė;Riešutėllis;8774842903;Ne;12;1;0;13
11276;Vilnelė;Nykštukas;4210511566;Taip;2;0;0;2
11277;Vilnelė;Nykštukas;2891787022;Ne;1;0;0;1
11278;Vilnelė;Nykštukas;4734511521;Ne;4;0;0;4
11279;Vilnelė;Nykštukas;4295630317;Ne;20;0;0;20
11280;Vilnelė;Nykštukas;1554473199;Ne;1;1;0;2
11281;Vilnelė;Nykštukas;1819154122;Taip;3;0;0;3
11282;Vilnelė;Nykštukas;4060927733;Taip;17;0;0;17
11283;Vilnelė;Nykštukas;2299381653;Taip;1;4;0;5
11284;Vilnelė;Nykštukas;5041031750;Ne;6;0;0;6
11285;Vilnelė;Nykštukas;2157793186;Ne;5;0;0;5
11286;Vilnelė;Nykštukas;4516818999;Ne;0;14;0;14
11287;Vilnelė;Nykštukas;8579294202;Ne;0;9;0;9
11288;Vilnelė;Nykštukas;7161529969;Ne;7;0;0;7
11289;Vilnelė;Nykštukas;3720979747;Ne;4;0;0;4
11290;Vilnelė;Nykštukas;6048991617;Taip;6;0;0;6
11291;Vilnelė;Nykštukas;6054488692;Ne;3;0;0;3
11292;Vilnelė;Nykštukas;8630048961;Ne;0;15;0;15
11293;Vilnelė;Nykštukas;1500899512;Ne;5;0;0;5
11294;Vilnelė;Nykštukas;7592040226;Ne;15;2;0;17
11295;Vilnelė;Nykštukas;1515873552;Ne;10;0;0;10
11296;Vilnelė;Nykštukas;5629086127;Ne;1;0;0;1
11297;Vilnelė;Pieštukas;9882766915;Ne;5;8;0;13
11298;Vilnelė;Pieštukas;5444967820;Ne;4;0;0;4
11299;Vilnelė;Pieštukas;3828623778;Ne;0;1;0;1
11300;Vilnelė;Pieštukas;7698638698;Ne;2;0;0;2
11301;Vilnelė;Pieštukas;3064118212;Ne;8;0;0;8
11302;Vilnelė;Pieštukas;7231998656;Taip;10;0;0;10
11303;Vilnelė;Pieštukas;2343750614;Ne;1;0;0;1
11304;Vilnelė;Pieštukas;5813090771;Ne;5;0;0;5
11305;Vilnelė;Pieštukas;4670933970;Ne;8;0;0;8
11306;Vilnelė;Pieštukas;9317041585;Ne;10;0;0;10
11307;Vilnelė;Pieštukas;2683662906;Ne;14;0;0;14
11308;Vilnelė;Pieštukas;4982137749;Taip;0;3;0;3
11309;Vilnelė;Pieštukas;2700153185;Taip;0;1;0;1
11310;Vilnelė;Pieštukas;4817502971;Ne;1;1;0;2
11311;Vilnelė;Pieštukas;3712463891;Ne;0;6;0;6
11312;Vilnelė;Pieštukas;2576381995;Ne;1;0;0;1
11313;Vilnelė;Pieštukas;9476510950;Ne;0;2;2;4
11314;Vilnelė;Pieštukas;9316933315;Ne;0;2;0;2
11315;Vilnelė;Pieštukas;8848138564;Taip;0;8;0;8
11316;Vilnelė;Pieštukas;7752502124;Taip;5;0;0;5
11317;Vilnelė;Voverytė;1414168531;Ne;0;0;1;1
11318;Vilnelė;Voverytė;3432602015;Ne;5;0;0;5
11319;Vilnelė;Voverytė;9660305163;Ne;5;0;2;7
11320;Vilnelė;Voverytė;9950598582;Taip;5;1;0;6
11321;Vilnelė;Voverytė;7968029402;Ne;3;0;0;3
11322;Vilnelė;Voverytė;7221712624;Ne;0;1;0;1
11323;Vilnelė;Voverytė;2964672357;Ne;0;1;0;1
11324;Vilnelė;Voverytė;5273665901;Taip;6;0;0;6
11325;Vilnelė;Voverytė;1566734465;Ne;5;0;0;5
11326;Vilnelė;Voverytė;1371066506;Ne;5;2;0;7
11327;Vilnelė;Voverytė;3654833067;Ne;10;0;0;10
11328;Vilnelė;Voverytė;4322462166;Ne;10;0;0;10
11329;Vilnelė;Voverytė;5649725693;Ne;5;0;0;5
11330;Vilnelė;Voverytė;3234028667;Ne;5;2;0;7
11331;Vilnelė;Voverytė;6569980514;Ne;7;8;0;15
11332;Vilnelė;Voverytė;4758117005;Taip;1;3;0;4
11333;Vilnelė;Voverytė;6634526716;Taip;5;2;0;7
11334;Vilnelė;Voverytė;1598555488;Ne;0;1;0;1
11335;Vilnelė;Voverytė;5960725916;Ne;10;6;0;16
11336;Vilnelė;Voverytė;7568755715;Ne;5;0;0;5
11337;Vilnelė;Kodėlčiukas;4642378600;Ne;0;1;0;1
11338;Vilnelė;Kodėlčiukas;6618109352;Ne;0;11;0;11
11339;Vilnelė;Kodėlčiukas;6715997340;Ne;0;1;0;1
11340;Vilnelė;Kodėlčiukas;9482133396;Ne;0;0;1;1
11341;Vilnelė;Kodėlčiukas;8439505238;Ne;20;0;0;20
11342;Vilnelė;Kodėlčiukas;1580287517;Ne;0;1;0;1
11343;Vilnelė;Kodėlčiukas;5558378376;Taip;0;2;1;3
11344;Vilnelė;Kodėlčiukas;3056845279;Ne;0;11;0;11
11345;Vilnelė;Kodėlčiukas;9537740492;Ne;0;0;1;1
11346;Vilnelė;Kodėlčiukas;3848720970;Ne;0;0;1;1
11347;Vilnelė;Kodėlčiukas;7833531435;Ne;0;2;0;2
11348;Vilnelė;Kodėlčiukas;5961910077;Ne;2;1;0;3
11349;Vilnelė;Kodėlčiukas;3115242919;Ne;0;7;0;7
11350;Vilnelė;Kodėlčiukas;8543995029;Taip;5;5;0;10
11351;Vilnelė;Kodėlčiukas;4986079102;Ne;0;2;0;2
11352;Vilnelė;Kodėlčiukas;5398303580;Ne;0;2;0;2
11353;Vilnelė;Kodėlčiukas;9418661965;Ne;5;1;0;6
11354;Vilnelė;Kodėlčiukas;5180951251;Ne;0;1;0;1
11355;Vilnelė;Žirniukas;9817054571;Ne;3;1;0;4
11356;Vilnelė;Žirniukas;8329253118;Taip;6;0;0;6
11357;Vilnelė;Žirniukas;5147406277;Taip;13;2;0;15
11358;Vilnelė;Žirniukas;9476348226;Ne;0;2;0;2
11359;Vilnelė;Žirniukas;9253975757;Ne;14;0;0;14
11360;Vilnelė;Žirniukas;9432188739;Ne;9;0;0;9
11361;Vilnelė;Žirniukas;8216383228;Ne;4;2;0;6
11362;Vilnelė;Žirniukas;2358167792;Ne;14;0;0;14
11363;Vilnelė;Žirniukas;2146981715;Ne;6;0;0;6
11364;Vilnelė;Žirniukas;9578715472;Ne;11;0;0;11
11365;Vilnelė;Žirniukas;2188575653;Ne;0;20;0;20
11366;Vilnelė;Žirniukas;2234709212;Ne;0;7;0;7
11367;Vilnelė;Žirniukas;1912897383;Ne;5;0;0;5
11368;Vilnelė;Žirniukas;4789175532;Ne;16;0;0;16
11369;Vilnelė;Pipiras;1977362135;Ne;11;0;0;11
11370;Vilnelė;Pipiras;6883775268;Ne;7;0;0;7
11371;Vilnelė;Pipiras;8061099641;Ne;0;1;0;1
11372;Vilnelė;Pipiras;5855361002;Ne;4;1;0;5
11373;Vilnelė;Pipiras;1631249610;Ne;5;2;0;7
11374;Vilnelė;Pipiras;4692537934;Ne;7;0;0;7
11375;Vilnelė;Pipiras;9300237246;Ne;20;0;0;20
11376;Vilnelė;Pipiras;7090044022;Ne;6;1;0;7
11377;Vilnelė;Pipiras;8602843000;Ne;5;2;0;7
11378;Vilnelė;Pipiras;9909858294;Ne;0;7;0;7
11379;Vilnelė;Pipiras;6707024855;Ne;0;5;0;5
11380;Vilnelė;Pipiras;9016135318;Ne;2;1;0;3
11381;Vilnelė;Pipiras;8015908754;Ne;5;9;0;14
11382;Vilnelė;Pipiras;4445721874;Ne;0;20;0;20
11383;Vilnelė;Pipiras;1003518211;Ne;0;20;0;20
11384;Vilnelė;Pipiras;3980908303;Ne;12;0;0;12
11385;Vėrinėlis;GAIDELIAI;6162461750;Ne;2;0;0;2
11386;Vėrinėlis;GAIDELIAI;1944358526;Ne;17;1;0;18
11387;Vėrinėlis;GAIDELIAI;3500287869;Ne;12;1;2;15
11388;Vėrinėlis;GAIDELIAI;6500266853;Ne;9;0;0;9
11389;Vėrinėlis;GAIDELIAI;5891690000;Ne;16;0;0;16
11390;Vėrinėlis;GAIDELIAI;4401001009;Ne;10;10;0;20
11391;Vėrinėlis;GAIDELIAI;1685329004;Ne;6;8;0;14
11392;Vėrinėlis;GAIDELIAI;4498096701;Ne;26;0;0;26
11393;Vėrinėlis;GAIDELIAI;9144004655;Ne;9;0;1;10
11394;Vėrinėlis;GAIDELIAI;8272531606;Ne;6;0;2;8
11395;Vėrinėlis;GAIDELIAI;2114637828;Ne;0;5;1;6
11396;Vėrinėlis;GAIDELIAI;1844862699;Ne;19;0;0;19
11397;Vėrinėlis;GAIDELIAI;7455948332;Ne;5;5;0;10
11398;Vėrinėlis;GAIDELIAI;4965735537;Ne;17;0;0;17
11399;Vėrinėlis;GAIDELIAI;1014076118;Taip;12;0;0;12
11400;Vėrinėlis;GAIDELIAI;2273903945;Ne;13;0;0;13
11401;Vėrinėlis;GAIDELIAI;8817186115;Ne;3;1;0;4
11402;Vėrinėlis;GAIDELIAI;6159725406;Ne;7;1;0;8
11403;Vėrinėlis;SAULUTĖ;7224418233;Ne;12;0;0;12
11404;Vėrinėlis;SAULUTĖ;8238013636;Ne;0;0;1;1
11405;Vėrinėlis;SAULUTĖ;2337883071;Ne;5;0;3;8
11406;Vėrinėlis;SAULUTĖ;6913001318;Ne;0;2;0;2
11407;Vėrinėlis;SAULUTĖ;7440020169;Ne;0;1;0;1
11408;Vėrinėlis;SAULUTĖ;7913975075;Ne;0;8;0;8
11409;Vėrinėlis;SAULUTĖ;9967737864;Ne;0;1;0;1
11410;Vėrinėlis;SAULUTĖ;9009344779;Ne;0;1;0;1
11411;Vėrinėlis;SAULUTĖ;4059906525;Ne;1;0;1;2
11412;Vėrinėlis;SAULUTĖ;3832662507;Ne;8;0;1;9
11413;Vėrinėlis;SAULUTĖ;1007705906;Ne;12;2;0;14
11414;Vėrinėlis;SAULUTĖ;9289003583;Ne;0;2;0;2
11415;Vėrinėlis;SAULUTĖ;1684203955;Ne;0;2;0;2
11416;Vėrinėlis;SAULUTĖ;5942475043;Ne;0;6;0;6
11417;Vėrinėlis;SAULUTĖ;2369434537;Ne;0;1;0;1
11418;Vėrinėlis;SAULUTĖ;1515803985;Ne;0;0;1;1
11419;Vėrinėlis;SAULUTĖ;1303022448;Ne;10;0;0;10
11420;Vėrinėlis;NYKŠTUKAI;5488087105;Ne;5;2;0;7
11421;Vėrinėlis;NYKŠTUKAI;5859566909;Ne;8;0;0;8
11422;Vėrinėlis;NYKŠTUKAI;4423562494;Ne;10;0;0;10
11423;Vėrinėlis;NYKŠTUKAI;5167825818;Ne;0;0;18;18
11424;Vėrinėlis;NYKŠTUKAI;9300891973;Ne;7;0;0;7
11425;Vėrinėlis;NYKŠTUKAI;8397635057;Taip;14;0;0;14
11426;Vėrinėlis;NYKŠTUKAI;8423611087;Ne;12;0;0;12
11427;Vėrinėlis;NYKŠTUKAI;8294753714;Ne;2;5;0;7
11428;Vėrinėlis;NYKŠTUKAI;4841000338;Ne;6;0;2;8
11429;Vėrinėlis;NYKŠTUKAI;2403376619;Taip;0;0;1;1
11430;Vėrinėlis;NYKŠTUKAI;2384172198;Ne;7;0;0;7
11431;Vėrinėlis;NYKŠTUKAI;4133310852;Ne;3;0;0;3
11432;Vėrinėlis;NYKŠTUKAI;7958241295;Ne;0;0;10;10
11433;Vėrinėlis;BURATINAS;7093959212;Ne;7;4;0;11
11434;Vėrinėlis;BURATINAS;2774618380;Taip;4;0;0;4
11435;Vėrinėlis;BURATINAS;5429955166;Ne;5;2;0;7
11436;Vėrinėlis;BURATINAS;5429372946;Taip;8;0;0;8
11437;Vėrinėlis;BURATINAS;2467700639;Ne;14;1;0;15
11438;Vėrinėlis;BURATINAS;6136232912;Ne;0;4;0;4
11439;Vėrinėlis;BURATINAS;6058712578;Ne;0;3;0;3
11440;Vėrinėlis;BURATINAS;6413701823;Ne;2;0;0;2
11441;Vėrinėlis;BURATINAS;2364117224;Ne;0;1;0;1
11442;Vėrinėlis;BURATINAS;7287634205;Ne;0;3;0;3
11443;Vėrinėlis;BURATINAS;3898060925;Ne;5;5;0;10
11444;Vėrinėlis;BURATINAS;4676052255;Ne;5;2;0;7
11445;Vėrinėlis;BURATINAS;3882915774;Taip;0;4;0;4
11446;Vėrinėlis;BURATINAS;7167034587;Ne;0;6;0;6
11447;Vėrinėlis;BURATINAS;1919350623;Ne;15;0;1;16
11448;Vėrinėlis;BURATINAS;9612956692;Ne;0;4;0;4
11449;Vėrinėlis;BURATINAS;6310807762;Ne;3;0;0;3
11450;Vėrinėlis;BURATINAS;5514167627;Ne;5;0;0;5
11451;Vėrinėlis;GINTARĖLIAI;8372084728;Ne;10;7;0;17
11452;Vėrinėlis;GINTARĖLIAI;6054398276;Ne;0;10;0;10
11453;Vėrinėlis;GINTARĖLIAI;7432965615;Ne;9;2;0;11
11454;Vėrinėlis;GINTARĖLIAI;3457199716;Ne;0;2;0;2
11455;Vėrinėlis;GINTARĖLIAI;7743951577;Taip;6;0;0;6
11456;Vėrinėlis;GINTARĖLIAI;2006432327;Ne;2;2;0;4
11457;Vėrinėlis;GINTARĖLIAI;6785519869;Taip;13;1;0;14
11458;Vėrinėlis;GINTARĖLIAI;3363388500;Ne;10;8;0;18
11459;Vėrinėlis;GINTARĖLIAI;9171173116;Ne;3;0;0;3
11460;Vėrinėlis;GINTARĖLIAI;3192625484;Ne;5;10;0;15
11461;Vėrinėlis;GINTARĖLIAI;8343196405;Ne;5;1;0;6
11462;Vėrinėlis;GINTARĖLIAI;4034106321;Ne;2;0;0;2
11463;Vėrinėlis;GINTARĖLIAI;5654269153;Ne;9;0;0;9
11464;Vėrinėlis;GINTARĖLIAI;6226329879;Ne;3;7;0;10
11465;Vėrinėlis;GINTARĖLIAI;7069247393;Ne;3;2;0;5
11466;Vėrinėlis;GINTARĖLIAI;9370715798;Taip;4;0;0;4
11467;Vėrinėlis;GINTARĖLIAI;6055921178;Ne;0;1;0;1
11468;Vėrinėlis;RAMUNĖLĖS;2911674984;Ne;7;0;0;7
11469;Vėrinėlis;RAMUNĖLĖS;4123553749;Ne;9;1;0;10
11470;Vėrinėlis;RAMUNĖLĖS;9234123596;Ne;11;0;1;12
11471;Vėrinėlis;RAMUNĖLĖS;5051742311;Ne;5;2;0;7
11472;Vėrinėlis;RAMUNĖLĖS;9257045102;Ne;9;1;0;10
11473;Vėrinėlis;RAMUNĖLĖS;5501075800;Ne;11;0;0;11
11474;Vėrinėlis;RAMUNĖLĖS;1699912818;Ne;11;0;0;11
11475;Vėrinėlis;RAMUNĖLĖS;4492269367;Ne;7;0;0;7
11476;Vėrinėlis;RAMUNĖLĖS;7294499755;Taip;12;1;0;13
11477;Vėrinėlis;RAMUNĖLĖS;7544881486;Ne;0;3;0;3
11478;Vėrinėlis;RAMUNĖLĖS;1403519604;Ne;11;0;0;11
11479;Vėrinėlis;RAMUNĖLĖS;6240649255;Ne;11;0;0;11
11480;Vėrinėlis;RAMUNĖLĖS;2763569936;Ne;0;3;0;3
11481;Vėrinėlis;RAMUNĖLĖS;7349463495;Ne;6;3;0;9
11482;Vėrinėlis;RAMUNĖLĖS;9935098198;Ne;16;0;0;16
11483;Vėrinėlis;KODELČIUKŲ;8722816580;Taip;0;0;2;2
11484;Vėrinėlis;KODELČIUKŲ;5342916562;Ne;6;0;0;6
11485;Vėrinėlis;KODELČIUKŲ;9349874701;Ne;7;0;0;7
11486;Vėrinėlis;KODELČIUKŲ;9179544549;Ne;20;0;0;20
11487;Vėrinėlis;KODELČIUKŲ;3830101723;Ne;3;0;0;3
11488;Vėrinėlis;KODELČIUKŲ;4818860992;Ne;2;0;0;2
11489;Vėrinėlis;KODELČIUKŲ;2908247336;Ne;11;0;2;13
11490;Vėrinėlis;KODELČIUKŲ;8389805682;Taip;7;0;0;7
11491;Vėrinėlis;KODELČIUKŲ;3563156582;Ne;13;0;0;13
11492;Vėrinėlis;KODELČIUKŲ;1119458722;Ne;6;0;1;7
11493;Vėrinėlis;KODELČIUKŲ;8029977991;Ne;7;0;0;7
11494;Vėrinėlis;KODELČIUKŲ;4065241921;Ne;2;0;1;3
11495;Vėrinėlis;KODELČIUKŲ;8977670959;Ne;9;0;0;9
11496;Vėrinėlis;KODELČIUKŲ;7382201231;Ne;9;0;0;9
11497;Vėrinėlis;ŽIRNIUKAI;1769852084;Ne;0;1;1;2
11498;Vėrinėlis;ŽIRNIUKAI;4981127515;Ne;2;0;1;3
11499;Vėrinėlis;ŽIRNIUKAI;8329989952;Ne;0;0;1;1
11500;Vėrinėlis;ŽIRNIUKAI;3202518504;Ne;0;1;3;4
11501;Vėrinėlis;ŽIRNIUKAI;4752902173;Ne;6;3;0;9
11502;Vėrinėlis;ŽIRNIUKAI;7237945125;Ne;19;0;0;19
11503;Vėrinėlis;ŽIRNIUKAI;5600815908;Ne;4;0;0;4
11504;Vėrinėlis;ŽIRNIUKAI;1736733257;Ne;5;0;0;5
11505;Vėrinėlis;ŽIRNIUKAI;2687583764;Taip;11;0;0;11
11506;Vėrinėlis;ŽIRNIUKAI;9419245081;Ne;0;1;0;1
11507;Vėrinėlis;ŽIRNIUKAI;7817387800;Ne;6;0;0;6
11508;Vėrinėlis;ŽIRNIUKAI;6377447141;Ne;6;0;0;6
11509;Vėrinėlis;ŽIRNIUKAI;7371908331;Ne;2;2;0;4
11510;Vėrinėlis;ŽIRNIUKAI;6392625405;Ne;1;2;0;3
11511;Vėrinėlis;ŽIRNIUKAI;1896980533;Ne;0;1;0;1
11512;Vėrinėlis;ŽIRNIUKAI;8483525051;Ne;0;1;0;1
11513;Vėrinėlis;ŽIRNIUKAI;6220653152;Ne;4;2;0;6
11514;Vėrinėlis;VARPELIAI;7416041207;Ne;0;9;0;9
11515;Vėrinėlis;VARPELIAI;8655158155;Ne;6;1;0;7
11516;Vėrinėlis;VARPELIAI;6362125404;Ne;10;3;0;13
11517;Vėrinėlis;VARPELIAI;9599724421;Ne;5;1;0;6
11518;Vėrinėlis;VARPELIAI;7216867683;Ne;10;2;0;12
11519;Vėrinėlis;VARPELIAI;8336694468;Ne;5;0;0;5
11520;Vėrinėlis;VARPELIAI;1026312967;Ne;0;2;0;2
11521;Vėrinėlis;VARPELIAI;2561255096;Ne;10;0;0;10
11522;Vėrinėlis;VARPELIAI;3392458614;Ne;5;2;0;7
11523;Vėrinėlis;VARPELIAI;5837383907;Ne;2;0;0;2
11524;Vėrinėlis;VARPELIAI;3953496894;Ne;6;0;0;6
11525;Vėrinėlis;VARPELIAI;3663446767;Ne;0;1;0;1
11526;Vėrinėlis;VARPELIAI;4086695239;Ne;11;0;0;11
11527;Vėrinėlis;BORUŽĖLĖS;8759487574;Ne;0;2;0;2
11528;Vėrinėlis;BORUŽĖLĖS;4819016753;Ne;1;0;0;1
11529;Vėrinėlis;BORUŽĖLĖS;1910385020;Ne;0;1;0;1
11530;Vėrinėlis;BORUŽĖLĖS;3934652683;Ne;3;0;0;3
11531;Vėrinėlis;BORUŽĖLĖS;6904733283;Ne;0;2;6;8
11532;Vėrinėlis;BORUŽĖLĖS;3718510933;Ne;0;1;0;1
11533;Vėrinėlis;BORUŽĖLĖS;2501287529;Ne;0;1;0;1
11534;Vėrinėlis;BORUŽĖLĖS;8904833339;Ne;0;3;0;3
11535;Vėrinėlis;BORUŽĖLĖS;3312501759;Ne;0;3;0;3
11536;Vėrinėlis;BORUŽĖLĖS;9217188911;Ne;7;6;0;13
11537;Vėrinėlis;BORUŽĖLĖS;7414937335;Ne;6;2;0;8
11538;Vėrinėlis;BORUŽĖLĖS;2574507205;Ne;13;0;0;13
11539;Vėrinėlis;BORUŽĖLĖS;4852563692;Ne;0;2;0;2
11540;Vėrinėlis;BORUŽĖLĖS;5865529907;Ne;5;0;1;6
11541;Vėrinėlis;BORUŽĖLĖS;9613642664;Ne;0;6;0;6
11542;Vėrinėlis;BORUŽĖLĖS;2467242845;Ne;0;3;0;3
11543;Vėrinėlis;BORUŽĖLĖS;4037594669;Ne;7;0;1;8
11544;Vėrinėlis;SVEIKUOLIAI;1909742394;Ne;0;1;1;2
11545;Vėrinėlis;SVEIKUOLIAI;6176308531;Ne;0;3;0;3
11546;Vėrinėlis;SVEIKUOLIAI;3563114419;Ne;0;1;0;1
11547;Vėrinėlis;SVEIKUOLIAI;8716965452;Ne;7;1;0;8
11548;Vėrinėlis;SVEIKUOLIAI;7584124339;Ne;4;0;2;6
11549;Vėrinėlis;SVEIKUOLIAI;4859330774;Ne;1;0;0;1
11550;Vėrinėlis;SVEIKUOLIAI;3958551159;Ne;5;0;0;5
11551;Vėrinėlis;SVEIKUOLIAI;5539714292;Taip;1;0;0;1
11552;Vėrinėlis;SVEIKUOLIAI;2516474825;Ne;0;1;0;1
11553;Vėrinėlis;SVEIKUOLIAI;9058127692;Ne;0;1;0;1
11554;Vėrinėlis;SVEIKUOLIAI;1278914183;Ne;10;0;0;10
11555;Vėrinėlis;SVEIKUOLIAI;7573209012;Ne;0;1;0;1
11556;Vėrinėlis;ŠIRDELĖS;7811024382;Ne;0;0;1;1
11557;Vėrinėlis;ŠIRDELĖS;4378592116;Ne;15;0;0;15
11558;Vėrinėlis;ŠIRDELĖS;7517113022;Ne;4;0;0;4
11559;Vėrinėlis;ŠIRDELĖS;1841277321;Ne;0;1;0;1
11560;Vėrinėlis;ŠIRDELĖS;5588658517;Ne;4;3;0;7
11561;Vėrinėlis;ŠIRDELĖS;5653635907;Ne;9;2;0;11
11562;Vėrinėlis;ŠIRDELĖS;1152010178;Ne;0;5;0;5
11563;Vėrinėlis;ŠIRDELĖS;2038169885;Ne;0;9;0;9
11564;Vėrinėlis;ŠIRDELĖS;9375922889;Taip;8;0;0;8
11565;Vėrinėlis;ŠIRDELĖS;5813009126;Ne;0;7;0;7
11566;Vėrinėlis;ŠIRDELĖS;3511809411;Ne;0;3;0;3
11567;Vėrinėlis;ŠIRDELĖS;9217815657;Ne;0;4;0;4
11568;Vėrinėlis;ŠIRDELĖS;4700093328;Ne;0;7;0;7
11569;Vėrinėlis;ŠIRDELĖS;1339847370;Taip;10;0;3;13
11570;Vėrinėlis;ŠIRDELĖS;1939318286;Ne;8;2;0;10
11571;Vėrinėlis;ŠIRDELĖS;7361319518;Ne;0;0;1;1
11572;Vėrinėlis;ŠIRDELĖS;2847839917;Taip;10;4;0;14
11573;Vėrinėlis;ŠIRDELĖS;7311740859;Ne;0;1;0;1
11574;Vėrinėlis;ŠIRDELĖS;6905591549;Ne;5;8;0;13
11575;Viltenė;Drugeliai;2392304909;Ne;3;2;0;5
11576;Viltenė;Drugeliai;4616047113;Ne;0;5;0;5
11577;Viltenė;Drugeliai;6810811656;Ne;0;3;0;3
11578;Viltenė;Drugeliai;3905014810;Ne;0;5;0;5
11579;Viltenė;Drugeliai;9476132305;Ne;0;5;0;5
11580;Viltenė;Drugeliai;5522245968;Ne;0;2;0;2
11581;Viltenė;Drugeliai;5552217000;Taip;0;1;0;1
11582;Viltenė;Drugeliai;9756519374;Ne;3;0;0;3
11583;Viltenė;Drugeliai;4195708756;Ne;0;4;0;4
11584;Viltenė;Drugeliai;1081603034;Ne;10;2;0;12
11585;Viltenė;Bitučių;5077874991;Ne;3;2;0;5
11586;Viltenė;Bitučių;7266522399;Ne;2;5;0;7
11587;Viltenė;Bitučių;5241075224;Taip;4;0;0;4
11588;Viltenė;Bitučių;1374979411;Ne;0;6;0;6
11589;Viltenė;Bitučių;1765335359;Ne;0;7;0;7
11590;Viltenė;Bitučių;8681961430;Ne;11;0;0;11
11591;Viltenė;Bitučių;9438542101;Ne;0;1;0;1
11592;Viltenė;Bitučių;8608269197;Ne;0;1;0;1
11593;Viltenė;Bitučių;3234013091;Ne;7;0;1;8
11594;Viltenė;Bitučių;2460019568;Ne;12;1;0;13
11595;Viltenė;Boružėlių;9572407405;Ne;0;5;0;5
11596;Viltenė;Boružėlių;3738838707;Ne;0;1;0;1
11597;Viltenė;Boružėlių;8473588098;Ne;0;5;0;5
11598;Viltenė;Boružėlių;3995418079;Ne;4;0;0;4
11599;Viltenė;Boružėlių;1399653129;Ne;4;0;0;4
11600;Viltenė;Boružėlių;7526555727;Ne;0;8;0;8
11601;Viltenė;Boružėlių;4036109404;Ne;5;2;0;7
11602;Viltenė;Boružėlių;4604298036;Ne;1;7;0;8
11603;Viltenė;Boružėlių;9242034622;Ne;3;1;0;4
11604;Viltenė;Boružėlių;6621273812;Ne;6;0;0;6
11605;Viltenė;Boružėlių;7010024061;Ne;0;10;0;10
11606;Viltenė;Boružėlių;8527270437;Ne;6;4;0;10
11607;Viltenė;Boružėlių;3052677157;Ne;0;2;0;2
11608;Viltenė;Gandriukų;6481491422;Ne;3;0;1;4
11609;Viltenė;Gandriukų;1126409020;Ne;0;7;0;7
11610;Viltenė;Gandriukų;2884698447;Ne;0;2;1;3
11611;Viltenė;Gandriukų;6060648988;Ne;0;2;0;2
11612;Viltenė;Gandriukų;1840626621;Ne;4;2;0;6
11613;Viltenė;Gandriukų;8549631247;Ne;0;1;0;1
11614;Viltenė;Gandriukų;7796422726;Ne;0;2;0;2
11615;Viltenė;Gandriukų;4945108189;Ne;0;3;0;3
11616;Viltenė;Gandriukų;5850652322;Ne;5;2;0;7
11617;Viltenė;Gandriukų;8110413064;Ne;0;1;0;1
11618;Viltenė;Gandriukų;3073228245;Ne;20;0;0;20
11619;Viltenė;Gandriukų;4468743044;Ne;0;1;0;1
11620;Viltenė;Gandriukų;6355857716;Ne;0;0;3;3
11621;Viltenė;Gandriukų;6473925760;Ne;10;0;1;11
11622;Viltenė;Gandriukų;8458769051;Ne;0;1;0;1
11623;Viltenė;Aitvariukai;2137929911;Ne;0;3;0;3
11624;Viltenė;Aitvariukai;9185054066;Ne;0;10;0;10
11625;Viltenė;Aitvariukai;2036902795;Ne;4;0;0;4
11626;Viltenė;Aitvariukai;5599943846;Ne;0;1;0;1
11627;Viltenė;Aitvariukai;6296509460;Ne;0;3;0;3
11628;Viltenė;Aitvariukai;9101795131;Ne;0;1;0;1
11629;Viltenė;Aitvariukai;2976705872;Ne;5;0;0;5
11630;Viltenė;Aitvariukai;2192086488;Ne;4;1;0;5
11631;Viltenė;Aitvariukai;2026654467;Ne;0;5;0;5
11632;Viltenė;Aitvariukai;4641365031;Taip;4;1;0;5
11633;Viltenė;Aitvariukai;7277455268;Ne;0;9;0;9
11634;Viltenė;Aitvariukai;2786572522;Ne;0;6;0;6
11635;Viltenė;Aitvariukai;6171399579;Ne;0;1;0;1
11636;Viltenė;Aitvariukai;3839680327;Taip;5;0;0;5
11637;Viltenė;Geniukų;3157417614;Ne;18;0;0;18
11638;Viltenė;Geniukų;2903596382;Ne;0;3;0;3
11639;Viltenė;Geniukų;6379567497;Ne;0;3;0;3
11640;Viltenė;Geniukų;7145240197;Ne;6;0;0;6
11641;Viltenė;Geniukų;7058586628;Ne;0;3;0;3
11642;Viltenė;Geniukų;7005219570;Ne;0;1;0;1
11643;Viltenė;Geniukų;4552355700;Ne;0;2;0;2
11644;Viltenė;Geniukų;8278572246;Ne;4;0;0;4
11645;Viltenė;Geniukų;2850146424;Ne;0;1;0;1
11646;Viltenė;Geniukų;7993258845;Ne;0;1;0;1
11647;Viltenė;Geniukų;6992120038;Ne;10;0;0;10
11648;Viltenė;Geniukų;4981225829;Ne;0;1;0;1
11649;Viltenė;Geniukų;3853518656;Ne;0;2;0;2
11650;Viltenė;Geniukų;9582577013;Ne;0;20;0;20
11651;Viltenė;Geniukų;3343045604;Ne;3;0;0;3
11652;Viltenė;Saulutės;8091905944;Ne;10;0;0;10
11653;Viltenė;Saulutės;1641406030;Taip;4;0;0;4
11654;Viltenė;Saulutės;4615393852;Ne;0;3;0;3
11655;Viltenė;Saulutės;9760364123;Ne;7;0;0;7
11656;Viltenė;Saulutės;3347380524;Ne;0;2;0;2
11657;Viltenė;Saulutės;2846574130;Ne;0;14;0;14
11658;Viltenė;Saulutės;2656363650;Ne;0;1;0;1
11659;Viltenė;Saulutės;4724382069;Ne;0;1;0;1
11660;Viltenė;Saulutės;2841144656;Ne;6;0;0;6
11661;Viltenė;Saulutės;7810374329;Taip;0;5;0;5
11662;Viltenė;Saulutės;9095458948;Ne;20;0;0;20
11663;Viltenė;Saulutės;4661430937;Ne;7;0;0;7
11664;Viltenė;Saulutės;8258247750;Ne;0;4;0;4
11665;Viltenė;Lapiukų;2034259692;Ne;0;4;0;4
11666;Viltenė;Lapiukų;3473533533;Ne;0;4;0;4
11667;Viltenė;Lapiukų;8696698257;Ne;0;1;0;1
11668;Viltenė;Lapiukų;8248514570;Ne;5;0;0;5
11669;Viltenė;Lapiukų;2878124826;Taip;10;0;0;10
11670;Viltenė;Lapiukų;2660622296;Ne;3;0;0;3
11671;Viltenė;Lapiukų;8122878153;Ne;0;7;0;7
11672;Viltenė;Lapiukų;9573891616;Ne;0;5;0;5
11673;Viltenė;Lapiukų;4243501722;Ne;1;0;0;1
11674;Viltenė;Lapiukų;5818645490;Ne;0;1;0;1
11675;Viltenė;Lapiukų;6429905246;Ne;3;0;0;3
11676;Viltenė;Lapiukų;6070264006;Ne;0;4;0;4
11677;Viltenė;Lapiukų;8187712849;Ne;2;0;0;2
11678;Viltenė;Lapiukų;3679704404;Ne;0;7;0;7
11679;Viltenė;Lapiukų;9846205631;Ne;0;1;0;1
11680;Viltenė;Lapiukų;1964849653;Ne;8;0;0;8
11681;Viltenė;Voveriukai;6888346135;Ne;0;7;0;7
11682;Viltenė;Voveriukai;2936670828;Ne;5;0;0;5
11683;Viltenė;Voveriukai;5816623708;Ne;0;18;0;18
11684;Viltenė;Voveriukai;5611839058;Ne;0;1;0;1
11685;Viltenė;Voveriukai;4414192600;Ne;5;2;0;7
11686;Viltenė;Voveriukai;8341211836;Ne;7;1;0;8
11687;Viltenė;Voveriukai;6954065006;Ne;8;2;1;11
11688;Viltenė;Voveriukai;6741521720;Ne;0;10;0;10
11689;Viltenė;Voveriukai;2642080849;Ne;0;2;1;3
11690;Viltenė;Voveriukai;6040634853;Ne;0;1;0;1
11691;Viltenė;Voveriukai;7322841332;Ne;5;2;0;7
11692;Viltenė;Voveriukai;1888167096;Ne;0;2;1;3
11693;Viltenė;Voveriukai;3291926243;Ne;0;5;0;5
11694;Viltenė;Voveriukai;1890096287;Ne;4;2;0;6
11695;Viltenė;Kiškučiai;7314937470;Ne;0;2;1;3
11696;Viltenė;Kiškučiai;8150583354;Ne;0;6;0;6
11697;Viltenė;Kiškučiai;9862698928;Ne;8;0;0;8
11698;Viltenė;Kiškučiai;3996210451;Ne;0;2;0;2
11699;Viltenė;Kiškučiai;7273826810;Ne;5;1;0;6
11700;Viltenė;Kiškučiai;1512772072;Ne;20;0;0;20
11701;Viltenė;Kiškučiai;4970273010;Ne;2;0;0;2
11702;Viltenė;Kiškučiai;6971198297;Ne;5;1;0;6
11703;Viltenė;Kiškučiai;5633115904;Ne;3;0;0;3
11704;Viltenė;Kiškučiai;2413392645;Ne;2;0;0;2
11705;Viltenė;Kiškučiai;3501209955;Ne;0;5;6;11
11706;Viltenė;Kiškučiai;1828982237;Ne;4;0;3;7
11707;Viltenė;Kiškučiai;5575163907;Ne;0;0;7;7
11708;Viltenė;Nykštukų;9263941853;Ne;0;4;0;4
11709;Viltenė;Nykštukų;9308502487;Ne;0;1;0;1
11710;Viltenė;Nykštukų;3331402933;Ne;4;0;1;5
11711;Viltenė;Nykštukų;6715408809;Ne;11;0;0;11
11712;Viltenė;Nykštukų;8423445808;Ne;5;0;0;5
11713;Viltenė;Nykštukų;4692894136;Ne;6;0;0;6
11714;Viltenė;Nykštukų;2675172000;Ne;8;0;0;8
11715;Viltenė;Nykštukų;9962055404;Ne;0;0;1;1
11716;Viltenė;Nykštukų;6805422614;Ne;10;0;0;10
11717;Viltenė;Nykštukų;2549050819;Ne;10;0;0;10
11718;Viltenė;Triušiukai;7754951374;Ne;0;0;3;3
11719;Viltenė;Triušiukai;1788524515;Ne;2;11;0;13
11720;Viltenė;Triušiukai;2720563160;Ne;2;0;1;3
11721;Viltenė;Triušiukai;7331321780;Ne;3;0;0;3
11722;Viltenė;Triušiukai;9211978362;Ne;5;1;0;6
11723;Viltenė;Triušiukai;3007260551;Ne;2;0;1;3
11724;Viltenė;Triušiukai;5083086443;Ne;5;0;0;5
11725;Viltenė;Triušiukai;9163535422;Ne;5;0;0;5
11726;Viltenė;Triušiukai;1280744308;Ne;10;10;0;20
11727;Viltenė;Triušiukai;8517635316;Ne;0;0;1;1
11728;Viltenė;Triušiukai;2077492267;Ne;5;0;1;6
11729;Voveraitė;ŽVIRBLIUKŲ;6684234832;Ne;0;0;10;10
11730;Voveraitė;ŽVIRBLIUKŲ;8119493388;Ne;0;2;1;3
11731;Voveraitė;ŽVIRBLIUKŲ;5804351872;Ne;0;0;3;3
11732;Voveraitė;ŽVIRBLIUKŲ;8803052781;Ne;0;5;0;5
11733;Voveraitė;ŽVIRBLIUKŲ;8257748589;Ne;0;1;1;2
11734;Voveraitė;ŽVIRBLIUKŲ;1522307865;Ne;5;0;3;8
11735;Voveraitė;ŽVIRBLIUKŲ;3811230983;Taip;0;0;10;10
11736;Voveraitė;ŽVIRBLIUKŲ;2142507659;Ne;7;0;0;7
11737;Voveraitė;ŽVIRBLIUKŲ;5395915359;Ne;0;0;6;6
11738;Voveraitė;ŽVIRBLIUKŲ;3247101840;Ne;10;0;0;10
11739;Voveraitė;ŽVIRBLIUKŲ;6643600680;Taip;0;0;3;3
11740;Voveraitė;ŽVIRBLIUKŲ;3877673172;Ne;0;1;12;13
11741;Voveraitė;ŽVIRBLIUKŲ;5605614222;Ne;0;0;2;2
11742;Voveraitė;ŽVIRBLIUKŲ;7248705010;Ne;0;0;4;4
11743;Voveraitė;VOVERIUKŲ;5104290434;Ne;8;3;0;11
11744;Voveraitė;VOVERIUKŲ;3883413387;Ne;8;0;0;8
11745;Voveraitė;VOVERIUKŲ;6762558038;Ne;3;0;0;3
11746;Voveraitė;VOVERIUKŲ;2317744694;Ne;14;0;0;14
11747;Voveraitė;VOVERIUKŲ;5484809515;Ne;0;1;0;1
11748;Voveraitė;VOVERIUKŲ;7047943041;Ne;9;0;0;9
11749;Voveraitė;VOVERIUKŲ;9350363241;Ne;2;0;0;2
11750;Voveraitė;VOVERIUKŲ;1003244190;Ne;0;1;0;1
11751;Voveraitė;VOVERIUKŲ;1805322222;Ne;7;0;0;7
11752;Voveraitė;VOVERIUKŲ;6179702518;Ne;4;0;0;4
11753;Voveraitė;VOVERIUKŲ;6177162728;Ne;7;0;0;7
11754;Voveraitė;VOVERIUKŲ;2035456422;Ne;4;1;0;5
11755;Voveraitė;VOVERIUKŲ;8936261148;Ne;6;0;0;6
11756;Voveraitė;KIŠKUČIŲ;9537862791;Ne;0;3;0;3
11757;Voveraitė;KIŠKUČIŲ;4478984171;Ne;2;0;0;2
11758;Voveraitė;KIŠKUČIŲ;9011096222;Ne;5;0;0;5
11759;Voveraitė;KIŠKUČIŲ;3058377539;Ne;0;3;0;3
11760;Voveraitė;KIŠKUČIŲ;8507818993;Ne;0;1;0;1
11761;Voveraitė;KIŠKUČIŲ;8746008166;Ne;0;3;0;3
11762;Voveraitė;KIŠKUČIŲ;8084986328;Ne;5;1;0;6
11763;Voveraitė;KIŠKUČIŲ;8220437514;Ne;4;0;0;4
11764;Voveraitė;KIŠKUČIŲ;5069929376;Ne;5;0;0;5
11765;Voveraitė;KIŠKUČIŲ;7379045686;Ne;0;3;0;3
11766;Voveraitė;KIŠKUČIŲ;1961699588;Ne;5;0;0;5
11767;Voveraitė;KIŠKUČIŲ;1979839656;Ne;0;1;0;1
11768;Voveraitė;KIŠKUČIŲ;8121423914;Ne;0;1;0;1
11769;Voveraitė;KIŠKUČIŲ;1322927329;Ne;3;0;0;3
11770;Voveraitė;KIŠKUČIŲ;8937070276;Ne;5;1;0;6
11771;Voveraitė;KIŠKUČIŲ;3859125174;Taip;11;0;0;11
11772;Voveraitė;KIŠKUČIŲ;4234600509;Ne;2;2;0;4
11773;Voveraitė;KODĖLČIUKŲ;7868415893;Ne;0;1;0;1
11774;Voveraitė;KODĖLČIUKŲ;3274422598;Ne;2;0;0;2
11775;Voveraitė;KODĖLČIUKŲ;8818603905;Ne;5;0;1;6
11776;Voveraitė;KODĖLČIUKŲ;9397887760;Ne;0;1;0;1
11777;Voveraitė;KODĖLČIUKŲ;4151144278;Ne;5;0;0;5
11778;Voveraitė;KODĖLČIUKŲ;5598685365;Ne;0;2;2;4
11779;Voveraitė;KODĖLČIUKŲ;1482908802;Ne;6;0;0;6
11780;Voveraitė;KODĖLČIUKŲ;9887747925;Ne;2;0;0;2
11781;Voveraitė;KODĖLČIUKŲ;7605427741;Ne;0;1;0;1
11782;Voveraitė;KODĖLČIUKŲ;3344886524;Taip;4;0;0;4
11783;Voveraitė;KODĖLČIUKŲ;3432886020;Ne;5;1;0;6
11784;Voveraitė;KODĖLČIUKŲ;8154347030;Ne;0;2;0;2
11785;Voveraitė;KODĖLČIUKŲ;2482908027;Ne;5;4;0;9
11786;Voveraitė;KODĖLČIUKŲ;8692155848;Ne;0;0;2;2
11787;Voveraitė;KODĖLČIUKŲ;1040007977;Ne;7;0;0;7
11788;Voveraitė;KODĖLČIUKŲ;3881039538;Ne;7;0;0;7
11789;Voveraitė;KODĖLČIUKŲ;7281753415;Ne;7;0;0;7
11790;Voveraitė;KODĖLČIUKŲ;8021563060;Ne;0;1;0;1
11791;Voveraitė;KODĖLČIUKŲ;9816971493;Ne;0;2;0;2
11792;Voveraitė;MEŠKIUKŲ;8881070477;Ne;6;0;0;6
11793;Voveraitė;MEŠKIUKŲ;7253112849;Ne;5;0;0;5
11794;Voveraitė;MEŠKIUKŲ;3217609712;Ne;0;6;0;6
11795;Voveraitė;MEŠKIUKŲ;3088866739;Ne;5;1;0;6
11796;Voveraitė;MEŠKIUKŲ;4207949414;Ne;4;1;0;5
11797;Voveraitė;MEŠKIUKŲ;7474214701;Ne;0;5;0;5
11798;Voveraitė;MEŠKIUKŲ;9729735431;Ne;0;1;0;1
11799;Voveraitė;MEŠKIUKŲ;6853358062;Ne;10;0;0;10
11800;Voveraitė;MEŠKIUKŲ;3539069705;Ne;0;3;0;3
11801;Voveraitė;MEŠKIUKŲ;6609235703;Taip;0;2;0;2
11802;Voveraitė;MEŠKIUKŲ;1528968162;Taip;5;3;0;8
11803;Voveraitė;MEŠKIUKŲ;3159659638;Ne;2;3;0;5
11804;Voveraitė;MEŠKIUKŲ;3532178114;Ne;2;3;0;5
11805;Voveraitė;MEŠKIUKŲ;8534405352;Ne;8;0;0;8
11806;Voveraitė;MEŠKIUKŲ;5018335921;Ne;8;7;0;15
11807;Voveraitė;MEŠKIUKŲ;6579193196;Taip;7;1;0;8
11808;Voveraitė;MEŠKIUKŲ;9332936763;Ne;10;2;0;12
11809;Voveraitė;MEŠKIUKŲ;6206817227;Taip;2;2;0;4
11810;Voveraitė;BORUŽĖLIŲ;7969862374;Ne;0;6;0;6
11811;Voveraitė;BORUŽĖLIŲ;2446269570;Ne;15;0;0;15
11812;Voveraitė;BORUŽĖLIŲ;1542869765;Ne;0;0;7;7
11813;Voveraitė;BORUŽĖLIŲ;3408126903;Ne;8;1;0;9
11814;Voveraitė;BORUŽĖLIŲ;8675606844;Ne;8;2;0;10
11815;Voveraitė;BORUŽĖLIŲ;8627692360;Ne;5;0;1;6
11816;Voveraitė;BORUŽĖLIŲ;3168493145;Ne;0;0;2;2
11817;Voveraitė;BORUŽĖLIŲ;7776716092;Ne;0;2;0;2
11818;Voveraitė;BORUŽĖLIŲ;8693704363;Ne;12;0;0;12
11819;Voveraitė;BORUŽĖLIŲ;7718303218;Ne;1;0;0;1
11820;Voveraitė;BORUŽĖLIŲ;9218074631;Taip;8;0;0;8
11821;Voveraitė;BORUŽĖLIŲ;6443288864;Ne;0;3;0;3
11822;Voveraitė;BORUŽĖLIŲ;1921260351;Ne;12;0;0;12
11823;Voveraitė;BORUŽĖLIŲ;8695525951;Ne;1;0;1;2
11824;Voveraitė;BORUŽĖLIŲ;6650343917;Ne;1;4;0;5
11825;Voveraitė;BORUŽĖLIŲ;3452040361;Ne;8;1;0;9
11826;Voveraitė;BORUŽĖLIŲ;8451803815;Ne;5;1;0;6
11827;Voveraitė;BORUŽĖLIŲ;8382950248;Ne;0;3;0;3
11828;Voveraitė;PELĖDŽIUKŲ;8705616608;Ne;3;0;0;3
11829;Voveraitė;PELĖDŽIUKŲ;2028714618;Ne;17;0;0;17
11830;Voveraitė;PELĖDŽIUKŲ;5415791380;Ne;1;0;0;1
11831;Voveraitė;PELĖDŽIUKŲ;2915226148;Ne;10;0;0;10
11832;Voveraitė;PELĖDŽIUKŲ;1971097565;Ne;5;0;0;5
11833;Voveraitė;PELĖDŽIUKŲ;2724402352;Ne;15;0;0;15
11834;Voveraitė;PELĖDŽIUKŲ;1063298119;Ne;8;0;0;8
11835;Voveraitė;PELĖDŽIUKŲ;1877131292;Ne;13;0;0;13
11836;Voveraitė;PELĖDŽIUKŲ;9074318124;Ne;17;0;0;17
11837;Voveraitė;PELĖDŽIUKŲ;6666893294;Ne;2;0;1;3
11838;Voveraitė;PELĖDŽIUKŲ;5918809105;Ne;7;0;0;7
11839;Voveraitė;PELĖDŽIUKŲ;9130691819;Ne;2;5;0;7
11840;Voveraitė;PELĖDŽIUKŲ;8126894347;Ne;5;0;0;5
11841;Voveraitė;PELĖDŽIUKŲ;3279671808;Ne;6;0;0;6
11842;Voveraitė;DRUGELIŲ;4300235743;Ne;8;0;0;8
11843;Voveraitė;DRUGELIŲ;1510853268;Ne;0;3;0;3
11844;Voveraitė;DRUGELIŲ;3388547792;Ne;0;1;0;1
11845;Voveraitė;DRUGELIŲ;8719547570;Ne;0;2;0;2
11846;Voveraitė;DRUGELIŲ;4017408873;Ne;3;0;0;3
11847;Voveraitė;DRUGELIŲ;1550830434;Ne;0;1;0;1
11848;Voveraitė;DRUGELIŲ;5114768009;Ne;3;2;0;5
11849;Voveraitė;DRUGELIŲ;1045204378;Ne;0;2;0;2
11850;Voveraitė;DRUGELIŲ;4911291891;Ne;4;2;1;7
11851;Voveraitė;DRUGELIŲ;6415024059;Taip;0;1;0;1
11852;Voveraitė;DRUGELIŲ;4350450125;Ne;4;1;0;5
11853;Voveraitė;DRUGELIŲ;8913940646;Ne;13;1;0;14
11854;Voveraitė;DRUGELIŲ;1201270622;Ne;2;2;1;5
11855;Voveraitė;DRUGELIŲ;7238482039;Taip;13;0;2;15
11856;Voveraitė;DRUGELIŲ;4961315260;Ne;2;2;1;5
11857;Voveraitė;DRUGELIŲ;8939638368;Ne;2;2;1;5
11858;Voveraitė;NYKŠTUKŲ;8206634977;Ne;2;0;0;2
11859;Voveraitė;NYKŠTUKŲ;3068683904;Taip;4;0;5;9
11860;Voveraitė;NYKŠTUKŲ;1294012085;Ne;0;3;0;3
11861;Voveraitė;NYKŠTUKŲ;8217771158;Ne;0;2;0;2
11862;Voveraitė;NYKŠTUKŲ;3409709168;Ne;0;0;2;2
11863;Voveraitė;NYKŠTUKŲ;1045121363;Taip;0;1;0;1
11864;Voveraitė;NYKŠTUKŲ;4319786615;Ne;0;2;0;2
11865;Voveraitė;NYKŠTUKŲ;1384430452;Taip;7;0;4;11
11866;Voveraitė;NYKŠTUKŲ;6648733729;Ne;8;1;0;9
11867;Voveraitė;NYKŠTUKŲ;2801245150;Ne;3;3;0;6
11868;Voveraitė;NYKŠTUKŲ;2839442228;Ne;0;0;1;1
11869;Voveraitė;NYKŠTUKŲ;5887384991;Ne;2;0;0;2
11870;Voveraitė;NYKŠTUKŲ;3627796093;Ne;5;5;1;11
11871;Voveraitė;NYKŠTUKŲ;4329107736;Ne;1;0;3;4
11872;Voveraitė;GENIUKŲ;8697761112;Ne;2;0;2;4
11873;Voveraitė;GENIUKŲ;6007396459;Ne;8;0;1;9
11874;Voveraitė;GENIUKŲ;1663784931;Ne;10;0;0;10
11875;Voveraitė;GENIUKŲ;8373093305;Ne;2;2;0;4
11876;Voveraitė;GENIUKŲ;4054841724;Ne;9;0;0;9
11877;Voveraitė;GENIUKŲ;4563198733;Ne;0;2;0;2
11878;Voveraitė;GENIUKŲ;1141304286;Ne;0;2;0;2
11879;Voveraitė;GENIUKŲ;3276295199;Ne;0;6;0;6
11880;Voveraitė;GENIUKŲ;6891841301;Ne;0;1;0;1
11881;Voveraitė;GENIUKŲ;6017698476;Ne;0;1;0;1
11882;Voveraitė;GENIUKŲ;8344323109;Ne;5;0;0;5
11883;Voveraitė;GENIUKŲ;5956830012;Ne;0;2;1;3
11884;Voveraitė;GENIUKŲ;1960385335;Taip;0;2;0;2
11885;Voveraitė;GENIUKŲ;9912862474;Ne;0;2;0;2
11886;Voveraitė;GENIUKŲ;1340379090;Ne;0;1;0;1
11887;Voveraitė;GENIUKŲ;5138855000;Ne;5;0;0;5
11888;Voveraitė;GENIUKŲ;6113913885;Ne;0;2;0;2
11889;Voveraitė;GENIUKŲ;7744504020;Ne;2;0;0;2
11890;Voveraitė;GENIUKŲ;9195700962;Ne;6;6;0;12
11891;Voveraitė;LAPIUKŲ;8405238812;Ne;4;0;0;4
11892;Voveraitė;LAPIUKŲ;8152541593;Ne;7;0;1;8
11893;Voveraitė;LAPIUKŲ;9327593792;Ne;13;0;0;13
11894;Voveraitė;LAPIUKŲ;4139239328;Ne;13;0;0;13
11895;Voveraitė;LAPIUKŲ;2587660082;Ne;0;5;0;5
11896;Voveraitė;LAPIUKŲ;6672252537;Ne;9;0;1;10
11897;Voveraitė;LAPIUKŲ;4689191326;Ne;10;0;0;10
11898;Voveraitė;LAPIUKŲ;7131189895;Ne;4;0;0;4
11899;Voveraitė;LAPIUKŲ;6766131083;Ne;15;0;5;20
11900;Voveraitė;LAPIUKŲ;4760054428;Ne;14;0;0;14
11901;Voveraitė;LAPIUKŲ;4848321265;Ne;15;0;3;18
11902;Voveraitė;LAPIUKŲ;3419973673;Ne;4;0;0;4
11903;Voveraitė;LAPIUKŲ;4402971359;Ne;4;0;0;4
11904;Voveraitė;LAPIUKŲ;1328831240;Taip;18;0;1;19
11905;Voveraitė;LAPIUKŲ;3955549715;Ne;0;0;15;15
11906;Voveraitė;LAPIUKŲ;9219176927;Ne;0;0;2;2
11907;Voveraitė;LAPIUKŲ;8382465808;Ne;6;1;1;8
11908;Voveraitė;EŽIUKŲ;5420123208;Ne;1;0;0;1
11909;Voveraitė;EŽIUKŲ;1692829228;Ne;3;0;1;4
11910;Voveraitė;EŽIUKŲ;8074808131;Ne;4;0;1;5
11911;Voveraitė;EŽIUKŲ;8229145014;Ne;4;0;1;5
11912;Voveraitė;EŽIUKŲ;2755043670;Ne;2;1;0;3
11913;Voveraitė;EŽIUKŲ;6481289149;Ne;5;0;0;5
11914;Voveraitė;EŽIUKŲ;6917511246;Ne;8;0;0;8
11915;Voveraitė;EŽIUKŲ;8663564002;Ne;5;2;0;7
11916;Voveraitė;EŽIUKŲ;3598956934;Ne;0;15;0;15
11917;Voveraitė;EŽIUKŲ;8465757758;Ne;5;0;1;6
11918;Voveraitė;EŽIUKŲ;5439761018;Ne;2;0;1;3
11919;Voveraitė;EŽIUKŲ;2064720751;Ne;4;2;0;6
11920;Voveraitė;EŽIUKŲ;4913232575;Ne;9;4;0;13
11921;Voveraitė;EŽIUKŲ;9859868228;Ne;2;5;0;7
11922;"Trakų Vokė";Voveriukų;1252962923;Ne;4;0;0;4
11923;"Trakų Vokė";Voveriukų;2163756512;Ne;0;1;0;1
11924;"Trakų Vokė";Voveriukų;9140597911;Ne;12;0;0;12
11925;"Trakų Vokė";Voveriukų;5741852704;Ne;5;0;0;5
11926;"Trakų Vokė";Voveriukų;4516714702;Ne;12;0;0;12
11927;"Trakų Vokė";Voveriukų;3445611475;Ne;1;0;0;1
11928;"Trakų Vokė";Voveriukų;3422308444;Ne;10;0;1;11
11929;"Trakų Vokė";Voveriukų;6076083379;Taip;0;2;0;2
11930;"Trakų Vokė";Voveriukų;7706665420;Ne;4;0;0;4
11931;"Trakų Vokė";Voveriukų;7656305410;Ne;3;0;0;3
11932;"Trakų Vokė";Voveriukų;2812442474;Ne;0;0;1;1
11933;"Trakų Vokė";Voveriukų;7671121106;Ne;0;0;4;4
11934;"Trakų Vokė";Voveriukų;7797516793;Ne;2;0;0;2
11935;"Trakų Vokė";Voveriukų;2077669020;Ne;1;1;0;2
11936;"Trakų Vokė";Voveriukų;8938061997;Ne;6;0;2;8
11937;"Trakų Vokė";Voveriukų;1946140073;Ne;14;0;0;14
11938;"Trakų Vokė";Voveriukų;6494156059;Ne;0;5;0;5
11939;"Trakų Vokė";Voveriukų;6247495021;Ne;3;2;0;5
11940;"Trakų Vokė";Voveriukų;3471649998;Ne;20;0;0;20
11941;"Trakų Vokė";Boružėlių;6550998156;Ne;4;0;0;4
11942;"Trakų Vokė";Boružėlių;6495211591;Ne;14;0;0;14
11943;"Trakų Vokė";Boružėlių;4621824988;Taip;16;0;0;16
11944;"Trakų Vokė";Boružėlių;7122970239;Ne;7;0;0;7
11945;"Trakų Vokė";Boružėlių;1798327247;Ne;0;2;0;2
11946;"Trakų Vokė";Boružėlių;6004005405;Ne;7;0;1;8
11947;"Trakų Vokė";Boružėlių;3930137078;Ne;11;0;1;12
11948;"Trakų Vokė";Boružėlių;1515075178;Ne;0;0;1;1
11949;"Trakų Vokė";Boružėlių;4377392002;Ne;6;0;0;6
11950;"Trakų Vokė";Boružėlių;7778039165;Ne;4;0;0;4
11951;"Trakų Vokė";Boružėlių;7933901042;Ne;5;0;0;5
11952;"Trakų Vokė";Boružėlių;7042434004;Ne;4;0;0;4
11953;"Trakų Vokė";KIŠKUČIŲ;2348524235;Ne;12;0;0;12
11954;"Trakų Vokė";KIŠKUČIŲ;6916284436;Ne;5;0;0;5
11955;"Trakų Vokė";KIŠKUČIŲ;2027461389;Ne;13;0;0;13
11956;"Trakų Vokė";KIŠKUČIŲ;8148859043;Ne;11;0;0;11
11957;"Trakų Vokė";KIŠKUČIŲ;9375730686;Ne;10;0;0;10
11958;"Trakų Vokė";KIŠKUČIŲ;2327739950;Taip;14;0;0;14
11959;"Trakų Vokė";KIŠKUČIŲ;3233117814;Ne;7;0;0;7
11960;"Trakų Vokė";KIŠKUČIŲ;3146611814;Ne;1;0;0;1
11961;"Trakų Vokė";KIŠKUČIŲ;8601290001;Ne;12;0;0;12
11962;"Trakų Vokė";KIŠKUČIŲ;1941250346;Ne;11;0;0;11
11963;"Trakų Vokė";KIŠKUČIŲ;4832898751;Ne;1;0;0;1
11964;"Trakų Vokė";KIŠKUČIŲ;8861279937;Ne;6;0;0;6
11965;"Trakų Vokė";KIŠKUČIŲ;7799307934;Ne;17;0;0;17
11966;"Trakų Vokė";BITUČIŲ;5031669549;Ne;5;0;0;5
11967;"Trakų Vokė";BITUČIŲ;8703806519;Ne;16;0;0;16
11968;"Trakų Vokė";BITUČIŲ;4531294784;Taip;5;0;0;5
11969;"Trakų Vokė";BITUČIŲ;5720994041;Ne;3;0;0;3
11970;"Trakų Vokė";BITUČIŲ;6402002961;Ne;2;0;0;2
11971;"Trakų Vokė";BITUČIŲ;3536227018;Taip;5;0;0;5
11972;"Trakų Vokė";BITUČIŲ;6787506848;Ne;0;1;0;1
11973;"Trakų Vokė";BITUČIŲ;1359519176;Ne;7;0;0;7
11974;"Trakų Vokė";BITUČIŲ;1039317931;Ne;20;0;0;20
11975;"Trakų Vokė";BITUČIŲ;3333979364;Ne;4;0;0;4
11976;"Trakų Vokė";BITUČIŲ;4212617288;Ne;2;0;0;2
11977;"Trakų Vokė";BITUČIŲ;3023545645;Ne;2;0;0;2
11978;"Trakų Vokė";BITUČIŲ;1000323267;Ne;2;0;0;2
11979;"Trakų Vokė";BITUČIŲ;8496627262;Ne;20;0;0;20
11980;"Trakų Vokė";BITUČIŲ;1389577176;Taip;2;0;0;2
11981;Zylutė;Katerok;8749296671;Ne;1;0;0;1
11982;Zylutė;Katerok;4592825972;Ne;0;1;0;1
11983;Zylutė;Katerok;8747721198;Ne;4;4;0;8
11984;Zylutė;Katerok;8212030518;Ne;4;5;0;9
11985;Zylutė;Katerok;7706833089;Ne;14;3;0;17
11986;Zylutė;Katerok;3115223229;Ne;2;0;0;2
11987;Zylutė;Katerok;2968625045;Ne;0;4;0;4
11988;Zylutė;Katerok;1897871944;Taip;0;2;0;2
11989;Zylutė;Katerok;3055559237;Ne;0;2;0;2
11990;Zylutė;Katerok;5948147748;Ne;1;0;0;1
11991;Zylutė;Katerok;7851423851;Ne;6;2;0;8
11992;Zylutė;Katerok;1164530815;Ne;0;2;0;2
11993;Zylutė;Katerok;1423890598;Ne;0;0;1;1
11994;Zylutė;Katerok;2558354198;Ne;0;1;0;1
11995;Zylutė;Katerok;8268700439;Taip;0;4;3;7
11996;Zylutė;Katerok;4494567155;Ne;0;10;0;10
11997;Zylutė;Katerok;8618778936;Ne;0;5;0;5
11998;Zylutė;"Vesole misiaki";9162232979;Ne;7;1;0;8
11999;Zylutė;"Vesole misiaki";9737308076;Ne;0;3;0;3
12000;Zylutė;"Vesole misiaki";5589330186;Taip;11;0;0;11
12001;Zylutė;"Vesole misiaki";3848401615;Ne;3;0;0;3
12002;Zylutė;"Vesole misiaki";2913504349;Ne;3;1;0;4
12003;Zylutė;"Vesole misiaki";2501761963;Ne;1;1;0;2
12004;Zylutė;"Vesole misiaki";2489898107;Ne;0;12;0;12
12005;Zylutė;"Vesole misiaki";2313423907;Ne;0;8;0;8
12006;Zylutė;"Vesole misiaki";2201317313;Ne;6;0;1;7
12007;Zylutė;"Vesole misiaki";9018673580;Ne;5;0;0;5
12008;Zylutė;"Vesole misiaki";5369354390;Taip;2;1;2;5
12009;Zylutė;"Vesole misiaki";8023418946;Ne;15;0;0;15
12010;Zylutė;"Vesole misiaki";9507157625;Taip;4;1;0;5
12011;Zylutė;"Vesole misiaki";2484025931;Ne;8;1;0;9
12012;Zylutė;NYKŠTUKAI;1169490002;Ne;9;2;0;11
12013;Zylutė;NYKŠTUKAI;7648922403;Ne;9;0;0;9
12014;Zylutė;NYKŠTUKAI;2113594059;Ne;10;2;0;12
12015;Zylutė;NYKŠTUKAI;9615779237;Ne;0;1;0;1
12016;Zylutė;NYKŠTUKAI;2604844156;Ne;8;4;0;12
12017;Zylutė;NYKŠTUKAI;2511658462;Ne;0;0;3;3
12018;Zylutė;NYKŠTUKAI;3035745273;Ne;6;0;4;10
12019;Zylutė;NYKŠTUKAI;2620903587;Ne;15;0;0;15
12020;Zylutė;NYKŠTUKAI;4706933533;Ne;0;0;1;1
12021;Zylutė;NYKŠTUKAI;4491529018;Ne;5;0;0;5
12022;Zylutė;NYKŠTUKAI;8987407474;Ne;0;0;2;2
12023;Zylutė;NYKŠTUKAI;2745905798;Ne;0;0;3;3
12024;Zylutė;NYKŠTUKAI;5975875502;Ne;0;1;0;1
12025;Zylutė;NYKŠTUKAI;9107676840;Taip;0;0;2;2
12026;Zylutė;NYKŠTUKAI;4840138765;Ne;8;0;1;9
12027;Zylutė;NYKŠTUKAI;9221414691;Taip;5;0;2;7
12028;Zylutė;Ručijok;5096881585;Ne;11;0;1;12
12029;Zylutė;Ručijok;9904758615;Ne;2;0;2;4
12030;Zylutė;Ručijok;2769424439;Ne;4;2;0;6
12031;Zylutė;Ručijok;1145229045;Ne;0;0;1;1
12032;Zylutė;Ručijok;3058040516;Ne;5;10;0;15
12033;Zylutė;Ručijok;5038936878;Ne;11;0;1;12
12034;Zylutė;Ručijok;5956114459;Ne;3;0;0;3
12035;Zylutė;Ručijok;6276017610;Ne;5;0;0;5
12036;Zylutė;Ručijok;3128535871;Ne;2;0;2;4
12037;Zylutė;Ručijok;6281989117;Taip;10;3;0;13
12038;Zylutė;Ručijok;2505224609;Taip;5;0;1;6
12039;Zylutė;Ručijok;7519900933;Ne;1;0;1;2
12040;Zylutė;Ručijok;3573761619;Ne;10;0;0;10
12041;Zylutė;Ručijok;7742044835;Taip;5;0;0;5
12042;Zylutė;Ručijok;3153857567;Ne;7;0;1;8
12043;Zylutė;Raduga;2916622808;Ne;15;0;0;15
12044;Zylutė;Raduga;2527003662;Taip;20;0;0;20
12045;Zylutė;Raduga;3977730349;Taip;9;0;0;9
12046;Zylutė;Raduga;7911418657;Ne;6;0;4;10
12047;Zylutė;Raduga;5650984730;Ne;2;0;1;3
12048;Zylutė;Raduga;6422018564;Taip;0;4;4;8
12049;Zylutė;Raduga;5019654510;Ne;11;0;2;13
12050;Zylutė;Raduga;2826889413;Ne;1;0;1;2
12051;Zylutė;Raduga;1935817272;Ne;17;0;0;17
12052;Zylutė;Raduga;9584717697;Ne;19;0;0;19
12053;Zylutė;Raduga;8448343323;Ne;5;0;0;5
12054;Zylutė;Raduga;1108316842;Ne;3;0;0;3
12055;Zylutė;Raduga;4801678066;Ne;16;0;0;16
12056;Zylutė;"Miki Maus";7762245887;Taip;7;0;0;7
12057;Zylutė;"Miki Maus";9213491152;Ne;7;1;0;8
12058;Zylutė;"Miki Maus";3928932787;Ne;0;9;0;9
12059;Zylutė;"Miki Maus";4057419108;Taip;11;0;0;11
12060;Zylutė;"Miki Maus";3668160578;Ne;10;0;0;10
12061;Zylutė;"Miki Maus";9093777086;Ne;0;8;0;8
12062;Zylutė;"Miki Maus";7123399601;Ne;0;7;0;7
12063;Zylutė;"Miki Maus";9951774752;Ne;5;0;0;5
12064;Zylutė;"Miki Maus";7625237309;Ne;13;0;0;13
12065;Zylutė;"Miki Maus";8291414891;Ne;7;0;0;7
12066;Zylutė;"Miki Maus";8230673446;Ne;10;0;0;10
12067;Zylutė;"Miki Maus";6876326785;Ne;6;0;0;6
12068;Zylutė;Solnyško;8379932761;Ne;10;0;0;10
12069;Zylutė;Solnyško;2088316489;Ne;0;6;0;6
12070;Zylutė;Solnyško;1076803315;Ne;2;1;0;3
12071;Zylutė;Solnyško;7616444695;Ne;9;0;0;9
12072;Zylutė;Solnyško;5234846079;Ne;1;1;0;2
12073;Zylutė;Solnyško;5939522435;Ne;0;3;0;3
12074;Zylutė;Solnyško;5826813410;Ne;0;13;0;13
12075;Zylutė;Solnyško;8033573972;Ne;1;0;0;1
12076;Zylutė;Solnyško;1969578486;Ne;3;1;0;4
12077;Zylutė;Solnyško;6573541087;Ne;20;0;0;20
12078;Zylutė;Solnyško;3201966434;Taip;1;1;0;2
12079;Zylutė;Solnyško;3656587423;Ne;5;0;0;5
12080;Zylutė;Solnyško;5011947014;Ne;0;1;0;1
12081;Zylutė;Solnyško;4474338590;Taip;0;0;2;2
12082;Zylutė;Solnyško;4474338590;Taip;0;0;2;2
12083;Zylutė;Motyliok;7241045507;Ne;10;0;0;10
12084;Zylutė;Motyliok;9913001904;Ne;11;0;0;11
12085;Zylutė;Motyliok;6112586092;Ne;0;10;0;10
12086;Zylutė;Motyliok;8178488164;Ne;9;0;0;9
12087;Zylutė;Motyliok;5045652581;Ne;0;10;0;10
12088;Zylutė;Motyliok;9586800176;Ne;2;0;0;2
12089;Zylutė;Motyliok;4497904128;Ne;0;9;0;9
12090;Zylutė;Motyliok;3355159275;Ne;0;3;0;3
12091;Zylutė;Motyliok;9995791665;Taip;6;0;2;8
12092;Zylutė;Motyliok;3455374127;Ne;4;6;0;10
12093;Zylutė;Motyliok;1632490481;Taip;4;1;0;5
12094;Zylutė;Motyliok;1726060015;Ne;11;0;0;11
12095;Zylutė;Motyliok;3084870481;Ne;5;0;0;5
12096;Zylutė;Motyliok;6051657134;Taip;2;0;0;2
12097;Zylutė;Motyliok;3271366684;Ne;2;0;0;2
12098;Zylutė;Motyliok;3633983359;Ne;5;0;0;5
12099;Zylutė;Motyliok;9155513221;Ne;14;0;0;14
12100;Zylutė;Motyliok;8262929231;Taip;15;0;0;15
12101;Zylutė;Motyliok;6601967273;Ne;6;0;0;6
12102;Zylutė;ŽVIRBLIUKAI;1319040747;Ne;0;0;5;5
12103;Zylutė;ŽVIRBLIUKAI;8326987895;Ne;0;2;0;2
12104;Zylutė;ŽVIRBLIUKAI;9330583784;Ne;10;0;0;10
12105;Zylutė;ŽVIRBLIUKAI;1220439948;Ne;0;10;0;10
12106;Zylutė;ŽVIRBLIUKAI;4646273830;Ne;0;0;1;1
12107;Zylutė;ŽVIRBLIUKAI;9580188426;Ne;5;0;1;6
12108;Zylutė;ŽVIRBLIUKAI;1797701777;Ne;0;1;0;1
12109;Zylutė;ŽVIRBLIUKAI;2966482773;Taip;0;5;0;5
12110;Zylutė;ŽVIRBLIUKAI;1452384017;Ne;0;0;1;1
12111;Zylutė;ŽVIRBLIUKAI;8152140523;Ne;0;0;5;5
12112;Zylutė;ŽVIRBLIUKAI;8346794629;Ne;0;0;3;3
12113;Zylutė;ŽVIRBLIUKAI;2061747513;Taip;0;2;0;2
12114;Zylutė;ŽVIRBLIUKAI;4611555689;Ne;0;7;0;7
12115;Zylutė;ŽVIRBLIUKAI;3894885445;Ne;0;4;0;4
12116;Zylutė;ŽVIRBLIUKAI;7137348151;Taip;3;1;0;4
12117;Zylutė;ŽVIRBLIUKAI;5722697679;Ne;0;0;1;1
12118;Zylutė;"DRUŽNYJE REBIATA";5332039406;Taip;16;0;0;16
12119;Zylutė;"DRUŽNYJE REBIATA";9039665233;Ne;1;0;0;1
12120;Zylutė;"DRUŽNYJE REBIATA";6075614020;Ne;15;2;0;17
12121;Zylutė;"DRUŽNYJE REBIATA";9518714240;Ne;1;2;0;3
12122;Zylutė;"DRUŽNYJE REBIATA";2693961315;Ne;17;0;0;17
12123;Zylutė;"DRUŽNYJE REBIATA";3372639449;Taip;3;0;0;3
12124;Zylutė;"DRUŽNYJE REBIATA";4916625058;Ne;3;0;0;3
12125;Zylutė;"DRUŽNYJE REBIATA";3447644735;Ne;5;0;0;5
12126;Zylutė;"DRUŽNYJE REBIATA";3174042441;Ne;8;2;0;10
12127;Zylutė;"DRUŽNYJE REBIATA";6848387941;Taip;7;1;0;8
12128;Zylutė;"DRUŽNYJE REBIATA";9193349264;Ne;5;1;1;7
12129;Zylutė;"DRUŽNYJE REBIATA";2444440430;Ne;3;0;0;3
12130;Zylutė;"DRUŽNYJE REBIATA";8204885376;Ne;3;0;3;6
12131;Zylutė;"DRUŽNYJE REBIATA";9769201088;Ne;10;2;0;12
12132;Zylutė;"DRUŽNYJE REBIATA";5233163416;Ne;6;1;0;7
12133;Zylutė;"DRUŽNYJE REBIATA";5126282685;Ne;0;2;0;2
12134;Zylutė;VIEVERSĖLIAI;9748604675;Taip;15;0;0;15
12135;Zylutė;VIEVERSĖLIAI;9372402025;Taip;10;0;0;10
12136;Zylutė;VIEVERSĖLIAI;6540140502;Ne;6;0;0;6
12137;Zylutė;VIEVERSĖLIAI;5058082347;Ne;6;0;0;6
12138;Zylutė;VIEVERSĖLIAI;6311805184;Ne;6;0;0;6
12139;Zylutė;VIEVERSĖLIAI;7072947464;Ne;13;0;0;13
12140;Zylutė;VIEVERSĖLIAI;3449678598;Ne;8;0;0;8
12141;Zylutė;VIEVERSĖLIAI;1271913393;Ne;13;0;0;13
12142;Zylutė;VIEVERSĖLIAI;4135186333;Ne;3;0;0;3
12143;Zylutė;VIEVERSĖLIAI;7070131037;Ne;10;0;0;10
12144;Zylutė;VIEVERSĖLIAI;1501573278;Taip;6;0;0;6
12145;Zylutė;VIEVERSĖLIAI;3787829836;Ne;2;0;0;2
12146;Zylutė;VIEVERSĖLIAI;5125900173;Ne;7;0;0;7
12147;Zylutė;VIEVERSĖLIAI;7173499688;Ne;10;0;0;10
12148;Zylutė;VIEVERSĖLIAI;8095671158;Taip;6;0;0;6
12149;Zylutė;VIEVERSĖLIAI;5444138006;Taip;13;0;0;13
12150;Zylutė;VIEVERSĖLIAI;4437827048;Ne;12;0;0;12
12151;Želmenėliai;Bitučių;3268310531;Ne;9;0;0;9
12152;Želmenėliai;Bitučių;2563117992;Ne;4;0;0;4
12153;Želmenėliai;Bitučių;6799702725;Ne;0;2;0;2
12154;Želmenėliai;Bitučių;8358780570;Ne;5;1;0;6
12155;Želmenėliai;Bitučių;9006406225;Ne;4;6;0;10
12156;Želmenėliai;Bitučių;5147895081;Ne;0;2;0;2
12157;Želmenėliai;Bitučių;9611741258;Ne;1;0;1;2
12158;Želmenėliai;Bitučių;1619143702;Ne;4;0;1;5
12159;Želmenėliai;Bitučių;9825545754;Ne;1;0;0;1
12160;Želmenėliai;Bitučių;5314438217;Ne;0;4;0;4
12161;Želmenėliai;Bitučių;4927030144;Ne;2;2;0;4
12162;Želmenėliai;Bitučių;8028761330;Ne;6;0;0;6
12163;Želmenėliai;Bitučių;2853659708;Ne;2;0;0;2
12164;Želmenėliai;Bitučių;9207984505;Ne;5;8;0;13
12165;Želmenėliai;Kačiukų;1292462938;Ne;0;0;1;1
12166;Želmenėliai;Kačiukų;2350936740;Taip;5;2;0;7
12167;Želmenėliai;Kačiukų;3063417708;Ne;0;7;0;7
12168;Želmenėliai;Kačiukų;2570248893;Ne;0;1;0;1
12169;Želmenėliai;Kačiukų;2577850672;Ne;0;4;0;4
12170;Želmenėliai;Kačiukų;7197717698;Ne;2;0;0;2
12171;Želmenėliai;Kačiukų;7849682820;Ne;8;3;0;11
12172;Želmenėliai;Kačiukų;2111008869;Ne;1;0;0;1
12173;Želmenėliai;Kačiukų;4589396143;Taip;0;1;0;1
12174;Želmenėliai;Kačiukų;4198085732;Ne;0;3;0;3
12175;Želmenėliai;Kačiukų;6509783586;Ne;0;2;0;2
12176;Želmenėliai;Kačiukų;4758240577;Ne;0;1;0;1
12177;Želmenėliai;Kačiukų;7094853897;Taip;15;0;0;15
12178;Želmenėliai;Kačiukų;9493581034;Ne;0;2;0;2
12179;Želmenėliai;Kačiukų;4931664953;Ne;0;7;0;7
12180;Želmenėliai;Kačiukų;4376978921;Ne;10;10;0;20
12181;Želmenėliai;Kačiukų;9313666706;Ne;0;3;0;3
12182;Želmenėliai;Kačiukų;8590129703;Ne;4;0;7;11
12183;Želmenėliai;Kačiukų;3959066963;Ne;3;1;2;6
12184;Želmenėliai;Voveriukų;5360157217;Ne;8;9;0;17
12185;Želmenėliai;Voveriukų;2545133678;Ne;0;0;1;1
12186;Želmenėliai;Voveriukų;4968328834;Ne;4;0;0;4
12187;Želmenėliai;Voveriukų;2924134152;Ne;9;0;2;11
12188;Želmenėliai;Voveriukų;5975166975;Ne;10;10;0;20
12189;Želmenėliai;Voveriukų;6857922902;Ne;2;1;0;3
12190;Želmenėliai;Voveriukų;9811131936;Ne;2;0;0;2
12191;Želmenėliai;Voveriukų;8968533318;Ne;0;0;3;3
12192;Želmenėliai;Voveriukų;8952421941;Ne;0;1;0;1
12193;Želmenėliai;Voveriukų;7345540758;Ne;1;0;0;1
12194;Želmenėliai;Voveriukų;4248374729;Ne;0;3;0;3
12195;Želmenėliai;Voveriukų;7263162876;Ne;12;0;0;12
12196;Želmenėliai;Voveriukų;1199920167;Ne;6;0;0;6
12197;Želmenėliai;Voveriukų;5247889693;Taip;11;1;0;12
12198;Želmenėliai;Voveriukų;5767158743;Ne;0;0;1;1
12199;Želmenėliai;Ežiukų;1652131150;Ne;5;1;0;6
12200;Želmenėliai;Ežiukų;5795735579;Ne;1;1;0;2
12201;Želmenėliai;Ežiukų;2311169187;Ne;5;0;0;5
12202;Želmenėliai;Ežiukų;3572462731;Ne;1;0;0;1
12203;Želmenėliai;Ežiukų;3353793939;Ne;5;0;0;5
12204;Želmenėliai;Ežiukų;7495157523;Ne;3;0;0;3
12205;Želmenėliai;Ežiukų;6779746783;Ne;7;0;0;7
12206;Želmenėliai;Ežiukų;6876147546;Taip;0;4;0;4
12207;Želmenėliai;Ežiukų;9126715074;Ne;5;0;0;5
12208;Želmenėliai;Ežiukų;1260607572;Ne;0;1;0;1
12209;Želmenėliai;Ežiukų;5638248652;Ne;8;0;0;8
12210;Želmenėliai;Ežiukų;8154713582;Ne;3;15;0;18
12211;Želmenėliai;Ežiukų;2296870749;Ne;4;0;0;4
12212;Želmenėliai;Ežiukų;6180553648;Ne;0;4;0;4
12213;Želmenėliai;Ežiukų;7294722095;Ne;8;1;0;9
12214;Želmenėliai;Ežiukų;4120125150;Ne;9;1;0;10
12215;Želmenėliai;Ežiukų;8987377791;Ne;0;2;0;2
12216;Želmenėliai;Ežiukų;6481952132;Ne;4;1;0;5
12217;Želmenėliai;Peledžiukų;8491797555;Ne;0;13;0;13
12218;Želmenėliai;Peledžiukų;7058759730;Ne;0;3;0;3
12219;Želmenėliai;Peledžiukų;4485249321;Ne;4;0;0;4
12220;Želmenėliai;Peledžiukų;3869372021;Ne;0;5;0;5
12221;Želmenėliai;Peledžiukų;4374898642;Ne;2;0;0;2
12222;Želmenėliai;Peledžiukų;7751609462;Ne;9;0;0;9
12223;Želmenėliai;Peledžiukų;5362390260;Ne;0;1;0;1
12224;Želmenėliai;Peledžiukų;1580370689;Ne;0;5;0;5
12225;Želmenėliai;Peledžiukų;7672980212;Ne;5;2;0;7
12226;Želmenėliai;Peledžiukų;6260153299;Ne;5;0;0;5
12227;Želmenėliai;Peledžiukų;6187661667;Ne;2;0;0;2
12228;Želmenėliai;Peledžiukų;6109546917;Ne;6;2;0;8
12229;Želmenėliai;Peledžiukų;8118696261;Ne;5;0;0;5
12230;Želmenėliai;Peledžiukų;4746898209;Ne;7;2;1;10
12231;Želmenėliai;Peledžiukų;9929149682;Taip;11;0;0;11
12232;Želmenėliai;Peledžiukų;3723155757;Taip;9;1;0;10
12233;Želmenėliai;Peledžiukų;6662439747;Ne;0;7;0;7
12234;Želmenėliai;Drugelių;7123290599;Ne;3;0;1;4
12235;Želmenėliai;Drugelių;4526936339;Ne;12;0;0;12
12236;Želmenėliai;Drugelių;5052052744;Ne;8;2;0;10
12237;Želmenėliai;Drugelių;2878494111;Ne;1;12;0;13
12238;Želmenėliai;Drugelių;5169813205;Ne;13;0;0;13
12239;Želmenėliai;Drugelių;7341132501;Ne;6;2;0;8
12240;Želmenėliai;Drugelių;9661692350;Ne;11;3;0;14
12241;Želmenėliai;Drugelių;6230010537;Ne;0;4;0;4
12242;Želmenėliai;Drugelių;1025894534;Ne;5;10;0;15
12243;Želmenėliai;Drugelių;1606079948;Ne;0;3;0;3
12244;Želmenėliai;Drugelių;9250666159;Ne;24;0;0;24
12245;Želmenėliai;Drugelių;5569699398;Ne;24;0;0;24
12246;Želmenėliai;Drugelių;4207070475;Ne;10;1;0;11
12247;Želmenėliai;Drugelių;8409831053;Taip;5;1;0;6
12248;Želmenėliai;Drugelių;8060048377;Ne;25;0;0;25
12249;Želmenėliai;Drugelių;3608041516;Ne;0;2;1;3
12250;Želmenėliai;Drugelių;2578675950;Ne;11;0;0;11
12251;Želmenėliai;Drugelių;5454656514;Ne;5;1;0;6
12252;Želmenėliai;Drugelių;7792850272;Ne;15;0;0;15
12253;Želmenėliai;Voriukų;6916426436;Ne;0;0;3;3
12254;Želmenėliai;Voriukų;7563461821;Ne;0;6;0;6
12255;Želmenėliai;Voriukų;4534946646;Ne;0;2;0;2
12256;Želmenėliai;Voriukų;4075533071;Ne;0;3;0;3
12257;Želmenėliai;Voriukų;4545012342;Ne;20;0;0;20
12258;Želmenėliai;Voriukų;7505996978;Ne;0;8;0;8
12259;Želmenėliai;Voriukų;2722619508;Ne;12;0;0;12
12260;Želmenėliai;Voriukų;5025345647;Ne;7;0;0;7
12261;Želmenėliai;Voriukų;8273301992;Ne;0;3;0;3
12262;Želmenėliai;Voriukų;9427388681;Ne;0;4;0;4
12263;Želmenėliai;Voriukų;6343814445;Ne;0;0;1;1
12264;Želmenėliai;Voriukų;5171736943;Ne;0;3;0;3
12265;Želmenėliai;Voriukų;7833143421;Ne;2;2;1;5
12266;Želmenėliai;Voriukų;7423900312;Ne;0;2;0;2
12267;Želmenėliai;Boružėlių;1764468979;Ne;2;5;0;7
12268;Želmenėliai;Boružėlių;8722573513;Ne;0;3;0;3
12269;Želmenėliai;Boružėlių;3516695805;Ne;8;2;0;10
12270;Želmenėliai;Boružėlių;5949535657;Ne;5;0;0;5
12271;Želmenėliai;Boružėlių;7077832687;Ne;8;1;0;9
12272;Želmenėliai;Boružėlių;3896171121;Ne;10;0;0;10
12273;Želmenėliai;Boružėlių;2951719129;Ne;11;2;0;13
12274;Želmenėliai;Boružėlių;5207899503;Ne;16;1;0;17
12275;Želmenėliai;Boružėlių;2111705047;Ne;8;0;0;8
12276;Želmenėliai;Boružėlių;8474210476;Taip;5;0;0;5
12277;Želmenėliai;Boružėlių;2179165096;Ne;4;2;0;6
12278;Želmenėliai;Boružėlių;6831569546;Ne;0;0;2;2
12279;Želmenėliai;Boružėlių;9042786857;Ne;2;1;0;3
12280;Želmenėliai;Boružėlių;5913022147;Ne;0;2;0;2
12281;Želmenėliai;Pūkuotukų;3558547171;Ne;0;1;0;1
12282;Želmenėliai;Pūkuotukų;4485851428;Ne;7;2;0;9
12283;Želmenėliai;Pūkuotukų;2501163903;Ne;11;0;0;11
12284;Želmenėliai;Pūkuotukų;1426080041;Taip;0;3;0;3
12285;Želmenėliai;Pūkuotukų;9076874685;Ne;0;1;0;1
12286;Želmenėliai;Pūkuotukų;3346680108;Ne;20;0;0;20
12287;Želmenėliai;Pūkuotukų;8654298177;Ne;9;0;0;9
12288;Želmenėliai;Pūkuotukų;9182208354;Ne;5;0;0;5
12289;Želmenėliai;Pūkuotukų;9544233589;Ne;5;0;0;5
12290;Želmenėliai;Pūkuotukų;4679930998;Ne;13;0;0;13
12291;Želmenėliai;Pūkuotukų;4930868989;Ne;5;4;0;9
12292;Želmenėliai;Pūkuotukų;4451798870;Ne;4;3;0;7
12293;Želmenėliai;Pūkuotukų;8104790589;Ne;9;1;0;10
12294;Želmenėliai;Pūkuotukų;4722890143;Taip;0;1;0;1
12295;Želmenėliai;Pūkuotukų;3232996198;Ne;6;1;0;7
12296;Želmenėliai;Pūkuotukų;6764567873;Ne;5;1;2;8
12297;Želmenėliai;Pūkuotukų;3926238501;Ne;0;10;0;10
12298;Želmenėliai;Pūkuotukų;2095477479;Ne;3;2;1;6
12299;Želmenėliai;Ančiukų;9377359390;Ne;7;0;0;7
12300;Želmenėliai;Ančiukų;8165683014;Ne;25;0;0;25
12301;Želmenėliai;Ančiukų;3172645969;Taip;7;0;0;7
12302;Želmenėliai;Ančiukų;7128213908;Ne;0;7;0;7
12303;Želmenėliai;Ančiukų;6723870371;Ne;4;0;0;4
12304;Želmenėliai;Ančiukų;5872145297;Ne;1;0;0;1
12305;Želmenėliai;Ančiukų;4824276300;Ne;10;0;0;10
12306;Želmenėliai;Ančiukų;9558387704;Ne;5;0;0;5
12307;Želmenėliai;Ančiukų;7550865762;Ne;8;0;0;8
12308;Želmenėliai;Ančiukų;4841250486;Ne;11;0;0;11
12309;Želmenėliai;Ančiukų;3057181122;Ne;6;0;0;6
12310;Želmenėliai;Ančiukų;1359184372;Ne;18;1;0;19
12311;Želmenėliai;Ančiukų;9945526672;Ne;30;0;0;30
12312;Želmenėliai;Nykštukų;3003922213;Ne;15;0;0;15
12313;Želmenėliai;Nykštukų;3539019330;Ne;5;0;0;5
12314;Želmenėliai;Nykštukų;3313780575;Ne;20;0;0;20
12315;Želmenėliai;Nykštukų;8191484604;Ne;20;0;0;20
12316;Želmenėliai;Nykštukų;2028226797;Ne;0;7;0;7
12317;Želmenėliai;Nykštukų;2369379191;Taip;5;0;0;5
12318;Želmenėliai;Nykštukų;6172599827;Ne;10;0;0;10
12319;Želmenėliai;Nykštukų;2678902898;Ne;6;0;1;7
12320;Želmenėliai;Nykštukų;7537198352;Ne;8;0;0;8
12321;Želmenėliai;Nykštukų;2896053108;Ne;7;1;0;8
12322;Želmenėliai;Nykštukų;4165912796;Ne;12;1;0;13
12323;Želmenėliai;Nykštukų;1613626023;Ne;0;1;0;1
12324;Želmenėliai;Nykštukų;2105799163;Ne;4;1;0;5
12325;Želmenėliai;Lašelių;9483665065;Ne;14;1;0;15
12326;Želmenėliai;Lašelių;5494517342;Ne;5;0;0;5
12327;Želmenėliai;Lašelių;9774587149;Ne;3;0;0;3
12328;Želmenėliai;Lašelių;2143421412;Ne;15;0;0;15
12329;Želmenėliai;Lašelių;9608259121;Ne;10;1;0;11
12330;Želmenėliai;Lašelių;6605391184;Ne;6;0;0;6
12331;Želmenėliai;Lašelių;4197691574;Ne;0;1;0;1
12332;Želmenėliai;Lašelių;3788587862;Taip;10;0;0;10
12333;Želmenėliai;Lašelių;7067545362;Ne;6;1;0;7
12334;Želmenėliai;Lašelių;4354709866;Ne;15;0;0;15
12335;Žemyna;Čiauškučiai;9985529041;Ne;0;1;6;7
12336;Žemyna;Čiauškučiai;9570187081;Taip;5;0;0;5
12337;Žemyna;Čiauškučiai;2547436771;Ne;0;0;2;2
12338;Žemyna;Čiauškučiai;6346173832;Ne;0;0;1;1
12339;Žemyna;Čiauškučiai;3074391266;Taip;0;0;4;4
12340;Žemyna;Čiauškučiai;4693414703;Ne;10;0;0;10
12341;Žemyna;Čiauškučiai;7620179886;Ne;0;0;1;1
12342;Žemyna;Čiauškučiai;2792702536;Ne;0;0;1;1
12343;Žemyna;Čiauškučiai;7376806308;Ne;0;1;0;1
12344;Žemyna;Čiauškučiai;7277970673;Ne;10;0;0;10
12345;Žemyna;Čiauškučiai;4642600915;Ne;0;0;1;1
12346;Žemyna;Čiauškučiai;2354265632;Ne;5;0;0;5
12347;Žemyna;Čiauškučiai;1654157342;Ne;0;1;0;1
12348;Žemyna;Čiauškučiai;7352868453;Ne;5;0;0;5
12349;Žemyna;Čiauškučiai;4501408683;Ne;4;1;0;5
12350;Žemyna;Čiauškučiai;7675699775;Ne;0;0;1;1
12351;Žemyna;Čiauškučiai;6254811026;Taip;5;0;2;7
12352;Žemyna;Nykštukai;5124024813;Ne;6;0;1;7
12353;Žemyna;Nykštukai;8965957442;Ne;7;0;2;9
12354;Žemyna;Nykštukai;6965700024;Ne;3;0;0;3
12355;Žemyna;Nykštukai;3413550977;Ne;15;0;0;15
12356;Žemyna;Nykštukai;8234617396;Taip;15;0;0;15
12357;Žemyna;Nykštukai;2105658990;Ne;2;0;1;3
12358;Žemyna;Nykštukai;1241953155;Ne;6;0;1;7
12359;Žemyna;Nykštukai;5274759824;Ne;0;0;1;1
12360;Žemyna;Nykštukai;9457156368;Taip;13;0;1;14
12361;Žemyna;Nykštukai;5968816137;Ne;5;0;1;6
12362;Žemyna;Nykštukai;4238528111;Taip;10;0;0;10
12363;Žemyna;Nykštukai;3741459808;Taip;10;0;0;10
12364;Žemyna;Nykštukai;3870917221;Ne;2;0;1;3
12365;Žemyna;Nykštukai;6571952468;Taip;14;0;0;14
12366;Žemyna;Nykštukai;6632827240;Ne;15;0;0;15
12367;Žemyna;Nykštukai;3935318882;Ne;9;0;0;9
12368;Žemyna;Nykštukai;2010676445;Ne;9;0;0;9
12369;Žemyna;Nykštukai;9788890112;Ne;14;0;0;14
12370;Žemyna;Nykštukai;8157281885;Ne;0;0;1;1
12371;Žemyna;Voveriukai;4549562657;Ne;8;2;0;10
12372;Žemyna;Voveriukai;8882641275;Ne;0;10;0;10
12373;Žemyna;Voveriukai;4900914346;Ne;0;8;0;8
12374;Žemyna;Voveriukai;8241038433;Ne;0;1;0;1
12375;Žemyna;Voveriukai;3500358886;Taip;11;0;0;11
12376;Žemyna;Voveriukai;6592356004;Ne;17;0;0;17
12377;Žemyna;Voveriukai;7468763527;Ne;2;0;0;2
12378;Žemyna;Voveriukai;7705964355;Ne;6;2;0;8
12379;Žemyna;Voveriukai;5486645485;Taip;5;2;1;8
12380;Žemyna;Voveriukai;5828590779;Ne;10;0;0;10
12381;Žemyna;Voveriukai;8601806926;Ne;0;20;0;20
12382;Žemyna;Kiškučiai;2006173745;Ne;0;0;2;2
12383;Žemyna;Kiškučiai;6116581655;Ne;0;0;1;1
12384;Žemyna;Kiškučiai;6728229865;Ne;0;6;0;6
12385;Žemyna;Kiškučiai;7280740926;Ne;0;0;1;1
12386;Žemyna;Kiškučiai;4872348199;Taip;0;0;2;2
12387;Žemyna;Kiškučiai;2710551760;Ne;0;1;0;1
12388;Žemyna;Kiškučiai;6419974691;Ne;0;0;2;2
12389;Žemyna;Kiškučiai;4502958166;Ne;0;1;1;2
12390;Žemyna;Kiškučiai;5868208651;Ne;0;0;1;1
12391;Žemyna;Kiškučiai;3992383447;Ne;10;0;0;10
12392;Žemyna;Kiškučiai;9568886284;Ne;5;0;3;8
12393;Žemyna;Kiškučiai;4612112289;Ne;0;1;0;1
12394;Žemyna;Kiškučiai;9501126807;Ne;0;0;3;3
12395;Žemyna;Vyturiukai;2526949655;Ne;11;1;0;12
12396;Žemyna;Vyturiukai;1417007895;Ne;0;4;0;4
12397;Žemyna;Vyturiukai;5355845891;Ne;1;0;0;1
12398;Žemyna;Vyturiukai;1481273689;Ne;2;0;0;2
12399;Žemyna;Vyturiukai;7781332622;Taip;13;1;0;14
12400;Žemyna;Vyturiukai;9366133892;Ne;0;0;1;1
12401;Žemyna;Vyturiukai;1031171460;Ne;4;0;0;4
12402;Žemyna;Vyturiukai;5204349188;Ne;6;0;0;6
12403;Žemyna;Vyturiukai;1345704379;Ne;17;0;0;17
12404;Žemyna;Vyturiukai;6097681172;Ne;2;4;0;6
12405;Žemyna;Vyturiukai;3446774478;Ne;5;2;0;7
12406;Žemyna;Vyturiukai;6271057561;Ne;0;2;0;2
12407;Žemyna;Vyturiukai;2304633263;Ne;0;0;5;5
12408;Žemyna;Vyturiukai;3679990879;Ne;4;0;3;7
12409;Žemyna;Vyturiukai;8681308720;Ne;2;2;1;5
12410;Žemyna;Vyturiukai;9646494715;Ne;8;1;0;9
12411;Žemyna;Vyturiukai;4863350801;Ne;5;0;0;5
12412;Žemyna;Vyturiukai;6372465987;Ne;5;0;0;5
12413;Žemyna;Vyturiukai;5655302107;Ne;4;6;0;10
12414;Žemyna;Pelėdžiukai;8525229514;Ne;4;0;1;5
12415;Žemyna;Pelėdžiukai;1846287760;Ne;3;0;6;9
12416;Žemyna;Pelėdžiukai;8775518984;Ne;3;0;5;8
12417;Žemyna;Pelėdžiukai;5337086029;Ne;5;0;0;5
12418;Žemyna;Pelėdžiukai;5450351549;Ne;0;0;3;3
12419;Žemyna;Pelėdžiukai;8926045231;Ne;11;0;0;11
12420;Žemyna;Pelėdžiukai;3860791215;Ne;6;0;0;6
12421;Žemyna;Pelėdžiukai;9471382383;Ne;0;0;2;2
12422;Žemyna;Pelėdžiukai;7942276632;Ne;0;0;1;1
12423;Žemyna;Pelėdžiukai;8408275231;Ne;2;0;4;6
12424;Žemyna;Pelėdžiukai;7417179112;Ne;0;0;1;1
12425;Žemyna;Pelėdžiukai;5387026410;Ne;5;0;0;5
12426;Žemyna;Pelėdžiukai;9831054554;Ne;0;0;4;4
12427;Žemyna;Pelėdžiukai;9194899557;Ne;6;0;0;6
12428;Žemyna;Pelėdžiukai;6175213274;Taip;20;0;0;20
12429;Žemyna;Pelėdžiukai;7311046586;Ne;0;0;2;2
12430;Žemyna;Pelėdžiukai;5124507416;Ne;0;0;2;2
12431;Žemyna;Pelėdžiukai;1713559750;Ne;1;0;1;2
12432;Žemyna;Vijurkai;4524929331;Ne;4;0;0;4
12433;Žemyna;Vijurkai;5114094924;Ne;0;2;0;2
12434;Žemyna;Vijurkai;3643594001;Ne;0;2;2;4
12435;Žemyna;Vijurkai;9182709647;Ne;1;0;0;1
12436;Žemyna;Vijurkai;4257096808;Ne;0;0;1;1
12437;Žemyna;Vijurkai;3874855308;Ne;3;0;0;3
12438;Žemyna;Vijurkai;7121742098;Ne;0;1;0;1
12439;Žemyna;Vijurkai;2461700030;Ne;0;7;0;7
12440;Žemyna;Vijurkai;3519840747;Ne;0;1;0;1
12441;Žemyna;Vijurkai;7508491119;Ne;0;1;0;1
12442;Žemyna;Vijurkai;1725771976;Ne;0;1;0;1
12443;Žemyna;Vijurkai;9653530823;Ne;2;2;0;4
12444;Žemyna;Vijurkai;2860210906;Ne;4;0;0;4
12445;Žemyna;Vijurkai;7832066079;Ne;3;4;0;7
12446;Žemyna;Vijurkai;4444870782;Ne;0;2;1;3
12447;Žemyna;Vijurkai;4265606762;Ne;6;0;0;6
12448;Žemyna;Vijurkai;7781924111;Ne;0;1;0;1
12449;Žemyna;Vijurkai;2928125522;Ne;5;1;0;6
12450;Žemyna;Vijurkai;4759403487;Ne;0;4;0;4
12451;Žemyna;Vijurkai;5222774764;Ne;0;20;0;20
12452;Žemyna;Šnekučiai;4540472310;Ne;2;6;0;8
12453;Žemyna;Šnekučiai;9647706055;Ne;1;5;0;6
12454;Žemyna;Šnekučiai;2883862675;Ne;6;0;0;6
12455;Žemyna;Šnekučiai;7537145330;Ne;5;0;0;5
12456;Žemyna;Šnekučiai;7683443675;Ne;5;0;0;5
12457;Žemyna;Šnekučiai;3899901920;Taip;6;0;0;6
12458;Žemyna;Šnekučiai;7831778620;Ne;0;2;0;2
12459;Žemyna;Šnekučiai;9692952139;Taip;4;0;0;4
12460;Žemyna;Šnekučiai;1795919515;Ne;0;1;0;1
12461;Žemyna;Šnekučiai;8319442149;Ne;6;0;0;6
12462;Žemyna;Šnekučiai;1999410395;Ne;7;0;0;7
12463;Žemyna;Šnekučiai;6872208929;Ne;0;5;0;5
12464;Žemyna;Šnekučiai;9813765590;Ne;14;3;0;17
12465;Žemyna;Šnekučiai;4779461598;Ne;5;0;2;7
12466;Žemyna;Šnekučiai;3976010927;Ne;19;0;0;19
12467;Žemyna;Šnekučiai;4963338410;Ne;9;0;0;9
12468;Žemyna;Šnekučiai;1078809628;Ne;10;0;0;10
12469;Žemyna;Šnekučiai;3729250035;Taip;5;0;0;5
12470;Žemyna;Šnekučiai;9535234845;Ne;5;0;2;7
12471;Žemyna;Šnekučiai;9796331127;Ne;4;1;0;5
12472;Žemyna;Šnekučiai;3996577758;Ne;1;1;0;2
12473;Žemyna;Pabiručiai;9827401825;Ne;0;4;0;4
12474;Žemyna;Pabiručiai;5743535463;Ne;0;6;0;6
12475;Žemyna;Pabiručiai;6958537154;Ne;0;2;0;2
12476;Žemyna;Pabiručiai;7005045961;Ne;0;1;0;1
12477;Žemyna;Pabiručiai;1745197274;Ne;0;1;0;1
12478;Žemyna;Pabiručiai;6041223291;Ne;5;2;0;7
12479;Žemyna;Pabiručiai;7122276019;Ne;0;1;0;1
12480;Žemyna;Pabiručiai;6208953341;Ne;0;6;0;6
12481;Žemyna;Pabiručiai;5127174926;Ne;10;0;0;10
12482;Žemyna;Pabiručiai;8559870965;Ne;0;2;1;3
12483;Žemyna;Pabiručiai;6450681255;Ne;3;0;0;3
12484;Žemyna;Pabiručiai;2860232791;Ne;0;0;1;1
12485;Žemyna;Pabiručiai;2414400761;Ne;0;5;0;5
12486;Žemyna;Pabiručiai;9511935264;Ne;0;3;0;3
12487;Žemyna;Pabiručiai;3393414493;Ne;5;0;0;5
12488;Žemyna;Pabiručiai;4960936366;Taip;10;0;0;10
12489;Žemyna;Pabiručiai;2495616844;Ne;0;2;0;2
12490;Žemyna;Pabiručiai;6329592260;Ne;0;5;0;5
12491;Žemyna;Drugeliai;7564693757;Taip;5;1;1;7
12492;Žemyna;Drugeliai;3505551915;Ne;0;0;8;8
12493;Žemyna;Drugeliai;2231967652;Ne;0;0;2;2
12494;Žemyna;Drugeliai;3755964840;Ne;4;0;0;4
12495;Žemyna;Drugeliai;9171823612;Ne;0;0;9;9
12496;Žemyna;Drugeliai;5518125715;Ne;0;0;4;4
12497;Žemyna;Drugeliai;1279981170;Taip;6;0;2;8
12498;Žemyna;Drugeliai;2102920661;Ne;8;0;0;8
12499;Žemyna;Drugeliai;6575272457;Ne;0;0;4;4
12500;Žemyna;Drugeliai;6164541167;Ne;3;0;0;3
12501;Žemyna;Drugeliai;3390442637;Ne;1;0;2;3
12502;Žemyna;Drugeliai;2371069183;Ne;0;0;1;1
12503;Žemyna;Drugeliai;7920398415;Ne;10;4;0;14
12504;Žemyna;Drugeliai;1695063377;Ne;8;0;0;8
12505;Žemyna;Drugeliai;7745383607;Ne;6;0;1;7
12506;Žemyna;Drugeliai;8709792653;Ne;4;0;0;4
12507;Žemyna;Drugeliai;7969518430;Ne;8;5;2;15
12508;Žemyna;"ŽIRNIUKAI ";8638419172;Ne;7;0;1;8
12509;Žemyna;"ŽIRNIUKAI ";5262196604;Ne;3;0;1;4
12510;Žemyna;"ŽIRNIUKAI ";6783675344;Ne;5;0;0;5
12511;Žemyna;"ŽIRNIUKAI ";9082375371;Ne;5;0;0;5
12512;Žemyna;"ŽIRNIUKAI ";3172071074;Ne;5;0;15;20
12513;Žemyna;"ŽIRNIUKAI ";8574497593;Ne;3;0;8;11
12514;Žemyna;"ŽIRNIUKAI ";3951546627;Ne;6;0;0;6
12515;Žemyna;"ŽIRNIUKAI ";2333634521;Ne;0;0;5;5
12516;Žemyna;"ŽIRNIUKAI ";7567666690;Ne;4;0;0;4
12517;Žemyna;"ŽIRNIUKAI ";1667692063;Ne;5;0;14;19
12518;Žemyna;"ŽIRNIUKAI ";1898736492;Ne;0;2;0;2
12519;Žemyna;"ŽIRNIUKAI ";2302222659;Ne;9;0;0;9
12520;Žemyna;"ŽIRNIUKAI ";3695746422;Ne;14;0;0;14
12521;Žemyna;"ŽIRNIUKAI ";1014787654;Ne;15;0;0;15
12522;Žemyna;"ŽIOGELIAI ";5193466394;Ne;0;5;0;5
12523;Žemyna;"ŽIOGELIAI ";8205404725;Ne;0;0;1;1
12524;Žemyna;"ŽIOGELIAI ";6638712995;Ne;2;0;7;9
12525;Žemyna;"ŽIOGELIAI ";3768231563;Ne;6;0;0;6
12526;Žemyna;"ŽIOGELIAI ";7580529381;Ne;13;0;0;13
12527;Žemyna;"ŽIOGELIAI ";5593285877;Ne;13;0;0;13
12528;Žemyna;"ŽIOGELIAI ";3397833166;Ne;0;0;3;3
12529;Žemyna;"ŽIOGELIAI ";2255662379;Ne;5;0;1;6
12530;Žemyna;"ŽIOGELIAI ";8017209353;Ne;5;0;1;6
12531;Žemyna;"ŽIOGELIAI ";8036600474;Ne;2;0;1;3
12532;Žemyna;"ŽIOGELIAI ";6317657622;Ne;12;0;0;12
12533;Žemyna;"ŽIOGELIAI ";9992027222;Ne;18;0;0;18
12534;Žemuogėlė;Boružiukai;1350671777;Ne;13;0;0;13
12535;Žemuogėlė;Boružiukai;9344628661;Ne;1;0;0;1
12536;Žemuogėlė;Boružiukai;2158359435;Ne;5;0;1;6
12537;Žemuogėlė;Boružiukai;1639634300;Taip;20;0;0;20
12538;Žemuogėlė;Boružiukai;5521993938;Ne;5;0;0;5
12539;Žemuogėlė;Boružiukai;1267222057;Ne;8;2;0;10
12540;Žemuogėlė;Boružiukai;9562512849;Ne;18;2;0;20
12541;Žemuogėlė;Boružiukai;8661864424;Ne;4;1;0;5
12542;Žemuogėlė;Boružiukai;1150466286;Ne;8;0;0;8
12543;Žemuogėlė;Boružiukai;8040255583;Ne;0;4;0;4
12544;Žemuogėlė;Boružiukai;2190458676;Ne;4;1;0;5
12545;Žemuogėlė;Boružiukai;6073591450;Ne;7;0;0;7
12546;Žemuogėlė;Boružiukai;7328566035;Taip;4;0;0;4
12547;Žemuogėlė;Boružiukai;1350383125;Ne;5;0;0;5
12548;Žemuogėlė;Boružiukai;3413805578;Ne;7;0;0;7
12549;Žemuogėlė;Boružiukai;3677459716;Taip;1;0;0;1
12550;Žemuogėlė;Boružiukai;8426601160;Ne;6;0;0;6
12551;Žemuogėlė;Boružiukai;5911215640;Ne;0;2;9;11
12552;Žemuogėlė;Šviesuliukai;9599829363;Ne;8;2;0;10
12553;Žemuogėlė;Šviesuliukai;4663181188;Ne;0;6;0;6
12554;Žemuogėlė;Šviesuliukai;1341637008;Ne;2;0;0;2
12555;Žemuogėlė;Šviesuliukai;7288060676;Ne;23;0;0;23
12556;Žemuogėlė;Šviesuliukai;5447960062;Ne;5;0;0;5
12557;Žemuogėlė;Šviesuliukai;2652630375;Ne;6;0;0;6
12558;Žemuogėlė;Šviesuliukai;1250186598;Ne;3;0;0;3
12559;Žemuogėlė;Šviesuliukai;3287415964;Ne;2;7;0;9
12560;Žemuogėlė;Šviesuliukai;5094867109;Ne;6;0;0;6
12561;Žemuogėlė;Šviesuliukai;4974793430;Ne;9;0;0;9
12562;Žemuogėlė;Šviesuliukai;5125826172;Ne;0;8;0;8
12563;Žemuogėlė;Šviesuliukai;8262862183;Taip;11;1;0;12
12564;Žemuogėlė;Šviesuliukai;8798113318;Taip;2;0;0;2
12565;Žemuogėlė;Šviesuliukai;1280794094;Taip;4;0;0;4
12566;Žemuogėlė;Šviesuliukai;2251142510;Taip;4;0;0;4
12567;Žemuogėlė;Šviesuliukai;1417355297;Ne;2;0;0;2
12568;Žemuogėlė;Šviesuliukai;6659616731;Ne;0;3;0;3
12569;Žemuogėlė;Lašiukai;3190523750;Ne;3;0;6;9
12570;Žemuogėlė;Lašiukai;1251497003;Ne;3;0;0;3
12571;Žemuogėlė;Lašiukai;3706531223;Ne;0;1;0;1
12572;Žemuogėlė;Lašiukai;8029484123;Ne;12;0;0;12
12573;Žemuogėlė;Lašiukai;5992802843;Ne;0;1;0;1
12574;Žemuogėlė;Lašiukai;3753156044;Ne;10;0;0;10
12575;Žemuogėlė;Lašiukai;7592566602;Ne;6;2;1;9
12576;Žemuogėlė;Lašiukai;1555899448;Ne;0;2;0;2
12577;Žemuogėlė;Lašiukai;3546429231;Ne;0;7;0;7
12578;Žemuogėlė;Lašiukai;3073956225;Taip;9;1;0;10
12579;Žemuogėlė;Lašiukai;9693814425;Ne;5;0;0;5
12580;Žemuogėlė;Lašiukai;3059525247;Ne;4;0;0;4
12581;Žemuogėlė;Lašiukai;6747566307;Ne;0;1;0;1
12582;Žemuogėlė;Lašiukai;2115883173;Ne;10;0;0;10
12583;Žemuogėlė;Lašiukai;9848385521;Ne;0;0;4;4
12584;Žemuogėlė;Lašiukai;5602718614;Taip;0;0;10;10
12585;Žemuogėlė;Skambaliukai;7804015060;Ne;0;3;0;3
12586;Žemuogėlė;Skambaliukai;3765022476;Ne;1;2;0;3
12587;Žemuogėlė;Skambaliukai;9476688736;Ne;6;0;0;6
12588;Žemuogėlė;Skambaliukai;2001471529;Ne;2;0;0;2
12589;Žemuogėlė;Skambaliukai;9519563708;Taip;1;1;0;2
12590;Žemuogėlė;Skambaliukai;5266493632;Ne;0;1;0;1
12591;Žemuogėlė;Skambaliukai;2259779058;Ne;0;1;0;1
12592;Žemuogėlė;Skambaliukai;9378432383;Ne;13;2;0;15
12593;Žemuogėlė;Skambaliukai;2555902309;Ne;5;0;0;5
12594;Žemuogėlė;Skambaliukai;2132549536;Ne;13;0;0;13
12595;Žemuogėlė;Skambaliukai;8496353410;Ne;6;1;0;7
12596;Žemuogėlė;Skambaliukai;1733808230;Ne;4;8;0;12
12597;Žemuogėlė;Skambaliukai;1469759840;Ne;5;0;0;5
12598;Žemuogėlė;Skambaliukai;9579921777;Ne;12;0;0;12
12599;Žemuogėlė;Spinduliukai;9955429241;Taip;3;0;0;3
12600;Žemuogėlė;Spinduliukai;5971652934;Ne;0;9;0;9
12601;Žemuogėlė;Spinduliukai;4578291476;Ne;0;19;0;19
12602;Žemuogėlė;Spinduliukai;6707522989;Ne;0;4;0;4
12603;Žemuogėlė;Spinduliukai;7669457695;Ne;0;9;0;9
12604;Žemuogėlė;Spinduliukai;4933948491;Ne;3;11;0;14
12605;Žemuogėlė;Spinduliukai;7342985744;Ne;18;4;0;22
12606;Žemuogėlė;Spinduliukai;7551522580;Ne;5;1;0;6
12607;Žemuogėlė;Spinduliukai;5499401648;Ne;5;5;0;10
12608;Žemuogėlė;Spinduliukai;7603740057;Ne;14;2;0;16
12609;Žemuogėlė;Spinduliukai;3746045950;Ne;0;10;0;10
12610;Žemuogėlė;Spinduliukai;4506847669;Ne;10;3;0;13
12611;Žemuogėlė;Spinduliukai;7837251012;Ne;6;2;2;10
12612;Žemuogėlė;Spinduliukai;7189855370;Ne;0;13;0;13
12613;Žemuogėlė;Spinduliukai;3801534195;Ne;4;1;0;5
12614;Žemuogėlė;Perliukai;1002937953;Ne;0;2;0;2
12615;Žemuogėlė;Perliukai;6504659145;Ne;2;1;0;3
12616;Žemuogėlė;Perliukai;3505090532;Ne;5;8;0;13
12617;Žemuogėlė;Perliukai;1790341419;Taip;1;0;0;1
12618;Žemuogėlė;Perliukai;4998981337;Taip;6;1;0;7
12619;Žemuogėlė;Perliukai;6045257180;Ne;1;0;0;1
12620;Žemuogėlė;Perliukai;8301927361;Ne;13;0;1;14
12621;Žemuogėlė;Perliukai;2496321184;Ne;2;0;0;2
12622;Žemuogėlė;Perliukai;8490643028;Ne;0;2;0;2
12623;Žemuogėlė;Perliukai;5208043522;Ne;13;0;0;13
12624;Žemuogėlė;Perliukai;2139102266;Ne;18;1;0;19
12625;Žemuogėlė;Perliukai;3740127955;Taip;9;3;1;13
12626;Žemuogėlė;Perliukai;5614510812;Ne;5;0;0;5
12627;Žemuogėlė;Perliukai;9735379466;Ne;0;2;0;2
12628;Žemuogėlė;Perliukai;4089939292;Taip;8;0;0;8
12629;Žemuogėlė;Perliukai;9584172565;Ne;5;1;0;6
12630;Žemuogėlė;Perliukai;8706379207;Ne;5;0;0;5
12631;Žemuogėlė;Perliukai;1457860763;Ne;7;0;0;7
12632;Žemuogėlė;Drugeliai;2745609317;Ne;11;0;0;11
12633;Žemuogėlė;Drugeliai;9694133286;Ne;5;1;0;6
12634;Žemuogėlė;Drugeliai;5557409350;Taip;10;2;0;12
12635;Žemuogėlė;Drugeliai;7668200447;Ne;9;0;0;9
12636;Žemuogėlė;Drugeliai;7148244029;Ne;10;2;0;12
12637;Žemuogėlė;Drugeliai;1901423257;Ne;0;5;0;5
12638;Žemuogėlė;Drugeliai;4862145385;Ne;20;1;0;21
12639;Žemuogėlė;Drugeliai;4368183799;Taip;17;1;0;18
12640;Žemuogėlė;Drugeliai;9902953729;Ne;12;2;0;14
12641;Žemuogėlė;Drugeliai;9537297860;Ne;1;9;0;10
12642;Žemuogėlė;Drugeliai;5170205929;Ne;5;3;0;8
12643;Žemuogėlė;Drugeliai;2428043195;Ne;3;4;0;7
12644;Žemuogėlė;Drugeliai;1716114524;Taip;5;1;0;6
12645;Žemuogėlė;Drugeliai;8137567729;Ne;0;4;0;4
12646;Žemuogėlė;Drugeliai;7974688217;Ne;16;0;0;16
12647;Žemuogėlė;Drugeliai;9273896998;Ne;19;0;0;19
12648;Žemuogėlė;Drugeliai;9801151322;Ne;0;7;0;7
12649;Žemuogėlė;Drugeliai;5142411841;Taip;10;0;0;10
12650;Žemuogėlė;Drugeliai;9872387354;Ne;13;1;0;14
12651;Žemuogėlė;"VIEVERSIUKAI ";6520776378;Ne;3;0;0;3
12652;Žemuogėlė;"VIEVERSIUKAI ";8048818368;Ne;9;0;0;9
12653;Žemuogėlė;"VIEVERSIUKAI ";6577040746;Ne;12;0;0;12
12654;Žemuogėlė;"VIEVERSIUKAI ";2674188340;Ne;8;0;0;8
12655;Žemuogėlė;"VIEVERSIUKAI ";7823828526;Ne;6;0;0;6
12656;Žemuogėlė;"VIEVERSIUKAI ";4172356209;Taip;22;0;0;22
12657;Žemuogėlė;"VIEVERSIUKAI ";6379837644;Ne;7;0;0;7
12658;Žemuogėlė;"VIEVERSIUKAI ";3104276726;Ne;4;0;0;4
12659;Žemuogėlė;"VIEVERSIUKAI ";3419907292;Ne;5;0;0;5
12660;Žemuogėlė;"VIEVERSIUKAI ";2800160529;Taip;7;0;0;7
12661;Žemuogėlė;"VIEVERSIUKAI ";8934779062;Ne;10;0;0;10
12662;Žemuogėlė;"VIEVERSIUKAI ";3090630899;Ne;4;0;0;4
12663;Žemuogėlė;"VIEVERSIUKAI ";8091000121;Ne;10;0;0;10
12664;Žemuogėlė;"VIEVERSIUKAI ";2110963483;Ne;24;0;0;24
12665;Žemuogėlė;"VIEVERSIUKAI ";2574719380;Taip;12;0;0;12
12666;Žemuogėlė;"NYKŠTUKAI ";9205221446;Ne;5;0;0;5
12667;Žemuogėlė;"NYKŠTUKAI ";2655733505;Ne;10;0;0;10
12668;Žemuogėlė;"NYKŠTUKAI ";1911605637;Ne;12;1;0;13
12669;Žemuogėlė;"NYKŠTUKAI ";9798128294;Ne;30;0;0;30
12670;Žemuogėlė;"NYKŠTUKAI ";1916826391;Taip;6;1;0;7
12671;Žemuogėlė;"NYKŠTUKAI ";5948873766;Ne;2;0;0;2
12672;Žemuogėlė;"NYKŠTUKAI ";3010585170;Ne;7;11;0;18
12673;Žemuogėlė;"NYKŠTUKAI ";1769751604;Ne;11;0;0;11
12674;Žemuogėlė;"NYKŠTUKAI ";3462564692;Ne;28;0;0;28
12675;Žemuogėlė;"NYKŠTUKAI ";7565473877;Ne;4;0;0;4
12676;Žemuogėlė;"NYKŠTUKAI ";8706639942;Taip;10;0;0;10
12677;Žemuogėlė;"NYKŠTUKAI ";4180815331;Ne;8;1;0;9
12678;Žemuogėlė;"NYKŠTUKAI ";9290074229;Ne;2;0;0;2
12679;Žemuogėlė;"NYKŠTUKAI ";1601617523;Ne;19;1;0;20
12680;Žemuogėlė;KIŠKUČIAI;3467743802;Ne;27;0;0;27
12681;Žemuogėlė;KIŠKUČIAI;8584425313;Taip;17;0;0;17
12682;Žemuogėlė;KIŠKUČIAI;7423719480;Ne;16;0;0;16
12683;Žemuogėlė;KIŠKUČIAI;9889748260;Ne;5;0;0;5
12684;Žemuogėlė;KIŠKUČIAI;3385450072;Ne;6;6;0;12
12685;Žemuogėlė;KIŠKUČIAI;3842157786;Ne;14;0;0;14
12686;Žemuogėlė;KIŠKUČIAI;3726995259;Ne;0;1;0;1
12687;Žemuogėlė;KIŠKUČIAI;6557523361;Ne;4;0;0;4
12688;Žemuogėlė;KIŠKUČIAI;9153455673;Ne;30;0;0;30
12689;Žemuogėlė;KIŠKUČIAI;2091617436;Ne;22;0;0;22
12690;Žemuogėlė;KIŠKUČIAI;9501717210;Ne;22;0;0;22
12691;Žemuogėlė;KIŠKUČIAI;6901260056;Ne;12;0;0;12
12692;Žemuogėlė;KIŠKUČIAI;7263992351;Ne;2;1;0;3
12693;Žemuogėlė;KIŠKUČIAI;7508582586;Ne;5;0;0;5
12694;Žemuogėlė;Žiniukai;8106709288;Ne;8;0;0;8
12695;Žemuogėlė;Žiniukai;2664267604;Ne;13;0;0;13
12696;Žemuogėlė;Žiniukai;1060986850;Ne;0;1;0;1
12697;Žemuogėlė;Žiniukai;9150335499;Taip;15;0;0;15
12698;Žemuogėlė;Žiniukai;7794377881;Taip;18;0;0;18
12699;Žemuogėlė;Žiniukai;1658954821;Ne;9;0;0;9
12700;Žemuogėlė;Žiniukai;4698671798;Ne;7;0;0;7
12701;Žemuogėlė;Žiniukai;1079114347;Ne;6;0;0;6
12702;Žemuogėlė;Žiniukai;5902241163;Ne;8;1;0;9
12703;Žemuogėlė;Žiniukai;7879519193;Taip;3;3;0;6
12704;Žemuogėlė;Žiniukai;2922827304;Ne;14;0;0;14
12705;Žemuogėlė;Žiniukai;2109195565;Ne;12;1;0;13
12706;Žemuogėlė;Žiniukai;7415364637;Ne;17;0;0;17
12707;Žemuogėlė;Žiniukai;3710681463;Ne;8;0;0;8
12708;Žemuogėlė;Žiniukai;1796489729;Ne;5;1;0;6
12709;Žemuogėlė;Žiniukai;8215763877;Ne;4;3;0;7
12710;Žemuogėlė;Žiniukai;2934225120;Ne;10;1;0;11
12711;Žemuogėlė;Žiniukai;3426685084;Ne;11;1;0;12
12712;Žibutė;PELĖDŽIUKAI;3777544301;Taip;2;0;0;2
12713;Žibutė;PELĖDŽIUKAI;1362419302;Ne;2;0;0;2
12714;Žibutė;PELĖDŽIUKAI;5677389434;Ne;2;1;0;3
12715;Žibutė;PELĖDŽIUKAI;5416015554;Ne;4;0;1;5
12716;Žibutė;PELĖDŽIUKAI;1366469428;Ne;6;0;0;6
12717;Žibutė;PELĖDŽIUKAI;4825064521;Ne;10;0;0;10
12718;Žibutė;PELĖDŽIUKAI;7531027545;Ne;2;0;1;3
12719;Žibutė;PELĖDŽIUKAI;3957898269;Ne;0;5;0;5
12720;Žibutė;PELĖDŽIUKAI;3645481894;Ne;4;0;0;4
12721;Žibutė;PELĖDŽIUKAI;8880329060;Taip;10;0;0;10
12722;Žibutė;PELĖDŽIUKAI;5591698130;Ne;1;0;0;1
12723;Žibutė;PELĖDŽIUKAI;9868621666;Ne;1;0;0;1
12724;Žibutė;PELĖDŽIUKAI;5009495840;Ne;4;0;0;4
12725;Žibutė;PELĖDŽIUKAI;7136145033;Ne;3;0;0;3
12726;Žibutė;PELĖDŽIUKAI;6978977383;Ne;0;0;3;3
12727;Žibutė;PELĖDŽIUKAI;2880593326;Ne;0;1;0;1
12728;Žibutė;PELĖDŽIUKAI;7479437931;Ne;0;2;0;2
12729;Žibutė;PELĖDŽIUKAI;9498011134;Ne;4;0;0;4
12730;Žibutė;KREGŽDUTĖS;7036454359;Ne;10;0;0;10
12731;Žibutė;KREGŽDUTĖS;3555071718;Ne;8;0;0;8
12732;Žibutė;KREGŽDUTĖS;5412917352;Ne;8;0;0;8
12733;Žibutė;KREGŽDUTĖS;5190377896;Ne;8;0;0;8
12734;Žibutė;KREGŽDUTĖS;3574946816;Ne;2;0;0;2
12735;Žibutė;KREGŽDUTĖS;9923687090;Ne;14;1;0;15
12736;Žibutė;KREGŽDUTĖS;4847295068;Ne;7;0;0;7
12737;Žibutė;KREGŽDUTĖS;9700866512;Ne;4;0;0;4
12738;Žibutė;KREGŽDUTĖS;7774532200;Ne;0;4;0;4
12739;Žibutė;KREGŽDUTĖS;2607509585;Ne;3;1;0;4
12740;Žibutė;KREGŽDUTĖS;8944042589;Ne;3;0;0;3
12741;Žibutė;KREGŽDUTĖS;2438980348;Ne;6;1;0;7
12742;Žibutė;KREGŽDUTĖS;5126232169;Ne;9;0;0;9
12743;Žibutė;KREGŽDUTĖS;8792292819;Ne;15;0;0;15
12744;Žibutė;KREGŽDUTĖS;7668484415;Ne;0;6;0;6
12745;Žibutė;KREGŽDUTĖS;2516448580;Ne;0;7;0;7
12746;Žibutė;BORUŽĖLĖS;8303166103;Ne;5;0;0;5
12747;Žibutė;BORUŽĖLĖS;4708691611;Ne;16;0;0;16
12748;Žibutė;BORUŽĖLĖS;9116859942;Ne;0;3;0;3
12749;Žibutė;BORUŽĖLĖS;1730975120;Ne;12;1;0;13
12750;Žibutė;BORUŽĖLĖS;9547812966;Ne;3;0;0;3
12751;Žibutė;BORUŽĖLĖS;9563567679;Ne;10;0;0;10
12752;Žibutė;BORUŽĖLĖS;7738606888;Ne;9;0;0;9
12753;Žibutė;BORUŽĖLĖS;6072605005;Ne;5;1;0;6
12754;Žibutė;BORUŽĖLĖS;8423264689;Ne;7;0;0;7
12755;Žibutė;BORUŽĖLĖS;5462787553;Ne;3;0;0;3
12756;Žibutė;BORUŽĖLĖS;3258258046;Ne;7;0;0;7
12757;Žibutė;BORUŽĖLĖS;9127784681;Ne;4;0;0;4
12758;Žibutė;BORUŽĖLĖS;6209156111;Ne;0;4;0;4
12759;Žibutė;BITUTĖS;7023683517;Ne;9;0;0;9
12760;Žibutė;BITUTĖS;3687123871;Ne;11;0;0;11
12761;Žibutė;BITUTĖS;2312717334;Ne;5;0;0;5
12762;Žibutė;BITUTĖS;6361543454;Ne;6;0;0;6
12763;Žibutė;BITUTĖS;6934760468;Ne;0;2;0;2
12764;Žibutė;BITUTĖS;4455757640;Ne;2;0;0;2
12765;Žibutė;BITUTĖS;8797870379;Ne;3;0;0;3
12766;Žibutė;BITUTĖS;7792267540;Ne;2;0;0;2
12767;Žibutė;BITUTĖS;9221523836;Ne;0;2;0;2
12768;Žibutė;BITUTĖS;3632745935;Ne;5;1;0;6
12769;Žibutė;BITUTĖS;7611641692;Ne;3;0;0;3
12770;Žibutė;BITUTĖS;5112512917;Ne;6;0;0;6
12771;Žibutė;BITUTĖS;8276724226;Ne;1;0;0;1
12772;Žibutė;BITUTĖS;4685356158;Ne;5;0;0;5
12773;Žibutė;BITUTĖS;1515636796;Ne;6;1;0;7
12774;Žibutė;BITUTĖS;7872636200;Ne;15;0;0;15
12775;Žibutė;BITUTĖS;6833179680;Ne;14;0;0;14
12776;Žibutė;BITUTĖS;1614551884;Ne;14;0;0;14
12777;Žibutė;KAČIUKAI;9611892163;Taip;6;0;0;6
12778;Žibutė;KAČIUKAI;1786332689;Ne;0;1;0;1
12779;Žibutė;KAČIUKAI;3618347199;Ne;2;0;0;2
12780;Žibutė;KAČIUKAI;5591970907;Ne;0;5;0;5
12781;Žibutė;KAČIUKAI;7764376193;Ne;10;0;0;10
12782;Žibutė;KAČIUKAI;8879347884;Ne;5;0;2;7
12783;Žibutė;KAČIUKAI;7608622330;Ne;0;0;1;1
12784;Žibutė;KAČIUKAI;5186839413;Ne;1;0;0;1
12785;Žibutė;KAČIUKAI;1381488132;Ne;0;0;4;4
12786;Žibutė;KAČIUKAI;4622674814;Ne;11;0;0;11
12787;Žibutė;KAČIUKAI;5632520305;Ne;1;0;0;1
12788;Žibutė;KAČIUKAI;7805758264;Ne;0;0;1;1
12789;Žibutė;KAČIUKAI;6672033757;Ne;0;1;0;1
12790;Žibutė;KAČIUKAI;3066580779;Ne;9;0;0;9
12791;Žibutė;KAČIUKAI;2374119662;Ne;2;2;0;4
12792;Žibutė;ZUIKIAI;5326761360;Ne;9;0;0;9
12793;Žibutė;ZUIKIAI;4741505387;Ne;16;0;0;16
12794;Žibutė;ZUIKIAI;2787326978;Ne;9;0;0;9
12795;Žibutė;ZUIKIAI;4787010953;Ne;3;0;0;3
12796;Žibutė;ZUIKIAI;9645026432;Ne;14;1;2;17
12797;Žibutė;ZUIKIAI;3875455223;Ne;1;0;0;1
12798;Žibutė;ZUIKIAI;3449188614;Ne;13;0;1;14
12799;Žibutė;ZUIKIAI;4434623264;Ne;0;3;0;3
12800;Žibutė;ZUIKIAI;9769180056;Ne;7;0;0;7
12801;Žibutė;ZUIKIAI;2013724729;Ne;5;0;0;5
12802;Žibutė;ZUIKIAI;9379539151;Ne;3;0;0;3
12803;Žibutė;ZUIKIAI;6234135622;Ne;9;0;0;9
12804;Žibutė;ZUIKIAI;8585964720;Ne;0;1;0;1
12805;Žibutė;ZUIKIAI;9793570682;Ne;21;0;0;21
12806;Žibutė;ZUIKIAI;6618315401;Ne;13;0;0;13
12807;Žibutė;ZUIKIAI;6290821274;Ne;14;0;0;14
12808;Žibutė;ZUIKIAI;5045628452;Ne;0;8;0;8
12809;Žiedas;Bitutės;8208331527;Ne;5;0;0;5
12810;Žiedas;Bitutės;8148831014;Ne;0;0;4;4
12811;Žiedas;Bitutės;3230107921;Ne;0;2;0;2
12812;Žiedas;Bitutės;3178778438;Ne;0;9;0;9
12813;Žiedas;Bitutės;9602083568;Ne;0;0;2;2
12814;Žiedas;Bitutės;5061575884;Ne;0;1;0;1
12815;Žiedas;Bitutės;5628720422;Ne;5;1;0;6
12816;Žiedas;Bitutės;1582961378;Ne;0;4;0;4
12817;Žiedas;Bitutės;5578227349;Ne;0;2;0;2
12818;Žiedas;Bitutės;6914059680;Ne;6;0;0;6
12819;Žiedas;Bitutės;6515510381;Ne;4;1;0;5
12820;Žiedas;Bitutės;3842589827;Ne;12;0;0;12
12821;Žiedas;Bitutės;1043230748;Ne;0;0;3;3
12822;Žiedas;Bitutės;5835309107;Taip;5;2;0;7
12823;Žiedas;Bitutės;3387263016;Taip;4;0;0;4
12824;Žiedas;Bitutės;3178580610;Ne;0;3;0;3
12825;Žiedas;Varpeliai;4699833757;Ne;0;1;0;1
12826;Žiedas;Varpeliai;8861734370;Taip;0;2;0;2
12827;Žiedas;Varpeliai;7780469974;Ne;15;0;0;15
12828;Žiedas;Varpeliai;4360175072;Ne;16;0;0;16
12829;Žiedas;Varpeliai;1086714229;Ne;16;2;0;18
12830;Žiedas;Varpeliai;3051211643;Taip;4;0;0;4
12831;Žiedas;Varpeliai;7445583512;Ne;3;0;0;3
12832;Žiedas;Varpeliai;1910079515;Ne;1;1;0;2
12833;Žiedas;Varpeliai;2714272604;Ne;12;2;0;14
12834;Žiedas;Varpeliai;8539301771;Ne;9;1;0;10
12835;Žiedas;Varpeliai;5108873389;Ne;10;0;1;11
12836;Žiedas;Varpeliai;2321239854;Ne;8;4;0;12
12837;Žiedas;Varpeliai;2680021778;Ne;7;0;0;7
12838;Žiedas;Varpeliai;9012779767;Ne;8;0;0;8
12839;Žiedas;Varpeliai;2684888407;Ne;16;0;0;16
12840;Žiedas;Varpeliai;2884725931;Ne;17;0;0;17
12841;Žiedas;Ramunėlės;3055218791;Ne;0;1;0;1
12842;Žiedas;Ramunėlės;5789261620;Ne;6;0;0;6
12843;Žiedas;Ramunėlės;5577339739;Taip;3;4;0;7
12844;Žiedas;Ramunėlės;6884933845;Ne;10;1;0;11
12845;Žiedas;Ramunėlės;1659873036;Ne;5;0;0;5
12846;Žiedas;Ramunėlės;1243169901;Ne;4;0;0;4
12847;Žiedas;Ramunėlės;5920211041;Ne;0;0;1;1
12848;Žiedas;Ramunėlės;4933650089;Ne;6;1;0;7
12849;Žiedas;Ramunėlės;4044156905;Ne;0;5;0;5
12850;Žiedas;Ramunėlės;4844442247;Ne;0;1;0;1
12851;Žiedas;Ramunėlės;7294671324;Ne;0;2;0;2
12852;Žiedas;Ramunėlės;1309242930;Taip;0;2;0;2
12853;Žiedas;Ramunėlės;5635958124;Ne;5;0;0;5
12854;Žiedas;Ramunėlės;9337317396;Ne;8;0;0;8
12855;Žiedas;Ramunėlės;2320411618;Ne;0;4;0;4
12856;Žiedas;Ramunėlės;1184578906;Ne;4;0;2;6
12857;Žiedas;Pakalnutės;7798930533;Taip;5;5;0;10
12858;Žiedas;Pakalnutės;1094506858;Taip;0;2;0;2
12859;Žiedas;Pakalnutės;9375048835;Ne;8;2;0;10
12860;Žiedas;Pakalnutės;5266048033;Ne;3;0;0;3
12861;Žiedas;Pakalnutės;5804334198;Ne;3;0;0;3
12862;Žiedas;Pakalnutės;4808020243;Ne;0;1;0;1
12863;Žiedas;Pakalnutės;3742949697;Ne;6;0;0;6
12864;Žiedas;Pakalnutės;6343634478;Taip;3;0;1;4
12865;Žiedas;Pakalnutės;8015880569;Ne;5;0;0;5
12866;Žiedas;Pakalnutės;8857150598;Ne;15;0;0;15
12867;Žiedas;Pakalnutės;9054709268;Ne;5;1;0;6
12868;Žiedas;Pakalnutės;9964883646;Ne;2;1;0;3
12869;Žiedas;Pakalnutės;4917324037;Ne;1;1;0;2
12870;Žiedas;Pakalnutės;4021189767;Ne;2;2;0;4
12871;Žiedas;Pakalnutės;1346658299;Ne;5;0;0;5
12872;Žiedas;Pakalnutės;4663390744;Ne;0;2;0;2
12873;Žiedas;Pakalnutės;4697477761;Ne;4;0;0;4
12874;Žiedas;Pakalnutės;9207945616;Ne;8;0;0;8
12875;Žiedas;Pakalnutės;7221702677;Taip;5;0;0;5
12876;Žiedas;Pakalnutės;2393112381;Ne;0;2;0;2
12877;Žiedas;Rožytės;8846443535;Taip;0;6;0;6
12878;Žiedas;Rožytės;7799489700;Ne;0;14;0;14
12879;Žiedas;Rožytės;8927034492;Ne;0;20;0;20
12880;Žiedas;Rožytės;6459679214;Ne;0;16;0;16
12881;Žiedas;Rožytės;5987689515;Ne;10;0;0;10
12882;Žiedas;Rožytės;1035854293;Ne;0;0;3;3
12883;Žiedas;Rožytės;2642760082;Ne;0;4;0;4
12884;Žiedas;Rožytės;1917085385;Ne;15;0;0;15
12885;Žiedas;Rožytės;3099608553;Ne;7;0;0;7
12886;Žiedas;Rožytės;7228139235;Ne;0;1;0;1
12887;Žiedas;Rožytės;1975718197;Ne;0;0;1;1
12888;Žiedas;Rožytės;2312361963;Ne;13;1;0;14
12889;Žiedas;Rožytės;6859410675;Ne;0;2;0;2
12890;Žiedas;Rožytės;1390431397;Ne;0;0;1;1
12891;Žiedas;Rožytės;3490370918;Ne;0;7;0;7
12892;Žiedas;Rožytės;9183582003;Ne;0;7;0;7
12893;Žiedas;Pumpurėliai;1631534238;Ne;6;0;0;6
12894;Žiedas;Pumpurėliai;3994387532;Ne;17;1;0;18
12895;Žiedas;Pumpurėliai;5862164657;Ne;5;0;0;5
12896;Žiedas;Pumpurėliai;9143843408;Ne;6;0;0;6
12897;Žiedas;Pumpurėliai;9833875402;Ne;5;0;0;5
12898;Žiedas;Pumpurėliai;8336518449;Ne;5;1;0;6
12899;Žiedas;Pumpurėliai;8112164640;Ne;12;0;0;12
12900;Žiedas;Pumpurėliai;8592046023;Ne;1;0;0;1
12901;Žiedas;Pumpurėliai;9537901302;Taip;2;0;0;2
12902;Žiedas;Pumpurėliai;1980594198;Ne;5;15;0;20
12903;Žiedas;Pumpurėliai;5814371567;Ne;11;0;1;12
12904;Žiedas;Pumpurėliai;4854055565;Ne;7;1;0;8
12905;Žiedas;Pumpurėliai;7314459335;Taip;2;0;0;2
12906;Žiedas;Pumpurėliai;3075660919;Ne;6;0;0;6
12907;Žiedas;Pumpurėliai;7801566777;Ne;18;0;0;18
12908;Žiedas;Pumpurėliai;6543036900;Ne;4;2;0;6
12909;Žiedas;Pumpurėliai;3682750815;Ne;16;0;0;16
12910;Žiedas;Pumpurėliai;2013485224;Ne;1;0;0;1
12911;Žiedas;"Dobiliukai ";6066566242;Ne;13;0;0;13
12912;Žiedas;"Dobiliukai ";8436592169;Ne;0;2;0;2
12913;Žiedas;"Dobiliukai ";3654878543;Ne;10;1;1;12
12914;Žiedas;"Dobiliukai ";8444690698;Ne;8;0;2;10
12915;Žiedas;"Dobiliukai ";2715554681;Taip;8;1;0;9
12916;Žiedas;"Dobiliukai ";2132564079;Ne;15;0;0;15
12917;Žiedas;"Dobiliukai ";9586578606;Taip;10;1;0;11
12918;Žiedas;"Dobiliukai ";3940002957;Taip;0;2;0;2
12919;Žiedas;"Dobiliukai ";5353507617;Ne;3;2;0;5
12920;Žiedas;"Dobiliukai ";1610219365;Ne;3;0;0;3
12921;Žiedas;"Dobiliukai ";2794691006;Taip;0;2;0;2
12922;Žiedas;"Dobiliukai ";6665199013;Ne;7;1;0;8
12923;Žiedas;"Dobiliukai ";1852347789;Ne;2;0;0;2
12924;Žiedas;"Dobiliukai ";2633676360;Ne;15;1;1;17
12925;Žiedas;"Dobiliukai ";7677595571;Taip;0;2;3;5
12926;Žiedas;"Dobiliukai ";5106427067;Taip;0;2;0;2
12927;Žiedas;"Dobiliukai ";2182340305;Taip;7;0;0;7
12928;Žiedas;"Dobiliukai ";2402512731;Ne;13;0;2;15
12929;Žiedas;RŪTELĖS;1885623466;Ne;0;2;0;2
12930;Žiedas;RŪTELĖS;9464217926;Ne;0;1;0;1
12931;Žiedas;RŪTELĖS;9543860953;Ne;3;0;1;4
12932;Žiedas;RŪTELĖS;3247328978;Ne;5;1;0;6
12933;Žiedas;RŪTELĖS;7399937598;Ne;5;1;0;6
12934;Žiedas;RŪTELĖS;1325715061;Ne;2;0;0;2
12935;Žiedas;RŪTELĖS;9111149805;Ne;0;2;0;2
12936;Žiedas;RŪTELĖS;4695900874;Ne;0;2;0;2
12937;Žiedas;RŪTELĖS;3258241663;Ne;0;5;0;5
12938;Žiedas;RŪTELĖS;6700593422;Ne;20;0;0;20
12939;Žiedas;RŪTELĖS;6245366671;Ne;0;2;0;2
12940;Žiedas;RŪTELĖS;3835714894;Ne;3;0;0;3
12941;Žiedas;RŪTELĖS;7535993061;Ne;5;0;0;5
12942;Žiedas;RŪTELĖS;1956219718;Ne;0;8;0;8
12943;Žiedas;RŪTELĖS;4809093267;Ne;14;0;0;14
12944;Žiedas;RŪTELĖS;6856477482;Ne;2;1;0;3
12945;Žiedas;RŪTELĖS;1874460511;Ne;0;5;0;5
12946;Žiedas;RŪTELĖS;7150427502;Ne;11;0;0;11
12947;Žiedas;RŪTELĖS;1562699898;Taip;4;0;0;4
12948;Žiedas;RŪTELĖS;6312115234;Ne;5;0;2;7
12949;Žiedas;RŪTELĖS;3831917542;Ne;3;0;0;3
12950;Žiedas;RŪTELĖS;1669599543;Taip;15;0;0;15
12951;Žiedas;SAULĖGRĄŽOS;1011602827;Ne;0;6;0;6
12952;Žiedas;SAULĖGRĄŽOS;8887021328;Ne;0;1;0;1
12953;Žiedas;SAULĖGRĄŽOS;2932857132;Ne;0;0;2;2
12954;Žiedas;SAULĖGRĄŽOS;5552786845;Ne;0;2;0;2
12955;Žiedas;SAULĖGRĄŽOS;8833895006;Ne;0;3;0;3
12956;Žiedas;SAULĖGRĄŽOS;4992446383;Ne;10;0;0;10
12957;Žiedas;SAULĖGRĄŽOS;1645402434;Ne;5;0;0;5
12958;Žiedas;SAULĖGRĄŽOS;2026540724;Ne;0;1;0;1
12959;Žiedas;SAULĖGRĄŽOS;4564268323;Ne;0;4;0;4
12960;Žiedas;SAULĖGRĄŽOS;1609487830;Ne;0;0;1;1
12961;Žiedas;SAULĖGRĄŽOS;3437651010;Ne;5;0;0;5
12962;Žiedas;SAULĖGRĄŽOS;3422053505;Ne;0;9;0;9
12963;Žiedas;SAULĖGRĄŽOS;5274845525;Ne;15;0;0;15
12964;Žiedas;SAULĖGRĄŽOS;7057747531;Ne;3;0;0;3
12965;Žiedas;SAULĖGRĄŽOS;8819018248;Ne;0;3;0;3
12966;Žiedas;SAULĖGRĄŽOS;3303581707;Ne;0;4;0;4
12967;Žiedas;SAULĖGRĄŽOS;1253833615;Ne;0;2;0;2
12968;Žiedas;RUGIAGĖLĖS;1826599535;Ne;5;2;0;7
12969;Žiedas;RUGIAGĖLĖS;3477341028;Ne;7;1;0;8
12970;Žiedas;RUGIAGĖLĖS;2124086277;Ne;6;0;1;7
12971;Žiedas;RUGIAGĖLĖS;1093479755;Ne;4;0;0;4
12972;Žiedas;RUGIAGĖLĖS;7381658912;Ne;5;2;1;8
12973;Žiedas;RUGIAGĖLĖS;2148027253;Taip;8;0;0;8
12974;Žiedas;RUGIAGĖLĖS;1758868055;Ne;1;0;0;1
12975;Žiedas;RUGIAGĖLĖS;1958481432;Ne;0;1;0;1
12976;Žiedas;RUGIAGĖLĖS;9393499257;Ne;8;0;0;8
12977;Žiedas;RUGIAGĖLĖS;8276022676;Taip;9;0;0;9
12978;Žiedas;RUGIAGĖLĖS;7418985667;Ne;5;0;0;5
12979;Žiedas;RUGIAGĖLĖS;6766710113;Ne;6;2;0;8
12980;Žiedas;RUGIAGĖLĖS;1835893385;Taip;12;1;0;13
12981;Žiedas;RUGIAGĖLĖS;3654749109;Ne;0;4;0;4
12982;Žiedas;RUGIAGĖLĖS;2913328259;Ne;17;0;0;17
12983;Žiedas;RUGIAGĖLĖS;4568189195;Ne;3;0;0;3
12984;Žiedas;RUGIAGĖLĖS;7114207461;Taip;0;2;0;2
12985;Žiedas;RUGIAGĖLĖS;3407247493;Ne;0;0;2;2
12986;Žiedas;RUGIAGĖLĖS;6923562927;Taip;11;0;0;11
12987;Žiedas;RUGIAGĖLĖS;1509140770;Ne;0;2;2;4
12988;Žiedas;RUGIAGĖLĖS;7498211984;Ne;7;0;0;7
12989;Žiedas;RUGIAGĖLĖS;3948942801;Ne;0;2;0;2
12990;Žiedas;RUGIAGĖLĖS;7441475685;Ne;10;1;0;11
12991;Žiedas;Boružėlės;9685152753;Ne;9;0;1;10
12992;Žiedas;Boružėlės;9218388800;Ne;0;1;0;1
12993;Žiedas;Boružėlės;9352485926;Ne;3;0;0;3
12994;Žiedas;Boružėlės;5914428064;Taip;0;5;0;5
12995;Žiedas;Boružėlės;3857121753;Taip;2;2;2;6
12996;Žiedas;Boružėlės;6443633568;Ne;6;0;0;6
12997;Žiedas;Boružėlės;7491134119;Ne;5;0;0;5
12998;Žiedas;Boružėlės;5959899914;Ne;0;9;0;9
12999;Žiedas;Boružėlės;7333813704;Ne;0;2;1;3
13000;Žiedas;Boružėlės;3715928992;Ne;5;2;0;7
13001;Žiedas;Boružėlės;5703750436;Ne;0;1;0;1
13002;Žiedas;Boružėlės;7578964555;Ne;4;5;0;9
13003;Žiedas;Boružėlės;5928377774;Ne;0;0;1;1
13004;Žiedas;Boružėlės;5126173608;Ne;0;1;1;2
13005;Žiedas;Boružėlės;7072578987;Ne;9;0;1;10
13006;Žiedas;Boružėlės;5647232875;Ne;3;1;1;5
13007;Žiedas;Boružėlės;1738121071;Taip;6;2;0;8
13008;Žiedas;AGUONĖLĖS;5518670127;Ne;16;0;0;16
13009;Žiedas;AGUONĖLĖS;2846835865;Taip;15;0;0;15
13010;Žiedas;AGUONĖLĖS;6162306565;Ne;0;0;2;2
13011;Žiedas;AGUONĖLĖS;5211681615;Ne;1;0;0;1
13012;Žiedas;AGUONĖLĖS;5947851166;Ne;4;3;0;7
13013;Žiedas;AGUONĖLĖS;8978215481;Ne;5;1;0;6
13014;Žiedas;AGUONĖLĖS;7159730702;Taip;15;0;0;15
13015;Žiedas;AGUONĖLĖS;8485801027;Ne;13;1;0;14
13016;Žiedas;AGUONĖLĖS;3634949279;Ne;7;1;0;8
13017;Žiedas;AGUONĖLĖS;1147121060;Ne;2;0;2;4
13018;Žiedas;AGUONĖLĖS;5789381608;Ne;2;1;0;3
13019;Žiedas;AGUONĖLĖS;6635256945;Ne;16;0;0;16
13020;Žiedas;AGUONĖLĖS;5177625346;Ne;20;0;0;20
13021;Žiedas;AGUONĖLĖS;4914111970;Taip;3;1;1;5
13022;Žiedas;ŽIBUTĖS;8638720939;Ne;7;0;0;7
13023;Žiedas;ŽIBUTĖS;4039958043;Ne;0;0;2;2
13024;Žiedas;ŽIBUTĖS;9269909624;Ne;10;0;0;10
13025;Žiedas;ŽIBUTĖS;8084555994;Taip;0;4;0;4
13026;Žiedas;ŽIBUTĖS;2935037966;Ne;6;0;0;6
13027;Žiedas;ŽIBUTĖS;3271812706;Ne;0;0;1;1
13028;Žiedas;ŽIBUTĖS;6248399763;Ne;4;1;0;5
13029;Žiedas;ŽIBUTĖS;8163426046;Ne;5;0;0;5
13030;Žiedas;ŽIBUTĖS;1546447912;Taip;12;0;0;12
13031;Žiedas;ŽIBUTĖS;9202969623;Ne;16;0;0;16
13032;Žiedas;ŽIBUTĖS;3488618084;Ne;4;2;4;10
13033;Žiedas;ŽIBUTĖS;8162441626;Ne;5;0;1;6
13034;Žiedas;ŽIBUTĖS;8651843785;Ne;11;0;0;11
13035;Žiedas;ŽIBUTĖS;9834096834;Ne;13;0;0;13
13036;Žiedas;DRUGELIAI;9763704573;Ne;3;0;0;3
13037;Žiedas;DRUGELIAI;5028265234;Ne;7;2;0;9
13038;Žiedas;DRUGELIAI;6852487760;Ne;19;0;0;19
13039;Žiedas;DRUGELIAI;8645771800;Ne;3;0;0;3
13040;Žiedas;DRUGELIAI;6041919197;Ne;3;0;0;3
13041;Žiedas;DRUGELIAI;8163645535;Ne;6;1;0;7
13042;Žiedas;DRUGELIAI;2182381160;Ne;3;0;0;3
13043;Žiedas;DRUGELIAI;9021286246;Ne;7;0;0;7
13044;Žiedas;DRUGELIAI;6261847845;Ne;2;2;0;4
13045;Žiedas;DRUGELIAI;5020148822;Ne;5;0;0;5
13046;Žiedas;DRUGELIAI;1219634640;Ne;0;1;0;1
13047;Žiedas;DRUGELIAI;2170318597;Ne;5;0;0;5
13048;Žiedas;DRUGELIAI;1333233100;Ne;1;2;0;3
13049;Žiogelis;SKRUZDELYTĖS;2959983278;Ne;0;1;0;1
13050;Žiogelis;SKRUZDELYTĖS;4677024422;Ne;1;0;0;1
13051;Žiogelis;SKRUZDELYTĖS;5281321968;Ne;2;0;0;2
13052;Žiogelis;SKRUZDELYTĖS;3214640817;Ne;0;11;0;11
13053;Žiogelis;SKRUZDELYTĖS;1937740173;Ne;8;0;0;8
13054;Žiogelis;SKRUZDELYTĖS;5737326104;Ne;3;1;0;4
13055;Žiogelis;SKRUZDELYTĖS;2614574694;Taip;3;0;0;3
13056;Žiogelis;SKRUZDELYTĖS;7107814348;Ne;0;8;0;8
13057;Žiogelis;SKRUZDELYTĖS;9243862028;Ne;0;2;0;2
13058;Žiogelis;SKRUZDELYTĖS;7395901559;Ne;0;3;0;3
13059;Žiogelis;SKRUZDELYTĖS;9819352425;Taip;4;1;0;5
13060;Žiogelis;SKRUZDELYTĖS;8780773039;Ne;0;7;0;7
13061;Žiogelis;SKRUZDELYTĖS;7881734492;Ne;5;0;0;5
13062;Žiogelis;SKRUZDELYTĖS;2701091043;Ne;0;3;0;3
13063;Žiogelis;SKRUZDELYTĖS;9120836406;Ne;3;0;0;3
13064;Žiogelis;SKRUZDELYTĖS;6742462116;Ne;2;2;0;4
13065;Žiogelis;SKRUZDELYTĖS;6608146625;Ne;9;0;0;9
13066;Žiogelis;SKRUZDELYTĖS;9035254979;Ne;11;0;0;11
13067;Žiogelis;SKRUZDELYTĖS;8682279246;Taip;4;0;0;4
13068;Žiogelis;ŽIRNIUKAI;1106149118;Ne;0;3;0;3
13069;Žiogelis;ŽIRNIUKAI;6284764694;Ne;1;2;0;3
13070;Žiogelis;ŽIRNIUKAI;9842311161;Ne;6;2;0;8
13071;Žiogelis;ŽIRNIUKAI;2036243422;Ne;3;1;0;4
13072;Žiogelis;ŽIRNIUKAI;9634291623;Ne;5;2;0;7
13073;Žiogelis;ŽIRNIUKAI;6491130711;Ne;1;0;0;1
13074;Žiogelis;ŽIRNIUKAI;4623532521;Ne;0;1;0;1
13075;Žiogelis;ŽIRNIUKAI;5996045442;Ne;3;4;0;7
13076;Žiogelis;ŽIRNIUKAI;5527793395;Ne;0;2;0;2
13077;Žiogelis;ŽIRNIUKAI;4974459437;Taip;5;4;0;9
13078;Žiogelis;ŽIRNIUKAI;8664568879;Taip;0;1;0;1
13079;Žiogelis;ŽIRNIUKAI;3199884855;Ne;7;0;0;7
13080;Žiogelis;ŽIRNIUKAI;5245672298;Ne;12;2;0;14
13081;Žiogelis;ŽIRNIUKAI;7804701635;Ne;1;0;0;1
13082;Žiogelis;DOBILĖLIAI;8485067381;Ne;0;5;0;5
13083;Žiogelis;DOBILĖLIAI;8712788346;Ne;20;0;0;20
13084;Žiogelis;DOBILĖLIAI;7535167450;Ne;1;0;0;1
13085;Žiogelis;DOBILĖLIAI;3361421852;Ne;2;1;0;3
13086;Žiogelis;DOBILĖLIAI;1268908081;Ne;0;2;0;2
13087;Žiogelis;DOBILĖLIAI;3856321373;Ne;6;0;0;6
13088;Žiogelis;DOBILĖLIAI;6378295945;Ne;2;2;0;4
13089;Žiogelis;DOBILĖLIAI;8959934210;Ne;1;0;0;1
13090;Žiogelis;DOBILĖLIAI;6980853713;Ne;2;0;0;2
13091;Žiogelis;DOBILĖLIAI;7340918175;Taip;0;1;0;1
13092;Žiogelis;DOBILĖLIAI;5454676924;Ne;5;0;0;5
13093;Žiogelis;DOBILĖLIAI;8058231095;Ne;8;0;0;8
13094;Žiogelis;DOBILĖLIAI;7702173581;Ne;0;1;0;1
13095;Žiogelis;DOBILĖLIAI;6593794147;Ne;6;0;0;6
13096;Žiogelis;DOBILĖLIAI;6515890056;Ne;5;5;0;10
13097;Žiogelis;DOBILĖLIAI;7310459638;Taip;1;2;0;3
13098;Žiogelis;DOBILĖLIAI;1763603533;Ne;15;0;0;15
13099;Žiogelis;DOBILĖLIAI;9813150014;Ne;0;1;0;1
13100;Žiogelis;BORUŽĖLĖS;8683148826;Ne;6;6;0;12
13101;Žiogelis;BORUŽĖLĖS;6532218580;Ne;7;0;0;7
13102;Žiogelis;BORUŽĖLĖS;1763070523;Taip;0;1;0;1
13103;Žiogelis;BORUŽĖLĖS;3308563362;Ne;1;0;0;1
13104;Žiogelis;BORUŽĖLĖS;2117192553;Ne;2;0;0;2
13105;Žiogelis;BORUŽĖLĖS;5911231906;Ne;2;0;0;2
13106;Žiogelis;BORUŽĖLĖS;6115834138;Ne;6;0;0;6
13107;Žiogelis;BORUŽĖLĖS;1465027680;Ne;1;0;0;1
13108;Žiogelis;BORUŽĖLĖS;4103035195;Ne;3;0;0;3
13109;Žiogelis;BORUŽĖLĖS;5364996984;Ne;1;0;0;1
13110;Žiogelis;BORUŽĖLĖS;9568208184;Ne;1;0;0;1
13111;Žiogelis;BORUŽĖLĖS;7065052244;Ne;5;0;0;5
13112;Žiogelis;BORUŽĖLĖS;6340620973;Ne;4;0;0;4
13113;Žiogelis;BORUŽĖLĖS;5961630249;Ne;0;1;0;1
13114;Žiogelis;BORUŽĖLĖS;3686409773;Ne;4;0;0;4
13115;Žiogelis;BORUŽĖLĖS;2122392982;Taip;1;0;0;1
13116;Žiogelis;DRUGELIAI;2797078863;Ne;15;0;0;15
13117;Žiogelis;DRUGELIAI;3820406417;Ne;0;13;0;13
13118;Žiogelis;DRUGELIAI;9533670829;Ne;6;0;0;6
13119;Žiogelis;DRUGELIAI;1673279182;Ne;0;9;0;9
13120;Žiogelis;DRUGELIAI;9964121573;Ne;7;0;0;7
13121;Žiogelis;DRUGELIAI;5104952346;Ne;5;0;0;5
13122;Žiogelis;DRUGELIAI;9717527407;Ne;4;0;0;4
13123;Žiogelis;DRUGELIAI;2622354022;Ne;10;5;0;15
13124;Žiogelis;DRUGELIAI;2243541285;Ne;5;1;0;6
13125;Žiogelis;DRUGELIAI;2326799191;Taip;7;0;0;7
13126;Žiogelis;DRUGELIAI;1833992163;Ne;6;0;0;6
13127;Žiogelis;DRUGELIAI;2529171444;Ne;3;3;0;6
13128;Žiogelis;DRUGELIAI;4946802677;Ne;6;0;0;6
13129;Žiogelis;DRUGELIAI;8763533677;Ne;15;0;0;15
13130;Žiogelis;DRUGELIAI;4994053705;Ne;5;1;0;6
13131;Žiogelis;DRUGELIAI;2655049586;Ne;6;0;0;6
13132;Žiogelis;DRUGELIAI;4120627587;Ne;1;0;0;1
13133;Žiogelis;PELĖDŽIUKAI;7128248940;Ne;0;4;0;4
13134;Žiogelis;PELĖDŽIUKAI;6709029770;Ne;0;1;0;1
13135;Žiogelis;PELĖDŽIUKAI;7502572217;Ne;4;0;0;4
13136;Žiogelis;PELĖDŽIUKAI;7120126547;Ne;0;2;0;2
13137;Žiogelis;PELĖDŽIUKAI;9387048672;Ne;0;8;0;8
13138;Žiogelis;PELĖDŽIUKAI;3937261260;Ne;0;1;0;1
13139;Žiogelis;PELĖDŽIUKAI;8873231715;Ne;1;0;0;1
13140;Žiogelis;PELĖDŽIUKAI;8894068297;Ne;0;2;0;2
13141;Žiogelis;PELĖDŽIUKAI;7725494899;Ne;0;1;0;1
13142;Žiogelis;PELĖDŽIUKAI;8689074067;Ne;0;2;0;2
13143;Žiogelis;PELĖDŽIUKAI;4565342104;Ne;0;1;0;1
13144;Žiogelis;PELĖDŽIUKAI;1223396469;Ne;17;0;0;17
13145;Žiogelis;PELĖDŽIUKAI;3500076229;Taip;0;14;0;14
13146;Žiogelis;PELĖDŽIUKAI;8715501524;Taip;12;2;0;14
13147;Žiogelis;PELĖDŽIUKAI;6347738933;Ne;6;0;0;6
13148;Žiogelis;PELĖDŽIUKAI;3520393042;Ne;0;1;0;1
13149;Žiogelis;VARPELIAI;8983731310;Ne;0;6;0;6
13150;Žiogelis;VARPELIAI;1954544417;Ne;8;0;0;8
13151;Žiogelis;VARPELIAI;9385596579;Ne;0;1;0;1
13152;Žiogelis;VARPELIAI;1447349850;Ne;0;1;0;1
13153;Žiogelis;VARPELIAI;3752358694;Ne;3;1;0;4
13154;Žiogelis;VARPELIAI;6402784913;Ne;0;2;0;2
13155;Žiogelis;VARPELIAI;4462189852;Taip;3;4;0;7
13156;Žiogelis;VARPELIAI;9470241656;Taip;3;2;0;5
13157;Žiogelis;VARPELIAI;2346231162;Ne;0;1;0;1
13158;Žiogelis;VARPELIAI;6658457517;Ne;10;0;0;10
13159;Žiogelis;VARPELIAI;6650891980;Ne;9;1;0;10
13160;Žiogelis;VARPELIAI;5076511003;Ne;0;1;0;1
13161;Žiogelis;VARPELIAI;1139259000;Ne;5;3;0;8
13162;Žiogelis;VARPELIAI;7992701275;Ne;19;0;0;19
13163;Žiogelis;VARPELIAI;2238709964;Ne;20;0;0;20
13164;Žiogelis;VARPELIAI;5288197445;Ne;6;1;0;7
13165;Žiogelis;VARPELIAI;5336455992;Ne;10;1;0;11
13166;Žiogelis;VARPELIAI;9769801670;Taip;14;0;0;14
13167;Žiogelis;VARPELIAI;5115094299;Ne;5;0;0;5
13168;Žiogelis;VARPELIAI;1647252870;Ne;20;0;0;20
13169;Žiogelis;KREGŽDUTĖS;5042341085;Ne;6;0;0;6
13170;Žiogelis;KREGŽDUTĖS;9766966628;Ne;12;0;0;12
13171;Žiogelis;KREGŽDUTĖS;8835394030;Ne;0;1;0;1
13172;Žiogelis;KREGŽDUTĖS;3792114246;Ne;0;2;0;2
13173;Žiogelis;KREGŽDUTĖS;9981130790;Ne;0;1;0;1
13174;Žiogelis;KREGŽDUTĖS;4605250897;Ne;5;0;0;5
13175;Žiogelis;KREGŽDUTĖS;5139645108;Ne;15;0;0;15
13176;Žiogelis;KREGŽDUTĖS;9790463889;Ne;5;0;0;5
13177;Žiogelis;KREGŽDUTĖS;9874412804;Ne;0;1;0;1
13178;Žiogelis;KREGŽDUTĖS;6024752960;Ne;5;2;0;7
13179;Žiogelis;KREGŽDUTĖS;8853905367;Ne;5;2;0;7
13180;Žiogelis;KREGŽDUTĖS;1397686161;Ne;5;5;0;10
13181;Žiogelis;KREGŽDUTĖS;2171351454;Ne;1;2;0;3
13182;Žiogelis;KREGŽDUTĖS;2173494736;Ne;3;0;0;3
13183;Žiogelis;KREGŽDUTĖS;1134384178;Ne;4;0;0;4
13184;Žiogelis;KREGŽDUTĖS;2759766559;Ne;0;3;0;3
13185;Žiogelis;ŽVIRBLIUKAI;6718866954;Ne;1;0;0;1
13186;Žiogelis;ŽVIRBLIUKAI;9756601090;Ne;8;0;0;8
13187;Žiogelis;ŽVIRBLIUKAI;4708377318;Ne;6;0;0;6
13188;Žiogelis;ŽVIRBLIUKAI;2028344962;Ne;1;0;0;1
13189;Žiogelis;ŽVIRBLIUKAI;6925485778;Ne;3;0;0;3
13190;Žiogelis;ŽVIRBLIUKAI;7539495906;Ne;2;0;0;2
13191;Žiogelis;ŽVIRBLIUKAI;2925961701;Ne;1;0;0;1
13192;Žiogelis;ŽVIRBLIUKAI;3407223108;Ne;10;0;0;10
13193;Žiogelis;ŽVIRBLIUKAI;4924536259;Ne;10;0;0;10
13194;Žiogelis;ŽVIRBLIUKAI;1093662117;Ne;3;0;0;3
13195;Žiogelis;ŽVIRBLIUKAI;2540274386;Ne;3;0;0;3
13196;Žiogelis;ŽVIRBLIUKAI;4602474688;Ne;8;0;0;8
13197;Žiogelis;BITUTĖS;5337641310;Ne;10;0;0;10
13198;Žiogelis;BITUTĖS;2771911603;Ne;0;1;0;1
13199;Žiogelis;BITUTĖS;6617995346;Ne;3;1;0;4
13200;Žiogelis;BITUTĖS;4755709634;Ne;1;0;0;1
13201;Žiogelis;BITUTĖS;7936785905;Taip;0;1;0;1
13202;Žiogelis;BITUTĖS;3628571567;Ne;0;1;0;1
13203;Žiogelis;BITUTĖS;9142952548;Ne;0;1;0;1
13204;Žiogelis;BITUTĖS;4450344120;Ne;9;1;0;10
13205;Žiogelis;BITUTĖS;8998694866;Ne;5;0;0;5
13206;Žiogelis;BITUTĖS;3472310047;Ne;0;1;0;1
13207;Žiogelis;BITUTĖS;8018943297;Ne;1;0;0;1
13208;Žiogelis;BITUTĖS;9918493914;Ne;3;0;0;3
13209;Žiogelis;BITUTĖS;6857937795;Ne;10;2;0;12
13210;Žiogelis;BITUTĖS;9672307977;Ne;1;0;0;1
13211;Žiogelis;BITUTĖS;2799966199;Taip;3;0;0;3
13212;Žiogelis;RIEŠUTĖLIAI;6035707604;Ne;12;0;0;12
13213;Žiogelis;RIEŠUTĖLIAI;8743725024;Ne;5;2;0;7
13214;Žiogelis;RIEŠUTĖLIAI;9869864499;Ne;0;1;0;1
13215;Žiogelis;RIEŠUTĖLIAI;8547003106;Taip;0;3;0;3
13216;Žiogelis;RIEŠUTĖLIAI;8652050979;Ne;15;0;0;15
13217;Žiogelis;RIEŠUTĖLIAI;7428779654;Ne;2;0;0;2
13218;Žiogelis;RIEŠUTĖLIAI;3037415668;Ne;2;0;0;2
13219;Žiogelis;RIEŠUTĖLIAI;6470463492;Ne;10;3;0;13
13220;Žiogelis;RIEŠUTĖLIAI;6313053720;Ne;8;0;0;8
13221;Žiogelis;RIEŠUTĖLIAI;5146366874;Ne;15;0;0;15
13222;Žiogelis;RIEŠUTĖLIAI;8135592447;Ne;8;0;0;8
13223;Žiogelis;RIEŠUTĖLIAI;2454569485;Ne;15;0;0;15
13224;Žiogelis;RIEŠUTĖLIAI;3242570582;Ne;2;0;0;2
13225;Žiogelis;RIEŠUTĖLIAI;7001506215;Ne;5;0;0;5
13226;Žiogelis;RIEŠUTĖLIAI;9783948483;Ne;1;0;0;1
13227;Žiogelis;PAKALNUTĖS;9144282935;Ne;6;0;0;6
13228;Žiogelis;PAKALNUTĖS;2275123126;Ne;1;0;0;1
13229;Žiogelis;PAKALNUTĖS;4587838884;Taip;9;5;0;14
13230;Žiogelis;PAKALNUTĖS;8303283893;Ne;0;1;0;1
13231;Žiogelis;PAKALNUTĖS;2724389716;Taip;1;0;0;1
13232;Žiogelis;PAKALNUTĖS;7763941077;Ne;0;2;0;2
13233;Žiogelis;PAKALNUTĖS;7008807839;Ne;7;0;0;7
13234;Žiogelis;PAKALNUTĖS;5984496369;Ne;9;0;0;9
13235;Žiogelis;PAKALNUTĖS;2177479618;Ne;10;0;0;10
13236;Žiogelis;PAKALNUTĖS;6213118462;Ne;0;3;0;3
13237;Žolynėlis;Spanguolėlė;8810441600;Taip;0;18;0;18
13238;Žolynėlis;Spanguolėlė;6440991320;Ne;20;0;0;20
13239;Žolynėlis;Spanguolėlė;3631138915;Ne;5;0;0;5
13240;Žolynėlis;Spanguolėlė;5218448120;Ne;2;4;0;6
13241;Žolynėlis;Spanguolėlė;4494255525;Ne;0;1;0;1
13242;Žolynėlis;Spanguolėlė;2493633505;Ne;4;1;0;5
13243;Žolynėlis;Spanguolėlė;5438607463;Ne;5;0;0;5
13244;Žolynėlis;Spanguolėlė;5208585298;Ne;7;2;0;9
13245;Žolynėlis;Spanguolėlė;7451189254;Ne;11;1;0;12
13246;Žolynėlis;Spanguolėlė;9498369210;Ne;0;1;0;1
13247;Žolynėlis;Spanguolėlė;7260397656;Ne;6;1;0;7
13248;Žolynėlis;Spanguolėlė;2315947380;Ne;7;1;0;8
13249;Žolynėlis;Spanguolėlė;5074658392;Ne;7;1;0;8
13250;Žolynėlis;Spanguolėlė;6288526291;Ne;9;0;0;9
13251;Žolynėlis;Spanguolėlė;7234022613;Ne;0;3;0;3
13252;Žolynėlis;Spanguolėlė;3222329369;Ne;12;0;0;12
13253;Žolynėlis;"SAULUTĖ (spec)";7962304738;Ne;3;2;0;5
13254;Žolynėlis;"SAULUTĖ (spec)";3934182673;Ne;1;2;0;3
13255;Žolynėlis;"SAULUTĖ (spec)";8588753136;Ne;0;2;0;2
13256;Žolynėlis;"SAULUTĖ (spec)";9507509872;Ne;0;9;0;9
13257;Žolynėlis;"LINELIS (spec)";8930536051;Ne;5;0;0;5
13258;Žolynėlis;"LINELIS (spec)";6510930436;Ne;20;0;0;20
13259;Žolynėlis;"LINELIS (spec)";6619551947;Ne;14;0;0;14
13260;Žolynėlis;"LINELIS (spec)";4000928238;Ne;7;2;0;9
13261;Žolynėlis;"LINELIS (spec)";5610113641;Ne;5;0;0;5
13262;Žolynėlis;"LINELIS (spec)";6678697536;Ne;15;0;0;15
13263;Žolynėlis;"LINELIS (spec)";3043560150;Ne;0;10;1;11
13264;Žolynėlis;"RASAKILA (spec)";4971887781;Ne;0;5;0;5
13265;Žolynėlis;"RASAKILA (spec)";4481343085;Ne;6;0;0;6
13266;Žolynėlis;"RASAKILA (spec)";8577197481;Ne;3;2;0;5
13267;Žolynėlis;"RAMUNĖLĖS (spec)";4559404699;Ne;0;2;0;2
13268;Žolynėlis;"RAMUNĖLĖS (spec)";1703785525;Ne;11;2;0;13
13269;Žolynėlis;"RAMUNĖLĖS (spec)";2072569949;Ne;8;2;0;10
13270;Žolynėlis;"RAMUNĖLĖS (spec)";1090944316;Ne;0;1;0;1
13271;Žolynėlis;"RAMUNĖLĖS (spec)";5729519418;Ne;4;1;0;5
13272;Žolynėlis;"RAMUNĖLĖS (spec)";7266224868;Ne;0;2;2;4
13273;Žolynėlis;"RAMUNĖLĖS (spec)";7085655808;Ne;1;2;0;3
13274;Žolynėlis;"RAMUNĖLĖS (spec)";3748657353;Ne;1;3;0;4
13275;Žolynėlis;Dobiliukai;2005661306;Ne;0;3;0;3
13276;Žolynėlis;Dobiliukai;2820649587;Ne;1;2;0;3
13277;Žolynėlis;Dobiliukai;7581436340;Ne;20;0;0;20
13278;Žolynėlis;Dobiliukai;3385748516;Ne;20;0;0;20
13279;Žolynėlis;Dobiliukai;2957426163;Ne;0;1;0;1
13280;Žolynėlis;Dobiliukai;5456771327;Ne;17;0;0;17
13281;Žolynėlis;Dobiliukai;5634886191;Ne;18;0;0;18
13282;Žolynėlis;Dobiliukai;3350246193;Ne;4;0;0;4
13283;Žolynėlis;Dobiliukai;5269388947;Ne;4;3;0;7
13284;Žolynėlis;Dobiliukai;1206144208;Ne;4;1;1;6
13285;Žolynėlis;Dobiliukai;1213384150;Ne;0;6;0;6
13286;Žolynėlis;Dobiliukai;7485033527;Ne;9;1;0;10
13287;Žolynėlis;Dobiliukai;7053810996;Taip;3;0;0;3
13288;Žolynėlis;Dobiliukai;6124252688;Ne;0;8;0;8
13289;Žolynėlis;Dobiliukai;4229530366;Ne;10;1;0;11
13290;Žolynėlis;Aguonėlė;3071570864;Ne;4;0;0;4
13291;Žolynėlis;Aguonėlė;1365534272;Ne;11;0;0;11
13292;Žolynėlis;Aguonėlė;2628636018;Ne;0;3;0;3
13293;Žolynėlis;Aguonėlė;6740105842;Ne;11;1;0;12
13294;Žolynėlis;Aguonėlė;3952731134;Ne;1;0;0;1
13295;Žolynėlis;Aguonėlė;6554864184;Ne;0;1;0;1
13296;Žolynėlis;Aguonėlė;9904373687;Ne;8;0;0;8
13297;Žolynėlis;Aguonėlė;9285539649;Ne;8;1;0;9
13298;Žolynėlis;Aguonėlė;5243624422;Taip;9;2;0;11
13299;Žolynėlis;Aguonėlė;4761054847;Ne;5;0;0;5
13300;Žolynėlis;Aguonėlė;6354832415;Ne;11;0;0;11
13301;Žolynėlis;Aguonėlė;1748987196;Ne;5;3;0;8
13302;Žolynėlis;Aguonėlė;4094173207;Ne;9;0;0;9
13303;Žolynėlis;Aguonėlė;6034854963;Ne;0;8;0;8
13304;Žolynėlis;Aguonėlė;1847470349;Ne;5;0;0;5
13305;Žolynėlis;Pienė;1163753820;Ne;0;2;0;2
13306;Žolynėlis;Pienė;9238832484;Ne;9;0;0;9
13307;Žolynėlis;Pienė;3877168024;Ne;5;0;0;5
13308;Žolynėlis;Pienė;4618251201;Taip;0;4;0;4
13309;Žolynėlis;Pienė;1264022895;Ne;12;1;0;13
13310;Žolynėlis;Pienė;8713225753;Ne;0;1;0;1
13311;Žolynėlis;Pienė;5332349177;Ne;0;10;1;11
13312;Žolynėlis;Pienė;3091749692;Ne;7;4;0;11
13313;Žolynėlis;Pienė;2263679711;Taip;5;2;0;7
13314;Žolynėlis;Pienė;5973298389;Ne;5;2;0;7
13315;Žolynėlis;Pienė;8552635547;Ne;0;2;2;4
13316;Žolynėlis;Pienė;2256262371;Ne;0;7;0;7
13317;Žolynėlis;Čiobreliai;8215427354;Ne;5;1;0;6
13318;Žolynėlis;Čiobreliai;2565770471;Ne;14;0;0;14
13319;Žolynėlis;Čiobreliai;6829144389;Ne;0;1;0;1
13320;Žolynėlis;Čiobreliai;2881461471;Ne;11;0;0;11
13321;Žolynėlis;Čiobreliai;2460982987;Ne;0;5;0;5
13322;Žolynėlis;Čiobreliai;7980206574;Ne;0;2;0;2
13323;Žolynėlis;Čiobreliai;3088932720;Ne;0;5;0;5
13324;Žolynėlis;Čiobreliai;4758738231;Ne;3;0;0;3
13325;Žolynėlis;Čiobreliai;6024288147;Ne;0;1;0;1
13326;Žolynėlis;Čiobreliai;1485195267;Ne;0;1;0;1
13327;Žolynėlis;Čiobreliai;6763515483;Taip;0;1;0;1
13328;Žolynėlis;Čiobreliai;5432464074;Ne;0;2;0;2
13329;Žolynėlis;Čiobreliai;6416217971;Ne;4;5;0;9
13330;Žolynėlis;Čiobreliai;1879046798;Ne;0;5;0;5
13331;Žolynėlis;Čiobreliai;2934361190;Ne;4;6;0;10
13332;Žolynėlis;Čiobreliai;8510764089;Ne;2;1;0;3
13333;Žolynėlis;Avietėlė;4277871671;Ne;10;0;0;10
13334;Žolynėlis;Avietėlė;9404844632;Ne;10;0;0;10
13335;Žolynėlis;Avietėlė;5873931225;Ne;8;1;0;9
13336;Žolynėlis;Avietėlė;1266614631;Ne;15;0;0;15
13337;Žolynėlis;Avietėlė;7855260478;Ne;11;2;0;13
13338;Žolynėlis;Avietėlė;2718255075;Ne;8;0;0;8
13339;Žolynėlis;Avietėlė;6417150398;Taip;13;0;0;13
13340;Žolynėlis;Avietėlė;7517815798;Ne;0;4;0;4
13341;Žolynėlis;Avietėlė;5581675294;Ne;15;0;0;15
13342;Žolynėlis;Avietėlė;1108820859;Ne;2;0;0;2
13343;Žolynėlis;Avietėlė;9905727117;Ne;12;0;0;12
13344;Žolynėlis;Avietėlė;4221470753;Ne;10;0;0;10
13345;Žolynėlis;Avietėlė;5234937076;Ne;14;0;0;14
13346;Žolynėlis;RŪTELĖ;2727273826;Taip;6;0;0;6
13347;Žolynėlis;RŪTELĖ;7264446456;Ne;0;1;0;1
13348;Žolynėlis;RŪTELĖ;3857544079;Taip;13;0;0;13
13349;Žolynėlis;RŪTELĖ;5175997689;Ne;6;0;0;6
13350;Žolynėlis;RŪTELĖ;4780520358;Ne;3;0;1;4
13351;Žolynėlis;RŪTELĖ;2181156327;Ne;0;1;0;1
13352;Žolynėlis;RŪTELĖ;5184931936;Taip;5;4;2;11
13353;Žolynėlis;RŪTELĖ;5666650566;Taip;10;0;0;10
13354;Žolynėlis;RŪTELĖ;5769654742;Ne;4;4;0;8
13355;Žuvėdra;"JŪROS ŽVAIGŽDUTĖS";1200084485;Ne;0;1;0;1
13356;Žuvėdra;"JŪROS ŽVAIGŽDUTĖS";4177319374;Taip;5;0;2;7
13357;Žuvėdra;"JŪROS ŽVAIGŽDUTĖS";7121154799;Ne;16;2;0;18
13358;Žuvėdra;"JŪROS ŽVAIGŽDUTĖS";8162649794;Taip;2;0;0;2
13359;Žuvėdra;"JŪROS ŽVAIGŽDUTĖS";2858729034;Taip;11;0;1;12
13360;Žuvėdra;"JŪROS ŽVAIGŽDUTĖS";6672289932;Taip;0;5;1;6
13361;Žuvėdra;"JŪROS ŽVAIGŽDUTĖS";5571732399;Ne;8;0;3;11
13362;Žuvėdra;"JŪROS ŽVAIGŽDUTĖS";3620753237;Ne;2;0;0;2
13363;Žuvėdra;"JŪROS ŽVAIGŽDUTĖS";6651984898;Ne;0;5;0;5
13364;Žuvėdra;"JŪROS ŽVAIGŽDUTĖS";1974766090;Ne;16;0;0;16
13365;Žuvėdra;"JŪROS ŽVAIGŽDUTĖS";8869169590;Taip;0;6;0;6
13366;Žuvėdra;"JŪROS ŽVAIGŽDUTĖS";4146310547;Ne;0;4;0;4
13367;Žuvėdra;"JŪROS ŽVAIGŽDUTĖS";5436158437;Taip;0;1;0;1
13368;Žuvėdra;"JŪROS ŽVAIGŽDUTĖS";2082128566;Ne;6;6;0;12
13369;Žuvėdra;"JŪROS ŽVAIGŽDUTĖS";2582404760;Ne;0;3;0;3
13370;Žuvėdra;"JŪROS ŽVAIGŽDUTĖS";8308610070;Ne;0;1;0;1
13371;Žuvėdra;DELFINUKAI;7235005234;Ne;0;0;3;3
13372;Žuvėdra;DELFINUKAI;5876618912;Ne;5;0;0;5
13373;Žuvėdra;DELFINUKAI;4702627979;Ne;0;7;0;7
13374;Žuvėdra;DELFINUKAI;7803397430;Ne;5;0;0;5
13375;Žuvėdra;DELFINUKAI;7705946236;Taip;20;0;0;20
13376;Žuvėdra;DELFINUKAI;3069506904;Ne;0;0;8;8
13377;Žuvėdra;DELFINUKAI;5913580058;Ne;0;0;1;1
13378;Žuvėdra;DELFINUKAI;9651268462;Ne;3;0;0;3
13379;Žuvėdra;DELFINUKAI;3423051494;Ne;12;0;0;12
13380;Žuvėdra;DELFINUKAI;4881712317;Ne;20;0;0;20
13381;Žuvėdra;DELFINUKAI;8111760611;Ne;10;0;0;10
13382;Žuvėdra;DELFINUKAI;1993897043;Ne;12;0;1;13
13383;Žuvėdra;DELFINUKAI;9200342856;Taip;8;0;0;8
13384;Žuvėdra;DELFINUKAI;1604010000;Ne;0;3;0;3
13385;Žuvėdra;DELFINUKAI;2323431685;Ne;9;0;0;9
13386;Žuvėdra;DELFINUKAI;9914814198;Taip;0;1;0;1
13387;Žuvėdra;OSMINOŽKI;5273726957;Ne;5;1;0;6
13388;Žuvėdra;OSMINOŽKI;7630057671;Ne;0;1;0;1
13389;Žuvėdra;OSMINOŽKI;7368183516;Ne;0;2;0;2
13390;Žuvėdra;OSMINOŽKI;3853045274;Ne;0;6;0;6
13391;Žuvėdra;OSMINOŽKI;3185158741;Taip;0;3;0;3
13392;Žuvėdra;OSMINOŽKI;5198825127;Taip;9;0;0;9
13393;Žuvėdra;OSMINOŽKI;5561903903;Ne;0;1;0;1
13394;Žuvėdra;OSMINOŽKI;5818639448;Ne;10;0;0;10
13395;Žuvėdra;OSMINOŽKI;2849503557;Ne;5;0;0;5
13396;Žuvėdra;OSMINOŽKI;7467154866;Ne;0;1;0;1
13397;Žuvėdra;OSMINOŽKI;5151984122;Ne;0;3;0;3
13398;Žuvėdra;OSMINOŽKI;8670342549;Ne;2;1;0;3
13399;Žuvėdra;OSMINOŽKI;6715416675;Ne;6;0;0;6
13400;Žuvėdra;OSMINOŽKI;3349158713;Ne;19;0;0;19
13401;Žuvėdra;OSMINOŽKI;8942228415;Ne;2;1;0;3
13402;Žuvėdra;OSMINOŽKI;4715123063;Ne;0;4;0;4
13403;Žuvėdra;RUSALAČKA;1707519901;Ne;5;2;0;7
13404;Žuvėdra;RUSALAČKA;1810114962;Ne;0;1;0;1
13405;Žuvėdra;RUSALAČKA;1960306957;Ne;0;9;0;9
13406;Žuvėdra;RUSALAČKA;2640238143;Ne;15;0;0;15
13407;Žuvėdra;RUSALAČKA;2577280901;Ne;5;1;3;9
13408;Žuvėdra;RUSALAČKA;5481785360;Ne;3;0;1;4
13409;Žuvėdra;RUSALAČKA;9011276878;Ne;0;1;0;1
13410;Žuvėdra;RUSALAČKA;7387863175;Ne;0;15;0;15
13411;Žuvėdra;RUSALAČKA;3058300342;Ne;6;2;0;8
13412;Žuvėdra;RUSALAČKA;7227722516;Ne;10;2;0;12
13413;Žuvėdra;RUSALAČKA;4893062971;Ne;0;0;1;1
13414;Žuvėdra;RUSALAČKA;1219808187;Taip;0;1;0;1
13415;Žuvėdra;RUSALAČKA;7908898376;Ne;0;0;1;1
13416;Žuvėdra;RUSALAČKA;2197976174;Ne;3;0;2;5
13417;Žuvėdra;RUSALAČKA;3781157324;Ne;11;0;0;11
13418;Žuvėdra;RUSALAČKA;1171751803;Ne;10;0;0;10
13419;Žuvėdra;RUSALAČKA;1039661177;Taip;5;0;0;5
13420;Žuvėdra;RUSALAČKA;6862766787;Ne;7;2;2;11
13421;Žuvėdra;JANTARIKI;1929548863;Ne;10;2;0;12
13422;Žuvėdra;JANTARIKI;9256424331;Ne;20;0;0;20
13423;Žuvėdra;JANTARIKI;2789379055;Ne;1;0;0;1
13424;Žuvėdra;JANTARIKI;9610223932;Ne;4;0;0;4
13425;Žuvėdra;JANTARIKI;9410938471;Ne;4;2;0;6
13426;Žuvėdra;JANTARIKI;1526878181;Ne;20;0;0;20
13427;Žuvėdra;JANTARIKI;5272918949;Ne;8;3;0;11
13428;Žuvėdra;JANTARIKI;1352508839;Ne;11;1;0;12
13429;Žuvėdra;JANTARIKI;1224866951;Ne;1;0;0;1
13430;Žuvėdra;JANTARIKI;3190173500;Ne;5;0;0;5
13431;Žuvėdra;"AUKSINĖ ŽUVELĖ";9460887312;Ne;2;4;0;6
13432;Žuvėdra;"AUKSINĖ ŽUVELĖ";5009153711;Taip;3;0;0;3
13433;Žuvėdra;"AUKSINĖ ŽUVELĖ";7135848009;Ne;6;0;1;7
13434;Žuvėdra;"AUKSINĖ ŽUVELĖ";4217169024;Ne;4;2;1;7
13435;Žuvėdra;"AUKSINĖ ŽUVELĖ";6451721553;Ne;8;0;0;8
13436;Žuvėdra;"AUKSINĖ ŽUVELĖ";4447517071;Ne;11;0;1;12
13437;Žuvėdra;"AUKSINĖ ŽUVELĖ";2118573300;Taip;12;0;0;12
13438;Žvangutis;PELIUKŲ;7616874368;Ne;4;1;0;5
13439;Žvangutis;PELIUKŲ;3906808900;Ne;2;0;0;2
13440;Žvangutis;PELIUKŲ;7722153982;Ne;7;0;0;7
13441;Žvangutis;PELIUKŲ;9958554027;Ne;0;1;0;1
13442;Žvangutis;PELIUKŲ;8592522675;Ne;10;0;0;10
13443;Žvangutis;PELIUKŲ;5817402847;Ne;13;3;0;16
13444;Žvangutis;PELIUKŲ;4407484687;Ne;6;0;0;6
13445;Žvangutis;PELIUKŲ;5638068914;Ne;20;0;0;20
13446;Žvangutis;PELIUKŲ;4337928288;Ne;0;1;0;1
13447;Žvangutis;PELIUKŲ;8062689240;Ne;3;0;0;3
13448;Žvangutis;PELIUKŲ;3875906173;Ne;9;2;0;11
13449;Žvangutis;PELIUKŲ;1328464199;Ne;8;1;0;9
13450;Žvangutis;PELIUKŲ;3546672690;Ne;4;2;0;6
13451;Žvangutis;PELIUKŲ;4992231141;Ne;2;1;0;3
13452;Žvangutis;PELIUKŲ;8481666202;Ne;4;5;0;9
13453;Žvangutis;ANČIUKŲ;5539992579;Ne;5;2;0;7
13454;Žvangutis;ANČIUKŲ;1324948757;Taip;0;2;0;2
13455;Žvangutis;ANČIUKŲ;6068428687;Ne;0;1;0;1
13456;Žvangutis;ANČIUKŲ;9149037184;Ne;4;0;0;4
13457;Žvangutis;ANČIUKŲ;1404378308;Ne;0;2;0;2
13458;Žvangutis;ANČIUKŲ;5012996199;Ne;0;4;0;4
13459;Žvangutis;ANČIUKŲ;2623107843;Ne;0;1;0;1
13460;Žvangutis;ANČIUKŲ;3276065009;Ne;0;1;0;1
13461;Žvangutis;ANČIUKŲ;5723728310;Taip;5;1;1;7
13462;Žvangutis;ANČIUKŲ;1282567366;Taip;5;0;0;5
13463;Žvangutis;ANČIUKŲ;2570379643;Ne;0;3;0;3
13464;Žvangutis;ANČIUKŲ;9036869235;Ne;0;1;0;1
13465;Žvangutis;ANČIUKŲ;2922083476;Ne;0;1;0;1
13466;Žvangutis;ANČIUKŲ;6207989105;Ne;0;1;0;1
13467;Žvangutis;ANČIUKŲ;6040986672;Ne;8;0;0;8
13468;Žvangutis;ANČIUKŲ;2716216474;Ne;7;1;1;9
13469;Žvangutis;PELĖDŽIUKŲ;7599491698;Ne;14;0;0;14
13470;Žvangutis;PELĖDŽIUKŲ;6094686500;Taip;0;0;3;3
13471;Žvangutis;PELĖDŽIUKŲ;9711017196;Taip;0;0;2;2
13472;Žvangutis;PELĖDŽIUKŲ;7051007224;Ne;0;0;1;1
13473;Žvangutis;PELĖDŽIUKŲ;8906823569;Ne;7;3;0;10
13474;Žvangutis;PELĖDŽIUKŲ;8753815074;Taip;0;0;1;1
13475;Žvangutis;PELĖDŽIUKŲ;8376022173;Ne;0;0;2;2
13476;Žvangutis;PELĖDŽIUKŲ;6825952779;Ne;0;1;0;1
13477;Žvangutis;PELĖDŽIUKŲ;8598396569;Ne;0;1;0;1
13478;Žvangutis;PELĖDŽIUKŲ;1590704985;Ne;0;0;2;2
13479;Žvangutis;PELĖDŽIUKŲ;9523189658;Ne;5;0;0;5
13480;Žvangutis;PELĖDŽIUKŲ;9883337991;Taip;1;0;0;1
13481;Žvangutis;PELĖDŽIUKŲ;2308726385;Ne;0;0;1;1
13482;Žvangutis;KAČIUKŲ;7213349517;Ne;7;0;0;7
13483;Žvangutis;KAČIUKŲ;2296360416;Ne;0;2;0;2
13484;Žvangutis;KAČIUKŲ;7721746116;Taip;0;3;0;3
13485;Žvangutis;KAČIUKŲ;2598842770;Ne;5;0;0;5
13486;Žvangutis;KAČIUKŲ;1142315595;Ne;4;1;0;5
13487;Žvangutis;KAČIUKŲ;4696437804;Ne;0;2;0;2
13488;Žvangutis;KAČIUKŲ;8492637734;Ne;10;3;0;13
13489;Žvangutis;KAČIUKŲ;8360356476;Ne;2;0;0;2
13490;Žvangutis;KAČIUKŲ;8863909185;Ne;6;3;0;9
13491;Žvangutis;KAČIUKŲ;3498584864;Taip;6;0;0;6
13492;Žvangutis;KAČIUKŲ;4408086513;Ne;9;3;0;12
13493;Žvangutis;KAČIUKŲ;1256264382;Ne;0;8;0;8
13494;Žvangutis;KAČIUKŲ;8030520477;Ne;6;1;1;8
13495;Žvangutis;KAČIUKŲ;5166614226;Ne;10;0;0;10
13496;Žvangutis;KAČIUKŲ;8810739982;Ne;4;0;0;4
13497;Žvangutis;KAČIUKŲ;2740875969;Ne;5;1;0;6
13498;Žvangutis;KAČIUKŲ;8269992031;Ne;4;1;0;5
13499;Žvangutis;KAČIUKŲ;1224292338;Ne;2;0;0;2
13500;Žvangutis;MEŠKUČIŲ;5714127995;Ne;10;0;0;10
13501;Žvangutis;MEŠKUČIŲ;8841791656;Ne;0;1;0;1
13502;Žvangutis;MEŠKUČIŲ;7007117864;Ne;6;0;0;6
13503;Žvangutis;MEŠKUČIŲ;5162865213;Ne;14;0;0;14
13504;Žvangutis;MEŠKUČIŲ;8081046191;Ne;7;0;0;7
13505;Žvangutis;MEŠKUČIŲ;2671205721;Ne;16;0;0;16
13506;Žvangutis;MEŠKUČIŲ;2148237530;Ne;3;2;0;5
13507;Žvangutis;MEŠKUČIŲ;8324813274;Ne;7;0;0;7
13508;Žvangutis;MEŠKUČIŲ;7098816023;Taip;5;0;0;5
13509;Žvangutis;MEŠKUČIŲ;3734153710;Ne;15;0;0;15
13510;Žvangutis;MEŠKUČIŲ;5780339899;Ne;14;0;0;14
13511;Žvangutis;MEŠKUČIŲ;6189100246;Ne;1;2;0;3
13512;Žvangutis;MEŠKUČIŲ;6329268519;Ne;6;0;0;6
13513;Žvangutis;MEŠKUČIŲ;5579521166;Ne;0;7;0;7
13514;Žvangutis;MEŠKUČIŲ;9671139568;Ne;16;0;0;16
13515;Žvangutis;KIŠKUČIŲ;7645908955;Ne;20;0;0;20
13516;Žvangutis;KIŠKUČIŲ;3029382724;Ne;6;0;0;6
13517;Žvangutis;KIŠKUČIŲ;4128856598;Taip;0;0;1;1
13518;Žvangutis;KIŠKUČIŲ;4968365511;Taip;10;0;0;10
13519;Žvangutis;KIŠKUČIŲ;1706200292;Ne;10;0;0;10
13520;Žvangutis;KIŠKUČIŲ;5328547183;Ne;11;0;0;11
13521;Žvangutis;KIŠKUČIŲ;4471191112;Ne;0;1;0;1
13522;Žvangutis;KIŠKUČIŲ;3081929677;Ne;5;0;3;8
13523;Žvangutis;KIŠKUČIŲ;6768957624;Ne;5;0;0;5
13524;Žvangutis;KIŠKUČIŲ;8233392333;Ne;12;0;0;12
13525;Žvangutis;KIŠKUČIŲ;2284700283;Ne;3;1;0;4
13526;Žvangutis;KIŠKUČIŲ;9292902597;Taip;13;0;0;13
13527;Žirniukas;Boružiukų;5311746004;Ne;0;0;11;11
13528;Žirniukas;Boružiukų;6268788036;Ne;0;2;0;2
13529;Žirniukas;Boružiukų;6363169823;Ne;2;2;0;4
13530;Žirniukas;Boružiukų;8148254025;Ne;0;1;0;1
13531;Žirniukas;Boružiukų;6531175340;Ne;0;1;0;1
13532;Žirniukas;Boružiukų;3022672028;Ne;7;0;0;7
13533;Žirniukas;Boružiukų;8180092480;Ne;0;0;2;2
13534;Žirniukas;Boružiukų;7397202752;Ne;0;2;1;3
13535;Žirniukas;Boružiukų;4233026576;Ne;5;0;0;5
13536;Žirniukas;Boružiukų;6598851580;Ne;0;2;7;9
13537;Žirniukas;Boružiukų;7965050711;Ne;0;0;4;4
13538;Žirniukas;Boružiukų;2140863010;Ne;0;0;20;20
13539;Žirniukas;Smalsučiai;6096664609;Ne;0;2;0;2
13540;Žirniukas;Smalsučiai;2733313392;Ne;0;0;2;2
13541;Žirniukas;Smalsučiai;9707776533;Ne;2;2;0;4
13542;Žirniukas;Smalsučiai;7278153529;Ne;2;1;0;3
13543;Žirniukas;Smalsučiai;8151071354;Ne;0;0;3;3
13544;Žirniukas;Smalsučiai;2325139043;Ne;4;0;0;4
13545;Žirniukas;Smalsučiai;4527367786;Ne;3;1;0;4
13546;Žirniukas;Smalsučiai;8599313527;Taip;0;2;5;7
13547;Žirniukas;Smalsučiai;4320686646;Ne;0;1;0;1
13548;Žirniukas;Smalsučiai;4045432303;Ne;5;2;0;7
13549;Žirniukas;Gėlyčių;2982628594;Ne;0;0;1;1
13550;Žirniukas;Gėlyčių;6121388208;Taip;5;1;2;8
13551;Žirniukas;Gėlyčių;6201949014;Ne;11;0;0;11
13552;Žirniukas;Gėlyčių;9497414375;Taip;1;2;1;4
13553;Žirniukas;Gėlyčių;6147030672;Ne;5;0;0;5
13554;Žirniukas;Gėlyčių;2789026451;Ne;6;0;0;6
13555;Žirniukas;Gėlyčių;9507651487;Ne;6;0;0;6
13556;Žirniukas;Gėlyčių;1368553187;Ne;9;0;0;9
13557;Žirniukas;Gėlyčių;2221770310;Ne;5;0;0;5
13558;Žirniukas;Gėlyčių;5554441466;Ne;6;0;0;6
13559;Žirniukas;Nykštukų;2746074694;Ne;8;1;0;9
13560;Žirniukas;Nykštukų;3874713264;Ne;0;3;0;3
13561;Žirniukas;Nykštukų;7368124402;Ne;0;1;0;1
13562;Žirniukas;Nykštukų;1635353228;Ne;5;0;0;5
13563;Žirniukas;Nykštukų;2027344763;Ne;4;1;0;5
13564;Žirniukas;Nykštukų;9730269905;Ne;0;2;0;2
13565;Žirniukas;Nykštukų;9478756666;Ne;0;1;0;1
13566;Žirniukas;Nykštukų;4732089209;Ne;10;0;0;10
13567;Žirniukas;Nykštukų;9988669252;Ne;0;1;0;1
13568;Žirniukas;Nykštukų;8242086461;Ne;5;2;0;7
13569;Žirniukas;Nykštukų;8242086461;Ne;5;2;0;7
13570;Žirniukas;Nykštukų;8242086461;Ne;5;2;0;7
13571;Žirniukas;Nykštukų;6511802399;Ne;5;2;0;7
13572;Žirniukas;Nykštukų;6511802399;Ne;5;2;0;7
13573;Žirniukas;Nykštukų;6511802399;Ne;5;2;0;7
13574;Žirniukas;Nykštukų;6349641015;Ne;3;1;3;7
13575;Žirniukas;Nykštukų;2635969699;Ne;7;0;0;7
13576;Žirniukas;Nykštukų;5422282267;Ne;8;0;2;10
13577;Žirniukas;Nykštukų;5103440019;Ne;5;0;2;7
13578;Žirniukas;Saulytės;5613818351;Ne;2;0;0;2
13579;Žirniukas;Saulytės;1345594362;Ne;5;0;0;5
13580;Žirniukas;Saulytės;9847840127;Taip;0;2;0;2
13581;Žirniukas;Saulytės;1005139737;Ne;0;0;2;2
13582;Žirniukas;Saulytės;7968189099;Ne;10;2;0;12
13583;Žirniukas;Saulytės;7081683726;Ne;5;5;0;10
13584;Žirniukas;Saulytės;1449763041;Ne;0;1;0;1
13585;Žirniukas;Saulytės;7269948694;Ne;3;0;0;3
13586;Žirniukas;Saulytės;6594686128;Ne;0;1;0;1
13587;Žirniukas;Saulytės;1679864330;Ne;1;0;0;1
13588;Žirniukas;Saulytės;3438394768;Ne;5;0;0;5
13589;Žirniukas;Saulytės;9569187800;Ne;7;0;0;7
13590;Žirniukas;Saulytės;2302878611;Ne;0;8;0;8
13591;Žirniukas;Saulytės;3603956795;Ne;3;0;0;3
13592;Žirniukas;Saulytės;4902056654;Ne;6;0;0;6
13593;Žirniukas;Saulytės;7563892184;Ne;6;0;0;6
13594;Žirniukas;Drugelių;6271194358;Ne;0;6;0;6
13595;Žirniukas;Drugelių;5269074776;Ne;10;0;1;11
13596;Žirniukas;Drugelių;3509857181;Ne;0;1;0;1
13597;Žirniukas;Drugelių;2517524802;Ne;0;2;0;2
13598;Žirniukas;Drugelių;9901196251;Ne;0;2;1;3
13599;Žirniukas;Drugelių;5046469974;Ne;0;1;0;1
13600;Žirniukas;Drugelių;1826203483;Ne;1;0;0;1
13601;Žirniukas;Drugelių;4536071547;Ne;0;1;0;1
13602;Žirniukas;Drugelių;3996393849;Ne;7;2;0;9
13603;Žirniukas;Drugelių;7240364379;Ne;0;2;1;3
13604;Žirniukas;Drugelių;6300372863;Ne;3;6;0;9
13605;Žirniukas;Drugelių;5670489807;Ne;2;0;0;2
13606;Žirniukas;Drugelių;9794535841;Ne;15;0;0;15
13607;Žirniukas;Drugelių;1031316325;Ne;5;0;0;5
13608;Žirniukas;Drugelių;1018506580;Ne;0;4;1;5
13609;Žirniukas;Drugelių;6993784924;Ne;0;0;1;1
13610;Žirniukas;Drugelių;9384464752;Ne;0;1;0;1
13611;Žirniukas;Pelėdžiukai;7889803840;Ne;0;1;0;1
13612;Žirniukas;Pelėdžiukai;4347695841;Ne;7;0;0;7
13613;Žirniukas;Pelėdžiukai;4847093256;Ne;1;0;0;1
13614;Žirniukas;Pelėdžiukai;7356213150;Ne;0;11;0;11
13615;Žirniukas;Pelėdžiukai;7545458622;Taip;10;0;0;10
13616;Žirniukas;Pelėdžiukai;5376080603;Ne;8;0;0;8
13617;Žirniukas;Pelėdžiukai;7755938379;Ne;5;0;0;5
13618;Žirniukas;Pelėdžiukai;5470692657;Taip;13;0;0;13
13619;Žirniukas;Pelėdžiukai;8690042163;Ne;3;0;0;3
13620;Žirniukas;Pelėdžiukai;8808445761;Taip;4;1;0;5
13621;Žirniukas;Pelėdžiukai;2332260494;Ne;10;0;0;10
13622;Žirniukas;Pelėdžiukai;6941160450;Ne;5;0;0;5
13623;Žirniukas;Pelėdžiukai;4464151713;Ne;5;0;0;5
13624;Žirniukas;Pelėdžiukai;4069128550;Ne;3;0;0;3
13625;Žirniukas;Pelėdžiukai;7767762079;Ne;1;0;0;1
13626;Žirniukas;ZUIKUČIAI;4860680720;Ne;10;1;0;11
13627;Žirniukas;ZUIKUČIAI;2315136490;Ne;0;2;0;2
13628;Žirniukas;ZUIKUČIAI;4519996144;Ne;12;0;0;12
13629;Žirniukas;ZUIKUČIAI;2081378583;Ne;4;0;0;4
13630;Žirniukas;ZUIKUČIAI;8511341812;Ne;7;0;0;7
13631;Žirniukas;ZUIKUČIAI;7530076269;Ne;0;12;0;12
13632;Žirniukas;ZUIKUČIAI;1255561862;Ne;1;0;0;1
13633;Žirniukas;ZUIKUČIAI;6780809984;Ne;15;0;0;15
13634;Žirniukas;ZUIKUČIAI;5580500746;Ne;0;2;1;3
13635;Žirniukas;ZUIKUČIAI;2161897682;Ne;3;1;0;4
13636;Žirniukas;ZUIKUČIAI;6042654423;Taip;12;0;0;12
13637;Žirniukas;ZUIKUČIAI;6223594794;Ne;0;5;0;5
13638;Žirniukas;ZUIKUČIAI;7868678721;Taip;5;3;1;9
13639;Aušra;Kodėlčiukai;4540040693;Ne;6;1;0;7
13640;Aušra;Kodėlčiukai;5013135853;Ne;15;0;0;15
13641;Aušra;Kodėlčiukai;6139706771;Ne;3;0;0;3
13642;Aušra;Kodėlčiukai;4720749995;Ne;1;0;0;1
13643;Aušra;Kodėlčiukai;8108663467;Ne;6;0;0;6
13644;Aušra;Kodėlčiukai;7314273812;Taip;4;1;0;5
13645;Aušra;Kodėlčiukai;1423840991;Ne;5;1;0;6
13646;Aušra;Kodėlčiukai;7469266085;Ne;12;3;0;15
13647;Aušra;Kodėlčiukai;1010721404;Ne;0;5;0;5
13648;Aušra;Kodėlčiukai;2611563172;Taip;14;1;0;15
13649;Aušra;Kodėlčiukai;1883185016;Taip;0;1;0;1
13650;Aušra;Kodėlčiukai;9437530221;Taip;0;20;0;20
13651;Aušra;Smalsučiai;4010347313;Ne;0;1;0;1
13652;Aušra;Smalsučiai;1630814772;Ne;0;1;0;1
13653;Aušra;Smalsučiai;2768220823;Ne;0;0;3;3
13654;Aušra;Smalsučiai;4000881716;Ne;0;1;0;1
13655;Aušra;Smalsučiai;5268479689;Ne;2;0;0;2
13656;Aušra;Smalsučiai;7710131755;Taip;7;1;0;8
13657;Aušra;Smalsučiai;8884580599;Taip;3;0;0;3
13658;Aušra;Smalsučiai;3468946868;Taip;7;0;0;7
13659;Aušra;Smalsučiai;8021547491;Taip;2;1;0;3
13660;Aušra;Smalsučiai;5925213006;Ne;4;2;1;7
13661;Aušra;Smalsučiai;2495610772;Ne;0;11;0;11
13662;Aušra;Smalsučiai;4163605313;Taip;0;9;0;9
13663;Aušra;Smalsučiai;6614027605;Taip;0;4;0;4
13664;Aušra;Smalsučiai;3860755808;Ne;0;12;0;12
13665;Aušra;Smalsučiai;2039920706;Ne;0;1;0;1
13666;Aušra;Smalsučiai;9333701196;Ne;0;1;0;1
13667;Aušra;Smalsučiai;8584355573;Taip;0;1;0;1
13668;Aušra;"1A klasė";5524681006;Ne;2;0;0;2
13669;Aušra;"1A klasė";3680329197;Ne;1;0;0;1
13670;Aušra;"1A klasė";1575761029;Ne;3;0;0;3
13671;Aušra;"1A klasė";5777939563;Ne;1;0;0;1
13672;Aušra;"1A klasė";1450251779;Ne;1;0;0;1
13673;Aušra;"1A klasė";7708360056;Ne;1;0;0;1
13674;Aušra;"1A klasė";1557503831;Ne;1;0;0;1
13675;Aušra;"1A klasė";1636794584;Taip;1;0;0;1
13676;Aušra;"1A klasė";1612662076;Ne;1;0;0;1
13677;Aušra;"1B klasė";8709340592;Ne;15;0;0;15
13678;Aušra;"1B klasė";6384243597;Ne;5;0;0;5
13679;Aušra;"1B klasė";1343532870;Ne;5;0;0;5
13680;Aušra;"1B klasė";7921251819;Ne;4;0;0;4
13681;Aušra;"1B klasė";8525869648;Ne;2;0;0;2
13682;Aušra;"1B klasė";9589692031;Ne;4;0;0;4
13683;Aušra;"1B klasė";5522008237;Ne;3;0;0;3
13684;Aušra;"1B klasė";9197020006;Ne;2;0;0;2
13685;Aušra;"1B klasė";7918281270;Ne;5;0;0;5
13686;Aušra;"1B klasė";43123279348;Ne;1;0;0;1
13687;Aušra;"2A klasė";3001784066;Ne;1;0;0;1
13688;Aušra;"2A klasė";84116863778;Ne;1;0;0;1
13689;Aušra;"2A klasė";21544489661;Ne;2;0;0;2
13690;Aušra;"2A klasė";3526237179;Ne;1;0;0;1
13691;Aušra;"2A klasė";1893586984;Ne;0;20;0;20
13692;Aušra;"2A klasė";15657824495;Ne;6;0;0;6
13693;Aušra;"2A klasė";5988529284;Taip;4;0;0;4
13694;Aušra;"2A klasė";58254707316;Ne;3;0;0;3
13695;Aušra;"2A klasė";1219257874;Ne;0;20;0;20
13696;Aušra;"2A klasė";3732655408;Ne;1;0;0;1
13697;Aušra;"3A klasė";42344686036;Ne;1;0;0;1
13698;Aušra;"3A klasė";5468993286;Ne;2;0;0;2
13699;Aušra;"3A klasė";48817619537;Ne;1;0;0;1
13700;Aušra;"3A klasė";35779814505;Ne;1;0;0;1
13701;Aušra;"3A klasė";76280361479;Ne;3;0;0;3
13702;Aušra;"3A klasė";14611425618;Ne;0;20;0;20
13703;Aušra;"3A klasė";4110537888;Ne;4;0;0;4
13704;Aušra;"4A klasė";40499781883;Ne;1;0;0;1
13705;Aušra;"4A klasė";70233681803;Ne;0;20;0;20
13706;Aušra;"4A klasė";88655846176;Ne;3;0;0;3
13707;Aušra;"4A klasė";3965445196;Ne;1;0;0;1
13708;Aušra;"4A klasė";85578471272;Ne;0;20;0;20
13709;Aušra;"4A klasė";68031503463;Ne;0;20;0;20
13710;Aušra;"4A klasė";81633973264;Ne;0;20;0;20
13711;Aušra;"4A klasė";52985512945;Ne;0;20;0;20
13712;Aušra;"4A klasė";51185323645;Ne;0;20;0;20
13713;Aušra;"4A klasė";1437385365;Ne;0;20;0;20
13714;Aušra;"4A klasė";15330844181;Ne;0;20;0;20
13715;Aušra;"4A klasė";2062775070;Ne;0;20;0;20
13716;Aušra;"4A klasė";40714551025;Ne;5;0;0;5
13717;Aušra;"2B klasė";41268510292;Ne;1;0;0;1
13718;Aušra;"2B klasė";3910688753;Ne;5;0;0;5
13719;Aušra;"2B klasė";70844824182;Ne;3;0;0;3
13720;Aušra;"2B klasė";58741201573;Ne;1;0;0;1
13721;Aušra;"2B klasė";65840410497;Ne;2;0;0;2
13722;Aušra;"2B klasė";1640356242;Ne;1;0;0;1
13723;Aušra;"2B klasė";90604001837;Taip;1;0;0;1
13724;Aušra;Pabiručiai;8769357172;Ne;0;1;0;1
13725;Aušra;Pabiručiai;8462418277;Ne;0;1;0;1
13726;Aušra;Pabiručiai;6555345047;Ne;3;1;0;4
13727;Aušra;Pabiručiai;1306616759;Ne;5;1;0;6
13728;Aušra;Pabiručiai;7476662446;Ne;0;0;1;1
13729;Aušra;Pabiručiai;7199483890;Ne;0;2;3;5
13730;Aušra;Pabiručiai;9466807067;Ne;2;0;0;2
13731;Aušra;Pabiručiai;7926621700;Ne;0;2;0;2
13732;Aušra;Pabiručiai;2904303784;Ne;2;0;0;2
13733;Aušra;Pabiručiai;7888891808;Ne;5;0;1;6
13734;Aušra;Pabiručiai;7944904281;Ne;0;2;1;3
13735;Aušra;Pabiručiai;4646215025;Ne;2;0;0;2
13736;Aušra;Pabiručiai;8665364744;Taip;14;0;1;15
13737;Aušra;Pabiručiai;4071233786;Ne;5;0;0;5
13738;Aušra;Pabiručiai;3953653896;Ne;10;1;0;11
13739;Aušra;Pabiručiai;6508435821;Ne;0;1;0;1
13740;Aušra;Pabiručiai;5797692122;Ne;0;3;0;3
13741;Aušra;Pabiručiai;7542690501;Ne;0;20;0;20
13742;Aušra;Pabiručiai;3759593393;Ne;0;2;0;2
13743;Aušra;Pabiručiai;2273160688;Ne;3;0;0;3
13744;Aušra;Gudručiai;1933801749;Ne;5;1;0;6
13745;Aušra;Gudručiai;6658178519;Ne;0;1;0;1
13746;Aušra;Gudručiai;5854637278;Ne;0;0;1;1
13747;Aušra;Gudručiai;4564561993;Ne;0;1;0;1
13748;Aušra;Gudručiai;2243689816;Ne;0;11;0;11
13749;Aušra;Gudručiai;5955385407;Ne;15;0;0;15
13750;Aušra;Gudručiai;9628651723;Ne;5;0;0;5
13751;Aušra;Gudručiai;3343235857;Ne;5;0;0;5
13752;Aušra;Gudručiai;8715912139;Ne;4;0;0;4
13753;Aušra;Gudručiai;7783006852;Ne;0;0;3;3
13754;Aušra;Gudručiai;1429548355;Taip;0;20;0;20
13755;Aušra;Gudručiai;1693711284;Ne;8;0;0;8
13756;Aušra;Gudručiai;6935310711;Ne;0;1;0;1
13757;Aušra;Gudručiai;3698868934;Ne;7;0;0;7
13758;Aušra;Gudručiai;9079804366;Ne;0;7;0;7
13759;Aušra;Gudručiai;3498143162;Ne;0;7;0;7
13760;Aušra;Gudručiai;2093165104;Ne;5;0;0;5
13761;Aušra;Naminukai;5596076175;Ne;15;0;0;15
13762;Aušra;Naminukai;5029468798;Ne;5;0;0;5
13763;Aušra;Naminukai;3889084120;Ne;2;2;1;5
13764;Aušra;Naminukai;9817943569;Ne;5;0;0;5
13765;Aušra;Naminukai;9783616691;Ne;0;1;0;1
13766;Aušra;Naminukai;7432671713;Ne;5;0;0;5
13767;Aušra;Naminukai;8872977307;Taip;0;0;3;3
13768;Aušra;Naminukai;7833475076;Ne;0;0;2;2
13769;Aušra;Naminukai;4856488024;Ne;0;0;2;2
13770;Aušra;Naminukai;1415288593;Taip;0;0;1;1
13771;Aušra;Naminukai;2831726456;Ne;1;2;0;3
13772;Aušra;Naminukai;5245988936;Ne;3;1;2;6
13773;Aušra;Naminukai;2109806524;Ne;8;1;0;9
13774;Aušra;Naminukai;4300801436;Ne;7;0;0;7
13775;Aušra;Naminukai;4824331856;Ne;0;2;3;5
13776;Aušra;Naminukai;4779994281;Ne;0;1;1;2
13777;Aušra;Naminukai;5270770998;Ne;2;1;0;3
13778;Aušra;"2 C klasė";1426802917;Ne;2;0;0;2
13779;Aušra;"2 C klasė";11130172902;Ne;1;0;0;1
13780;Aušra;"2 C klasė";1542575012;Taip;1;0;0;1
13781;Aušra;"2 C klasė";1291782232;Ne;3;0;0;3
13782;Aušra;"2 C klasė";78489473446;Ne;3;0;0;3
13783;Aušra;"2 C klasė";1371282149;Ne;2;0;0;2
13784;Berželis;PČIOLKI;7781031211;Taip;8;0;1;9
13785;Berželis;PČIOLKI;4546285993;Ne;0;20;0;20
13786;Berželis;PČIOLKI;6942559693;Ne;2;0;1;3
13787;Berželis;PČIOLKI;5069322062;Ne;0;0;3;3
13788;Berželis;PČIOLKI;6577232093;Ne;0;6;0;6
13789;Berželis;PČIOLKI;9585609150;Ne;5;1;0;6
13790;Berželis;PČIOLKI;9091691636;Ne;0;0;1;1
13791;Berželis;PČIOLKI;9245706377;Ne;0;0;1;1
13792;Berželis;PČIOLKI;6387242787;Ne;0;20;0;20
13793;Berželis;PČIOLKI;2954451168;Ne;0;3;0;3
13794;Berželis;"BOŽJI KOROVKI";7421059780;Ne;5;0;0;5
13795;Berželis;"BOŽJI KOROVKI";4100740863;Ne;13;2;0;15
13796;Berželis;"BOŽJI KOROVKI";5953387226;Ne;0;9;0;9
13797;Berželis;"BOŽJI KOROVKI";3070917065;Ne;4;1;0;5
13798;Berželis;"BOŽJI KOROVKI";8118040960;Ne;0;1;0;1
13799;Berželis;"BOŽJI KOROVKI";2005082089;Ne;9;0;0;9
13800;Berželis;"BOŽJI KOROVKI";9848723402;Ne;6;1;0;7
13801;Berželis;"BOŽJI KOROVKI";6651007152;Ne;0;2;0;2
13802;Berželis;"BOŽJI KOROVKI";8451877584;Ne;2;0;2;4
13803;Berželis;"BOŽJI KOROVKI";7080168105;Ne;5;1;0;6
13804;Berželis;"BOŽJI KOROVKI";9438498834;Ne;0;2;0;2
13805;Berželis;"BOŽJI KOROVKI";1132252592;Ne;0;2;0;2
13806;Berželis;"BOŽJI KOROVKI";5550598069;Ne;1;0;0;1
13807;Berželis;"BOŽJI KOROVKI";8871199713;Ne;5;0;1;6
13808;Berželis;"BOŽJI KOROVKI";1722262813;Ne;0;3;0;3
13809;Berželis;"BOŽJI KOROVKI";9466461910;Ne;13;0;0;13
13810;Berželis;"BOŽJI KOROVKI";2901168499;Ne;4;2;0;6
13811;Berželis;"BOŽJI KOROVKI";1498165322;Ne;6;0;0;6
13812;Berželis;SOLNYŠKO;7411282628;Ne;10;0;0;10
13813;Berželis;SOLNYŠKO;8957312159;Taip;8;0;1;9
13814;Berželis;SOLNYŠKO;1167103292;Ne;0;0;2;2
13815;Berželis;SOLNYŠKO;5408368340;Taip;3;0;4;7
13816;Berželis;SOLNYŠKO;1070751052;Ne;9;0;0;9
13817;Berželis;SOLNYŠKO;5464385395;Taip;0;1;0;1
13818;Berželis;SOLNYŠKO;6422037185;Ne;7;0;0;7
13819;Berželis;SOLNYŠKO;1424868444;Ne;6;3;0;9
13820;Berželis;SOLNYŠKO;1146976812;Ne;0;1;1;2
13821;Berželis;SOLNYŠKO;6774460279;Ne;15;5;0;20
13822;Berželis;SOLNYŠKO;2146432569;Ne;11;0;1;12
13823;Berželis;SOLNYŠKO;4125566288;Ne;0;0;3;3
13824;Berželis;SOLNYŠKO;1503116062;Taip;11;0;0;11
13825;Berželis;SOLNYŠKO;8353172510;Ne;15;0;0;15
13826;Berželis;SOLNYŠKO;6281925938;Ne;0;12;0;12
13827;Berželis;SOLNYŠKO;8783396190;Taip;0;0;1;1
13828;Berželis;SOLNYŠKO;5194480946;Ne;2;0;2;4
13829;Berželis;BABOČKI;7535016799;Ne;6;0;1;7
13830;Berželis;BABOČKI;3929755468;Ne;9;0;0;9
13831;Berželis;BABOČKI;3118835709;Ne;6;0;2;8
13832;Berželis;BABOČKI;4511595124;Ne;11;0;1;12
13833;Berželis;BABOČKI;9233307928;Ne;20;0;0;20
13834;Berželis;BABOČKI;7672845584;Ne;5;0;0;5
13835;Berželis;BABOČKI;5460675556;Ne;9;0;0;9
13836;Berželis;BABOČKI;6465432599;Ne;17;0;0;17
13837;Berželis;BABOČKI;5357039865;Ne;7;0;1;8
13838;Berželis;BABOČKI;9300262294;Ne;8;1;0;9
13839;Berželis;SOVUŠKI;5350402890;Ne;4;0;0;4
13840;Berželis;SOVUŠKI;8185887403;Ne;10;0;0;10
13841;Berželis;SOVUŠKI;1289333809;Ne;5;1;0;6
13842;Berželis;SOVUŠKI;8086074279;Ne;0;1;0;1
13843;Berželis;SOVUŠKI;6706273205;Ne;5;0;0;5
13844;Berželis;SOVUŠKI;1464998584;Ne;7;0;0;7
13845;Berželis;SOVUŠKI;3835273594;Ne;5;2;0;7
13846;Berželis;SOVUŠKI;2632535013;Ne;12;3;0;15
13847;Berželis;SOVUŠKI;6698849108;Ne;4;0;1;5
13848;Berželis;SOVUŠKI;1583268041;Ne;0;1;0;1
13849;Berželis;SOVUŠKI;5925726854;Ne;15;0;0;15
13850;Berželis;SOVUŠKI;1044720859;Ne;0;4;0;4
13851;Berželis;SOVUŠKI;2615832804;Ne;4;9;0;13
13852;Berželis;PODSOLNUŠKI;3157906472;Ne;11;4;0;15
13853;Berželis;PODSOLNUŠKI;9945124824;Ne;1;0;0;1
13854;Berželis;PODSOLNUŠKI;8168498937;Taip;5;0;0;5
13855;Berželis;PODSOLNUŠKI;9072126286;Ne;0;0;1;1
13856;Berželis;PODSOLNUŠKI;8633724383;Ne;3;0;0;3
13857;Berželis;PODSOLNUŠKI;2259367998;Ne;6;0;1;7
13858;Berželis;PODSOLNUŠKI;3033042487;Ne;3;0;1;4
13859;Berželis;PODSOLNUŠKI;2136455625;Ne;8;0;1;9
13860;Berželis;PODSOLNUŠKI;1964320071;Ne;6;0;1;7
13861;Berželis;PODSOLNUŠKI;9133988149;Ne;2;0;0;2
13862;Berželis;PODSOLNUŠKI;6686248053;Ne;6;2;0;8
13863;Berželis;PODSOLNUŠKI;5963915092;Ne;0;0;2;2
13864;Berželis;PODSOLNUŠKI;3378237475;Ne;0;0;2;2
13865;Berželis;PODSOLNUŠKI;4681334359;Ne;2;0;0;2
13866;Berželis;LAPIUKAI;3813964138;Ne;0;0;1;1
13867;Berželis;LAPIUKAI;9658062645;Ne;0;0;2;2
13868;Berželis;LAPIUKAI;9681310544;Taip;0;0;4;4
13869;Berželis;LAPIUKAI;9543499205;Ne;0;1;0;1
13870;Berželis;LAPIUKAI;8994102218;Taip;0;4;0;4
13871;Berželis;LAPIUKAI;4854931959;Taip;0;0;2;2
13872;Berželis;LAPIUKAI;7848240865;Taip;0;0;5;5
13873;Berželis;LAPIUKAI;7545277683;Ne;0;0;1;1
13874;Berželis;LAPIUKAI;7807553847;Ne;0;0;2;2
13875;Berželis;LAPIUKAI;1456066646;Ne;0;0;2;2
13876;Berželis;LAPIUKAI;9459031158;Ne;4;0;0;4
13877;Berželis;LAPIUKAI;6186408090;Ne;0;0;7;7
13878;Berželis;LAPIUKAI;1673524685;Ne;12;0;0;12
13879;Berželis;LAPIUKAI;7902774064;Taip;15;0;0;15
13880;Berželis;MEŠKIUKAI;2062794406;Ne;6;0;0;6
13881;Berželis;MEŠKIUKAI;9178527605;Taip;0;0;1;1
13882;Berželis;MEŠKIUKAI;1235617054;Ne;9;2;0;11
13883;Berželis;MEŠKIUKAI;1178588907;Ne;1;0;0;1
13884;Berželis;MEŠKIUKAI;5100214127;Ne;0;4;0;4
13885;Berželis;MEŠKIUKAI;3535856504;Taip;2;0;0;2
13886;Berželis;MEŠKIUKAI;8560266611;Ne;7;0;0;7
13887;Berželis;MEŠKIUKAI;3936106342;Taip;3;0;0;3
13888;Berželis;MEŠKIUKAI;6689893827;Ne;5;0;0;5
13889;Berželis;MEŠKIUKAI;8251510865;Ne;2;0;4;6
13890;Berželis;MEŠKIUKAI;9182053246;Ne;2;0;0;2
13891;Berželis;MEŠKIUKAI;7374231804;Ne;3;0;0;3
13892;Berželis;MEŠKIUKAI;6394357191;Ne;5;0;0;5
13893;Berželis;MEŠKIUKAI;8552923414;Ne;1;0;0;1
13894;Berželis;ŽIEDELIAI;3786609012;Ne;11;0;0;11
13895;Berželis;ŽIEDELIAI;9805181733;Ne;0;0;3;3
13896;Berželis;ŽIEDELIAI;2016827207;Ne;11;0;2;13
13897;Berželis;ŽIEDELIAI;9979442772;Ne;4;0;5;9
13898;Berželis;ŽIEDELIAI;7042967329;Taip;0;0;3;3
13899;Berželis;ŽIEDELIAI;9925865228;Ne;7;0;0;7
13900;Berželis;ŽIEDELIAI;1402975280;Taip;0;5;0;5
13901;Berželis;ŽIEDELIAI;3351114197;Ne;9;0;0;9
13902;Berželis;ŽIEDELIAI;5248880873;Ne;3;2;2;7
13903;Berželis;ŽIEDELIAI;2508532190;Ne;0;2;0;2
13904;Berželis;ŽIEDELIAI;2947072348;Ne;0;1;0;1
13905;Berželis;ŽIEDELIAI;6384939601;Ne;6;0;2;8
13906;Berželis;ŽIEDELIAI;2794074071;Taip;6;0;0;6
13907;Berželis;NYKŠTUKAI;8148104183;Ne;0;0;6;6
13908;Berželis;NYKŠTUKAI;7935684899;Ne;7;0;6;13
13909;Berželis;NYKŠTUKAI;1403664386;Ne;3;5;0;8
13910;Berželis;NYKŠTUKAI;5637168259;Ne;1;0;0;1
13911;Berželis;NYKŠTUKAI;9666648116;Ne;0;0;11;11
13912;Berželis;NYKŠTUKAI;3559065542;Ne;10;0;0;10
13913;Berželis;NYKŠTUKAI;3556594755;Ne;7;0;1;8
13914;Berželis;NYKŠTUKAI;2933069798;Taip;3;0;1;4
13915;Berželis;NYKŠTUKAI;8430372047;Ne;0;0;2;2
13916;Berželis;NYKŠTUKAI;5099275362;Taip;3;0;0;3
13917;Berželis;NYKŠTUKAI;5101382213;Ne;3;0;0;3
13918;Berželis;NYKŠTUKAI;7676141462;Ne;0;5;0;5
13919;Berželis;NYKŠTUKAI;3852021563;Ne;9;0;0;9
13920;Berželis;NYKŠTUKAI;3379227410;Taip;10;0;1;11
13921;Berželis;NYKŠTUKAI;4032178538;Taip;0;0;1;1
13922;Berželis;NYKŠTUKAI;5839964720;Ne;2;3;0;5
13923;Berželis;NYKŠTUKAI;5012540410;Ne;0;0;1;1
13924;Berželis;NYKŠTUKAI;9925281959;Taip;10;0;10;20
13925;Berželis;UOGELĖS;8735934456;Ne;2;0;1;3
13926;Berželis;UOGELĖS;6136155301;Ne;10;0;0;10
13927;Berželis;UOGELĖS;9950641759;Ne;0;0;4;4
13928;Berželis;UOGELĖS;2321608974;Ne;0;0;2;2
13929;Berželis;UOGELĖS;4607486516;Ne;5;0;1;6
13930;Berželis;UOGELĖS;5197350105;Ne;0;5;0;5
13931;Berželis;UOGELĖS;1847117067;Taip;4;0;1;5
13932;Berželis;KODĖLČIUKAI;5134372871;Ne;0;4;0;4
13933;Berželis;KODĖLČIUKAI;7852089381;Ne;4;0;2;6
13934;Berželis;KODĖLČIUKAI;5751995154;Ne;0;0;1;1
13935;Berželis;KODĖLČIUKAI;3589890886;Ne;0;0;1;1
13936;Berželis;KODĖLČIUKAI;1127524998;Ne;0;0;1;1
13937;Berželis;KODĖLČIUKAI;3951962738;Taip;2;0;0;2
13938;Berželis;KODĖLČIUKAI;2193392844;Taip;7;0;1;8
13939;Berželis;KODĖLČIUKAI;9696962207;Ne;0;0;1;1
13940;Berželis;KODĖLČIUKAI;8286301258;Ne;9;2;0;11
13941;Berželis;KODĖLČIUKAI;6500588668;Ne;2;0;0;2
13942;Berželis;KODĖLČIUKAI;9418230816;Ne;0;9;6;15
13943;Berželis;KODĖLČIUKAI;4254592648;Ne;7;0;2;9
13944;Berželis;KODĖLČIUKAI;2144796691;Ne;15;0;0;15
13945;Berželis;KODĖLČIUKAI;8737788279;Ne;5;0;2;7
13946;Saulutė;Drugeliai;5987478379;Taip;2;0;0;2
13947;Saulutė;Drugeliai;5943795519;Taip;3;0;0;3
13948;Saulutė;Drugeliai;4067009709;Ne;3;0;0;3
13949;Saulutė;Drugeliai;3991128892;Ne;4;0;0;4
13950;Saulutė;Drugeliai;7689842018;Ne;3;0;0;3
13951;Saulutė;Drugeliai;4288298305;Ne;8;1;0;9
13952;Saulutė;Drugeliai;9133269796;Ne;6;1;0;7
13953;Saulutė;Drugeliai;6057938367;Ne;4;0;0;4
13954;Saulutė;Drugeliai;1268204445;Ne;0;1;0;1
13955;Saulutė;Drugeliai;1585403702;Ne;2;0;0;2
13956;Saulutė;Drugeliai;4915192103;Ne;5;0;0;5
13957;Saulutė;Drugeliai;8003855875;Ne;1;0;0;1
13958;Saulutė;Drugeliai;2301903550;Ne;3;1;0;4
13959;Saulutė;Drugeliai;2337702344;Ne;2;0;0;2
13960;Saulutė;Drugeliai;6455593653;Ne;2;1;0;3
13961;Saulutė;Drugeliai;9410517602;Ne;6;0;0;6
13962;Saulutė;Drugeliai;1088813143;Ne;1;0;0;1
13963;Saulutė;Drugeliai;6304028361;Ne;1;1;0;2
13964;Saulutė;Drugeliai;7139492238;Ne;9;0;0;9
13965;Saulutė;Drugeliai;2750955550;Ne;20;0;0;20
13966;Saulutė;Drugeliai;5931269521;Ne;10;0;0;10
13967;Saulutė;Drugeliai;3730442890;Ne;6;1;0;7
13968;Saulutė;Drugeliai;8409958782;Ne;1;1;0;2
13969;Saulutė;"Saulės zuikučiai";6924891265;Ne;6;0;0;6
13970;Saulutė;"Saulės zuikučiai";5448950324;Ne;5;11;0;16
13971;Saulutė;"Saulės zuikučiai";3948540247;Ne;1;1;0;2
13972;Saulutė;"Saulės zuikučiai";4130972647;Taip;14;1;0;15
13973;Saulutė;"Saulės zuikučiai";3242810449;Ne;0;13;0;13
13974;Saulutė;"Saulės zuikučiai";9110162513;Ne;0;4;0;4
13975;Saulutė;"Saulės zuikučiai";1648978545;Ne;3;3;0;6
13976;Saulutė;"Saulės zuikučiai";6927834443;Taip;0;12;0;12
13977;Saulutė;"Saulės zuikučiai";8714520840;Ne;0;14;0;14
13978;Saulutė;"Saulės zuikučiai";9726675673;Ne;28;0;0;28
13979;Saulutė;"Saulės zuikučiai";8520474896;Ne;28;0;0;28
13980;Saulutė;"Saulės zuikučiai";7132125341;Ne;1;0;0;1
13981;Saulutė;"Saulės zuikučiai";3215349379;Taip;3;20;0;23
13982;Saulutė;"Saulės zuikučiai";3259790911;Ne;13;4;0;17
13983;Saulutė;"Saulės zuikučiai";7311594119;Ne;19;0;0;19
13984;Saulutė;"Saulės zuikučiai";9567511354;Ne;9;0;0;9
13985;Saulutė;"Saulės zuikučiai";6579874077;Ne;0;10;0;10
13986;Saulutė;"Saulės zuikučiai";6178908581;Ne;6;0;0;6
13987;Saulutė;"Saulės zuikučiai";8472510151;Ne;7;1;0;8
13988;Saulutė;"Saulės zuikučiai";7478215328;Ne;6;2;0;8
13989;Saulutė;"Saulės zuikučiai";9727366891;Ne;4;7;0;11
13990;Saulutė;"Saulės zuikučiai";4222649372;Ne;15;1;0;16
13991;Saulutė;Boružėlės;3295289082;Ne;4;1;0;5
13992;Saulutė;Boružėlės;1587328722;Ne;4;0;0;4
13993;Saulutė;Boružėlės;8390767549;Ne;10;0;0;10
13994;Saulutė;Boružėlės;7576532632;Ne;1;0;0;1
13995;Saulutė;Boružėlės;5811810714;Ne;0;3;0;3
13996;Saulutė;Boružėlės;7081700501;Ne;1;0;0;1
13997;Saulutė;Boružėlės;7474989619;Ne;0;2;0;2
13998;Saulutė;Boružėlės;1803710557;Ne;4;0;0;4
13999;Saulutė;Boružėlės;9173336078;Ne;0;0;1;1
14000;Saulutė;Boružėlės;9098663596;Ne;5;0;0;5
14001;Saulutė;Boružėlės;1265174091;Ne;0;0;1;1
14002;Saulutė;Boružėlės;2988010963;Ne;0;18;0;18
14003;Saulutė;Boružėlės;3852862834;Ne;3;0;1;4
14004;Saulutė;Boružėlės;1275552038;Ne;4;0;1;5
14005;Saulutė;Boružėlės;3363212754;Ne;4;1;0;5
14006;Saulutė;Boružėlės;4840187188;Ne;12;0;0;12
14007;Saulutė;Nykštukai;2601822200;Ne;4;0;1;5
14008;Saulutė;Nykštukai;3244850673;Ne;5;1;0;6
14009;Saulutė;Nykštukai;3221612665;Ne;10;0;0;10
14010;Saulutė;Nykštukai;2140277182;Ne;14;0;0;14
14011;Saulutė;Nykštukai;4800144085;Ne;0;11;0;11
14012;Saulutė;Nykštukai;8257363228;Ne;7;0;0;7
14013;Saulutė;Nykštukai;8984040932;Taip;1;6;0;7
14014;Saulutė;Nykštukai;3463428772;Ne;5;0;0;5
14015;Saulutė;Nykštukai;9930330487;Ne;4;0;0;4
14016;Saulutė;Nykštukai;7158455528;Ne;3;0;0;3
14017;Saulutė;Nykštukai;1229624643;Ne;5;0;0;5
14018;Saulutė;Nykštukai;9572394489;Ne;11;0;0;11
14019;Saulutė;Nykštukai;5509365461;Ne;5;1;0;6
14020;Saulutė;Nykštukai;3408369823;Ne;4;0;0;4
14021;Saulutė;Nykštukai;5264813819;Ne;2;0;1;3
14022;Saulutė;Nykštukai;3265401334;Ne;4;0;0;4
14023;Saulutė;Nykštukai;9497439410;Ne;0;6;0;6
14024;Saulutė;Nykštukai;5335820652;Taip;5;1;0;6
14025;Saulutė;Nykštukai;4510990261;Ne;10;0;4;14
14026;Saulutė;Nykštukai;7555183487;Ne;5;2;0;7
14027;Saulutė;Meškiukai;5219429911;Ne;0;0;4;4
14028;Saulutė;Meškiukai;8787977881;Ne;0;6;0;6
14029;Saulutė;Meškiukai;8147755754;Ne;9;0;0;9
14030;Saulutė;Meškiukai;1562476697;Ne;16;2;0;18
14031;Saulutė;Meškiukai;1776176097;Ne;8;0;0;8
14032;Saulutė;Meškiukai;1408451926;Ne;11;0;1;12
14033;Saulutė;Meškiukai;9175541045;Ne;12;0;2;14
14034;Saulutė;Meškiukai;6978306762;Ne;16;0;0;16
14035;Saulutė;Meškiukai;7757420187;Taip;11;0;0;11
14036;Saulutė;Meškiukai;1415128133;Ne;0;0;6;6
14037;Saulutė;Meškiukai;9919098322;Ne;7;0;3;10
14038;Saulutė;Meškiukai;1848147862;Ne;14;0;1;15
14039;Saulutė;Meškiukai;3883395634;Ne;5;0;0;5
14040;Saulutė;Meškiukai;2929345460;Ne;20;0;0;20
14041;Saulutė;Meškiukai;9825396096;Ne;7;13;0;20
14042;Saulutė;Meškiukai;1175393220;Ne;7;0;0;7
14043;Saulutė;Meškiukai;8844784669;Ne;5;0;2;7
14044;Saulutė;Ežiukai;2813274509;Ne;7;0;0;7
14045;Saulutė;Ežiukai;2315812734;Ne;3;0;0;3
14046;Saulutė;Ežiukai;8736917541;Taip;7;0;0;7
14047;Saulutė;Ežiukai;4363210987;Ne;5;0;0;5
14048;Saulutė;Ežiukai;5972503001;Ne;6;0;0;6
14049;Saulutė;Ežiukai;6884472677;Ne;10;0;0;10
14050;Saulutė;Ežiukai;4194586403;Ne;2;0;0;2
14051;Saulutė;Ežiukai;1853984777;Ne;2;0;0;2
14052;Saulutė;Ežiukai;1666301750;Ne;8;0;0;8
14053;Saulutė;Ežiukai;3133714991;Ne;4;0;0;4
14054;Saulutė;Ežiukai;2728669975;Ne;10;1;0;11
14055;Saulutė;Ežiukai;9398356470;Ne;8;0;1;9
14056;Saulutė;Ežiukai;6126870829;Ne;6;0;0;6
14057;Saulutė;Ežiukai;3565818383;Ne;5;0;0;5
14058;Saulutė;Ežiukai;9101950978;Ne;2;0;0;2
14059;Saulutė;Ežiukai;6982979199;Ne;5;0;0;5
14060;Saulutė;Ežiukai;8919457259;Ne;5;0;0;5
14061;Saulutė;Ežiukai;3125186472;Ne;10;0;0;10
14062;Saulutė;Ežiukai;7941601480;Ne;8;0;0;8
14063;Saulutė;Ežiukai;8961335897;Ne;7;0;0;7
14064;Saulutė;Ežiukai;4039065925;Ne;7;0;0;7
14065;Saulutė;Bitutės;5897526863;Ne;14;0;1;15
14066;Saulutė;Bitutės;6531388817;Taip;0;0;4;4
14067;Saulutė;Bitutės;1640977737;Ne;9;0;0;9
14068;Saulutė;Bitutės;8681103477;Ne;10;0;1;11
14069;Saulutė;Bitutės;2251663689;Ne;10;9;0;19
14070;Saulutė;Bitutės;8428335721;Ne;19;0;0;19
14071;Saulutė;Bitutės;5623547412;Ne;15;5;0;20
14072;Saulutė;Bitutės;1931298484;Ne;2;1;0;3
14073;Saulutė;Bitutės;5308928580;Ne;16;0;0;16
14074;Saulutė;Bitutės;9741004996;Ne;10;0;1;11
14075;Saulutė;Bitutės;3883903645;Taip;8;0;1;9
14076;Saulutė;Bitutės;2402895955;Ne;0;0;3;3
14077;Saulutė;Bitutės;4055603288;Taip;10;0;2;12
14078;Saulutė;Bitutės;8551251470;Ne;3;13;1;17
14079;Saulutė;Bitutės;2849357495;Ne;7;0;0;7
14080;Saulutė;Bitutės;1763631244;Ne;0;4;2;6
14081;Saulutė;Bitutės;7123687661;Ne;14;0;0;14
14082;Saulutė;Pelėdžiukai;8512137633;Taip;4;2;0;6
14083;Saulutė;Pelėdžiukai;4211866191;Ne;23;0;0;23
14084;Saulutė;Pelėdžiukai;2373409300;Ne;8;0;3;11
14085;Saulutė;Pelėdžiukai;8405262902;Taip;11;0;0;11
14086;Saulutė;Pelėdžiukai;1745754752;Ne;4;0;1;5
14087;Saulutė;Pelėdžiukai;4123500930;Ne;7;0;0;7
14088;Saulutė;Pelėdžiukai;1056158093;Ne;5;0;0;5
14089;Saulutė;Pelėdžiukai;8371366346;Ne;0;3;0;3
14090;Saulutė;Pelėdžiukai;6842585310;Ne;16;0;0;16
14091;Saulutė;Pelėdžiukai;1776164273;Ne;10;1;0;11
14092;Saulutė;Pelėdžiukai;5850783789;Ne;21;0;0;21
14093;Saulutė;Pelėdžiukai;7243072252;Ne;1;0;0;1
14094;Saulutė;Pelėdžiukai;9903380188;Ne;4;0;0;4
14095;Saulutė;Pelėdžiukai;7620841597;Ne;19;0;0;19
14096;Saulutė;Pelėdžiukai;7640441297;Ne;19;0;0;19
14097;Saulutė;Pelėdžiukai;6046611248;Taip;0;4;0;4
14098;Saulutė;Pelėdžiukai;4301516165;Ne;23;0;1;24
14099;Saulutė;Pelėdžiukai;7258180835;Ne;15;1;0;16
14100;Saulutė;Pelėdžiukai;2566263680;Ne;9;1;3;13
14101;Saulutė;Pelėdžiukai;9106119465;Ne;3;0;0;3
14102;Saulutė;Pelėdžiukai;4179271978;Ne;30;0;0;30
14103;Saulutė;Zylutės;3228226715;Ne;1;0;0;1
14104;Saulutė;Zylutės;8040751073;Ne;3;5;0;8
14105;Saulutė;Zylutės;2074473832;Ne;4;0;0;4
14106;Saulutė;Zylutės;8041118115;Ne;20;0;0;20
14107;Saulutė;Zylutės;4686825392;Ne;5;0;0;5
14108;Saulutė;Zylutės;7446423510;Ne;0;0;3;3
14109;Saulutė;Zylutės;8717210130;Ne;10;1;0;11
14110;Saulutė;Zylutės;8211523302;Ne;2;1;0;3
14111;Saulutė;Zylutės;3272296969;Taip;3;0;0;3
14112;Saulutė;Zylutės;7032417938;Taip;11;0;0;11
14113;Saulutė;Zylutės;1784093413;Ne;0;18;0;18
14114;Saulutė;Zylutės;8722717930;Ne;16;1;0;17
14115;Saulutė;Zylutės;5442075474;Ne;13;0;0;13
14116;Saulutė;Zylutės;4390098560;Ne;8;0;0;8
14117;Saulutė;Zylutės;4663795223;Ne;0;20;0;20
14118;Saulutė;Zylutės;7839168221;Ne;1;0;0;1
14119;Saulutė;Zylutės;2527027536;Ne;4;0;0;4
14120;Saulutė;Zylutės;2725491887;Ne;15;0;0;15
14121;Saulutė;Zylutės;1712365476;Ne;12;0;0;12
14122;Saulutė;Zylutės;4516130694;Ne;0;20;0;20
14123;Saulutė;Zylutės;5460773696;Ne;7;0;0;7
14124;Saulutė;"1 klasė";7844396402;Ne;1;0;0;1
14125;Saulutė;"1 klasė";8379304869;Ne;2;0;0;2
14126;Saulutė;"1 klasė";9947607411;Ne;7;0;0;7
14127;Saulutė;"1 klasė";1324799653;Taip;5;0;0;5
14128;Saulutė;"1 klasė";3691381351;Ne;2;0;0;2
14129;Saulutė;"1 klasė";8242602551;Ne;1;0;0;1
14130;Saulutė;"1 klasė";2397257894;Ne;1;0;0;1
14131;Saulutė;"1 klasė";2781003892;Ne;2;0;0;2
14132;Saulutė;"1 klasė";2816806902;Ne;7;0;0;7
14133;Saulutė;"1 klasė";5247769309;Ne;4;0;0;4
14134;Saulutė;"1 klasė";9521155670;Ne;2;0;0;2
14135;Saulutė;"1 klasė";3620722907;Ne;7;0;0;7
14136;Saulutė;"1 klasė";3749374270;Ne;5;0;0;5
14137;Saulutė;"1 klasė";1562393383;Ne;1;0;0;1
14138;Saulutė;"1 klasė";5641148690;Ne;1;0;0;1
14139;Saulutė;"1 klasė";4818911910;Ne;5;0;0;5
14140;Saulutė;"1 klasė";1833001939;Ne;4;0;0;4
14141;Saulutė;"1 klasė";8092104136;Ne;16;0;0;16
14142;Saulutė;"1 klasė";4971244488;Taip;2;0;0;2
14143;Saulutė;"2 klasė";61073095949;Ne;5;0;0;5
14144;Saulutė;"2 klasė";1717909005;Ne;2;0;0;2
14145;Saulutė;"2 klasė";1513449225;Ne;8;0;0;8
14146;Saulutė;"2 klasė";87814849917;Ne;5;0;0;5
14147;Saulutė;"2 klasė";8944601874;Ne;11;0;0;11
14148;Saulutė;"2 klasė";3064199909;Ne;5;0;0;5
14149;Saulutė;"2 klasė";1556270046;Ne;6;0;0;6
14150;Saulutė;"2 klasė";4272320685;Ne;7;0;0;7
14151;Saulutė;"2 klasė";28772515317;Ne;1;0;0;1
14152;Saulutė;"2 klasė";2677995903;Ne;2;0;0;2
14153;Saulutė;"2 klasė";1391904744;Ne;2;0;0;2
14154;Saulutė;"2 klasė";1786491396;Ne;10;0;0;10
14155;Saulutė;"2 klasė";1386800520;Ne;8;0;0;8
14156;Saulutė;"2 klasė";6096297366;Ne;10;0;0;10
14157;Saulutė;"2 klasė";1332002470;Ne;11;0;0;11
14158;Saulutė;"2 klasė";89920419797;Ne;5;0;0;5
14159;Saulutė;"3 klasė";45306237230;Ne;3;0;0;3
14160;Saulutė;"3 klasė";79438946697;Ne;5;0;0;5
14161;Saulutė;"3 klasė";79919438191;Ne;5;0;0;5
14162;Saulutė;"3 klasė";29074930927;Ne;1;0;0;1
14163;Saulutė;"3 klasė";31705050946;Ne;2;0;0;2
14164;Saulutė;"3 klasė";37315117916;Ne;3;0;0;3
14165;Saulutė;"3 klasė";3445723020;Ne;1;0;0;1
14166;Saulutė;"3 klasė";77923802656;Ne;5;0;0;5
14167;Saulutė;"3 klasė";1935503629;Ne;2;0;0;2
14168;Saulutė;"3 klasė";75405796772;Ne;16;0;0;16
14169;Saulutė;"3 klasė";1277263391;Ne;2;0;0;2
14170;Saulutė;"3 klasė";97145959022;Ne;20;0;0;20
14171;Saulutė;"3 klasė";77170708225;Ne;6;0;0;6
14172;Saulutė;"3 klasė";4640909915;Ne;2;0;0;2
14173;Saulutė;"3 klasė";1534183935;Ne;6;0;0;6
14174;Saulutė;"3 klasė";5574049005;Ne;3;0;0;3
14175;Saulutė;"3 klasė";1510434265;Ne;6;0;0;6
14176;Saulutė;"3 klasė";1422040758;Ne;5;0;0;5
14177;Saulutė;"3 klasė";77951768319;Ne;2;0;0;2
14178;Saulutė;"4 klasė";1005459768;Ne;5;0;0;5
14179;Saulutė;"4 klasė";1804521229;Ne;6;0;0;6
14180;Saulutė;"4 klasė";76108591835;Taip;1;0;0;1
14181;Saulutė;"4 klasė";3156830821;Ne;2;0;0;2
14182;Saulutė;"4 klasė";3246485288;Ne;6;0;0;6
14183;Saulutė;"4 klasė";44452051978;Ne;2;0;0;2
14184;Saulutė;"4 klasė";25124975646;Ne;6;0;0;6
14185;Saulutė;"4 klasė";3450668814;Taip;13;0;0;13
14186;Saulutė;"4 klasė";8168961080;Ne;6;0;0;6
14187;Saulutė;"4 klasė";76744652185;Ne;5;0;0;5
14188;Saulutė;"4 klasė";97296161595;Ne;9;0;0;9
14189;Saulutė;"4 klasė";1205642335;Ne;1;0;0;1
14190;Saulutė;"4 klasė";2426509692;Ne;2;0;0;2
14191;Saulutė;"4 klasė";99841176399;Ne;1;0;0;1
14192;Saulutė;"4 klasė";1337654926;Ne;10;0;0;10
14193;Saulutė;"4 klasė";2787531476;Ne;5;0;0;5
14194;Saulutė;"4 klasė";13147367113;Ne;1;0;0;1
14195;Saulutė;"4 klasė";2216383015;Ne;1;0;0;1
14196;Saulutė;"4 klasė";96497471950;Ne;3;0;0;3
14197;Saulutė;"4 klasė";6557918941;Ne;1;0;0;1
14198;Svaja;SAULĖGRĄŽA;4510147045;Ne;0;8;0;8
14199;Svaja;SAULĖGRĄŽA;9680766688;Ne;0;0;2;2
14200;Svaja;SAULĖGRĄŽA;3912426942;Ne;3;0;0;3
14201;Svaja;SAULĖGRĄŽA;3809817617;Ne;0;0;2;2
14202;Svaja;SAULĖGRĄŽA;3501620040;Ne;0;1;0;1
14203;Svaja;SAULĖGRĄŽA;4333001830;Ne;0;5;0;5
14204;Svaja;SAULĖGRĄŽA;6928763381;Ne;6;9;3;18
14205;Svaja;SAULĖGRĄŽA;7408966637;Ne;10;0;0;10
14206;Svaja;SAULĖGRĄŽA;3563842321;Ne;2;0;1;3
14207;Svaja;SAULĖGRĄŽA;3461282516;Ne;0;0;1;1
14208;Svaja;SAULĖGRĄŽA;4253831334;Ne;4;0;0;4
14209;Svaja;SAULĖGRĄŽA;6963684639;Ne;9;0;0;9
14210;Svaja;SAULĖGRĄŽA;4189290919;Ne;0;20;0;20
14211;Svaja;SAULĖGRĄŽA;2481547868;Ne;5;0;0;5
14212;Svaja;SAULĖGRĄŽA;8875703109;Ne;0;0;2;2
14213;Svaja;SAULĖGRĄŽA;1496216379;Ne;0;0;5;5
14214;Svaja;"STEBUKLINGAS ŽIBINTAS";1558093905;Ne;0;0;1;1
14215;Svaja;"STEBUKLINGAS ŽIBINTAS";2200408537;Ne;2;0;0;2
14216;Svaja;"STEBUKLINGAS ŽIBINTAS";9814969596;Ne;0;2;0;2
14217;Svaja;"STEBUKLINGAS ŽIBINTAS";4290716676;Ne;5;0;0;5
14218;Svaja;"STEBUKLINGAS ŽIBINTAS";9545690301;Ne;2;0;2;4
14219;Svaja;"STEBUKLINGAS ŽIBINTAS";6128350581;Ne;2;0;1;3
14220;Svaja;"STEBUKLINGAS ŽIBINTAS";9259478140;Taip;0;1;1;2
14221;Svaja;"STEBUKLINGAS ŽIBINTAS";4237592104;Ne;7;0;0;7
14222;Svaja;"STEBUKLINGAS ŽIBINTAS";8363418532;Ne;0;0;2;2
14223;Svaja;"STEBUKLINGAS ŽIBINTAS";7277217069;Ne;6;0;3;9
14224;Svaja;"STEBUKLINGAS ŽIBINTAS";8172396846;Ne;0;0;3;3
14225;Svaja;"STEBUKLINGAS ŽIBINTAS";2188430052;Ne;0;0;1;1
14226;Svaja;"STEBUKLINGAS ŽIBINTAS";4565097904;Ne;0;0;1;1
14227;Svaja;SAULUTĖ;3382252131;Ne;5;0;0;5
14228;Svaja;SAULUTĖ;3684781373;Ne;3;0;0;3
14229;Svaja;SAULUTĖ;1013124074;Ne;2;0;0;2
14230;Svaja;SAULUTĖ;1312040427;Ne;3;0;0;3
14231;Svaja;SAULUTĖ;5455078232;Ne;5;0;0;5
14232;Svaja;SAULUTĖ;7087302180;Ne;4;4;0;8
14233;Svaja;SAULUTĖ;6335409702;Ne;5;0;0;5
14234;Svaja;SAULUTĖ;6027456849;Ne;8;0;0;8
14235;Svaja;SAULUTĖ;8609098948;Ne;5;0;0;5
14236;Svaja;SAULUTĖ;1344097741;Ne;2;0;0;2
14237;Svaja;SAULUTĖ;7520701357;Ne;3;0;0;3
14238;Svaja;SAULUTĖ;4577061794;Ne;4;0;0;4
14239;Svaja;SAULUTĖ;2599692546;Ne;2;14;0;16
14240;Svaja;SAULUTĖ;4415517674;Ne;4;0;0;4
14241;Svaja;SAULUTĖ;6354364944;Ne;1;0;0;1
14242;Svaja;SAULUTĖ;5186248897;Ne;10;0;0;10
14243;Svaja;"AUKSINĖ ŽUVELĖ";1914129062;Ne;5;0;2;7
14244;Svaja;"AUKSINĖ ŽUVELĖ";2427918378;Ne;0;1;0;1
14245;Svaja;"AUKSINĖ ŽUVELĖ";3567924341;Ne;6;0;3;9
14246;Svaja;"AUKSINĖ ŽUVELĖ";5033214011;Ne;10;0;0;10
14247;Svaja;"AUKSINĖ ŽUVELĖ";5013548619;Ne;0;0;2;2
14248;Svaja;"AUKSINĖ ŽUVELĖ";6028471687;Ne;3;0;0;3
14249;Svaja;"AUKSINĖ ŽUVELĖ";1877749103;Ne;1;0;0;1
14250;Svaja;"AUKSINĖ ŽUVELĖ";5908440171;Ne;3;0;1;4
14251;Svaja;"AUKSINĖ ŽUVELĖ";7562678317;Ne;5;0;2;7
14252;Svaja;"AUKSINĖ ŽUVELĖ";7434898745;Ne;0;3;0;3
14253;Svaja;"AUKSINĖ ŽUVELĖ";2641473764;Ne;3;0;0;3
14254;Svaja;"AUKSINĖ ŽUVELĖ";6086270618;Ne;5;0;0;5
14255;Svaja;"AUKSINĖ ŽUVELĖ";1932506236;Ne;10;0;3;13
14256;Svaja;"PRIE ĮLANKOS";9240037050;Ne;6;0;0;6
14257;Svaja;"PRIE ĮLANKOS";3459060550;Ne;8;0;1;9
14258;Svaja;"PRIE ĮLANKOS";6361228838;Ne;0;0;2;2
14259;Svaja;"PRIE ĮLANKOS";7853479591;Ne;2;0;0;2
14260;Svaja;"PRIE ĮLANKOS";2770477678;Ne;0;4;0;4
14261;Svaja;"PRIE ĮLANKOS";5127370193;Ne;0;0;1;1
14262;Svaja;"PRIE ĮLANKOS";9689082202;Ne;0;0;1;1
14263;Svaja;"PRIE ĮLANKOS";3612833383;Ne;7;0;0;7
14264;Svaja;"PRIE ĮLANKOS";6385127914;Ne;0;0;2;2
14265;Svaja;"PRIE ĮLANKOS";6102907953;Ne;6;0;3;9
14266;Svaja;"PRIE ĮLANKOS";2070084064;Ne;2;0;0;2
14267;Svaja;"PRIE ĮLANKOS";4256222944;Ne;0;0;1;1
14268;Svaja;"PRIE ĮLANKOS";5126348190;Ne;0;0;4;4
14269;Svaja;"PRIE ĮLANKOS";3823958567;Ne;0;0;1;1
14270;Svaja;"PRIE ĮLANKOS";6059069293;Ne;3;0;0;3
14271;Svaja;"PRIE ĮLANKOS";8622800666;Ne;0;0;3;3
14272;Svaja;"1 B klasė";20473739993;Ne;0;20;0;20
14273;Svaja;"1 B klasė";50207734108;Ne;1;0;0;1
14274;Svaja;"1 B klasė";5479482244;Ne;1;0;0;1
14275;Svaja;"1 B klasė";1633236289;Ne;5;0;0;5
14276;Svaja;"1 B klasė";1392455608;Ne;3;0;0;3
14277;Svaja;"1 B klasė";9864664937;Ne;3;0;0;3
14278;Svaja;"1 B klasė";1617844709;Ne;5;0;0;5
14279;Svaja;"1 B klasė";5862570666;Ne;1;0;0;1
14280;Svaja;"1 B klasė";9950569499;Ne;7;0;0;7
14281;Svaja;"1 B klasė";4541391191;Ne;5;0;0;5
14282;Svaja;"1 B klasė";6638804854;Ne;2;0;0;2
14283;Svaja;"1 B klasė";2627089275;Ne;4;0;0;4
14284;Svaja;"1 A klasė";7936765752;Ne;2;0;0;2
14285;Svaja;"1 A klasė";3802996573;Taip;2;0;0;2
14286;Svaja;"1 A klasė";5443682744;Ne;1;0;0;1
14287;Svaja;"1 A klasė";4968201186;Ne;5;0;0;5
14288;Svaja;"1 A klasė";7473493846;Taip;5;0;0;5
14289;Svaja;"1 A klasė";2750615517;Ne;2;0;0;2
14290;Svaja;"1 A klasė";9311520300;Ne;1;0;0;1
14291;Svaja;"1 A klasė";2018689468;Ne;1;0;0;1
14292;Svaja;"1 A klasė";7514587933;Ne;2;0;0;2
14293;Svaja;"1 A klasė";4393041946;Ne;1;0;0;1
14294;Svaja;"1 A klasė";1377813636;Ne;1;0;0;1
14295;Svaja;"1 A klasė";3630922360;Ne;3;0;0;3
14296;Svaja;"1 A klasė";8357287467;Taip;1;0;0;1
14297;Svaja;"1 A klasė";1114477688;Ne;1;0;0;1
14298;Svaja;"1 A klasė";5356005675;Ne;4;0;0;4
14299;Svaja;"2 A klasė";43307670660;Ne;3;0;0;3
14300;Svaja;"2 A klasė";5335776957;Ne;0;20;0;20
14301;Svaja;"2 A klasė";22702341083;Ne;2;0;0;2
14302;Svaja;"2 A klasė";1576498450;Ne;1;0;0;1
14303;Svaja;"2 A klasė";1046879533;Ne;1;0;0;1
14304;Svaja;"2 A klasė";47457128214;Ne;4;0;0;4
14305;Svaja;"2 A klasė";2147266053;Ne;4;0;0;4
14306;Svaja;"2 A klasė";73679997517;Ne;1;0;0;1
14307;Svaja;"2 A klasė";56117509354;Ne;1;0;0;1
14308;Svaja;"2 A klasė";7669562010;Ne;6;0;0;6
14309;Svaja;"2 A klasė";4900757614;Ne;3;0;0;3
14310;Svaja;"2 A klasė";8697355813;Ne;3;0;0;3
14311;Svaja;"2 A klasė";193181908;Ne;1;0;0;1
14312;Svaja;"2 A klasė";193181908;Ne;1;0;0;1
14313;Svaja;"2 B klasė";55925058866;Ne;1;19;0;20
14314;Svaja;"2 B klasė";8875237023;Ne;1;0;0;1
14315;Svaja;"2 B klasė";8279605005;Ne;3;17;0;20
14316;Svaja;"2 B klasė";1437557657;Ne;6;0;0;6
14317;Svaja;"2 B klasė";36505115395;Ne;0;20;0;20
14318;Svaja;"2 B klasė";7911488445;Ne;1;0;0;1
14319;Svaja;"2 B klasė";64196174690;Ne;0;20;0;20
14320;Svaja;"2 B klasė";21871530266;Ne;1;0;0;1
14321;Svaja;"2 B klasė";3562817807;Ne;0;20;0;20
14322;Svaja;"2 B klasė";2069150261;Taip;2;0;0;2
14323;Svaja;"2 B klasė";1191494598;Ne;2;0;0;2
14324;Svaja;"2 B klasė";24863928147;Ne;1;0;0;1
14325;Svaja;"2 B klasė";15159708127;Ne;2;0;0;2
14326;Svaja;"2 B klasė";11671380984;Taip;5;0;0;5
14327;Svaja;"2 B klasė";99183628764;Ne;2;0;0;2
14328;Svaja;"2 B klasė";1865658456;Ne;3;0;0;3
14329;Svaja;"3 A klasė";9628146488;Ne;1;0;0;1
14330;Svaja;"3 A klasė";1304775332;Taip;2;0;0;2
14331;Svaja;"3 A klasė";8198614500;Ne;7;0;0;7
14332;Svaja;"3 A klasė";5522433229;Ne;5;0;0;5
14333;Svaja;"3 A klasė";18733824395;Ne;1;0;0;1
14334;Svaja;"3 A klasė";26500981786;Ne;2;0;0;2
14335;Svaja;"3 A klasė";23112873505;Ne;4;0;0;4
14336;Svaja;"3 A klasė";15246943974;Ne;2;0;0;2
14337;Svaja;"3 A klasė";1562041360;Ne;5;0;0;5
14338;Svaja;"3 B klasė";69028070656;Ne;5;0;0;5
14339;Svaja;"3 B klasė";30360097999;Ne;20;0;0;20
14340;Svaja;"3 B klasė";19887874988;Ne;1;0;0;1
14341;Svaja;"3 B klasė";7719185632;Ne;8;0;0;8
14342;Svaja;"3 B klasė";57216954289;Ne;3;0;0;3
14343;Svaja;"3 B klasė";44989143252;Ne;10;0;0;10
14344;Svaja;"3 B klasė";87432529423;Ne;1;0;0;1
14345;Svaja;"3 B klasė";3077814152;Ne;1;0;0;1
14346;Svaja;"3 B klasė";6056157113;Ne;1;0;0;1
14347;Svaja;"3 B klasė";21608020858;Ne;1;0;0;1
14348;Svaja;"3 B klasė";4804779327;Ne;3;17;0;20
14349;Svaja;"3 B klasė";40814723278;Ne;1;0;0;1
14350;Svaja;"3 B klasė";69413101571;Ne;1;0;0;1
14351;Svaja;"3 B klasė";89316574266;Ne;9;11;0;20
14352;Svaja;"3 B klasė";809734624;Ne;3;0;0;3
14353;Svaja;"3 B klasė";76618850202;Ne;1;0;0;1
14354;Svaja;"4 A klasė";6057524892;Ne;1;0;0;1
14355;Svaja;"4 A klasė";63346231562;Ne;1;0;0;1
14356;Svaja;"4 A klasė";64487515384;Ne;0;20;0;20
14357;Svaja;"4 A klasė";4617061890;Taip;4;0;0;4
14358;Svaja;"4 A klasė";8828911320;Ne;0;20;0;20
14359;Svaja;"4 A klasė";3604946305;Ne;0;20;0;20
14360;Svaja;"4 A klasė";3474439050;Ne;3;0;0;3
14361;Svaja;"4 A klasė";72752022712;Ne;1;0;0;1
14362;Svaja;"4 A klasė";30754812113;Ne;3;0;0;3
14363;Svaja;"4 A klasė";1168637823;Ne;5;0;0;5
14364;Svaja;"4 A klasė";60448774566;Ne;0;4;0;4
14365;Svaja;"4 A klasė";1649920341;Ne;5;0;0;5
14366;Svaja;"4 B klasė";70506691027;Ne;2;18;0;20
14367;Svaja;"4 B klasė";73391331150;Ne;1;19;0;20
14368;Svaja;"4 B klasė";70507326327;Ne;0;20;0;20
14369;Svaja;"4 B klasė";8011137572;Ne;1;0;0;1
14370;Svaja;"4 B klasė";54328462992;Ne;1;19;0;20
14371;Svaja;"4 B klasė";71708072632;Ne;5;0;0;5
14372;Svaja;"4 B klasė";56506642672;Ne;1;0;0;1
14373;Svaja;"4 B klasė";17947580061;Ne;3;0;0;3
14374;Svaja;"4 B klasė";3526873547;Ne;3;0;0;3
14375;Svaja;"4 B klasė";62971657427;Ne;1;0;0;1
14376;Svaja;"4 B klasė";50649509868;Ne;6;14;0;20
14377;Svaja;"4 B klasė";80772711351;Ne;1;0;0;1
14378;Svaja;"4 B klasė";6969692916;Ne;2;0;0;2
14379;Svaja;"4 B klasė";4282243865;Ne;0;1;0;1
14380;Svaja;"4 C klasė";89047123808;Ne;1;0;0;1
14381;Svaja;"4 C klasė";41183537732;Ne;4;0;0;4
14382;Svaja;"4 C klasė";2165716699;Ne;2;18;0;20
14383;Svaja;"4 C klasė";94449039022;Ne;0;20;0;20
14384;Svaja;"4 C klasė";85150525696;Ne;5;0;0;5
14385;Svaja;"4 C klasė";36001411632;Ne;1;0;0;1
14386;Svaja;"4 C klasė";34995551069;Ne;3;0;0;3
14387;Svaja;"4 C klasė";1848422504;Ne;4;0;0;4
14388;Svaja;"4 C klasė";3743948734;Ne;2;0;0;2
14389;Svaja;"4 C klasė";54852358913;Taip;4;0;0;4
14390;Svaja;"4 C klasė";57253216255;Ne;2;0;0;2
14391;Svaja;"4 C klasė";91855230473;Ne;1;0;0;1
14392;Svaja;"4 C klasė";1855559693;Ne;1;19;0;20
14393;Svaja;"4 C klasė";31216445971;Ne;2;18;0;20
14394;Svaja;"4 C klasė";20342193231;Ne;4;0;0;4
14395;Svaja;"4 C klasė";91088224294;Ne;1;19;0;20
14396;Šilelis;PAUKŠTELIAI;6128379060;Ne;3;3;0;6
14397;Šilelis;PAUKŠTELIAI;9653439873;Ne;4;1;0;5
14398;Šilelis;PAUKŠTELIAI;2823486581;Ne;2;0;0;2
14399;Šilelis;PAUKŠTELIAI;6369443270;Ne;0;5;0;5
14400;Šilelis;PAUKŠTELIAI;7595774842;Ne;3;0;0;3
14401;Šilelis;PAUKŠTELIAI;6614686867;Ne;15;0;0;15
14402;Šilelis;PAUKŠTELIAI;3053443777;Ne;7;0;0;7
14403;Šilelis;PAUKŠTELIAI;4960501068;Ne;0;7;0;7
14404;Šilelis;PAUKŠTELIAI;7072057348;Ne;0;1;0;1
14405;Šilelis;PAUKŠTELIAI;1124854378;Ne;5;0;0;5
14406;Šilelis;PAUKŠTELIAI;8184170908;Ne;2;0;0;2
14407;Šilelis;PAUKŠTELIAI;9799198904;Taip;5;0;0;5
14408;Šilelis;PAUKŠTELIAI;5493811298;Ne;5;0;0;5
14409;Šilelis;PAUKŠTELIAI;7652950762;Ne;0;0;1;1
14410;Šilelis;SKRUZDELIUKAI;6359318134;Ne;5;0;3;8
14411;Šilelis;SKRUZDELIUKAI;5598152793;Taip;0;4;0;4
14412;Šilelis;SKRUZDELIUKAI;8090773379;Ne;0;2;0;2
14413;Šilelis;SKRUZDELIUKAI;9589138527;Ne;0;4;0;4
14414;Šilelis;SKRUZDELIUKAI;2972202874;Taip;0;1;0;1
14415;Šilelis;SKRUZDELIUKAI;9461117894;Ne;5;0;0;5
14416;Šilelis;SKRUZDELIUKAI;5091571136;Ne;0;4;0;4
14417;Šilelis;SKRUZDELIUKAI;8297975308;Ne;0;10;0;10
14418;Šilelis;SKRUZDELIUKAI;9276607554;Taip;0;1;0;1
14419;Šilelis;SKRUZDELIUKAI;6139976105;Ne;3;0;0;3
14420;Šilelis;SMERFY;3247333567;Ne;4;1;0;5
14421;Šilelis;SMERFY;3089270468;Ne;0;2;0;2
14422;Šilelis;SMERFY;4504627601;Ne;2;0;0;2
14423;Šilelis;SMERFY;6390855924;Ne;8;0;0;8
14424;Šilelis;SMERFY;1821827154;Ne;0;3;0;3
14425;Šilelis;SMERFY;4196893379;Ne;0;2;0;2
14426;Šilelis;SMERFY;1890114622;Ne;1;0;0;1
14427;Šilelis;SMERFY;8909345826;Ne;6;0;0;6
14428;Šilelis;SMERFY;9502563865;Ne;5;0;0;5
14429;Šilelis;SMERFY;8659845107;Ne;3;0;0;3
14430;Šilelis;SMERFY;1906712332;Ne;6;0;0;6
14431;Šilelis;EŽIUKAI;4702068672;Ne;0;2;0;2
14432;Šilelis;EŽIUKAI;2295849333;Ne;0;1;0;1
14433;Šilelis;EŽIUKAI;1883483049;Ne;0;6;0;6
14434;Šilelis;EŽIUKAI;6386996498;Ne;5;0;0;5
14435;Šilelis;EŽIUKAI;6233673622;Ne;20;0;0;20
14436;Šilelis;EŽIUKAI;3312235148;Ne;10;0;1;11
14437;Šilelis;EŽIUKAI;5314433515;Ne;6;0;0;6
14438;Šilelis;EŽIUKAI;1980323777;Ne;6;0;0;6
14439;Šilelis;EŽIUKAI;9203888742;Ne;0;9;0;9
14440;Šilelis;EŽIUKAI;2289616655;Ne;20;0;0;20
14441;Šilelis;EŽIUKAI;5167084901;Ne;0;0;6;6
14442;Šilelis;EŽIUKAI;3669647107;Ne;0;3;0;3
14443;Šilelis;EŽIUKAI;2151250706;Ne;20;0;0;20
14444;Šilelis;EŽIUKAI;7891369140;Ne;10;0;1;11
14445;Šilelis;NYKŠTUKAI;3046954717;Ne;0;13;0;13
14446;Šilelis;NYKŠTUKAI;3158708835;Ne;5;0;0;5
14447;Šilelis;NYKŠTUKAI;6195580698;Ne;0;0;1;1
14448;Šilelis;NYKŠTUKAI;6107771932;Ne;0;0;4;4
14449;Šilelis;NYKŠTUKAI;4323998445;Taip;6;0;0;6
14450;Šilelis;NYKŠTUKAI;2095572561;Taip;3;1;2;6
14451;Šilelis;NYKŠTUKAI;2161973782;Ne;0;1;0;1
14452;Šilelis;NYKŠTUKAI;4459114205;Ne;5;1;0;6
14453;Šilelis;NYKŠTUKAI;3728633100;Ne;2;1;0;3
14454;Šilelis;NYKŠTUKAI;3999426414;Ne;0;1;0;1
14455;Šilelis;NYKŠTUKAI;5745874033;Ne;0;1;0;1
14456;Šilelis;NYKŠTUKAI;9769483899;Ne;0;1;1;2
14457;Šilelis;NYKŠTUKAI;8944490184;Ne;5;0;1;6
14458;Šilelis;NYKŠTUKAI;2908840424;Ne;4;3;0;7
14459;Šilelis;NYKŠTUKAI;4868465692;Ne;0;5;0;5
14460;Šilelis;NYKŠTUKAI;4754544277;Ne;5;1;0;6
14461;Šilelis;NYKŠTUKAI;1222028604;Ne;5;0;4;9
14462;Šilelis;NYKŠTUKAI;7480611069;Ne;5;0;0;5
14463;Šilelis;NYKŠTUKAI;9360553910;Ne;0;1;0;1
14464;Šilelis;NYKŠTUKAI;6852463814;Ne;10;4;0;14
14465;Šilelis;NYKŠTUKAI;9715544798;Ne;2;5;0;7
14466;Šilelis;ANČIUKAI;1726944289;Ne;0;0;1;1
14467;Šilelis;ANČIUKAI;9661578871;Ne;4;0;0;4
14468;Šilelis;ANČIUKAI;6616262730;Ne;5;0;1;6
14469;Šilelis;ANČIUKAI;4323750313;Ne;10;0;0;10
14470;Šilelis;ANČIUKAI;6364741317;Ne;0;0;3;3
14471;Šilelis;ANČIUKAI;1325857464;Taip;4;0;0;4
14472;Šilelis;ANČIUKAI;9407916190;Ne;0;8;0;8
14473;Šilelis;ANČIUKAI;7128670936;Ne;0;1;0;1
14474;Šilelis;ANČIUKAI;8613748314;Ne;3;1;0;4
14475;Šilelis;ANČIUKAI;5381213051;Taip;8;0;0;8
14476;Šilelis;ANČIUKAI;2976607303;Ne;0;0;1;1
14477;Šilelis;ANČIUKAI;8807755852;Ne;0;2;0;2
14478;Šilelis;ANČIUKAI;4135383684;Ne;0;1;0;1
14479;Šilelis;ANČIUKAI;5926624138;Taip;2;0;1;3
14480;Šilelis;ANČIUKAI;8603589758;Ne;0;0;1;1
14481;Šilelis;ANČIUKAI;4996192593;Ne;7;0;1;8
14482;Šilelis;ANČIUKAI;6485433036;Ne;6;0;3;9
14483;Šilelis;ANČIUKAI;7968869585;Taip;4;0;0;4
14484;Šilelis;ANČIUKAI;3182336761;Taip;9;0;1;10
14485;Šilelis;ANČIUKAI;9767000842;Taip;0;0;3;3
14486;Šilelis;KAČIUKAI;9899047136;Ne;0;1;0;1
14487;Šilelis;KAČIUKAI;3216168797;Ne;15;0;0;15
14488;Šilelis;KAČIUKAI;9848760151;Taip;0;1;0;1
14489;Šilelis;KAČIUKAI;4743459915;Ne;0;1;0;1
14490;Šilelis;KAČIUKAI;8387022157;Ne;0;6;0;6
14491;Šilelis;KAČIUKAI;3393466953;Ne;0;7;0;7
14492;Šilelis;KAČIUKAI;8064905796;Ne;2;2;0;4
14493;Šilelis;KAČIUKAI;7123048946;Ne;10;0;0;10
14494;Šilelis;KAČIUKAI;2906501601;Ne;0;3;0;3
14495;Šilelis;KAČIUKAI;6510813364;Ne;0;1;0;1
14496;Šilelis;KAČIUKAI;8504187981;Taip;0;1;0;1
14497;Šilelis;KAČIUKAI;6470073008;Ne;0;1;0;1
14498;Šilelis;KAČIUKAI;3419284228;Ne;0;1;1;2
14499;Šilelis;KAČIUKAI;3712001932;Ne;0;4;0;4
14500;Šilelis;KAČIUKAI;9106999969;Ne;0;1;0;1
14501;Šilelis;KAČIUKAI;6894466509;Ne;0;0;2;2
14502;Šilelis;KAČIUKAI;5026203678;Ne;0;5;0;5
14503;Šilelis;KAČIUKAI;6561145380;Ne;0;3;0;3
14504;Šilelis;KAČIUKAI;5138192616;Ne;2;2;0;4
14505;Šilelis;KIŠKUČIAI;2209552706;Ne;1;0;1;2
14506;Šilelis;KIŠKUČIAI;7043644521;Ne;0;0;4;4
14507;Šilelis;KIŠKUČIAI;8096868221;Ne;0;0;1;1
14508;Šilelis;KIŠKUČIAI;9746722034;Ne;4;0;0;4
14509;Šilelis;KIŠKUČIAI;8598321310;Ne;0;0;3;3
14510;Šilelis;KIŠKUČIAI;9992207035;Ne;11;0;2;13
14511;Šilelis;KIŠKUČIAI;5431978292;Ne;0;0;1;1
14512;Šilelis;KIŠKUČIAI;6415777619;Ne;14;0;0;14
14513;Šilelis;KIŠKUČIAI;7822646258;Ne;6;0;0;6
14514;Šilelis;KIŠKUČIAI;4910899296;Taip;5;0;0;5
14515;Šilelis;KREGŽDUTĖS;8453070684;Ne;3;0;1;4
14516;Šilelis;KREGŽDUTĖS;8665357907;Ne;10;0;0;10
14517;Šilelis;KREGŽDUTĖS;1152159735;Taip;5;0;0;5
14518;Šilelis;KREGŽDUTĖS;6630114847;Taip;5;0;0;5
14519;Šilelis;KREGŽDUTĖS;3953114161;Taip;5;0;0;5
14520;Šilelis;KREGŽDUTĖS;2499322761;Ne;10;0;0;10
14521;Šilelis;KREGŽDUTĖS;5868594049;Ne;12;0;1;13
14522;Šilelis;KREGŽDUTĖS;8855625488;Ne;1;0;0;1
14523;Šilelis;KREGŽDUTĖS;1279361795;Taip;1;0;0;1
14524;Šilelis;KREGŽDUTĖS;9292761872;Ne;5;2;0;7
14525;Šilelis;KREGŽDUTĖS;6987557382;Ne;0;0;4;4
14526;Šilelis;KREGŽDUTĖS;9991765829;Ne;1;2;2;5
14527;Šilelis;KREGŽDUTĖS;1805615293;Ne;5;5;0;10
14528;Šilelis;KREGŽDUTĖS;5192604763;Ne;0;5;1;6
14529;Šilelis;KREGŽDUTĖS;6065839221;Ne;7;0;0;7
14530;Šilelis;PAGRANDUKAI;8616798722;Ne;4;0;0;4
14531;Šilelis;PAGRANDUKAI;6598481106;Ne;18;0;0;18
14532;Šilelis;PAGRANDUKAI;8654600612;Ne;15;0;0;15
14533;Šilelis;PAGRANDUKAI;1325551883;Ne;5;0;0;5
14534;Šilelis;PAGRANDUKAI;6090493923;Ne;19;0;0;19
14535;Šilelis;PAGRANDUKAI;5090120850;Ne;9;0;0;9
14536;Šilelis;PAGRANDUKAI;7890456241;Ne;17;0;0;17
14537;Šilelis;PAGRANDUKAI;3147394614;Ne;13;0;0;13
14538;Šilelis;PAGRANDUKAI;2693883266;Ne;13;0;0;13
14539;Šilelis;PAGRANDUKAI;2702371841;Ne;5;0;0;5
14540;Šilelis;PAGRANDUKAI;2378919393;Ne;14;0;0;14
14541;Šilelis;PAGRANDUKAI;6484740846;Taip;0;0;3;3
14542;Šilelis;BITUTĖS;7512731255;Ne;0;1;2;3
14543;Šilelis;BITUTĖS;7814807923;Ne;5;2;1;8
14544;Šilelis;BITUTĖS;5843337891;Ne;0;0;1;1
14545;Šilelis;BITUTĖS;1960952604;Ne;11;0;0;11
14546;Šilelis;BITUTĖS;7350013139;Ne;5;0;0;5
14547;Šilelis;BITUTĖS;3879234745;Taip;0;0;6;6
14548;Šilelis;BITUTĖS;3062557053;Ne;0;0;1;1
14549;Šilelis;BITUTĖS;5375413045;Ne;0;15;0;15
14550;Šilelis;BITUTĖS;6830200578;Ne;0;5;0;5
14551;Šilelis;BITUTĖS;6479728064;Ne;0;9;0;9
14552;Šilelis;BITUTĖS;3686287802;Ne;0;0;1;1
14553;Šilelis;BITUTĖS;9602317911;Ne;0;9;0;9
14554;Šilelis;BITUTĖS;8304500877;Taip;0;0;2;2
14555;Šilelis;BITUTĖS;7061399035;Taip;0;1;2;3
14556;Šilelis;BITUTĖS;4272205822;Taip;0;8;0;8
14557;Šilelis;DRUGELIAI;6800679760;Ne;5;1;0;6
14558;Šilelis;DRUGELIAI;3100416582;Ne;4;0;2;6
14559;Šilelis;DRUGELIAI;8563843417;Ne;3;0;0;3
14560;Šilelis;DRUGELIAI;3134882364;Ne;0;5;0;5
14561;Šilelis;DRUGELIAI;5131513427;Ne;0;4;0;4
14562;Šilelis;DRUGELIAI;2575292661;Ne;3;6;0;9
14563;Šilelis;DRUGELIAI;4762848901;Ne;0;5;0;5
14564;Šilelis;DRUGELIAI;8579501639;Ne;5;7;0;12
14565;Šilelis;DRUGELIAI;2073341570;Ne;5;0;3;8
14566;Šilelis;DRUGELIAI;3551123110;Ne;20;0;0;20
14567;Šilelis;DRUGELIAI;9047094780;Ne;5;0;0;5
14568;Šilelis;DRUGELIAI;4513916744;Taip;13;0;0;13
14569;Šilelis;DRUGELIAI;1244496708;Ne;0;0;1;1
14570;Šilelis;DRUGELIAI;9593306122;Ne;5;0;0;5
14571;Šilelis;DRUGELIAI;5845704184;Ne;3;2;0;5
14572;Šilelis;DRUGELIAI;5899112658;Ne;7;0;0;7
14573;Šilelis;DRUGELIAI;3080593571;Ne;0;12;0;12
14574;Vaduvos;PAGRANDUKAI;6611531526;Ne;5;0;0;5
14575;Vaduvos;PAGRANDUKAI;4576510280;Ne;9;2;0;11
14576;Vaduvos;PAGRANDUKAI;8070494719;Ne;4;1;0;5
14577;Vaduvos;PAGRANDUKAI;3206096414;Ne;17;0;0;17
14578;Vaduvos;PAGRANDUKAI;7425991335;Ne;1;0;0;1
14579;Vaduvos;PAGRANDUKAI;7592658267;Ne;0;2;0;2
14580;Vaduvos;PAGRANDUKAI;8533315132;Ne;0;7;0;7
14581;Vaduvos;PAGRANDUKAI;2508650990;Ne;0;4;0;4
14582;Vaduvos;PAGRANDUKAI;1466282653;Taip;6;0;0;6
14583;Vaduvos;PAGRANDUKAI;8055108164;Ne;7;0;0;7
14584;Vaduvos;PAGRANDUKAI;6943057114;Ne;0;9;0;9
14585;Vaduvos;PAGRANDUKAI;8669267296;Ne;5;1;0;6
14586;Vaduvos;PAGRANDUKAI;1736248725;Taip;8;2;0;10
14587;Vaduvos;PAGRANDUKAI;2369774637;Ne;3;7;0;10
14588;Vaduvos;PAGRANDUKAI;9385879695;Taip;14;3;0;17
14589;Vaduvos;PAGRANDUKAI;1414575326;Ne;4;0;0;4
14590;Vaduvos;PAGRANDUKAI;3710830036;Ne;9;0;0;9
14591;Vaduvos;PAGRANDUKAI;7205880191;Ne;10;3;0;13
14592;Vaduvos;PAGRANDUKAI;3695552176;Ne;4;0;0;4
14593;Vaduvos;KODĖLČIUKAI;9429028460;Ne;3;0;0;3
14594;Vaduvos;KODĖLČIUKAI;6210729584;Ne;0;5;0;5
14595;Vaduvos;KODĖLČIUKAI;4177935331;Ne;0;3;0;3
14596;Vaduvos;KODĖLČIUKAI;9072097216;Ne;1;0;0;1
14597;Vaduvos;KODĖLČIUKAI;4270137614;Ne;5;0;0;5
14598;Vaduvos;KODĖLČIUKAI;3682708061;Ne;0;2;0;2
14599;Vaduvos;KODĖLČIUKAI;5262165284;Ne;5;2;0;7
14600;Vaduvos;KODĖLČIUKAI;8603418399;Taip;15;0;0;15
14601;Vaduvos;KODĖLČIUKAI;3096104197;Ne;18;0;0;18
14602;Vaduvos;KODĖLČIUKAI;5761137540;Ne;2;0;0;2
14603;Vaduvos;KODĖLČIUKAI;9597857664;Ne;11;0;0;11
14604;Vaduvos;KODĖLČIUKAI;1054097622;Ne;0;2;0;2
14605;Vaduvos;KODĖLČIUKAI;6013737546;Ne;0;7;0;7
14606;Vaduvos;KODĖLČIUKAI;4789480822;Ne;7;4;0;11
14607;Vaduvos;KODĖLČIUKAI;3164402142;Ne;1;0;0;1
14608;Vaduvos;KODĖLČIUKAI;7904713344;Ne;5;4;0;9
14609;Vaduvos;KODĖLČIUKAI;8324927031;Ne;5;2;0;7
14610;Vaduvos;SMALSUČIAI;2184711783;Ne;0;3;0;3
14611;Vaduvos;SMALSUČIAI;3091707832;Ne;0;2;0;2
14612;Vaduvos;SMALSUČIAI;6462126837;Ne;0;4;0;4
14613;Vaduvos;SMALSUČIAI;6213672547;Ne;1;0;0;1
14614;Vaduvos;SMALSUČIAI;1265287458;Ne;1;2;0;3
14615;Vaduvos;SMALSUČIAI;3948025914;Ne;0;2;0;2
14616;Vaduvos;SMALSUČIAI;6253552951;Ne;4;0;0;4
14617;Vaduvos;SMALSUČIAI;7508333714;Ne;5;0;0;5
14618;Vaduvos;SMALSUČIAI;7789888994;Ne;18;0;0;18
14619;Vaduvos;SMALSUČIAI;6379952023;Ne;5;7;0;12
14620;Vaduvos;SMALSUČIAI;3680758366;Ne;0;1;0;1
14621;Vaduvos;SMALSUČIAI;9896249776;Ne;6;0;0;6
14622;Vaduvos;GILIUKAI;1277811729;Ne;14;0;0;14
14623;Vaduvos;GILIUKAI;1969325922;Taip;0;2;0;2
14624;Vaduvos;GILIUKAI;5376707663;Taip;3;0;0;3
14625;Vaduvos;GILIUKAI;6409466338;Taip;0;1;0;1
14626;Vaduvos;GILIUKAI;2835635250;Ne;6;0;0;6
14627;Vaduvos;GILIUKAI;2939561403;Ne;0;5;0;5
14628;Vaduvos;GILIUKAI;6514406042;Ne;3;1;0;4
14629;Vaduvos;GILIUKAI;3057729267;Ne;4;0;0;4
14630;Vaduvos;GILIUKAI;8580834401;Ne;0;1;0;1
14631;Vaduvos;GILIUKAI;9167796462;Ne;6;0;0;6
14632;Vaduvos;GILIUKAI;6276149710;Ne;12;1;0;13
14633;Vaduvos;GILIUKAI;6572776966;Ne;9;0;0;9
14634;Vaduvos;GILIUKAI;6676167440;Ne;7;0;0;7
14635;Vaduvos;GILIUKAI;2957685586;Taip;4;1;0;5
14636;Vaduvos;GILIUKAI;3540548094;Ne;2;0;0;2
14637;Vaduvos;GILIUKAI;8964194121;Ne;8;0;0;8
14638;Vaduvos;GILIUKAI;5297217576;Ne;6;2;0;8
14639;Vaduvos;GILIUKAI;5010914832;Ne;5;0;0;5
14640;Vaduvos;GILIUKAI;4030891958;Ne;10;0;0;10
14641;Vaduvos;GILIUKAI;7730737705;Ne;17;0;0;17
14642;Vaduvos;GILIUKAI;2011976336;Ne;5;0;0;5
14643;Vaduvos;GILIUKAI;5510687497;Ne;6;3;0;9
14644;Vaduvos;BORUŽĖLĖS;2277525837;Ne;0;1;0;1
14645;Vaduvos;BORUŽĖLĖS;6439773886;Ne;0;5;0;5
14646;Vaduvos;BORUŽĖLĖS;6593754016;Ne;10;3;0;13
14647;Vaduvos;BORUŽĖLĖS;7521846747;Ne;3;2;0;5
14648;Vaduvos;BORUŽĖLĖS;1422507884;Ne;3;1;0;4
14649;Vaduvos;BORUŽĖLĖS;3461756429;Ne;5;0;0;5
14650;Vaduvos;BORUŽĖLĖS;2417613291;Ne;7;0;0;7
14651;Vaduvos;BORUŽĖLĖS;5717064754;Ne;3;0;0;3
14652;Vaduvos;BORUŽĖLĖS;8064111922;Ne;9;0;0;9
14653;Vaduvos;BORUŽĖLĖS;2923920649;Ne;0;1;0;1
14654;Vaduvos;BORUŽĖLĖS;6552763746;Ne;3;0;0;3
14655;Vaduvos;BORUŽĖLĖS;3255011809;Ne;5;2;0;7
14656;Vaduvos;BORUŽĖLĖS;7169054113;Ne;0;1;0;1
14657;Vaduvos;BORUŽĖLĖS;2366843609;Ne;3;0;0;3
14658;Vaduvos;BORUŽĖLĖS;6991960029;Ne;4;1;0;5
14659;Vaduvos;BORUŽĖLĖS;3833382641;Ne;10;0;0;10
14660;Vaduvos;DRUGELIAI;4936598927;Ne;10;0;0;10
14661;Vaduvos;DRUGELIAI;9824469881;Ne;5;0;0;5
14662;Vaduvos;DRUGELIAI;5915272436;Ne;12;1;0;13
14663;Vaduvos;DRUGELIAI;4238942070;Ne;5;1;0;6
14664;Vaduvos;DRUGELIAI;1539465611;Ne;1;0;0;1
14665;Vaduvos;DRUGELIAI;8384302877;Ne;2;0;0;2
14666;Vaduvos;DRUGELIAI;6770559352;Taip;2;0;0;2
14667;Vaduvos;DRUGELIAI;4856601924;Ne;2;2;0;4
14668;Vaduvos;DRUGELIAI;3477273224;Ne;4;0;0;4
14669;Vaduvos;DRUGELIAI;2452309232;Taip;10;0;0;10
14670;Vaduvos;DRUGELIAI;6776150749;Ne;6;0;0;6
14671;Vaduvos;DRUGELIAI;4587836073;Ne;2;0;0;2
14672;Vaduvos;DRUGELIAI;9333495119;Ne;13;1;0;14
14673;Vaduvos;DRUGELIAI;7597268115;Ne;2;0;0;2
14674;Vaduvos;DRUGELIAI;8400344609;Ne;2;0;0;2
14675;Vaduvos;DRUGELIAI;2789503381;Ne;0;1;0;1
14676;Vaduvos;DRUGELIAI;1987969267;Ne;4;0;0;4
14677;Vaduvos;DRUGELIAI;8990472878;Ne;7;2;0;9
14678;Vaduvos;DRUGELIAI;2717887489;Ne;7;1;0;8
14679;Vaduvos;DRUGELIAI;5881009426;Taip;9;0;0;9
14680;Vaduvos;RIEŠUTĖLIAI;3855900628;Ne;6;0;0;6
14681;Vaduvos;RIEŠUTĖLIAI;8709781176;Ne;15;1;0;16
14682;Vaduvos;RIEŠUTĖLIAI;3690176756;Ne;9;3;0;12
14683;Vaduvos;RIEŠUTĖLIAI;5457850068;Taip;0;5;0;5
14684;Vaduvos;RIEŠUTĖLIAI;9420758132;Ne;0;2;0;2
14685;Vaduvos;RIEŠUTĖLIAI;5217573680;Ne;10;2;0;12
14686;Vaduvos;RIEŠUTĖLIAI;2838261867;Ne;5;0;0;5
14687;Vaduvos;RIEŠUTĖLIAI;3775261278;Ne;10;0;0;10
14688;Vaduvos;RIEŠUTĖLIAI;6228969089;Ne;9;2;0;11
14689;Vaduvos;RIEŠUTĖLIAI;6163392340;Ne;13;0;0;13
14690;Vaduvos;RIEŠUTĖLIAI;9508198734;Ne;13;0;0;13
14691;Vaduvos;RIEŠUTĖLIAI;1247907161;Ne;0;2;0;2
14692;Vaduvos;RIEŠUTĖLIAI;5012931485;Ne;14;0;0;14
14693;Vaduvos;RIEŠUTĖLIAI;2767613126;Ne;9;0;0;9
14694;Vaduvos;"1 klasė";4805607216;Ne;0;1;0;1
14695;Vaduvos;"1 klasė";4805607216;Ne;0;1;0;1
14696;Vaduvos;"1 klasė";72724196791;Ne;0;1;0;1
14697;Vaduvos;"1 klasė";8299189235;Ne;0;1;0;1
14698;Vaduvos;"1 klasė";5428067167;Taip;0;1;0;1
14699;Vaduvos;"1 klasė";7397068779;Ne;0;1;0;1
14700;Vaduvos;"1 klasė";5573145836;Ne;0;1;0;1
14701;Vaduvos;"1 klasė";7337663549;Ne;0;3;0;3
14702;Vaduvos;"2 klasė";3174998523;Taip;0;3;0;3
14703;Vaduvos;"2 klasė";4513707989;Ne;0;8;0;8
14704;Vaduvos;"2 klasė";3722349868;Ne;0;1;0;1
14705;Vaduvos;"2 klasė";13888236429;Ne;0;4;0;4
14706;Vaduvos;"2 klasė";22641388717;Ne;0;3;0;3
14707;Vaduvos;"2 klasė";46608435244;Ne;0;3;0;3
14708;Vaduvos;"2 klasė";5435336235;Ne;0;5;0;5
14709;Vaduvos;"2 klasė";56280470781;Ne;0;1;0;1
14710;Vaduvos;"2 klasė";6128582180;Ne;0;3;0;3
14711;Vaduvos;"2 klasė";11202010413;Ne;0;20;0;20
14712;Vaduvos;"2 klasė";1681367373;Ne;0;7;0;7
14713;Vaduvos;"2 klasė";1370696345;Ne;0;6;0;6
14714;Vaduvos;"4 klasė";96148085691;Taip;0;20;0;20
14715;Vaduvos;"4 klasė";32138087379;Ne;0;20;0;20
14716;Vaduvos;"4 klasė";17473821556;Ne;0;20;0;20
14717;Vaduvos;"4 klasė";53866301875;Ne;0;20;0;20
14718;Vaduvos;"4 klasė";1532675814;Ne;0;5;0;5
14719;Vaduvos;"4 klasė";98259624669;Ne;0;20;0;20
14720;Vaduvos;"4 klasė";36931517006;Ne;0;1;0;1
14721;Vaduvos;"4 klasė";61243424057;Ne;0;4;0;4
14722;Vaduvos;"4 klasė";78245732319;Ne;0;1;0;1
14723;Vaduvos;"4 klasė";48433447683;Ne;0;2;0;2
14724;Vaduvos;"4 klasė";85090873161;Taip;0;20;0;20
14725;Vaduvos;3A;6279678482;Ne;0;5;0;5
14726;Vaduvos;3A;62703428759;Ne;0;3;0;3
14727;Vaduvos;3A;19390879176;Ne;0;1;0;1
14728;Vaduvos;3A;1139509471;Ne;0;20;0;20
14729;Vaduvos;3A;1010061503;Ne;0;2;0;2
14730;Vaduvos;3A;1107557891;Ne;0;20;0;20
14731;Vaduvos;3B;40872193458;Ne;0;20;0;20
14732;Vaduvos;3B;6500567162;Ne;0;1;0;1
14733;Vaduvos;3B;78931952732;Ne;0;3;0;3
14734;Vaduvos;3B;1241148402;Ne;0;2;0;2
14735;Vaduvos;3B;64074141491;Ne;0;1;0;1
14736;Vaduvos;3B;93924290247;Ne;0;3;0;3
14737;Vaduvos;3B;62521006557;Ne;0;1;0;1
14738;Vaduvos;3B;16882774330;Ne;0;1;0;1
14739;Vaduvos;3B;87671358423;Ne;0;20;0;20
14740;Vilkpėdės;PASAKORIŲ;3129307975;Ne;6;0;0;6
14741;Vilkpėdės;PASAKORIŲ;1268568294;Ne;1;0;0;1
14742;Vilkpėdės;PASAKORIŲ;7918728030;Taip;9;0;0;9
14743;Vilkpėdės;PASAKORIŲ;8819707366;Ne;1;0;0;1
14744;Vilkpėdės;PASAKORIŲ;8261543050;Ne;7;0;0;7
14745;Vilkpėdės;PASAKORIŲ;2102814426;Ne;8;0;0;8
14746;Vilkpėdės;PASAKORIŲ;6877083798;Ne;5;0;0;5
14747;Vilkpėdės;PASAKORIŲ;7780157972;Ne;3;0;0;3
14748;Vilkpėdės;PASAKORIŲ;9892981462;Ne;4;0;0;4
14749;Vilkpėdės;PASAKORIŲ;7937515587;Ne;3;0;0;3
14750;Vilkpėdės;PASAKORIŲ;4625117662;Ne;1;0;0;1
14751;Vilkpėdės;PASAKORIŲ;3646631186;Ne;0;1;0;1
14752;Vilkpėdės;PASAKORIŲ;9350127172;Ne;10;0;0;10
14753;Vilkpėdės;MĮSLIUKŲ;7705509136;Ne;13;0;0;13
14754;Vilkpėdės;MĮSLIUKŲ;7370710652;Ne;9;1;0;10
14755;Vilkpėdės;MĮSLIUKŲ;2116411914;Taip;5;0;0;5
14756;Vilkpėdės;MĮSLIUKŲ;4314657343;Ne;5;0;0;5
14757;Vilkpėdės;MĮSLIUKŲ;7184242648;Ne;10;0;0;10
14758;Vilkpėdės;MĮSLIUKŲ;4904820034;Ne;4;0;0;4
14759;Vilkpėdės;MĮSLIUKŲ;2505859673;Ne;0;0;3;3
14760;Vilkpėdės;MĮSLIUKŲ;8907004805;Ne;3;0;0;3
14761;Vilkpėdės;MĮSLIUKŲ;9537458943;Ne;9;0;0;9
14762;Vilkpėdės;MĮSLIUKŲ;7334892130;Ne;8;0;0;8
14763;Vilkpėdės;MĮSLIUKŲ;5110059560;Taip;3;0;0;3
14764;Vilkpėdės;ŽINIUKŲ;4270461575;Ne;11;0;0;11
14765;Vilkpėdės;ŽINIUKŲ;4998396593;Ne;10;0;0;10
14766;Vilkpėdės;ŽINIUKŲ;6819447340;Ne;19;0;0;19
14767;Vilkpėdės;ŽINIUKŲ;1278300322;Ne;8;0;0;8
14768;Vilkpėdės;ŽINIUKŲ;9797550851;Ne;11;0;6;17
14769;Vilkpėdės;ŽINIUKŲ;1040357501;Ne;12;1;1;14
14770;Vilkpėdės;ŽINIUKŲ;6876470245;Ne;12;1;1;14
14771;Vilkpėdės;ŽINIUKŲ;8431620518;Ne;13;0;0;13
14772;Vilkpėdės;ŽINIUKŲ;1655396296;Ne;8;0;0;8
14773;Vilkpėdės;ŽINIUKŲ;2379571797;Ne;8;0;0;8
14774;Vilkpėdės;ŽINIUKŲ;2358685682;Ne;25;0;0;25
14775;Vilkpėdės;ŽINIUKŲ;5076206526;Ne;0;3;0;3
14776;Vilkpėdės;ŽINIUKŲ;3611416887;Ne;0;3;0;3
14777;Vilkpėdės;ŽINIUKŲ;7008659662;Ne;0;0;1;1
14778;Vilkpėdės;ŽINIUKŲ;9501254301;Ne;2;2;0;4
14779;Vilkpėdės;IŠMINČIŲ;8002436634;Taip;10;0;0;10
14780;Vilkpėdės;IŠMINČIŲ;1249504082;Ne;5;0;0;5
14781;Vilkpėdės;IŠMINČIŲ;4052026470;Ne;0;0;10;10
14782;Vilkpėdės;IŠMINČIŲ;5050493757;Ne;4;7;0;11
14783;Vilkpėdės;IŠMINČIŲ;8217972925;Ne;4;0;0;4
14784;Vilkpėdės;IŠMINČIŲ;5677284428;Ne;1;0;0;1
14785;Vilkpėdės;IŠMINČIŲ;2232913117;Taip;0;0;11;11
14786;Vilkpėdės;IŠMINČIŲ;7805866055;Ne;4;0;1;5
14787;Vilkpėdės;IŠMINČIŲ;3994451071;Ne;0;0;10;10
14788;Vilkpėdės;IŠMINČIŲ;4726171678;Taip;2;0;2;4
14789;Vilkpėdės;IŠMINČIŲ;2529188623;Ne;1;1;1;3
14790;Vilkpėdės;IŠMINČIŲ;7519472444;Ne;11;0;0;11
14791;Vilkpėdės;IŠMINČIŲ;9334610111;Ne;5;2;0;7
14792;Vilkpėdės;IŠMINČIŲ;6268525635;Ne;18;0;0;18
14793;Vilkpėdės;IŠMINČIŲ;3521289746;Ne;9;0;2;11
14794;Vilkpėdės;IŠMINČIŲ;4277073629;Ne;12;5;0;17
14795;Vilkpėdės;IŠMINČIŲ;7489143683;Ne;0;0;5;5
14796;Vilkpėdės;TYRINĖTOJŲ;6418829930;Ne;3;3;0;6
14797;Vilkpėdės;TYRINĖTOJŲ;1633942236;Ne;1;7;0;8
14798;Vilkpėdės;TYRINĖTOJŲ;7829343719;Taip;10;0;0;10
14799;Vilkpėdės;TYRINĖTOJŲ;8484873068;Ne;3;5;0;8
14800;Vilkpėdės;TYRINĖTOJŲ;2503128176;Taip;2;0;0;2
14801;Vilkpėdės;TYRINĖTOJŲ;9570469277;Taip;7;5;0;12
14802;Vilkpėdės;TYRINĖTOJŲ;5274855225;Ne;18;0;0;18
14803;Vilkpėdės;TYRINĖTOJŲ;8860791478;Ne;3;0;0;3
14804;Vilkpėdės;TYRINĖTOJŲ;5420512675;Taip;2;0;0;2
14805;Vilkpėdės;TYRINĖTOJŲ;8613778606;Ne;11;0;0;11
14806;Vilkpėdės;TYRINĖTOJŲ;7991758361;Ne;6;0;0;6
14807;Vilkpėdės;TYRINĖTOJŲ;2736318576;Taip;2;0;0;2
14808;Vilkpėdės;TYRINĖTOJŲ;6064336759;Ne;3;0;0;3
14809;Vilkpėdės;TYRINĖTOJŲ;5577199802;Ne;2;0;0;2
14810;Vilkpėdės;TYRINĖTOJŲ;8930504912;Ne;1;0;0;1
14811;Vilkpėdės;TYRINĖTOJŲ;3303872633;Ne;5;6;0;11
14812;Vilkpėdės;TYRINĖTOJŲ;5972405023;Taip;10;0;0;10
14813;Vilkpėdės;TYRINĖTOJŲ;4485811377;Ne;11;1;0;12
14814;Vilkpėdės;TYRINĖTOJŲ;9841831811;Ne;17;0;0;17
14815;Vilkpėdės;GUDRUOLIŲ;2525399410;Ne;0;0;2;2
14816;Vilkpėdės;GUDRUOLIŲ;1985540746;Ne;5;0;1;6
14817;Vilkpėdės;GUDRUOLIŲ;6198736925;Ne;2;0;0;2
14818;Vilkpėdės;GUDRUOLIŲ;2703704892;Ne;1;0;0;1
14819;Vilkpėdės;GUDRUOLIŲ;5812430367;Ne;7;0;0;7
14820;Vilkpėdės;GUDRUOLIŲ;1478022307;Ne;0;3;0;3
14821;Vilkpėdės;GUDRUOLIŲ;2205143759;Ne;1;0;2;3
14822;Vilkpėdės;GUDRUOLIŲ;4018140154;Ne;9;0;0;9
14823;Vilkpėdės;GUDRUOLIŲ;6598572049;Ne;0;0;1;1
14824;Vilkpėdės;GUDRUOLIŲ;2419661008;Ne;0;0;1;1
14825;Vilkpėdės;GUDRUOLIŲ;7931496783;Ne;1;0;0;1
14826;Vilkpėdės;GUDRUOLIŲ;2418313731;Ne;9;0;5;14
14827;Vilkpėdės;GUDRUOLIŲ;8385974099;Ne;0;6;0;6
14828;Vilkpėdės;GUDRUOLIŲ;4031175523;Ne;0;0;1;1
14829;Vilkpėdės;GUDRUOLIŲ;6671311193;Ne;0;0;2;2
14830;Vilkpėdės;GUDRUOLIŲ;7114183123;Ne;20;0;0;20
14831;Vilkpėdės;SMALSUOLIŲ;4095366279;Ne;0;1;0;1
14832;Vilkpėdės;SMALSUOLIŲ;1019057127;Ne;0;10;0;10
14833;Vilkpėdės;SMALSUOLIŲ;6522707709;Ne;9;5;0;14
14834;Vilkpėdės;SMALSUOLIŲ;1655985778;Ne;16;0;0;16
14835;Vilkpėdės;SMALSUOLIŲ;4311938034;Ne;5;0;0;5
14836;Vilkpėdės;SMALSUOLIŲ;3664125930;Ne;5;0;0;5
14837;Vilkpėdės;SMALSUOLIŲ;3350784810;Ne;0;8;0;8
14838;Vilkpėdės;SMALSUOLIŲ;5346798201;Ne;3;4;0;7
14839;Vilkpėdės;SMALSUOLIŲ;1396827668;Ne;10;0;0;10
14840;Vilkpėdės;SMALSUOLIŲ;5551822633;Ne;1;8;0;9
14841;Vilkpėdės;SMALSUOLIŲ;9544418642;Ne;0;0;11;11
14842;Vilkpėdės;SMALSUOLIŲ;3666145718;Ne;5;2;0;7
14843;Vilkpėdės;SMALSUOLIŲ;5633014328;Ne;0;1;0;1
14844;Vilkpėdės;SMALSUOLIŲ;3737265597;Ne;9;0;0;9
14845;Vilkpėdės;SMALSUOLIŲ;5422061533;Ne;2;0;0;2
14846;Vilkpėdės;SMALSUOLIŲ;7634076203;Ne;4;0;0;4
14847;Vilkpėdės;SMALSUOLIŲ;3720639726;Ne;0;10;0;10
14848;Vilkpėdės;SMALSUOLIŲ;2241104719;Ne;0;3;0;3
14849;Vilkpėdės;KODĖLČIŲ;9605430333;Ne;0;15;0;15
14850;Vilkpėdės;KODĖLČIŲ;8969001990;Taip;4;1;0;5
14851;Vilkpėdės;KODĖLČIŲ;7158737372;Ne;5;6;0;11
14852;Vilkpėdės;KODĖLČIŲ;3785308006;Ne;2;0;0;2
14853;Vilkpėdės;KODĖLČIŲ;6744834487;Ne;0;5;0;5
14854;Vilkpėdės;KODĖLČIŲ;4166416292;Ne;0;13;0;13
14855;Vilkpėdės;KODĖLČIŲ;7401886306;Ne;0;1;0;1
14856;Vilkpėdės;KODĖLČIŲ;7284081203;Ne;3;0;0;3
14857;Vilkpėdės;KODĖLČIŲ;6820236577;Ne;5;0;0;5
14858;Vilkpėdės;KODĖLČIŲ;4255757333;Ne;11;0;0;11
14859;Vilkpėdės;KODĖLČIŲ;5053032081;Ne;2;0;0;2
14860;Vilkpėdės;KODĖLČIŲ;6778288398;Ne;6;0;0;6
14861;Vilkpėdės;KODĖLČIŲ;1537270256;Ne;7;1;0;8
14862;Vilkpėdės;KODĖLČIŲ;3229559339;Ne;7;1;0;8
14863;Vilkpėdės;MOKSLINČIŲ;9294350205;Ne;0;1;0;1
14864;Vilkpėdės;MOKSLINČIŲ;5048931309;Ne;0;0;2;2
14865;Vilkpėdės;MOKSLINČIŲ;7698759895;Ne;0;6;0;6
14866;Vilkpėdės;MOKSLINČIŲ;1217929358;Ne;1;2;0;3
14867;Vilkpėdės;MOKSLINČIŲ;1807884737;Ne;5;0;0;5
14868;Vilkpėdės;MOKSLINČIŲ;2251274741;Ne;11;0;0;11
14869;Vilkpėdės;MOKSLINČIŲ;6816745585;Ne;5;0;0;5
14870;Vilkpėdės;MOKSLINČIŲ;9460356725;Ne;0;1;0;1
14871;Vilkpėdės;MOKSLINČIŲ;8128254701;Ne;0;3;0;3
14872;Vilkpėdės;MOKSLINČIŲ;7747013579;Ne;0;1;0;1
14873;Vilkpėdės;MOKSLINČIŲ;3987021185;Ne;3;1;0;4
14874;Vilkpėdės;MOKSLINČIŲ;7908813288;Ne;0;1;0;1
14875;Vilkpėdės;MOKSLINČIŲ;9795696242;Ne;1;0;2;3
14876;Vilkpėdės;MOKSLINČIŲ;6261547304;Ne;0;1;0;1
14877;Vilkpėdės;MOKSLINČIŲ;2420271759;Ne;5;6;0;11
14878;Vilkpėdės;MOKSLINČIŲ;3696611509;Ne;5;0;0;5
14879;Vilkpėdės;MOKSLINČIŲ;1063561954;Ne;0;1;1;2
14880;Vilkpėdės;MOKSLINČIŲ;8783790519;Ne;7;1;2;10
14881;Žiburėlis;Nykštukai;4109288891;Taip;16;1;0;17
14882;Žiburėlis;Nykštukai;7522040537;Ne;1;2;0;3
14883;Žiburėlis;Nykštukai;9526477121;Taip;8;1;0;9
14884;Žiburėlis;Nykštukai;4387021429;Ne;2;4;0;6
14885;Žiburėlis;Nykštukai;4910787530;Ne;0;9;0;9
14886;Žiburėlis;Nykštukai;9783567484;Ne;0;5;0;5
14887;Žiburėlis;Nykštukai;5324852807;Ne;3;0;0;3
14888;Žiburėlis;Nykštukai;4916545915;Ne;0;6;0;6
14889;Žiburėlis;Nykštukai;8133371774;Ne;0;16;0;16
14890;Žiburėlis;Nykštukai;7278242428;Ne;5;0;0;5
14891;Žiburėlis;Nykštukai;5732540560;Ne;0;6;0;6
14892;Žiburėlis;Nykštukai;1228806324;Taip;2;3;0;5
14893;Žiburėlis;Nykštukai;2163018032;Ne;0;11;0;11
14894;Žiburėlis;Nykštukai;4581800760;Ne;5;1;0;6
14895;Žiburėlis;Nykštukai;5002691930;Ne;0;1;0;1
14896;Žiburėlis;Nykštukai;8346571253;Ne;14;0;0;14
14897;Žiburėlis;Nykštukai;5098955523;Ne;0;6;0;6
14898;Žiburėlis;Nykštukai;5629404179;Ne;0;1;0;1
14899;Žiburėlis;Nykštukai;1190058462;Ne;0;1;0;1
14900;Žiburėlis;Nykštukai;7111530833;Ne;0;2;0;2
14901;Žiburėlis;"Žiniukai ";3687703187;Ne;0;1;0;1
14902;Žiburėlis;"Žiniukai ";7465939429;Taip;0;2;0;2
14903;Žiburėlis;"Žiniukai ";4710995351;Ne;0;2;0;2
14904;Žiburėlis;"Žiniukai ";1559091567;Ne;5;1;0;6
14905;Žiburėlis;"Žiniukai ";3750024153;Ne;5;2;0;7
14906;Žiburėlis;"Žiniukai ";7633450988;Taip;4;0;0;4
14907;Žiburėlis;"Žiniukai ";8480167191;Ne;11;0;0;11
14908;Žiburėlis;"Žiniukai ";2292895729;Ne;0;5;0;5
14909;Žiburėlis;"Žiniukai ";7163594513;Ne;3;0;0;3
14910;Žiburėlis;"Žiniukai ";5408766721;Ne;8;1;0;9
14911;Žiburėlis;"Žiniukai ";7862546963;Ne;0;1;0;1
14912;Žiburėlis;"Žiniukai ";8902837168;Ne;0;1;0;1
14913;Žiburėlis;"Žiniukai ";6696156248;Ne;4;0;0;4
14914;Žiburėlis;"Žiniukai ";3938379566;Ne;0;2;0;2
14915;Žiburėlis;"Žiniukai ";5174211773;Ne;0;1;0;1
14916;Žiburėlis;"Žiniukai ";9818415192;Ne;5;0;0;5
14917;Žiburėlis;"Smalsiukai ";5438697081;Taip;2;0;0;2
14918;Žiburėlis;"Smalsiukai ";3936418539;Ne;4;1;0;5
14919;Žiburėlis;"Smalsiukai ";2072972990;Ne;15;0;0;15
14920;Žiburėlis;"Smalsiukai ";3835820013;Taip;5;2;0;7
14921;Žiburėlis;"Smalsiukai ";8875517201;Ne;4;0;0;4
14922;Žiburėlis;"Smalsiukai ";8065557477;Ne;2;0;0;2
14923;Žiburėlis;"Smalsiukai ";1843213137;Ne;2;0;0;2
14924;Žiburėlis;"Smalsiukai ";7402647048;Ne;3;6;0;9
14925;Žiburėlis;"Smalsiukai ";2491972986;Ne;0;5;0;5
14926;Žiburėlis;"Smalsiukai ";8973307069;Ne;2;0;0;2
14927;Žiburėlis;"Smalsiukai ";8970153523;Ne;1;0;0;1
14928;Žiburėlis;"Smalsiukai ";5145195661;Ne;2;0;0;2
14929;Žiburėlis;"Smalsiukai ";8018718405;Ne;4;2;0;6
14930;Žiburėlis;"Giliukai ";1090883494;Ne;7;0;0;7
14931;Žiburėlis;"Giliukai ";9215654134;Taip;0;1;0;1
14932;Žiburėlis;"Giliukai ";6918525245;Ne;1;1;0;2
14933;Žiburėlis;"Giliukai ";6946621147;Ne;0;2;0;2
14934;Žiburėlis;"Giliukai ";4091901597;Ne;5;0;0;5
14935;Žiburėlis;"Giliukai ";3776569251;Ne;2;0;0;2
14936;Žiburėlis;"Giliukai ";9494271740;Ne;2;0;0;2
14937;Žiburėlis;"Giliukai ";8440073413;Ne;11;0;0;11
14938;Žiburėlis;"Giliukai ";6121237159;Ne;11;0;0;11
14939;Žiburėlis;"Giliukai ";7977098545;Ne;4;0;0;4
14940;Žiburėlis;Meškiukai;3593851196;Ne;0;0;7;7
14941;Žiburėlis;Meškiukai;9470154520;Ne;0;1;2;3
14942;Žiburėlis;Meškiukai;2285666668;Ne;3;0;0;3
14943;Žiburėlis;Meškiukai;2836519241;Ne;5;0;0;5
14944;Žiburėlis;Meškiukai;2186032732;Ne;0;1;0;1
14945;Žiburėlis;Meškiukai;2254407798;Ne;6;0;0;6
14946;Žiburėlis;Meškiukai;4887304311;Ne;0;0;3;3
14947;Žiburėlis;Meškiukai;1651713696;Ne;1;0;0;1
14948;Žiburėlis;Meškiukai;1105220246;Taip;0;1;1;2
14949;Žiburėlis;Meškiukai;8415647388;Ne;0;2;0;2
14950;Žiburėlis;Meškiukai;2371990135;Ne;0;0;1;1
14951;Žiburėlis;Meškiukai;8883542394;Ne;1;1;0;2
14952;Žiburėlis;Meškiukai;6218255066;Ne;2;0;0;2
14953;Žiburėlis;Meškiukai;3522480911;Taip;5;1;2;8
14954;Žiburėlis;Meškiukai;1606332622;Taip;5;1;1;7
14955;Žiburėlis;Meškiukai;1758251348;Ne;0;2;0;2
14956;Žiburėlis;Meškiukai;8284913889;Ne;9;0;2;11
14957;Žiburėlis;Meškiukai;2851350451;Taip;1;1;0;2
14958;Žiburėlis;Meškiukai;6206770019;Ne;6;9;0;15
14959;Žiburėlis;Viščiukai;2720743003;Taip;2;0;0;2
14960;Žiburėlis;Viščiukai;5059109680;Ne;1;0;0;1
14961;Žiburėlis;Viščiukai;7426295852;Ne;0;2;0;2
14962;Žiburėlis;Viščiukai;3069436943;Ne;14;0;0;14
14963;Žiburėlis;Viščiukai;1507346142;Ne;17;0;0;17
14964;Žiburėlis;Viščiukai;4066875778;Ne;1;0;0;1
14965;Žiburėlis;Viščiukai;9369610274;Ne;0;5;0;5
14966;Žiburėlis;Viščiukai;9009869114;Ne;4;0;0;4
14967;Žiburėlis;Viščiukai;1839099729;Ne;1;0;0;1
14968;Žiburėlis;Viščiukai;2382486049;Ne;14;0;0;14
14969;Žiburėlis;Viščiukai;6856548398;Ne;0;1;0;1
14970;Žiburėlis;Viščiukai;5490536675;Ne;2;0;0;2
14971;Žiburėlis;Viščiukai;6145211660;Ne;5;0;0;5
14972;Žiburėlis;"Drambliukai ";5115160061;Taip;29;0;0;29
14973;Žiburėlis;"Drambliukai ";7364102991;Taip;5;1;0;6
14974;Žiburėlis;"Drambliukai ";8179414341;Ne;3;0;0;3
14975;Žiburėlis;"Drambliukai ";3323538690;Ne;5;0;0;5
14976;Žiburėlis;"Drambliukai ";8603154782;Ne;2;0;0;2
14977;Žiburėlis;"Drambliukai ";5213049603;Ne;14;0;0;14
14978;Žiburėlis;"Drambliukai ";6750601280;Taip;5;3;0;8
14979;Žiburėlis;"Drambliukai ";9048781241;Ne;6;7;0;13
14980;Žiburėlis;"Drambliukai ";6126086504;Ne;5;6;0;11
14981;Žiburėlis;"Drambliukai ";7687475882;Ne;6;1;0;7
14982;Žiburėlis;"Drambliukai ";5254196326;Ne;5;0;0;5
14983;Žiburėlis;"Drambliukai ";8444514098;Ne;18;0;0;18
14984;Žiburėlis;"Drambliukai ";4459356832;Ne;0;5;0;5
14985;Žiburėlis;"Drambliukai ";5579727416;Ne;5;0;0;5
14986;Žiburėlis;"Drambliukai ";1449541244;Taip;7;10;0;17
14987;Žiburėlis;"Drambliukai ";2472729022;Ne;11;6;0;17
14988;Žiburėlis;BORUŽIUKAI;3723613593;Ne;11;0;0;11
14989;Žiburėlis;BORUŽIUKAI;9964255985;Ne;5;1;0;6
14990;Žiburėlis;BORUŽIUKAI;7895148630;Taip;14;0;0;14
14991;Žiburėlis;BORUŽIUKAI;8936912406;Ne;0;1;0;1
14992;Žiburėlis;BORUŽIUKAI;4631232618;Ne;15;0;0;15
14993;Žiburėlis;BORUŽIUKAI;5793531526;Ne;0;2;0;2
14994;Žiburėlis;BORUŽIUKAI;4578828135;Ne;0;1;0;1
14995;Žiburėlis;BORUŽIUKAI;6128571259;Taip;2;13;0;15
14996;Žiburėlis;BORUŽIUKAI;3760039280;Ne;2;1;0;3
14997;Žiburėlis;BORUŽIUKAI;5799439634;Ne;2;0;0;2
14998;Žiburėlis;BORUŽIUKAI;8373944614;Ne;9;0;0;9
14999;Žiburėlis;BORUŽIUKAI;9256751455;Ne;6;0;0;6
15000;Žiburėlis;BORUŽIUKAI;2077823704;Ne;6;0;0;6
15001;Žiburėlis;BORUŽIUKAI;9357376188;Ne;5;0;0;5
15002;Žiburėlis;BORUŽIUKAI;7017574924;Ne;10;0;0;10
15003;Žiburėlis;BORUŽIUKAI;2527837980;Ne;12;0;0;12
15004;Žiburėlis;BORUŽIUKAI;9771442035;Taip;0;2;0;2
15005;Žiburėlis;SPINDULIUKAI;2995697464;Ne;9;0;0;9
15006;Žiburėlis;SPINDULIUKAI;7856708616;Ne;0;20;0;20
15007;Žiburėlis;SPINDULIUKAI;5205959106;Ne;10;1;0;11
15008;Žiburėlis;SPINDULIUKAI;2808361570;Taip;3;2;0;5
15009;Žiburėlis;SPINDULIUKAI;5881242405;Ne;0;2;0;2
15010;Žiburėlis;SPINDULIUKAI;2131951626;Ne;0;1;0;1
15011;Žiburėlis;SPINDULIUKAI;3253759256;Taip;10;2;0;12
15012;Žiburėlis;SPINDULIUKAI;6969335298;Ne;5;0;0;5
15013;Žiburėlis;SPINDULIUKAI;5835919483;Ne;3;2;0;5
15014;Žiburėlis;SPINDULIUKAI;4738991020;Ne;10;0;0;10
15015;Žiburėlis;SPINDULIUKAI;6080914975;Ne;5;2;0;7
15016;Žiburėlis;SPINDULIUKAI;9325991773;Ne;1;0;0;1
15017;Žiburėlis;SPINDULIUKAI;6674351628;Taip;10;0;0;10
15018;Žiburėlis;SPINDULIUKAI;5075522632;Ne;0;3;0;3
15019;Žiburėlis;SPINDULIUKAI;1908345602;Ne;11;0;0;11
15020;Žiburėlis;SPINDULIUKAI;8140848665;Ne;15;0;0;15
15021;Žiburėlis;SPINDULIUKAI;4727673956;Ne;0;1;0;1
15022;Žiburėlis;SPINDULIUKAI;7140031765;Taip;6;0;0;6
15023;Žiburėlis;KIŠKUČIAI;6492467281;Ne;0;0;1;1
15024;Žiburėlis;KIŠKUČIAI;3352845095;Ne;5;0;0;5
15025;Žiburėlis;KIŠKUČIAI;1004953300;Taip;3;0;0;3
15026;Žiburėlis;KIŠKUČIAI;3296994981;Ne;0;4;0;4
15027;Žiburėlis;KIŠKUČIAI;5418413225;Ne;0;6;0;6
15028;Žiburėlis;KIŠKUČIAI;6044837042;Taip;0;0;1;1
15029;Žiburėlis;KIŠKUČIAI;1334695206;Ne;7;0;3;10
15030;Žiburėlis;KIŠKUČIAI;7597762608;Ne;0;2;0;2
15031;Žiburėlis;KIŠKUČIAI;6562748977;Ne;6;0;1;7
15032;Žiburėlis;KIŠKUČIAI;4477396434;Ne;0;2;2;4
15033;Žiburėlis;KIŠKUČIAI;2712358146;Ne;1;0;0;1
15034;Žiburėlis;KIŠKUČIAI;5410394172;Ne;0;7;1;8
15035;Žiburėlis;KIŠKUČIAI;4003368130;Ne;17;0;0;17
15036;Žiburėlis;KIŠKUČIAI;1868558773;Taip;1;2;0;3
15037;Žiburėlis;KIŠKUČIAI;9731661697;Taip;5;0;0;5
15038;Žiburėlis;DRUGELIAI;9551175579;Ne;2;0;0;2
15039;Žiburėlis;DRUGELIAI;2872122574;Ne;20;0;0;20
15040;Žiburėlis;DRUGELIAI;5422660783;Ne;10;3;0;13
15041;Žiburėlis;DRUGELIAI;5758539955;Ne;8;0;0;8
15042;Žiburėlis;DRUGELIAI;3780842203;Taip;6;1;0;7
15043;Žiburėlis;DRUGELIAI;6751043071;Ne;11;0;0;11
15044;Žiburėlis;DRUGELIAI;8082088504;Taip;0;1;0;1
15045;Žiburėlis;DRUGELIAI;5025452484;Taip;0;7;0;7
15046;Žiburėlis;DRUGELIAI;5724506894;Ne;5;0;0;5
15047;Žiburėlis;DRUGELIAI;8207315673;Taip;3;0;0;3
15048;Žiburėlis;DRUGELIAI;4656467260;Ne;4;0;0;4
15049;Žiburėlis;DRUGELIAI;9344950711;Taip;10;2;0;12
15050;Žiburėlis;DRUGELIAI;2102574423;Ne;2;0;0;2
15051;Žiburėlis;DRUGELIAI;6274583813;Ne;0;1;0;1
15052;Žiburėlis;DRUGELIAI;5194593598;Taip;0;1;0;1
15053;Žiburėlis;DRUGELIAI;2383554216;Ne;5;1;0;6
15054;Žiburėlis;DRUGELIAI;9041469393;Taip;4;1;0;5
15055;Žiburėlis;DRUGELIAI;8285987095;Ne;8;3;0;11
15056;Žiburėlis;DRUGELIAI;8752098051;Ne;6;0;0;6
15057;Žiburėlis;DRUGELIAI;4937518207;Ne;8;0;0;8
15058;Žiburėlis;DRUGELIAI;2805244671;Ne;5;1;0;6
15059;Bangelė;Aštuonkojai;6216334243;Ne;0;2;0;2
15060;Bangelė;Aštuonkojai;8406002339;Ne;5;0;1;6
15061;Bangelė;Aštuonkojai;8385661612;Ne;11;0;0;11
15062;Bangelė;Aštuonkojai;7434358474;Ne;5;12;0;17
15063;Bangelė;Aštuonkojai;6978215876;Ne;6;0;6;12
15064;Bangelė;Aštuonkojai;9801978617;Ne;5;0;0;5
15065;Bangelė;Aštuonkojai;7107685761;Ne;0;0;1;1
15066;Bangelė;Aštuonkojai;5994720767;Ne;8;3;0;11
15067;Bangelė;Aštuonkojai;4532810332;Ne;0;12;0;12
15068;Bangelė;Aštuonkojai;4036461205;Ne;0;1;0;1
15069;Bangelė;Aštuonkojai;3344441441;Ne;10;0;0;10
15070;Bangelė;Aštuonkojai;2858929915;Ne;4;0;0;4
15071;Bangelė;Aštuonkojai;7068305612;Ne;13;0;0;13
15072;Bangelė;Aštuonkojai;8943721679;Ne;5;0;0;5
15073;Bangelė;Delfinukai,;9142460659;Ne;5;0;0;5
15074;Bangelė;Delfinukai,;6566277472;Ne;0;0;4;4
15075;Bangelė;Delfinukai,;7362196984;Ne;6;0;2;8
15076;Bangelė;Delfinukai,;4317054990;Ne;0;1;1;2
15077;Bangelė;Delfinukai,;4712616315;Ne;4;1;0;5
15078;Bangelė;Delfinukai,;4940247006;Ne;20;0;0;20
15079;Bangelė;Delfinukai,;8335931279;Ne;0;7;0;7
15080;Bangelė;Delfinukai,;9311379746;Ne;0;10;0;10
15081;Bangelė;Delfinukai,;5980274157;Ne;0;1;0;1
15082;Bangelė;Delfinukai,;4851593235;Ne;0;10;0;10
15083;Bangelė;Delfinukai,;8998648968;Ne;5;0;0;5
15084;Bangelė;Delfinukai,;7016039389;Ne;0;1;0;1
15085;Bangelė;Delfinukai,;2127734178;Ne;6;0;0;6
15086;Bangelė;Delfinukai,;2107766301;Ne;20;0;0;20
15087;Bangelė;Delfinukai,;5237434283;Ne;6;0;0;6
15088;Bangelė;"Saulės spindulėliai";9488932192;Ne;0;0;2;2
15089;Bangelė;"Saulės spindulėliai";1754002501;Ne;0;1;0;1
15090;Bangelė;"Saulės spindulėliai";6953698592;Ne;0;1;0;1
15091;Bangelė;"Saulės spindulėliai";3063439996;Ne;0;5;0;5
15092;Bangelė;"Saulės spindulėliai";6026399355;Ne;0;7;0;7
15093;Bangelė;"Saulės spindulėliai";9143945953;Ne;0;1;1;2
15094;Bangelė;"Saulės spindulėliai";3022508446;Ne;0;0;2;2
15095;Bangelė;"Saulės spindulėliai";5476753511;Ne;0;0;2;2
15096;Bangelė;"Saulės spindulėliai";5546256869;Ne;0;1;0;1
15097;Bangelė;"Saulės spindulėliai";6980232224;Ne;0;2;0;2
15098;Bangelė;"Saulės spindulėliai";1390623903;Ne;0;5;0;5
15099;Bangelė;"Saulės spindulėliai";9788923823;Ne;0;14;3;17
15100;Bangelė;"Saulės spindulėliai";7136625230;Ne;0;3;0;3
15101;Bangelė;"Saulės spindulėliai";9168310196;Ne;0;5;0;5
15102;Bangelė;"Saulės spindulėliai";9790680407;Taip;5;0;1;6
15103;Bangelė;"Pingvinukai ";2405364948;Ne;11;0;0;11
15104;Bangelė;"Pingvinukai ";8959248662;Ne;0;0;1;1
15105;Bangelė;"Pingvinukai ";5054826517;Ne;6;0;3;9
15106;Bangelė;"Pingvinukai ";8943497040;Ne;3;3;0;6
15107;Bangelė;"Pingvinukai ";8297403610;Ne;10;0;3;13
15108;Bangelė;"Pingvinukai ";2023033514;Ne;20;0;0;20
15109;Bangelė;"Pingvinukai ";3351519357;Ne;7;0;0;7
15110;Bangelė;"Pingvinukai ";7794085741;Ne;0;5;0;5
15111;Bangelė;"Pingvinukai ";8372151959;Ne;5;0;4;9
15112;Bangelė;"Pingvinukai ";2279517392;Ne;5;0;1;6
15113;Bangelė;"Pingvinukai ";9740713810;Ne;10;0;0;10
15114;Bangelė;"Pingvinukai ";5829865386;Ne;0;0;2;2
15115;Bangelė;"Pingvinukai ";1591647267;Ne;0;0;1;1
15116;Bangelė;"Pingvinukai ";7808569484;Ne;0;5;0;5
15117;Bangelė;"Pingvinukai ";2362345363;Ne;3;0;1;4
15118;Bangelė;"Jūros žvaigždutės ";9447145378;Ne;0;0;2;2
15119;Bangelė;"Jūros žvaigždutės ";8745595583;Ne;7;0;0;7
15120;Bangelė;"Jūros žvaigždutės ";6174617493;Ne;4;3;0;7
15121;Bangelė;"Jūros žvaigždutės ";8075810032;Ne;0;4;0;4
15122;Bangelė;"Jūros žvaigždutės ";2624013880;Ne;9;0;1;10
15123;Bangelė;"Jūros žvaigždutės ";6397805392;Ne;10;3;0;13
15124;Bangelė;"Jūros žvaigždutės ";5961647252;Ne;5;0;0;5
15125;Bangelė;"Jūros žvaigždutės ";3851738513;Ne;10;0;0;10
15126;Bangelė;"Jūros žvaigždutės ";4891131242;Ne;0;0;1;1
15127;Bangelė;"Jūros žvaigždutės ";8931569423;Ne;2;1;2;5
15128;Bangelė;"Jūros žvaigždutės ";7364368699;Ne;0;2;0;2
15129;Bangelė;"Jūros žvaigždutės ";4480762963;Ne;6;0;2;8
15130;Bangelė;"Jūros žvaigždutės ";5370269001;Ne;5;5;0;10
15131;Bangelė;Žuvytės;7174742281;Ne;8;5;0;13
15132;Bangelė;Žuvytės;6806911810;Ne;9;2;0;11
15133;Bangelė;Žuvytės;6548270099;Ne;9;0;0;9
15134;Bangelė;Žuvytės;7074211876;Ne;0;0;2;2
15135;Bangelė;Žuvytės;4086446380;Ne;5;1;0;6
15136;Bangelė;Žuvytės;9268294844;Ne;0;0;2;2
15137;Bangelė;Žuvytės;3069288815;Ne;6;0;0;6
15138;Bangelė;Žuvytės;9633372201;Ne;6;0;0;6
15139;Bangelė;Žuvytės;9729929020;Ne;7;0;0;7
15140;Bangelė;Žuvytės;8563674709;Ne;15;0;0;15
15141;Bangelė;Žuvytės;5673493708;Ne;10;2;0;12
15142;Bangelė;Žuvytės;3500097405;Taip;19;0;0;19
15143;Bangelė;Žuvytės;3744789873;Ne;3;0;0;3
15144;Bangelė;Žuvytės;3016778137;Taip;0;1;0;1
15145;Bangelė;Žuvytės;1898671487;Ne;0;4;0;4
15146;Bangelė;Ruoniai;8758933649;Ne;0;0;1;1
15147;Bangelė;Ruoniai;8702632542;Ne;0;5;0;5
15148;Bangelė;Ruoniai;6480681705;Ne;0;1;0;1
15149;Bangelė;Ruoniai;7142694888;Ne;0;6;0;6
15150;Bangelė;Ruoniai;1895213200;Ne;0;0;1;1
15151;Bangelė;Ruoniai;9765268154;Ne;0;6;0;6
15152;Bangelė;Ruoniai;8495423628;Ne;7;0;0;7
15153;Bangelė;Ruoniai;7419016784;Ne;0;1;1;2
15154;Bangelė;Ruoniai;5190563034;Ne;6;0;0;6
15155;Bangelė;Ruoniai;9954762483;Ne;0;6;0;6
15156;Bangelė;Ruoniai;9493465898;Ne;8;0;0;8
15157;Bangelė;Ruoniai;5597329949;Ne;9;1;0;10
15158;Bangelė;Ruoniai;2134225414;Ne;0;0;2;2
15159;Bangelė;Ruoniai;4494049529;Ne;5;0;1;6
15160;Bangelė;Ruoniai;3334029244;Ne;0;0;2;2
15161;Bangelė;Ruoniai;6496580354;Ne;0;11;0;11
15162;Bangelė;"Pagrandukai ";9355348960;Ne;5;0;0;5
15163;Bangelė;"Pagrandukai ";1467390411;Ne;5;0;0;5
15164;Bangelė;"Pagrandukai ";7432980844;Ne;3;0;0;3
15165;Bangelė;"Pagrandukai ";2011446859;Ne;13;0;0;13
15166;Bangelė;"Pagrandukai ";8880874539;Ne;13;0;0;13
15167;Bangelė;"Pagrandukai ";7729373603;Ne;13;0;2;15
15168;Bangelė;"Pagrandukai ";5237637695;Ne;12;0;0;12
15169;Bangelė;"Pagrandukai ";7138947462;Ne;12;0;0;12
15170;Bangelė;"Pagrandukai ";2535189316;Ne;8;2;0;10
15171;Bangelė;"Pagrandukai ";9430653481;Ne;10;0;1;11
15172;Bangelė;"Pagrandukai ";4558724094;Taip;12;0;0;12
15173;Bangelė;"Zuikučiai ";4611715232;Ne;19;0;0;19
15174;Bangelė;"Zuikučiai ";6925192867;Ne;5;0;0;5
15175;Bangelė;"Zuikučiai ";3994276744;Ne;7;0;0;7
15176;Bangelė;"Zuikučiai ";3059847953;Ne;10;5;0;15
15177;Bangelė;"Zuikučiai ";5909385625;Ne;19;0;0;19
15178;Bangelė;"Zuikučiai ";4401415720;Ne;5;0;0;5
15179;Bangelė;"Zuikučiai ";9841829359;Ne;0;1;0;1
15180;Bangelė;"Zuikučiai ";8836768508;Ne;0;1;0;1
15181;Bangelė;"Zuikučiai ";6100558953;Ne;10;1;0;11
15182;Bangelė;Vėžliukai;4037426263;Ne;10;2;0;12
15183;Bangelė;Vėžliukai;7862345122;Ne;0;6;0;6
15184;Bangelė;Vėžliukai;2630571748;Ne;5;3;0;8
15185;Bangelė;Vėžliukai;6003859569;Ne;5;0;0;5
15186;Bangelė;Vėžliukai;3978683237;Ne;0;0;4;4
15187;Bangelė;Vėžliukai;5779198855;Ne;0;1;0;1
15188;Bangelė;Vėžliukai;5746189515;Ne;0;8;0;8
15189;Bangelė;Vėžliukai;8454369872;Taip;0;2;0;2
15190;Bangelė;Vėžliukai;9561221619;Ne;0;2;0;2
15191;Bangelė;Vėžliukai;1182624046;Ne;0;8;0;8
15192;Bangelė;Vėžliukai;5625257865;Ne;5;0;2;7
15193;Bangelė;Vėžliukai;9010238689;Taip;5;1;0;6
15194;Bangelė;Vėžliukai;9128326823;Ne;3;2;1;6
15195;Bangelė;Vėžliukai;6415607960;Taip;15;2;0;17
15196;Bangelė;Vėžliukai;2301343701;Ne;2;4;0;6
15197;Bangelė;Vėžliukai;6506241123;Taip;15;0;1;16
15198;Bangelė;Vėžliukai;8950435528;Ne;0;1;0;1
15199;Gėlynas;PAKALNUTĖ;4557380282;Ne;16;0;0;16
15200;Gėlynas;PAKALNUTĖ;6884111634;Ne;4;0;0;4
15201;Gėlynas;PAKALNUTĖ;1548317086;Ne;1;0;0;1
15202;Gėlynas;PAKALNUTĖ;3470963396;Ne;5;0;0;5
15203;Gėlynas;PAKALNUTĖ;6053841081;Ne;1;0;0;1
15204;Gėlynas;PAKALNUTĖ;2171064300;Ne;1;0;0;1
15205;Gėlynas;PAKALNUTĖ;2404562144;Ne;0;4;0;4
15206;Gėlynas;PAKALNUTĖ;7504469409;Ne;4;4;0;8
15207;Gėlynas;PAKALNUTĖ;4366442459;Ne;10;0;0;10
15208;Gėlynas;PAKALNUTĖ;1463783538;Taip;3;0;0;3
15209;Gėlynas;PAKALNUTĖ;7064068912;Ne;10;0;0;10
15210;Gėlynas;PAKALNUTĖ;1822933936;Ne;7;0;0;7
15211;Gėlynas;PAKALNUTĖ;4668195919;Ne;9;0;0;9
15212;Gėlynas;PAKALNUTĖ;8555408466;Ne;5;4;0;9
15213;Gėlynas;PAKALNUTĖ;2377323648;Taip;1;0;0;1
15214;Gėlynas;PAKALNUTĖ;5382148888;Ne;5;0;0;5
15215;Gėlynas;PAKALNUTĖ;6296728638;Ne;2;0;0;2
15216;Gėlynas;PAKALNUTĖ;5826067446;Ne;8;0;0;8
15217;Gėlynas;PAKALNUTĖ;2273705177;Taip;10;0;0;10
15218;Gėlynas;PAKALNUTĖ;5350834071;Ne;5;0;0;5
15219;Gėlynas;PAKALNUTĖ;2520140743;Taip;3;0;0;3
15220;Gėlynas;PAKALNUTĖ;6244314445;Ne;5;0;0;5
15221;Gėlynas;PAKALNUTĖ;9707677931;Ne;1;0;0;1
15222;Gėlynas;VARPELIS;1505666690;Ne;6;0;0;6
15223;Gėlynas;VARPELIS;9330385153;Ne;3;0;0;3
15224;Gėlynas;VARPELIS;9724668402;Ne;6;0;0;6
15225;Gėlynas;VARPELIS;2742456983;Ne;5;1;0;6
15226;Gėlynas;VARPELIS;2784709117;Ne;7;0;1;8
15227;Gėlynas;VARPELIS;3606076029;Ne;0;6;0;6
15228;Gėlynas;VARPELIS;5320531856;Ne;5;0;0;5
15229;Gėlynas;VARPELIS;7730322729;Ne;0;6;0;6
15230;Gėlynas;VARPELIS;4505012978;Ne;0;0;1;1
15231;Gėlynas;VARPELIS;5634213306;Ne;2;0;1;3
15232;Gėlynas;VARPELIS;9508507084;Ne;0;0;1;1
15233;Gėlynas;VARPELIS;2348787949;Ne;5;0;0;5
15234;Gėlynas;VARPELIS;5541707540;Taip;0;0;1;1
15235;Gėlynas;VARPELIS;5124029118;Ne;1;0;0;1
15236;Gėlynas;VARPELIS;8615943743;Ne;0;2;0;2
15237;Gėlynas;VARPELIS;8458276300;Ne;5;0;0;5
15238;Gėlynas;VARPELIS;8999346908;Ne;4;1;0;5
15239;Gėlynas;VARPELIS;3491517766;Ne;14;0;0;14
15240;Gėlynas;RAKTAŽOLĖ;7389502638;Ne;0;1;0;1
15241;Gėlynas;RAKTAŽOLĖ;1590299264;Ne;6;0;0;6
15242;Gėlynas;RAKTAŽOLĖ;5751256561;Ne;20;0;0;20
15243;Gėlynas;RAKTAŽOLĖ;8080660097;Ne;2;0;0;2
15244;Gėlynas;RAKTAŽOLĖ;1015554617;Ne;4;0;0;4
15245;Gėlynas;RAKTAŽOLĖ;6875794958;Ne;2;0;0;2
15246;Gėlynas;RAKTAŽOLĖ;3492361041;Ne;11;0;0;11
15247;Gėlynas;RAKTAŽOLĖ;6451922757;Ne;5;0;0;5
15248;Gėlynas;RAKTAŽOLĖ;2141722631;Ne;5;0;0;5
15249;Gėlynas;RAKTAŽOLĖ;7150367866;Ne;2;0;0;2
15250;Gėlynas;RAKTAŽOLĖ;4983822000;Ne;1;0;0;1
15251;Gėlynas;RAKTAŽOLĖ;9462822190;Ne;6;0;0;6
15252;Gėlynas;RAKTAŽOLĖ;3549079170;Ne;7;0;0;7
15253;Gėlynas;RAKTAŽOLĖ;5964419627;Taip;2;0;0;2
15254;Gėlynas;RAKTAŽOLĖ;4824667762;Ne;1;0;0;1
15255;Gėlynas;RAKTAŽOLĖ;7998013477;Ne;6;0;0;6
15256;Gėlynas;RAKTAŽOLĖ;8447789767;Ne;1;1;0;2
15257;Gėlynas;RAKTAŽOLĖ;9305282699;Ne;1;0;0;1
15258;Gėlynas;RAKTAŽOLĖ;1235384604;Ne;5;0;0;5
15259;Gėlynas;RAKTAŽOLĖ;8693415786;Ne;7;0;0;7
15260;Gėlynas;RAKTAŽOLĖ;2800420481;Ne;1;0;0;1
15261;Gėlynas;RAKTAŽOLĖ;8444505017;Ne;1;0;0;1
15262;Gėlynas;SAULĖGRĄŽA;3746597878;Ne;0;5;0;5
15263;Gėlynas;SAULĖGRĄŽA;1862266440;Ne;7;0;0;7
15264;Gėlynas;SAULĖGRĄŽA;4292724541;Ne;1;0;0;1
15265;Gėlynas;SAULĖGRĄŽA;2790269385;Ne;0;0;3;3
15266;Gėlynas;SAULĖGRĄŽA;9552677108;Ne;3;3;0;6
15267;Gėlynas;SAULĖGRĄŽA;2608369575;Ne;3;3;0;6
15268;Gėlynas;SAULĖGRĄŽA;1949260962;Ne;9;0;0;9
15269;Gėlynas;SAULĖGRĄŽA;5942466822;Ne;6;0;0;6
15270;Gėlynas;SAULĖGRĄŽA;2193861056;Taip;5;0;3;8
15271;Gėlynas;SAULĖGRĄŽA;9230984365;Ne;0;0;1;1
15272;Gėlynas;SAULĖGRĄŽA;6221721945;Ne;12;0;0;12
15273;Gėlynas;SAULĖGRĄŽA;6790040590;Taip;4;0;0;4
15274;Gėlynas;SAULĖGRĄŽA;4854709904;Taip;0;0;9;9
15275;Gėlynas;SAULĖGRĄŽA;1665668966;Ne;0;0;2;2
15276;Gėlynas;SAULĖGRĄŽA;1570975863;Ne;14;0;0;14
15277;Gėlynas;SAULĖGRĄŽA;9302757372;Ne;0;19;0;19
15278;Gėlynas;SAULĖGRĄŽA;6342888072;Ne;0;5;0;5
15279;Gėlynas;RAMUNĖLĖ;5813156578;Ne;7;0;0;7
15280;Gėlynas;RAMUNĖLĖ;8550986498;Ne;13;0;0;13
15281;Gėlynas;RAMUNĖLĖ;1003739544;Taip;20;0;0;20
15282;Gėlynas;RAMUNĖLĖ;8483711968;Ne;10;0;1;11
15283;Gėlynas;RAMUNĖLĖ;5576414317;Ne;14;0;0;14
15284;Gėlynas;RAMUNĖLĖ;1625163282;Ne;9;0;0;9
15285;Gėlynas;RAMUNĖLĖ;1962457749;Ne;5;0;1;6
15286;Gėlynas;RAMUNĖLĖ;2968257637;Ne;4;0;0;4
15287;Gėlynas;RAMUNĖLĖ;9063119595;Ne;11;0;0;11
15288;Gėlynas;RAMUNĖLĖ;1923691283;Taip;1;0;6;7
15289;Gėlynas;RAMUNĖLĖ;1360487284;Ne;5;0;0;5
15290;Gėlynas;RAMUNĖLĖ;2043763411;Ne;0;9;0;9
15291;Gėlynas;RAMUNĖLĖ;4666515153;Ne;7;0;0;7
15292;Gėlynas;RAMUNĖLĖ;1074695140;Taip;2;0;0;2
15293;Gėlynas;RAMUNĖLĖ;6447818933;Ne;8;0;0;8
15294;Gėlynas;ŽIBUTĖ;8681345327;Ne;12;3;0;15
15295;Gėlynas;ŽIBUTĖ;1556683639;Ne;4;3;0;7
15296;Gėlynas;ŽIBUTĖ;2885148633;Ne;9;0;0;9
15297;Gėlynas;ŽIBUTĖ;9786032406;Ne;5;1;0;6
15298;Gėlynas;ŽIBUTĖ;6053762333;Ne;15;0;0;15
15299;Gėlynas;ŽIBUTĖ;4018507719;Ne;0;1;0;1
15300;Gėlynas;ŽIBUTĖ;4012165601;Ne;0;1;0;1
15301;Gėlynas;ŽIBUTĖ;7633304238;Ne;4;3;0;7
15302;Gėlynas;ŽIBUTĖ;1579053252;Ne;11;0;0;11
15303;Gėlynas;ŽIBUTĖ;9980617252;Ne;2;0;0;2
15304;Gėlynas;ŽIBUTĖ;9859626078;Ne;9;0;0;9
15305;Gėlynas;ŽIBUTĖ;1073904355;Ne;2;2;0;4
15306;Gėlynas;ŽIBUTĖ;9256960820;Ne;11;0;0;11
15307;Gėlynas;ŽIBUTĖ;9513419357;Ne;5;3;0;8
15308;Gėlynas;ŽIBUTĖ;3629326461;Ne;5;5;0;10
15309;Obelėlė;Gudručiai;9900484892;Ne;6;0;1;7
15310;Obelėlė;Gudručiai;9586720282;Ne;10;0;0;10
15311;Obelėlė;Gudručiai;9567704282;Ne;5;0;0;5
15312;Obelėlė;Gudručiai;4015702815;Ne;5;0;0;5
15313;Obelėlė;Gudručiai;4309139638;Ne;2;0;1;3
15314;Obelėlė;Gudručiai;5141585309;Ne;8;0;1;9
15315;Obelėlė;Gudručiai;9736557012;Ne;0;0;1;1
15316;Obelėlė;Gudručiai;2053807216;Ne;0;0;1;1
15317;Obelėlė;Gudručiai;2204293216;Ne;0;16;0;16
15318;Obelėlė;Gudručiai;1184082097;Ne;7;1;0;8
15319;Obelėlė;Gudručiai;2533715287;Ne;0;20;0;20
15320;Obelėlė;Gudručiai;1312484983;Ne;7;0;1;8
15321;Obelėlė;Gudručiai;1565630870;Ne;0;0;1;1
15322;Obelėlė;Gudručiai;1598785483;Ne;0;2;0;2
15323;Obelėlė;Gudručiai;2170134084;Ne;0;0;2;2
15324;Obelėlė;Gudručiai;8155712451;Ne;5;0;0;5
15325;Obelėlė;Gudručiai;8371648703;Ne;0;0;1;1
15326;Obelėlė;Gudručiai;1362135757;Ne;8;0;0;8
15327;Obelėlė;Gudručiai;3769993089;Ne;3;0;0;3
15328;Obelėlė;Gudručiai;1630067014;Ne;0;1;0;1
15329;Obelėlė;Pasakaitė;9008900055;Ne;10;0;0;10
15330;Obelėlė;Pasakaitė;9332534001;Ne;10;0;0;10
15331;Obelėlė;Pasakaitė;2465101384;Ne;10;0;0;10
15332;Obelėlė;Pasakaitė;3452970142;Taip;0;8;0;8
15333;Obelėlė;Pasakaitė;6945301927;Ne;0;0;2;2
15334;Obelėlė;Pasakaitė;9995891955;Ne;5;5;0;10
15335;Obelėlė;Pasakaitė;3646359565;Ne;6;0;0;6
15336;Obelėlė;Pasakaitė;2663004768;Ne;3;0;1;4
15337;Obelėlė;Pasakaitė;4707488292;Ne;20;0;0;20
15338;Obelėlė;Pasakaitė;2031637374;Taip;5;0;1;6
15339;Obelėlė;Pasakaitė;4678269928;Taip;7;0;1;8
15340;Obelėlė;Pasakaitė;8060994250;Taip;7;0;0;7
15341;Obelėlė;Pasakaitė;5617103957;Ne;0;4;0;4
15342;Obelėlė;Pasakaitė;6321178561;Ne;0;15;0;15
15343;Obelėlė;Pasakaitė;9903010418;Ne;4;0;2;6
15344;Obelėlė;Svajokliai;9981446556;Taip;5;0;0;5
15345;Obelėlė;Svajokliai;4849499826;Ne;0;2;0;2
15346;Obelėlė;Svajokliai;1469593267;Ne;5;0;1;6
15347;Obelėlė;Svajokliai;9819048265;Taip;10;0;0;10
15348;Obelėlė;Svajokliai;6325027163;Ne;2;0;0;2
15349;Obelėlė;Svajokliai;7094715237;Ne;0;0;1;1
15350;Obelėlė;Svajokliai;3986892111;Ne;1;0;0;1
15351;Obelėlė;Svajokliai;7003947655;Ne;0;1;0;1
15352;Obelėlė;Svajokliai;9641297002;Ne;6;0;0;6
15353;Obelėlė;Svajokliai;8918176312;Ne;0;0;1;1
15354;Obelėlė;Svajokliai;8604451971;Ne;0;0;1;1
15355;Obelėlė;Svajokliai;7794072582;Ne;0;0;1;1
15356;Obelėlė;Svajokliai;6785654280;Ne;3;0;0;3
15357;Obelėlė;Smalsučiai;6497584911;Ne;5;0;0;5
15358;Obelėlė;Smalsučiai;7687093936;Ne;4;0;0;4
15359;Obelėlė;Smalsučiai;1469375976;Ne;0;2;0;2
15360;Obelėlė;Smalsučiai;7108517080;Ne;0;0;1;1
15361;Obelėlė;Smalsučiai;6020342761;Ne;6;0;0;6
15362;Obelėlė;Smalsučiai;4987747783;Ne;2;0;3;5
15363;Obelėlė;Smalsučiai;5085970254;Ne;7;0;1;8
15364;Obelėlė;Smalsučiai;8709758561;Ne;5;0;0;5
15365;Obelėlė;Smalsučiai;2631405243;Ne;7;0;0;7
15366;Obelėlė;Smalsučiai;8173307704;Ne;12;0;0;12
15367;Obelėlė;Smalsučiai;6720808705;Ne;5;0;1;6
15368;Obelėlė;Smalsučiai;7850656031;Ne;5;5;0;10
15369;Obelėlė;Smalsučiai;9084969712;Taip;6;0;0;6
15370;Obelėlė;Smalsučiai;6364101139;Ne;0;9;0;9
15371;Obelėlė;Smalsučiai;6064646690;Ne;0;0;1;1
15372;Obelėlė;Smalsučiai;8183287212;Ne;0;1;0;1
15373;Obelėlė;Smalsučiai;2574840626;Ne;6;2;0;8
15374;Obelėlė;Smalsučiai;8981403984;Ne;5;0;5;10
15375;Obelėlė;Pabiručiai;2035035265;Ne;8;0;0;8
15376;Obelėlė;Pabiručiai;5763713052;Taip;13;0;0;13
15377;Obelėlė;Pabiručiai;7667966704;Ne;1;0;0;1
15378;Obelėlė;Pabiručiai;1819480590;Ne;5;0;0;5
15379;Obelėlė;Pabiručiai;8579887226;Ne;11;0;0;11
15380;Obelėlė;Pabiručiai;6946457363;Ne;1;0;0;1
15381;Obelėlė;Pabiručiai;8948297718;Ne;9;0;0;9
15382;Obelėlė;Pabiručiai;3951816174;Ne;9;0;0;9
15383;Obelėlė;Pabiručiai;5599466885;Ne;0;0;4;4
15384;Obelėlė;Pabiručiai;9634414572;Ne;5;0;0;5
15385;Obelėlė;Pabiručiai;2262107831;Ne;0;0;1;1
15386;Obelėlė;Pabiručiai;4851824672;Ne;10;0;0;10
15387;Obelėlė;Pabiručiai;3526079444;Ne;9;0;0;9
15388;Obelėlė;Pabiručiai;9731565368;Ne;3;0;0;3
15389;Obelėlė;Pabiručiai;8827515572;Ne;3;0;0;3
15390;Obelėlė;Pabiručiai;2399173200;Ne;14;0;0;14
15391;Obelėlė;Pabiručiai;8443192155;Ne;10;0;0;10
15392;Obelėlė;Pabiručiai;9627134967;Ne;5;9;0;14
15393;Obelėlė;Pabiručiai;4575139158;Ne;17;0;0;17
15394;Obelėlė;Strakaliukai;1706102918;Taip;7;0;0;7
15395;Obelėlė;Strakaliukai;8754552660;Ne;6;0;0;6
15396;Obelėlė;Strakaliukai;8092024850;Ne;5;0;0;5
15397;Obelėlė;Strakaliukai;9716500560;Ne;0;0;1;1
15398;Obelėlė;Strakaliukai;4251418414;Ne;1;0;0;1
15399;Obelėlė;Strakaliukai;7128421330;Ne;6;0;0;6
15400;Obelėlė;Strakaliukai;5943314566;Ne;7;0;0;7
15401;Obelėlė;Strakaliukai;5741823041;Ne;4;0;0;4
15402;Obelėlė;Strakaliukai;8050551266;Ne;0;0;1;1
15403;Obelėlė;Strakaliukai;7468335279;Taip;0;0;2;2
15404;Obelėlė;Strakaliukai;1180508643;Ne;0;3;0;3
15405;Obelėlė;Strakaliukai;7124393375;Ne;8;0;4;12
15406;Obelėlė;Strakaliukai;5001844064;Ne;2;0;0;2
15407;Obelėlė;Strakaliukai;9976694313;Ne;1;0;0;1
15408;Obelėlė;Strakaliukai;1537769810;Ne;5;0;0;5
15409;Obelėlė;Strakaliukai;5776116844;Ne;0;5;0;5
15410;Obelėlė;Strakaliukai;1419189517;Ne;4;0;0;4
15411;Obelėlė;Strakaliukai;3425736276;Ne;3;0;0;3
15412;Obelėlė;Strakaliukai;8487088625;Ne;0;1;0;1
15413;Obelėlė;Strakaliukai;5374979248;Taip;4;0;0;4
15414;Obelėlė;Saulutė;2772753891;Taip;10;0;0;10
15415;Obelėlė;Saulutė;8486560892;Ne;5;1;0;6
15416;Obelėlė;Saulutė;1858251094;Ne;0;0;1;1
15417;Obelėlė;Saulutė;2893378990;Ne;5;0;0;5
15418;Obelėlė;Saulutė;7491934262;Ne;0;10;0;10
15419;Obelėlė;Saulutė;9043542844;Ne;0;0;4;4
15420;Obelėlė;Saulutė;4321210604;Taip;3;0;0;3
15421;Obelėlė;Saulutė;4209489251;Ne;0;0;2;2
15422;Obelėlė;Saulutė;4309622934;Ne;16;0;0;16
15423;Obelėlė;Saulutė;3590915973;Ne;1;0;0;1
15424;Obelėlė;Saulutė;6470533765;Ne;0;2;1;3
15425;Obelėlė;Saulutė;8223715886;Ne;0;2;1;3
15426;Obelėlė;Saulutė;8461505586;Ne;10;0;0;10
15427;Obelėlė;Saulutė;2730569223;Ne;0;0;3;3
15428;Obelėlė;Saulutė;4218895290;Ne;2;0;1;3
15429;Obelėlė;Rieduliukai;7358561581;Taip;4;0;0;4
15430;Obelėlė;Rieduliukai;6288343928;Ne;10;0;0;10
15431;Obelėlė;Rieduliukai;8518041886;Ne;4;0;0;4
15432;Obelėlė;Rieduliukai;9980499571;Ne;6;0;0;6
15433;Obelėlė;Rieduliukai;7254219285;Ne;7;0;0;7
15434;Obelėlė;Rieduliukai;9329425457;Ne;5;0;0;5
15435;Obelėlė;Rieduliukai;9418600546;Ne;5;0;0;5
15436;Obelėlė;Rieduliukai;1246354139;Ne;3;0;0;3
15437;Obelėlė;Rieduliukai;4004797759;Ne;8;0;0;8
15438;Obelėlė;Rieduliukai;5441524884;Ne;0;20;0;20
15439;Obelėlė;Rieduliukai;3210789582;Ne;15;0;0;15
15440;Obelėlė;Rieduliukai;1039878043;Ne;15;0;0;15
15441;Obelėlė;Rieduliukai;9359921446;Ne;3;0;0;3
15442;Obelėlė;Žirniukai;9542303128;Ne;0;0;1;1
15443;Obelėlė;Žirniukai;3886008149;Ne;2;0;0;2
15444;Obelėlė;Žirniukai;4676986978;Ne;4;0;0;4
15445;Obelėlė;Žirniukai;9222485883;Taip;7;0;0;7
15446;Obelėlė;Žirniukai;4708077301;Ne;15;0;0;15
15447;Obelėlė;Žirniukai;3199776998;Ne;3;0;1;4
15448;Obelėlė;Žirniukai;1369344706;Ne;15;0;0;15
15449;Obelėlė;Žirniukai;2561695305;Ne;0;0;2;2
15450;Obelėlė;Žirniukai;1329818819;Ne;3;0;0;3
15451;Obelėlė;Žirniukai;5933225940;Ne;0;0;2;2
15452;Obelėlė;Žirniukai;3347690540;Ne;0;0;2;2
15453;Obelėlė;Žirniukai;9502503757;Ne;10;0;0;10
15454;Obelėlė;Žirniukai;3474007758;Ne;13;0;1;14
15455;Obelėlė;Žirniukai;8777938603;Ne;5;9;0;14
15456;Obelėlė;Žirniukai;5213900934;Ne;5;0;1;6
15457;Obelėlė;Žirniukai;4862765923;Ne;1;0;0;1
15458;Obelėlė;Bičiuliai;5209482838;Ne;6;0;0;6
15459;Obelėlė;Bičiuliai;8422696011;Ne;5;0;0;5
15460;Obelėlė;Bičiuliai;1799603610;Ne;10;0;0;10
15461;Obelėlė;Bičiuliai;5192989376;Taip;0;20;0;20
15462;Obelėlė;Bičiuliai;2769784741;Ne;0;20;0;20
15463;Obelėlė;Bičiuliai;7813350634;Ne;7;0;0;7
15464;Obelėlė;Bičiuliai;6133596410;Ne;5;0;0;5
15465;Obelėlė;Bičiuliai;3568124213;Ne;1;0;0;1
15466;Obelėlė;Bičiuliai;2702773541;Ne;15;0;0;15
15467;Obelėlė;Bičiuliai;4223995429;Ne;1;0;0;1
15468;Obelėlė;Bičiuliai;8982197866;Ne;9;0;0;9
15469;Obelėlė;Bičiuliai;5073364608;Ne;0;2;0;2
15470;Obelėlė;Bičiuliai;3881456534;Taip;5;0;0;5
15471;Obelėlė;Kodėlčiukai;9960526051;Ne;6;0;0;6
15472;Obelėlė;Kodėlčiukai;1050919659;Ne;3;0;0;3
15473;Obelėlė;Kodėlčiukai;7014872044;Ne;0;0;1;1
15474;Obelėlė;Kodėlčiukai;3028107343;Ne;2;0;0;2
15475;Obelėlė;Kodėlčiukai;4717038536;Ne;0;0;1;1
15476;Obelėlė;Kodėlčiukai;4840134079;Taip;8;0;0;8
15477;Obelėlė;Kodėlčiukai;8762518354;Ne;0;0;1;1
15478;Obelėlė;Kodėlčiukai;3320493372;Ne;0;0;1;1
15479;Obelėlė;Kodėlčiukai;8366162313;Ne;1;0;0;1
15480;Obelėlė;Kodėlčiukai;2227383487;Ne;1;0;1;2
15481;Obelėlė;Kodėlčiukai;8818153952;Ne;4;0;0;4
15482;Obelėlė;Kodėlčiukai;5221918341;Taip;10;0;0;10
15483;Obelėlė;Kodėlčiukai;3748406335;Ne;7;0;0;7
15484;Obelėlė;Kodėlčiukai;1472630240;Ne;2;0;0;2
15485;Obelėlė;Pagrandukai;7934967787;Ne;13;0;0;13
15486;Obelėlė;Pagrandukai;9258651395;Taip;5;0;1;6
15487;Obelėlė;Pagrandukai;3563701047;Ne;6;0;0;6
15488;Obelėlė;Pagrandukai;4930485327;Ne;3;0;1;4
15489;Obelėlė;Pagrandukai;9514739912;Ne;5;0;0;5
15490;Obelėlė;Pagrandukai;7368698046;Ne;0;0;3;3
15491;Obelėlė;Pagrandukai;3738932600;Ne;2;0;1;3
15492;Obelėlė;Pagrandukai;2203568007;Ne;10;1;0;11
15493;Obelėlė;Pagrandukai;1423488655;Ne;3;0;0;3
15494;Obelėlė;Pagrandukai;6045739549;Taip;5;0;0;5
15495;Spygliukas;Bitutės;8272537768;Ne;10;0;0;10
15496;Spygliukas;Bitutės;9444569348;Ne;1;0;0;1
15497;Spygliukas;Bitutės;3041184642;Ne;4;0;0;4
15498;Spygliukas;Bitutės;5134327772;Ne;0;2;0;2
15499;Spygliukas;Bitutės;8869320003;Ne;0;2;0;2
15500;Spygliukas;Bitutės;8476882854;Ne;7;1;0;8
15501;Spygliukas;Bitutės;8270525839;Ne;0;2;0;2
15502;Spygliukas;Bitutės;3697691132;Ne;9;2;0;11
15503;Spygliukas;Bitutės;1550737449;Taip;3;1;0;4
15504;Spygliukas;Bitutės;4053158210;Taip;0;1;0;1
15505;Spygliukas;Bitutės;2395961015;Taip;0;1;0;1
15506;Spygliukas;Bitutės;5180736358;Ne;1;0;0;1
15507;Spygliukas;Bitutės;9431217584;Ne;0;6;0;6
15508;Spygliukas;Bitutės;8825264090;Taip;6;1;0;7
15509;Spygliukas;Kiškučiai;8246739374;Ne;5;0;0;5
15510;Spygliukas;Kiškučiai;1243647769;Ne;7;0;0;7
15511;Spygliukas;Kiškučiai;6680699873;Ne;3;0;0;3
15512;Spygliukas;Kiškučiai;5043843336;Ne;3;0;0;3
15513;Spygliukas;Kiškučiai;8509447147;Ne;2;0;0;2
15514;Spygliukas;Kiškučiai;2955219028;Ne;14;0;0;14
15515;Spygliukas;Kiškučiai;5739075961;Ne;10;0;0;10
15516;Spygliukas;Kiškučiai;1823720183;Ne;20;0;0;20
15517;Spygliukas;Kiškučiai;1775612723;Ne;8;0;0;8
15518;Spygliukas;Kiškučiai;7324915516;Ne;10;2;0;12
15519;Spygliukas;Kiškučiai;6414439254;Ne;10;2;0;12
15520;Spygliukas;Kiškučiai;8565217488;Ne;16;0;0;16
15521;Spygliukas;Kiškučiai;3065727701;Ne;16;0;0;16
15522;Spygliukas;Kiškučiai;2367685286;Taip;0;20;0;20
15523;Spygliukas;Kiškučiai;7663839690;Ne;2;0;0;2
15524;Spygliukas;Kiškučiai;4409209677;Ne;3;0;0;3
15525;Spygliukas;Kiškučiai;9060123423;Ne;11;0;0;11
15526;Spygliukas;Boružėlės;5615854225;Ne;0;8;0;8
15527;Spygliukas;Boružėlės;6195903792;Ne;3;3;0;6
15528;Spygliukas;Boružėlės;7261580644;Ne;7;2;0;9
15529;Spygliukas;Boružėlės;6246925536;Taip;3;1;0;4
15530;Spygliukas;Boružėlės;8299276429;Taip;2;2;0;4
15531;Spygliukas;Boružėlės;8981549891;Ne;1;0;0;1
15532;Spygliukas;Boružėlės;9813995933;Taip;0;8;0;8
15533;Spygliukas;Boružėlės;4013601534;Ne;9;0;0;9
15534;Spygliukas;Boružėlės;1436452804;Ne;10;2;0;12
15535;Spygliukas;Boružėlės;3959136555;Ne;6;0;0;6
15536;Spygliukas;Boružėlės;6383264068;Ne;5;0;0;5
15537;Spygliukas;Boružėlės;5369930705;Ne;5;0;0;5
15538;Spygliukas;Boružėlės;1330384915;Ne;12;0;0;12
15539;Spygliukas;Boružėlės;1037321774;Ne;2;2;0;4
15540;Spygliukas;Boružėlės;1683270282;Ne;0;20;0;20
15541;Spygliukas;Boružėlės;9025238241;Ne;6;1;0;7
15542;Spygliukas;Boružėlės;5255993275;Taip;6;0;0;6
15543;Spygliukas;Ežiukai;2164549239;Ne;2;0;0;2
15544;Spygliukas;Ežiukai;4340767624;Ne;8;0;0;8
15545;Spygliukas;Ežiukai;4615217628;Taip;6;8;0;14
15546;Spygliukas;Ežiukai;5612894706;Ne;2;1;0;3
15547;Spygliukas;Ežiukai;6552944183;Ne;1;0;0;1
15548;Spygliukas;Ežiukai;6459076295;Ne;2;0;0;2
15549;Spygliukas;Ežiukai;7749937772;Ne;15;0;0;15
15550;Spygliukas;Ežiukai;2719100414;Ne;0;1;0;1
15551;Spygliukas;Ežiukai;1429613380;Ne;1;0;0;1
15552;Spygliukas;Ežiukai;4026252608;Ne;0;2;0;2
15553;Spygliukas;Ežiukai;4098112375;Ne;10;0;0;10
15554;Spygliukas;Ežiukai;9321493897;Ne;3;0;0;3
15555;Spygliukas;Ežiukai;7908419787;Taip;5;0;0;5
15556;Spygliukas;Ežiukai;3088387895;Ne;3;0;0;3
15557;Spygliukas;Ežiukai;7287543571;Taip;9;0;0;9
15558;Spygliukas;Ežiukai;3297728501;Ne;1;1;0;2
15559;Spygliukas;Ežiukai;3959227706;Ne;6;0;0;6
15560;Spygliukas;Geniukai;8821434815;Ne;6;0;0;6
15561;Spygliukas;Geniukai;2713999021;Ne;5;0;0;5
15562;Spygliukas;Geniukai;6700076900;Ne;18;0;0;18
15563;Spygliukas;Geniukai;8338260940;Ne;1;0;0;1
15564;Spygliukas;Geniukai;9945315122;Ne;1;0;0;1
15565;Spygliukas;Geniukai;1291429206;Ne;1;0;0;1
15566;Spygliukas;Geniukai;7477731865;Ne;1;0;0;1
15567;Spygliukas;Geniukai;2950722789;Taip;2;0;0;2
15568;Spygliukas;Geniukai;8308394841;Ne;4;0;0;4
15569;Spygliukas;Geniukai;9783154498;Ne;1;0;0;1
15570;Spygliukas;Geniukai;8581453160;Ne;1;0;0;1
15571;Spygliukas;Geniukai;7573756485;Ne;1;0;0;1
15572;Spygliukas;Geniukai;9770852356;Ne;5;0;0;5
15573;Spygliukas;Riešutėliai;9070219319;Ne;0;1;0;1
15574;Spygliukas;Riešutėliai;7271659513;Ne;7;2;0;9
15575;Spygliukas;Riešutėliai;9392554576;Ne;2;0;0;2
15576;Spygliukas;Riešutėliai;8604767396;Ne;0;4;0;4
15577;Spygliukas;Riešutėliai;4634660174;Ne;3;1;0;4
15578;Spygliukas;Riešutėliai;7924880159;Ne;2;0;0;2
15579;Spygliukas;Riešutėliai;4368224847;Ne;0;1;0;1
15580;Spygliukas;Riešutėliai;9316731983;Ne;4;0;0;4
15581;Spygliukas;Riešutėliai;6630979640;Taip;1;1;0;2
15582;Spygliukas;Riešutėliai;5012876830;Ne;4;0;0;4
15583;Spygliukas;Riešutėliai;2315421636;Ne;5;0;0;5
15584;Spygliukas;Riešutėliai;7125425492;Ne;1;0;0;1
15585;Spygliukas;Riešutėliai;4505044604;Ne;0;5;0;5
15586;Spygliukas;Riešutėliai;2989701249;Ne;1;0;0;1
15587;Spygliukas;Riešutėliai;9086986643;Taip;0;1;0;1
15588;Spygliukas;Pelėdžiukai;3569857813;Ne;6;0;0;6
15589;Spygliukas;Pelėdžiukai;4577592862;Taip;7;7;0;14
15590;Spygliukas;Pelėdžiukai;6931145017;Ne;1;0;0;1
15591;Spygliukas;Pelėdžiukai;9285259322;Ne;0;1;0;1
15592;Spygliukas;Pelėdžiukai;1341333016;Ne;9;0;0;9
15593;Spygliukas;Pelėdžiukai;8806126755;Taip;2;0;0;2
15594;Spygliukas;Pelėdžiukai;4477402331;Ne;4;0;0;4
15595;Spygliukas;Pelėdžiukai;2772801133;Ne;1;0;0;1
15596;Spygliukas;Pelėdžiukai;3706443395;Ne;2;0;0;2
15597;Spygliukas;Pelėdžiukai;5765106914;Ne;6;0;0;6
15598;Spygliukas;Pelėdžiukai;8708083787;Ne;6;0;0;6
15599;Spygliukas;Pelėdžiukai;3416275094;Ne;3;0;0;3
15600;Spygliukas;Zylutės;2135024989;Ne;20;0;0;20
15601;Spygliukas;Zylutės;7351963782;Ne;6;0;0;6
15602;Spygliukas;Zylutės;9348022137;Ne;3;0;0;3
15603;Spygliukas;Zylutės;3804738695;Taip;5;0;0;5
15604;Spygliukas;Zylutės;3036959597;Ne;3;0;0;3
15605;Spygliukas;Zylutės;5565042215;Ne;9;0;0;9
15606;Spygliukas;Zylutės;4161787684;Ne;3;0;0;3
15607;Spygliukas;Zylutės;8536017163;Ne;3;0;0;3
15608;Spygliukas;Zylutės;6061859914;Ne;13;0;0;13
15609;Spygliukas;Zylutės;4097562838;Ne;5;0;0;5
15610;Spygliukas;Zylutės;2504348694;Ne;11;0;0;11
15611;Spygliukas;Zylutės;6021859437;Ne;10;0;0;10
15612;Spygliukas;Zylutės;5357257525;Ne;14;0;0;14
15613;Spygliukas;Zylutės;9382060963;Ne;10;0;0;10
15614;Spygliukas;Zylutės;8246963847;Ne;7;0;0;7
15615;Spygliukas;Skruzdėliukai;9370633403;Ne;0;20;0;20
15616;Spygliukas;Skruzdėliukai;9155444846;Taip;5;0;0;5
15617;Spygliukas;Skruzdėliukai;6828136677;Ne;10;0;0;10
15618;Spygliukas;Skruzdėliukai;7524773805;Ne;3;3;0;6
15619;Spygliukas;Skruzdėliukai;2921299830;Ne;8;0;0;8
15620;Spygliukas;Skruzdėliukai;9138352625;Ne;7;0;0;7
15621;Spygliukas;Skruzdėliukai;1419835654;Ne;7;0;0;7
15622;Spygliukas;Skruzdėliukai;5513126879;Ne;4;0;0;4
15623;Spygliukas;Skruzdėliukai;3458761442;Ne;0;5;0;5
15624;Spygliukas;Skruzdėliukai;9211070397;Ne;13;1;0;14
15625;Spygliukas;Skruzdėliukai;1210648053;Ne;5;0;0;5
15626;Spygliukas;Skruzdėliukai;7163485844;Ne;5;0;0;5
15627;Spygliukas;Skruzdėliukai;4974008654;Ne;6;0;0;6
15628;Spygliukas;Skruzdėliukai;6749921681;Ne;2;0;0;2
15629;Spygliukas;Voveraitės;9112172144;Ne;4;0;0;4
15630;Spygliukas;Voveraitės;7897603878;Ne;3;2;0;5
15631;Spygliukas;Voveraitės;7741841634;Ne;4;5;0;9
15632;Spygliukas;Voveraitės;2272141731;Ne;2;0;0;2
15633;Spygliukas;Voveraitės;6758336405;Ne;0;4;0;4
15634;Spygliukas;Voveraitės;7113913750;Ne;4;0;0;4
15635;Spygliukas;Voveraitės;9231097598;Ne;1;0;0;1
15636;Spygliukas;Voveraitės;7313828707;Ne;4;0;0;4
15637;Spygliukas;Voveraitės;1234195733;Ne;0;5;0;5
15638;Spygliukas;Giliukų;1761340174;Ne;2;2;0;4
15639;Spygliukas;Giliukų;4854168938;Taip;8;0;0;8
15640;Spygliukas;Giliukų;7522567241;Ne;0;1;0;1
15641;Spygliukas;Giliukų;7460280684;Taip;3;0;0;3
15642;Spygliukas;Giliukų;4429961491;Ne;5;0;0;5
15643;Spygliukas;Giliukų;8821028259;Ne;5;0;0;5
15644;Spygliukas;Giliukų;6485350404;Ne;20;0;0;20
15645;Spygliukas;Giliukų;3237501537;Ne;10;0;0;10
15646;Spygliukas;Giliukų;8722863277;Ne;10;0;0;10
15647;Spygliukas;Giliukų;3603606800;Ne;3;1;0;4
15648;Spygliukas;Giliukų;6290439938;Ne;8;0;0;8
15649;Spygliukas;Giliukų;7776811391;Ne;2;0;0;2
15650;Spygliukas;Giliukų;4494339318;Ne;10;0;0;10
15651;Spygliukas;Drugeliai;8178732077;Ne;7;0;0;7
15652;Spygliukas;Drugeliai;5164567779;Ne;0;2;0;2
15653;Spygliukas;Drugeliai;9465470810;Ne;4;1;0;5
15654;Spygliukas;Drugeliai;3317395260;Ne;3;0;0;3
15655;Spygliukas;Drugeliai;6858338620;Ne;2;0;0;2
15656;Spygliukas;Drugeliai;5638595939;Ne;5;1;0;6
15657;Spygliukas;Drugeliai;5006372835;Ne;3;0;0;3
15658;Spygliukas;Drugeliai;3268222954;Ne;4;0;0;4
15659;Spygliukas;Drugeliai;3066293772;Ne;3;0;0;3
15660;Spygliukas;Drugeliai;2632672131;Taip;0;1;0;1
15661;Vieversys;Žirniukai;5365334453;Ne;9;0;0;9
15662;Vieversys;Žirniukai;7029322013;Taip;5;1;0;6
15663;Vieversys;Žirniukai;2266222087;Taip;2;0;0;2
15664;Vieversys;Žirniukai;2869545222;Taip;3;0;0;3
15665;Vieversys;Žirniukai;7601876587;Ne;4;0;0;4
15666;Vieversys;Žirniukai;2024837493;Ne;17;0;0;17
15667;Vieversys;Žirniukai;8129566710;Ne;4;0;1;5
15668;Vieversys;Žirniukai;5576923685;Ne;0;1;0;1
15669;Vieversys;Žirniukai;6052943894;Ne;8;0;0;8
15670;Vieversys;Žirniukai;3295424711;Ne;4;0;0;4
15671;Vieversys;Žirniukai;7309040730;Ne;2;0;0;2
15672;Vieversys;Žirniukai;3575906273;Ne;10;0;0;10
15673;Vieversys;Žirniukai;1724543625;Taip;4;0;0;4
15674;Vieversys;Žirniukai;3533711179;Taip;5;0;0;5
15675;Vieversys;Žirniukai;2242368843;Ne;8;0;0;8
15676;Vieversys;Žirniukai;9666764935;Ne;3;0;3;6
15677;Vieversys;Žirniukai;8966020793;Ne;0;0;6;6
15678;Vieversys;Žirniukai;3683573041;Ne;5;0;0;5
15679;Vieversys;Varpelių;5150986489;Taip;1;0;0;1
15680;Vieversys;Varpelių;9463693741;Ne;8;0;0;8
15681;Vieversys;Varpelių;1924774817;Taip;6;1;0;7
15682;Vieversys;Varpelių;3595005599;Ne;5;1;0;6
15683;Vieversys;Varpelių;9155896981;Ne;2;2;3;7
15684;Vieversys;Varpelių;5160814541;Ne;5;0;0;5
15685;Vieversys;Varpelių;9580031042;Ne;0;2;0;2
15686;Vieversys;Varpelių;2635722489;Ne;4;1;0;5
15687;Vieversys;Varpelių;3262738994;Ne;8;0;0;8
15688;Vieversys;Varpelių;8350070741;Ne;10;0;0;10
15689;Vieversys;Varpelių;9453100342;Ne;3;0;0;3
15690;Vieversys;Varpelių;2956566201;Ne;10;0;0;10
15691;Vieversys;Varpelių;1727558984;Ne;11;0;0;11
15692;Vieversys;Varpelių;3780226431;Taip;10;0;2;12
15693;Vieversys;Varpelių;3572628491;Taip;6;0;0;6
15694;Vieversys;Varpelių;1128991679;Taip;2;1;0;3
15695;Vieversys;Varpelių;7611047781;Ne;5;1;0;6
15696;Vieversys;Varpelių;8079885165;Ne;9;0;1;10
15697;Vieversys;Varpelių;4510888337;Ne;2;4;0;6
15698;Vieversys;Kiškučių;6127272124;Ne;0;5;0;5
15699;Vieversys;Kiškučių;3360981720;Taip;4;0;0;4
15700;Vieversys;Kiškučių;9308040716;Ne;9;0;1;10
15701;Vieversys;Kiškučių;4741252829;Ne;9;0;1;10
15702;Vieversys;Kiškučių;3164280186;Ne;5;0;2;7
15703;Vieversys;Kiškučių;4690095102;Ne;5;0;0;5
15704;Vieversys;Kiškučių;7048475906;Ne;0;0;1;1
15705;Vieversys;Kiškučių;4072323869;Ne;6;0;0;6
15706;Vieversys;Kiškučių;2663322242;Ne;10;0;0;10
15707;Vieversys;Kiškučių;7596355010;Ne;0;7;0;7
15708;Vieversys;Kiškučių;9322322737;Ne;0;0;2;2
15709;Vieversys;Kiškučių;9164615794;Ne;0;3;0;3
15710;Vieversys;Kiškučių;8174124875;Taip;0;2;0;2
15711;Vieversys;Pelėdžiukų;3681120339;Ne;0;0;4;4
15712;Vieversys;Pelėdžiukų;6882614465;Ne;0;0;2;2
15713;Vieversys;Pelėdžiukų;7007620994;Ne;0;0;3;3
15714;Vieversys;Pelėdžiukų;3946609345;Ne;0;0;3;3
15715;Vieversys;Pelėdžiukų;6563139211;Ne;0;2;3;5
15716;Vieversys;Pelėdžiukų;4294676988;Ne;6;0;1;7
15717;Vieversys;Pelėdžiukų;4835022593;Ne;0;0;3;3
15718;Vieversys;Pelėdžiukų;3249717073;Taip;0;5;1;6
15719;Vieversys;Pelėdžiukų;7120329258;Ne;0;0;1;1
15720;Vieversys;Pelėdžiukų;9494957750;Ne;0;0;4;4
15721;Vieversys;Pelėdžiukų;9835682858;Ne;0;0;7;7
15722;Vieversys;Pelėdžiukų;5907903394;Ne;2;0;2;4
15723;Vieversys;Pelėdžiukų;5769453869;Ne;3;0;1;4
15724;Vieversys;Saulučių;8492908398;Ne;4;0;0;4
15725;Vieversys;Saulučių;8706336322;Ne;1;0;0;1
15726;Vieversys;Saulučių;5966170543;Ne;1;0;0;1
15727;Vieversys;Saulučių;9268459013;Ne;1;0;0;1
15728;Vieversys;Saulučių;5210732072;Ne;10;0;0;10
15729;Vieversys;Saulučių;9188208330;Ne;1;0;0;1
15730;Vieversys;Saulučių;9476611261;Taip;0;20;0;20
15731;Vieversys;Saulučių;9978867863;Ne;0;10;0;10
15732;Vieversys;Saulučių;5479620291;Taip;11;0;0;11
15733;Vieversys;Saulučių;6083402842;Ne;3;0;0;3
15734;Vieversys;Saulučių;3601928285;Ne;1;0;0;1
15735;Vieversys;Saulučių;6839896363;Taip;11;0;0;11
15736;Vieversys;Saulučių;2661027772;Taip;0;0;1;1
15737;Vieversys;Saulučių;4428101863;Ne;0;5;0;5
15738;Vieversys;Saulučių;5417413393;Ne;16;0;0;16
15739;Vieversys;Saulučių;4335653911;Ne;6;0;0;6
15740;Vieversys;Saulučių;2931875387;Ne;1;0;0;1
15741;Vieversys;Saulučių;9092693925;Taip;8;0;0;8
15742;Vieversys;Kregždučių;3156245273;Taip;0;3;0;3
15743;Vieversys;Kregždučių;5645852451;Taip;3;0;0;3
15744;Vieversys;Kregždučių;9088171869;Ne;15;0;0;15
15745;Vieversys;Kregždučių;7998100115;Ne;6;1;0;7
15746;Vieversys;Kregždučių;9093088054;Ne;0;5;0;5
15747;Vieversys;Kregždučių;2849852593;Ne;3;0;3;6
15748;Vieversys;Kregždučių;6808541662;Ne;0;1;0;1
15749;Vieversys;Kregždučių;6157594693;Ne;9;1;0;10
15750;Vieversys;Kregždučių;1322953831;Ne;2;1;0;3
15751;Vieversys;Kregždučių;9090281352;Ne;1;7;0;8
15752;Vieversys;Kregždučių;4308330177;Ne;11;0;2;13
15753;Vieversys;Kregždučių;4347494053;Ne;0;0;1;1
15754;Vieversys;Kregždučių;3122763958;Ne;5;0;0;5
15755;Vieversys;Kregždučių;2938302462;Ne;3;0;0;3
15756;Vieversys;Kregždučių;9577869269;Ne;2;0;1;3
15757;Vieversys;Boružėlių;8587368497;Ne;3;0;0;3
15758;Vieversys;Boružėlių;4565799599;Ne;0;1;0;1
15759;Vieversys;Boružėlių;7399326463;Ne;1;0;0;1
15760;Vieversys;Boružėlių;8084767846;Ne;2;5;0;7
15761;Vieversys;Boružėlių;9826657384;Ne;0;3;0;3
15762;Vieversys;Boružėlių;7429565381;Ne;0;0;1;1
15763;Vieversys;Boružėlių;4297477514;Ne;0;0;1;1
15764;Vieversys;Boružėlių;2701284187;Ne;18;0;0;18
15765;Vieversys;Boružėlių;6234199996;Ne;20;0;0;20
15766;Vieversys;Boružėlių;4183584366;Ne;4;0;1;5
15767;Vieversys;Boružėlių;4061364544;Ne;0;0;1;1
15768;Vieversys;Boružėlių;8446180685;Ne;10;0;0;10
15769;Vieversys;Boružėlių;1013074080;Ne;3;0;0;3
15770;Vieversys;Bitučių;9802720188;Taip;0;20;0;20
15771;Vieversys;Bitučių;7427200045;Ne;4;0;0;4
15772;Vieversys;Bitučių;8339300439;Ne;10;5;0;15
15773;Vieversys;Bitučių;6133686703;Ne;8;0;0;8
15774;Vieversys;Bitučių;8916379820;Ne;7;0;0;7
15775;Vieversys;Bitučių;6070871599;Ne;12;0;0;12
15776;Vieversys;Bitučių;8443729534;Ne;1;1;0;2
15777;Vieversys;Bitučių;7623394512;Ne;0;0;1;1
15778;Vieversys;Bitučių;5598338574;Taip;14;0;0;14
15779;Vieversys;Bitučių;3798183613;Ne;7;0;0;7
15780;Vieversys;Bitučių;3539906884;Ne;0;20;0;20
15781;Vieversys;Bitučių;5226457473;Ne;0;20;0;20
15782;Vieversys;Bitučių;4138476832;Ne;11;0;0;11
15783;Vieversys;Bitučių;1844718177;Ne;6;0;0;6
15784;Vieversys;Smalsučių;9412299328;Ne;4;0;0;4
15785;Vieversys;Smalsučių;8199984460;Ne;0;0;20;20
15786;Vieversys;Smalsučių;1714096583;Ne;5;0;0;5
15787;Vieversys;Smalsučių;8371839883;Ne;5;0;1;6
15788;Vieversys;Smalsučių;4952182897;Ne;0;0;1;1
15789;Vieversys;Smalsučių;1160455554;Ne;8;0;0;8
15790;Vieversys;Smalsučių;8200432952;Ne;16;0;0;16
15791;Vieversys;Smalsučių;2535992834;Ne;12;0;0;12
15792;Vieversys;Smalsučių;4974924858;Ne;0;0;1;1
15793;Vieversys;Smalsučių;7111551694;Ne;6;0;0;6
15794;Vieversys;Smalsučių;4743593002;Ne;1;0;2;3
15795;Vieversys;Smalsučių;6092848276;Ne;5;0;2;7
15796;Vieversys;Smalsučių;6498432810;Ne;20;0;0;20
15797;Vieversys;Kodėlčiukų;5037806018;Ne;4;0;0;4
15798;Vieversys;Kodėlčiukų;1752359969;Taip;0;6;0;6
15799;Vieversys;Kodėlčiukų;6791121542;Ne;15;0;0;15
15800;Vieversys;Kodėlčiukų;5898422871;Ne;5;6;0;11
15801;Vieversys;Kodėlčiukų;7453156612;Ne;12;0;0;12
15802;Vieversys;Kodėlčiukų;6926960486;Ne;2;0;0;2
15803;Vieversys;Kodėlčiukų;3180687885;Ne;4;0;0;4
15804;Vieversys;Kodėlčiukų;1881076551;Ne;6;0;0;6
15805;Vieversys;Kodėlčiukų;1384388802;Ne;5;5;0;10
15806;Vieversys;Kodėlčiukų;2562413607;Ne;5;0;0;5
15807;Vieversys;Kodėlčiukų;9965162863;Ne;7;0;0;7
15808;Vieversys;Kodėlčiukų;4702339508;Taip;9;0;0;9
15809;Vieversys;Kodėlčiukų;4631238425;Ne;4;0;0;4
15810;Vieversys;Kodėlčiukų;8512643926;Ne;6;0;0;6
15811;Vieversys;Kodėlčiukų;7967372524;Ne;3;0;0;3
15812;Vieversys;NYKŠTUKAI;6767212393;Ne;8;0;0;8
15813;Vieversys;NYKŠTUKAI;2143285915;Ne;4;0;0;4
15814;Vieversys;NYKŠTUKAI;7340840045;Ne;11;0;0;11
15815;Vieversys;NYKŠTUKAI;3557067985;Ne;1;0;0;1
15816;Vieversys;NYKŠTUKAI;4051613934;Taip;5;0;0;5
15817;Vieversys;NYKŠTUKAI;8054640386;Ne;2;0;0;2
15818;Vieversys;NYKŠTUKAI;9812354315;Ne;10;0;0;10
15819;Vieversys;NYKŠTUKAI;1377293916;Ne;4;0;0;4
15820;Vieversys;NYKŠTUKAI;4482612962;Ne;16;0;0;16
15821;Vieversys;NYKŠTUKAI;6408198729;Ne;19;0;0;19
15822;Vieversys;DRUGELIAI;2638813853;Ne;6;0;2;8
15823;Vieversys;DRUGELIAI;6669012722;Ne;5;0;0;5
15824;Vieversys;DRUGELIAI;9813883328;Ne;4;0;0;4
15825;Vieversys;DRUGELIAI;7708807923;Ne;0;3;0;3
15826;Vieversys;DRUGELIAI;4129333932;Ne;5;1;0;6
15827;Vieversys;DRUGELIAI;6581002790;Ne;10;0;0;10
15828;Vieversys;DRUGELIAI;1720061988;Taip;3;1;0;4
15829;Vieversys;DRUGELIAI;6014448044;Ne;2;0;0;2
15830;Vieversys;DRUGELIAI;6222790462;Ne;1;0;0;1
15831;Vieversys;DRUGELIAI;1752390411;Taip;0;4;0;4
15832;Vieversys;DRUGELIAI;4743557459;Ne;13;0;0;13
15833;Vieversys;DRUGELIAI;9377014366;Ne;20;0;0;20
15834;Vieversys;DRUGELIAI;8595221658;Ne;10;0;0;10
15835;Žirmūnėliai;SAULUTĖS;5560694124;Ne;0;2;0;2
15836;Žirmūnėliai;SAULUTĖS;6116321928;Ne;5;0;0;5
15837;Žirmūnėliai;SAULUTĖS;2310523676;Ne;5;0;0;5
15838;Žirmūnėliai;SAULUTĖS;4922028935;Ne;2;0;0;2
15839;Žirmūnėliai;SAULUTĖS;4763350308;Ne;0;2;0;2
15840;Žirmūnėliai;SAULUTĖS;5626711530;Ne;0;11;0;11
15841;Žirmūnėliai;SAULUTĖS;3902161368;Ne;5;1;0;6
15842;Žirmūnėliai;SAULUTĖS;6072407337;Ne;5;0;0;5
15843;Žirmūnėliai;SAULUTĖS;4338673048;Ne;0;6;0;6
15844;Žirmūnėliai;SAULUTĖS;4793967980;Ne;5;0;0;5
15845;Žirmūnėliai;SAULUTĖS;8242112212;Ne;1;2;0;3
15846;Žirmūnėliai;SAULUTĖS;1940552890;Ne;3;0;0;3
15847;Žirmūnėliai;SAULUTĖS;2392106040;Ne;5;1;0;6
15848;Žirmūnėliai;SAULUTĖS;4343419766;Ne;0;1;0;1
15849;Žirmūnėliai;SAULUTĖS;9145626116;Ne;15;2;0;17
15850;Žirmūnėliai;SAULUTĖS;7675488865;Ne;4;1;0;5
15851;Žirmūnėliai;SAULUTĖS;8345632807;Ne;0;3;0;3
15852;Žirmūnėliai;SAULUTĖS;8592714547;Ne;5;2;0;7
15853;Žirmūnėliai;SAULUTĖS;4134541560;Ne;3;0;0;3
15854;Žirmūnėliai;SAULUTĖS;8481357052;Ne;6;0;0;6
15855;Žirmūnėliai;GILIUKAI;6430944858;Ne;5;0;0;5
15856;Žirmūnėliai;GILIUKAI;3562689670;Ne;0;1;0;1
15857;Žirmūnėliai;GILIUKAI;5929166560;Ne;1;2;0;3
15858;Žirmūnėliai;GILIUKAI;3767421827;Ne;10;0;0;10
15859;Žirmūnėliai;GILIUKAI;4327504033;Ne;0;8;0;8
15860;Žirmūnėliai;GILIUKAI;5104310002;Taip;5;2;0;7
15861;Žirmūnėliai;GILIUKAI;1025809131;Taip;0;1;0;1
15862;Žirmūnėliai;GILIUKAI;6899109664;Ne;0;1;0;1
15863;Žirmūnėliai;GILIUKAI;1791977446;Ne;0;1;0;1
15864;Žirmūnėliai;GILIUKAI;6875484657;Ne;0;10;0;10
15865;Žirmūnėliai;GILIUKAI;9871163622;Ne;0;0;1;1
15866;Žirmūnėliai;GILIUKAI;2959090234;Ne;1;3;0;4
15867;Žirmūnėliai;GILIUKAI;5486475468;Ne;0;0;1;1
15868;Žirmūnėliai;GILIUKAI;8618410295;Ne;11;0;0;11
15869;Žirmūnėliai;GILIUKAI;1941509002;Ne;3;0;3;6
15870;Žirmūnėliai;GILIUKAI;3646039695;Ne;0;2;0;2
15871;Žirmūnėliai;GILIUKAI;4807331877;Ne;0;0;10;10
15872;Žirmūnėliai;DRUGELIAI;2802717644;Ne;10;0;0;10
15873;Žirmūnėliai;DRUGELIAI;3029428022;Ne;7;1;0;8
15874;Žirmūnėliai;DRUGELIAI;5281338626;Ne;0;1;0;1
15875;Žirmūnėliai;DRUGELIAI;6892941066;Ne;2;1;0;3
15876;Žirmūnėliai;DRUGELIAI;9280663182;Ne;0;11;0;11
15877;Žirmūnėliai;DRUGELIAI;6427861912;Ne;5;0;0;5
15878;Žirmūnėliai;DRUGELIAI;2736632324;Ne;2;1;0;3
15879;Žirmūnėliai;DRUGELIAI;5892153807;Taip;12;1;0;13
15880;Žirmūnėliai;DRUGELIAI;2870069039;Ne;3;2;0;5
15881;Žirmūnėliai;DRUGELIAI;4291114238;Ne;0;2;0;2
15882;Žirmūnėliai;DRUGELIAI;3012945005;Taip;2;1;0;3
15883;Žirmūnėliai;DRUGELIAI;8782085662;Ne;0;2;0;2
15884;Žirmūnėliai;DRUGELIAI;4836165731;Ne;10;0;0;10
15885;Žirmūnėliai;DRUGELIAI;9472372819;Taip;3;0;0;3
15886;Žirmūnėliai;DRUGELIAI;3174613910;Ne;2;2;0;4
15887;Žirmūnėliai;DRUGELIAI;6812682361;Ne;7;0;0;7
15888;Žirmūnėliai;DRUGELIAI;5668266601;Ne;14;0;0;14
15889;Žirmūnėliai;DRUGELIAI;5616289290;Ne;5;1;0;6
15890;Žirmūnėliai;DRUGELIAI;9908958250;Taip;5;1;0;6
15891;Žirmūnėliai;BORUŽIUKAI;5316869112;Ne;2;0;0;2
15892;Žirmūnėliai;BORUŽIUKAI;6641667315;Ne;0;1;0;1
15893;Žirmūnėliai;BORUŽIUKAI;1356219744;Ne;2;2;0;4
15894;Žirmūnėliai;BORUŽIUKAI;2985092368;Ne;6;1;0;7
15895;Žirmūnėliai;BORUŽIUKAI;5736502380;Ne;0;1;0;1
15896;Žirmūnėliai;BORUŽIUKAI;9241738140;Ne;17;0;0;17
15897;Žirmūnėliai;BORUŽIUKAI;9378860669;Ne;2;0;0;2
15898;Žirmūnėliai;BORUŽIUKAI;8607934394;Ne;4;1;0;5
15899;Žirmūnėliai;BORUŽIUKAI;7422544482;Ne;3;0;0;3
15900;Žirmūnėliai;BORUŽIUKAI;4336415033;Taip;0;1;0;1
15901;Žirmūnėliai;BORUŽIUKAI;1473482823;Ne;1;0;0;1
15902;Žirmūnėliai;EŽIUKAI;7011701994;Ne;4;0;1;5
15903;Žirmūnėliai;EŽIUKAI;2661052835;Ne;6;4;0;10
15904;Žirmūnėliai;EŽIUKAI;1655437833;Ne;0;0;1;1
15905;Žirmūnėliai;EŽIUKAI;3640979388;Ne;10;2;0;12
15906;Žirmūnėliai;EŽIUKAI;6878528100;Ne;0;0;7;7
15907;Žirmūnėliai;EŽIUKAI;8440187348;Ne;5;1;0;6
15908;Žirmūnėliai;EŽIUKAI;4968278870;Ne;7;0;2;9
15909;Žirmūnėliai;EŽIUKAI;2693415717;Ne;5;1;0;6
15910;Žirmūnėliai;EŽIUKAI;7953019230;Ne;7;6;0;13
15911;Žirmūnėliai;EŽIUKAI;1832367936;Ne;0;0;2;2
15912;Žirmūnėliai;EŽIUKAI;3180116136;Ne;10;0;0;10
15913;Žirmūnėliai;EŽIUKAI;9759491055;Ne;0;6;0;6
15914;Žirmūnėliai;EŽIUKAI;1127214387;Ne;20;1;0;21
15915;Žirmūnėliai;EŽIUKAI;4101748829;Ne;0;4;0;4
15916;Žirmūnėliai;EŽIUKAI;2379638934;Ne;0;7;0;7
15917;Žirmūnėliai;EŽIUKAI;4710829908;Ne;0;3;0;3
15918;Žirmūnėliai;EŽIUKAI;7996709950;Ne;0;10;0;10
15919;Žirmūnėliai;EŽIUKAI;7580002502;Ne;15;0;1;16
15920;Žirmūnėliai;EŽIUKAI;4638575301;Ne;4;0;2;6
15921;Žirmūnėliai;EŽIUKAI;3310847619;Ne;2;0;0;2
15922;Žirmūnėliai;EŽIUKAI;1977798059;Ne;0;2;8;10
15923;Žirmūnėliai;EŽIUKAI;3458810185;Ne;0;1;0;1
15924;Žirmūnėliai;ŽVIRBLIUKAI;8627403283;Ne;2;0;0;2
15925;Žirmūnėliai;ŽVIRBLIUKAI;7020486370;Ne;0;5;0;5
15926;Žirmūnėliai;ŽVIRBLIUKAI;3449815783;Ne;0;2;0;2
15927;Žirmūnėliai;ŽVIRBLIUKAI;7892626521;Ne;0;9;0;9
15928;Žirmūnėliai;ŽVIRBLIUKAI;4778339658;Ne;0;1;0;1
15929;Žirmūnėliai;ŽVIRBLIUKAI;9541122034;Ne;5;0;0;5
15930;Žirmūnėliai;ŽVIRBLIUKAI;2837129621;Ne;5;0;0;5
15931;Žirmūnėliai;ŽVIRBLIUKAI;1273684243;Ne;0;0;3;3
15932;Žirmūnėliai;ŽVIRBLIUKAI;2971175236;Ne;0;2;0;2
15933;Žirmūnėliai;ŽVIRBLIUKAI;9154874729;Ne;2;0;0;2
15934;Žirmūnėliai;ŽVIRBLIUKAI;6594728970;Ne;0;2;0;2
15935;Žirmūnėliai;ŽVIRBLIUKAI;3795476732;Ne;17;0;0;17
15936;Žirmūnėliai;ŽVIRBLIUKAI;9732291476;Ne;3;0;0;3
15937;Žirmūnėliai;ŽVIRBLIUKAI;7087770068;Ne;0;4;0;4
15938;Žirmūnėliai;ŽVIRBLIUKAI;3431320961;Ne;0;1;0;1
15939;Žirmūnėliai;ŽVIRBLIUKAI;1571242696;Ne;0;2;0;2
15940;Žirmūnėliai;ŽVIRBLIUKAI;3766779594;Ne;0;3;0;3
15941;Žirmūnėliai;SPALVELĖS;6259368139;Ne;0;2;1;3
15942;Žirmūnėliai;SPALVELĖS;9306935083;Ne;13;0;0;13
15943;Žirmūnėliai;SPALVELĖS;9042509512;Ne;8;1;0;9
15944;Žirmūnėliai;SPALVELĖS;5076712824;Ne;0;3;0;3
15945;Žirmūnėliai;SPALVELĖS;8444883234;Ne;7;0;0;7
15946;Žirmūnėliai;SPALVELĖS;3977279181;Ne;0;2;0;2
15947;Žirmūnėliai;SPALVELĖS;8002655555;Ne;0;10;0;10
15948;Žirmūnėliai;SPALVELĖS;1116572386;Ne;6;0;0;6
15949;Žirmūnėliai;SPALVELĖS;1255294064;Ne;20;0;0;20
15950;Žirmūnėliai;SPALVELĖS;3520677404;Ne;9;0;0;9
15951;Žirmūnėliai;SPALVELĖS;5646794795;Ne;11;0;1;12
15952;Žirmūnėliai;SPALVELĖS;5901940160;Ne;8;0;0;8
15953;Žirmūnėliai;SPALVELĖS;4641264260;Ne;0;2;0;2
15954;Žirmūnėliai;SPALVELĖS;9858198555;Ne;0;3;0;3
15955;Žirmūnėliai;DEBESĖLIAI;6908512961;Ne;0;3;0;3
15956;Žirmūnėliai;DEBESĖLIAI;4347548125;Ne;20;0;0;20
15957;Žirmūnėliai;DEBESĖLIAI;3330603362;Ne;10;1;0;11
15958;Žirmūnėliai;DEBESĖLIAI;5440814849;Ne;0;2;1;3
15959;Žirmūnėliai;DEBESĖLIAI;7680479258;Ne;5;0;0;5
15960;Žirmūnėliai;DEBESĖLIAI;8136265008;Ne;0;17;0;17
15961;Žirmūnėliai;DEBESĖLIAI;7568228423;Ne;18;0;0;18
15962;Žirmūnėliai;DEBESĖLIAI;9813507899;Ne;9;0;0;9
15963;Žirmūnėliai;DEBESĖLIAI;8687642039;Ne;7;0;1;8
15964;Žirmūnėliai;DEBESĖLIAI;5982848146;Ne;12;0;0;12
15965;Žirmūnėliai;DEBESĖLIAI;5676730437;Ne;1;0;0;1
15966;Žirmūnėliai;DEBESĖLIAI;4653124134;Taip;3;0;0;3
15967;Žirmūnėliai;DEBESĖLIAI;4501490189;Ne;9;0;1;10
15968;Žirmūnėliai;DEBESĖLIAI;8239982682;Taip;8;0;0;8
15969;Žirmūnėliai;DEBESĖLIAI;6066212109;Ne;0;1;0;1
15970;Žirmūnėliai;DEBESĖLIAI;9759504463;Ne;5;0;0;5
15971;Žirmūnėliai;DEBESĖLIAI;5622319185;Ne;2;0;0;2
15972;Žirmūnėliai;DEBESĖLIAI;7053321410;Ne;11;0;0;11
15973;Žirmūnėliai;DEBESĖLIAI;8615363279;Ne;4;0;0;4
15974;Žirmūnėliai;VIŠČIUKAI;9688789802;Taip;4;0;0;4
15975;Žirmūnėliai;VIŠČIUKAI;2898177059;Taip;5;0;0;5
15976;Žirmūnėliai;VIŠČIUKAI;1512873821;Ne;12;0;0;12
15977;Žirmūnėliai;VIŠČIUKAI;5659912057;Taip;4;2;1;7
15978;Žirmūnėliai;VIŠČIUKAI;4019091254;Ne;3;0;0;3
15979;Žirmūnėliai;VIŠČIUKAI;3144841534;Ne;7;2;0;9
15980;Žirmūnėliai;VIŠČIUKAI;6640314231;Ne;9;0;0;9
15981;Žirmūnėliai;VIŠČIUKAI;7421097025;Ne;4;0;0;4
15982;Žirmūnėliai;VIŠČIUKAI;4464218112;Ne;16;0;0;16
15983;Žirmūnėliai;VIŠČIUKAI;7287108760;Ne;2;0;0;2
15984;Žirmūnėliai;VIŠČIUKAI;2353478333;Ne;0;6;0;6
15985;Žirmūnėliai;VIŠČIUKAI;4260032711;Ne;11;0;0;11
15986;Žirmūnėliai;VIŠČIUKAI;2821518346;Taip;4;0;0;4
15987;Žirmūnėliai;ZUIKUČIŲ;2074215403;Taip;15;1;0;16
15988;Žirmūnėliai;ZUIKUČIŲ;6122934687;Ne;0;0;2;2
15989;Žirmūnėliai;ZUIKUČIŲ;3560820710;Taip;4;0;1;5
15990;Žirmūnėliai;ZUIKUČIŲ;1582955541;Ne;0;2;0;2
15991;Žirmūnėliai;ZUIKUČIŲ;5772120262;Taip;0;0;13;13
15992;Žirmūnėliai;ZUIKUČIŲ;9448915252;Ne;0;0;16;16
15993;Žirmūnėliai;ZUIKUČIŲ;8526701525;Ne;0;2;0;2
15994;Žirmūnėliai;ZUIKUČIŲ;9953641492;Ne;10;1;0;11
15995;Žirmūnėliai;ZUIKUČIŲ;1498162175;Ne;10;1;0;11
15996;Žirmūnėliai;ZUIKUČIŲ;7232606752;Ne;6;0;0;6
15997;Žirmūnėliai;ZUIKUČIŲ;2857408011;Taip;0;0;1;1
15998;Žirmūnėliai;ZUIKUČIŲ;7771277342;Ne;8;0;0;8
15999;Žirmūnėliai;ZUIKUČIŲ;3825102173;Ne;3;0;0;3
16000;Žirmūnėliai;ZUIKUČIŲ;2069337771;Ne;0;0;7;7
16001;Žirmūnėliai;OBUOLIUKAI;4575123456;Ne;1;2;0;3
16002;Žirmūnėliai;OBUOLIUKAI;9002868728;Ne;7;0;0;7
16003;Žirmūnėliai;OBUOLIUKAI;2073922023;Taip;2;1;0;3
16004;Žirmūnėliai;OBUOLIUKAI;7059249540;Ne;3;1;0;4
16005;Žirmūnėliai;OBUOLIUKAI;4999561481;Ne;6;2;0;8
16006;Žirmūnėliai;OBUOLIUKAI;6358006462;Ne;0;2;0;2
16007;Žirmūnėliai;OBUOLIUKAI;2497258407;Ne;5;2;0;7
16008;Žirmūnėliai;OBUOLIUKAI;3949374730;Ne;0;0;1;1
16009;Žirmūnėliai;OBUOLIUKAI;6869102228;Ne;15;0;0;15
16010;Žirmūnėliai;OBUOLIUKAI;6450412481;Ne;0;5;0;5
16011;Žirmūnėliai;OBUOLIUKAI;9225654910;Ne;0;4;0;4
16012;Žirmūnėliai;OBUOLIUKAI;5483418311;Ne;7;0;0;7
16013;Žirmūnėliai;OBUOLIUKAI;8823426998;Taip;0;3;0;3
16014;Žirmūnėliai;OBUOLIUKAI;2263820829;Ne;2;0;2;4
16015;Žirmūnėliai;OBUOLIUKAI;9823124599;Ne;16;0;3;19
16016;Žirmūnėliai;DAINORĖLIAI;6397359786;Taip;0;1;0;1
16017;Žirmūnėliai;DAINORĖLIAI;3493835685;Ne;0;7;0;7
16018;Žirmūnėliai;DAINORĖLIAI;7113999217;Ne;16;0;2;18
16019;Žirmūnėliai;DAINORĖLIAI;9483005892;Ne;8;0;0;8
16020;Žirmūnėliai;DAINORĖLIAI;6258830302;Ne;0;1;0;1
16021;Žirmūnėliai;DAINORĖLIAI;5977682064;Ne;20;0;0;20
16022;Žirmūnėliai;DAINORĖLIAI;1162986139;Ne;9;0;0;9
16023;Žirmūnėliai;DAINORĖLIAI;9220007612;Ne;7;0;1;8
16024;Žirmūnėliai;DAINORĖLIAI;2991492176;Ne;0;0;2;2
16025;Žirmūnėliai;DAINORĖLIAI;4578525446;Ne;0;2;0;2
16026;Žirmūnėliai;DAINORĖLIAI;3319602277;Taip;0;1;0;1
16027;Žirmūnėliai;DAINORĖLIAI;5750554959;Ne;0;0;2;2
16028;Žirmūnėliai;DAINORĖLIAI;8512701905;Ne;6;0;0;6
16029;Žirmūnėliai;DAINORĖLIAI;6026141001;Ne;10;5;0;15
16030;"Dainorėliai (Ankštoji g. 11)";VARPELIAI;3094277796;Ne;3;0;0;3
16031;"Dainorėliai (Ankštoji g. 11)";VARPELIAI;2340411409;Ne;8;0;0;8
16032;"Dainorėliai (Ankštoji g. 11)";VARPELIAI;3205801143;Ne;2;0;0;2
16033;"Dainorėliai (Ankštoji g. 11)";VARPELIAI;6708318702;Ne;0;0;3;3
16034;"Dainorėliai (Ankštoji g. 11)";VARPELIAI;5326096582;Ne;0;2;0;2
16035;"Dainorėliai (Ankštoji g. 11)";VARPELIAI;4812986408;Ne;10;2;0;12
16036;"Dainorėliai (Ankštoji g. 11)";VARPELIAI;1822342787;Taip;0;2;0;2
16037;"Dainorėliai (Ankštoji g. 11)";VARPELIAI;6652070415;Ne;7;0;0;7
16038;"Dainorėliai (Ankštoji g. 11)";VARPELIAI;5098256007;Ne;3;0;0;3
16039;"Dainorėliai (Ankštoji g. 11)";VARPELIAI;5900613350;Ne;10;0;0;10
16040;"Dainorėliai (Ankštoji g. 11)";VARPELIAI;7476236758;Ne;3;0;0;3
16041;"Dainorėliai (Ankštoji g. 11)";VARPELIAI;4312828453;Ne;5;0;0;5
16042;"Dainorėliai (Ankštoji g. 11)";VARPELIAI;2732648440;Ne;16;0;3;19
16043;"Dainorėliai (Ankštoji g. 11)";VARPELIAI;1505858775;Ne;5;0;0;5
16044;"Dainorėliai (Ankštoji g. 11)";VARPELIAI;9612167901;Ne;16;0;3;19
16045;"Dainorėliai (Ankštoji g. 11)";VARPELIAI;6192380237;Ne;5;0;0;5
16046;"Dainorėliai (Ankštoji g. 11)";ŽIOGELIAI;5591598390;Ne;5;1;0;6
16047;"Dainorėliai (Ankštoji g. 11)";ŽIOGELIAI;2450726148;Ne;3;0;0;3
16048;"Dainorėliai (Ankštoji g. 11)";ŽIOGELIAI;5793828922;Ne;0;1;0;1
16049;"Dainorėliai (Ankštoji g. 11)";ŽIOGELIAI;7591953671;Ne;10;0;0;10
16050;"Dainorėliai (Ankštoji g. 11)";ŽIOGELIAI;3887433142;Ne;0;2;0;2
16051;"Dainorėliai (Ankštoji g. 11)";ŽIOGELIAI;2541781620;Ne;9;0;0;9
16052;"Dainorėliai (Ankštoji g. 11)";ŽIOGELIAI;7984447187;Ne;11;0;0;11
16053;"Dainorėliai (Ankštoji g. 11)";ŽIOGELIAI;4307634491;Ne;0;1;0;1
16054;"Dainorėliai (Ankštoji g. 11)";ŽIOGELIAI;3592770633;Ne;4;0;0;4
16055;"Dainorėliai (Ankštoji g. 11)";ŽIOGELIAI;3598951899;Ne;2;0;0;2
16056;"Dainorėliai (Ankštoji g. 11)";ŽIOGELIAI;4307634491;Ne;0;1;0;1
16057;"Dainorėliai (Ankštoji g. 11)";ŽIOGELIAI;3592770633;Ne;4;0;0;4
16058;"Dainorėliai (Ankštoji g. 11)";ŽIOGELIAI;3598951899;Ne;2;0;0;2
16059;"Dainorėliai (Ankštoji g. 11)";ŽIOGELIAI;4973241539;Ne;18;0;1;19
16060;"Dainorėliai (Ankštoji g. 11)";ŽIOGELIAI;8280877177;Ne;5;0;0;5
16061;"Dainorėliai (Ankštoji g. 11)";ŽIOGELIAI;2215481883;Ne;5;4;0;9
16062;"Dainorėliai (Ankštoji g. 11)";DRUGELIAI;6403389248;Ne;0;1;0;1
16063;"Dainorėliai (Ankštoji g. 11)";DRUGELIAI;4900234806;Ne;9;0;0;9
16064;"Dainorėliai (Ankštoji g. 11)";DRUGELIAI;2703267758;Ne;1;1;0;2
16065;"Dainorėliai (Ankštoji g. 11)";DRUGELIAI;6899629612;Ne;0;1;0;1
16066;"Dainorėliai (Ankštoji g. 11)";DRUGELIAI;2605119306;Ne;0;2;0;2
16067;"Dainorėliai (Ankštoji g. 11)";DRUGELIAI;9976869100;Ne;4;1;0;5
16068;"Dainorėliai (Ankštoji g. 11)";DRUGELIAI;3063825996;Ne;4;2;0;6
16069;"Dainorėliai (Ankštoji g. 11)";DRUGELIAI;5854379630;Ne;0;1;0;1
16070;"Dainorėliai (Ankštoji g. 11)";DRUGELIAI;3711954197;Ne;2;2;0;4
16071;"Dainorėliai (Ankštoji g. 11)";DRUGELIAI;8088948564;Ne;5;4;0;9
16072;"Dainorėliai (Ankštoji g. 11)";DRUGELIAI;2803571247;Ne;6;3;0;9
16073;"Dainorėliai (Ankštoji g. 11)";DRUGELIAI;1332165159;Ne;24;0;0;24
16074;"Dainorėliai (Ankštoji g. 11)";DRUGELIAI;8684975630;Ne;0;2;0;2
16075;"Dainorėliai (Ankštoji g. 11)";DRUGELIAI;2740773904;Ne;1;2;0;3
16076;"Dainorėliai (Ankštoji g. 11)";DRUGELIAI;7030974201;Ne;4;0;0;4
16077;"Dainorėliai (Ankštoji g. 11)";"1 klasė";88781762328;Ne;5;0;0;5
16078;"Dainorėliai (Ankštoji g. 11)";"1 klasė";5959380807;Ne;1;0;0;1
16079;"Dainorėliai (Ankštoji g. 11)";"1 klasė";7822546498;Ne;2;0;0;2
16080;"Dainorėliai (Ankštoji g. 11)";"1 klasė";9319771186;Ne;2;0;0;2
16081;"Dainorėliai (Ankštoji g. 11)";"1 klasė";6909583023;Ne;2;0;0;2
16082;"Dainorėliai (Ankštoji g. 11)";"1 klasė";9996171088;Ne;3;0;0;3
16083;"Dainorėliai (Ankštoji g. 11)";"1 klasė";7664689396;Ne;3;0;0;3
16084;"Dainorėliai (Ankštoji g. 11)";"1 klasė";2917508421;Ne;2;0;0;2
16085;"Dainorėliai (Ankštoji g. 11)";"1 klasė";2812688181;Ne;2;0;0;2
16086;"Dainorėliai (Ankštoji g. 11)";"1 klasė";18233813290;Ne;5;0;0;5
16087;"Dainorėliai (Ankštoji g. 11)";"1 klasė";2095914442;Ne;3;0;0;3
16088;"Dainorėliai (Ankštoji g. 11)";"1 klasė";4255893222;Ne;2;0;0;2
16089;"Dainorėliai (Ankštoji g. 11)";"1 klasė";1666616466;Ne;2;0;0;2
16090;"Dainorėliai (Ankštoji g. 11)";"1 klasė";1307749129;Ne;2;0;0;2
16091;"Dainorėliai (Ankštoji g. 11)";"1 klasė";1088248393;Ne;1;0;0;1
16092;"Dainorėliai (Ankštoji g. 11)";"1 klasė";2031800114;Ne;2;0;0;2
16093;"Dainorėliai (Ankštoji g. 11)";"1 klasė";65467351140;Ne;1;0;0;1
16094;"Dainorėliai (Ankštoji g. 11)";"1 klasė";87242570532;Ne;2;0;0;2
16095;"Dainorėliai (Ankštoji g. 11)";"1 klasė";5693385617;Ne;2;0;0;2
16096;"Dainorėliai (Ankštoji g. 11)";"1 klasė";9608529135;Ne;1;0;0;1
16097;"Dainorėliai (Ankštoji g. 11)";"1 klasė";3034686938;Ne;2;0;0;2
16098;"Dainorėliai (Ankštoji g. 11)";"2 klasė";2520667095;Ne;3;0;0;3
16099;"Dainorėliai (Ankštoji g. 11)";"2 klasė";50432354832;Ne;1;0;0;1
16100;"Dainorėliai (Ankštoji g. 11)";"2 klasė";73649870571;Ne;4;0;0;4
16101;"Dainorėliai (Ankštoji g. 11)";"2 klasė";1531362555;Ne;6;0;0;6
16102;"Dainorėliai (Ankštoji g. 11)";"2 klasė";73386013083;Ne;5;0;0;5
16103;"Dainorėliai (Ankštoji g. 11)";"2 klasė";27521381629;Ne;1;0;0;1
16104;"Dainorėliai (Ankštoji g. 11)";"2 klasė";53935690864;Ne;2;0;0;2
16105;"Dainorėliai (Ankštoji g. 11)";"2 klasė";2287353933;Ne;3;0;0;3
16106;"Dainorėliai (Ankštoji g. 11)";"2 klasė";86659723162;Ne;1;0;0;1
16107;"Dainorėliai (Ankštoji g. 11)";"2 klasė";6195426672;Ne;3;0;0;3
16108;"Dainorėliai (Ankštoji g. 11)";"2 klasė";94480397292;Ne;6;0;0;6
16109;"Dainorėliai (Ankštoji g. 11)";"2 klasė";49483881135;Ne;1;0;0;1
16110;"Dainorėliai (Ankštoji g. 11)";"2 klasė";1515552402;Ne;2;0;0;2
16111;"Dainorėliai (Ankštoji g. 11)";"2 klasė";1084400276;Ne;1;0;0;1
16112;"Dainorėliai (Ankštoji g. 11)";"2 klasė";1910653135;Ne;11;0;0;11
16113;"Dainorėliai (Ankštoji g. 11)";"3 klasė";1829858221;Ne;6;0;0;6
16114;"Dainorėliai (Ankštoji g. 11)";"3 klasė";1646521870;Ne;2;0;0;2
16115;"Dainorėliai (Ankštoji g. 11)";"3 klasė";29132059636;Ne;5;0;0;5
16116;"Dainorėliai (Ankštoji g. 11)";"3 klasė";32573583030;Ne;2;0;0;2
16117;"Dainorėliai (Ankštoji g. 11)";"3 klasė";97947842490;Ne;1;0;0;1
16118;"Dainorėliai (Ankštoji g. 11)";"3 klasė";18936645521;Ne;6;0;0;6
16119;"Dainorėliai (Ankštoji g. 11)";"3 klasė";6948863728;Ne;2;0;0;2
16120;"Dainorėliai (Ankštoji g. 11)";"3 klasė";35134511946;Ne;1;0;0;1
16121;"Dainorėliai (Ankštoji g. 11)";"3 klasė";33847164571;Ne;1;0;0;1
16122;"Dainorėliai (Ankštoji g. 11)";"4 klasė";42402953271;Ne;4;0;0;4
16123;"Dainorėliai (Ankštoji g. 11)";"4 klasė";34219208558;Ne;2;0;0;2
16124;"Dainorėliai (Ankštoji g. 11)";"4 klasė";2045625141;Ne;10;0;0;10
16125;"Dainorėliai (Ankštoji g. 11)";"4 klasė";2441164154;Ne;2;0;0;2
16126;"Dainorėliai (Ankštoji g. 11)";"4 klasė";69556449215;Ne;3;0;0;3
16127;"Dainorėliai (Ankštoji g. 11)";"4 klasė";8244355193;Ne;2;0;0;2
16128;"Dainorėliai (Ankštoji g. 11)";"4 klasė";2142553899;Ne;8;0;0;8
16129;"Dainorėliai (Ankštoji g. 11)";"4 klasė";13138644060;Ne;1;0;0;1
16130;"Dainorėliai (Ankštoji g. 11)";"4 klasė";98830139164;Ne;1;0;0;1
16131;"Dainorėliai (Ankštoji g. 11)";"4 klasė";18741625569;Ne;1;0;0;1
16132;"Dainorėliai (Ankštoji g. 11)";"4 klasė";47323045857;Ne;1;0;0;1
16133;"Dainorėliai (Ankštoji g. 11)";"4 klasė";65118883315;Ne;5;0;0;5
16134;"Dainorėliai (Ankštoji g. 11)";"4 klasė";69732047046;Ne;4;0;0;4
16135;"Dainorėliai (Ankštoji g. 11)";SAULUTĖS;8857018998;Ne;2;0;0;2
16136;"Dainorėliai (Ankštoji g. 11)";SAULUTĖS;6385439136;Ne;1;0;0;1
16137;"Dainorėliai (Ankštoji g. 11)";SAULUTĖS;1552829080;Ne;1;0;0;1
16138;"Dainorėliai (Ankštoji g. 11)";SAULUTĖS;5410183494;Ne;10;0;0;10
16139;"Dainorėliai (Ankštoji g. 11)";SAULUTĖS;5587907483;Ne;12;0;0;12
16140;"Dainorėliai (Ankštoji g. 11)";SAULUTĖS;2064843848;Ne;3;0;0;3
16141;"Dainorėliai (Ankštoji g. 11)";SAULUTĖS;5687390372;Ne;5;0;0;5
16142;"Dainorėliai (Ankštoji g. 11)";SAULUTĖS;7804441689;Ne;6;0;0;6
16143;"Dainorėliai (Ankštoji g. 11)";SAULUTĖS;4431804759;Ne;5;0;0;5
16144;"Dainorėliai (Ankštoji g. 11)";SAULUTĖS;6697149560;Ne;11;0;0;11
16145;"Dainorėliai (Ankštoji g. 11)";SAULUTĖS;3762178533;Ne;10;0;0;10
16146;"Dainorėliai (Ankštoji g. 11)";SAULUTĖS;8857018998;Ne;2;0;0;2
16147;"Dainorėliai (Ankštoji g. 11)";SAULUTĖS;6697149560;Ne;11;0;0;11
16148;"Dainorėliai (Ankštoji g. 11)";SAULUTĖS;4079711515;Taip;4;0;0;4
16149;"Dainorėliai (Ankštoji g. 11)";SAULUTĖS;4969782237;Ne;7;0;0;7
16150;Lokiukas;BITUTĖS;4551069961;Ne;0;2;0;2
16151;Lokiukas;BITUTĖS;5217458476;Ne;5;3;0;8
16152;Lokiukas;BITUTĖS;6260486656;Ne;0;8;0;8
16153;Lokiukas;BITUTĖS;9480025132;Ne;2;1;0;3
16154;Lokiukas;BITUTĖS;8334800302;Ne;0;5;0;5
16155;Lokiukas;BITUTĖS;6883994020;Ne;7;0;0;7
16156;Lokiukas;BITUTĖS;1987485885;Ne;0;2;0;2
16157;Lokiukas;BITUTĖS;5794303981;Ne;10;3;0;13
16158;Lokiukas;BITUTĖS;2671053309;Taip;4;1;0;5
16159;Lokiukas;BITUTĖS;1647778939;Ne;7;0;0;7
16160;Lokiukas;BITUTĖS;8994257898;Ne;0;2;0;2
16161;Lokiukas;BITUTĖS;8378138411;Taip;5;0;0;5
16162;Lokiukas;BITUTĖS;8656751314;Ne;0;1;0;1
16163;Lokiukas;BITUTĖS;2181315008;Ne;5;0;0;5
16164;Lokiukas;BITUTĖS;3896883842;Ne;2;0;0;2
16165;Lokiukas;BITUTĖS;1376124245;Ne;0;20;0;20
16166;Lokiukas;BITUTĖS;7920238202;Ne;0;5;0;5
16167;Lokiukas;BITUTĖS;3329205450;Ne;0;4;0;4
16168;Lokiukas;BITUTĖS;2051644210;Ne;5;0;0;5
16169;Lokiukas;"1 B klasė";1210407640;Ne;3;0;0;3
16170;Lokiukas;"1 B klasė";1733486244;Ne;6;0;0;6
16171;Lokiukas;"1 B klasė";6336140882;Ne;3;0;0;3
16172;Lokiukas;"1 B klasė";1188049956;Ne;3;0;0;3
16173;Lokiukas;"1 B klasė";5446430319;Ne;3;0;0;3
16174;Lokiukas;"1 B klasė";35364823312;Ne;1;0;0;1
16175;Lokiukas;"1 B klasė";1620856143;Ne;3;0;0;3
16176;Lokiukas;"1 B klasė";1604886863;Ne;4;0;0;4
16177;Lokiukas;"1 B klasė";4024866819;Ne;7;0;0;7
16178;Lokiukas;"1 B klasė";5275588088;Ne;1;0;0;1
16179;Lokiukas;"1 B klasė";67972824332;Ne;4;0;0;4
16180;Lokiukas;"1 A klasė";2642065594;Ne;1;0;0;1
16181;Lokiukas;"1 A klasė";6069516217;Ne;2;0;0;2
16182;Lokiukas;"1 A klasė";7943213321;Ne;5;0;0;5
16183;Lokiukas;"1 A klasė";3694653020;Ne;2;0;0;2
16184;Lokiukas;"1 A klasė";8902619265;Ne;2;0;0;2
16185;Lokiukas;"1 A klasė";1040288021;Ne;1;0;0;1
16186;Lokiukas;"1 A klasė";8286358519;Ne;6;0;0;6
16187;Lokiukas;"1 A klasė";9336617879;Ne;2;0;0;2
16188;Lokiukas;"1 A klasė";1886540733;Ne;4;0;0;4
16189;Lokiukas;"1 A klasė";3843999609;Ne;2;0;0;2
16190;Lokiukas;"1 A klasė";1898004894;Ne;1;0;0;1
16191;Lokiukas;"1 A klasė";4985243068;Ne;5;0;0;5
16192;Lokiukas;"1 A klasė";7623203279;Taip;2;0;0;2
16193;Lokiukas;"1 A klasė";7623203279;Taip;2;0;0;2
16194;Lokiukas;GUDRUČIAI;3930463578;Ne;7;0;0;7
16195;Lokiukas;GUDRUČIAI;4919744559;Ne;2;0;0;2
16196;Lokiukas;GUDRUČIAI;9354491312;Ne;2;0;0;2
16197;Lokiukas;GUDRUČIAI;6091878190;Ne;1;0;0;1
16198;Lokiukas;GUDRUČIAI;7208757038;Ne;3;0;0;3
16199;Lokiukas;GUDRUČIAI;4660479216;Ne;1;0;0;1
16200;Lokiukas;GUDRUČIAI;1049009199;Ne;0;1;0;1
16201;Lokiukas;GUDRUČIAI;8440973450;Ne;2;0;0;2
16202;Lokiukas;GUDRUČIAI;8481539433;Taip;1;0;0;1
16203;Lokiukas;GUDRUČIAI;3411390558;Ne;0;6;0;6
16204;Lokiukas;BORUŽĖLĖS;5473316050;Taip;4;1;0;5
16205;Lokiukas;BORUŽĖLĖS;2266747745;Ne;18;0;0;18
16206;Lokiukas;BORUŽĖLĖS;8758248334;Ne;10;0;0;10
16207;Lokiukas;BORUŽĖLĖS;9673257342;Ne;5;0;0;5
16208;Lokiukas;BORUŽĖLĖS;3015119335;Ne;5;0;0;5
16209;Lokiukas;BORUŽĖLĖS;1756658146;Ne;4;0;0;4
16210;Lokiukas;BORUŽĖLĖS;4417116107;Ne;8;0;0;8
16211;Lokiukas;BORUŽĖLĖS;3849212461;Ne;16;0;0;16
16212;Lokiukas;BORUŽĖLĖS;3668903653;Ne;2;0;0;2
16213;Lokiukas;BORUŽĖLĖS;2466354050;Ne;0;1;0;1
16214;Lokiukas;BORUŽĖLĖS;6827710384;Ne;9;0;0;9
16215;Lokiukas;BORUŽĖLĖS;5843699073;Ne;4;0;0;4
16216;Lokiukas;BORUŽĖLĖS;7955048052;Ne;11;0;0;11
16217;Lokiukas;BORUŽĖLĖS;8144936688;Ne;11;0;0;11
16218;Lokiukas;BORUŽĖLĖS;2999594131;Ne;4;0;0;4
16219;Lokiukas;BORUŽĖLĖS;8420913680;Taip;20;0;0;20
16220;Lokiukas;BORUŽĖLĖS;8139809541;Taip;10;1;0;11
16221;Lokiukas;BORUŽĖLĖS;2754009962;Ne;2;0;0;2
16222;Lokiukas;BORUŽĖLĖS;3383354228;Ne;11;0;0;11
16223;Lokiukas;ANČIUKAI;5944620142;Ne;6;0;0;6
16224;Lokiukas;ANČIUKAI;9253014845;Ne;10;1;1;12
16225;Lokiukas;ANČIUKAI;2323620627;Ne;10;1;1;12
16226;Lokiukas;ANČIUKAI;3452792650;Ne;5;0;0;5
16227;Lokiukas;ANČIUKAI;7147146400;Ne;7;1;0;8
16228;Lokiukas;ANČIUKAI;7991284293;Ne;0;20;0;20
16229;Lokiukas;ANČIUKAI;1243077419;Ne;0;20;0;20
16230;Lokiukas;ANČIUKAI;1027917827;Taip;0;20;0;20
16231;Lokiukas;ANČIUKAI;1741109639;Ne;0;20;0;20
16232;Lokiukas;ANČIUKAI;6944809045;Ne;5;0;1;6
16233;Lokiukas;ANČIUKAI;5785049399;Ne;0;1;0;1
16234;Lokiukas;KODĖLČIUKAI;8630112458;Ne;1;0;0;1
16235;Lokiukas;KODĖLČIUKAI;8576418875;Ne;10;3;0;13
16236;Lokiukas;KODĖLČIUKAI;6869785650;Ne;0;4;0;4
16237;Lokiukas;KODĖLČIUKAI;2625981190;Ne;7;0;0;7
16238;Lokiukas;KODĖLČIUKAI;5401463671;Ne;3;1;0;4
16239;Lokiukas;KODĖLČIUKAI;9798351980;Ne;0;2;0;2
16240;Lokiukas;KODĖLČIUKAI;1170293017;Ne;6;1;0;7
16241;Lokiukas;KODĖLČIUKAI;9996442005;Ne;3;1;0;4
16242;Lokiukas;KODĖLČIUKAI;4317453894;Ne;3;0;0;3
16243;Lokiukas;KODĖLČIUKAI;7426579018;Ne;4;0;0;4
16244;Lokiukas;KODĖLČIUKAI;1724976098;Ne;0;1;1;2
16245;Lokiukas;KODĖLČIUKAI;3733581089;Ne;1;3;0;4
16246;Lokiukas;KODĖLČIUKAI;1076719080;Taip;10;1;0;11
16247;Lokiukas;KODĖLČIUKAI;6102196040;Ne;0;1;0;1
16248;Lokiukas;KODĖLČIUKAI;9779789133;Ne;0;1;0;1
16249;Lokiukas;KODĖLČIUKAI;9266061396;Ne;5;0;0;5
16250;Lokiukas;KODĖLČIUKAI;5353687011;Taip;0;1;0;1
16251;Lokiukas;DRUGELIAI;4858829710;Ne;0;0;2;2
16252;Lokiukas;DRUGELIAI;4206181176;Ne;0;2;0;2
16253;Lokiukas;DRUGELIAI;4442073527;Ne;0;2;0;2
16254;Lokiukas;DRUGELIAI;2021477393;Ne;2;1;0;3
16255;Lokiukas;DRUGELIAI;7532603655;Ne;0;2;0;2
16256;Lokiukas;DRUGELIAI;7006828256;Ne;4;0;0;4
16257;Lokiukas;DRUGELIAI;8596706753;Ne;4;3;0;7
16258;Lokiukas;DRUGELIAI;4197547631;Ne;6;1;0;7
16259;Lokiukas;DRUGELIAI;8266708371;Ne;2;0;0;2
16260;Lokiukas;DRUGELIAI;6226281752;Ne;2;1;0;3
16261;Lokiukas;DRUGELIAI;2374601283;Ne;0;3;0;3
16262;Lokiukas;DRUGELIAI;1390586527;Ne;12;0;0;12
16263;Lokiukas;DRUGELIAI;2093224908;Ne;5;0;0;5
16264;Lokiukas;DRUGELIAI;1341265560;Ne;5;2;0;7
16265;Lokiukas;DRUGELIAI;5131662172;Ne;2;0;0;2
16266;Lokiukas;DRUGELIAI;4284574166;Ne;6;0;3;9
16267;Lokiukas;DRUGELIAI;1913742619;Ne;3;0;0;3
16268;Lokiukas;DRUGELIAI;4521556853;Ne;3;1;0;4
16269;Lokiukas;DRUGELIAI;5092095494;Ne;16;0;0;16
16270;Lokiukas;"2 A klasė";1626698185;Ne;6;0;0;6
16271;Lokiukas;"2 A klasė";69364831994;Ne;6;0;0;6
16272;Lokiukas;"2 A klasė";74169282323;Ne;5;0;0;5
16273;Lokiukas;"2 A klasė";1625137322;Ne;1;0;0;1
16274;Lokiukas;"2 A klasė";35890122494;Ne;2;0;0;2
16275;Lokiukas;"2 A klasė";8270572748;Ne;1;0;0;1
16276;Lokiukas;"2 A klasė";3825101647;Ne;20;0;0;20
16277;Lokiukas;"2 A klasė";8618280811;Taip;20;0;0;20
16278;Lokiukas;"2 A klasė";8323172347;Ne;2;0;0;2
16279;Lokiukas;"2 A klasė";3004895246;Ne;20;0;0;20
16280;Lokiukas;"2 A klasė";56069293343;Ne;1;0;0;1
16281;Lokiukas;"2 B klasė";14605095801;Ne;7;0;0;7
16282;Lokiukas;"2 B klasė";8568285232;Ne;1;0;0;1
16283;Lokiukas;"2 B klasė";5453470660;Ne;1;0;0;1
16284;Lokiukas;"2 B klasė";8036643654;Ne;2;0;0;2
16285;Lokiukas;"2 B klasė";4427448272;Ne;20;0;0;20
16286;Lokiukas;"2 B klasė";2673522432;Ne;20;0;0;20
16287;Lokiukas;"2 B klasė";8399364170;Ne;11;0;0;11
16288;Lokiukas;"2 B klasė";2476231041;Ne;1;0;0;1
16289;Lokiukas;"2 B klasė";5943583254;Ne;1;0;0;1
16290;Lokiukas;"2 B klasė";5437008837;Ne;2;0;0;2
16291;Lokiukas;"2 B klasė";97284171512;Ne;3;0;0;3
16292;Lokiukas;"2 B klasė";3070998871;Ne;4;0;0;4
16293;Lokiukas;"2 B klasė";20659573470;Ne;20;0;0;20
16294;Lokiukas;"2 B klasė";8943496964;Ne;20;0;0;20
16295;Lokiukas;"2 B klasė";3505492809;Ne;1;0;0;1
16296;Lokiukas;"3 A klasė";83086633109;Ne;1;0;0;1
16297;Lokiukas;"3 A klasė";131300206;Ne;6;0;0;6
16298;Lokiukas;"3 A klasė";82025637099;Ne;4;0;0;4
16299;Lokiukas;"3 A klasė";73515179103;Ne;4;0;0;4
16300;Lokiukas;"3 A klasė";8240261104;Ne;1;0;0;1
16301;Lokiukas;"3 A klasė";67133709394;Ne;1;0;0;1
16302;Lokiukas;"3 A klasė";52940830874;Ne;1;0;0;1
16303;Lokiukas;"3 A klasė";38884246104;Ne;1;0;0;1
16304;Lokiukas;"3 A klasė";2502465398;Ne;2;0;0;2
16305;Lokiukas;"3 A klasė";9890308887;Ne;2;0;0;2
16306;Lokiukas;"3 A klasė";51237034253;Ne;1;0;0;1
16307;Lokiukas;"3 A klasė";4989577303;Ne;7;0;0;7
16308;Lokiukas;"3 A klasė";1106442860;Ne;2;0;0;2
16309;Lokiukas;"3 A klasė";1224477393;Ne;1;0;0;1
16310;Lokiukas;"3 B klasė";51059574159;Ne;1;0;0;1
16311;Lokiukas;"3 B klasė";32714964224;Ne;1;0;0;1
16312;Lokiukas;"3 B klasė";2959877846;Ne;20;0;0;20
16313;Lokiukas;"3 B klasė";57505829630;Ne;1;0;0;1
16314;Lokiukas;"3 B klasė";1072148409;Ne;5;0;0;5
16315;Lokiukas;"3 B klasė";7130407913;Ne;6;0;0;6
16316;Lokiukas;"3 B klasė";7235277422;Ne;20;0;0;20
16317;Lokiukas;"3 B klasė";2054450461;Ne;2;0;0;2
16318;Lokiukas;"3 B klasė";4662981914;Ne;3;0;0;3
16319;Lokiukas;"3 B klasė";6414861823;Ne;20;0;0;20
16320;Lokiukas;"3 B klasė";98045145204;Ne;20;0;0;20
16321;Lokiukas;"3 B klasė";68390568000;Ne;3;0;0;3
16322;Lokiukas;"3 B klasė";40006848965;Ne;1;0;0;1
16323;Lokiukas;"3 B klasė";3255141230;Ne;18;0;0;18
16324;Lokiukas;"3 B klasė";3255141230;Ne;18;0;0;18
16325;Lokiukas;"3 B klasė";38001876942;Ne;2;0;0;2
16326;Lokiukas;"4 A klasė";15406362908;Ne;1;0;0;1
16327;Lokiukas;"4 A klasė";45122233067;Ne;6;0;0;6
16328;Lokiukas;"4 A klasė";10948160841;Ne;20;0;0;20
16329;Lokiukas;"4 A klasė";21802863853;Ne;1;0;0;1
16330;Lokiukas;"4 A klasė";22979689191;Ne;4;0;0;4
16331;Lokiukas;"4 A klasė";80754592972;Ne;2;0;0;2
16332;Lokiukas;"4 A klasė";14903100496;Ne;1;0;0;1
16333;Lokiukas;"4 A klasė";4608275224;Ne;3;0;0;3
16334;Lokiukas;"4 A klasė";99706061553;Ne;1;0;0;1
16335;Lokiukas;"4 A klasė";7785940412;Ne;3;0;0;3
16336;Lokiukas;"4 A klasė";72092394330;Ne;1;0;0;1
16337;Lokiukas;"4 A klasė";35769782473;Ne;20;0;0;20
16338;Lokiukas;"4 A klasė";38531751377;Ne;1;0;0;1
16339;Lokiukas;"4 A klasė";59840033826;Ne;2;0;0;2
16340;Lokiukas;"4 A klasė";80793623068;Ne;1;0;0;1
16341;Lokiukas;"4 A klasė";43070670534;Ne;1;0;0;1
16342;Lokiukas;"4 A klasė";5198408183;Ne;3;0;0;3
16343;Lokiukas;"4 A klasė";24099693663;Ne;20;0;0;20
16344;Lokiukas;"4 A klasė";9747265775;Ne;20;0;0;20
16345;Lokiukas;"4 A klasė";93374754851;Ne;2;0;0;2
16346;Lokiukas;"4 A klasė";25170045140;Ne;20;0;0;20
16347;Lokiukas;"4 A klasė";15685936471;Ne;1;0;0;1
16348;Lokiukas;"4 A klasė";97609897018;Taip;2;0;0;2
16349;Lokiukas;"4 A klasė";15574258138;Ne;2;0;0;2
16350;Lokiukas;"4 A klasė";9077016953;Ne;3;0;0;3
16351;Lokiukas;"4 A klasė";24523198513;Ne;20;0;0;20
16352;Lokiukas;"4 A klasė";29577495646;Ne;5;0;0;5
16353;Lokiukas;"4 B klasė";32506466236;Ne;4;0;0;4
16354;Lokiukas;"4 B klasė";7324496782;Ne;5;0;0;5
16355;Lokiukas;"4 B klasė";10811780420;Ne;5;0;0;5
16356;Lokiukas;"4 B klasė";28796727185;Ne;20;0;0;20
16357;Lokiukas;"4 B klasė";88415635113;Ne;12;0;0;12
16358;Lokiukas;"4 B klasė";95910336503;Ne;4;0;0;4
16359;Lokiukas;"4 B klasė";7903535850;Ne;4;0;0;4
16360;Lokiukas;"4 B klasė";7497324442;Ne;20;0;0;20
16361;Lokiukas;"4 B klasė";96046361641;Ne;3;0;0;3
16362;Lokiukas;"4 B klasė";61890775725;Ne;12;0;0;12
16363;Lokiukas;"4 B klasė";24221829774;Ne;8;0;0;8
16364;Lokiukas;"4 B klasė";58513885211;Ne;6;0;0;6
16365;Lokiukas;"4 B klasė";50713289266;Ne;6;0;0;6
16366;Lokiukas;"4 B klasė";20231469825;Ne;3;0;0;3
16367;Lokiukas;"4 B klasė";1146878499;Ne;1;0;0;1
16368;Lokiukas;"4 B klasė";9141446821;Ne;4;0;0;4
16369;Lokiukas;"4 B klasė";75507005694;Ne;4;0;0;4
16370;Lokiukas;"4 B klasė";73426072972;Ne;10;0;0;10
16371;Lokiukas;"4 B klasė";59913848400;Ne;7;0;0;7
16372;Lokiukas;"4 B klasė";62268017779;Ne;1;0;0;1
16373;Lokiukas;"4 B klasė";2105377652;Ne;2;0;0;2
16374;Lokiukas;"4 B klasė";39867459515;Ne;12;0;0;12
16375;Lokiukas;"4 B klasė";5311341721;Ne;20;0;0;20
16376;Lokiukas;"4 B klasė";9516336072;Ne;6;0;0;6
16377;Šaltinėlis;Ančiukų;3901200729;Ne;10;0;0;10
16378;Šaltinėlis;Ančiukų;1312785137;Taip;1;1;0;2
16379;Šaltinėlis;Ančiukų;9209105445;Ne;5;5;0;10
16380;Šaltinėlis;Ančiukų;9112527921;Ne;4;0;0;4
16381;Šaltinėlis;Ančiukų;9398488555;Ne;3;0;0;3
16382;Šaltinėlis;Ančiukų;2027779524;Ne;0;6;0;6
16383;Šaltinėlis;Ančiukų;5498764523;Ne;2;0;0;2
16384;Šaltinėlis;Ančiukų;4226929875;Ne;14;0;0;14
16385;Šaltinėlis;Ančiukų;5005394548;Ne;6;5;0;11
16386;Šaltinėlis;Ančiukų;1102861619;Taip;0;0;1;1
16387;Šaltinėlis;Ančiukų;1928794692;Ne;2;2;0;4
16388;Šaltinėlis;Ančiukų;1742421427;Ne;9;0;0;9
16389;Šaltinėlis;Ančiukų;9581384663;Ne;8;0;0;8
16390;Šaltinėlis;Ančiukų;9465174636;Ne;0;7;0;7
16391;Šaltinėlis;Ančiukų;5455997139;Ne;4;0;0;4
16392;Šaltinėlis;Ančiukų;9588260206;Ne;10;1;0;11
16393;Šaltinėlis;Ančiukų;8116985061;Ne;0;20;0;20
16394;Šaltinėlis;Ančiukų;6371994202;Ne;13;0;0;13
16395;Šaltinėlis;Ančiukų;6244924079;Ne;0;1;0;1
16396;Šaltinėlis;Ančiukų;3806267811;Ne;0;2;0;2
16397;Šaltinėlis;Bitučių;7311831014;Ne;2;1;0;3
16398;Šaltinėlis;Bitučių;5854723120;Ne;0;8;0;8
16399;Šaltinėlis;Bitučių;1678450741;Ne;0;1;0;1
16400;Šaltinėlis;Bitučių;5833136956;Ne;2;1;0;3
16401;Šaltinėlis;Bitučių;5799032398;Ne;10;0;0;10
16402;Šaltinėlis;Bitučių;5525740049;Ne;6;0;0;6
16403;Šaltinėlis;Bitučių;5343279219;Ne;7;0;0;7
16404;Šaltinėlis;Bitučių;7118672118;Ne;5;0;0;5
16405;Šaltinėlis;Bitučių;8950694484;Ne;6;0;0;6
16406;Šaltinėlis;Bitučių;2465009553;Ne;5;0;0;5
16407;Šaltinėlis;Bitučių;5382567842;Ne;1;0;0;1
16408;Šaltinėlis;Bitučių;4681460322;Ne;6;0;0;6
16409;Šaltinėlis;Bitučių;3968514430;Ne;0;5;0;5
16410;Šaltinėlis;Bitučių;6721510313;Ne;4;0;0;4
16411;Šaltinėlis;Bitučių;1978469605;Ne;5;0;0;5
16412;Šaltinėlis;Bitučių;5774391181;Ne;2;0;0;2
16413;Šaltinėlis;Bitučių;2499890317;Ne;4;0;0;4
16414;Šaltinėlis;Bitučių;7650840990;Ne;8;0;0;8
16415;Šaltinėlis;Bitučių;5345738219;Ne;5;0;0;5
16416;Šaltinėlis;Bitučių;3579974049;Ne;0;5;0;5
16417;Šaltinėlis;Bitučių;4743907195;Ne;6;0;0;6
16418;Šaltinėlis;Bitučių;1287205292;Ne;5;0;0;5
16419;Šaltinėlis;Bitučių;7973137015;Ne;8;0;0;8
16420;Šaltinėlis;Bitučių;7519967594;Ne;3;0;0;3
16421;Šaltinėlis;Bitučių;3017437426;Ne;6;0;0;6
16422;Šaltinėlis;Bitučių;9983153464;Ne;4;0;0;4
16423;Šaltinėlis;Saulutės;3159555258;Ne;8;3;0;11
16424;Šaltinėlis;Saulutės;8258039377;Ne;5;0;0;5
16425;Šaltinėlis;Saulutės;5871681602;Ne;11;0;0;11
16426;Šaltinėlis;Saulutės;3448242910;Ne;0;3;0;3
16427;Šaltinėlis;Saulutės;6109197821;Ne;5;0;0;5
16428;Šaltinėlis;Saulutės;8439306703;Ne;3;0;0;3
16429;Šaltinėlis;Saulutės;3505001330;Ne;6;2;0;8
16430;Šaltinėlis;Saulutės;8973369897;Ne;3;2;0;5
16431;Šaltinėlis;Saulutės;6145605567;Ne;7;4;0;11
16432;Šaltinėlis;Saulutės;3780870805;Ne;0;1;0;1
16433;Šaltinėlis;Saulutės;2157520281;Ne;5;4;0;9
16434;Šaltinėlis;Saulutės;8995954572;Ne;0;7;0;7
16435;Šaltinėlis;Saulutės;5996579651;Ne;10;0;0;10
16436;Šaltinėlis;Saulutės;9613234759;Ne;0;1;0;1
16437;Šaltinėlis;Saulutės;9218436977;Ne;3;3;0;6
16438;Šaltinėlis;Meškiukų;6645807642;Ne;7;1;0;8
16439;Šaltinėlis;Meškiukų;9759912102;Ne;5;0;0;5
16440;Šaltinėlis;Meškiukų;4664741207;Ne;7;1;0;8
16441;Šaltinėlis;Meškiukų;1400918201;Ne;10;0;0;10
16442;Šaltinėlis;Meškiukų;1656674673;Ne;4;3;0;7
16443;Šaltinėlis;Meškiukų;4248763165;Ne;2;6;0;8
16444;Šaltinėlis;Meškiukų;5982018366;Ne;10;0;0;10
16445;Šaltinėlis;Meškiukų;9922223978;Ne;13;0;0;13
16446;Šaltinėlis;Meškiukų;8995077908;Taip;8;0;0;8
16447;Šaltinėlis;Meškiukų;5982188743;Ne;4;0;0;4
16448;Šaltinėlis;Meškiukų;6586783795;Ne;7;0;0;7
16449;Šaltinėlis;Meškiukų;7468640592;Taip;4;0;0;4
16450;Šaltinėlis;Meškiukų;4064231806;Ne;5;0;0;5
16451;Šaltinėlis;Meškiukų;6688536661;Ne;2;0;0;2
16452;Šaltinėlis;Meškiukų;8880659539;Ne;6;2;0;8
16453;Šaltinėlis;Meškiukų;3228788999;Ne;4;0;0;4
16454;Šaltinėlis;Meškiukų;5905345563;Ne;4;0;0;4
16455;Šaltinėlis;Meškiukų;2332065937;Ne;1;0;0;1
16456;Šaltinėlis;Meškiukų;4936982698;Ne;7;0;0;7
16457;Šaltinėlis;Nykštukai;9766640995;Ne;7;0;2;9
16458;Šaltinėlis;Nykštukai;3356138058;Ne;12;0;0;12
16459;Šaltinėlis;Nykštukai;5434349511;Taip;10;0;1;11
16460;Šaltinėlis;Nykštukai;2976773344;Ne;3;0;0;3
16461;Šaltinėlis;Nykštukai;3687243030;Ne;4;6;0;10
16462;Šaltinėlis;Nykštukai;4364256563;Ne;7;0;0;7
16463;Šaltinėlis;Nykštukai;9333013048;Taip;0;0;1;1
16464;Šaltinėlis;Nykštukai;4029616063;Ne;11;0;0;11
16465;Šaltinėlis;Nykštukai;6530797082;Ne;2;0;0;2
16466;Šaltinėlis;Nykštukai;7534585887;Taip;11;0;0;11
16467;Šaltinėlis;Nykštukai;8977029692;Ne;5;2;0;7
16468;Šaltinėlis;Nykštukai;3497881408;Ne;0;11;0;11
16469;Šaltinėlis;Nykštukai;6383844995;Ne;5;0;0;5
16470;Šaltinėlis;Nykštukai;1441937630;Ne;5;0;0;5
16471;Šaltinėlis;Nykštukai;4742849747;Ne;0;1;0;1
16472;Šaltinėlis;Nykštukai;1496105338;Ne;3;0;1;4
16473;Šaltinėlis;Nykštukai;7432957835;Ne;7;0;0;7
16474;Šaltinėlis;Nykštukai;1468854968;Ne;0;3;0;3
16475;Šaltinėlis;Perliukų;2825412170;Ne;4;0;0;4
16476;Šaltinėlis;Perliukų;1686009371;Ne;18;0;0;18
16477;Šaltinėlis;Perliukų;7068058767;Ne;8;0;0;8
16478;Šaltinėlis;Perliukų;2189112609;Ne;8;0;0;8
16479;Šaltinėlis;Perliukų;8914777163;Ne;0;6;0;6
16480;Šaltinėlis;Perliukų;7387221265;Ne;5;0;0;5
16481;Šaltinėlis;Perliukų;9674923143;Ne;0;4;0;4
16482;Šaltinėlis;Perliukų;3073692882;Ne;0;2;0;2
16483;Šaltinėlis;Perliukų;5325974488;Ne;2;0;0;2
16484;Šaltinėlis;Perliukų;2126751248;Ne;10;0;0;10
16485;Šaltinėlis;Perliukų;3271931810;Ne;11;0;0;11
16486;Šaltinėlis;Perliukų;7955094634;Ne;2;0;0;2
16487;Šaltinėlis;Perliukų;1445108285;Ne;5;0;0;5
16488;Šaltinėlis;Perliukų;7133044918;Ne;8;0;0;8
16489;Šaltinėlis;Perliukų;2806453623;Ne;4;0;0;4
16490;Šaltinėlis;Perliukų;8695191968;Ne;1;0;0;1
16491;Šaltinėlis;Perliukų;4430546695;Ne;1;0;0;1
16492;Šaltinėlis;BORUŽĖLĖS;2222188915;Ne;7;0;0;7
16493;Šaltinėlis;BORUŽĖLĖS;8289348049;Ne;6;0;0;6
16494;Šaltinėlis;BORUŽĖLĖS;1012869495;Ne;6;0;0;6
16495;Šaltinėlis;BORUŽĖLĖS;7007255432;Ne;14;0;0;14
16496;Šaltinėlis;BORUŽĖLĖS;2704220005;Ne;9;0;0;9
16497;Šaltinėlis;BORUŽĖLĖS;7074953363;Ne;11;0;0;11
16498;Šaltinėlis;BORUŽĖLĖS;1283839856;Ne;6;0;0;6
16499;Šaltinėlis;BORUŽĖLĖS;4754031495;Ne;10;0;0;10
16500;Šaltinėlis;BORUŽĖLĖS;8806353914;Ne;8;1;0;9
16501;Šaltinėlis;BORUŽĖLĖS;5943247739;Ne;11;0;0;11
16502;Šaltinėlis;BORUŽĖLĖS;9258088219;Ne;3;0;0;3
16503;Šaltinėlis;BORUŽĖLĖS;4825400376;Ne;3;0;0;3
16504;Šaltinėlis;BORUŽĖLĖS;8979939577;Ne;4;0;0;4
16505;Šaltinėlis;BORUŽĖLĖS;2053262491;Ne;8;0;0;8
16506;Šaltinėlis;BORUŽĖLĖS;6553155860;Ne;15;0;0;15
16507;Šaltinėlis;"4B klasė";93256161233;Ne;0;1;0;1
16508;Šaltinėlis;"4B klasė";83173349544;Ne;0;1;0;1
16509;Šaltinėlis;"4B klasė";39088869084;Ne;0;3;0;3
16510;Šaltinėlis;"4B klasė";7711903999;Ne;0;2;0;2
16511;Šaltinėlis;"4B klasė";3072314714;Ne;0;2;0;2
16512;Šaltinėlis;"4B klasė";1220687492;Ne;0;1;0;1
16513;Šaltinėlis;"4B klasė";74337710550;Ne;0;3;0;3
16514;Šaltinėlis;"4B klasė";19630605543;Ne;0;3;0;3
16515;Šaltinėlis;"4B klasė";3626545396;Ne;0;4;0;4
16516;Šaltinėlis;"4B klasė";4762756751;Ne;0;1;0;1
16517;Šaltinėlis;"4B klasė";72372808270;Ne;0;1;0;1
16518;Šaltinėlis;"4B klasė";1924418657;Ne;0;2;0;2
16519;Šaltinėlis;"4B klasė";77194317310;Ne;0;2;0;2
16520;Šaltinėlis;"4B klasė";57847832778;Ne;0;2;0;2
16521;Šaltinėlis;"4B klasė";2099800744;Ne;0;2;0;2
16522;Šaltinėlis;"4B klasė";70315400705;Ne;0;3;0;3
16523;Šaltinėlis;"4B klasė";81082410620;Ne;0;3;0;3
16524;Šaltinėlis;1A;8500790262;Ne;0;3;0;3
16525;Šaltinėlis;1A;9362495172;Ne;0;2;0;2
16526;Šaltinėlis;1A;2973820849;Ne;0;10;0;10
16527;Šaltinėlis;1A;7737797979;Ne;0;1;0;1
16528;Šaltinėlis;1A;9820788524;Ne;0;20;0;20
16529;Šaltinėlis;1A;2084451705;Ne;0;4;0;4
16530;Šaltinėlis;"2A klasė";1580090516;Ne;0;1;0;1
16531;Šaltinėlis;"2A klasė";2105963102;Ne;0;1;0;1
16532;Šaltinėlis;"2A klasė";3582666579;Ne;0;5;0;5
16533;Šaltinėlis;"2A klasė";46569341613;Ne;0;2;0;2
16534;Šaltinėlis;"2A klasė";52142182972;Ne;0;20;0;20
16535;Šaltinėlis;"2A klasė";6880337593;Ne;0;4;0;4
16536;Šaltinėlis;"2A klasė";9188065549;Ne;0;3;0;3
16537;Šaltinėlis;"2A klasė";3516760367;Ne;0;3;0;3
16538;Šaltinėlis;"2A klasė";1910670134;Ne;0;1;0;1
16539;Šaltinėlis;"2A klasė";9595350871;Ne;0;1;0;1
16540;Šaltinėlis;"2A klasė";8902634958;Ne;0;5;0;5
16541;Šaltinėlis;"2A klasė";9757246434;Ne;0;4;0;4
16542;Šaltinėlis;"2A klasė";7262120071;Ne;0;3;0;3
16543;Šaltinėlis;"2B klasė";6068980312;Ne;0;3;0;3
16544;Šaltinėlis;"2B klasė";9425353041;Ne;0;1;0;1
16545;Šaltinėlis;"2B klasė";17147527171;Ne;0;20;0;20
16546;Šaltinėlis;"2B klasė";1716801722;Ne;0;10;0;10
16547;Šaltinėlis;"2B klasė";2333071711;Ne;0;4;0;4
16548;Šaltinėlis;"2B klasė";23301579810;Ne;0;20;0;20
16549;Šaltinėlis;"2B klasė";526307704;Ne;0;2;0;2
16550;Šaltinėlis;"2B klasė";1958647188;Ne;0;4;0;4
16551;Šaltinėlis;"2B klasė";1583520894;Ne;0;7;0;7
16552;Šaltinėlis;"2B klasė";11083638216;Ne;0;1;0;1
16553;Šaltinėlis;"3A klasė";32264290873;Ne;0;2;0;2
16554;Šaltinėlis;"3A klasė";1767635282;Ne;0;4;0;4
16555;Šaltinėlis;"3A klasė";1390316465;Ne;0;2;0;2
16556;Šaltinėlis;"3A klasė";1658370782;Ne;0;1;0;1
16557;Šaltinėlis;"3A klasė";3455754351;Ne;0;20;0;20
16558;Šaltinėlis;"3A klasė";66575684640;Ne;0;2;0;2
16559;Šaltinėlis;"3A klasė";86592374576;Ne;0;20;0;20
16560;Šaltinėlis;"3A klasė";1614411921;Ne;0;2;0;2
16561;Šaltinėlis;"3A klasė";79406746980;Ne;0;2;0;2
16562;Šaltinėlis;"3A klasė";1224027643;Ne;0;3;0;3
16563;Šaltinėlis;"3A klasė";48525545812;Ne;0;4;0;4
16564;Šaltinėlis;"3A klasė";3022926855;Ne;0;8;0;8
16565;Šaltinėlis;"3A klasė";1190394855;Ne;0;1;0;1
16566;Šaltinėlis;"3A klasė";32949623652;Ne;0;2;0;2
16567;Šaltinėlis;"4A klasė";14213856824;Ne;0;1;0;1
16568;Šaltinėlis;"4A klasė";84656960510;Ne;0;20;0;20
16569;Šaltinėlis;"4A klasė";83621946293;Ne;0;20;0;20
16570;Šaltinėlis;"4A klasė";67808618878;Ne;0;20;0;20
16571;Šaltinėlis;"4A klasė";9647785988;Ne;0;2;0;2
16572;Šaltinėlis;"4A klasė";82671662416;Ne;0;8;0;8
16573;Šaltinėlis;"4A klasė";54025577281;Taip;0;3;0;3
16574;Šaltinėlis;"4A klasė";54753218491;Ne;0;1;0;1
16575;Šaltinėlis;"4A klasė";86029472773;Ne;0;1;0;1
16576;Šaltinėlis;"4A klasė";64821172553;Ne;0;2;0;2
16577;Šaltinėlis;"4A klasė";5744976843;Ne;0;5;0;5
16578;Šaltinėlis;"4A klasė";25459069972;Ne;0;1;0;1
16579;Šaltinėlis;"4A klasė";89358384113;Ne;0;1;0;1
16580;Šaltinėlis;1B;3660687688;Ne;0;2;0;2
16581;Šaltinėlis;1B;1348724947;Ne;0;20;0;20
16582;Šaltinėlis;1B;2230403251;Ne;0;1;0;1
16583;Šaltinėlis;1B;4387568448;Ne;0;1;0;1
16584;Šaltinėlis;1B;2658414287;Ne;0;3;0;3
16585;Šaltinėlis;1B;7918995181;Taip;0;2;0;2
16586;Šaltinėlis;1B;3638565578;Ne;0;1;0;1
16587;Šaltinėlis;1B;1367082230;Ne;0;1;0;1
16588;Šaltinėlis;1B;5869977541;Ne;0;1;0;1
16589;Šaltinėlis;1B;5099997904;Ne;0;1;0;1
16590;Šaltinėlis;1B;8721116918;Ne;0;1;0;1
16591;Šaltinėlis;1B;3609939325;Ne;0;1;0;1
16592;Šaltinėlis;1B;7211267255;Ne;0;1;0;1
16593;Šaltinėlis;1B;9108653045;Ne;0;1;0;1
16594;Šaltinėlis;1B;6816346946;Ne;0;1;0;1
16595;Šaltinėlis;1B;5495098615;Ne;0;1;0;1
16596;Šaltinėlis;1B;9762392403;Ne;0;3;0;3
16597;Gabijėlė;GANDRIUKŲ;4498088417;Ne;10;0;1;11
16598;Gabijėlė;GANDRIUKŲ;2277489032;Ne;3;0;0;3
16599;Gabijėlė;GANDRIUKŲ;8994076883;Ne;3;0;0;3
16600;Gabijėlė;GANDRIUKŲ;5057272847;Ne;0;0;6;6
16601;Gabijėlė;GANDRIUKŲ;3532989398;Ne;2;0;0;2
16602;Gabijėlė;GANDRIUKŲ;2215880644;Ne;1;0;5;6
16603;Gabijėlė;GANDRIUKŲ;3799003783;Ne;2;0;0;2
16604;Gabijėlė;GANDRIUKŲ;6004026516;Ne;0;5;0;5
16605;Gabijėlė;GANDRIUKŲ;9706026832;Ne;5;1;0;6
16606;Gabijėlė;GANDRIUKŲ;2491503656;Ne;0;6;0;6
16607;Gabijėlė;GANDRIUKŲ;8904768332;Taip;0;0;2;2
16608;Gabijėlė;GANDRIUKŲ;5715645968;Ne;0;0;2;2
16609;Gabijėlė;GANDRIUKŲ;5054419205;Ne;5;5;0;10
16610;Gabijėlė;GANDRIUKŲ;9929652398;Ne;0;1;1;2
16611;Gabijėlė;GANDRIUKŲ;7530976246;Ne;0;0;1;1
16612;Gabijėlė;GANDRIUKŲ;2682112101;Ne;0;1;0;1
16613;Gabijėlė;GANDRIUKŲ;5312189552;Ne;2;1;0;3
16614;Gabijėlė;LAKŠTINGALIUKŲ;5862882027;Ne;6;0;0;6
16615;Gabijėlė;LAKŠTINGALIUKŲ;8035360208;Ne;0;6;0;6
16616;Gabijėlė;LAKŠTINGALIUKŲ;8167646385;Ne;2;0;1;3
16617;Gabijėlė;LAKŠTINGALIUKŲ;8926268619;Ne;11;0;1;12
16618;Gabijėlė;LAKŠTINGALIUKŲ;9480021589;Ne;0;2;0;2
16619;Gabijėlė;LAKŠTINGALIUKŲ;3215569531;Ne;0;1;0;1
16620;Gabijėlė;LAKŠTINGALIUKŲ;9116943443;Taip;0;1;3;4
16621;Gabijėlė;LAKŠTINGALIUKŲ;7444385669;Ne;9;0;0;9
16622;Gabijėlė;LAKŠTINGALIUKŲ;9491327802;Ne;5;0;0;5
16623;Gabijėlė;LAKŠTINGALIUKŲ;2550300871;Ne;0;1;0;1
16624;Gabijėlė;LAKŠTINGALIUKŲ;9324498850;Ne;6;2;1;9
16625;Gabijėlė;LAKŠTINGALIUKŲ;8314088016;Ne;0;1;0;1
16626;Gabijėlė;LAKŠTINGALIUKŲ;6295299651;Ne;0;1;0;1
16627;Gabijėlė;LAKŠTINGALIUKŲ;9694544564;Ne;0;4;3;7
16628;Gabijėlė;ŽVIRBLIUKŲ;7043775905;Taip;1;1;0;2
16629;Gabijėlė;ŽVIRBLIUKŲ;4475530177;Ne;0;0;1;1
16630;Gabijėlė;ŽVIRBLIUKŲ;7410541320;Ne;5;4;0;9
16631;Gabijėlė;ŽVIRBLIUKŲ;4493192224;Ne;2;0;0;2
16632;Gabijėlė;ŽVIRBLIUKŲ;3268231136;Ne;0;9;0;9
16633;Gabijėlė;ŽVIRBLIUKŲ;5942625633;Ne;0;0;2;2
16634;Gabijėlė;ŽVIRBLIUKŲ;3155403180;Ne;5;0;1;6
16635;Gabijėlė;ŽVIRBLIUKŲ;1158461185;Ne;5;0;1;6
16636;Gabijėlė;ŽVIRBLIUKŲ;8823299212;Ne;3;1;2;6
16637;Gabijėlė;ŽVIRBLIUKŲ;8879972953;Ne;5;0;2;7
16638;Gabijėlė;ŽVIRBLIUKŲ;9627906252;Taip;7;1;0;8
16639;Gabijėlė;ŽVIRBLIUKŲ;6674038058;Ne;0;1;0;1
16640;Gabijėlė;ŽVIRBLIUKŲ;1273722177;Ne;2;0;3;5
16641;Gabijėlė;ŽVIRBLIUKŲ;6154378055;Ne;0;1;0;1
16642;Gabijėlė;ŽVIRBLIUKŲ;9259673720;Taip;0;1;1;2
16643;Gabijėlė;GENIUKŲ;4827797140;Ne;0;7;0;7
16644;Gabijėlė;GENIUKŲ;6931780900;Taip;0;2;0;2
16645;Gabijėlė;GENIUKŲ;2030555139;Ne;8;1;0;9
16646;Gabijėlė;GENIUKŲ;7261932151;Taip;1;0;0;1
16647;Gabijėlė;GENIUKŲ;2539692903;Ne;2;0;0;2
16648;Gabijėlė;GENIUKŲ;6923511443;Ne;0;6;0;6
16649;Gabijėlė;GENIUKŲ;8384795164;Ne;2;0;0;2
16650;Gabijėlė;GENIUKŲ;3209491491;Taip;0;2;0;2
16651;Gabijėlė;GENIUKŲ;8185042446;Taip;2;0;0;2
16652;Gabijėlė;GENIUKŲ;9413654318;Ne;5;0;0;5
16653;Gabijėlė;GENIUKŲ;4664011011;Ne;5;0;0;5
16654;Gabijėlė;GENIUKŲ;4490619514;Ne;9;0;0;9
16655;Gabijėlė;GENIUKŲ;1021920133;Taip;9;0;0;9
16656;Gabijėlė;GENIUKŲ;1345747441;Taip;13;0;0;13
16657;Gabijėlė;GENIUKŲ;7597037953;Ne;5;0;0;5
16658;Gabijėlė;GENIUKŲ;6469409776;Ne;5;15;0;20
16659;Gabijėlė;GENIUKŲ;6539078572;Ne;0;6;0;6
16660;Gabijėlė;GENIUKŲ;7509112343;Ne;4;1;0;5
16661;Gabijėlė;DAGILIUKŲ;9348393550;Ne;0;2;0;2
16662;Gabijėlė;DAGILIUKŲ;4264925447;Ne;0;2;0;2
16663;Gabijėlė;DAGILIUKŲ;9120107749;Ne;6;0;0;6
16664;Gabijėlė;DAGILIUKŲ;4462129182;Ne;0;1;0;1
16665;Gabijėlė;DAGILIUKŲ;9503639471;Ne;0;0;3;3
16666;Gabijėlė;DAGILIUKŲ;1988597157;Ne;10;0;0;10
16667;Gabijėlė;DAGILIUKŲ;9895518740;Ne;10;0;0;10
16668;Gabijėlė;DAGILIUKŲ;9449023766;Ne;0;1;0;1
16669;Gabijėlė;DAGILIUKŲ;1455856766;Ne;0;0;2;2
16670;Gabijėlė;DAGILIUKŲ;6438144206;Taip;0;0;2;2
16671;Gabijėlė;DAGILIUKŲ;8662914262;Ne;0;6;0;6
16672;Gabijėlė;DAGILIUKŲ;9280283478;Ne;3;1;0;4
16673;Gabijėlė;DAGILIUKŲ;2254104149;Ne;0;1;0;1
16674;Gabijėlė;DAGILIUKŲ;8078326688;Ne;0;0;1;1
16675;Gabijėlė;DAGILIUKŲ;2386980295;Ne;0;0;4;4
16676;Gabijėlė;DAGILIUKŲ;9581539166;Ne;0;0;4;4
16677;Gabijėlė;DAGILIUKŲ;3548399391;Ne;0;0;7;7
16678;Gabijėlė;DAGILIUKŲ;4328252445;Ne;0;1;0;1
16679;Gabijėlė;DAGILIUKŲ;9893869150;Ne;2;1;0;3
16680;Gabijėlė;PELEDŽIUKŲ;4170105224;Ne;4;4;0;8
16681;Gabijėlė;PELEDŽIUKŲ;5675574534;Ne;5;0;0;5
16682;Gabijėlė;PELEDŽIUKŲ;5163460269;Ne;2;0;1;3
16683;Gabijėlė;PELEDŽIUKŲ;1356830225;Ne;0;0;2;2
16684;Gabijėlė;PELEDŽIUKŲ;9265103627;Ne;1;0;0;1
16685;Gabijėlė;PELEDŽIUKŲ;9451897367;Ne;17;0;0;17
16686;Gabijėlė;PELEDŽIUKŲ;2128428173;Ne;2;0;0;2
16687;Gabijėlė;PELEDŽIUKŲ;7028670164;Ne;0;0;5;5
16688;Gabijėlė;PELEDŽIUKŲ;5481472116;Ne;1;0;0;1
16689;Gabijėlė;PELEDŽIUKŲ;5869580147;Ne;0;0;2;2
16690;Gabijėlė;PELEDŽIUKŲ;7096789623;Ne;0;0;1;1
16691;Gabijėlė;PELEDŽIUKŲ;4724322463;Ne;0;7;0;7
16692;Gabijėlė;PELEDŽIUKŲ;1810898809;Taip;0;0;1;1
16693;Gabijėlė;PELEDŽIUKŲ;5801792404;Ne;20;0;0;20
16694;Gabijėlė;PELEDŽIUKŲ;5579070948;Ne;0;1;0;1
16695;Gabijėlė;PELEDŽIUKŲ;1076369632;Ne;12;0;0;12
16696;Gabijėlė;PELEDŽIUKŲ;8549800358;Ne;3;0;0;3
16697;Gabijėlė;PELEDŽIUKŲ;8133131896;Ne;4;0;0;4
16698;Gabijėlė;PELEDŽIUKŲ;2048046055;Ne;5;0;0;5
16699;Gabijėlė;PELEDŽIUKŲ;8088806507;Ne;0;7;0;7
16700;Gabijėlė;PELEDŽIUKŲ;6728495961;Ne;10;0;0;10
16701;Gabijėlė;KREGZDŽIUKŲ;5407565441;Taip;0;0;1;1
16702;Gabijėlė;KREGZDŽIUKŲ;9683202312;Ne;0;0;1;1
16703;Gabijėlė;KREGZDŽIUKŲ;2357515455;Ne;10;0;0;10
16704;Gabijėlė;KREGZDŽIUKŲ;1574272380;Ne;10;6;0;16
16705;Gabijėlė;KREGZDŽIUKŲ;9675186834;Ne;14;0;1;15
16706;Gabijėlė;KREGZDŽIUKŲ;4317708029;Ne;0;9;0;9
16707;Gabijėlė;KREGZDŽIUKŲ;8555272917;Ne;0;4;0;4
16708;Gabijėlė;KREGZDŽIUKŲ;3584692524;Ne;0;1;2;3
16709;Gabijėlė;KREGZDŽIUKŲ;8613821848;Ne;8;1;0;9
16710;Gabijėlė;KREGZDŽIUKŲ;7038167942;Ne;0;9;0;9
16711;Gabijėlė;KREGZDŽIUKŲ;9528783892;Ne;0;10;0;10
16712;Gabijėlė;KREGZDŽIUKŲ;9358478209;Ne;0;0;1;1
16713;Gabijėlė;KREGZDŽIUKŲ;9030890792;Ne;8;0;0;8
16714;Gabijėlė;KREGZDŽIUKŲ;3031333199;Ne;3;0;0;3
16715;Gabijėlė;KREGZDŽIUKŲ;9116153981;Ne;3;1;0;4
16716;Gabijėlė;KREGZDŽIUKŲ;4575230225;Ne;9;1;0;10
16717;Gabijėlė;ZYLIUKŲ;7700700293;Taip;7;0;2;9
16718;Gabijėlė;ZYLIUKŲ;6759447513;Ne;0;7;2;9
16719;Gabijėlė;ZYLIUKŲ;1090635644;Ne;3;0;0;3
16720;Gabijėlė;ZYLIUKŲ;2764185879;Ne;3;0;3;6
16721;Gabijėlė;ZYLIUKŲ;6463161337;Ne;0;0;2;2
16722;Gabijėlė;ZYLIUKŲ;7921467223;Ne;4;0;1;5
16723;Gabijėlė;ZYLIUKŲ;6562965816;Ne;3;0;0;3
16724;Gabijėlė;ZYLIUKŲ;4376486874;Ne;0;0;2;2
16725;Gabijėlė;ZYLIUKŲ;7047606048;Ne;4;0;0;4
16726;Gabijėlė;ZYLIUKŲ;6983092888;Ne;3;0;0;3
16727;Gabijėlė;ZYLIUKŲ;4267803371;Ne;0;4;1;5
16728;Gabijėlė;ZYLIUKŲ;8362509831;Ne;0;0;1;1
16729;Gabijėlė;ZYLIUKŲ;4907669556;Ne;0;9;0;9
16730;Gabijėlė;ZYLIUKŲ;1947898190;Ne;8;4;0;12
16731;Gabijėlė;ZYLIUKŲ;2384174631;Taip;0;0;5;5
16732;Gabijėlė;ZYLIUKŲ;3181607628;Ne;3;0;0;3
16733;Gabijėlė;ZYLIUKŲ;5736012194;Taip;17;0;0;17
16734;Gabijėlė;ZYLIUKŲ;4712780337;Ne;5;2;0;7
16735;Gabijėlė;ZYLIUKŲ;1004297369;Ne;5;0;1;6
16736;Gabijėlė;ZYLIUKŲ;7180444215;Ne;0;0;3;3
16737;Gabijėlė;ZYLIUKŲ;6446842432;Ne;4;0;1;5
16738;Gabijėlė;VOLUNGĖLIŲ;2099510027;Ne;6;0;0;6
16739;Gabijėlė;VOLUNGĖLIŲ;6842537434;Ne;0;3;0;3
16740;Gabijėlė;VOLUNGĖLIŲ;6956030813;Ne;6;1;0;7
16741;Gabijėlė;VOLUNGĖLIŲ;3763595874;Ne;3;1;0;4
16742;Gabijėlė;VOLUNGĖLIŲ;4580305437;Ne;0;3;0;3
16743;Gabijėlė;VOLUNGĖLIŲ;5737066080;Ne;8;0;0;8
16744;Gabijėlė;VOLUNGĖLIŲ;6643563560;Ne;0;2;0;2
16745;Gabijėlė;VOLUNGĖLIŲ;8569742033;Ne;0;1;0;1
16746;Gabijėlė;VOLUNGĖLIŲ;8327903800;Ne;9;0;0;9
16747;Gabijėlė;VOLUNGĖLIŲ;6960725029;Ne;8;0;0;8
16748;Gabijėlė;ANČIUKŲ;2107898976;Ne;13;1;0;14
16749;Gabijėlė;ANČIUKŲ;4000838897;Ne;4;1;0;5
16750;Gabijėlė;ANČIUKŲ;5060265729;Taip;3;0;1;4
16751;Gabijėlė;ANČIUKŲ;3972933727;Taip;4;1;0;5
16752;Gabijėlė;ANČIUKŲ;9657713903;Ne;1;0;0;1
16753;Gabijėlė;ANČIUKŲ;4087903129;Ne;0;3;0;3
16754;Gabijėlė;ANČIUKŲ;2398441433;Ne;10;0;0;10
16755;Gabijėlė;ANČIUKŲ;7049399327;Taip;1;0;0;1
16756;Gabijėlė;ANČIUKŲ;8611258788;Ne;0;1;2;3
16757;Gabijėlė;ANČIUKŲ;8834028360;Taip;2;1;0;3
16758;Gabijėlė;ANČIUKŲ;1002680245;Ne;6;1;0;7
16759;Gabijėlė;ANČIUKŲ;6393256426;Ne;5;1;0;6
16760;Gabijėlė;ANČIUKŲ;4692161807;Ne;1;0;0;1
16761;Gabijėlė;ANČIUKŲ;6040818549;Ne;7;0;0;7
16762;Gabijėlė;ANČIUKŲ;6481368028;Taip;17;0;0;17
16763;Gabijėlė;ANČIUKŲ;7590725504;Ne;0;5;0;5
16764;Gabijėlė;ANČIUKŲ;1230236612;Ne;10;0;0;10
16765;Gabijėlė;ANČIUKŲ;6850461646;Ne;0;0;1;1
16766;Gabijėlė;ANČIUKŲ;1525969706;Ne;5;0;0;5
16767;Gabijėlė;ANČIUKŲ;5310270057;Taip;0;1;0;1
16768;Gabijėlė;BALANDŽIUKŲ;3652632748;Ne;1;0;0;1
16769;Gabijėlė;BALANDŽIUKŲ;8514099621;Ne;2;0;0;2
16770;Gabijėlė;BALANDŽIUKŲ;6795173519;Ne;2;0;0;2
16771;Gabijėlė;BALANDŽIUKŲ;6748378606;Ne;5;1;0;6
16772;Gabijėlė;BALANDŽIUKŲ;7558307454;Ne;0;3;0;3
16773;Gabijėlė;BALANDŽIUKŲ;1612957739;Ne;3;0;0;3
16774;Gabijėlė;BALANDŽIUKŲ;8388297947;Ne;2;0;0;2
16775;Gabijėlė;BALANDŽIUKŲ;7888013969;Taip;2;0;0;2
16776;Gabijėlė;BALANDŽIUKŲ;3011163947;Ne;2;0;0;2
16777;Gabijėlė;BALANDŽIUKŲ;5788152675;Ne;12;0;0;12
16778;Gabijėlė;BALANDŽIUKŲ;6296983654;Ne;0;6;0;6
16779;Gabijėlė;BALANDŽIUKŲ;7224216275;Taip;3;0;0;3
16780;Gabijėlė;BALANDŽIUKŲ;7447079902;Ne;2;0;0;2
16781;Gabijėlė;BALANDŽIUKŲ;2289016022;Ne;4;0;0;4
16782;Gabijėlė;BALANDŽIUKŲ;8965185578;Ne;5;0;0;5
16783;Gabijėlė;VYTURIUKŲ;6131649116;Ne;3;0;1;4
16784;Gabijėlė;VYTURIUKŲ;8461048184;Ne;3;0;0;3
16785;Gabijėlė;VYTURIUKŲ;7894667201;Ne;4;0;1;5
16786;Gabijėlė;VYTURIUKŲ;3960795412;Ne;7;0;0;7
16787;Gabijėlė;VYTURIUKŲ;3973977318;Ne;3;0;0;3
16788;Gabijėlė;VYTURIUKŲ;9628900843;Ne;0;0;2;2
16789;Gabijėlė;VYTURIUKŲ;5652244967;Ne;5;4;0;9
16790;Gabijėlė;VYTURIUKŲ;3343196830;Ne;4;0;0;4
16791;Gabijėlė;VYTURIUKŲ;1523190444;Ne;2;0;0;2
16792;Gabijėlė;VYTURIUKŲ;7295985579;Ne;7;0;0;7
16793;Gabijėlė;VYTURIUKŲ;6834871835;Ne;7;0;0;7
16794;Gabijėlė;VYTURIUKŲ;8749080961;Ne;4;0;0;4
16795;Gabijėlė;VYTURIUKŲ;1185216449;Ne;1;0;0;1
16796;Gabijėlė;VYTURIUKŲ;6107630313;Ne;5;0;0;5
16797;Gabijėlė;VYTURIUKŲ;4248856615;Ne;8;1;0;9
16798;"Pilaitukas (I. Kanto al. 7A)";BITUTĖS;8943142551;Ne;4;2;0;6
16799;"Pilaitukas (I. Kanto al. 7A)";BITUTĖS;6225968272;Ne;4;2;0;6
16800;"Pilaitukas (I. Kanto al. 7A)";BITUTĖS;5904710385;Ne;4;2;0;6
16801;"Pilaitukas (I. Kanto al. 7A)";BITUTĖS;1486895496;Ne;8;0;0;8
16802;"Pilaitukas (I. Kanto al. 7A)";BITUTĖS;1746050808;Ne;0;1;0;1
16803;"Pilaitukas (I. Kanto al. 7A)";BITUTĖS;9441608677;Ne;2;0;0;2
16804;"Pilaitukas (I. Kanto al. 7A)";BITUTĖS;7555601497;Ne;2;0;0;2
16805;"Pilaitukas (I. Kanto al. 7A)";BITUTĖS;5979852431;Ne;2;1;0;3
16806;"Pilaitukas (I. Kanto al. 7A)";BITUTĖS;9950619644;Ne;10;0;0;10
16807;"Pilaitukas (I. Kanto al. 7A)";BITUTĖS;2633256935;Ne;7;0;0;7
16808;"Pilaitukas (I. Kanto al. 7A)";BITUTĖS;8747053041;Ne;7;1;0;8
16809;"Pilaitukas (I. Kanto al. 7A)";BITUTĖS;6271751691;Ne;6;0;0;6
16810;"Pilaitukas (I. Kanto al. 7A)";BITUTĖS;9306169443;Ne;0;1;0;1
16811;"Pilaitukas (I. Kanto al. 7A)";BITUTĖS;1568651642;Ne;7;0;0;7
16812;"Pilaitukas (I. Kanto al. 7A)";BITUTĖS;5155899628;Ne;6;1;0;7
16813;"Pilaitukas (I. Kanto al. 7A)";BITUTĖS;5340877261;Ne;6;1;0;7
16814;"Pilaitukas (I. Kanto al. 7A)";BITUTĖS;6064545501;Ne;8;0;0;8
16815;"Pilaitukas (I. Kanto al. 7A)";BITUTĖS;3751157025;Ne;9;1;0;10
16816;"Pilaitukas (I. Kanto al. 7A)";ZUIKUČIAI;4383174356;Ne;1;0;0;1
16817;"Pilaitukas (I. Kanto al. 7A)";ZUIKUČIAI;4118652467;Ne;10;1;0;11
16818;"Pilaitukas (I. Kanto al. 7A)";ZUIKUČIAI;1841240800;Ne;2;2;0;4
16819;"Pilaitukas (I. Kanto al. 7A)";ZUIKUČIAI;4710865219;Ne;2;2;0;4
16820;"Pilaitukas (I. Kanto al. 7A)";ZUIKUČIAI;6054821801;Ne;0;2;0;2
16821;"Pilaitukas (I. Kanto al. 7A)";ZUIKUČIAI;5691854235;Ne;3;0;0;3
16822;"Pilaitukas (I. Kanto al. 7A)";ZUIKUČIAI;3952708917;Ne;1;0;0;1
16823;"Pilaitukas (I. Kanto al. 7A)";ZUIKUČIAI;6337917448;Ne;0;1;0;1
16824;"Pilaitukas (I. Kanto al. 7A)";ZUIKUČIAI;3636976107;Ne;0;1;0;1
16825;"Pilaitukas (I. Kanto al. 7A)";ZUIKUČIAI;8207648026;Ne;15;0;0;15
16826;"Pilaitukas (I. Kanto al. 7A)";ZUIKUČIAI;3921932673;Ne;15;0;0;15
16827;"Pilaitukas (I. Kanto al. 7A)";ZUIKUČIAI;1290017967;Ne;0;2;0;2
16828;"Pilaitukas (I. Kanto al. 7A)";ZUIKUČIAI;5564784922;Ne;3;1;0;4
16829;"Pilaitukas (I. Kanto al. 7A)";ZUIKUČIAI;9327651233;Ne;0;5;0;5
16830;"Pilaitukas (I. Kanto al. 7A)";ZUIKUČIAI;9150579386;Ne;14;0;0;14
16831;"Pilaitukas (I. Kanto al. 7A)";ZUIKUČIAI;6238537739;Ne;4;0;0;4
16832;"Pilaitukas (I. Kanto al. 7A)";ZUIKUČIAI;6876537203;Taip;4;0;0;4
16833;"Pilaitukas (I. Kanto al. 7A)";ANČIUKAI;7773318230;Ne;3;8;0;11
16834;"Pilaitukas (I. Kanto al. 7A)";ANČIUKAI;4097742120;Ne;0;1;0;1
16835;"Pilaitukas (I. Kanto al. 7A)";ANČIUKAI;2923272767;Ne;0;1;0;1
16836;"Pilaitukas (I. Kanto al. 7A)";ANČIUKAI;8620858011;Ne;8;0;0;8
16837;"Pilaitukas (I. Kanto al. 7A)";ANČIUKAI;4286388920;Ne;2;0;0;2
16838;"Pilaitukas (I. Kanto al. 7A)";ANČIUKAI;3761827714;Ne;1;0;0;1
16839;"Pilaitukas (I. Kanto al. 7A)";ANČIUKAI;8643066116;Ne;0;0;1;1
16840;"Pilaitukas (I. Kanto al. 7A)";ANČIUKAI;1120549352;Ne;7;0;1;8
16841;"Pilaitukas (I. Kanto al. 7A)";ANČIUKAI;6888607864;Ne;7;0;1;8
16842;"Pilaitukas (I. Kanto al. 7A)";ANČIUKAI;7876850509;Ne;1;1;0;2
16843;"Pilaitukas (I. Kanto al. 7A)";ANČIUKAI;3035456834;Ne;1;0;1;2
16844;"Pilaitukas (I. Kanto al. 7A)";ANČIUKAI;2476942319;Ne;0;0;1;1
16845;"Pilaitukas (I. Kanto al. 7A)";ANČIUKAI;8033540052;Ne;11;0;1;12
16846;"Pilaitukas (I. Kanto al. 7A)";ANČIUKAI;1781762820;Ne;10;0;0;10
16847;"Pilaitukas (I. Kanto al. 7A)";ANČIUKAI;5706918634;Taip;10;0;0;10
16848;"Pilaitukas (I. Kanto al. 7A)";ANČIUKAI;8954370321;Ne;2;0;1;3
16849;"Pilaitukas (I. Kanto al. 7A)";MEŠKIUKAI;8577357264;Ne;2;1;0;3
16850;"Pilaitukas (I. Kanto al. 7A)";MEŠKIUKAI;5297214263;Ne;4;2;0;6
16851;"Pilaitukas (I. Kanto al. 7A)";MEŠKIUKAI;8268790017;Ne;2;0;0;2
16852;"Pilaitukas (I. Kanto al. 7A)";MEŠKIUKAI;2054626415;Ne;5;2;0;7
16853;"Pilaitukas (I. Kanto al. 7A)";MEŠKIUKAI;9742268665;Ne;11;0;0;11
16854;"Pilaitukas (I. Kanto al. 7A)";MEŠKIUKAI;1610122884;Ne;3;0;0;3
16855;"Pilaitukas (I. Kanto al. 7A)";MEŠKIUKAI;3867660147;Ne;3;0;0;3
16856;"Pilaitukas (I. Kanto al. 7A)";MEŠKIUKAI;2365387089;Ne;1;0;0;1
16857;"Pilaitukas (I. Kanto al. 7A)";MEŠKIUKAI;9670329628;Ne;0;8;0;8
16858;"Pilaitukas (I. Kanto al. 7A)";MEŠKIUKAI;7750575554;Ne;11;0;0;11
16859;"Pilaitukas (I. Kanto al. 7A)";MEŠKIUKAI;9397435605;Ne;0;5;0;5
16860;"Pilaitukas (I. Kanto al. 7A)";MEŠKIUKAI;9187961584;Ne;1;0;0;1
16861;"Pilaitukas (I. Kanto al. 7A)";MEŠKIUKAI;7781507786;Ne;8;5;0;13
16862;"Pilaitukas (I. Kanto al. 7A)";MEŠKIUKAI;4171896175;Ne;4;0;0;4
16863;"Pilaitukas (I. Kanto al. 7A)";MEŠKIUKAI;6807166920;Ne;0;8;0;8
16864;"Pilaitukas (I. Kanto al. 7A)";MEŠKIUKAI;1591276987;Ne;2;0;0;2
16865;"Pilaitukas (I. Kanto al. 7A)";MEŠKIUKAI;2830212921;Ne;8;3;0;11
16866;"Pilaitukas (I. Kanto al. 7A)";MEŠKIUKAI;9930306085;Ne;14;0;3;17
16867;"Pilaitukas (I. Kanto al. 7A)";ŽUVYTĖS;4353195155;Ne;0;3;0;3
16868;"Pilaitukas (I. Kanto al. 7A)";ŽUVYTĖS;8913709682;Ne;1;0;0;1
16869;"Pilaitukas (I. Kanto al. 7A)";ŽUVYTĖS;2862447956;Ne;4;0;0;4
16870;"Pilaitukas (I. Kanto al. 7A)";ŽUVYTĖS;8727175656;Ne;4;0;0;4
16871;"Pilaitukas (I. Kanto al. 7A)";ŽUVYTĖS;8207194955;Ne;0;1;1;2
16872;"Pilaitukas (I. Kanto al. 7A)";ŽUVYTĖS;5640802570;Ne;2;0;0;2
16873;"Pilaitukas (I. Kanto al. 7A)";ŽUVYTĖS;8993885764;Ne;0;1;0;1
16874;"Pilaitukas (I. Kanto al. 7A)";ŽUVYTĖS;9260893320;Ne;0;1;0;1
16875;"Pilaitukas (I. Kanto al. 7A)";ŽUVYTĖS;5710747769;Ne;2;1;0;3
16876;"Pilaitukas (I. Kanto al. 7A)";ŽUVYTĖS;5206637809;Ne;0;4;1;5
16877;"Pilaitukas (I. Kanto al. 7A)";ŽUVYTĖS;5288784331;Ne;2;0;0;2
16878;"Pilaitukas (I. Kanto al. 7A)";ŽUVYTĖS;1704055907;Ne;4;0;4;8
16879;"Pilaitukas (I. Kanto al. 7A)";ŽUVYTĖS;8255398803;Ne;3;2;0;5
16880;"Pilaitukas (I. Kanto al. 7A)";ŽUVYTĖS;1607454890;Taip;1;0;0;1
16881;"Pilaitukas (I. Kanto al. 7A)";PAUKŠTELIAI;1295215465;Ne;1;0;0;1
16882;"Pilaitukas (I. Kanto al. 7A)";PAUKŠTELIAI;7082099968;Ne;16;1;0;17
16883;"Pilaitukas (I. Kanto al. 7A)";PAUKŠTELIAI;2242454299;Ne;0;1;0;1
16884;"Pilaitukas (I. Kanto al. 7A)";PAUKŠTELIAI;4082490488;Ne;1;1;0;2
16885;"Pilaitukas (I. Kanto al. 7A)";PAUKŠTELIAI;6099109886;Ne;0;1;0;1
16886;"Pilaitukas (I. Kanto al. 7A)";PAUKŠTELIAI;3541354283;Ne;2;0;0;2
16887;"Pilaitukas (I. Kanto al. 7A)";PAUKŠTELIAI;5740951665;Ne;2;0;0;2
16888;"Pilaitukas (I. Kanto al. 7A)";PAUKŠTELIAI;4591799893;Ne;16;0;0;16
16889;"Pilaitukas (I. Kanto al. 7A)";PAUKŠTELIAI;6308557885;Ne;10;0;0;10
16890;"Pilaitukas (I. Kanto al. 7A)";PAUKŠTELIAI;6514731102;Ne;10;0;0;10
16891;"Pilaitukas (I. Kanto al. 7A)";PAUKŠTELIAI;5331915157;Taip;1;1;0;2
16892;"Pilaitukas (I. Kanto al. 7A)";PAUKŠTELIAI;8169484415;Ne;0;6;0;6
16893;"Pilaitukas (I. Kanto al. 7A)";PAUKŠTELIAI;3159733673;Ne;1;1;0;2
16894;"Pilaitukas (I. Kanto al. 7A)";BORUŽĖLĖS;9898379569;Ne;6;0;0;6
16895;"Pilaitukas (I. Kanto al. 7A)";BORUŽĖLĖS;5185051301;Ne;0;5;1;6
16896;"Pilaitukas (I. Kanto al. 7A)";BORUŽĖLĖS;1731106179;Ne;0;10;0;10
16897;"Pilaitukas (I. Kanto al. 7A)";BORUŽĖLĖS;3784944532;Ne;5;0;2;7
16898;"Pilaitukas (I. Kanto al. 7A)";BORUŽĖLĖS;5186675623;Ne;3;0;0;3
16899;"Pilaitukas (I. Kanto al. 7A)";BORUŽĖLĖS;4589130143;Ne;0;0;1;1
16900;"Pilaitukas (I. Kanto al. 7A)";BORUŽĖLĖS;1944443723;Taip;8;0;0;8
16901;"Pilaitukas (I. Kanto al. 7A)";BORUŽĖLĖS;6280870972;Ne;7;0;1;8
16902;"Pilaitukas (I. Kanto al. 7A)";BORUŽĖLĖS;3849247594;Ne;8;0;0;8
16903;"Pilaitukas (I. Kanto al. 7A)";BORUŽĖLĖS;5201301769;Ne;3;0;0;3
16904;"Pilaitukas (I. Kanto al. 7A)";BORUŽĖLĖS;2555073719;Ne;5;0;0;5
16905;"Pilaitukas (I. Kanto al. 7A)";BORUŽĖLĖS;6835592675;Ne;14;0;0;14
16906;"Pilaitukas (I. Kanto al. 7A)";BORUŽĖLĖS;5066594124;Ne;13;0;0;13
16907;"Pilaitukas (I. Kanto al. 7A)";BORUŽĖLĖS;2336933998;Ne;10;0;0;10
16908;"Pilaitukas (I. Kanto al. 7A)";BORUŽĖLĖS;8047683859;Ne;15;0;0;15
16909;"Pilaitukas (I. Kanto al. 7A)";BORUŽĖLĖS;8694369154;Ne;15;0;0;15
16910;"Pilaitukas (I. Kanto al. 7A)";BORUŽĖLĖS;9587140991;Ne;16;0;2;18
16911;"Pilaitukas (I. Kanto al. 7A)";BORUŽĖLĖS;9405479859;Ne;1;0;0;1
16912;"Pilaitukas (I. Kanto al. 7A)";DRUGELIAI;2917197418;Ne;0;0;1;1
16913;"Pilaitukas (I. Kanto al. 7A)";DRUGELIAI;9741985709;Ne;0;0;1;1
16914;"Pilaitukas (I. Kanto al. 7A)";DRUGELIAI;7807341574;Ne;5;0;1;6
16915;"Pilaitukas (I. Kanto al. 7A)";DRUGELIAI;5215800828;Taip;0;3;0;3
16916;"Pilaitukas (I. Kanto al. 7A)";DRUGELIAI;2414941263;Ne;5;0;2;7
16917;"Pilaitukas (I. Kanto al. 7A)";DRUGELIAI;8710069256;Ne;1;0;1;2
16918;"Pilaitukas (I. Kanto al. 7A)";DRUGELIAI;3609692114;Ne;6;0;1;7
16919;"Pilaitukas (I. Kanto al. 7A)";DRUGELIAI;9601295632;Ne;0;0;1;1
16920;"Pilaitukas (I. Kanto al. 7A)";DRUGELIAI;2768655540;Ne;10;0;3;13
16921;"Pilaitukas (I. Kanto al. 7A)";DRUGELIAI;1052452915;Ne;15;0;1;16
16922;"Pilaitukas (I. Kanto al. 7A)";DRUGELIAI;7478616628;Ne;0;2;0;2
16923;"Pilaitukas (I. Kanto al. 7A)";DRUGELIAI;1134083816;Ne;2;2;0;4
16924;"Pilaitukas (I. Kanto al. 7A)";DRUGELIAI;1452645899;Ne;0;0;4;4
16925;"Pilaitukas (I. Kanto al. 7A)";DRUGELIAI;8092422909;Ne;15;0;1;16
16926;"Pilaitukas (I. Kanto al. 7A)";PELIUKAI;9246925227;Taip;5;0;0;5
16927;"Pilaitukas (I. Kanto al. 7A)";PELIUKAI;8769116377;Ne;4;0;0;4
16928;"Pilaitukas (I. Kanto al. 7A)";PELIUKAI;5421602723;Ne;0;4;0;4
16929;"Pilaitukas (I. Kanto al. 7A)";PELIUKAI;6833933586;Ne;0;4;0;4
16930;"Pilaitukas (I. Kanto al. 7A)";PELIUKAI;2416277190;Ne;9;0;0;9
16931;"Pilaitukas (I. Kanto al. 7A)";PELIUKAI;1270365948;Ne;4;0;0;4
16932;"Pilaitukas (I. Kanto al. 7A)";PELIUKAI;9556421129;Ne;9;0;0;9
16933;"Pilaitukas (I. Kanto al. 7A)";PELIUKAI;3651140874;Ne;0;1;0;1
16934;"Pilaitukas (I. Kanto al. 7A)";PELIUKAI;7750936973;Ne;7;5;0;12
16935;"Pilaitukas (I. Kanto al. 7A)";PELIUKAI;1781241002;Ne;3;0;0;3
16936;"Pilaitukas (I. Kanto al. 7A)";KAČIUKAI;1585341963;Ne;0;1;0;1
16937;"Pilaitukas (I. Kanto al. 7A)";KAČIUKAI;7594484959;Ne;0;0;1;1
16938;"Pilaitukas (I. Kanto al. 7A)";KAČIUKAI;3080014745;Ne;5;4;0;9
16939;"Pilaitukas (I. Kanto al. 7A)";KAČIUKAI;8009040109;Ne;0;1;0;1
16940;"Pilaitukas (I. Kanto al. 7A)";KAČIUKAI;2105380328;Ne;4;0;0;4
16941;"Pilaitukas (I. Kanto al. 7A)";KAČIUKAI;5326689274;Ne;16;0;0;16
16942;"Pilaitukas (I. Kanto al. 7A)";KAČIUKAI;9653647227;Ne;16;0;0;16
16943;"Pilaitukas (I. Kanto al. 7A)";KAČIUKAI;4022543517;Ne;0;3;0;3
16944;"Pilaitukas (I. Kanto al. 7A)";KAČIUKAI;3825942473;Ne;0;10;0;10
16945;"Pilaitukas (I. Kanto al. 7A)";KAČIUKAI;1611371690;Ne;15;0;1;16
16946;"Pilaitukas (I. Kanto al. 7A)";KAČIUKAI;6436694057;Ne;0;0;1;1
16947;"Pilaitukas (I. Kanto al. 7A)";KAČIUKAI;9974310580;Ne;6;0;0;6
16948;"Pilaitukas (I. Kanto al. 7A)";KAČIUKAI;6235375235;Ne;10;0;1;11
16949;"Pilaitukas (I. Kanto al. 7A)";KAČIUKAI;9914575692;Ne;2;0;0;2
16950;"Pilaitukas (I. Kanto al. 7A)";KAČIUKAI;4341157841;Ne;0;1;0;1
16951;"Pilaitukas (I. Kanto al. 7A)";SAULUTĖS;2110996493;Ne;10;0;0;10
16952;"Pilaitukas (I. Kanto al. 7A)";SAULUTĖS;8306015313;Ne;0;7;3;10
16953;"Pilaitukas (I. Kanto al. 7A)";SAULUTĖS;8801358120;Ne;1;0;0;1
16954;"Pilaitukas (I. Kanto al. 7A)";SAULUTĖS;3927713632;Ne;1;0;0;1
16955;"Pilaitukas (I. Kanto al. 7A)";SAULUTĖS;1970389617;Ne;9;0;0;9
16956;"Pilaitukas (I. Kanto al. 7A)";SAULUTĖS;1351676866;Ne;13;0;0;13
16957;"Pilaitukas (I. Kanto al. 7A)";SAULUTĖS;4947536980;Ne;14;0;0;14
16958;"Pilaitukas (I. Kanto al. 7A)";SAULUTĖS;8484807843;Ne;5;0;0;5
16959;"Pilaitukas (I. Kanto al. 7A)";SAULUTĖS;8586082743;Ne;8;0;0;8
16960;"Pilaitukas (I. Kanto al. 7A)";SAULUTĖS;8693322790;Ne;8;0;0;8
16961;"Pilaitukas (I. Kanto al. 7A)";SAULUTĖS;9041750889;Ne;0;20;0;20
16962;"Pilaitukas (I. Kanto al. 7A)";MENULIUKAI;1620231835;Ne;7;0;0;7
16963;"Pilaitukas (I. Kanto al. 7A)";MENULIUKAI;8873155277;Ne;2;0;0;2
16964;"Pilaitukas (I. Kanto al. 7A)";MENULIUKAI;1532252453;Ne;6;1;0;7
16965;"Pilaitukas (I. Kanto al. 7A)";MENULIUKAI;8225571149;Ne;0;0;1;1
16966;"Pilaitukas (I. Kanto al. 7A)";MENULIUKAI;7855892595;Ne;6;0;0;6
16967;"Pilaitukas (I. Kanto al. 7A)";MENULIUKAI;8058057477;Ne;7;0;1;8
16968;"Pilaitukas (I. Kanto al. 7A)";MENULIUKAI;9106756175;Ne;8;0;0;8
16969;"Pilaitukas (I. Kanto al. 7A)";MENULIUKAI;5213352941;Ne;1;0;0;1
16970;"Pilaitukas (I. Kanto al. 7A)";MENULIUKAI;3258857371;Ne;1;0;0;1
16971;"Pilaitukas (I. Kanto al. 7A)";MENULIUKAI;9800474455;Taip;5;1;0;6
16972;"Pilaitukas (I. Kanto al. 7A)";MENULIUKAI;2215317686;Ne;0;1;0;1
16973;"Pilaitukas (I. Kanto al. 7A)";ĖŽIUKAI;6019760696;Ne;6;0;0;6
16974;"Pilaitukas (I. Kanto al. 7A)";ĖŽIUKAI;2342453729;Ne;0;2;0;2
16975;"Pilaitukas (I. Kanto al. 7A)";ĖŽIUKAI;2484405944;Taip;5;0;3;8
16976;"Pilaitukas (I. Kanto al. 7A)";ĖŽIUKAI;3283178614;Ne;6;0;1;7
16977;"Pilaitukas (I. Kanto al. 7A)";ĖŽIUKAI;4577941964;Ne;7;1;0;8
16978;"Pilaitukas (I. Kanto al. 7A)";ĖŽIUKAI;9099718179;Ne;2;0;0;2
16979;"Pilaitukas (I. Kanto al. 7A)";ĖŽIUKAI;7075283592;Ne;5;0;0;5
16980;"Pilaitukas (I. Kanto al. 7A)";ĖŽIUKAI;8312146534;Ne;0;1;0;1
16981;"Pilaitukas (I. Kanto al. 7A)";ĖŽIUKAI;3437303302;Ne;1;1;0;2
16982;"Pilaitukas (I. Kanto al. 7A)";ĖŽIUKAI;1955352672;Ne;1;1;0;2
16983;"Pilaitukas (I. Kanto al. 7A)";ĖŽIUKAI;2982393064;Ne;5;0;0;5
16984;"Pilaitukas (I. Kanto al. 7A)";ĖŽIUKAI;1251079289;Ne;10;0;0;10
16985;"Pilaitukas (I. Kanto al. 7A)";ĖŽIUKAI;2600504692;Ne;0;20;0;20
16986;"Pilaitukas (I. Kanto al. 7A)";ĖŽIUKAI;2717071397;Ne;18;0;0;18
16987;Švelnukas;Pelėdžiukai;8016531082;Ne;5;0;0;5
16988;Švelnukas;Pelėdžiukai;8219071968;Ne;2;0;0;2
16989;Švelnukas;Pelėdžiukai;9008722163;Ne;13;0;0;13
16990;Švelnukas;Pelėdžiukai;5699300764;Ne;6;0;0;6
16991;Švelnukas;Pelėdžiukai;1116279011;Ne;9;0;0;9
16992;Švelnukas;Pelėdžiukai;3892058023;Ne;11;0;0;11
16993;Švelnukas;Pelėdžiukai;5681611554;Ne;0;1;1;2
16994;Švelnukas;Pelėdžiukai;8589226595;Ne;7;0;1;8
16995;Švelnukas;Pelėdžiukai;3804532959;Ne;0;3;0;3
16996;Švelnukas;Pelėdžiukai;8650902343;Ne;1;0;0;1
16997;Švelnukas;Pelėdžiukai;1409803554;Ne;5;1;0;6
16998;Švelnukas;Pelėdžiukai;1991507109;Ne;0;4;0;4
16999;Švelnukas;Pelėdžiukai;9808833734;Ne;3;0;0;3
17000;Švelnukas;Pelėdžiukai;6069027553;Ne;18;0;0;18
17001;Švelnukas;Pelėdžiukai;9814032171;Ne;1;0;0;1
17002;Švelnukas;Pelėdžiukai;7489142128;Ne;1;0;0;1
17003;Švelnukas;Ežiukai;4711482287;Ne;0;1;0;1
17004;Švelnukas;Ežiukai;6209334207;Ne;3;0;0;3
17005;Švelnukas;Ežiukai;2348752207;Taip;0;20;0;20
17006;Švelnukas;Ežiukai;1143579276;Taip;0;0;2;2
17007;Švelnukas;Ežiukai;9402567487;Ne;1;1;0;2
17008;Švelnukas;Ežiukai;8569985034;Ne;0;3;0;3
17009;Švelnukas;Ežiukai;3235768013;Taip;2;0;0;2
17010;Švelnukas;Ežiukai;9347355242;Ne;5;0;0;5
17011;Švelnukas;Ežiukai;3832011837;Ne;5;0;0;5
17012;Švelnukas;Ežiukai;9829912750;Ne;1;0;0;1
17013;Švelnukas;Ežiukai;9394816723;Ne;0;0;3;3
17014;Švelnukas;Ežiukai;6658530716;Ne;4;0;3;7
17015;Švelnukas;Ežiukai;6004580752;Ne;6;0;0;6
17016;Švelnukas;Ežiukai;4035050422;Ne;2;0;2;4
17017;Švelnukas;Ežiukai;4048599050;Ne;2;0;2;4
17018;Švelnukas;Ežiukai;9712567632;Ne;10;1;0;11
17019;Švelnukas;Ežiukai;2106591525;Ne;6;0;0;6
17020;Švelnukas;Švelnukai;4681584014;Ne;0;0;1;1
17021;Švelnukas;Švelnukai;6607578153;Ne;0;0;1;1
17022;Švelnukas;Švelnukai;8847738918;Ne;2;0;0;2
17023;Švelnukas;Švelnukai;9766734938;Ne;0;2;0;2
17024;Švelnukas;Švelnukai;5032829856;Ne;4;0;0;4
17025;Švelnukas;Švelnukai;5213589179;Ne;9;2;0;11
17026;Švelnukas;Švelnukai;4194249709;Ne;0;0;2;2
17027;Švelnukas;Švelnukai;5936821902;Ne;8;0;0;8
17028;Švelnukas;Švelnukai;7607215137;Ne;1;0;0;1
17029;Švelnukas;Švelnukai;4629757899;Taip;11;1;0;12
17030;Švelnukas;Švelnukai;6964997767;Ne;0;0;1;1
17031;Švelnukas;Švelnukai;8951810066;Ne;2;0;1;3
17032;Švelnukas;Švelnukai;6204286255;Ne;0;0;5;5
17033;Švelnukas;Švelnukai;5960966542;Ne;8;1;0;9
17034;Švelnukas;Boružiukai;1951447127;Ne;0;0;2;2
17035;Švelnukas;Boružiukai;3849957906;Taip;0;0;3;3
17036;Švelnukas;Boružiukai;5550841477;Ne;0;0;1;1
17037;Švelnukas;Boružiukai;9722532034;Ne;0;0;1;1
17038;Švelnukas;Boružiukai;1332533332;Taip;0;0;4;4
17039;Švelnukas;Boružiukai;4134678301;Ne;4;0;1;5
17040;Švelnukas;Boružiukai;8458233793;Ne;6;0;1;7
17041;Švelnukas;Boružiukai;7967996032;Ne;0;0;3;3
17042;Švelnukas;Boružiukai;4990399144;Ne;0;5;0;5
17043;Švelnukas;Boružiukai;9575767514;Ne;0;0;2;2
17044;Švelnukas;Boružiukai;6282137936;Ne;0;5;0;5
17045;Švelnukas;Boružiukai;2088128734;Ne;0;1;0;1
17046;Švelnukas;Boružiukai;4404904322;Ne;0;0;1;1
17047;Švelnukas;Boružiukai;3561920685;Ne;0;0;3;3
17048;Švelnukas;Boružiukai;8895028305;Ne;2;0;0;2
17049;Švelnukas;Boružiukai;4823928859;Ne;5;0;0;5
17050;Švelnukas;Smalsučiai;5085517759;Ne;0;0;3;3
17051;Švelnukas;Smalsučiai;1661019352;Ne;0;1;0;1
17052;Švelnukas;Smalsučiai;2730288544;Ne;0;0;1;1
17053;Švelnukas;Smalsučiai;5805289419;Ne;4;0;0;4
17054;Švelnukas;Smalsučiai;1415899173;Ne;2;1;0;3
17055;Švelnukas;Smalsučiai;8193690277;Ne;8;1;2;11
17056;Švelnukas;Smalsučiai;3472774028;Ne;0;0;9;9
17057;Švelnukas;Smalsučiai;6764222588;Ne;0;0;14;14
17058;Švelnukas;Smalsučiai;1840752560;Ne;0;1;0;1
17059;Švelnukas;Smalsučiai;8268391509;Taip;0;0;5;5
17060;Švelnukas;Smalsučiai;4467095100;Ne;0;0;8;8
17061;Švelnukas;Smalsučiai;7125883267;Ne;0;1;0;1
17062;Švelnukas;Smalsučiai;8210720087;Ne;5;0;0;5
17063;Švelnukas;Smalsučiai;6155098464;Ne;0;0;5;5
17064;Švelnukas;Smalsučiai;1100719254;Ne;8;0;0;8
17065;Švelnukas;Smalsučiai;8829819783;Ne;11;0;0;11
17066;Švelnukas;Nykštukai;1058623863;Ne;0;2;0;2
17067;Švelnukas;Nykštukai;3455801077;Ne;0;0;2;2
17068;Švelnukas;Nykštukai;9371102717;Ne;0;20;0;20
17069;Švelnukas;Nykštukai;5969852813;Ne;0;20;0;20
17070;Švelnukas;Nykštukai;5483481191;Taip;0;0;1;1
17071;Švelnukas;Nykštukai;5097880045;Ne;1;0;1;2
17072;Švelnukas;Nykštukai;8572664468;Ne;0;0;4;4
17073;Švelnukas;Nykštukai;1983560609;Ne;0;1;0;1
17074;Švelnukas;Nykštukai;6135073159;Ne;0;0;2;2
17075;Švelnukas;Nykštukai;6731324414;Ne;10;1;0;11
17076;Švelnukas;Nykštukai;5066121542;Taip;4;0;1;5
17077;Švelnukas;Nykštukai;3173070733;Ne;0;4;0;4
17078;Boružėlė;"Nykštukai gudručiai";7736917485;Ne;0;20;0;20
17079;Boružėlė;"Nykštukai gudručiai";9520696660;Taip;0;0;3;3
17080;Boružėlė;"Nykštukai gudručiai";5691884576;Ne;5;0;0;5
17081;Boružėlė;"Nykštukai gudručiai";9193273478;Ne;11;0;0;11
17082;Boružėlė;"Nykštukai gudručiai";3237771499;Ne;15;2;0;17
17083;Boružėlė;"Nykštukai gudručiai";8359957290;Ne;5;1;0;6
17084;Boružėlė;"Nykštukai gudručiai";8141240094;Ne;0;1;14;15
17085;Boružėlė;"Nykštukai gudručiai";2349571778;Ne;5;2;0;7
17086;Boružėlė;"Nykštukai gudručiai";1894170218;Taip;10;0;0;10
17087;Boružėlė;"Nykštukai gudručiai";3509512899;Ne;8;0;0;8
17088;Boružėlė;"Nykštukai gudručiai";8888151470;Ne;8;0;0;8
17089;Boružėlė;"Nykštukai gudručiai";3430953692;Ne;0;2;0;2
17090;Boružėlė;"Nykštukai gudručiai";8365962523;Ne;0;2;1;3
17091;Boružėlė;"Nykštukai gudručiai";6876323023;Ne;3;0;0;3
17092;Boružėlė;"Nykštukai gudručiai";2744894565;Ne;0;2;1;3
17093;Boružėlė;"Nykštukai gudručiai";6590829182;Ne;5;4;0;9
17094;Boružėlė;"Nykštukai gudručiai";3129825206;Ne;0;7;0;7
17095;Boružėlė;"Nykštukai gudručiai";9771767352;Ne;8;0;0;8
17096;Boružėlė;"Nykštukai gudručiai";2571360077;Ne;0;1;0;1
17097;Boružėlė;"Nykštukai gudručiai";9078805020;Ne;5;1;0;6
17098;Boružėlė;"Saulės zuikučiai";4554260776;Ne;0;1;0;1
17099;Boružėlė;"Saulės zuikučiai";5298170118;Ne;10;0;0;10
17100;Boružėlė;"Saulės zuikučiai";2133849514;Ne;0;2;0;2
17101;Boružėlė;"Saulės zuikučiai";1292298259;Ne;5;0;0;5
17102;Boružėlė;"Saulės zuikučiai";3130977416;Ne;3;0;0;3
17103;Boružėlė;"Saulės zuikučiai";7256396576;Ne;0;0;1;1
17104;Boružėlė;"Saulės zuikučiai";4323998138;Ne;0;0;1;1
17105;Boružėlė;"Saulės zuikučiai";3952645542;Ne;4;0;0;4
17106;Boružėlė;"Saulės zuikučiai";5516103398;Ne;6;0;2;8
17107;Boružėlė;"Saulės zuikučiai";8259586236;Ne;0;2;0;2
17108;Boružėlė;"Saulės zuikučiai";3955841578;Ne;0;2;0;2
17109;Boružėlė;"Saulės zuikučiai";1583223569;Ne;0;2;0;2
17110;Boružėlė;"Saulės zuikučiai";4433248526;Ne;0;2;0;2
17111;Boružėlė;"Saulės zuikučiai";1547802140;Ne;3;0;0;3
17112;Boružėlė;"Saulės zuikučiai";4020348640;Ne;4;0;0;4
17113;Boružėlė;"Saulės zuikučiai";2842256033;Ne;0;1;0;1
17114;Boružėlė;"Saulės zuikučiai";2561969142;Taip;0;2;1;3
17115;Boružėlė;"Saulės zuikučiai";7262515868;Ne;10;0;0;10
17116;Boružėlė;"Saulės zuikučiai";6527254253;Ne;18;0;0;18
17117;Boružėlė;"Saulės zuikučiai";7942043844;Ne;9;0;0;9
17118;Boružėlė;"Saulės zuikučiai";2515608520;Ne;13;0;0;13
17119;Boružėlė;Gėlytės;3288141024;Ne;18;0;0;18
17120;Boružėlė;Gėlytės;1166207929;Ne;5;2;0;7
17121;Boružėlė;Gėlytės;4180537253;Ne;10;2;2;14
17122;Boružėlė;Gėlytės;6722353853;Ne;5;1;0;6
17123;Boružėlė;Gėlytės;3300678477;Ne;0;1;0;1
17124;Boružėlė;Gėlytės;7763958937;Ne;9;0;0;9
17125;Boružėlė;Gėlytės;3354291446;Ne;5;1;0;6
17126;Boružėlė;Gėlytės;8520403894;Ne;19;0;0;19
17127;Boružėlė;Gėlytės;4268486154;Ne;0;5;0;5
17128;Boružėlė;Gėlytės;7614216150;Ne;0;1;0;1
17129;Boružėlė;Gėlytės;8205706322;Ne;8;1;0;9
17130;Boružėlė;Gėlytės;8834231529;Ne;6;6;0;12
17131;Boružėlė;Gėlytės;8929444125;Ne;4;0;2;6
17132;Boružėlė;Gėlytės;3604658753;Ne;0;7;1;8
17133;Boružėlė;Smalsutis;2629139832;Taip;0;1;0;1
17134;Boružėlė;Smalsutis;4125177837;Taip;6;0;2;8
17135;Boružėlė;Smalsutis;6734750713;Ne;0;2;4;6
17136;Boružėlė;Smalsutis;5456349784;Ne;5;0;0;5
17137;Boružėlė;Smalsutis;9615931888;Ne;10;0;0;10
17138;Boružėlė;Smalsutis;9993823313;Ne;0;1;0;1
17139;Boružėlė;Smalsutis;5108107657;Ne;6;0;1;7
17140;Boružėlė;Smalsutis;4606274286;Ne;0;2;0;2
17141;Boružėlė;Smalsutis;8956248864;Ne;0;0;4;4
17142;Boružėlė;Smalsutis;8239372270;Taip;5;2;0;7
17143;Boružėlė;Smalsutis;6057263329;Ne;5;0;0;5
17144;Boružėlė;Smalsutis;7132100212;Ne;8;0;0;8
17145;Boružėlė;Smalsutis;6367963436;Ne;11;1;1;13
17146;Boružėlė;Smalsutis;5220224249;Ne;9;0;0;9
17147;Boružėlė;Smalsutis;1969793682;Ne;2;0;0;2
17148;Boružėlė;Smalsutis;6767206150;Taip;0;1;2;3
17149;Boružėlė;Smalsutis;6430695398;Ne;6;0;2;8
17150;Boružėlė;Smalsutis;4859297816;Ne;16;0;0;16
17151;Boružėlė;Smalsutis;6599359132;Ne;7;0;0;7
17152;Boružėlė;Smalsutis;7089148766;Ne;5;0;0;5
17153;Boružėlė;Drugeliai;8357946299;Ne;10;0;0;10
17154;Boružėlė;Drugeliai;1130980139;Ne;0;2;0;2
17155;Boružėlė;Drugeliai;6463583187;Ne;0;2;0;2
17156;Boružėlė;Drugeliai;3136028536;Ne;0;2;0;2
17157;Boružėlė;Drugeliai;2211576663;Ne;0;5;0;5
17158;Boružėlė;Drugeliai;1559001916;Ne;2;1;0;3
17159;Boružėlė;Drugeliai;3108758436;Ne;0;1;0;1
17160;Boružėlė;Drugeliai;8482813204;Ne;0;2;0;2
17161;Boružėlė;Drugeliai;6369070055;Ne;1;0;0;1
17162;Boružėlė;Drugeliai;6980022864;Ne;8;0;0;8
17163;Boružėlė;Drugeliai;5726187445;Ne;0;1;0;1
17164;Boružėlė;Drugeliai;8213060214;Ne;15;0;0;15
17165;Boružėlė;Drugeliai;3331238309;Ne;5;5;1;11
17166;Boružėlė;Vyturėliai;7934628014;Ne;9;0;0;9
17167;Boružėlė;Vyturėliai;7887412867;Ne;0;3;0;3
17168;Boružėlė;Vyturėliai;6233993159;Ne;15;0;0;15
17169;Boružėlė;Vyturėliai;6721005189;Ne;5;0;0;5
17170;Boružėlė;Vyturėliai;3991218067;Ne;7;0;0;7
17171;Boružėlė;Vyturėliai;3331139963;Ne;0;1;0;1
17172;Boružėlė;Vyturėliai;2104101406;Ne;5;1;0;6
17173;Boružėlė;Vyturėliai;8377410278;Ne;15;0;0;15
17174;Boružėlė;Vyturėliai;4928818565;Ne;0;0;1;1
17175;Boružėlė;Vyturėliai;5619719965;Ne;2;11;1;14
17176;Boružėlė;Vyturėliai;8073918985;Taip;0;4;0;4
17177;Boružėlė;Vyturėliai;1047419932;Ne;0;2;0;2
17178;Boružėlė;Vyturėliai;1929202434;Ne;9;0;0;9
17179;Boružėlė;Vyturėliai;8165748779;Taip;7;0;0;7
17180;Boružėlė;Vyturėliai;7068409148;Ne;4;1;0;5
17181;Boružėlė;Vyturėliai;8434178580;Ne;9;0;0;9
17182;Boružėlė;Vyturėliai;2084361709;Ne;3;2;1;6
17183;Boružėlė;Vyturėliai;3281431237;Ne;13;0;0;13
17184;Boružėlė;Žvaigždutės;9838823214;Ne;0;7;0;7
17185;Boružėlė;Žvaigždutės;3489498503;Ne;0;3;0;3
17186;Boružėlė;Žvaigždutės;5307997577;Ne;0;2;3;5
17187;Boružėlė;Žvaigždutės;8916241914;Ne;0;2;0;2
17188;Boružėlė;Žvaigždutės;7078709057;Ne;0;1;0;1
17189;Boružėlė;Žvaigždutės;6972646373;Ne;0;1;0;1
17190;Boružėlė;Žvaigždutės;8820827882;Ne;3;2;0;5
17191;Boružėlė;Žvaigždutės;1799882790;Ne;0;6;0;6
17192;Boružėlė;Žvaigždutės;5420788580;Ne;0;2;2;4
17193;Boružėlė;Žvaigždutės;2075050639;Ne;5;0;0;5
17194;Boružėlė;Ąžuoliukai;1874865061;Ne;10;1;2;13
17195;Boružėlė;Ąžuoliukai;6820122408;Ne;0;2;8;10
17196;Boružėlė;Ąžuoliukai;6708666819;Taip;8;0;1;9
17197;Boružėlė;Ąžuoliukai;9818317963;Ne;0;0;4;4
17198;Boružėlė;Ąžuoliukai;6297693776;Ne;13;0;0;13
17199;Boružėlė;Ąžuoliukai;8734782540;Ne;0;2;0;2
17200;Boružėlė;Ąžuoliukai;7065907155;Ne;0;2;0;2
17201;Boružėlė;Ąžuoliukai;4113917886;Ne;0;0;10;10
17202;Boružėlė;Ąžuoliukai;1608652924;Ne;3;0;1;4
17203;Boružėlė;Ąžuoliukai;3005601935;Ne;0;4;6;10
17204;Boružėlė;Ąžuoliukai;8752343077;Ne;5;0;0;5
17205;Boružėlė;Ąžuoliukai;4727351240;Ne;10;2;1;13
17206;Boružėlė;Ąžuoliukai;4497753570;Ne;14;0;0;14
17207;Boružėlė;Ąžuoliukai;1865891989;Ne;3;0;0;3
17208;Boružėlė;Ąžuoliukai;8739264310;Taip;7;0;4;11
17209;Boružėlė;Ąžuoliukai;3097874340;Taip;5;2;0;7
17210;Boružėlė;Ąžuoliukai;7149439740;Ne;8;0;0;8
17211;Boružėlė;Ąžuoliukai;1630903587;Ne;4;1;4;9
17212;Boružėlė;Ąžuoliukai;9964146295;Taip;2;0;0;2
17213;Boružėlė;Saulutės;9492548829;Ne;8;2;0;10
17214;Boružėlė;Saulutės;5437943626;Ne;3;2;0;5
17215;Boružėlė;Saulutės;3503931241;Ne;3;2;0;5
17216;Boružėlė;Saulutės;8882070834;Ne;4;0;0;4
17217;Boružėlė;Saulutės;6265279517;Ne;6;2;0;8
17218;Boružėlė;Saulutės;6275425512;Ne;2;0;0;2
17219;Boružėlė;Saulutės;8804878419;Ne;3;2;0;5
17220;Boružėlė;Saulutės;3871593172;Ne;12;1;0;13
17221;Boružėlė;Saulutės;3953507461;Ne;5;2;2;9
17222;Boružėlė;Saulutės;1492091211;Ne;0;1;0;1
17223;Boružėlė;Saulutės;1830043506;Ne;0;1;0;1
17224;Boružėlė;Saulutės;1779839709;Ne;3;0;0;3
17225;Boružėlė;Saulutės;5064892417;Ne;0;2;0;2
17226;Boružėlė;Saulutės;8577301586;Ne;0;1;0;1
17227;Boružėlė;Saulutės;8660954142;Ne;0;1;0;1
17228;Boružėlė;Saulutės;3093287452;Taip;1;2;0;3
17229;Boružėlė;Ežiukai;9342498392;Taip;0;1;0;1
17230;Boružėlė;Ežiukai;8195442951;Ne;0;2;6;8
17231;Boružėlė;Ežiukai;6448688592;Ne;0;1;0;1
17232;Boružėlė;Ežiukai;2429696310;Ne;0;2;1;3
17233;Boružėlė;Ežiukai;9893643199;Ne;5;2;0;7
17234;Boružėlė;Ežiukai;5394149649;Ne;3;0;0;3
17235;Boružėlė;Ežiukai;8167376712;Ne;0;1;0;1
17236;Boružėlė;Ežiukai;1784594085;Ne;0;1;0;1
17237;Boružėlė;Ežiukai;9423458813;Ne;3;1;0;4
17238;Boružėlė;Ežiukai;5825164520;Ne;6;0;5;11
17239;Boružėlė;Ežiukai;7190980006;Ne;0;10;0;10
17240;Boružėlė;Ežiukai;7459531236;Ne;3;2;0;5
17241;Boružėlė;Ežiukai;8818358360;Ne;3;2;0;5
17242;Boružėlė;Ežiukai;1693082285;Ne;0;2;7;9
17243;Boružėlė;Ežiukai;2926620929;Ne;12;1;0;13
17244;Boružėlė;Ežiukai;8291389794;Ne;3;1;0;4
17245;Boružėlė;Ežiukai;2524469162;Ne;5;0;0;5
17246;Boružėlė;Ežiukai;5492228053;Ne;0;4;0;4
17247;Boružėlė;Ežiukai;6087811262;Ne;5;0;0;5
17248;Boružėlė;Boružiukai;8944790932;Ne;5;0;0;5
17249;Boružėlė;Boružiukai;2298750617;Ne;4;0;0;4
17250;Boružėlė;Boružiukai;3097217902;Ne;0;1;0;1
17251;Boružėlė;Boružiukai;6026505923;Ne;7;0;0;7
17252;Boružėlė;Boružiukai;4771951587;Ne;0;9;1;10
17253;Boružėlė;Boružiukai;8868736347;Ne;0;4;0;4
17254;Boružėlė;Boružiukai;3814031203;Ne;8;0;0;8
17255;Boružėlė;Boružiukai;1070536820;Ne;4;0;1;5
17256;Boružėlė;Boružiukai;6856426845;Ne;11;0;0;11
17257;Boružėlė;Boružiukai;8512180544;Ne;5;0;0;5
17258;Boružėlė;Boružiukai;3209486458;Ne;0;2;3;5
17259;Boružėlė;Boružiukai;3972950428;Ne;0;1;0;1
17260;Boružėlė;Boružiukai;6010385301;Ne;0;2;1;3
17261;Boružėlė;Boružiukai;2304719318;Ne;5;0;0;5
17262;Boružėlė;Boružiukai;5667227930;Ne;0;0;3;3
17263;Boružėlė;Boružiukai;5545252373;Ne;0;4;0;4
17264;Boružėlė;Nykštukai;1966066642;Ne;3;2;0;5
17265;Boružėlė;Nykštukai;6267999965;Ne;4;2;0;6
17266;Boružėlė;Nykštukai;6776735311;Ne;3;1;4;8
17267;Boružėlė;Nykštukai;6221965115;Ne;14;0;0;14
17268;Boružėlė;Nykštukai;2930463607;Taip;0;1;1;2
17269;Boružėlė;Nykštukai;6529896335;Ne;10;0;0;10
17270;Boružėlė;Nykštukai;6273128752;Taip;11;1;0;12
17271;Boružėlė;Nykštukai;6733644286;Ne;4;0;1;5
17272;Boružėlė;Nykštukai;2984478360;Ne;0;1;1;2
17273;Boružėlė;Nykštukai;3471567359;Ne;7;1;0;8
17274;Boružėlė;Nykštukai;1444196386;Taip;11;0;0;11
17275;Boružėlė;Nykštukai;8970308091;Ne;6;6;0;12
17276;Boružėlė;Nykštukai;6330458151;Ne;10;1;3;14
17277;Žaliakalnio;Drugeliai;8056516915;Ne;4;0;1;5
17278;Žaliakalnio;Drugeliai;9106286038;Ne;17;0;0;17
17279;Žaliakalnio;Drugeliai;1004188539;Ne;15;0;0;15
17280;Žaliakalnio;Drugeliai;9762481841;Ne;14;0;0;14
17281;Žaliakalnio;Drugeliai;9710185940;Ne;0;8;0;8
17282;Žaliakalnio;Drugeliai;5626776693;Ne;12;0;0;12
17283;Žaliakalnio;Drugeliai;4945570058;Ne;10;0;0;10
17284;Žaliakalnio;Drugeliai;6521902343;Ne;11;1;0;12
17285;Žaliakalnio;Drugeliai;7351146376;Ne;17;0;0;17
17286;Žaliakalnio;Drugeliai;9790375448;Ne;12;2;0;14
17287;Žaliakalnio;Drugeliai;7966604753;Ne;7;0;0;7
17288;Žaliakalnio;Drugeliai;7078689014;Ne;13;0;1;14
17289;Žaliakalnio;Drugeliai;4642184038;Ne;10;0;0;10
17290;Žaliakalnio;Drugeliai;7229655569;Ne;6;1;0;7
17291;Žaliakalnio;Drugeliai;4888533074;Ne;10;1;0;11
17292;Žaliakalnio;Drugeliai;5305220570;Ne;5;0;0;5
17293;Žaliakalnio;Drugeliai;8852165484;Taip;0;0;4;4
17294;Žaliakalnio;Drugeliai;9167631614;Ne;7;0;0;7
17295;Žaliakalnio;Drugeliai;6166482260;Taip;13;0;0;13
17296;Žaliakalnio;Boružėlių;5843020412;Ne;0;4;0;4
17297;Žaliakalnio;Boružėlių;2284465378;Ne;10;1;0;11
17298;Žaliakalnio;Boružėlių;7977009681;Ne;0;5;0;5
17299;Žaliakalnio;Boružėlių;2808776865;Ne;5;0;0;5
17300;Žaliakalnio;Boružėlių;2278681435;Ne;0;2;0;2
17301;Žaliakalnio;Boružėlių;9421259943;Ne;5;1;0;6
17302;Žaliakalnio;Boružėlių;3105500733;Ne;1;2;0;3
17303;Žaliakalnio;Boružėlių;1200844791;Ne;0;1;0;1
17304;Žaliakalnio;Boružėlių;8052539476;Ne;10;10;0;20
17305;Žaliakalnio;Boružėlių;6590016097;Ne;7;4;0;11
17306;Žaliakalnio;Boružėlių;8304431519;Ne;12;1;0;13
17307;Žaliakalnio;Boružėlių;5488964606;Ne;14;0;0;14
17308;Žaliakalnio;Boružėlių;8429135626;Ne;0;8;0;8
17309;Žaliakalnio;Boružėlių;8073554707;Ne;10;0;0;10
17310;Žaliakalnio;Boružėlių;2987217910;Ne;6;5;0;11
17311;Žaliakalnio;Boružėlių;9032003195;Ne;0;2;0;2
17312;Žaliakalnio;Boružėlių;6602037942;Ne;0;1;0;1
17313;Žaliakalnio;Boružėlių;4961762841;Ne;4;1;0;5
17314;Žaliakalnio;Boružėlių;3027735957;Ne;5;2;0;7
17315;Žaliakalnio;Zuikučiai;3072808139;Ne;17;0;0;17
17316;Žaliakalnio;Zuikučiai;2111418502;Ne;0;8;0;8
17317;Žaliakalnio;Zuikučiai;2654494663;Ne;1;1;0;2
17318;Žaliakalnio;Zuikučiai;8576412247;Ne;0;3;0;3
17319;Žaliakalnio;Zuikučiai;9317649996;Ne;0;4;0;4
17320;Žaliakalnio;Zuikučiai;5645294219;Ne;0;4;0;4
17321;Žaliakalnio;Zuikučiai;4879096956;Ne;0;4;0;4
17322;Žaliakalnio;Zuikučiai;7258677907;Ne;0;5;0;5
17323;Žaliakalnio;Zuikučiai;9868348859;Ne;6;2;0;8
17324;Žaliakalnio;Zuikučiai;5939383017;Ne;0;2;0;2
17325;Žaliakalnio;Zuikučiai;4231316753;Ne;0;2;0;2
17326;Žaliakalnio;Zuikučiai;9478722760;Ne;4;5;0;9
17327;Žaliakalnio;Zuikučiai;7099047041;Ne;5;1;0;6
17328;Žaliakalnio;Zuikučiai;9378617562;Ne;1;0;0;1
17329;Žaliakalnio;Zuikučiai;6659576919;Ne;15;0;0;15
17330;Žaliakalnio;Zuikučiai;7047556229;Ne;0;2;0;2
17331;Žaliakalnio;Zuikučiai;4563419248;Ne;14;1;0;15
17332;Žaliakalnio;Zuikučiai;3032513275;Ne;5;0;0;5
17333;Žaliakalnio;Zuikučiai;7495990953;Taip;3;1;0;4
17334;Žaliakalnio;Zuikučiai;5566009966;Ne;11;2;0;13
17335;Žaliakalnio;Bitutė;5744370516;Ne;8;0;0;8
17336;Žaliakalnio;Bitutė;3619817569;Ne;6;1;0;7
17337;Žaliakalnio;Bitutė;3905448562;Ne;9;1;0;10
17338;Žaliakalnio;Bitutė;8481665290;Ne;11;2;0;13
17339;Žaliakalnio;Bitutė;8950583202;Ne;0;1;0;1
17340;Žaliakalnio;Bitutė;6324315523;Ne;7;2;0;9
17341;Žaliakalnio;Bitutė;6877235095;Ne;12;0;0;12
17342;Žaliakalnio;Bitutė;2280683252;Ne;5;1;0;6
17343;Žaliakalnio;Bitutė;7711347723;Ne;0;0;1;1
17344;Žaliakalnio;Bitutė;8185190219;Taip;0;2;0;2
17345;Žaliakalnio;Bitutė;7830692152;Ne;0;2;0;2
17346;Žaliakalnio;Bitutė;1423481154;Ne;0;2;0;2
17347;Žaliakalnio;Bitutė;4928400872;Ne;0;2;0;2
17348;Žaliakalnio;Bitutė;2613771302;Ne;15;0;0;15
17349;Žaliakalnio;Bitutė;8599646291;Ne;5;0;0;5
17350;Žaliakalnio;Bitutė;1343293430;Ne;0;1;0;1
17351;Žaliakalnio;Bitutė;3721878250;Ne;10;1;0;11
17352;Žaliakalnio;Bitutė;6291287113;Ne;0;2;1;3
17353;Žaliakalnio;Bitutė;1173977434;Ne;3;1;0;4
17354;Žaliakalnio;Bitutė;9485995178;Ne;0;4;0;4
17355;Žaliakalnio;Bitutė;1309236035;Ne;15;0;0;15
17356;Žaliakalnio;Bitutė;8534973941;Ne;14;1;0;15
17357;Žaliakalnio;Nykštukų;9069518153;Taip;7;2;0;9
17358;Žaliakalnio;Nykštukų;8142435757;Ne;1;2;0;3
17359;Žaliakalnio;Nykštukų;3446593135;Ne;6;0;0;6
17360;Žaliakalnio;Nykštukų;1064854294;Taip;0;2;0;2
17361;Žaliakalnio;Nykštukų;1632465983;Ne;0;4;0;4
17362;Žaliakalnio;Nykštukų;9521104462;Taip;10;0;0;10
17363;Žaliakalnio;Nykštukų;5565027085;Ne;2;0;0;2
17364;Žaliakalnio;Nykštukų;2242604156;Ne;2;2;0;4
17365;Žaliakalnio;Nykštukų;2225778044;Ne;3;1;0;4
17366;Žaliakalnio;Nykštukų;4255734788;Ne;13;0;0;13
17367;Žaliakalnio;Nykštukų;7793937917;Ne;13;1;0;14
17368;Žaliakalnio;Nykštukų;8117013474;Ne;2;0;0;2
17369;Žaliakalnio;Nykštukų;7205368281;Ne;0;1;0;1
17370;Žaliakalnio;Nykštukų;4036239701;Ne;0;11;0;11
17371;Žaliakalnio;Nykštukų;5258266970;Ne;14;0;0;14
17372;Žaliakalnio;Nykštukų;3041002600;Ne;4;1;0;5
17373;Žaliakalnio;Nykštukų;4154737541;Ne;1;0;0;1
17374;Žaliakalnio;Nykštukų;2155412338;Ne;0;4;0;4
17375;Žaliakalnio;Nykštukų;1511302012;Ne;2;1;0;3
17376;Žaliakalnio;ŽIOGELIAI;2426844621;Ne;3;2;0;5
17377;Žaliakalnio;ŽIOGELIAI;1133557422;Ne;0;5;0;5
17378;Žaliakalnio;ŽIOGELIAI;3464935314;Ne;0;3;0;3
17379;Žaliakalnio;ŽIOGELIAI;7648422668;Ne;2;0;0;2
17380;Žaliakalnio;ŽIOGELIAI;4702470511;Ne;0;3;0;3
17381;Žaliakalnio;ŽIOGELIAI;2272043654;Ne;5;0;0;5
17382;Žaliakalnio;ŽIOGELIAI;8518422934;Ne;2;0;0;2
17383;Žaliakalnio;ŽIOGELIAI;6674631040;Taip;11;0;0;11
17384;Žaliakalnio;ŽIOGELIAI;8245784590;Ne;20;0;0;20
17385;Žaliakalnio;ŽIOGELIAI;8383425712;Ne;7;0;0;7
17386;Žaliakalnio;ŽIOGELIAI;2514763739;Ne;5;0;0;5
17387;Žaliakalnio;ŽIOGELIAI;8891815592;Ne;7;0;0;7
17388;Žaliakalnio;ŽIOGELIAI;6294045755;Ne;15;1;0;16
17389;Žaliakalnio;ŽIOGELIAI;8232697563;Ne;6;4;0;10
17390;Žaliakalnio;ŽIOGELIAI;2694424532;Ne;12;1;0;13
17391;Žaliakalnio;ŽIOGELIAI;6136717862;Ne;4;0;0;4
17392;Žaliakalnio;ŽIOGELIAI;8568306789;Ne;0;1;0;1
17393;Žaliakalnio;ŽIOGELIAI;9383567339;Ne;0;4;0;4
17394;Žaliakalnio;SAULUTĖS;1253655689;Ne;0;1;0;1
17395;Žaliakalnio;SAULUTĖS;6795532166;Ne;0;1;0;1
17396;Žaliakalnio;SAULUTĖS;7913029369;Ne;3;3;0;6
17397;Žaliakalnio;SAULUTĖS;7793917852;Ne;7;2;0;9
17398;Žaliakalnio;SAULUTĖS;3018398546;Ne;0;2;0;2
17399;Žaliakalnio;SAULUTĖS;8765159796;Ne;0;1;0;1
17400;Žaliakalnio;SAULUTĖS;3028921540;Ne;7;3;0;10
17401;Žaliakalnio;SAULUTĖS;4355433666;Ne;0;1;0;1
17402;Žaliakalnio;SAULUTĖS;1715385224;Ne;12;2;0;14
17403;Žaliakalnio;SAULUTĖS;3304186400;Taip;0;13;0;13
17404;Žaliakalnio;SAULUTĖS;3832291926;Ne;0;8;0;8
17405;Žaliakalnio;SAULUTĖS;7071209465;Ne;0;1;0;1
17406;Žaliakalnio;SAULUTĖS;7543073516;Ne;0;3;0;3
17407;Žaliakalnio;SAULUTĖS;2806386840;Ne;18;0;0;18
17408;Žaliakalnio;SAULUTĖS;9267349375;Taip;0;1;0;1
17409;Žaliakalnio;SAULUTĖS;7989372873;Ne;0;2;0;2
17410;Žaliakalnio;SAULUTĖS;4412760433;Ne;10;0;0;10
17411;Volungė;Bitutės;6661730121;Ne;1;0;0;1
17412;Volungė;Bitutės;5791161943;Ne;0;0;1;1
17413;Volungė;Bitutės;3307326410;Ne;5;0;3;8
17414;Volungė;Bitutės;6755366051;Ne;5;0;0;5
17415;Volungė;Bitutės;4013639324;Ne;5;0;0;5
17416;Volungė;Bitutės;5892600735;Ne;0;2;7;9
17417;Volungė;Bitutės;1902122510;Ne;7;0;1;8
17418;Volungė;Bitutės;1752817125;Ne;3;3;1;7
17419;Volungė;Bitutės;3515725398;Ne;0;0;2;2
17420;Volungė;Bitutės;3666364101;Ne;0;0;1;1
17421;Volungė;Bitutės;7151952679;Ne;13;0;0;13
17422;Volungė;Bitutės;5960027749;Ne;0;0;4;4
17423;Volungė;Bitutės;5149291935;Ne;2;0;0;2
17424;Volungė;Bitutės;8166517073;Ne;2;0;1;3
17425;Volungė;Bitutės;9842009354;Ne;4;0;3;7
17426;Volungė;Bitutės;9933980783;Ne;19;0;0;19
17427;Volungė;Bitutės;4685227759;Ne;0;0;1;1
17428;Volungė;Boružiukai;6445614647;Taip;15;0;4;19
17429;Volungė;Boružiukai;1592634034;Ne;8;0;0;8
17430;Volungė;Boružiukai;5588544003;Ne;0;1;1;2
17431;Volungė;Boružiukai;3758750922;Ne;13;0;4;17
17432;Volungė;Boružiukai;5561683986;Ne;0;0;1;1
17433;Volungė;Boružiukai;9562426487;Ne;5;4;0;9
17434;Volungė;Boružiukai;4136178027;Ne;0;2;0;2
17435;Volungė;Boružiukai;4664635246;Taip;0;10;5;15
17436;Volungė;Boružiukai;8987748481;Ne;5;0;1;6
17437;Volungė;Boružiukai;5882826586;Ne;11;0;2;13
17438;Volungė;Boružiukai;5338942678;Ne;5;0;0;5
17439;Volungė;Boružiukai;5054666349;Ne;2;0;0;2
17440;Volungė;Žvirbliukai;2360026330;Ne;0;0;1;1
17441;Volungė;Žvirbliukai;8414351815;Ne;0;0;3;3
17442;Volungė;Žvirbliukai;2051410463;Taip;10;0;3;13
17443;Volungė;Žvirbliukai;5750385275;Taip;10;0;4;14
17444;Volungė;Žvirbliukai;9575894080;Taip;14;0;0;14
17445;Volungė;Žvirbliukai;8927595898;Ne;8;0;0;8
17446;Volungė;Žvirbliukai;9384821249;Ne;0;0;2;2
17447;Volungė;Žvirbliukai;5361410157;Ne;0;0;5;5
17448;Volungė;Žvirbliukai;2949033093;Ne;10;0;0;10
17449;Volungė;Žvirbliukai;2159667991;Ne;5;0;0;5
17450;Volungė;Žvirbliukai;5470252589;Ne;0;0;5;5
17451;Volungė;Žvirbliukai;1022606584;Ne;12;0;0;12
17452;Volungė;Žvirbliukai;8894121428;Ne;11;0;0;11
17453;Volungė;Žvirbliukai;9139746132;Ne;0;0;1;1
17454;Volungė;Žvirbliukai;3332069842;Ne;0;0;1;1
17455;Volungė;Žvirbliukai;4605844193;Ne;8;0;0;8
17456;Volungė;Žiogeliai;6360834021;Ne;0;0;8;8
17457;Volungė;Žiogeliai;4856240879;Ne;0;0;4;4
17458;Volungė;Žiogeliai;4694016281;Ne;3;0;0;3
17459;Volungė;Žiogeliai;8640511964;Ne;0;0;1;1
17460;Volungė;Žiogeliai;5170536566;Ne;0;0;2;2
17461;Volungė;Žiogeliai;8421730419;Ne;5;2;5;12
17462;Volungė;Žiogeliai;6532202782;Ne;0;0;15;15
17463;Volungė;Žiogeliai;2712034356;Ne;0;0;2;2
17464;Volungė;Žiogeliai;2246291631;Ne;8;0;0;8
17465;Volungė;Žiogeliai;2456643081;Ne;0;0;1;1
17466;Volungė;Žiogeliai;8299305464;Ne;5;0;7;12
17467;Volungė;Žiogeliai;8578521969;Ne;5;0;0;5
17468;Volungė;Žiogeliai;4839484528;Ne;6;0;0;6
17469;Volungė;Žiogeliai;2187800215;Ne;0;0;1;1
17470;Volungė;Pelėdžiukai;6431477042;Ne;0;8;5;13
17471;Volungė;Pelėdžiukai;3528581949;Ne;0;0;2;2
17472;Volungė;Pelėdžiukai;1137713075;Ne;0;4;0;4
17473;Volungė;Pelėdžiukai;2322594823;Ne;0;3;0;3
17474;Volungė;Pelėdžiukai;7965601199;Ne;0;0;4;4
17475;Volungė;Pelėdžiukai;2603335248;Taip;1;0;0;1
17476;Volungė;Pelėdžiukai;1974650443;Ne;0;0;1;1
17477;Volungė;Pelėdžiukai;2068447339;Taip;0;20;0;20
17478;Volungė;Pelėdžiukai;9188994935;Ne;0;12;0;12
17479;Volungė;Pelėdžiukai;1757041481;Ne;0;0;1;1
17480;Volungė;Pelėdžiukai;8285309230;Ne;16;0;0;16
17481;Volungė;Pelėdžiukai;7149986415;Ne;0;0;2;2
17482;Volungė;Pelėdžiukai;4598763851;Ne;0;3;0;3
17483;Volungė;Pelėdžiukai;2627555750;Ne;3;0;4;7
17484;Volungė;Pelėdžiukai;7867741556;Ne;0;0;1;1
17485;Volungė;Pelėdžiukai;7971287899;Ne;0;0;11;11
17486;Volungė;Pelėdžiukai;9729285419;Ne;0;0;5;5
17487;Volungė;Pelėdžiukai;8459167833;Ne;1;0;0;1
17488;Volungė;Drugeliai;6280208510;Ne;4;1;0;5
17489;Volungė;Drugeliai;4032261812;Ne;5;3;0;8
17490;Volungė;Drugeliai;6488473384;Ne;3;0;0;3
17491;Volungė;Drugeliai;8045459660;Ne;0;1;3;4
17492;Volungė;Drugeliai;1402200673;Ne;0;1;3;4
17493;Volungė;Drugeliai;7574856429;Ne;4;0;0;4
17494;Volungė;Drugeliai;5284011092;Ne;0;0;2;2
17495;Volungė;Drugeliai;2686827560;Taip;0;0;2;2
17496;Volungė;Drugeliai;9973604148;Ne;0;0;2;2
17497;Volungė;Drugeliai;8905401944;Ne;7;0;1;8
17498;Volungė;Drugeliai;6782622442;Ne;0;0;1;1
17499;Volungė;Drugeliai;4745609424;Taip;5;0;0;5
17500;Volungė;Drugeliai;7584598377;Ne;0;0;2;2
17501;Volungė;"SKRUZDĖLIUKAI ";3394646139;Ne;8;0;0;8
17502;Volungė;"SKRUZDĖLIUKAI ";6464890465;Ne;6;0;1;7
17503;Volungė;"SKRUZDĖLIUKAI ";2493541457;Ne;0;0;5;5
17504;Volungė;"SKRUZDĖLIUKAI ";1948015523;Ne;3;0;0;3
17505;Volungė;"SKRUZDĖLIUKAI ";1101228927;Ne;6;0;0;6
17506;Volungė;"SKRUZDĖLIUKAI ";5332306628;Ne;0;0;6;6
17507;Volungė;"SKRUZDĖLIUKAI ";9319825151;Taip;5;0;0;5
17508;Volungė;"SKRUZDĖLIUKAI ";6370584522;Ne;0;3;0;3
17509;Volungė;"SKRUZDĖLIUKAI ";8168630107;Ne;0;4;0;4
17510;Volungė;"SKRUZDĖLIUKAI ";3818924175;Ne;3;0;0;3
17511;Volungė;"SKRUZDĖLIUKAI ";6110117105;Ne;10;0;0;10
17512;Volungė;"SKRUZDĖLIUKAI ";4944556574;Ne;0;3;0;3
17513;Volungė;"SKRUZDĖLIUKAI ";2212423676;Ne;3;0;0;3
17514;Volungė;"SKRUZDĖLIUKAI ";5942497397;Ne;8;0;3;11
17515;Volungė;"SKRUZDĖLIUKAI ";4991465781;Ne;0;0;2;2
17516;Volungė;"SKRUZDĖLIUKAI ";8613580206;Ne;1;0;0;1
17517;Volungė;Zylutės;6715770777;Ne;0;0;3;3
17518;Volungė;Zylutės;2874194121;Ne;5;0;2;7
17519;Volungė;Zylutės;4363877851;Ne;6;0;0;6
17520;Volungė;Zylutės;1877753679;Ne;13;0;2;15
17521;Volungė;Zylutės;9005691348;Ne;3;0;2;5
17522;Volungė;Zylutės;2765042584;Ne;9;0;2;11
17523;Volungė;Zylutės;7754202158;Taip;4;0;0;4
17524;Volungė;Zylutės;9519564424;Ne;6;0;0;6
17525;Volungė;Zylutės;5497911485;Ne;5;0;0;5
17526;Volungė;Zylutės;5345072950;Ne;13;0;2;15
17527;Volungė;Zylutės;2404239677;Ne;4;0;0;4
17528;Giliukas;SMALSUČIAI;9462634699;Ne;8;0;0;8
17529;Giliukas;SMALSUČIAI;7646966187;Ne;2;0;0;2
17530;Giliukas;SMALSUČIAI;3274313536;Taip;0;1;0;1
17531;Giliukas;SMALSUČIAI;9287193955;Ne;5;4;0;9
17532;Giliukas;SMALSUČIAI;7944198886;Ne;5;0;0;5
17533;Giliukas;SMALSUČIAI;5527212334;Ne;5;2;0;7
17534;Giliukas;SMALSUČIAI;9499591494;Ne;0;1;0;1
17535;Giliukas;SMALSUČIAI;2099575372;Ne;4;0;2;6
17536;Giliukas;SMALSUČIAI;7195772641;Ne;5;0;0;5
17537;Giliukas;SMALSUČIAI;4258921446;Ne;0;4;0;4
17538;Giliukas;SMALSUČIAI;1439350058;Ne;5;0;0;5
17539;Giliukas;SMALSUČIAI;4843920452;Ne;8;0;3;11
17540;Giliukas;SMALSUČIAI;2004782696;Taip;0;2;0;2
17541;Giliukas;SMALSUČIAI;8977247073;Ne;0;0;2;2
17542;Giliukas;SMALSUČIAI;9229086918;Ne;0;3;0;3
17543;Giliukas;SMALSUČIAI;2349166172;Ne;0;0;1;1
17544;Giliukas;SMALSUČIAI;8241215831;Ne;6;0;2;8
17545;Giliukas;GUDRUČIAI;4960232685;Taip;0;1;0;1
17546;Giliukas;GUDRUČIAI;9458262379;Ne;1;0;0;1
17547;Giliukas;GUDRUČIAI;6148883070;Ne;1;0;0;1
17548;Giliukas;GUDRUČIAI;7425654504;Ne;3;2;0;5
17549;Giliukas;GUDRUČIAI;7130696530;Ne;1;3;0;4
17550;Giliukas;GUDRUČIAI;3150981084;Ne;0;3;0;3
17551;Giliukas;GUDRUČIAI;6134554678;Ne;0;6;0;6
17552;Giliukas;GUDRUČIAI;3137768675;Ne;5;0;0;5
17553;Giliukas;GUDRUČIAI;2064182165;Ne;11;0;0;11
17554;Giliukas;GUDRUČIAI;6956862865;Ne;0;2;0;2
17555;Giliukas;GUDRUČIAI;9617542456;Ne;0;7;0;7
17556;Giliukas;GUDRUČIAI;9274289812;Ne;1;5;0;6
17557;Giliukas;GUDRUČIAI;3718774263;Ne;13;7;0;20
17558;Giliukas;GUDRUČIAI;9152432124;Ne;6;0;0;6
17559;Giliukas;GUDRUČIAI;4854370266;Ne;2;0;0;2
17560;Giliukas;GUDRUČIAI;6338583515;Ne;4;2;0;6
17561;Giliukas;GUDRUČIAI;6703080106;Ne;9;0;0;9
17562;Giliukas;GUDRUČIAI;4347883309;Ne;0;1;0;1
17563;Giliukas;PABIRUČIAI;4183026763;Ne;11;0;0;11
17564;Giliukas;PABIRUČIAI;4247090684;Ne;9;0;0;9
17565;Giliukas;PABIRUČIAI;2379370477;Ne;4;0;0;4
17566;Giliukas;PABIRUČIAI;3054591644;Ne;2;0;0;2
17567;Giliukas;PABIRUČIAI;3870143024;Ne;0;1;0;1
17568;Giliukas;PABIRUČIAI;6914013230;Ne;13;0;0;13
17569;Giliukas;PABIRUČIAI;4810236703;Ne;5;0;0;5
17570;Giliukas;PABIRUČIAI;4105974682;Ne;0;0;2;2
17571;Giliukas;PABIRUČIAI;8874804636;Ne;4;0;0;4
17572;Giliukas;PABIRUČIAI;8626920684;Taip;0;2;0;2
17573;Giliukas;PABIRUČIAI;7012272912;Ne;0;0;1;1
17574;Giliukas;PABIRUČIAI;1075275967;Ne;7;0;0;7
17575;Giliukas;PABIRUČIAI;3268682615;Ne;2;0;0;2
17576;Giliukas;PABIRUČIAI;4838600191;Ne;14;0;1;15
17577;Giliukas;PABIRUČIAI;1395779355;Ne;6;0;1;7
17578;Giliukas;ŠVELNUKAI;9224387185;Ne;2;0;0;2
17579;Giliukas;ŠVELNUKAI;9360994563;Ne;4;0;0;4
17580;Giliukas;ŠVELNUKAI;2012365132;Taip;6;0;0;6
17581;Giliukas;ŠVELNUKAI;4565216956;Ne;2;0;0;2
17582;Giliukas;ŠVELNUKAI;5000654626;Ne;3;0;0;3
17583;Giliukas;ŠVELNUKAI;8973584424;Ne;4;0;0;4
17584;Giliukas;ŠVELNUKAI;9679421414;Ne;14;1;0;15
17585;Giliukas;ŠVELNUKAI;3238820351;Ne;2;0;0;2
17586;Giliukas;ŠVELNUKAI;4340602792;Taip;2;0;0;2
17587;Giliukas;ŠVELNUKAI;6563305502;Ne;2;2;0;4
17588;Giliukas;ŠVELNUKAI;4301950538;Ne;6;0;0;6
17589;Giliukas;ŠVELNUKAI;7657935162;Ne;2;0;0;2
17590;Giliukas;ŽINIUKAI;2502801547;Ne;5;2;0;7
17591;Giliukas;ŽINIUKAI;5201020765;Ne;20;1;0;21
17592;Giliukas;ŽINIUKAI;2042324002;Ne;3;0;0;3
17593;Giliukas;ŽINIUKAI;2801731379;Ne;14;2;0;16
17594;Giliukas;ŽINIUKAI;8499893356;Ne;0;14;0;14
17595;Giliukas;ŽINIUKAI;3720032249;Ne;10;0;0;10
17596;Giliukas;ŽINIUKAI;3659105022;Ne;1;5;0;6
17597;Giliukas;ŽINIUKAI;4940718205;Ne;1;2;0;3
17598;Giliukas;ŽINIUKAI;8491008130;Taip;24;0;0;24
17599;Giliukas;ŽINIUKAI;4163383707;Ne;2;2;0;4
17600;Giliukas;ŽINIUKAI;1332725572;Ne;9;6;0;15
17601;Giliukas;ŽINIUKAI;2798676079;Ne;0;1;0;1
17602;Giliukas;ŽINIUKAI;4404761569;Ne;3;0;1;4
17603;Giliukas;ŽINIUKAI;1915809569;Ne;0;3;0;3
17604;Giliukas;ŽINIUKAI;2787116787;Ne;0;3;0;3
17605;Giliukas;MYLIMUKAI;7481387658;Ne;1;0;0;1
17606;Giliukas;MYLIMUKAI;7290236898;Ne;16;0;0;16
17607;Giliukas;MYLIMUKAI;2045566679;Taip;10;0;0;10
17608;Giliukas;MYLIMUKAI;8012946026;Ne;4;0;2;6
17609;Giliukas;MYLIMUKAI;7406406981;Ne;2;2;2;6
17610;Giliukas;MYLIMUKAI;2169949712;Ne;5;4;0;9
17611;Giliukas;MYLIMUKAI;5467076457;Ne;2;0;0;2
17612;Giliukas;MYLIMUKAI;2109668106;Ne;13;0;0;13
17613;Giliukas;MYLIMUKAI;6650117646;Ne;6;0;0;6
17614;Giliukas;MYLIMUKAI;5199968458;Ne;9;0;0;9
17615;Giliukas;MYLIMUKAI;3185622470;Ne;7;0;5;12
17616;Giliukas;MYLIMUKAI;8414652507;Ne;20;0;0;20
17617;Giliukas;MYLIMUKAI;7560774044;Ne;10;0;0;10
17618;Giliukas;MYLIMUKAI;3717956257;Ne;4;0;0;4
17619;Giliukas;ČIAUŠKUČIAI;6742406486;Ne;5;0;0;5
17620;Giliukas;ČIAUŠKUČIAI;2840410579;Ne;15;3;0;18
17621;Giliukas;ČIAUŠKUČIAI;7316126011;Ne;12;1;0;13
17622;Giliukas;ČIAUŠKUČIAI;9134734376;Ne;6;0;1;7
17623;Giliukas;ČIAUŠKUČIAI;3728323646;Ne;12;0;0;12
17624;Giliukas;ČIAUŠKUČIAI;1710286878;Ne;1;0;5;6
17625;Giliukas;ČIAUŠKUČIAI;9704885611;Ne;0;0;1;1
17626;Giliukas;ČIAUŠKUČIAI;7993049824;Ne;21;0;1;22
17627;Giliukas;ČIAUŠKUČIAI;2700296404;Ne;2;0;3;5
17628;Giliukas;ČIAUŠKUČIAI;9160815037;Taip;4;0;0;4
17629;Giliukas;ČIAUŠKUČIAI;1221640023;Ne;9;2;3;14
17630;Giliukas;ČIAUŠKUČIAI;2298554837;Ne;0;0;3;3
17631;Giliukas;ŠNEKUČIAI;1762536884;Ne;3;0;0;3
17632;Giliukas;ŠNEKUČIAI;2612551188;Ne;8;0;0;8
17633;Giliukas;ŠNEKUČIAI;9366734581;Taip;5;0;0;5
17634;Giliukas;ŠNEKUČIAI;7053406257;Ne;8;1;0;9
17635;Giliukas;ŠNEKUČIAI;2226855971;Ne;4;0;0;4
17636;Giliukas;ŠNEKUČIAI;2742106493;Ne;5;2;0;7
17637;Giliukas;ŠNEKUČIAI;3726149759;Ne;2;2;0;4
17638;Giliukas;ŠNEKUČIAI;6748766233;Ne;2;0;0;2
17639;Giliukas;ŠNEKUČIAI;6953123617;Ne;0;2;0;2
17640;Giliukas;ŠNEKUČIAI;5222092567;Ne;2;0;0;2
17641;Giliukas;ŠNEKUČIAI;3055598917;Ne;0;1;0;1
17642;Giliukas;ŠNEKUČIAI;4581414740;Taip;9;2;0;11
17643;Giliukas;ŠNEKUČIAI;7431116067;Ne;4;0;0;4
17644;Giliukas;ŠNEKUČIAI;7205807049;Ne;3;1;0;4
17645;Giliukas;ŠNEKUČIAI;1165810193;Ne;3;1;0;4
17646;Giliukas;ŠNEKUČIAI;1916905497;Ne;3;0;0;3
17647;Giliukas;ŠNEKUČIAI;5625404051;Ne;7;0;0;7
17648;"Lazdynų mokykla (Žėručio g. 4)";LEPG;7487278074;Ne;5;0;0;5
17649;"Lazdynų mokykla (Žėručio g. 4)";LEPG;7320049068;Ne;5;0;0;5
17650;"Lazdynų mokykla (Žėručio g. 4)";LEPG;1396367371;Ne;2;0;0;2
17651;"Lazdynų mokykla (Žėručio g. 4)";LEPG;7324846434;Ne;4;0;0;4
17652;"Lazdynų mokykla (Žėručio g. 4)";LEPG;7659209862;Ne;12;0;0;12
17653;"Lazdynų mokykla (Žėručio g. 4)";LEPG;9654428418;Ne;7;0;0;7
17654;"Lazdynų mokykla (Žėručio g. 4)";LEPG;3435025978;Ne;0;0;1;1
17655;"Lazdynų mokykla (Žėručio g. 4)";LEPG;5420067622;Ne;0;0;2;2
17656;"Lazdynų mokykla (Žėručio g. 4)";LEPG;1738732866;Ne;0;0;7;7
17657;"Lazdynų mokykla (Žėručio g. 4)";LEPG;8990701154;Ne;11;0;1;12
17658;"Lazdynų mokykla (Žėručio g. 4)";LEPG;2666441234;Ne;9;0;0;9
17659;"Lazdynų mokykla (Žėručio g. 4)";RUPG-1;4776074273;Ne;3;0;0;3
17660;"Lazdynų mokykla (Žėručio g. 4)";RUPG-1;7110858765;Ne;4;0;0;4
17661;"Lazdynų mokykla (Žėručio g. 4)";RUPG-1;6577255841;Ne;5;0;0;5
17662;"Lazdynų mokykla (Žėručio g. 4)";RUPG-1;7647195979;Ne;8;0;0;8
17663;"Lazdynų mokykla (Žėručio g. 4)";RUPG-1;4715171946;Ne;12;0;0;12
17664;"Lazdynų mokykla (Žėručio g. 4)";RUPG-1;2700475528;Ne;8;0;0;8
17665;"Lazdynų mokykla (Žėručio g. 4)";RUPG-1;7180617984;Ne;2;0;0;2
17666;"Lazdynų mokykla (Žėručio g. 4)";RUPG-1;2308739823;Ne;1;0;0;1
17667;"Lazdynų mokykla (Žėručio g. 4)";RUPG-1;5015519090;Ne;7;0;0;7
17668;"Lazdynų mokykla (Žėručio g. 4)";RUPG-1;9968637187;Ne;15;0;0;15
17669;"Lazdynų mokykla (Žėručio g. 4)";RUPG-1;8886654664;Ne;11;0;0;11
17670;"Lazdynų mokykla (Žėručio g. 4)";RUPG-2;3837424301;Ne;0;0;1;1
17671;"Lazdynų mokykla (Žėručio g. 4)";RUPG-2;8720878006;Ne;0;20;0;20
17672;"Lazdynų mokykla (Žėručio g. 4)";RUPG-2;8675089149;Ne;2;0;0;2
17673;"Lazdynų mokykla (Žėručio g. 4)";RUPG-2;7963866641;Ne;9;0;0;9
17674;"Lazdynų mokykla (Žėručio g. 4)";RUPG-2;9982496951;Ne;10;0;0;10
17675;"Lazdynų mokykla (Žėručio g. 4)";RUPG-2;8229454863;Taip;0;0;3;3
17676;"Lazdynų mokykla (Žėručio g. 4)";RUPG-2;5806696915;Ne;8;0;0;8
17677;"Lazdynų mokykla (Žėručio g. 4)";RUPG-2;3634678954;Ne;10;4;0;14
17678;"Lazdynų mokykla (Žėručio g. 4)";RUPG-2;5770044886;Ne;9;2;0;11
17679;"Lazdynų mokykla (Žėručio g. 4)";RUPG-2;2539006620;Ne;0;20;0;20
17680;"Lazdynų mokykla (Žėručio g. 4)";RUPG-2;8757701456;Ne;0;1;0;1
17681;"Lazdynų mokykla (Žėručio g. 4)";RUPG-2;9534937419;Ne;6;0;0;6
17682;"Vilnios pagrindinė mokykla";DRUGELIAI;8384925496;Ne;31;0;0;31
17683;"„Atžalyno” mokykla-darželis";Giliukai;7652421432;Ne;3;0;0;3
17684;"„Atžalyno” mokykla-darželis";Giliukai;1961428224;Ne;3;0;1;4
17685;"„Atžalyno” mokykla-darželis";Giliukai;9101301819;Ne;2;0;0;2
17686;"„Atžalyno” mokykla-darželis";Giliukai;8320161812;Ne;0;0;2;2
17687;"„Atžalyno” mokykla-darželis";Giliukai;7669725276;Ne;5;0;0;5
17688;"„Atžalyno” mokykla-darželis";Giliukai;4784990018;Ne;11;0;0;11
17689;"„Atžalyno” mokykla-darželis";Giliukai;2462839180;Ne;7;0;0;7
17690;"„Atžalyno” mokykla-darželis";Giliukai;8070499557;Ne;0;0;8;8
17691;"„Atžalyno” mokykla-darželis";Giliukai;1915676392;Ne;7;0;0;7
17692;"„Atžalyno” mokykla-darželis";Giliukai;4107946143;Ne;4;0;0;4
17693;"„Atžalyno” mokykla-darželis";Giliukai;9913048992;Ne;2;0;1;3
17694;"„Atžalyno” mokykla-darželis";Giliukai;5335059675;Ne;3;0;1;4
17695;"„Atžalyno” mokykla-darželis";Giliukai;9690554753;Ne;3;0;0;3
17696;"„Atžalyno” mokykla-darželis";Giliukai;2446697763;Ne;0;0;1;1
17697;"„Atžalyno” mokykla-darželis";Giliukai;7579781779;Ne;0;0;1;1
17698;"„Atžalyno” mokykla-darželis";Giliukai;7883570492;Ne;9;0;1;10
17699;"„Atžalyno” mokykla-darželis";Giliukai;4616870552;Ne;2;0;0;2
17700;"„Atžalyno” mokykla-darželis";Giliukai;5986664970;Ne;3;0;0;3
17701;"„Atžalyno” mokykla-darželis";Giliukai;6903825217;Ne;1;0;1;2
17702;"„Atžalyno” mokykla-darželis";Giliukai;8357021249;Ne;1;0;0;1
17703;"„Atžalyno” mokykla-darželis";Giliukai;4166521512;Ne;3;0;0;3
17704;"„Atžalyno” mokykla-darželis";Giliukai;8372179128;Ne;1;0;3;4
17705;"„Atžalyno” mokykla-darželis";Riešutėliai;4360099345;Ne;6;2;0;8
17706;"„Atžalyno” mokykla-darželis";Riešutėliai;5947938371;Ne;0;0;12;12
17707;"„Atžalyno” mokykla-darželis";Riešutėliai;5384245347;Ne;11;0;0;11
17708;"„Atžalyno” mokykla-darželis";Riešutėliai;4246430352;Ne;11;0;0;11
17709;"„Atžalyno” mokykla-darželis";Riešutėliai;8574494664;Ne;2;6;0;8
17710;"„Atžalyno” mokykla-darželis";Riešutėliai;5815412814;Ne;2;0;1;3
17711;"„Atžalyno” mokykla-darželis";Riešutėliai;4161658496;Ne;0;8;1;9
17712;"„Atžalyno” mokykla-darželis";Riešutėliai;8942132574;Ne;0;6;0;6
17713;"„Atžalyno” mokykla-darželis";Riešutėliai;3564781987;Ne;0;0;1;1
17714;"„Atžalyno” mokykla-darželis";Riešutėliai;7368616441;Taip;5;0;4;9
17715;"„Atžalyno” mokykla-darželis";Riešutėliai;5242752663;Ne;9;0;0;9
17716;"„Atžalyno” mokykla-darželis";Riešutėliai;8803555426;Ne;7;2;2;11
17717;"„Atžalyno” mokykla-darželis";Riešutėliai;5994983369;Ne;0;2;0;2
17718;"„Atžalyno” mokykla-darželis";Riešutėliai;7676614240;Ne;0;1;0;1
17719;"„Atžalyno” mokykla-darželis";Riešutėliai;3751729666;Ne;5;0;2;7
17720;"„Atžalyno” mokykla-darželis";Riešutėliai;3441950153;Ne;0;11;0;11
17721;"„Atžalyno” mokykla-darželis";Riešutėliai;4223591454;Ne;0;0;3;3
17722;"„Atžalyno” mokykla-darželis";Riešutėliai;8625074554;Ne;3;4;0;7
17723;"„Atžalyno” mokykla-darželis";Riešutėliai;3555868198;Ne;13;0;1;14
17724;"„Atžalyno” mokykla-darželis";Žirniukai;2849915655;Ne;6;0;0;6
17725;"„Atžalyno” mokykla-darželis";Žirniukai;6120955217;Taip;0;8;0;8
17726;"„Atžalyno” mokykla-darželis";Žirniukai;1787256844;Ne;7;1;0;8
17727;"„Atžalyno” mokykla-darželis";Žirniukai;2547003287;Ne;8;1;0;9
17728;"„Atžalyno” mokykla-darželis";Žirniukai;3664056583;Ne;4;4;0;8
17729;"„Atžalyno” mokykla-darželis";Žirniukai;5456248305;Taip;16;0;0;16
17730;"„Atžalyno” mokykla-darželis";Žirniukai;3719072139;Ne;14;0;0;14
17731;"„Atžalyno” mokykla-darželis";Žirniukai;9245994735;Ne;11;0;0;11
17732;"„Atžalyno” mokykla-darželis";Žirniukai;2000352986;Ne;7;1;0;8
17733;"„Atžalyno” mokykla-darželis";Žirniukai;2177213062;Ne;5;0;0;5
17734;"„Atžalyno” mokykla-darželis";Žirniukai;4635394632;Ne;9;0;0;9
17735;"„Atžalyno” mokykla-darželis";Žirniukai;3524131672;Ne;12;0;0;12
17736;"„Atžalyno” mokykla-darželis";Žirniukai;4840490901;Ne;6;1;0;7
17737;"„Atžalyno” mokykla-darželis";Žirniukai;4796052680;Ne;9;0;2;11
17738;"„Atžalyno” mokykla-darželis";Žirniukai;3181675972;Taip;4;0;0;4
17739;"„Atžalyno” mokykla-darželis";Žirniukai;8163063211;Ne;9;0;0;9
17740;"„Atžalyno” mokykla-darželis";Žirniukai;4431437971;Ne;2;0;0;2
17741;"„Atžalyno” mokykla-darželis";Žirniukai;3770167696;Ne;5;0;3;8
17742;"„Atžalyno” mokykla-darželis";Žirniukai;6307949550;Ne;19;0;10;29
17743;"„Atžalyno” mokykla-darželis";Žirniukai;7625074947;Ne;23;0;0;23
17744;"„Atžalyno” mokykla-darželis";VYŠNIUKAI;9216535506;Ne;5;0;0;5
17745;"„Atžalyno” mokykla-darželis";VYŠNIUKAI;6960661098;Ne;2;1;0;3
17746;"„Atžalyno” mokykla-darželis";VYŠNIUKAI;1059756637;Ne;10;1;0;11
17747;"„Atžalyno” mokykla-darželis";VYŠNIUKAI;7999992997;Ne;29;0;0;29
17748;"„Atžalyno” mokykla-darželis";VYŠNIUKAI;8872288787;Ne;19;0;1;20
17749;"„Atžalyno” mokykla-darželis";VYŠNIUKAI;5410469885;Ne;13;1;0;14
17750;"„Atžalyno” mokykla-darželis";VYŠNIUKAI;5878874414;Ne;4;1;0;5
17751;"„Atžalyno” mokykla-darželis";VYŠNIUKAI;3930056490;Ne;0;3;0;3
17752;"„Atžalyno” mokykla-darželis";VYŠNIUKAI;6984404118;Ne;9;0;0;9
17753;"„Atžalyno” mokykla-darželis";VYŠNIUKAI;6939741360;Taip;5;2;0;7
17754;"„Atžalyno” mokykla-darželis";VYŠNIUKAI;5398871923;Ne;0;3;0;3
17755;"„Atžalyno” mokykla-darželis";VYŠNIUKAI;3046953980;Ne;11;0;0;11
17756;"„Atžalyno” mokykla-darželis";VYŠNIUKAI;2825064244;Ne;9;1;0;10
17757;"„Atžalyno” mokykla-darželis";VYŠNIUKAI;3768908704;Ne;4;1;0;5
17758;"„Atžalyno” mokykla-darželis";VYŠNIUKAI;6959131424;Ne;0;1;0;1
17759;"„Atžalyno” mokykla-darželis";VYŠNIUKAI;1851189680;Ne;0;1;0;1
17760;"„Atžalyno” mokykla-darželis";VYŠNIUKAI;5562429493;Ne;2;1;0;3
17761;"„Atžalyno” mokykla-darželis";PIPIRIUKAI;5615246040;Ne;5;0;7;12
17762;"„Atžalyno” mokykla-darželis";PIPIRIUKAI;1988657552;Ne;10;0;15;25
17763;"„Atžalyno” mokykla-darželis";PIPIRIUKAI;6721771665;Taip;0;0;5;5
17764;"„Atžalyno” mokykla-darželis";PIPIRIUKAI;2921181385;Ne;0;3;1;4
17765;"„Atžalyno” mokykla-darželis";PIPIRIUKAI;2108706876;Ne;13;0;1;14
17766;"„Atžalyno” mokykla-darželis";PIPIRIUKAI;1228919159;Ne;0;10;0;10
17767;"„Atžalyno” mokykla-darželis";PIPIRIUKAI;3919301151;Ne;0;8;2;10
17768;"„Atžalyno” mokykla-darželis";PIPIRIUKAI;3624299098;Ne;0;2;0;2
17769;"„Atžalyno” mokykla-darželis";PIPIRIUKAI;2537063401;Ne;2;0;6;8
17770;"„Atžalyno” mokykla-darželis";PIPIRIUKAI;3204191459;Ne;8;2;0;10
17771;"„Atžalyno” mokykla-darželis";PIPIRIUKAI;5321475187;Ne;7;0;0;7
17772;"„Atžalyno” mokykla-darželis";PIPIRIUKAI;3015863723;Ne;5;2;0;7
17773;"„Atžalyno” mokykla-darželis";PIPIRIUKAI;3323233525;Ne;5;2;0;7
17774;"„Atžalyno” mokykla-darželis";PIPIRIUKAI;4596770586;Ne;7;0;1;8
17775;"„Atžalyno” mokykla-darželis";PIPIRIUKAI;1664011018;Ne;20;0;0;20
17776;"„Atžalyno” mokykla-darželis";PIPIRIUKAI;1866452425;Ne;2;0;4;6
17777;"„Atžalyno” mokykla-darželis";PIPIRIUKAI;9737568538;Ne;1;0;1;2
17778;"„Atžalyno” mokykla-darželis";PIPIRIUKAI;5406800599;Ne;0;2;0;2
17779;"„Atžalyno” mokykla-darželis";PIPIRIUKAI;3312254613;Ne;0;3;0;3
17780;"„Atžalyno” mokykla-darželis";PIPIRIUKAI;1443004141;Ne;0;0;10;10
17781;"Vilniaus Naujininkų mokykla";"SAULĖS ZUIKUČIAI";9856315057;Taip;2;2;0;4
17782;"Vilniaus Naujininkų mokykla";"SAULĖS ZUIKUČIAI";1901250406;Ne;0;4;0;4
17783;"Vilniaus Naujininkų mokykla";"SAULĖS ZUIKUČIAI";9411054207;Ne;0;11;0;11
17784;"Vilniaus Naujininkų mokykla";"SAULĖS ZUIKUČIAI";9544088525;Ne;3;2;0;5
17785;"Vilniaus Naujininkų mokykla";"SAULĖS ZUIKUČIAI";9488762308;Ne;16;0;0;16
17786;"Vilniaus Naujininkų mokykla";"SAULĖS ZUIKUČIAI";3929956703;Ne;15;0;0;15
17787;"Vilniaus Naujininkų mokykla";"SAULĖS ZUIKUČIAI";3502355847;Ne;0;4;0;4
17788;"Vilniaus Naujininkų mokykla";"SAULĖS ZUIKUČIAI";4675274695;Taip;5;1;0;6
17789;"Vilniaus Naujininkų mokykla";"SAULĖS ZUIKUČIAI";3243090025;Ne;1;0;0;1
17790;"Vilniaus Naujininkų mokykla";"SAULĖS ZUIKUČIAI";9786654519;Ne;8;0;0;8
17791;"Vilniaus Naujininkų mokykla";"SAULĖS ZUIKUČIAI";6235626283;Ne;3;0;0;3
17792;"Vilniaus Naujininkų mokykla";"SAULĖS ZUIKUČIAI";9699407871;Ne;0;1;0;1
17793;"Vilniaus Naujininkų mokykla";SMALSUČIAI;3654667879;Ne;5;0;0;5
17794;"Vilniaus Naujininkų mokykla";SMALSUČIAI;3192556582;Ne;0;3;0;3
17795;"Vilniaus Naujininkų mokykla";SMALSUČIAI;9993335478;Ne;6;0;0;6
17796;"Vilniaus Naujininkų mokykla";SMALSUČIAI;9990953133;Ne;1;0;0;1
17797;"Vilniaus Naujininkų mokykla";SMALSUČIAI;1306106945;Ne;5;0;0;5
17798;"Vilniaus Naujininkų mokykla";SMALSUČIAI;8555610571;Ne;20;0;0;20
17799;"Vilniaus Naujininkų mokykla";SMALSUČIAI;8637047688;Ne;3;0;0;3
17800;"Vilniaus Naujininkų mokykla";SMALSUČIAI;6417648753;Ne;4;0;0;4
17801;"Vilniaus Naujininkų mokykla";SMALSUČIAI;8935072613;Ne;9;0;0;9
17802;"Vilniaus Naujininkų mokykla";SMALSUČIAI;1096474672;Ne;5;0;0;5
17803;"Vilniaus Naujininkų mokykla";SMALSUČIAI;4784667239;Ne;15;0;0;15
17804;"Vilniaus karaliaus Mindaugo mokykla";"PUG 2";4684525618;Ne;1;0;0;1
17805;"Vilniaus karaliaus Mindaugo mokykla";"PUG 2";2938446054;Ne;0;0;1;1
17806;"Vilniaus karaliaus Mindaugo mokykla";"PUG 2";4992188525;Ne;2;0;0;2
17807;"Vilniaus karaliaus Mindaugo mokykla";"PUG 2";2287044278;Ne;3;0;2;5
17808;"Vilniaus karaliaus Mindaugo mokykla";"PUG 2";7615716438;Ne;2;0;0;2
17809;"Vilniaus karaliaus Mindaugo mokykla";"PUG 2";6906137103;Ne;1;0;1;2
17810;"Vilniaus karaliaus Mindaugo mokykla";"PUG 2";4143844589;Ne;0;0;2;2
17811;"Vilniaus karaliaus Mindaugo mokykla";"PUG 2";8456560292;Ne;2;0;0;2
17812;"Vilniaus karaliaus Mindaugo mokykla";"PUG 2";6384832317;Ne;5;0;1;6
17813;"Vilniaus karaliaus Mindaugo mokykla";"PUG 2";9670205249;Ne;1;0;1;2
17814;"Vilniaus karaliaus Mindaugo mokykla";"PUG 2";3741784446;Ne;0;20;0;20
17815;"Vilniaus karaliaus Mindaugo mokykla";"PUG 2";8578903763;Ne;4;0;0;4
17816;"Vilniaus karaliaus Mindaugo mokykla";"PUG 2";8340697546;Taip;1;0;0;1
17817;"Vilniaus karaliaus Mindaugo mokykla";"PUG 2";9780684867;Ne;0;0;5;5
17818;"Vilniaus karaliaus Mindaugo mokykla";"PUG 2";4920263429;Taip;1;0;0;1
17819;"Vilniaus karaliaus Mindaugo mokykla";"PUG 1";3888408459;Ne;5;0;0;5
17820;"Vilniaus karaliaus Mindaugo mokykla";"PUG 1";7043125057;Ne;10;0;1;11
17821;"Vilniaus karaliaus Mindaugo mokykla";"PUG 1";7064391685;Ne;0;4;0;4
17822;"Vilniaus karaliaus Mindaugo mokykla";"PUG 1";5640182548;Ne;0;1;1;2
17823;"Vilniaus karaliaus Mindaugo mokykla";"PUG 1";4405567649;Ne;10;0;0;10
17824;"Vilniaus karaliaus Mindaugo mokykla";"PUG 1";5752454925;Ne;0;0;1;1
17825;"Vilniaus karaliaus Mindaugo mokykla";"PUG 1";5648658237;Ne;0;0;3;3
17826;"Vilniaus karaliaus Mindaugo mokykla";"PUG 1";7770852445;Ne;4;0;0;4
17827;"Vilniaus karaliaus Mindaugo mokykla";"PUG 1";3953844737;Ne;0;0;1;1
17828;"Vilniaus karaliaus Mindaugo mokykla";"PUG 1";7271589727;Ne;0;0;2;2
17829;"Vilniaus karaliaus Mindaugo mokykla";"PUG 1";1403569615;Ne;0;1;0;1
17830;"Vilniaus karaliaus Mindaugo mokykla";"PUG 1";9651789217;Ne;0;0;3;3
17831;"Vilniaus karaliaus Mindaugo mokykla";"PUG 1";2926077771;Ne;3;0;0;3
17832;"Vilniaus karaliaus Mindaugo mokykla";"PUG 1";3587941684;Ne;7;0;0;7
17833;"Vilniaus karaliaus Mindaugo mokykla";"PUG 1";2549704540;Ne;5;0;1;6
17834;"Vilniaus karaliaus Mindaugo mokykla";"PUG 1";2361829423;Ne;0;0;1;1
17835;"Vilniaus karaliaus Mindaugo mokykla";"PUG 3";7433354196;Ne;1;0;0;1
17836;"Vilniaus karaliaus Mindaugo mokykla";"PUG 3";3252419072;Ne;1;0;0;1
17837;"Vilniaus karaliaus Mindaugo mokykla";"PUG 3";9056468879;Ne;1;0;0;1
17838;"Vilniaus karaliaus Mindaugo mokykla";"PUG 3";1945918102;Ne;0;0;5;5
17839;"Vilniaus karaliaus Mindaugo mokykla";"PUG 3";1814323427;Ne;6;0;2;8
17840;"Vilniaus karaliaus Mindaugo mokykla";"PUG 3";7351939034;Ne;3;0;0;3
17841;"Vilniaus karaliaus Mindaugo mokykla";"PUG 3";2319707653;Ne;4;0;0;4
17842;"Vilniaus karaliaus Mindaugo mokykla";"PUG 3";4741154518;Ne;4;0;0;4
17843;"Vilniaus karaliaus Mindaugo mokykla";"PUG 3";4215451069;Ne;1;0;0;1
17844;"Vilniaus karaliaus Mindaugo mokykla";"PUG 3";2044795759;Ne;8;0;0;8
17845;"Vilniaus karaliaus Mindaugo mokykla";"PUG 3";5613442667;Ne;7;0;0;7
17846;"Vilniaus karaliaus Mindaugo mokykla";"PUG 3";7149197796;Ne;0;20;0;20
17847;"Vilniaus karaliaus Mindaugo mokykla";"PUG 3";8705825002;Ne;1;0;0;1
17848;"Vilniaus karaliaus Mindaugo mokykla";"PUG 3";7638190553;Ne;3;0;0;3
17849;"Vilniaus karaliaus Mindaugo mokykla";"PUG 3";6762306583;Ne;0;4;0;4
17850;"Vilniaus karaliaus Mindaugo mokykla";"PUG 3";1621497786;Ne;1;0;0;1
17851;"Vilniaus Levo Karsavino vidurinė mokykla";PELEDŽIUKAI;1887013803;Ne;0;7;0;7
17852;"Vilniaus Levo Karsavino vidurinė mokykla";PELEDŽIUKAI;6464887268;Ne;0;2;0;2
17853;"Vilniaus Levo Karsavino vidurinė mokykla";PELEDŽIUKAI;5876182759;Ne;5;1;0;6
17854;"Vilniaus Levo Karsavino vidurinė mokykla";PELEDŽIUKAI;6569135467;Ne;0;0;1;1
17855;"Vilniaus Levo Karsavino vidurinė mokykla";PELEDŽIUKAI;3117948118;Ne;3;0;1;4
17856;"Vilniaus Levo Karsavino vidurinė mokykla";PELEDŽIUKAI;2654373943;Taip;6;0;1;7
17857;"Vilniaus Levo Karsavino vidurinė mokykla";PELEDŽIUKAI;9988041515;Ne;2;0;3;5
17858;"Vilniaus Levo Karsavino vidurinė mokykla";PELEDŽIUKAI;9108428738;Ne;2;0;3;5
17859;"Vilniaus Levo Karsavino vidurinė mokykla";PELEDŽIUKAI;2681013154;Ne;5;0;1;6
17860;"Vilniaus Levo Karsavino vidurinė mokykla";PELEDŽIUKAI;3780475392;Ne;0;6;0;6
17861;"Vilniaus Levo Karsavino vidurinė mokykla";PELEDŽIUKAI;8386409466;Ne;6;0;1;7
17862;"Vilniaus Levo Karsavino vidurinė mokykla";PELEDŽIUKAI;3059970035;Ne;6;0;0;6
17863;"Vilniaus Levo Karsavino vidurinė mokykla";PELEDŽIUKAI;7023534254;Ne;5;0;2;7
17864;"Vilniaus Levo Karsavino vidurinė mokykla";PELEDŽIUKAI;4493469560;Ne;9;0;0;9
17865;"Vilniaus Levo Karsavino vidurinė mokykla";PELEDŽIUKAI;3608920051;Ne;0;3;0;3
17866;"Vilniaus Levo Karsavino vidurinė mokykla";ŽINIUKAI;4416434150;Ne;7;0;0;7
17867;"Vilniaus Levo Karsavino vidurinė mokykla";ŽINIUKAI;9325387975;Ne;3;0;2;5
17868;"Vilniaus Levo Karsavino vidurinė mokykla";ŽINIUKAI;2013694393;Ne;11;0;1;12
17869;"Vilniaus Levo Karsavino vidurinė mokykla";ŽINIUKAI;2107123106;Ne;2;0;3;5
17870;"Vilniaus Levo Karsavino vidurinė mokykla";ŽINIUKAI;7482740111;Ne;0;0;2;2
17871;"Vilniaus Levo Karsavino vidurinė mokykla";ŽINIUKAI;5408157164;Ne;0;0;1;1
17872;"Vilniaus Levo Karsavino vidurinė mokykla";ŽINIUKAI;2122665619;Ne;3;5;2;10
17873;"Vilniaus Levo Karsavino vidurinė mokykla";ŽINIUKAI;1632925219;Ne;4;0;2;6
17874;"Vilniaus Levo Karsavino vidurinė mokykla";ŽINIUKAI;2697867000;Ne;4;0;0;4
17875;"Vilniaus Levo Karsavino vidurinė mokykla";ŽINIUKAI;6391999153;Ne;3;0;1;4
17876;"Vilniaus Levo Karsavino vidurinė mokykla";ŽINIUKAI;5102718403;Ne;14;0;0;14
17877;"Vilniaus Levo Karsavino vidurinė mokykla";ŽINIUKAI;6945510312;Ne;0;0;4;4
17878;"Vilniaus Liepkalnio Pagrindinė Mokykla";Bitutės;5682528849;Taip;5;0;0;5
17879;"Vilniaus Liepkalnio Pagrindinė Mokykla";Bitutės;8723898832;Ne;1;0;0;1
17880;"Vilniaus Liepkalnio Pagrindinė Mokykla";Bitutės;8080492986;Ne;15;0;0;15
17881;"Vilniaus Liepkalnio Pagrindinė Mokykla";Bitutės;3239288878;Ne;6;0;1;7
17882;"Vilniaus Liepkalnio Pagrindinė Mokykla";Bitutės;3369970611;Ne;0;0;3;3
17883;"Vilniaus Liepkalnio Pagrindinė Mokykla";Bitutės;4344780723;Ne;0;0;2;2
17884;"Vilniaus Liepkalnio Pagrindinė Mokykla";Bitutės;1085400709;Ne;7;0;1;8
17885;"Vilniaus Liepkalnio Pagrindinė Mokykla";Bitutės;8387453394;Ne;1;0;0;1
17886;"Vilniaus Pranciškaus Skorinos gimnazija";SAULYTĖ;3621289572;Ne;11;0;0;11
17887;"Vilniaus Pranciškaus Skorinos gimnazija";SAULYTĖ;8946940285;Ne;0;0;6;6
17888;"Vilniaus Pranciškaus Skorinos gimnazija";SAULYTĖ;2978563798;Ne;10;0;0;10
17889;"Vilniaus Pranciškaus Skorinos gimnazija";SAULYTĖ;2347857813;Ne;3;0;1;4
17890;"Vilniaus Pranciškaus Skorinos gimnazija";SAULYTĖ;2220506064;Ne;4;0;5;9
17891;"Vilniaus Pranciškaus Skorinos gimnazija";SAULYTĖ;1797706575;Ne;4;0;6;10
17892;"Vilniaus Pranciškaus Skorinos gimnazija";SAULYTĖ;9424930375;Ne;4;0;5;9
17893;"Vilniaus Pranciškaus Skorinos gimnazija";SAULYTĖ;3558729735;Ne;4;2;0;6
17894;"Vilniaus Pranciškaus Skorinos gimnazija";SAULYTĖ;2290343066;Ne;0;30;0;30
17895;"Vilniaus Pranciškaus Skorinos gimnazija";SAULYTĖ;4500542668;Ne;18;0;0;18
17896;"Vilniaus Pranciškaus Skorinos gimnazija";SAULYTĖ;2782818158;Ne;3;0;2;5
17897;"Vilniaus Pranciškaus Skorinos gimnazija";SAULYTĖ;4719223490;Ne;17;0;1;18
17898;"Vilniaus Pranciškaus Skorinos gimnazija";SAULYTĖ;6892006495;Ne;0;3;0;3
17899;"Vilniaus Pranciškaus Skorinos gimnazija";SAULYTĖ;8592478282;Taip;0;0;4;4
17900;"Vilniaus Pranciškaus Skorinos gimnazija";SAULYTĖ;4522879237;Ne;5;0;3;8
17901;"Vilniaus Simono Konarskio mokykla";"1 GR.";9988467124;Ne;9;0;0;9
17902;"Vilniaus Simono Konarskio mokykla";"1 GR.";6861123988;Ne;1;0;0;1
17903;"Vilniaus Simono Konarskio mokykla";"1 GR.";7233139048;Ne;5;0;0;5
17904;"Vilniaus Simono Konarskio mokykla";"1 GR.";9009809585;Ne;5;0;0;5
17905;"Vilniaus Simono Konarskio mokykla";"1 GR.";4048726627;Ne;5;0;0;5
17906;"Vilniaus Simono Konarskio mokykla";"1 GR.";4858617162;Ne;5;0;0;5
17907;"Vilniaus Simono Konarskio mokykla";"1 GR.";9065848425;Ne;5;0;0;5
17908;"Vilniaus Simono Konarskio mokykla";"1 GR.";7230987338;Ne;1;0;0;1
17909;"Vilniaus Trakų Vokės gimnazija";DRUGELIAI;8874384610;Ne;10;1;0;11
17910;"Vilniaus Trakų Vokės gimnazija";DRUGELIAI;4535167417;Ne;6;0;0;6
17911;"Vilniaus Trakų Vokės gimnazija";DRUGELIAI;2539647111;Ne;9;0;0;9
17912;"Vilniaus Trakų Vokės gimnazija";DRUGELIAI;2453791555;Ne;13;1;0;14
17913;"Vilniaus Trakų Vokės gimnazija";DRUGELIAI;4854440884;Ne;20;0;0;20
17914;"Vilniaus Trakų Vokės gimnazija";DRUGELIAI;2761614687;Ne;12;1;0;13
17915;"Vilniaus Trakų Vokės gimnazija";DRUGELIAI;8706990390;Ne;12;0;0;12
17916;"Vilniaus Trakų Vokės gimnazija";DRUGELIAI;9094930495;Ne;4;1;0;5
17917;"Vilniaus Trakų Vokės gimnazija";DRUGELIAI;9483709021;Ne;1;0;0;1
17918;"Vilniaus Trakų Vokės gimnazija";DRUGELIAI;2880299812;Ne;2;0;0;2
17919;"Vilniaus Trakų Vokės gimnazija";DRUGELIAI;9506008651;Ne;5;0;0;5
17920;"Vilniaus Trakų Vokės gimnazija";DRUGELIAI;6326568445;Ne;0;1;0;1
17921;"Vilniaus Trakų Vokės gimnazija";DRUGELIAI;1360046096;Ne;4;2;0;6
17922;"Vilniaus Trakų Vokės gimnazija";DRUGELIAI;2503382218;Ne;3;1;0;4
17923;"Vilniaus Trakų Vokės gimnazija";DRUGELIAI;3278842582;Ne;1;0;0;1
17924;"Vilniaus Trakų Vokės gimnazija";DRUGELIAI;3611639112;Ne;1;1;0;2
17925;"Vilniaus Trakų Vokės gimnazija";DRUGELIAI;8605461082;Ne;7;0;0;7
17926;"Vilniaus Trakų Vokės gimnazija";DRUGELIAI;3328527700;Ne;6;0;0;6
17927;"Vilniaus Trakų Vokės gimnazija";DRUGELIAI;5206616285;Ne;0;1;0;1
17928;"Vilniaus Trakų Vokės gimnazija";DRUGELIAI;8929514493;Ne;11;0;0;11
17929;"Vilniaus Trakų Vokės gimnazija";DRUGELIAI;9233090228;Ne;11;0;0;11
17930;"Vilniaus Trakų Vokės gimnazija";VOVERIUKAI;1080300137;Ne;1;0;0;1
17931;"Vilniaus Trakų Vokės gimnazija";VOVERIUKAI;2469340933;Ne;0;1;0;1
17932;"Vilniaus Trakų Vokės gimnazija";VOVERIUKAI;6908913934;Ne;6;0;0;6
17933;"Vilniaus Trakų Vokės gimnazija";VOVERIUKAI;4362066941;Ne;6;6;0;12
17934;"Vilniaus Trakų Vokės gimnazija";VOVERIUKAI;3555513755;Ne;0;4;0;4
17935;"Vilniaus Trakų Vokės gimnazija";VOVERIUKAI;5338798362;Ne;8;0;0;8
17936;"Vilniaus Trakų Vokės gimnazija";VOVERIUKAI;9582511053;Ne;6;4;0;10
17937;"Vilniaus Trakų Vokės gimnazija";VOVERIUKAI;3319243283;Ne;1;0;0;1
17938;"Vilniaus Trakų Vokės gimnazija";VOVERIUKAI;6908487075;Ne;4;0;0;4
17939;"Vilniaus Trakų Vokės gimnazija";VOVERIUKAI;1910363787;Ne;3;0;0;3
17940;"Vilniaus Trakų Vokės gimnazija";VOVERIUKAI;7858812338;Ne;1;0;0;1
17941;"Vilniaus Trakų Vokės gimnazija";VOVERIUKAI;3913623741;Ne;1;0;0;1
17942;"Vilniaus Trakų Vokės gimnazija";VOVERIUKAI;4520091712;Ne;2;0;0;2
17943;"Vilniaus Trakų Vokės gimnazija";VOVERIUKAI;8168960897;Ne;5;1;0;6
17944;"Vilniaus Trakų Vokės gimnazija";VOVERIUKAI;1057189769;Ne;2;2;0;4
17945;"Vilniaus Trakų Vokės gimnazija";VOVERIUKAI;4014027030;Ne;2;9;0;11
17946;"Vilniaus Trakų Vokės gimnazija";VOVERIUKAI;7660240598;Ne;0;10;0;10
17947;"Vilniaus Trakų Vokės gimnazija";VOVERIUKAI;4438127190;Ne;6;0;0;6
17948;"Vilniaus Trakų Vokės gimnazija";VOVERIUKAI;2388817616;Ne;5;0;0;5
17949;"Vilniaus Trakų Vokės gimnazija";VOVERIUKAI;8472834181;Ne;0;1;0;1
17950;"Vilniaus Trakų Vokės gimnazija";BITUTĖS;6732422645;Taip;0;1;1;2
17951;"Vilniaus Trakų Vokės gimnazija";BITUTĖS;7909596435;Ne;10;0;2;12
17952;"Vilniaus Trakų Vokės gimnazija";BITUTĖS;6751625456;Ne;4;1;1;6
17953;"Vilniaus Trakų Vokės gimnazija";BITUTĖS;7752786907;Ne;10;0;1;11
17954;"Vilniaus Trakų Vokės gimnazija";BITUTĖS;2475068032;Ne;6;0;0;6
17955;"Vilniaus Trakų Vokės gimnazija";BITUTĖS;9819489467;Ne;0;1;2;3
17956;"Vilniaus Trakų Vokės gimnazija";BITUTĖS;2516219363;Ne;0;1;1;2
17957;"Vilniaus Trakų Vokės gimnazija";BITUTĖS;2571561865;Ne;4;1;0;5
17958;"Vilniaus Trakų Vokės gimnazija";BITUTĖS;6765094662;Taip;0;2;0;2
17959;"Vilniaus Trakų Vokės gimnazija";BITUTĖS;4601374629;Ne;5;0;0;5
17960;"Vilniaus Trakų Vokės gimnazija";BITUTĖS;9051697544;Ne;4;0;7;11
17961;"Vilniaus Trakų Vokės gimnazija";BITUTĖS;3346395516;Ne;2;0;1;3
17962;"Vilniaus Trakų Vokės gimnazija";BITUTĖS;9453317084;Ne;0;1;1;2
17963;"Vilniaus Trakų Vokės gimnazija";BITUTĖS;2869217654;Taip;2;2;0;4
17964;"Vilniaus Trakų Vokės gimnazija";BITUTĖS;7508070996;Ne;15;0;3;18
17965;"Vilniaus Trakų Vokės gimnazija";BITUTĖS;1602352855;Ne;9;0;1;10
17966;"Vilniaus Trakų Vokės gimnazija";BITUTĖS;5695160925;Ne;9;1;0;10
17967;"Vilniaus Trakų Vokės gimnazija";BITUTĖS;9668538340;Ne;0;5;0;5
17968;"Vilniaus Trakų Vokės gimnazija";BITUTĖS;3449317958;Ne;0;1;1;2
17969;"Vilniaus Trakų Vokės gimnazija";BITUTĖS;1398572100;Ne;0;4;0;4
17970;"Vilniaus Trakų Vokės gimnazija";BITUTĖS;2469486746;Ne;5;0;2;7
17971;"Vilniaus Ryto progimnazija";RYTUKAI;3397350274;Ne;3;0;0;3
17972;"Vilniaus Ryto progimnazija";RYTUKAI;4822495270;Ne;2;0;0;2
17973;"Vilniaus Ryto progimnazija";RYTUKAI;3235523199;Ne;5;0;0;5
17974;"Vilniaus Ryto progimnazija";RYTUKAI;2537442505;Taip;0;9;0;9
17975;"Vilniaus Ryto progimnazija";RYTUKAI;7365398150;Ne;6;0;1;7
17976;"Vilniaus Ryto progimnazija";RYTUKAI;3461165182;Ne;0;0;12;12
17977;"Vilniaus Ryto progimnazija";RYTUKAI;6340323302;Ne;4;0;0;4
17978;"Vilniaus Ryto progimnazija";RYTUKAI;7638618099;Ne;2;1;1;4
17979;"Vilniaus Ryto progimnazija";RYTUKAI;6852734826;Ne;3;0;1;4
17980;"Vilniaus Ryto progimnazija";RYTUKAI;5494350183;Taip;0;8;0;8
17981;"Vilniaus Ryto progimnazija";RYTUKAI;5148002236;Ne;2;0;0;2
17982;"Vilniaus Ryto progimnazija";RYTUKAI;4086461803;Ne;5;0;0;5
17983;"Vilniaus Ryto progimnazija";RYTUKAI;2921485707;Ne;11;0;2;13
17984;"Vilniaus Ryto progimnazija";RYTUKAI;4029370760;Taip;6;0;0;6
17985;"Vilniaus Salininkų gimnazija";"Priešmokyklinė A";6850925495;Ne;3;0;0;3
17986;"Vilniaus Salininkų gimnazija";"Priešmokyklinė A";8995565864;Ne;0;5;0;5
17987;"Vilniaus Salininkų gimnazija";"Priešmokyklinė A";6327046935;Ne;0;1;0;1
17988;"Vilniaus Salininkų gimnazija";"Priešmokyklinė A";4425748908;Ne;0;2;0;2
17989;"Vilniaus Salininkų gimnazija";"Priešmokyklinė A";8774984357;Ne;0;1;0;1
17990;"Vilniaus Salininkų gimnazija";"Priešmokyklinė A";6155979185;Ne;0;6;0;6
17991;"Vilniaus Salininkų gimnazija";"Priešmokyklinė A";8206979332;Ne;0;1;0;1
17992;"Vilniaus Salininkų gimnazija";"Priešmokyklinė A";2262425557;Ne;6;0;0;6
17993;"Vilniaus Salininkų gimnazija";"PRIEŠMOKYKLINĖ B";5427013789;Ne;6;2;0;8
17994;"Vilniaus Salininkų gimnazija";"PRIEŠMOKYKLINĖ B";3100499807;Ne;6;2;0;8
17995;"Vilniaus Salininkų gimnazija";"PRIEŠMOKYKLINĖ B";3585435095;Ne;2;0;0;2
17996;"Vilniaus Salininkų gimnazija";"PRIEŠMOKYKLINĖ B";1658695150;Ne;1;0;1;2
17997;"Vilniaus Salininkų gimnazija";"PRIEŠMOKYKLINĖ B";3737834032;Ne;1;0;0;1
17998;"Vilniaus Salininkų gimnazija";"PRIEŠMOKYKLINĖ B";9344614003;Ne;2;0;0;2
17999;"Vilniaus Salininkų gimnazija";"PRIEŠMOKYKLINĖ B";2808778763;Taip;2;0;0;2
18000;"Vilniaus Salininkų gimnazija";"PRIEŠMOKYKLINĖ B";9890660815;Ne;2;0;0;2
18001;"Vilniaus Salininkų gimnazija";"PRIEŠMOKYKLINĖ B";8189699392;Ne;1;0;0;1
18002;"Vilniaus Salininkų gimnazija";"PRIEŠMOKYKLINĖ B";8047582970;Ne;0;0;2;2
18003;"Vilniaus Salininkų gimnazija";"PRIEŠMOKYKLINĖ B";3739751121;Ne;0;0;1;1
18004;"Vilniaus Salininkų gimnazija";"PRIEŠMOKYKLINĖ B";7403996266;Taip;5;0;0;5
18005;"Vilniaus Salininkų gimnazija";"PRIEŠMOKYKLINĖ B";9813360176;Ne;1;1;0;2
18006;"Vilniaus Salininkų gimnazija";"PRIEŠMOKYKLINĖ B";6656578271;Ne;9;0;0;9
18007;"Vilniaus Salininkų gimnazija";"PRIEŠMOKYKLINĖ B";6266609965;Ne;4;1;0;5
18008;"Vilniaus Salininkų gimnazija";"PRIEŠMOKYKLINĖ B";3196285660;Ne;3;0;0;3
18009;"Vilniaus Salininkų gimnazija";"PRIEŠMOKYKLINĖ B";4771867627;Ne;5;0;0;5
18010;"Vilniaus „Spindulio“ progimnazija";PM2;8076961367;Ne;0;1;0;1
18011;"Vilniaus „Spindulio“ progimnazija";PM2;5030400578;Ne;0;2;0;2
18012;"Vilniaus „Spindulio“ progimnazija";PM2;1455509576;Ne;3;0;0;3
18013;"Vilniaus „Spindulio“ progimnazija";PM2;2094258481;Ne;1;2;0;3
18014;"Vilniaus „Spindulio“ progimnazija";PM2;7197544314;Ne;0;1;0;1
18015;"Vilniaus „Spindulio“ progimnazija";PM2;3985610575;Taip;2;2;0;4
18016;"Vilniaus „Spindulio“ progimnazija";PM2;8936645508;Taip;0;2;0;2
18017;"Vilniaus „Spindulio“ progimnazija";PM2;1153948822;Ne;1;1;0;2
18018;"Vilniaus „Spindulio“ progimnazija";PM1;8160982025;Ne;0;1;0;1
18019;"Vilniaus „Spindulio“ progimnazija";PM1;9628317328;Ne;0;1;0;1
18020;"Vilniaus „Spindulio“ progimnazija";PM1;9898412288;Ne;3;0;0;3
18021;"Vilniaus „Spindulio“ progimnazija";PM1;6577214344;Ne;5;0;0;5
18022;"Vilniaus „Spindulio“ progimnazija";PM1;8432654056;Taip;3;0;0;3
18023;"Vilniaus „Spindulio“ progimnazija";PM1;6575909478;Ne;5;1;0;6
18024;"Vilniaus „Spindulio“ progimnazija";PM1;6047881184;Ne;0;0;1;1
18025;"Vilniaus „Spindulio“ progimnazija";PM1;6826790492;Ne;4;0;0;4
18026;"Vilniaus „Spindulio“ progimnazija";PM1;5123666058;Ne;1;0;0;1
18027;"Vilniaus „Spindulio“ progimnazija";PM1;2948291866;Ne;1;0;0;1
18028;"Vilniaus „Spindulio“ progimnazija";PM1;2945894661;Ne;4;0;0;4
18029;"Vilniaus „Spindulio“ progimnazija";PM1;1392036584;Ne;11;0;0;11
18030;"Vilniaus „Spindulio“ progimnazija";PM1;4713803167;Ne;10;1;0;11
18031;"Vilniaus „Spindulio“ progimnazija";PM1;3554823424;Ne;0;7;0;7
18032;"Vilniaus Vladislavo Sirokomlės gimnazija";Nykštukai;1588062393;Ne;5;0;0;5
18033;"Vilniaus Vladislavo Sirokomlės gimnazija";Nykštukai;2923698853;Ne;3;27;0;30
18034;"Vilniaus Vladislavo Sirokomlės gimnazija";Nykštukai;7364698713;Ne;0;1;0;1
18035;"Vilniaus Vladislavo Sirokomlės gimnazija";Nykštukai;6613003059;Ne;5;1;0;6
18036;"Vilniaus Vladislavo Sirokomlės gimnazija";Nykštukai;7113970557;Ne;0;1;0;1
18037;"Vilniaus Vladislavo Sirokomlės gimnazija";Nykštukai;7413098580;Ne;3;2;0;5
18038;"Vilniaus Vladislavo Sirokomlės gimnazija";Nykštukai;6843262303;Ne;0;0;1;1
18039;"Vilniaus Vladislavo Sirokomlės gimnazija";Nykštukai;5150028968;Ne;0;1;0;1
18040;"Vilniaus Vladislavo Sirokomlės gimnazija";Nykštukai;5999318972;Ne;3;0;0;3
18041;"Vilniaus Vladislavo Sirokomlės gimnazija";Nykštukai;2092319455;Ne;2;2;0;4
18042;"Vilniaus Vladislavo Sirokomlės gimnazija";Nykštukai;5822045625;Ne;0;4;0;4
18043;"Vilniaus Vladislavo Sirokomlės gimnazija";Nykštukai;6166192468;Ne;2;0;0;2
18044;"Vilniaus Vladislavo Sirokomlės gimnazija";Nykštukai;1272758839;Taip;12;0;0;12
18045;"Vilniaus Vladislavo Sirokomlės gimnazija";Smurfai;2262586409;Ne;0;31;0;31
18046;"Vilniaus Vladislavo Sirokomlės gimnazija";Smurfai;7429739147;Ne;19;1;0;20
18047;"Vilniaus Vladislavo Sirokomlės gimnazija";Smurfai;1386916991;Ne;9;2;0;11
18048;"Vilniaus Vladislavo Sirokomlės gimnazija";Smurfai;2999425729;Ne;11;1;0;12
18049;"Vilniaus Vladislavo Sirokomlės gimnazija";Smurfai;7334310944;Ne;4;1;0;5
18050;"Vilniaus Vladislavo Sirokomlės gimnazija";Smurfai;6385918522;Ne;0;8;0;8
18051;"Vilniaus Vladislavo Sirokomlės gimnazija";Smurfai;3810261864;Ne;0;3;0;3
18052;"Vilniaus Vladislavo Sirokomlės gimnazija";Smurfai;4658530212;Ne;0;2;0;2
18053;"Vilniaus Vladislavo Sirokomlės gimnazija";Smurfai;4760204642;Ne;3;1;0;4
18054;"Vilniaus Vladislavo Sirokomlės gimnazija";Smurfai;3316897176;Ne;1;2;0;3
18055;"Vilniaus „Pelėdos” pradinė mokykla";BITUTĖS;1540892686;Ne;8;0;0;8
18056;"Vilniaus „Pelėdos” pradinė mokykla";BITUTĖS;6886461269;Ne;2;0;0;2
18057;"Vilniaus „Pelėdos” pradinė mokykla";BITUTĖS;8466974910;Ne;1;0;0;1
18058;"Vilniaus „Pelėdos” pradinė mokykla";BITUTĖS;8874979704;Ne;8;0;0;8
18059;"Vilniaus „Pelėdos” pradinė mokykla";BITUTĖS;3247532201;Ne;6;0;3;9
18060;"Vilniaus „Pelėdos” pradinė mokykla";BITUTĖS;2737277656;Ne;1;0;0;1
18061;"Vilniaus „Pelėdos” pradinė mokykla";BITUTĖS;6505671642;Ne;1;0;0;1
18062;"Vilniaus „Pelėdos” pradinė mokykla";BITUTĖS;8016820352;Ne;1;0;0;1
18063;"Vilniaus „Pelėdos” pradinė mokykla";BITUTĖS;8650379074;Ne;6;0;0;6
18064;"Vilniaus „Pelėdos” pradinė mokykla";BITUTĖS;8874149122;Ne;1;0;0;1
18065;"Vilniaus „Pelėdos” pradinė mokykla";BITUTĖS;5061655822;Ne;10;0;0;10
18066;"Vilniaus „Pelėdos” pradinė mokykla";BITUTĖS;7960825423;Ne;2;0;0;2
18067;"Vilniaus „Pelėdos” pradinė mokykla";BITUTĖS;4324931449;Ne;6;0;0;6
18068;"Vilniaus „Pelėdos” pradinė mokykla";BITUTĖS;5924332293;Taip;1;0;0;1
18069;"Vilniaus Joachimo Lelevelio inžinerijos gimnazija";0A;7508357392;Ne;3;0;0;3
18070;"Vilniaus Joachimo Lelevelio inžinerijos gimnazija";0A;7307307882;Ne;0;3;0;3
18071;"Vilniaus Joachimo Lelevelio inžinerijos gimnazija";0A;6316768460;Ne;1;0;0;1
18072;"Vilniaus Joachimo Lelevelio inžinerijos gimnazija";0B;9965517774;Taip;6;2;0;8
18073;"Vilniaus Joachimo Lelevelio inžinerijos gimnazija";0B;7138581709;Taip;6;2;0;8
18074;"Vilniaus Joachimo Lelevelio inžinerijos gimnazija";0B;7911007041;Taip;3;0;0;3
18075;"Vilniaus Joachimo Lelevelio inžinerijos gimnazija";0B;2125410714;Ne;0;1;0;1
18076;"Vilniaus Joachimo Lelevelio inžinerijos gimnazija";0B;7956422880;Ne;3;0;0;3
18077;"Vilniaus Joachimo Lelevelio inžinerijos gimnazija";0B;8446233414;Ne;0;6;0;6
18078;"Vilniaus Joachimo Lelevelio inžinerijos gimnazija";0B;5689369492;Ne;0;1;0;1
18079;"Vilniaus Joachimo Lelevelio inžinerijos gimnazija";0B;7553024183;Ne;4;0;0;4
18080;"Vilniaus Joachimo Lelevelio inžinerijos gimnazija";0B;8703116268;Ne;0;2;0;2
18081;"Vilniaus Juzefo Ignacijaus Kraševskio gimnazija";DRUGĖLIAI;5157814568;Ne;5;0;0;5
18082;"Vilniaus Juzefo Ignacijaus Kraševskio gimnazija";DRUGĖLIAI;8747343811;Ne;4;0;0;4
18083;"Vilniaus Juzefo Ignacijaus Kraševskio gimnazija";DRUGĖLIAI;7502911642;Ne;4;0;0;4
18084;"Vilniaus Juzefo Ignacijaus Kraševskio gimnazija";DRUGĖLIAI;6403149921;Ne;16;0;0;16
18085;"Vilniaus Juzefo Ignacijaus Kraševskio gimnazija";DRUGĖLIAI;5328263421;Taip;3;0;0;3
18086;"Vilniaus Juzefo Ignacijaus Kraševskio gimnazija";DRUGĖLIAI;4257115650;Ne;2;0;0;2
18087;"Vilniaus Juzefo Ignacijaus Kraševskio gimnazija";DRUGĖLIAI;8521846076;Ne;0;3;0;3
18088;"Vilniaus Juzefo Ignacijaus Kraševskio gimnazija";DRUGĖLIAI;6427289718;Ne;3;0;0;3
18089;"Vilniaus Juzefo Ignacijaus Kraševskio gimnazija";DRUGĖLIAI;8214699601;Ne;0;4;0;4
18090;"Vilniaus Juzefo Ignacijaus Kraševskio gimnazija";DRUGĖLIAI;6781303455;Ne;5;1;0;6
18091;"Vilniaus Juzefo Ignacijaus Kraševskio gimnazija";DRUGĖLIAI;4845049639;Ne;1;0;0;1
18092;"Vilniaus Juzefo Ignacijaus Kraševskio gimnazija";DRUGĖLIAI;3522200752;Ne;9;1;0;10
18093;"Vilniaus Juzefo Ignacijaus Kraševskio gimnazija";DRUGĖLIAI;8808382134;Ne;7;0;0;7
18094;"Vilniaus Juzefo Ignacijaus Kraševskio gimnazija";DRUGĖLIAI;9333766622;Ne;9;5;0;14
18095;"Vilniaus Jono Pauliaus II progimnazija";Nykštukai;6742119549;Ne;15;0;0;15
18096;"Vilniaus Jono Pauliaus II progimnazija";Nykštukai;8047799576;Ne;0;1;0;1
18097;"Vilniaus Jono Pauliaus II progimnazija";Nykštukai;1381191703;Ne;0;20;0;20
18098;"Vilniaus Jono Pauliaus II progimnazija";Nykštukai;9042329808;Ne;5;0;0;5
18099;"Vilniaus Jono Pauliaus II progimnazija";Nykštukai;5909697341;Ne;0;2;0;2
18100;"Vilniaus Jono Pauliaus II progimnazija";Nykštukai;3346154143;Ne;7;0;0;7
18101;"Vilniaus Jono Pauliaus II progimnazija";Nykštukai;8054114720;Ne;0;4;0;4
18102;"Vilniaus Jono Pauliaus II progimnazija";Nykštukai;2190583964;Ne;4;1;0;5
18103;"Vilniaus Jono Pauliaus II progimnazija";Nykštukai;3998988004;Ne;6;1;0;7
18104;"Vilniaus Jono Pauliaus II progimnazija";Nykštukai;6756184787;Ne;0;1;0;1
18105;"Vilniaus Jono Pauliaus II progimnazija";Nykštukai;5768470608;Ne;1;0;1;2
18106;"Vilniaus Jono Pauliaus II progimnazija";Nykštukai;3584347608;Ne;0;1;0;1
18107;"Vilniaus Jono Pauliaus II progimnazija";Žiniukai;3687735991;Ne;0;1;0;1
18108;"Vilniaus Jono Pauliaus II progimnazija";Žiniukai;4543822765;Ne;1;0;1;2
18109;"Vilniaus Jono Pauliaus II progimnazija";Žiniukai;7459673719;Ne;0;8;0;8
18110;"Vilniaus Jono Pauliaus II progimnazija";Žiniukai;4566817285;Ne;2;0;0;2
18111;"Vilniaus Jono Pauliaus II progimnazija";Žiniukai;3332865242;Ne;6;0;0;6
18112;"Vilniaus Jono Pauliaus II progimnazija";Žiniukai;5978993456;Ne;2;0;0;2
18113;"Vilniaus Jono Pauliaus II progimnazija";Žiniukai;4288487063;Ne;3;0;0;3
18114;"Vilniaus Jono Pauliaus II progimnazija";Žiniukai;9522524163;Ne;5;2;0;7
18115;"Vilniaus Jono Pauliaus II progimnazija";Žiniukai;6712878938;Ne;0;1;0;1
18116;"Vilniaus Jono Pauliaus II progimnazija";Žiniukai;9414051187;Ne;11;0;0;11
18117;"Vilniaus Jono Pauliaus II progimnazija";Žiniukai;8812316692;Ne;3;0;0;3
18118;"Vilniaus Jono Pauliaus II progimnazija";Žiniukai;9357757604;Ne;5;2;0;7
18119;"Vilniaus Jono Pauliaus II progimnazija";Žiniukai;4291690659;Ne;0;1;0;1
18120;"Vilniaus Jono Pauliaus II progimnazija";Žiniukai;3489127587;Ne;0;8;0;8
18121;"Vilniaus Jono Pauliaus II progimnazija";Žiniukai;5043122065;Ne;2;0;0;2
18122;"Vilniaus Jono Pauliaus II progimnazija";Žiniukai;3349199472;Ne;0;4;0;4
18123;"Vilniaus Jono Pauliaus II progimnazija";Žiniukai;2654794460;Ne;5;1;0;6
18124;"Vilniaus Jono Pauliaus II progimnazija";Žiniukai;6478873536;Ne;18;0;0;18
18125;"Vilniaus Jono Pauliaus II progimnazija";Spindulėlis;5492437864;Ne;9;1;0;10
18126;"Vilniaus Jono Pauliaus II progimnazija";Spindulėlis;3269357241;Ne;2;0;0;2
18127;"Vilniaus Jono Pauliaus II progimnazija";Spindulėlis;2840112908;Ne;5;0;0;5
18128;"Vilniaus Jono Pauliaus II progimnazija";Spindulėlis;4433799070;Ne;0;1;0;1
18129;"Vilniaus Jono Pauliaus II progimnazija";Spindulėlis;5440679175;Ne;0;1;0;1
18130;"Vilniaus Jono Pauliaus II progimnazija";Spindulėlis;4426643908;Ne;2;0;0;2
18131;"Vilniaus Jono Pauliaus II progimnazija";Spindulėlis;6996900411;Taip;14;1;0;15
18132;"Vilniaus Jono Pauliaus II progimnazija";Spindulėlis;2090334618;Ne;12;0;0;12
18133;"Vilniaus Jono Pauliaus II progimnazija";Spindulėlis;6435612222;Ne;13;0;0;13
18134;"Vilniaus Jono Pauliaus II progimnazija";Spindulėlis;1583038469;Ne;3;0;0;3
18135;"Vilniaus Jono Pauliaus II progimnazija";Spindulėlis;9226214856;Ne;4;0;0;4
18136;"Vilniaus Jono Pauliaus II progimnazija";Spindulėlis;3121251271;Ne;0;4;0;4
18137;"Vilniaus Jono Pauliaus II progimnazija";Spindulėlis;4189943614;Ne;0;2;0;2
18138;"Vilniaus Jono Pauliaus II progimnazija";Spindulėlis;2515028280;Ne;2;0;0;2
18139;"Vilniaus Jono Pauliaus II progimnazija";Spindulėlis;5987294293;Ne;0;8;0;8
18140;"Vilniaus Jono Pauliaus II progimnazija";Spindulėlis;8043493934;Ne;2;0;0;2
18141;"Vilniaus Jono Pauliaus II progimnazija";Uogytės;3502278745;Ne;2;0;0;2
18142;"Vilniaus Jono Pauliaus II progimnazija";Uogytės;3445649442;Ne;2;0;0;2
18143;"Vilniaus Jono Pauliaus II progimnazija";Uogytės;2843328732;Ne;5;0;0;5
18144;"Vilniaus Jono Pauliaus II progimnazija";Uogytės;4726351175;Ne;2;0;0;2
18145;"Vilniaus Jono Pauliaus II progimnazija";Uogytės;5028510873;Ne;3;0;0;3
18146;"Vilniaus Jono Pauliaus II progimnazija";Uogytės;5600979545;Ne;9;0;0;9
18147;"Vilniaus Jono Pauliaus II progimnazija";Uogytės;8459980712;Ne;1;0;0;1
18148;"Vilniaus Jono Pauliaus II progimnazija";Uogytės;9037835899;Ne;2;0;0;2
18149;"Vilniaus Jono Pauliaus II progimnazija";Uogytės;9235884407;Ne;0;20;0;20
18150;"Vilniaus Jono Pauliaus II progimnazija";Uogytės;8949018147;Ne;3;0;0;3
18151;"Vilniaus Verkių mokykla-daugiafunkcis centras";"SĮUP I m.m., SĮUP II m.m. klasė";1853931111;Ne;0;7;0;7
18152;"Vilniaus Verkių mokykla-daugiafunkcis centras";"SĮUP I m.m., SĮUP II m.m. klasė";6808441017;Ne;0;10;0;10
18153;"Vilniaus Verkių mokykla-daugiafunkcis centras";"SĮUP I m.m., SĮUP II m.m. klasė";7886245604;Ne;0;4;0;4
18154;"Vilniaus Verkių mokykla-daugiafunkcis centras";"SĮUP I m.m., SĮUP II m.m. klasė";6213577188;Ne;0;17;0;17
18155;"Vilniaus Verkių mokykla-daugiafunkcis centras";"SĮUP I m.m., SĮUP II m.m. klasė";8732243137;Ne;0;1;0;1
18156;"Vilniaus Verkių mokykla-daugiafunkcis centras";"SĮUP I m.m., SĮUP II m.m. klasė";6301505187;Ne;0;4;0;4
18157;"Vilniaus Verkių mokykla-daugiafunkcis centras";"SĮUP I m.m., SĮUP II m.m. klasė";9975744237;Ne;0;1;0;1
18158;"Vilniaus Verkių mokykla-daugiafunkcis centras";"SĮUP I m.m., SĮUP II m.m. klasė";5476038315;Ne;0;5;0;5
18159;"Vilniaus Verkių mokykla-daugiafunkcis centras";"SĮUP I m.m., SĮUP II m.m., SĮUP III m.m. klasė ";4518835802;Ne;0;4;0;4
18160;"Vilniaus Verkių mokykla-daugiafunkcis centras";"SĮUP I m.m., SĮUP II m.m., SĮUP III m.m. klasė ";9666721487;Ne;0;7;0;7
18161;"Vilniaus Verkių mokykla-daugiafunkcis centras";"SĮUP I m.m., SĮUP II m.m., SĮUP III m.m. klasė ";2714397701;Ne;0;3;0;3
18162;"Vilniaus Verkių mokykla-daugiafunkcis centras";"SĮUP I m.m., SĮUP II m.m., SĮUP III m.m. klasė ";4054448861;Ne;0;3;0;3
18163;"Vilniaus Verkių mokykla-daugiafunkcis centras";"SĮUP I m.m., SĮUP II m.m., SĮUP III m.m. klasė ";7381890668;Ne;0;5;0;5
18164;"Vilniaus Verkių mokykla-daugiafunkcis centras";"SĮUP I m.m., SĮUP II m.m., SĮUP III m.m. klasė ";2708620759;Ne;0;14;0;14
18165;"Vilniaus Verkių mokykla-daugiafunkcis centras";"SĮUP I m.m., SĮUP II m.m., SĮUP III m.m. klasė ";7323583579;Ne;0;5;0;5
18166;"Vilniaus Verkių mokykla-daugiafunkcis centras";"9, 10 L klasė";2810286239;Ne;0;20;0;20
18167;"Vilniaus Verkių mokykla-daugiafunkcis centras";"9, 10 L klasė";2054806833;Ne;0;10;0;10
18168;"Vilniaus Verkių mokykla-daugiafunkcis centras";"9, 10 L klasė";9613466086;Ne;0;13;0;13
18169;"Vilniaus Verkių mokykla-daugiafunkcis centras";"9, 10 L klasė";9613466086;Ne;0;13;0;13
18170;"Vilniaus Verkių mokykla-daugiafunkcis centras";"9, 10 L klasė";7616694308;Ne;0;5;0;5
18171;"Vilniaus Verkių mokykla-daugiafunkcis centras";"9, 10 L klasė";1480378589;Ne;0;20;0;20
18172;"Vilniaus Verkių mokykla-daugiafunkcis centras";"9, 10 L klasė";3519068093;Ne;1;2;0;3
18173;"Vilniaus Verkių mokykla-daugiafunkcis centras";"9, 10 L klasė";1990482351;Ne;0;1;0;1
18174;"Vilniaus Verkių mokykla-daugiafunkcis centras";"9, 10 S klasė";7689301739;Ne;0;7;0;7
18175;"Vilniaus Verkių mokykla-daugiafunkcis centras";"9, 10 S klasė";6396691531;Ne;0;20;0;20
18176;"Vilniaus Verkių mokykla-daugiafunkcis centras";"9, 10 S klasė";1937996951;Ne;0;3;0;3
18177;"Vilniaus Verkių mokykla-daugiafunkcis centras";"9, 10 S klasė";7819002176;Ne;0;2;0;2
18178;"Vilniaus Verkių mokykla-daugiafunkcis centras";"9, 10 S klasė";5030855634;Ne;0;19;0;19
18179;"Vilniaus Verkių mokykla-daugiafunkcis centras";"9, 10 S klasė";1259538808;Ne;0;20;0;20
18180;"Vilniaus Verkių mokykla-daugiafunkcis centras";"8, 9 S klasė";1514869108;Ne;0;1;0;1
18181;"Vilniaus Verkių mokykla-daugiafunkcis centras";"8, 9 S klasė";3145397791;Ne;0;7;0;7
18182;"Vilniaus Verkių mokykla-daugiafunkcis centras";"8, 9 S klasė";3870610295;Ne;0;4;0;4
18183;"Vilniaus Verkių mokykla-daugiafunkcis centras";"7 S klasė";3631392717;Ne;0;1;0;1
18184;"Vilniaus Verkių mokykla-daugiafunkcis centras";"7 S klasė";11657021053;Ne;0;1;0;1
18185;"Vilniaus Verkių mokykla-daugiafunkcis centras";"7 S klasė";13432910676;Ne;0;5;0;5
18186;"Vilniaus Verkių mokykla-daugiafunkcis centras";"7 S klasė";9598385220;Ne;0;11;0;11
18187;"Vilniaus Verkių mokykla-daugiafunkcis centras";"7 S klasė";4914336091;Ne;0;1;0;1
18188;"Vilniaus Verkių mokykla-daugiafunkcis centras";"7 S klasė";4914336091;Ne;0;1;0;1
18189;"Vilniaus Verkių mokykla-daugiafunkcis centras";"7 S klasė";2254324740;Ne;0;12;0;12
18190;"Vilniaus Verkių mokykla-daugiafunkcis centras";"5, 6, 7, 8 L klasė";37572425955;Ne;0;9;0;9
18191;"Vilniaus Verkių mokykla-daugiafunkcis centras";"5, 6, 7, 8 L klasė";44425437058;Ne;0;6;0;6
18192;"Vilniaus Verkių mokykla-daugiafunkcis centras";"5, 6, 7, 8 L klasė";2261393560;Ne;0;6;0;6
18193;"Vilniaus Verkių mokykla-daugiafunkcis centras";"5, 6, 7, 8 L klasė";37848550744;Ne;0;20;0;20
18194;"Vilniaus Verkių mokykla-daugiafunkcis centras";"5, 6 S klasė";2396841187;Ne;0;5;0;5
18195;"Vilniaus Verkių mokykla-daugiafunkcis centras";"5, 6 S klasė";8342540661;Ne;0;1;0;1
18196;"Vilniaus Verkių mokykla-daugiafunkcis centras";"5, 6 S klasė";9634174513;Ne;0;20;0;20
18197;"Vilniaus Verkių mokykla-daugiafunkcis centras";"5, 6 S klasė";62513475987;Ne;0;1;0;1
18198;"Vilniaus Verkių mokykla-daugiafunkcis centras";"5, 6 S klasė";2728524848;Ne;0;2;0;2
18199;"Vilniaus Verkių mokykla-daugiafunkcis centras";"5, 6 S klasė";9816043688;Ne;0;8;0;8
18200;"Vilniaus Verkių mokykla-daugiafunkcis centras";"5, 6 S klasė";24268622677;Ne;0;1;0;1
18201;"Vilniaus Verkių mokykla-daugiafunkcis centras";"5, 6 S klasė";24268622677;Ne;0;1;0;1
18202;"Vilniaus Verkių mokykla-daugiafunkcis centras";"5, 6 S klasė";24268622677;Ne;0;1;0;1
18203;"Vilniaus Verkių mokykla-daugiafunkcis centras";"5, 6 S klasė";24268622677;Ne;0;1;0;1
18204;"Vilniaus Verkių mokykla-daugiafunkcis centras";"5, 6 S klasė";67335258608;Ne;0;20;0;20
18205;"Vilniaus Verkių mokykla-daugiafunkcis centras";"5, 6 S klasė";5754278814;Ne;0;8;0;8
18206;"Vilniaus Verkių mokykla-daugiafunkcis centras";"3, 4 S klasė";6417342868;Ne;0;5;0;5
18207;"Vilniaus Verkių mokykla-daugiafunkcis centras";"3, 4 S klasė";2160146000;Ne;0;1;0;1
18208;"Vilniaus Verkių mokykla-daugiafunkcis centras";"3, 4 S klasė";4675792296;Ne;0;20;0;20
18209;"Vilniaus Verkių mokykla-daugiafunkcis centras";"3, 4 S klasė";4675792296;Ne;0;20;0;20
18210;"Vilniaus Verkių mokykla-daugiafunkcis centras";"Priešmokyklinio, 1, 2 S klasė";7942036741;Ne;0;3;0;3
18211;"Vilniaus Verkių mokykla-daugiafunkcis centras";"Priešmokyklinio, 1, 2 S klasė";1809511815;Ne;0;6;0;6
18212;"Vilniaus Verkių mokykla-daugiafunkcis centras";"Priešmokyklinio, 1, 2 S klasė";8844612659;Ne;0;1;0;1
18213;"Vilniaus Verkių mokykla-daugiafunkcis centras";"1, 2, 3, 4 S, L klasė rusų";9256422807;Ne;0;10;0;10
18214;"Vilniaus Verkių mokykla-daugiafunkcis centras";"1, 2, 3, 4 S, L klasė rusų";3504918499;Ne;0;2;0;2
18215;"Vilniaus Verkių mokykla-daugiafunkcis centras";"1, 2, 3, 4 S, L klasė rusų";3504918499;Ne;0;2;0;2
18216;"Vilniaus Verkių mokykla-daugiafunkcis centras";"1, 2, 3, 4 S, L klasė rusų";4011623622;Taip;0;18;0;18
18217;"Vilniaus Verkių mokykla-daugiafunkcis centras";"1, 2, 3, 4 S, L klasė rusų";2064565430;Ne;0;12;0;12
18218;"Vilniaus Verkių mokykla-daugiafunkcis centras";"1, 2, 3, 5, 7 S, L klasė lenkų";6215345468;Ne;0;20;0;20
18219;"Vilniaus Verkių mokykla-daugiafunkcis centras";"1, 2, 3, 5, 7 S, L klasė lenkų";5802046806;Ne;0;5;0;5
18220;"Vilniaus Verkių mokykla-daugiafunkcis centras";"1, 2, 3, 5, 7 S, L klasė lenkų";7591511377;Ne;0;8;0;8
18221;"Vilniaus Verkių mokykla-daugiafunkcis centras";"1, 2, 3, 5, 7 S, L klasė lenkų";6813357731;Ne;0;5;0;5
18222;"Vilniaus Verkių mokykla-daugiafunkcis centras";"1, 2, 3, 5, 7 S, L klasė lenkų";6868531249;Ne;0;5;0;5
18223;"Vilniaus Verkių mokykla-daugiafunkcis centras";"1, 2, 3, 5, 7 S, L klasė lenkų";6868531249;Ne;0;5;0;5
18224;"Vilniaus Verkių mokykla-daugiafunkcis centras";"1, 2, 3, 5, 7 S, L klasė lenkų";6868531249;Ne;0;5;0;5
18225;"Vilniaus Verkių mokykla-daugiafunkcis centras";"1, 2, 3, 5, 7 S, L klasė lenkų";6868531249;Ne;0;5;0;5
18226;"Vilniaus Verkių mokykla-daugiafunkcis centras";"1, 2, 3, 5, 7 S, L klasė lenkų";6868531249;Ne;0;5;0;5
18227;"Vilniaus Verkių mokykla-daugiafunkcis centras";"1, 2, 3, 5, 7 S, L klasė lenkų";6868531249;Ne;0;5;0;5
18228;"Vilniaus Verkių mokykla-daugiafunkcis centras";"5, 6, 7, 8 L klasė RU";4066377955;Ne;0;6;0;6
18229;"Vilniaus Verkių mokykla-daugiafunkcis centras";"5, 6, 7, 8 L klasė RU";1503792026;Ne;0;15;0;15
18230;"Vilniaus Verkių mokykla-daugiafunkcis centras";"5, 6, 7, 8 L klasė RU";9259642351;Ne;0;20;0;20
18231;"Vilniaus Verkių mokykla-daugiafunkcis centras";" SĮUP I m.m., SĮUP II m.m. klasė RU";7000432264;Ne;0;1;0;1
18232;"Vilniaus Verkių mokykla-daugiafunkcis centras";" SĮUP I m.m., SĮUP II m.m. klasė RU";9098854782;Ne;0;4;0;4
18233;"Vilniaus Verkių mokykla-daugiafunkcis centras";" SĮUP I m.m., SĮUP II m.m. klasė RU";6937513931;Ne;0;20;0;20
18234;"Vilniaus Verkių mokykla-daugiafunkcis centras";" SĮUP I m.m., SĮUP II m.m. klasė RU";3155197214;Ne;0;20;0;20
18235;"Vilniaus Verkių mokykla-daugiafunkcis centras";" SĮUP I m.m., SĮUP II m.m. klasė RU";1454746961;Ne;0;7;0;7
18236;"Vilniaus Verkių mokykla-daugiafunkcis centras";" SĮUP I m.m., SĮUP II m.m. klasė RU";2076640938;Ne;0;8;0;8
18237;"Vilniaus Verkių mokykla-daugiafunkcis centras";" SĮUP I m.m., SĮUP II m.m. klasė RU";1062601239;Ne;0;3;0;3
18238;"Vilniaus Verkių mokykla-daugiafunkcis centras";" SĮUP I m.m., SĮUP II m.m. klasė RU";6958157444;Ne;0;3;0;3
18239;"Vilniaus Verkių mokykla-daugiafunkcis centras";" SĮUP I m.m., SĮUP II m.m. klasė RU";9430569608;Ne;0;20;0;20
18240;"Vilniaus Verkių mokykla-daugiafunkcis centras";" SĮUP I m.m., SĮUP II m.m. klasė RU";2305478898;Ne;0;5;0;5
18241;"Vilniaus Verkių mokykla-daugiafunkcis centras";" SĮUP I m.m., SĮUP II m.m. klasė RU";2518928115;Ne;0;3;0;3
18242;Gluosnis;KIŠKUČIAI;2984134115;Ne;0;1;4;5
18243;Gluosnis;KIŠKUČIAI;6955695422;Ne;4;0;0;4
18244;Gluosnis;KIŠKUČIAI;1305651237;Ne;5;0;0;5
18245;Gluosnis;KIŠKUČIAI;4285562600;Ne;0;2;0;2
18246;Gluosnis;KIŠKUČIAI;8009719622;Ne;8;0;0;8
18247;Gluosnis;KIŠKUČIAI;9833971809;Ne;0;0;1;1
18248;Gluosnis;KIŠKUČIAI;6883663577;Ne;4;2;0;6
18249;Gluosnis;KIŠKUČIAI;1512855055;Taip;7;0;1;8
18250;Gluosnis;KIŠKUČIAI;8337313448;Ne;0;0;2;2
18251;Gluosnis;KIŠKUČIAI;4632419177;Ne;0;0;3;3
18252;Gluosnis;KIŠKUČIAI;8928597187;Ne;0;0;4;4
18253;Gluosnis;KIŠKUČIAI;6994005000;Ne;0;1;0;1
18254;Gluosnis;KIŠKUČIAI;9221983318;Ne;6;0;1;7
18255;Gluosnis;KIŠKUČIAI;5664156894;Ne;5;4;1;10
18256;Gluosnis;KIŠKUČIAI;7073637619;Taip;2;0;3;5
18257;Gluosnis;KIŠKUČIAI;1391404073;Ne;5;0;2;7
18258;Gluosnis;KIŠKUČIAI;4591550636;Ne;6;6;0;12
18259;Gluosnis;KIŠKUČIAI;6212693015;Taip;15;2;0;17
18260;Gluosnis;EŽIUKAI;5350702449;Ne;5;0;2;7
18261;Gluosnis;EŽIUKAI;8577271806;Ne;0;0;1;1
18262;Gluosnis;EŽIUKAI;6622415563;Ne;3;0;0;3
18263;Gluosnis;EŽIUKAI;9788278155;Ne;1;2;0;3
18264;Gluosnis;EŽIUKAI;7974944779;Ne;0;1;0;1
18265;Gluosnis;EŽIUKAI;7526020668;Ne;2;1;0;3
18266;Gluosnis;EŽIUKAI;5522411084;Ne;0;0;1;1
18267;Gluosnis;EŽIUKAI;6681653921;Ne;2;11;0;13
18268;Gluosnis;EŽIUKAI;4902627153;Taip;10;0;0;10
18269;Gluosnis;EŽIUKAI;2525780494;Ne;13;4;0;17
18270;Gluosnis;EŽIUKAI;9389736360;Ne;0;1;1;2
18271;Gluosnis;EŽIUKAI;2707855273;Ne;8;0;0;8
18272;Gluosnis;EŽIUKAI;7523459118;Ne;3;0;2;5
18273;Gluosnis;EŽIUKAI;2794163383;Ne;3;0;1;4
18274;Gluosnis;EŽIUKAI;7264550578;Ne;6;0;1;7
18275;Gluosnis;EŽIUKAI;5368171142;Ne;0;11;0;11
18276;Gluosnis;MEŠKIUKAI;8981904827;Ne;0;0;1;1
18277;Gluosnis;MEŠKIUKAI;8998776286;Ne;4;1;0;5
18278;Gluosnis;MEŠKIUKAI;1846499141;Ne;20;0;0;20
18279;Gluosnis;MEŠKIUKAI;7935750427;Ne;0;0;3;3
18280;Gluosnis;MEŠKIUKAI;4905002832;Ne;0;1;0;1
18281;Gluosnis;MEŠKIUKAI;9102081648;Taip;0;0;2;2
18282;Gluosnis;MEŠKIUKAI;4498429439;Ne;5;0;0;5
18283;Gluosnis;MEŠKIUKAI;1235091885;Ne;4;7;0;11
18284;Gluosnis;MEŠKIUKAI;1165636758;Ne;0;0;3;3
18285;Gluosnis;MEŠKIUKAI;8499748544;Ne;0;5;0;5
18286;Gluosnis;MEŠKIUKAI;9699577397;Ne;9;0;0;9
18287;Gluosnis;MEŠKIUKAI;4107344313;Ne;10;0;0;10
18288;Gluosnis;MEŠKIUKAI;1101472999;Ne;0;1;4;5
18289;Gluosnis;MEŠKIUKAI;7995558671;Ne;4;0;0;4
18290;Gluosnis;MEŠKIUKAI;8842139496;Ne;2;0;0;2
18291;Gluosnis;MEŠKIUKAI;6428753580;Taip;4;0;1;5
18292;Gluosnis;MEŠKIUKAI;6246512101;Ne;5;0;0;5
18293;Gluosnis;MEŠKIUKAI;3038732180;Ne;12;0;2;14
18294;Gluosnis;MEŠKIUKAI;1712795835;Ne;5;0;0;5
18295;Gluosnis;BORUŽĖLĖS;8840658383;Ne;13;1;0;14
18296;Gluosnis;BORUŽĖLĖS;1102935178;Ne;3;0;1;4
18297;Gluosnis;BORUŽĖLĖS;2167312808;Ne;0;0;1;1
18298;Gluosnis;BORUŽĖLĖS;4204797742;Ne;0;6;0;6
18299;Gluosnis;BORUŽĖLĖS;6302765948;Ne;5;0;2;7
18300;Gluosnis;BORUŽĖLĖS;9938235476;Ne;0;3;0;3
18301;Gluosnis;BORUŽĖLĖS;2945796648;Ne;0;1;1;2
18302;Gluosnis;BORUŽĖLĖS;2173191971;Ne;4;0;5;9
18303;Gluosnis;BORUŽĖLĖS;4237053702;Ne;9;0;0;9
18304;Gluosnis;BORUŽĖLĖS;9664090375;Ne;3;0;0;3
18305;Gluosnis;BORUŽĖLĖS;1335152703;Taip;5;0;0;5
18306;Gluosnis;BORUŽĖLĖS;1314992969;Taip;4;0;1;5
18307;Gluosnis;BORUŽĖLĖS;7833136455;Ne;0;1;0;1
18308;Gluosnis;BORUŽĖLĖS;5556821953;Taip;0;0;1;1
18309;Gluosnis;BORUŽĖLĖS;6086258054;Ne;5;0;2;7
18310;Gluosnis;BORUŽĖLĖS;1351519995;Ne;3;2;2;7
18311;Gluosnis;BORUŽĖLĖS;6960673767;Taip;7;7;0;14
18312;Gluosnis;LAPIUKAI;5266206726;Ne;8;0;0;8
18313;Gluosnis;LAPIUKAI;8976032500;Ne;0;0;6;6
18314;Gluosnis;LAPIUKAI;3190331209;Taip;0;1;0;1
18315;Gluosnis;LAPIUKAI;5376108804;Taip;9;0;0;9
18316;Gluosnis;LAPIUKAI;9386396460;Ne;10;0;0;10
18317;Gluosnis;LAPIUKAI;1664508998;Ne;0;0;1;1
18318;Gluosnis;LAPIUKAI;1296975213;Ne;0;0;1;1
18319;Gluosnis;LAPIUKAI;8227732558;Ne;4;1;0;5
18320;Gluosnis;LAPIUKAI;4146877525;Taip;5;7;0;12
18321;Gluosnis;LAPIUKAI;4616132460;Ne;5;0;0;5
18322;Gluosnis;LAPIUKAI;7090336454;Ne;4;0;0;4
18323;Gluosnis;PELĖDŽIUKAI;5633386146;Taip;0;0;2;2
18324;Gluosnis;PELĖDŽIUKAI;1144177849;Ne;4;0;0;4
18325;Gluosnis;PELĖDŽIUKAI;6747244713;Ne;0;0;1;1
18326;Gluosnis;PELĖDŽIUKAI;3900322680;Ne;9;0;1;10
18327;Gluosnis;PELĖDŽIUKAI;6729016081;Ne;1;0;0;1
18328;Gluosnis;PELĖDŽIUKAI;4069584911;Ne;0;0;1;1
18329;Gluosnis;PELĖDŽIUKAI;1263019496;Ne;2;5;0;7
18330;Gluosnis;PELĖDŽIUKAI;6119618742;Ne;9;0;0;9
18331;Gluosnis;PELĖDŽIUKAI;8109714321;Taip;5;0;0;5
18332;Gluosnis;PELĖDŽIUKAI;2794080237;Ne;4;0;0;4
18333;Gluosnis;PELĖDŽIUKAI;4564193030;Ne;1;1;2;4
18334;Gluosnis;PELĖDŽIUKAI;5623135790;Ne;15;2;0;17
18335;Gluosnis;PELĖDŽIUKAI;2310874591;Ne;8;0;0;8
18336;Gluosnis;PELĖDŽIUKAI;5210930032;Taip;0;3;0;3
18337;Gluosnis;PELĖDŽIUKAI;5008836118;Ne;0;0;2;2
18338;Gluosnis;PELĖDŽIUKAI;4224637208;Ne;0;1;0;1
18339;Gluosnis;PELĖDŽIUKAI;4361177196;Ne;10;0;0;10
18340;Gluosnis;PELĖDŽIUKAI;9484423786;Taip;5;0;0;5
18341;Gluosnis;PELĖDŽIUKAI;9423229931;Ne;5;0;0;5
18342;Gluosnis;PELĖDŽIUKAI;3578467708;Ne;3;0;0;3
18343;Gluosnis;VOVERIUKAI;4798207493;Ne;7;0;0;7
18344;Gluosnis;VOVERIUKAI;5822836262;Ne;5;0;0;5
18345;Gluosnis;VOVERIUKAI;8374694200;Ne;8;0;0;8
18346;Gluosnis;VOVERIUKAI;8299388060;Ne;8;0;1;9
18347;Gluosnis;VOVERIUKAI;6617408330;Ne;4;0;0;4
18348;Gluosnis;VOVERIUKAI;5972818467;Ne;13;0;0;13
18349;Gluosnis;VOVERIUKAI;3400563947;Ne;0;1;0;1
18350;Gluosnis;VOVERIUKAI;5850079627;Ne;10;0;0;10
18351;Gluosnis;VOVERIUKAI;2243717506;Ne;9;0;0;9
18352;Gluosnis;VOVERIUKAI;1757821835;Ne;7;0;0;7
18353;Gluosnis;VOVERIUKAI;8310409721;Ne;3;0;0;3
18354;Gluosnis;VOVERIUKAI;2746499687;Ne;8;0;0;8
18355;Gluosnis;VOVERIUKAI;1636516971;Ne;0;2;0;2
18356;Gluosnis;DRUGELIAI;1716235604;Ne;0;4;0;4
18357;Gluosnis;DRUGELIAI;4125830926;Taip;5;1;0;6
18358;Gluosnis;DRUGELIAI;6358187113;Taip;5;0;0;5
18359;Gluosnis;DRUGELIAI;9084785666;Ne;0;5;0;5
18360;Gluosnis;DRUGELIAI;4940563623;Ne;0;3;0;3
18361;Gluosnis;DRUGELIAI;4653963373;Ne;2;2;0;4
18362;Gluosnis;DRUGELIAI;2458662117;Ne;5;0;1;6
18363;Gluosnis;DRUGELIAI;8314366921;Ne;0;0;2;2
18364;Gluosnis;DRUGELIAI;6914171069;Ne;0;2;0;2
18365;Gluosnis;DRUGELIAI;5943955268;Ne;0;0;1;1
18366;Gluosnis;DRUGELIAI;8690911930;Ne;0;0;1;1
18367;Gluosnis;DRUGELIAI;1787206205;Ne;8;0;0;8
18368;Gluosnis;DRUGELIAI;5264930854;Ne;5;3;0;8
18369;Gluosnis;BITUTĖS;4176300773;Taip;1;0;0;1
18370;Gluosnis;BITUTĖS;2554790908;Ne;0;4;0;4
18371;Gluosnis;BITUTĖS;8281499182;Ne;2;0;0;2
18372;Gluosnis;BITUTĖS;6432475763;Ne;2;0;0;2
18373;Gluosnis;BITUTĖS;1966484574;Ne;0;1;0;1
18374;Gluosnis;BITUTĖS;5889360726;Ne;1;0;1;2
18375;Gluosnis;BITUTĖS;3362089746;Ne;3;0;2;5
18376;Gluosnis;BITUTĖS;7390361159;Ne;1;0;1;2
18377;Gluosnis;BITUTĖS;8380310240;Ne;2;0;0;2
18378;Gluosnis;BITUTĖS;4481544177;Taip;0;0;3;3
18379;Gluosnis;BITUTĖS;9201769624;Ne;0;0;2;2
18380;Gluosnis;BITUTĖS;6001358241;Ne;0;0;3;3
18381;Gluosnis;BITUTĖS;6197840105;Ne;2;2;0;4
18382;Gluosnis;BITUTĖS;5204445760;Ne;0;2;0;2
18383;Gluosnis;BITUTĖS;5432102004;Ne;0;0;2;2
18384;"Vilniaus Simono Stanevičiaus progimnazija";BITUTĖS;7528014407;Ne;0;3;0;3
18385;"Vilniaus Simono Stanevičiaus progimnazija";BITUTĖS;5140264695;Ne;1;1;0;2
18386;"Vilniaus Simono Stanevičiaus progimnazija";BITUTĖS;5733610359;Ne;6;0;0;6
18387;"Vilniaus Simono Stanevičiaus progimnazija";BITUTĖS;2021296978;Ne;0;3;0;3
18388;"Vilniaus Simono Stanevičiaus progimnazija";BITUTĖS;8667155756;Ne;0;1;0;1
18389;"Vilniaus Simono Stanevičiaus progimnazija";BITUTĖS;1566011843;Ne;2;0;0;2
18390;"Vilniaus Simono Stanevičiaus progimnazija";BITUTĖS;4586098882;Ne;0;2;0;2
18391;"Vilniaus Simono Stanevičiaus progimnazija";BITUTĖS;8378295683;Taip;0;2;0;2
18392;"Vilniaus Simono Stanevičiaus progimnazija";BITUTĖS;3678796113;Ne;1;19;0;20
18393;"Vilniaus Simono Stanevičiaus progimnazija";BITUTĖS;7335784416;Ne;0;1;0;1
18394;"Vilniaus Simono Stanevičiaus progimnazija";BITUTĖS;6259640492;Ne;7;1;0;8
18395;"Vilniaus Simono Stanevičiaus progimnazija";BITUTĖS;6800864033;Ne;0;1;0;1
18396;"Vilniaus Simono Stanevičiaus progimnazija";KATINĖLIAI;2487784714;Ne;14;0;0;14
18397;"Vilniaus Simono Stanevičiaus progimnazija";KATINĖLIAI;7991650887;Ne;2;0;1;3
18398;"Vilniaus Simono Stanevičiaus progimnazija";KATINĖLIAI;4682659878;Ne;0;7;0;7
18399;"Vilniaus Simono Stanevičiaus progimnazija";KATINĖLIAI;1051805733;Ne;0;1;0;1
18400;"Vilniaus Simono Stanevičiaus progimnazija";KATINĖLIAI;4973969827;Ne;0;1;0;1
18401;"Vilniaus Simono Stanevičiaus progimnazija";KATINĖLIAI;1569084597;Ne;4;0;0;4
18402;"Vilniaus Simono Stanevičiaus progimnazija";KATINĖLIAI;1166282379;Ne;0;3;0;3
18403;"Vilniaus Simono Stanevičiaus progimnazija";KATINĖLIAI;6073971598;Taip;2;0;0;2
18404;"Vilniaus Simono Stanevičiaus progimnazija";KATINĖLIAI;2734024890;Ne;1;0;0;1
18405;"Vilniaus Simono Stanevičiaus progimnazija";KATINĖLIAI;2483957349;Ne;5;0;0;5
18406;"Vilniaus Simono Stanevičiaus progimnazija";KATINĖLIAI;6248532738;Ne;1;0;0;1
18407;"Vilniaus Simono Stanevičiaus progimnazija";KATINĖLIAI;8967704928;Ne;1;0;0;1
18408;"Vilniaus Simono Stanevičiaus progimnazija";KATINĖLIAI;8799003374;Ne;0;20;0;20
18409;"Vilniaus Simono Stanevičiaus progimnazija";KATINĖLIAI;1545323439;Ne;7;0;0;7
18410;"Vilniaus Saulėtekio mokykla-daugiafunkcinis centras";"PRIEŠMOKYKLINĖ 2";3499348606;Ne;0;30;0;30
18411;"Vilniaus Saulėtekio mokykla-daugiafunkcinis centras";"PRIEŠMOKYKLINĖ 2";4730746531;Ne;2;0;0;2
18412;"Vilniaus Saulėtekio mokykla-daugiafunkcinis centras";"PRIEŠMOKYKLINĖ 2";9471880764;Ne;8;0;2;10
18413;"Vilniaus Saulėtekio mokykla-daugiafunkcinis centras";"PRIEŠMOKYKLINĖ 2";8012122042;Ne;2;0;0;2
18414;"Vilniaus Saulėtekio mokykla-daugiafunkcinis centras";"PRIEŠMOKYKLINĖ 2";2034007263;Ne;5;0;0;5
18415;"Vilniaus Saulėtekio mokykla-daugiafunkcinis centras";"PRIEŠMOKYKLINĖ 2";7958528778;Ne;0;30;0;30
18416;"Vilniaus Saulėtekio mokykla-daugiafunkcinis centras";"PRIEŠMOKYKLINĖ 2";3080668107;Ne;9;0;1;10
18417;"Vilniaus Saulėtekio mokykla-daugiafunkcinis centras";"PRIEŠMOKYKLINĖ 2";6080664872;Ne;15;0;1;16
18418;"Vilniaus Saulėtekio mokykla-daugiafunkcinis centras";"PRIEŠMOKYKLINĖ 2";3873345138;Ne;15;0;3;18
18419;"Vilniaus Saulėtekio mokykla-daugiafunkcinis centras";"PRIEŠMOKYKLINĖ 2";6702207851;Ne;5;0;1;6
18420;"Vilniaus Saulėtekio mokykla-daugiafunkcinis centras";"PRIEŠMOKYKLINĖ 2";5551184248;Ne;0;30;0;30
18421;"Vilniaus Saulėtekio mokykla-daugiafunkcinis centras";"PRIEŠMOKYKLINĖ 2";2631120189;Taip;30;0;0;30
18422;"Vilniaus Saulėtekio mokykla-daugiafunkcinis centras";"PRIEŠMOKYKLINĖ 2";5998344519;Ne;8;0;2;10
18423;"Vilniaus Saulėtekio mokykla-daugiafunkcinis centras";"PRIEŠMOKYKLINĖ  1";7735063486;Ne;6;0;0;6
18424;"Vilniaus Saulėtekio mokykla-daugiafunkcinis centras";"PRIEŠMOKYKLINĖ  1";3744848906;Ne;15;0;2;17
18425;"Vilniaus Saulėtekio mokykla-daugiafunkcinis centras";"PRIEŠMOKYKLINĖ  1";4234425668;Ne;10;1;0;11
18426;"Vilniaus Saulėtekio mokykla-daugiafunkcinis centras";"PRIEŠMOKYKLINĖ  1";4852738818;Ne;11;0;0;11
18427;"Vilniaus Saulėtekio mokykla-daugiafunkcinis centras";"PRIEŠMOKYKLINĖ  1";5399981203;Ne;0;3;0;3
18428;"Vilniaus Saulėtekio mokykla-daugiafunkcinis centras";"PRIEŠMOKYKLINĖ  1";8997525194;Ne;0;0;7;7
18429;"Vilniaus Saulėtekio mokykla-daugiafunkcinis centras";"PRIEŠMOKYKLINĖ  1";6860696706;Ne;3;0;0;3
18430;"Vilniaus Saulėtekio mokykla-daugiafunkcinis centras";"PRIEŠMOKYKLINĖ  1";9031478765;Ne;0;0;1;1
18431;"Vilniaus Saulėtekio mokykla-daugiafunkcinis centras";"PRIEŠMOKYKLINĖ  1";5532685692;Ne;4;0;1;5
18432;"Vilniaus Saulėtekio mokykla-daugiafunkcinis centras";"PRIEŠMOKYKLINĖ  1";5817562139;Ne;0;30;0;30
18433;"Vilniaus Saulėtekio mokykla-daugiafunkcinis centras";"PRIEŠMOKYKLINĖ  1";1625321820;Ne;13;0;0;13
18434;"Vilniaus Saulėtekio mokykla-daugiafunkcinis centras";"PRIEŠMOKYKLINĖ  1";3382354753;Ne;14;0;2;16
18435;"Vilniaus Saulėtekio mokykla-daugiafunkcinis centras";"PRIEŠMOKYKLINĖ  1";9099285081;Ne;0;3;0;3
18436;"Vilniaus Saulėtekio mokykla-daugiafunkcinis centras";"PRIEŠMOKYKLINĖ  1";1839351438;Ne;0;0;1;1
18437;"Vilniaus Saulėtekio mokykla-daugiafunkcinis centras";"PRIEŠMOKYKLINĖ  1";5586871557;Ne;0;30;0;30
18438;"Vilniaus Saulėtekio mokykla-daugiafunkcinis centras";"PRIEŠMOKYKLINĖ  1";2429527586;Ne;0;0;3;3
18439;"Vilniaus Maironio progimnazija";"1 PU";5593526943;Ne;2;0;0;2
18440;"Vilniaus Maironio progimnazija";"1 PU";1603752483;Ne;10;0;0;10
18441;"Vilniaus Maironio progimnazija";"1 PU";5022388487;Taip;4;0;0;4
18442;"Vilniaus Maironio progimnazija";"1 PU";1024337077;Ne;0;31;0;31
18443;"Vilniaus Maironio progimnazija";"1 PU";6176234300;Ne;1;0;0;1
18444;"Vilniaus Maironio progimnazija";"1 PU";1339850717;Ne;10;3;0;13
18445;"Vilniaus Maironio progimnazija";"1 PU";4570512336;Ne;1;0;0;1
18446;"Vilniaus Maironio progimnazija";"1 PU";6266095782;Ne;3;0;0;3
18447;"Vilniaus Maironio progimnazija";"1 PU";9803206596;Ne;9;0;0;9
18448;"Vilniaus Maironio progimnazija";"1 PU";2707029719;Ne;7;1;0;8
18449;"Vilniaus Maironio progimnazija";"1 PU";3347146751;Ne;1;1;0;2
18450;"Vilniaus Maironio progimnazija";"1 PU";2443856355;Ne;4;0;0;4
18451;"Vilniaus Maironio progimnazija";"2 PU";8768526171;Ne;3;0;0;3
18452;"Vilniaus Maironio progimnazija";"2 PU";6949120693;Ne;7;0;0;7
18453;"Vilniaus Maironio progimnazija";"2 PU";7080578299;Ne;3;0;0;3
18454;"Vilniaus Maironio progimnazija";"2 PU";9968072478;Taip;0;2;0;2
18455;"Vilniaus Maironio progimnazija";"2 PU";8480891793;Ne;4;0;0;4
18456;"Vilniaus Maironio progimnazija";"2 PU";3320524073;Ne;2;2;0;4
18457;"Vilniaus Maironio progimnazija";"2 PU";2339010385;Ne;2;0;0;2
18458;"Vilniaus Maironio progimnazija";"2 PU";3895256591;Ne;0;1;0;1
18459;"Vilniaus Maironio progimnazija";"2 PU";1827752731;Ne;3;0;0;3
18460;"Vilniaus Maironio progimnazija";"2 PU";7252265838;Ne;1;1;0;2
18461;"Vilniaus Maironio progimnazija";"2 PU";2868899342;Ne;3;0;0;3
18462;"Vilniaus Maironio progimnazija";"2 PU";8606551477;Ne;2;0;0;2
18463;"Vilniaus Maironio progimnazija";"2 PU";2334234258;Ne;3;0;0;3
18464;"Vilniaus Maironio progimnazija";"2 PU";9978625382;Ne;3;1;0;4
18465;"Vilniaus kunigaikščio Gedimino progimnazija";NYKŠTUKAI;2406183145;Ne;0;2;0;2
18466;"Vilniaus kunigaikščio Gedimino progimnazija";NYKŠTUKAI;2379660463;Ne;0;2;0;2
18467;"Vilniaus kunigaikščio Gedimino progimnazija";NYKŠTUKAI;9408948207;Ne;4;5;0;9
18468;"Vilniaus kunigaikščio Gedimino progimnazija";NYKŠTUKAI;6942029629;Ne;0;3;0;3
18469;"Vilniaus kunigaikščio Gedimino progimnazija";NYKŠTUKAI;7161727352;Ne;0;2;0;2
18470;"Vilniaus kunigaikščio Gedimino progimnazija";NYKŠTUKAI;9777202512;Ne;3;3;0;6
18471;"Vilniaus kunigaikščio Gedimino progimnazija";NYKŠTUKAI;1420438624;Ne;2;0;0;2
18472;"Gintarėlis (Popieriaus g. 46A)";SKRUZDĖLIUKAI;5738933125;Ne;6;4;0;10
18473;"Gintarėlis (Popieriaus g. 46A)";SKRUZDĖLIUKAI;7510541192;Ne;0;4;0;4
18474;"Gintarėlis (Popieriaus g. 46A)";SKRUZDĖLIUKAI;1955719034;Ne;10;0;0;10
18475;"Gintarėlis (Popieriaus g. 46A)";SKRUZDĖLIUKAI;1215549844;Ne;10;0;0;10
18476;"Gintarėlis (Popieriaus g. 46A)";SKRUZDĖLIUKAI;5961603860;Ne;0;6;0;6
18477;"Gintarėlis (Popieriaus g. 46A)";SKRUZDĖLIUKAI;4290033336;Ne;3;0;0;3
18478;"Gintarėlis (Popieriaus g. 46A)";SKRUZDĖLIUKAI;5474876914;Ne;0;2;0;2
18479;"Gintarėlis (Popieriaus g. 46A)";SKRUZDĖLIUKAI;6333647073;Ne;5;2;0;7
18480;"Gintarėlis (Popieriaus g. 46A)";SKRUZDĖLIUKAI;7274616480;Ne;0;6;0;6
18481;"Gintarėlis (Popieriaus g. 46A)";SKRUZDĖLIUKAI;1362980885;Ne;0;8;0;8
18482;"Gintarėlis (Popieriaus g. 46A)";SKRUZDĖLIUKAI;9762364250;Ne;3;0;0;3
18483;"Gintarėlis (Popieriaus g. 46A)";SKRUZDĖLIUKAI;7206593645;Ne;4;1;0;5
18484;"Gintarėlis (Popieriaus g. 46A)";SKRUZDĖLIUKAI;7400455090;Ne;4;2;0;6
18485;"Gintarėlis (Popieriaus g. 46A)";SKRUZDĖLIUKAI;7413074674;Ne;0;1;0;1
18486;"Gintarėlis (Popieriaus g. 46A)";PELĖDŽIUKAI;6506180216;Taip;12;1;0;13
18487;"Gintarėlis (Popieriaus g. 46A)";PELĖDŽIUKAI;9200073539;Ne;7;2;1;10
18488;"Gintarėlis (Popieriaus g. 46A)";PELĖDŽIUKAI;1628276472;Ne;7;1;0;8
18489;"Gintarėlis (Popieriaus g. 46A)";PELĖDŽIUKAI;8792175474;Ne;0;3;0;3
18490;"Gintarėlis (Popieriaus g. 46A)";PELĖDŽIUKAI;3304191482;Ne;6;0;0;6
18491;"Gintarėlis (Popieriaus g. 46A)";PELĖDŽIUKAI;2731865977;Ne;9;0;0;9
18492;"Gintarėlis (Popieriaus g. 46A)";PELĖDŽIUKAI;4181430769;Taip;10;2;0;12
18493;"Gintarėlis (Popieriaus g. 46A)";PELĖDŽIUKAI;3202819190;Ne;9;0;0;9
18494;"Gintarėlis (Popieriaus g. 46A)";PELĖDŽIUKAI;2308673417;Ne;10;0;0;10
18495;"Gintarėlis (Popieriaus g. 46A)";PELĖDŽIUKAI;6883573289;Ne;18;0;0;18
18496;"Gintarėlis (Popieriaus g. 46A)";PELĖDŽIUKAI;3127881266;Taip;8;2;0;10
18497;"Gintarėlis (Popieriaus g. 46A)";PELĖDŽIUKAI;2052962147;Taip;14;0;0;14
18498;"Gintarėlis (Popieriaus g. 46A)";PELĖDŽIUKAI;8677500463;Taip;16;0;0;16
18499;"Gintarėlis (Popieriaus g. 46A)";PELĖDŽIUKAI;7031945895;Ne;10;2;0;12
18500;"Gintarėlis (Popieriaus g. 46A)";PELĖDŽIUKAI;3744569118;Ne;0;20;0;20
18501;"Gintarėlis (Popieriaus g. 46A)";PELĖDŽIUKAI;8068499156;Ne;10;0;0;10
18502;"Gintarėlis (Popieriaus g. 46A)";"LINKSMASIS AVILYS";7872515649;Ne;5;1;0;6
18503;"Gintarėlis (Popieriaus g. 46A)";"LINKSMASIS AVILYS";7256557310;Ne;0;7;0;7
18504;"Gintarėlis (Popieriaus g. 46A)";"LINKSMASIS AVILYS";7010430969;Ne;4;2;0;6
18505;"Gintarėlis (Popieriaus g. 46A)";"LINKSMASIS AVILYS";8680339493;Taip;15;0;0;15
18506;"Gintarėlis (Popieriaus g. 46A)";"LINKSMASIS AVILYS";5223116373;Ne;10;0;0;10
18507;"Gintarėlis (Popieriaus g. 46A)";"LINKSMASIS AVILYS";3825572125;Ne;8;0;0;8
18508;"Gintarėlis (Popieriaus g. 46A)";"LINKSMASIS AVILYS";1994856959;Ne;5;0;0;5
18509;"Gintarėlis (Popieriaus g. 46A)";"LINKSMASIS AVILYS";8223747534;Ne;8;0;0;8
18510;"Gintarėlis (Popieriaus g. 46A)";"LINKSMASIS AVILYS";1045355492;Ne;0;2;0;2
18511;"Gintarėlis (Popieriaus g. 46A)";"LINKSMASIS AVILYS";6193540660;Ne;11;2;0;13
18512;"Gintarėlis (Popieriaus g. 46A)";"LINKSMASIS AVILYS";7916257692;Ne;7;2;0;9
18513;"Gintarėlis (Popieriaus g. 46A)";"LINKSMASIS AVILYS";9045108717;Ne;13;0;0;13
18514;"Gintarėlis (Popieriaus g. 46A)";"LINKSMASIS AVILYS";5379858630;Ne;0;0;11;11
18515;"Gintarėlis (Popieriaus g. 46A)";Varliukai;6821929306;Ne;7;0;0;7
18516;"Gintarėlis (Popieriaus g. 46A)";Varliukai;4263315669;Ne;10;0;0;10
18517;"Gintarėlis (Popieriaus g. 46A)";Varliukai;6514247750;Ne;6;0;0;6
18518;"Gintarėlis (Popieriaus g. 46A)";Varliukai;4556644354;Ne;7;0;0;7
18519;"Gintarėlis (Popieriaus g. 46A)";Varliukai;7510641510;Ne;8;0;0;8
18520;"Gintarėlis (Popieriaus g. 46A)";Varliukai;6534072038;Ne;20;0;0;20
18521;"Gintarėlis (Popieriaus g. 46A)";Varliukai;5478441530;Taip;13;0;0;13
18522;"Gintarėlis (Popieriaus g. 46A)";Varliukai;5771196440;Ne;10;0;0;10
18523;"Gintarėlis (Popieriaus g. 46A)";Varliukai;7783860076;Ne;9;0;0;9
18524;"Gintarėlis (Popieriaus g. 46A)";Varliukai;7201714826;Ne;0;0;1;1
18525;"Gintarėlis (Popieriaus g. 46A)";Varliukai;6796839291;Ne;0;10;0;10
18526;"Gintarėlis (Popieriaus g. 46A)";Varliukai;3842338529;Ne;0;20;0;20
18527;"Gintarėlis (Popieriaus g. 46A)";Varliukai;2742819175;Ne;9;0;1;10
18528;"Gintarėlis (Popieriaus g. 46A)";Varliukai;2692117849;Ne;7;6;0;13
18529;"Gintarėlis (Popieriaus g. 46A)";Varliukai;9063374884;Ne;10;2;0;12
18530;"Gintarėlis (Popieriaus g. 46A)";Varliukai;8226000686;Ne;0;6;0;6
18531;"Gintarėlis (Popieriaus g. 46A)";Varliukai;7128652904;Taip;8;0;0;8
18532;"Pušynėlis (A. Mickevičiaus g. 21)";DAIGIUKAI;8668906624;Ne;10;2;1;13
18533;"Pušynėlis (A. Mickevičiaus g. 21)";DAIGIUKAI;9835049161;Ne;0;2;0;2
18534;"Pušynėlis (A. Mickevičiaus g. 21)";DAIGIUKAI;8473976622;Ne;0;1;0;1
18535;"Pušynėlis (A. Mickevičiaus g. 21)";DAIGIUKAI;6630085270;Ne;16;0;0;16
18536;"Pušynėlis (A. Mickevičiaus g. 21)";DAIGIUKAI;6321506677;Ne;7;0;0;7
18537;"Pušynėlis (A. Mickevičiaus g. 21)";DAIGIUKAI;5601877137;Ne;9;0;0;9
18538;"Pušynėlis (A. Mickevičiaus g. 21)";DAIGIUKAI;7825721993;Ne;0;2;1;3
18539;"Pušynėlis (A. Mickevičiaus g. 21)";DAIGIUKAI;2905910220;Ne;5;0;0;5
18540;"Pušynėlis (A. Mickevičiaus g. 21)";DAIGIUKAI;2283845338;Taip;5;0;0;5
18541;"Pušynėlis (A. Mickevičiaus g. 21)";NYKŠTUKAI;8820865805;Ne;0;20;0;20
18542;"Pušynėlis (A. Mickevičiaus g. 21)";NYKŠTUKAI;9520423020;Ne;0;3;0;3
18543;"Pušynėlis (A. Mickevičiaus g. 21)";NYKŠTUKAI;3574446664;Taip;2;0;0;2
18544;"Pušynėlis (A. Mickevičiaus g. 21)";NYKŠTUKAI;8512699165;Ne;0;4;3;7
18545;"Pušynėlis (A. Mickevičiaus g. 21)";NYKŠTUKAI;5364537212;Ne;0;9;2;11
18546;"Pušynėlis (A. Mickevičiaus g. 21)";NYKŠTUKAI;8327830781;Ne;0;2;6;8
18547;"Pušynėlis (A. Mickevičiaus g. 21)";NYKŠTUKAI;5317547220;Ne;0;0;1;1
18548;"Pušynėlis (A. Mickevičiaus g. 21)";NYKŠTUKAI;9025539389;Ne;3;0;1;4
18549;"Pušynėlis (A. Mickevičiaus g. 21)";NYKŠTUKAI;6594473055;Ne;0;2;0;2
18550;"Pušynėlis (A. Mickevičiaus g. 21)";NYKŠTUKAI;2763762463;Taip;0;3;0;3
18551;"Pušynėlis (A. Mickevičiaus g. 21)";NYKŠTUKAI;6270870180;Taip;9;1;0;10
18552;"Pušynėlis (A. Mickevičiaus g. 21)";NYKŠTUKAI;9717473430;Ne;6;1;0;7
18553;"Pušynėlis (A. Mickevičiaus g. 21)";NYKŠTUKAI;5512586591;Ne;9;0;0;9
18554;"Pušynėlis (A. Mickevičiaus g. 21)";NYKŠTUKAI;2065121473;Ne;5;0;1;6
18555;"Pušynėlis (A. Mickevičiaus g. 21)";GILIUKAI;9517319856;Ne;20;0;0;20
18556;"Pušynėlis (A. Mickevičiaus g. 21)";GILIUKAI;2825756894;Ne;8;1;0;9
18557;"Pušynėlis (A. Mickevičiaus g. 21)";GILIUKAI;4997004998;Ne;0;1;0;1
18558;"Pušynėlis (A. Mickevičiaus g. 21)";GILIUKAI;3301741162;Ne;0;2;0;2
18559;"Pušynėlis (A. Mickevičiaus g. 21)";GILIUKAI;9028515427;Ne;9;11;0;20
18560;"Pušynėlis (A. Mickevičiaus g. 21)";GILIUKAI;1134325833;Ne;0;1;0;1
18561;"Pušynėlis (A. Mickevičiaus g. 21)";GILIUKAI;9220344337;Taip;5;0;0;5
18562;"Pušynėlis (A. Mickevičiaus g. 21)";GILIUKAI;1050710006;Taip;0;2;0;2
18563;"Pušynėlis (A. Mickevičiaus g. 21)";GILIUKAI;1758632291;Taip;5;0;0;5
18564;"Pušynėlis (A. Mickevičiaus g. 21)";GILIUKAI;7429853563;Taip;7;3;0;10
18565;"Pušynėlis (A. Mickevičiaus g. 21)";GILIUKAI;8464672994;Ne;6;2;0;8
18566;"Pušynėlis (A. Mickevičiaus g. 21)";GILIUKAI;9055713601;Ne;3;0;0;3
18567;"Pušynėlis (A. Mickevičiaus g. 21)";GILIUKAI;1904434730;Ne;5;0;0;5
18568;"Pušynėlis (A. Mickevičiaus g. 21)";GILIUKAI;3362971538;Ne;0;1;0;1
18569;"Pušynėlis (A. Mickevičiaus g. 21)";GILIUKAI;8699085292;Ne;5;0;0;5
18570;"Pušynėlis (A. Mickevičiaus g. 21)";LINELIS;4126444564;Ne;4;0;0;4
18571;"Pušynėlis (A. Mickevičiaus g. 21)";LINELIS;4738909947;Ne;8;2;0;10
18572;"Pušynėlis (A. Mickevičiaus g. 21)";LINELIS;3189188757;Ne;0;3;0;3
18573;"Pušynėlis (A. Mickevičiaus g. 21)";LINELIS;8654487151;Taip;1;2;0;3
18574;"Pušynėlis (A. Mickevičiaus g. 21)";LINELIS;6160295507;Ne;5;0;0;5
18575;"Pušynėlis (A. Mickevičiaus g. 21)";LINELIS;8837847094;Ne;12;0;0;12
18576;"Pušynėlis (A. Mickevičiaus g. 21)";LINELIS;6374352500;Ne;0;6;0;6
18577;"Pušynėlis (A. Mickevičiaus g. 21)";LINELIS;9216703884;Ne;2;2;0;4
18578;"Pušynėlis (A. Mickevičiaus g. 21)";LINELIS;5668765825;Ne;14;1;0;15
18579;"Pušynėlis (A. Mickevičiaus g. 21)";LINELIS;3954867816;Ne;0;5;0;5
18580;"Pušynėlis (A. Mickevičiaus g. 21)";LINELIS;7685809238;Ne;19;0;0;19
18581;"Pušynėlis (A. Mickevičiaus g. 21)";LINELIS;7011836009;Ne;3;2;0;5
18582;"Pušynėlis (A. Mickevičiaus g. 21)";LINELIS;6735037523;Ne;0;2;4;6
18583;"Pušynėlis (A. Mickevičiaus g. 21)";LINELIS;9401101407;Ne;0;1;0;1
18584;"Pušynėlis (A. Mickevičiaus g. 21)";LINELIS;9147558926;Ne;0;1;0;1
18585;"Pušynėlis (A. Mickevičiaus g. 21)";LINELIS;1612049897;Ne;3;4;0;7
18586;"Pušynėlis (A. Mickevičiaus g. 21)";LINELIS;4898147530;Taip;0;1;0;1
18587;"Pušynėlis (A. Mickevičiaus g. 21)";LINELIS;2228682366;Ne;0;9;0;9
18588;"Pušynėlis (A. Mickevičiaus g. 21)";LINELIS;4464615995;Ne;15;0;0;15
18589;"Naminukas (Klinikų g. 5)";VARPELIAI;3281707263;Taip;0;0;1;1
18590;"Naminukas (Klinikų g. 5)";VARPELIAI;1086919259;Ne;0;1;0;1
18591;"Naminukas (Klinikų g. 5)";VARPELIAI;2576516583;Ne;8;5;0;13
18592;"Naminukas (Klinikų g. 5)";VARPELIAI;8694425584;Ne;0;0;3;3
18593;"Naminukas (Klinikų g. 5)";VARPELIAI;8782832803;Ne;6;0;0;6
18594;"Naminukas (Klinikų g. 5)";VARPELIAI;7555926818;Ne;11;0;0;11
18595;"Naminukas (Klinikų g. 5)";VARPELIAI;9426969493;Ne;8;0;0;8
18596;"Naminukas (Klinikų g. 5)";VARPELIAI;6834388512;Ne;9;0;8;17
18597;"Naminukas (Klinikų g. 5)";VARPELIAI;8212264128;Ne;2;1;0;3
18598;"Naminukas (Klinikų g. 5)";VARPELIAI;8659342548;Ne;0;1;4;5
18599;"Naminukas (Klinikų g. 5)";VARPELIAI;1415188327;Ne;15;0;0;15
18600;"Naminukas (Klinikų g. 5)";VARPELIAI;5154177047;Ne;15;0;0;15
18601;"Naminukas (Klinikų g. 5)";SAULUTĖS;7947598191;Ne;2;0;0;2
18602;"Naminukas (Klinikų g. 5)";SAULUTĖS;2516513740;Ne;0;1;1;2
18603;"Naminukas (Klinikų g. 5)";SAULUTĖS;2721723305;Ne;1;4;0;5
18604;"Naminukas (Klinikų g. 5)";SAULUTĖS;8052458976;Ne;8;0;0;8
18605;"Naminukas (Klinikų g. 5)";SAULUTĖS;2089455192;Ne;0;1;0;1
18606;"Naminukas (Klinikų g. 5)";SAULUTĖS;1828220049;Ne;3;0;1;4
18607;"Naminukas (Klinikų g. 5)";SAULUTĖS;5172385044;Taip;9;1;0;10
18608;"Naminukas (Klinikų g. 5)";SAULUTĖS;7772300667;Ne;12;0;0;12
18609;"Naminukas (Klinikų g. 5)";SAULUTĖS;3497829075;Ne;0;0;2;2
18610;"Naminukas (Klinikų g. 5)";SAULUTĖS;6515021073;Ne;18;0;0;18
18611;"Naminukas (Klinikų g. 5)";SAULUTĖS;9894306360;Ne;3;9;0;12
18612;"Naminukas (Klinikų g. 5)";SAULUTĖS;5991261279;Ne;6;0;0;6
18613;"Naminukas (Klinikų g. 5)";SAULUTĖS;9537360943;Ne;7;0;1;8
18614;"Naminukas (Klinikų g. 5)";DRUGELIAI;7033053271;Ne;5;0;0;5
18615;"Naminukas (Klinikų g. 5)";DRUGELIAI;8432194383;Ne;0;2;2;4
18616;"Naminukas (Klinikų g. 5)";DRUGELIAI;9835701381;Ne;1;0;0;1
18617;"Naminukas (Klinikų g. 5)";DRUGELIAI;1092799944;Ne;0;1;0;1
18618;"Naminukas (Klinikų g. 5)";DRUGELIAI;3911352454;Ne;0;0;1;1
18619;"Naminukas (Klinikų g. 5)";DRUGELIAI;7107337857;Ne;8;0;1;9
18620;"Naminukas (Klinikų g. 5)";DRUGELIAI;9212800864;Ne;0;1;0;1
18621;"Naminukas (Klinikų g. 5)";DRUGELIAI;1879925655;Ne;7;0;0;7
18622;"Naminukas (Klinikų g. 5)";DRUGELIAI;2881576194;Ne;0;1;0;1
18623;"Naminukas (Klinikų g. 5)";DRUGELIAI;4836599508;Ne;0;5;0;5
18624;"Naminukas (Klinikų g. 5)";DRUGELIAI;1563213488;Ne;0;0;1;1
18625;"Naminukas (Klinikų g. 5)";DRUGELIAI;4709625816;Ne;0;0;1;1
18626;"Naminukas (Klinikų g. 5)";DRUGELIAI;1932169696;Ne;15;0;0;15
18627;"Naminukas (Klinikų g. 5)";DRUGELIAI;9215327479;Ne;8;0;0;8
18628;"Naminukas (Klinikų g. 5)";BITUTĖS;6592057292;Ne;14;0;0;14
18629;"Naminukas (Klinikų g. 5)";BITUTĖS;5288557629;Ne;3;6;0;9
18630;"Naminukas (Klinikų g. 5)";BITUTĖS;7099787230;Ne;5;0;0;5
18631;"Naminukas (Klinikų g. 5)";BITUTĖS;3088386659;Ne;1;1;0;2
18632;"Naminukas (Klinikų g. 5)";BITUTĖS;3276656641;Ne;4;0;2;6
18633;"Naminukas (Klinikų g. 5)";BITUTĖS;2004615252;Ne;0;0;3;3
18634;"Naminukas (Klinikų g. 5)";BITUTĖS;4116151797;Taip;0;0;1;1
18635;"Naminukas (Klinikų g. 5)";BITUTĖS;2339599448;Ne;4;1;0;5
18636;"Naminukas (Klinikų g. 5)";BITUTĖS;1454039572;Ne;8;0;0;8
18637;"Naminukas (Klinikų g. 5)";BITUTĖS;6949857110;Ne;0;0;1;1
18638;"Naminukas (Klinikų g. 5)";BITUTĖS;8039086094;Ne;4;0;1;5
18639;"Naminukas (Klinikų g. 5)";BITUTĖS;4171789569;Ne;0;5;0;5
18640;"Gervelė (Stadiono g. 5)";BORUŽĖLĖS;2696708010;Ne;4;0;0;4
18641;"Gervelė (Stadiono g. 5)";BORUŽĖLĖS;2136541073;Ne;9;0;0;9
18642;"Gervelė (Stadiono g. 5)";BORUŽĖLĖS;4354544070;Ne;9;0;0;9
18643;"Gervelė (Stadiono g. 5)";BORUŽĖLĖS;3448452820;Ne;12;0;0;12
18644;"Gervelė (Stadiono g. 5)";BORUŽĖLĖS;2794943031;Ne;6;0;1;7
18645;"Gervelė (Stadiono g. 5)";BORUŽĖLĖS;5697289420;Ne;3;0;0;3
18646;"Gervelė (Stadiono g. 5)";BORUŽĖLĖS;8763515382;Ne;12;0;0;12
18647;"Gervelė (Stadiono g. 5)";BORUŽĖLĖS;3516734802;Ne;8;0;0;8
18648;"Gervelė (Stadiono g. 5)";BORUŽĖLĖS;6340371637;Ne;6;0;0;6
18649;"Gervelė (Stadiono g. 5)";BORUŽĖLĖS;9370956691;Ne;3;0;1;4
18650;"Gervelė (Stadiono g. 5)";PAUKŠTELIAI;2892214705;Ne;0;9;0;9
18651;"Gervelė (Stadiono g. 5)";PAUKŠTELIAI;9154032804;Ne;0;8;0;8
18652;"Gervelė (Stadiono g. 5)";PAUKŠTELIAI;7843800194;Ne;1;5;0;6
18653;"Gervelė (Stadiono g. 5)";PAUKŠTELIAI;4588890423;Taip;0;10;0;10
18654;"Gervelė (Stadiono g. 5)";PAUKŠTELIAI;7847393041;Ne;5;12;0;17
18655;"Gervelė (Stadiono g. 5)";PAUKŠTELIAI;6427072260;Ne;1;0;0;1
18656;"Gervelė (Stadiono g. 5)";PAUKŠTELIAI;2622183564;Taip;17;3;0;20
18657;"Gervelė (Stadiono g. 5)";PAUKŠTELIAI;8190190100;Ne;0;1;0;1
18658;"Gervelė (Stadiono g. 5)";PAUKŠTELIAI;2712133300;Ne;0;11;0;11
18659;"Gervelė (Stadiono g. 5)";SPINDULĖLIAI;4051246539;Ne;0;0;1;1
18660;"Gervelė (Stadiono g. 5)";SPINDULĖLIAI;6241611652;Ne;0;8;0;8
18661;"Gervelė (Stadiono g. 5)";SPINDULĖLIAI;1204513844;Ne;2;0;4;6
18662;"Gervelė (Stadiono g. 5)";SPINDULĖLIAI;8710469480;Ne;0;1;0;1
18663;"Gervelė (Stadiono g. 5)";SPINDULĖLIAI;9777308731;Ne;7;0;0;7
18664;"Gervelė (Stadiono g. 5)";SPINDULĖLIAI;6573919007;Ne;3;0;1;4
18665;"Gervelė (Stadiono g. 5)";SPINDULĖLIAI;3567687304;Ne;0;0;4;4
18666;"Gervelė (Stadiono g. 5)";SPINDULĖLIAI;6372245141;Ne;0;0;1;1
18667;"Gervelė (Stadiono g. 5)";SPINDULĖLIAI;5818430690;Taip;5;0;2;7
18668;"Gervelė (Stadiono g. 5)";SPINDULĖLIAI;1515920896;Taip;3;0;1;4
18669;"Gervelė (Stadiono g. 5)";SPINDULĖLIAI;4168864882;Ne;0;0;1;1
18670;"Gervelė (Stadiono g. 5)";SPINDULĖLIAI;5828514911;Ne;9;0;0;9
18671;"Gervelė (Stadiono g. 5)";SPINDULĖLIAI;2031118410;Ne;0;7;0;7
18672;"Gervelė (Stadiono g. 5)";SPINDULĖLIAI;9542729826;Ne;3;0;0;3
18673;"Gervelė (Stadiono g. 5)";GĖLYTĖS;6621769160;Ne;4;0;0;4
18674;"Gervelė (Stadiono g. 5)";GĖLYTĖS;4832348492;Ne;0;0;1;1
18675;"Gervelė (Stadiono g. 5)";GĖLYTĖS;7855598075;Ne;0;6;0;6
18676;"Gervelė (Stadiono g. 5)";GĖLYTĖS;6488139414;Ne;3;0;0;3
18677;"Gervelė (Stadiono g. 5)";GĖLYTĖS;3216423543;Ne;2;0;0;2
18678;"Gervelė (Stadiono g. 5)";GĖLYTĖS;4925983616;Ne;0;0;3;3
18679;"Gervelė (Stadiono g. 5)";GĖLYTĖS;8423813651;Ne;0;0;2;2
18680;"Gervelė (Stadiono g. 5)";GĖLYTĖS;7952102572;Ne;0;0;6;6
18681;"Gervelė (Stadiono g. 5)";GĖLYTĖS;5966215998;Ne;10;0;0;10
18682;"Gervelė (Stadiono g. 5)";GĖLYTĖS;7463376031;Ne;0;8;0;8
18683;"Gervelė (Stadiono g. 5)";GĖLYTĖS;2431435960;Ne;2;0;2;4
18684;"Gervelė (Stadiono g. 5)";GĖLYTĖS;9100411947;Taip;6;0;2;8
18685;"Kūlverstukas (Mindaugo g. 7)";GNOMIKI;1720671485;Ne;0;9;0;9
18686;"Kūlverstukas (Mindaugo g. 7)";GNOMIKI;2501327054;Ne;0;1;0;1
18687;"Kūlverstukas (Mindaugo g. 7)";GNOMIKI;8348978878;Ne;0;7;0;7
18688;"Kūlverstukas (Mindaugo g. 7)";GNOMIKI;8927489885;Ne;5;0;0;5
18689;"Kūlverstukas (Mindaugo g. 7)";GNOMIKI;2709547427;Taip;0;1;0;1
18690;"Kūlverstukas (Mindaugo g. 7)";GNOMIKI;5532063862;Ne;1;0;0;1
18691;"Kūlverstukas (Mindaugo g. 7)";GNOMIKI;5747277587;Ne;0;0;5;5
18692;"Kūlverstukas (Mindaugo g. 7)";GNOMIKI;1166429762;Ne;6;1;0;7
18693;"Kūlverstukas (Mindaugo g. 7)";GNOMIKI;6514730230;Ne;0;2;0;2
18694;"Kūlverstukas (Mindaugo g. 7)";GNOMIKI;3239566139;Ne;0;2;0;2
18695;"Kūlverstukas (Mindaugo g. 7)";GNOMIKI;5260820316;Ne;0;1;0;1
18696;"Kūlverstukas (Mindaugo g. 7)";GNOMIKI;6387540242;Ne;7;0;0;7
18697;"Kūlverstukas (Mindaugo g. 7)";GNOMIKI;3029705994;Ne;0;0;3;3
18698;"Kūlverstukas (Mindaugo g. 7)";GNOMIKI;1869389013;Ne;2;0;0;2
18699;"Kūlverstukas (Mindaugo g. 7)";GNOMIKI;3201081769;Ne;0;0;5;5
18700;"Kūlverstukas (Mindaugo g. 7)";GNOMIKI;2822906102;Ne;5;0;0;5
18701;"Kūlverstukas (Mindaugo g. 7)";GNOMIKI;5879283662;Ne;3;0;1;4
18702;"Kūlverstukas (Mindaugo g. 7)";ZAIČIATA;8994705290;Ne;0;9;0;9
18703;"Kūlverstukas (Mindaugo g. 7)";ZAIČIATA;3660002342;Ne;2;0;0;2
18704;"Kūlverstukas (Mindaugo g. 7)";ZAIČIATA;7883325884;Ne;0;2;0;2
18705;"Kūlverstukas (Mindaugo g. 7)";ZAIČIATA;6621027840;Ne;9;0;0;9
18706;"Kūlverstukas (Mindaugo g. 7)";ZAIČIATA;6872789727;Ne;11;0;0;11
18707;"Kūlverstukas (Mindaugo g. 7)";ZAIČIATA;1229210560;Ne;10;0;0;10
18708;"Kūlverstukas (Mindaugo g. 7)";ZAIČIATA;9596978613;Ne;11;0;0;11
18709;"Kūlverstukas (Mindaugo g. 7)";ZAIČIATA;8841423764;Ne;4;0;0;4
18710;"Kūlverstukas (Mindaugo g. 7)";ZAIČIATA;1443431065;Ne;0;1;0;1
18711;"Kūlverstukas (Mindaugo g. 7)";SVETLIAČKI;2154916232;Ne;0;5;0;5
18712;"Kūlverstukas (Mindaugo g. 7)";SVETLIAČKI;5794471794;Ne;0;0;3;3
18713;"Kūlverstukas (Mindaugo g. 7)";SVETLIAČKI;7829384850;Ne;1;1;0;2
18714;"Kūlverstukas (Mindaugo g. 7)";SVETLIAČKI;3449300504;Ne;0;2;0;2
18715;"Kūlverstukas (Mindaugo g. 7)";SVETLIAČKI;1102996499;Ne;0;1;0;1
18716;"Kūlverstukas (Mindaugo g. 7)";SVETLIAČKI;6311116034;Ne;0;1;0;1
18717;"Kūlverstukas (Mindaugo g. 7)";SVETLIAČKI;1635418112;Ne;0;5;0;5
18718;"Kūlverstukas (Mindaugo g. 7)";SVETLIAČKI;4352034102;Ne;8;0;0;8
18719;"Kūlverstukas (Mindaugo g. 7)";SVETLIAČKI;2434552926;Ne;2;0;0;2
18720;"Kūlverstukas (Mindaugo g. 7)";SVETLIAČKI;2589356040;Ne;6;0;0;6
18721;"Kūlverstukas (Mindaugo g. 7)";SVETLIAČKI;5079635330;Ne;1;0;0;1
18722;"Kūlverstukas (Mindaugo g. 7)";SVETLIAČKI;6319075079;Ne;4;0;0;4
18723;"Kūlverstukas (Mindaugo g. 7)";ZVONOČKI;1486878343;Ne;5;0;1;6
18724;"Kūlverstukas (Mindaugo g. 7)";ZVONOČKI;8835111916;Ne;5;0;0;5
18725;"Kūlverstukas (Mindaugo g. 7)";ZVONOČKI;5724787637;Ne;0;2;0;2
18726;"Kūlverstukas (Mindaugo g. 7)";ZVONOČKI;9835391223;Ne;17;0;0;17
18727;"Kūlverstukas (Mindaugo g. 7)";ZVONOČKI;1566191212;Ne;1;0;1;2
18728;"Kūlverstukas (Mindaugo g. 7)";ZVONOČKI;9569296370;Taip;12;1;0;13
18729;"Kūlverstukas (Mindaugo g. 7)";ZVONOČKI;1047459617;Ne;0;2;0;2
18730;"Kūlverstukas (Mindaugo g. 7)";ZVONOČKI;2091204077;Ne;0;2;0;2
18731;"Kūlverstukas (Mindaugo g. 7)";ZVONOČKI;6463626516;Ne;6;0;3;9
18732;"Kūlverstukas (Mindaugo g. 7)";ZVONOČKI;8814110710;Ne;0;0;1;1
18733;"Kūlverstukas (Mindaugo g. 7)";ZVONOČKI;4152186586;Ne;1;2;0;3
18734;"Kūlverstukas (Mindaugo g. 7)";ZVONOČKI;6680792848;Ne;6;1;0;7
18735;"Kūlverstukas (Mindaugo g. 7)";ZVONOČKI;4424095457;Ne;0;1;0;1
18736;"Kūlverstukas (Mindaugo g. 7)";ZVONOČKI;1808699695;Ne;1;0;3;4
18737;"Kūlverstukas (Mindaugo g. 7)";ZVONOČKI;1646912457;Ne;0;2;0;2
18738;"Kūlverstukas (Mindaugo g. 7)";ZVONOČKI;4116831802;Ne;2;0;0;2
18739;"Kūlverstukas (Mindaugo g. 7)";ZVONOČKI;6219872984;Ne;0;0;8;8
18740;"Kūlverstukas (Mindaugo g. 7)";ZVONOČKI;9098427210;Ne;4;0;1;5
18741;"Kūlverstukas (Mindaugo g. 7)";ZVONOČKI;1916522637;Ne;0;0;2;2
18742;"Vilniaus Pavilnio pagrindinė mokykla";"PRIEŠMOKYKLINĖ RU";6537464526;Ne;6;0;0;6
18743;"Vilniaus Pavilnio pagrindinė mokykla";"PRIEŠMOKYKLINĖ RU";1509519996;Ne;3;0;0;3
18744;"Vilniaus Pavilnio pagrindinė mokykla";"PRIEŠMOKYKLINĖ RU";5706671963;Ne;3;0;0;3
18745;"Vilniaus Pavilnio pagrindinė mokykla";"PRIEŠMOKYKLINĖ RU";1035890284;Ne;2;0;0;2
18746;"Vilniaus Pavilnio pagrindinė mokykla";"PRIEŠMOKYKLINĖ RU";1107633909;Ne;2;0;0;2
18747;"Vilniaus Pavilnio pagrindinė mokykla";"PRIEŠMOKYKLINĖ RU";1344983194;Taip;2;0;0;2
18748;"Vilniaus Pavilnio pagrindinė mokykla";"PRIEŠMOKYKLINĖ RU";8684207189;Ne;0;20;0;20
18749;"Vilniaus Pavilnio pagrindinė mokykla";"PRIEŠMOKYKLINĖ RU";8262619320;Ne;1;0;0;1
18750;"Vilniaus Pavilnio pagrindinė mokykla";"PRIEŠMOKYKLINĖ RU";4516507512;Ne;7;0;0;7
18751;"Vilniaus Pavilnio pagrindinė mokykla";"PRIEŠMOKYKLINĖ PL";9533901360;Ne;1;0;0;1
18752;"Vilniaus Pavilnio pagrindinė mokykla";"PRIEŠMOKYKLINĖ PL";6716558946;Ne;2;0;0;2
18753;"Vilniaus Pavilnio pagrindinė mokykla";"PRIEŠMOKYKLINĖ PL";5760026802;Ne;2;0;0;2
18754;"Lazdynų mokykla (Liudvinavo g.128)";DRUGELIAI;7524849851;Ne;3;2;0;5
18755;"Lazdynų mokykla (Liudvinavo g.128)";DRUGELIAI;8650496265;Ne;10;0;0;10
18756;"Lazdynų mokykla (Liudvinavo g.128)";DRUGELIAI;9309081745;Taip;4;0;0;4
18757;"Lazdynų mokykla (Liudvinavo g.128)";DRUGELIAI;1951041742;Ne;3;0;0;3
18758;"Lazdynų mokykla (Liudvinavo g.128)";DRUGELIAI;2767732459;Ne;0;3;0;3
18759;"Lazdynų mokykla (Liudvinavo g.128)";DRUGELIAI;6394098306;Ne;4;0;0;4
18760;"Lazdynų mokykla (Liudvinavo g.128)";DRUGELIAI;7074859809;Taip;11;2;0;13
18761;"Lazdynų mokykla (Liudvinavo g.128)";DRUGELIAI;4097980299;Ne;0;3;0;3
18762;"Lazdynų mokykla (Liudvinavo g.128)";DRUGELIAI;8001610972;Ne;0;2;0;2
18763;"Lazdynų mokykla (Liudvinavo g.128)";DRUGELIAI;5902104981;Ne;0;3;0;3
18764;"Lazdynų mokykla (Liudvinavo g.128)";DRUGELIAI;7590111138;Ne;0;1;0;1
18765;"Lazdynų mokykla (Liudvinavo g.128)";DRUGELIAI;2027751624;Ne;0;5;0;5
18766;"Lazdynų mokykla (Liudvinavo g.128)";DRUGELIAI;8011040528;Ne;4;0;0;4
18767;"Lazdynų mokykla (Liudvinavo g.128)";DRUGELIAI;5632106043;Ne;6;0;0;6
18768;"Lazdynų mokykla (Liudvinavo g.128)";ZUIKUČIAI;7232402011;Ne;0;1;0;1
18769;"Lazdynų mokykla (Liudvinavo g.128)";ZUIKUČIAI;4166599533;Taip;5;0;0;5
18770;"Lazdynų mokykla (Liudvinavo g.128)";ZUIKUČIAI;3265099747;Ne;7;0;0;7
18771;"Lazdynų mokykla (Liudvinavo g.128)";ZUIKUČIAI;3302443490;Taip;5;0;0;5
18772;"Lazdynų mokykla (Liudvinavo g.128)";ZUIKUČIAI;7000921682;Ne;0;1;0;1
18773;"Lazdynų mokykla (Liudvinavo g.128)";ZUIKUČIAI;3535244441;Ne;5;0;0;5
18774;"Lazdynų mokykla (Liudvinavo g.128)";ZUIKUČIAI;5465094647;Ne;0;4;0;4
18775;"Lazdynų mokykla (Liudvinavo g.128)";ZUIKUČIAI;1044630813;Ne;0;5;0;5
18776;"Lazdynų mokykla (Liudvinavo g.128)";ZUIKUČIAI;7229926614;Ne;4;0;0;4
18777;"Lazdynų mokykla (Liudvinavo g.128)";ZUIKUČIAI;8899186547;Ne;13;0;0;13
18778;"Lazdynų mokykla (Liudvinavo g.128)";ZUIKUČIAI;5181200460;Ne;4;0;0;4
18779;"Lazdynų mokykla (Liudvinavo g.128)";ZUIKUČIAI;9169301469;Ne;4;0;0;4
18780;"Vilniaus Šilo mokykla";Boružėlės;7122041826;Ne;13;0;0;13
18781;"Vilniaus Šilo mokykla";Boružėlės;1196172221;Ne;8;0;0;8
18782;"Vilniaus Šilo mokykla";Boružėlės;1538635985;Ne;8;0;0;8
18783;"Vilniaus Šilo mokykla";Boružėlės;6136087920;Ne;0;20;0;20
18784;"Vilniaus Šilo mokykla";Boružėlės;4544126354;Ne;13;0;0;13
18785;"Vilniaus Šilo mokykla";Boružėlės;8897729962;Ne;9;0;0;9
18786;"Vilniaus Šilo mokykla";"3 spec.";1417978731;Ne;3;0;0;3
18787;"Vilniaus Šilo mokykla";"3 spec.";28814860843;Ne;0;20;0;20
18788;"Vilniaus Šilo mokykla";"3 spec.";63472451321;Ne;0;20;0;20
18789;"Vilniaus Šilo mokykla";"3 spec.";3473596157;Ne;5;0;0;5
18790;"Vilniaus Šilo mokykla";"3 spec.";1475766630;Ne;0;20;0;20
18791;"Vilniaus Šilo mokykla";"3 spec.";1401546788;Ne;2;0;0;2
18792;"Vilniaus Šilo mokykla";"7-10 spec.";9944901942;Ne;3;0;0;3
18793;"Vilniaus Šilo mokykla";"7-10 spec.";3333634089;Ne;0;20;0;20
18794;"Vilniaus Šilo mokykla";"7-10 spec.";8548722736;Ne;1;0;0;1
18795;"Vilniaus Šilo mokykla";"7-10 spec.";5255365063;Ne;2;0;0;2
18796;"Vilniaus Šilo mokykla";"7-10 spec.";6452740859;Ne;5;0;0;5
18797;"Vilniaus Šilo mokykla";"7-10 spec.";4906175269;Ne;1;0;0;1
18798;"Vilniaus Šilo mokykla";"7-10 lav.";92425322676;Ne;5;0;0;5
18799;"Vilniaus Šilo mokykla";"7-10 lav.";81654551230;Ne;5;0;0;5
18800;"Vilniaus Šilo mokykla";"7-10 lav.";6868265902;Ne;0;20;0;20
18801;"Vilniaus Šilo mokykla";"7-10 lav.";2234931428;Ne;0;20;0;20
18802;"Vilniaus Šilo mokykla";"SĮ A";6954467869;Ne;0;20;0;20
18803;"Vilniaus Šilo mokykla";"SĮ A";9354191217;Ne;3;0;0;3
18804;"Vilniaus Šilo mokykla";"SĮ A";9471629029;Ne;12;0;0;12
18805;"Vilniaus Šilo mokykla";"SĮ A";6088433049;Ne;2;0;0;2
18806;"Vilniaus Šilo mokykla";"SĮ A";9845575989;Ne;1;0;0;1
18807;"Vilniaus Šilo mokykla";"SĮ A";3308772529;Ne;1;0;0;1
18808;"Vilniaus Šilo mokykla";"SĮ A";1726056983;Ne;8;0;0;8
18809;"Vilniaus Šilo mokykla";"SĮ A";3442250711;Ne;5;0;0;5
18810;"Vilniaus Šilo mokykla";"SĮ C";8642665550;Ne;1;0;0;1
18811;"Vilniaus Šilo mokykla";"SĮ C";5309862220;Ne;0;20;0;20
18812;"Vilniaus Šilo mokykla";"SĮ C";1010885560;Ne;1;0;0;1
18813;"Vilniaus Šilo mokykla";"SĮ C";2501187241;Ne;3;0;0;3
18814;"Vilniaus Šilo mokykla";"8 spec.";948748525;Ne;12;0;0;12
18815;"Vilniaus Šilo mokykla";"8 spec.";1422218905;Ne;0;20;0;20
18816;"Vilniaus Šilo mokykla";"8 spec.";1177826873;Ne;1;0;0;1
18817;"Vilniaus Šilo mokykla";"8 spec.";3776046409;Ne;1;0;0;1
18818;"Vilniaus Šilo mokykla";"8 spec.";9784624648;Ne;7;0;0;7
18819;"Vilniaus Šilo mokykla";"8 spec.";3621978449;Ne;2;0;0;2
18820;"Vilniaus Šilo mokykla";"8 spec.";5186364504;Ne;0;20;0;20
18821;"Vilniaus Šilo mokykla";"8-10 lav.";2020417997;Ne;2;0;0;2
18822;"Vilniaus Šilo mokykla";"8-10 lav.";8926954085;Ne;1;0;0;1
18823;"Vilniaus Šilo mokykla";"8-10 lav.";8276932013;Ne;2;0;0;2
18824;"Vilniaus Šilo mokykla";"7 lav.";29353956408;Ne;4;0;0;4
18825;"Vilniaus Šilo mokykla";"7 lav.";67989956617;Ne;0;20;0;20
18826;"Vilniaus Šilo mokykla";"7 lav.";7418552136;Ne;15;0;0;15
18827;"Vilniaus Šilo mokykla";"7-8 lav.";4081645294;Ne;2;0;0;2
18828;"Vilniaus Šilo mokykla";"7-8 lav.";1705610089;Ne;0;20;0;20
18829;"Vilniaus Šilo mokykla";"7-8 lav.";62142659591;Ne;1;0;0;1
18830;"Vilniaus Šilo mokykla";"7-8 lav.";8566222716;Ne;8;0;0;8
18831;"Vilniaus Šilo mokykla";"7-8 lav.";7056277395;Ne;0;20;0;20
18832;"Vilniaus Šilo mokykla";"7-8 lav.";6700004229;Ne;3;0;0;3
18833;"Vilniaus Šilo mokykla";"7-8 lav.";50288610995;Ne;2;0;0;2
18834;"Vilniaus Šilo mokykla";"7-8 lav.";4416954354;Ne;4;0;0;4
18835;"Vilniaus Šilo mokykla";"6-9 spec.";4887033681;Ne;5;0;0;5
18836;"Vilniaus Šilo mokykla";"6-9 spec.";61123788986;Ne;0;20;0;20
18837;"Vilniaus Šilo mokykla";"6-9 spec.";2631958308;Ne;1;0;0;1
18838;"Vilniaus Šilo mokykla";"6-9 spec.";6695507703;Ne;2;0;0;2
18839;"Vilniaus Šilo mokykla";"6-9 spec.";6930420609;Ne;4;0;0;4
18840;"Vilniaus Šilo mokykla";"5-10 lav.";88721781220;Ne;1;0;0;1
18841;"Vilniaus Šilo mokykla";"5-10 lav.";9057435844;Ne;1;0;0;1
18842;"Vilniaus Šilo mokykla";"5-10 lav.";7354905114;Ne;1;0;0;1
18843;"Vilniaus Šilo mokykla";"5-6 spec. RU";3419495275;Ne;8;0;0;8
18844;"Vilniaus Šilo mokykla";"5-6 spec. RU";9789373884;Ne;0;20;0;20
18845;"Vilniaus Šilo mokykla";"5-6 spec. RU";1989565075;Ne;0;20;0;20
18846;"Vilniaus Šilo mokykla";"5-6 spec. RU";11529512484;Ne;9;0;0;9
18847;"Vilniaus Šilo mokykla";"5-6 spec. RU";13277011762;Ne;1;0;0;1
18848;"Vilniaus Šilo mokykla";"5-6 lav.";7329254454;Ne;0;20;0;20
18849;"Vilniaus Šilo mokykla";"5-6 lav.";1535004699;Ne;14;0;0;14
18850;"Vilniaus Šilo mokykla";"5-6 lav.";3194974747;Ne;2;0;0;2
18851;"Vilniaus Šilo mokykla";"5-6 lav.";26052502707;Ne;5;0;0;5
18852;"Vilniaus Šilo mokykla";"5-6 lav.";74782962545;Ne;0;20;0;20
18853;"Vilniaus Šilo mokykla";"5-6 lav.";72751441075;Ne;10;0;0;10
18854;"Vilniaus Šilo mokykla";"5-6 lav.";87692349348;Ne;0;20;0;20
18855;"Vilniaus Šilo mokykla";"3-4 spec. LT";5835827997;Ne;0;20;0;20
18856;"Vilniaus Šilo mokykla";"3-4 spec. LT";7418149721;Ne;1;0;0;1
18857;"Vilniaus Šilo mokykla";"3-4 spec. LT";7418149721;Ne;1;0;0;1
18858;"Vilniaus Šilo mokykla";"3-4 spec. LT";3366848846;Ne;1;0;0;1
18859;"Vilniaus Šilo mokykla";"3-4 spec. LT";30738331224;Ne;2;0;0;2
18860;"Vilniaus Šilo mokykla";"1 spec. B";3237698420;Ne;1;0;0;1
18861;"Vilniaus Šilo mokykla";"1 spec. B";1657452686;Ne;3;0;0;3
18862;"Vilniaus Šilo mokykla";"1 spec. B";3055294324;Ne;1;0;0;1
18863;"Vilniaus Šilo mokykla";"1 spec. B";9072764004;Ne;4;0;0;4
18864;"Vilniaus Šilo mokykla";"1 spec. B";1739403100;Ne;0;20;0;20
18865;"Vilniaus Šilo mokykla";"1 spec. B";8500010303;Ne;0;20;0;20
18866;"Vilniaus Šilo mokykla";"1 spec. B";60265156684;Ne;1;0;0;1
18867;"Vilniaus Šilo mokykla";"2-4 spec. RU";4908579339;Ne;8;0;0;8
18868;"Vilniaus Šilo mokykla";"2-4 spec. RU";2401287472;Ne;10;0;0;10
18869;"Vilniaus Šilo mokykla";"2-4 spec. RU";4078721064;Ne;1;0;0;1
18870;"Vilniaus Šilo mokykla";"2-4 spec. RU";4574965127;Ne;2;0;0;2
18871;"Vilniaus Šilo mokykla";"2 spec.";1153167430;Ne;1;0;0;1
18872;"Vilniaus Šilo mokykla";"2 spec.";4438939800;Ne;5;0;0;5
18873;"Vilniaus Šilo mokykla";"2 spec.";1971717759;Ne;1;0;0;1
18874;"Vilniaus Šilo mokykla";"2 spec.";1180183091;Ne;0;20;0;20
18875;"Vilniaus Šilo mokykla";"2 spec.";8863021708;Ne;11;0;0;11
18876;"Vilniaus Šilo mokykla";"3-4 lav. ";3127870635;Ne;2;0;0;2
18877;"Vilniaus Šilo mokykla";"3-4 lav. ";1999375828;Ne;0;20;0;20
18878;"Vilniaus Šilo mokykla";"3-4 lav. ";3748420427;Ne;14;0;0;14
18879;"Vilniaus Šilo mokykla";"1 spec. A";5311183877;Taip;20;0;0;20
18880;"Vilniaus Šilo mokykla";"1 spec. A";1675384533;Ne;7;0;0;7
18881;"Vilniaus Šilo mokykla";"1 spec. A";2070454339;Ne;0;20;0;20
18882;"Vilniaus Šilo mokykla";"1 spec. A";8915901727;Ne;5;0;0;5
18883;"Vilniaus Šilo mokykla";"1 spec. A";7966574791;Ne;1;0;0;1
18884;"Vilniaus Šilo mokykla";"1 spec. A";2048595572;Ne;7;0;0;7
18885;"Vilniaus Šilo mokykla";"1 spec. A";30383556768;Ne;0;20;0;20
18886;"Vilniaus Šilo mokykla";"5-6 spec. ";90363704660;Ne;3;0;0;3
18887;"Vilniaus Šilo mokykla";"5-6 spec. ";2321953405;Ne;3;0;0;3
18888;"Vilniaus Šilo mokykla";"5-6 spec. ";2093680385;Ne;2;0;0;2
18889;"Vilniaus Šilo mokykla";"5-6 spec. ";3352991548;Ne;2;0;0;2
18890;"Vilniaus Šilo mokykla";"5-6 spec. ";1340301492;Taip;7;0;0;7
18891;Malūnėlis;BITUTĖS;1001575740;Ne;2;0;0;2
18892;Malūnėlis;BITUTĖS;8618778205;Ne;9;1;0;10
18893;Malūnėlis;BITUTĖS;3329510128;Ne;2;0;0;2
18894;Malūnėlis;BITUTĖS;5402027714;Ne;0;3;0;3
18895;Malūnėlis;BITUTĖS;6199265600;Ne;0;1;0;1
18896;Malūnėlis;BITUTĖS;7144098762;Ne;12;0;0;12
18897;Malūnėlis;BITUTĖS;9891418762;Taip;0;9;0;9
18898;Malūnėlis;BITUTĖS;8642960989;Ne;0;5;0;5
18899;Malūnėlis;BITUTĖS;5959610426;Taip;4;0;0;4
18900;Malūnėlis;BITUTĖS;4367009696;Ne;0;2;0;2
18901;Malūnėlis;BITUTĖS;9936144392;Ne;1;0;0;1
18902;Malūnėlis;BITUTĖS;8440160819;Ne;0;3;0;3
18903;Malūnėlis;BITUTĖS;1528972517;Ne;0;11;0;11
18904;Malūnėlis;BITUTĖS;4202723476;Taip;5;1;0;6
18905;Malūnėlis;BITUTĖS;3402561453;Ne;0;11;0;11
18906;Malūnėlis;BITUTĖS;6805587761;Ne;20;0;0;20
18907;Malūnėlis;BITUTĖS;2495112045;Ne;6;0;0;6
18908;Malūnėlis;BITUTĖS;4802771311;Ne;5;0;0;5
18909;Malūnėlis;BITUTĖS;3935474148;Ne;0;1;0;1
18910;Malūnėlis;BITUTĖS;8528076375;Ne;3;9;0;12
18911;Malūnėlis;VOVERIUKAI;2192305527;Ne;19;0;0;19
18912;Malūnėlis;VOVERIUKAI;3371260811;Ne;7;0;0;7
18913;Malūnėlis;VOVERIUKAI;5061720786;Ne;6;0;0;6
18914;Malūnėlis;VOVERIUKAI;1770049356;Ne;10;1;0;11
18915;Malūnėlis;VOVERIUKAI;6081634102;Ne;10;0;0;10
18916;Malūnėlis;VOVERIUKAI;5540120728;Ne;4;6;0;10
18917;Malūnėlis;VOVERIUKAI;2525923211;Ne;9;0;0;9
18918;Malūnėlis;VOVERIUKAI;6531364407;Taip;0;1;1;2
18919;Malūnėlis;VOVERIUKAI;5727725132;Ne;4;1;0;5
18920;Malūnėlis;VOVERIUKAI;2637299307;Ne;7;0;1;8
18921;Malūnėlis;VOVERIUKAI;8277245773;Ne;5;5;0;10
18922;Malūnėlis;VOVERIUKAI;5686301875;Taip;1;2;0;3
18923;Malūnėlis;BORUŽĖLĖS;8551271848;Ne;5;0;0;5
18924;Malūnėlis;BORUŽĖLĖS;4787212056;Ne;7;0;0;7
18925;Malūnėlis;BORUŽĖLĖS;9185138453;Ne;11;2;0;13
18926;Malūnėlis;BORUŽĖLĖS;7350160970;Ne;15;1;0;16
18927;Malūnėlis;BORUŽĖLĖS;5722497620;Ne;15;1;0;16
18928;Malūnėlis;BORUŽĖLĖS;3364355098;Ne;4;0;1;5
18929;Malūnėlis;BORUŽĖLĖS;9539119799;Taip;3;1;0;4
18930;Malūnėlis;BORUŽĖLĖS;1523505295;Ne;2;0;0;2
18931;Malūnėlis;BORUŽĖLĖS;7756102926;Ne;2;0;0;2
18932;Malūnėlis;BORUŽĖLĖS;4164843364;Ne;9;0;0;9
18933;Malūnėlis;BORUŽĖLĖS;3504339452;Ne;9;1;0;10
18934;Malūnėlis;BORUŽĖLĖS;5197527972;Ne;8;0;0;8
18935;Malūnėlis;BORUŽĖLĖS;4288943715;Ne;12;0;0;12
18936;Malūnėlis;Skruzdėliukų;9798968369;Ne;2;0;0;2
18937;Malūnėlis;Skruzdėliukų;4859886340;Ne;17;0;0;17
18938;Malūnėlis;Skruzdėliukų;1213476648;Ne;4;0;0;4
18939;Malūnėlis;Skruzdėliukų;9300944734;Ne;7;3;0;10
18940;Malūnėlis;Skruzdėliukų;5474437579;Ne;3;0;0;3
18941;Malūnėlis;Skruzdėliukų;1549241453;Ne;10;0;0;10
18942;Malūnėlis;Skruzdėliukų;5478561852;Taip;1;0;0;1
18943;Malūnėlis;Skruzdėliukų;9207327884;Ne;19;0;0;19
18944;Malūnėlis;Skruzdėliukų;6609446450;Ne;4;0;0;4
18945;Malūnėlis;Skruzdėliukų;5687585794;Ne;1;0;0;1
18946;Malūnėlis;Skruzdėliukų;8076487157;Taip;7;0;0;7
18947;Malūnėlis;Skruzdėliukų;8751365673;Ne;1;0;0;1
18948;Malūnėlis;Skruzdėliukų;6575258889;Taip;5;0;0;5
18949;Malūnėlis;Skruzdėliukų;1003043129;Taip;0;0;1;1
18950;Malūnėlis;Skruzdėliukų;7983537913;Taip;2;0;0;2
18951;Malūnėlis;Skruzdėliukų;9894452403;Ne;0;1;1;2
18952;Malūnėlis;Skruzdėliukų;9342720464;Ne;13;1;0;14
18953;Malūnėlis;Skruzdėliukų;5232728972;Ne;12;0;0;12
18954;Malūnėlis;Skruzdėliukų;2574604828;Ne;0;3;0;3
18955;Malūnėlis;Žirniukų;3791873303;Ne;0;4;0;4
18956;Malūnėlis;Žirniukų;3031849277;Taip;3;0;0;3
18957;Malūnėlis;Žirniukų;6747286787;Ne;0;1;0;1
18958;Malūnėlis;Žirniukų;4539998453;Ne;2;0;0;2
18959;Malūnėlis;Žirniukų;6943968536;Ne;3;0;0;3
18960;Malūnėlis;Žirniukų;4841028952;Ne;13;0;0;13
18961;Malūnėlis;Žirniukų;7097858329;Ne;5;0;0;5
18962;Malūnėlis;Žirniukų;5893575540;Ne;8;0;0;8
18963;Malūnėlis;Žirniukų;2961972215;Ne;9;0;0;9
18964;Malūnėlis;Žirniukų;5622982984;Ne;1;1;0;2
18965;Malūnėlis;Žirniukų;3315571256;Ne;13;1;0;14
18966;Malūnėlis;Žirniukų;3315571256;Ne;13;1;0;14
18967;Malūnėlis;Žirniukų;3315571256;Ne;13;1;0;14
18968;Malūnėlis;Žirniukų;9941335615;Ne;5;0;0;5
18969;Malūnėlis;Žirniukų;3464224841;Ne;3;1;0;4
18970;Malūnėlis;Žirniukų;6047042736;Ne;1;0;0;1
18971;Malūnėlis;Žirniukų;4875859413;Ne;2;0;0;2
18972;Malūnėlis;Žirniukų;9559372808;Taip;3;5;0;8
18973;Malūnėlis;Žirniukų;7740957549;Ne;5;0;0;5
18974;"Dainorėliai (Goštauto g. 4)";PUMPURĖLIAI;6132543858;Ne;10;4;0;14
18975;"Dainorėliai (Goštauto g. 4)";PUMPURĖLIAI;4560328911;Ne;15;1;0;16
18976;"Dainorėliai (Goštauto g. 4)";PUMPURĖLIAI;4435310580;Ne;13;3;0;16
18977;"Dainorėliai (Goštauto g. 4)";PUMPURĖLIAI;7197089520;Ne;16;2;0;18
18978;"Dainorėliai (Goštauto g. 4)";PUMPURĖLIAI;5534783929;Ne;8;0;0;8
18979;"Dainorėliai (Goštauto g. 4)";PUMPURĖLIAI;4826994208;Ne;4;0;0;4
18980;"Dainorėliai (Goštauto g. 4)";PUMPURĖLIAI;4848146301;Ne;3;0;0;3
18981;"Dainorėliai (Goštauto g. 4)";PUMPURĖLIAI;1030872812;Taip;5;1;0;6
18982;"Dainorėliai (Goštauto g. 4)";PUMPURĖLIAI;7986631005;Ne;14;1;0;15
18983;"Dainorėliai (Goštauto g. 4)";PUMPURĖLIAI;6203352124;Ne;10;0;0;10
18984;"Dainorėliai (Goštauto g. 4)";DEBESĖLIŲ;6513417505;Ne;0;4;0;4
18985;"Dainorėliai (Goštauto g. 4)";DEBESĖLIŲ;9285865812;Ne;4;1;0;5
18986;"Dainorėliai (Goštauto g. 4)";DEBESĖLIŲ;6284140548;Taip;0;3;0;3
18987;"Dainorėliai (Goštauto g. 4)";DEBESĖLIŲ;5691833295;Taip;0;5;0;5
18988;"Dainorėliai (Goštauto g. 4)";DEBESĖLIŲ;3561729784;Ne;0;0;1;1
18989;"Dainorėliai (Goštauto g. 4)";DEBESĖLIŲ;4302308605;Ne;0;2;0;2
18990;"Dainorėliai (Goštauto g. 4)";DEBESĖLIŲ;5714565603;Ne;0;2;0;2
18991;"Dainorėliai (Goštauto g. 4)";DEBESĖLIŲ;1233029451;Ne;7;10;0;17
18992;"Dainorėliai (Goštauto g. 4)";DEBESĖLIŲ;6449332338;Ne;0;1;0;1
18993;"Krivūlė (Vokiečių g. 1)";PABIRUČIAI;9011102232;Ne;0;12;0;12
18994;"Krivūlė (Vokiečių g. 1)";PABIRUČIAI;1944288576;Ne;0;0;1;1
18995;"Krivūlė (Vokiečių g. 1)";PABIRUČIAI;3696403149;Taip;14;0;0;14
18996;"Krivūlė (Vokiečių g. 1)";PABIRUČIAI;5721252419;Ne;4;0;0;4
18997;"Krivūlė (Vokiečių g. 1)";PABIRUČIAI;4600688626;Ne;8;0;2;10
18998;"Krivūlė (Vokiečių g. 1)";PABIRUČIAI;7308968772;Ne;8;0;0;8
18999;"Krivūlė (Vokiečių g. 1)";PABIRUČIAI;4884789671;Ne;5;0;5;10
19000;"Krivūlė (Vokiečių g. 1)";PABIRUČIAI;8678565710;Taip;11;0;0;11
19001;"Krivūlė (Vokiečių g. 1)";PABIRUČIAI;3976974038;Ne;0;0;1;1
19002;"Krivūlė (Vokiečių g. 1)";PABIRUČIAI;2259139771;Ne;10;0;0;10
19003;"Krivūlė (Vokiečių g. 1)";PABIRUČIAI;3138555448;Ne;7;11;0;18
19004;"Krivūlė (Vokiečių g. 1)";PABIRUČIAI;3227555647;Ne;0;0;4;4
19005;"Krivūlė (Vokiečių g. 1)";PABIRUČIAI;4261770381;Ne;9;0;2;11
19006;"Krivūlė (Vokiečių g. 1)";PABIRUČIAI;6632875947;Ne;5;0;0;5
19007;"Krivūlė (Vokiečių g. 1)";PABIRUČIAI;6422534805;Ne;3;0;0;3
19008;"Krivūlė (Vokiečių g. 1)";PABIRUČIAI;3209201717;Ne;12;0;0;12
19009;"Krivūlė (Vokiečių g. 1)";SMALSUČIAI;5304221329;Ne;0;0;5;5
19010;"Krivūlė (Vokiečių g. 1)";SMALSUČIAI;7508079584;Ne;0;0;1;1
19011;"Krivūlė (Vokiečių g. 1)";SMALSUČIAI;4814488445;Ne;5;0;0;5
19012;"Krivūlė (Vokiečių g. 1)";SMALSUČIAI;7997564406;Ne;0;4;0;4
19013;"Krivūlė (Vokiečių g. 1)";SMALSUČIAI;8710938907;Ne;3;0;2;5
19014;"Krivūlė (Vokiečių g. 1)";SMALSUČIAI;4491462086;Taip;14;0;1;15
19015;"Krivūlė (Vokiečių g. 1)";SMALSUČIAI;4773564048;Taip;0;0;3;3
19016;"Krivūlė (Vokiečių g. 1)";SMALSUČIAI;3324090723;Ne;4;0;0;4
19017;"Krivūlė (Vokiečių g. 1)";SMALSUČIAI;8042469720;Ne;0;1;0;1
19018;"Krivūlė (Vokiečių g. 1)";SMALSUČIAI;4845066055;Ne;20;0;0;20
19019;"Krivūlė (Vokiečių g. 1)";SMALSUČIAI;9328365491;Ne;5;0;1;6
19020;"Krivūlė (Vokiečių g. 1)";SMALSUČIAI;7528273082;Ne;5;0;0;5
19021;"Krivūlė (Vokiečių g. 1)";SMALSUČIAI;6521798502;Ne;5;0;0;5
19022;"Krivūlė (Vokiečių g. 1)";SMALSUČIAI;5790418638;Ne;0;0;2;2
19023;"Krivūlė (Vokiečių g. 1)";SMALSUČIAI;1851097789;Ne;11;0;0;11
19024;"Krivūlė (Vokiečių g. 1)";GUDRUČIAI;8520470321;Ne;0;12;2;14
19025;"Krivūlė (Vokiečių g. 1)";GUDRUČIAI;5753204752;Ne;0;0;1;1
19026;"Krivūlė (Vokiečių g. 1)";GUDRUČIAI;2536472220;Ne;0;0;2;2
19027;"Krivūlė (Vokiečių g. 1)";GUDRUČIAI;7436569684;Ne;5;0;1;6
19028;"Krivūlė (Vokiečių g. 1)";GUDRUČIAI;6072261879;Ne;7;0;1;8
19029;"Krivūlė (Vokiečių g. 1)";GUDRUČIAI;6931566125;Ne;4;0;0;4
19030;"Krivūlė (Vokiečių g. 1)";GUDRUČIAI;5149419581;Ne;0;0;6;6
19031;"Krivūlė (Vokiečių g. 1)";GUDRUČIAI;7789605738;Ne;7;0;0;7
19032;"Krivūlė (Vokiečių g. 1)";GUDRUČIAI;9693693101;Ne;7;0;1;8
19033;"Krivūlė (Vokiečių g. 1)";GUDRUČIAI;5462491857;Ne;0;2;0;2
19034;"Krivūlė (Vokiečių g. 1)";GUDRUČIAI;8871794542;Ne;3;0;0;3
19035;"Krivūlė (Vokiečių g. 1)";GUDRUČIAI;3076382863;Ne;0;0;4;4
19036;"Krivūlė (Vokiečių g. 1)";GUDRUČIAI;5199600243;Ne;0;0;2;2
19037;"Pumpurėlis (Trinapolio g. 11)";GUDRUČIAI;9353403057;Ne;5;0;0;5
19038;"Pumpurėlis (Trinapolio g. 11)";GUDRUČIAI;9353403057;Ne;5;0;0;5
19039;"Pumpurėlis (Trinapolio g. 11)";GUDRUČIAI;5187890514;Ne;9;0;0;9
19040;"Pumpurėlis (Trinapolio g. 11)";GUDRUČIAI;3387386473;Ne;4;5;0;9
19041;"Pumpurėlis (Trinapolio g. 11)";GUDRUČIAI;7177681927;Taip;5;0;1;6
19042;"Pumpurėlis (Trinapolio g. 11)";GUDRUČIAI;2130008026;Ne;13;0;0;13
19043;"Pumpurėlis (Trinapolio g. 11)";GUDRUČIAI;8475215020;Ne;0;1;0;1
19044;"Pumpurėlis (Trinapolio g. 11)";GUDRUČIAI;3333547914;Taip;15;0;2;17
19045;"Pumpurėlis (Trinapolio g. 11)";GUDRUČIAI;9550967420;Ne;7;7;0;14
19046;"Pumpurėlis (Trinapolio g. 11)";GUDRUČIAI;1750311606;Ne;0;0;3;3
19047;"Pumpurėlis (Trinapolio g. 11)";GUDRUČIAI;8134060801;Ne;0;20;0;20
19048;"Pumpurėlis (Trinapolio g. 11)";GUDRUČIAI;1682281017;Ne;11;0;0;11
19049;"Pumpurėlis (Trinapolio g. 11)";GUDRUČIAI;9154835447;Ne;1;0;2;3
19050;"Pumpurėlis (Trinapolio g. 11)";GUDRUČIAI;3546444707;Ne;5;0;1;6
19051;"Pumpurėlis (Trinapolio g. 11)";GUDRUČIAI;2071687578;Ne;1;0;2;3
19052;"Pumpurėlis (Trinapolio g. 11)";GUDRUČIAI;8090926450;Ne;5;3;0;8
19053;"Pumpurėlis (Trinapolio g. 11)";GUDRUČIAI;6459621192;Ne;0;0;5;5
19054;"Pumpurėlis (Trinapolio g. 11)";GUDRUČIAI;6766514486;Taip;2;0;1;3
19055;"Pumpurėlis (Trinapolio g. 11)";PABIRUČIAI;9824315755;Ne;5;2;0;7
19056;"Pumpurėlis (Trinapolio g. 11)";PABIRUČIAI;4565317498;Ne;3;0;1;4
19057;"Pumpurėlis (Trinapolio g. 11)";PABIRUČIAI;7910361194;Ne;10;5;0;15
19058;"Pumpurėlis (Trinapolio g. 11)";PABIRUČIAI;5249717804;Ne;14;0;0;14
19059;"Pumpurėlis (Trinapolio g. 11)";PABIRUČIAI;5403012236;Ne;0;5;0;5
19060;"Pumpurėlis (Trinapolio g. 11)";PABIRUČIAI;4955734206;Ne;5;0;0;5
19061;"Pumpurėlis (Trinapolio g. 11)";PABIRUČIAI;8704865319;Ne;13;1;0;14
19062;"Pumpurėlis (Trinapolio g. 11)";PABIRUČIAI;8207951541;Ne;1;0;0;1
19063;"Pumpurėlis (Trinapolio g. 11)";PABIRUČIAI;4696006714;Taip;2;0;0;2
19064;"Pumpurėlis (Trinapolio g. 11)";PABIRUČIAI;2187090934;Ne;3;0;0;3
19065;"Pumpurėlis (Trinapolio g. 11)";PABIRUČIAI;1222204689;Taip;4;6;0;10
19066;"Pumpurėlis (Trinapolio g. 11)";PABIRUČIAI;6920353753;Taip;9;6;0;15
19067;"Pumpurėlis (Trinapolio g. 11)";PABIRUČIAI;6920353753;Taip;9;6;0;15
19068;"Pumpurėlis (Trinapolio g. 11)";PABIRUČIAI;3841134563;Ne;5;0;0;5
19069;"Pumpurėlis (Trinapolio g. 11)";PABIRUČIAI;3841134563;Ne;5;0;0;5
19070;"Pumpurėlis (Trinapolio g. 11)";PABIRUČIAI;3841134563;Ne;5;0;0;5
19071;"Pumpurėlis (Trinapolio g. 11)";PABIRUČIAI;6732130591;Ne;6;0;0;6
19072;"Pumpurėlis (Trinapolio g. 11)";PABIRUČIAI;7145050820;Ne;5;0;1;6
19073;"Pumpurėlis (Trinapolio g. 11)";PABIRUČIAI;3464806589;Ne;13;0;0;13
19074;"Pumpurėlis (Trinapolio g. 11)";PABIRUČIAI;9012133443;Ne;5;0;0;5
19075;"Pumpurėlis (Trinapolio g. 11)";PABIRUČIAI;5703275497;Ne;5;0;0;5
19076;"Pumpurėlis (Trinapolio g. 11)";PABIRUČIAI;7199184901;Ne;5;0;0;5
19077;"Gilužis (Įsruties g. 30)";AITVARIUKŲ;3612834040;Taip;6;0;2;8
19078;"Gilužis (Įsruties g. 30)";AITVARIUKŲ;6279641042;Ne;1;0;0;1
19079;"Gilužis (Įsruties g. 30)";AITVARIUKŲ;2971604057;Ne;0;3;0;3
19080;"Gilužis (Įsruties g. 30)";AITVARIUKŲ;6430615720;Ne;9;1;0;10
19081;"Gilužis (Įsruties g. 30)";AITVARIUKŲ;4351997862;Ne;9;1;0;10
19082;"Gilužis (Įsruties g. 30)";AITVARIUKŲ;2094662680;Ne;16;2;0;18
19083;"Gilužis (Įsruties g. 30)";AITVARIUKŲ;6020457766;Ne;6;0;1;7
19084;"Gilužis (Įsruties g. 30)";AITVARIUKŲ;1766021430;Ne;11;0;0;11
19085;"Gilužis (Įsruties g. 30)";AITVARIUKŲ;2401999477;Ne;16;0;0;16
19086;"Gilužis (Įsruties g. 30)";AITVARIUKŲ;8268273217;Ne;10;0;0;10
19087;"Gilužis (Įsruties g. 30)";AITVARIUKŲ;8412189871;Ne;0;0;1;1
19088;"Gilužis (Įsruties g. 30)";AITVARIUKŲ;9434214933;Taip;11;0;0;11
19089;"Gilužis (Įsruties g. 30)";AITVARIUKŲ;4731369089;Ne;10;0;0;10
19090;"Gilužis (Įsruties g. 30)";AITVARIUKŲ;2614683353;Ne;8;12;0;20
19091;"Gilužis (Įsruties g. 30)";AITVARIUKŲ;2657805562;Ne;9;0;0;9
19092;"Gilužis (Įsruties g. 30)";AITVARIUKŲ;6713383000;Ne;9;0;0;9
19093;"Gilužis (Įsruties g. 30)";SPINDULIUKŲ;8951766269;Taip;7;0;1;8
19094;"Gilužis (Įsruties g. 30)";SPINDULIUKŲ;8712363813;Ne;9;0;0;9
19095;"Gilužis (Įsruties g. 30)";SPINDULIUKŲ;8499650174;Ne;14;0;0;14
19096;"Gilužis (Įsruties g. 30)";SPINDULIUKŲ;4939683067;Ne;10;0;0;10
19097;"Gilužis (Įsruties g. 30)";SPINDULIUKŲ;4483309790;Ne;5;0;0;5
19098;"Gilužis (Įsruties g. 30)";SPINDULIUKŲ;7513403761;Ne;17;0;0;17
19099;"Gilužis (Įsruties g. 30)";SPINDULIUKŲ;8587454386;Ne;6;0;0;6
19100;"Gilužis (Įsruties g. 30)";SPINDULIUKŲ;6582408024;Ne;2;0;1;3
19101;"Gilužis (Įsruties g. 30)";SPINDULIUKŲ;7606952525;Ne;7;0;0;7
19102;"Gilužis (Įsruties g. 30)";SPINDULIUKŲ;8238801880;Ne;5;0;0;5
19103;"Gilužis (Įsruties g. 30)";SPINDULIUKŲ;7924726810;Ne;5;0;0;5
19104;"Gilužis (Įsruties g. 30)";SPINDULIUKŲ;5971465705;Ne;20;0;0;20
19105;"Gilužis (Įsruties g. 30)";SPINDULIUKŲ;9352644751;Ne;13;0;0;13
19106;"Gilužis (Įsruties g. 30)";SPINDULIUKŲ;9689776829;Ne;0;0;5;5
19107;"Gilužis (Įsruties g. 30)";SPINDULIUKŲ;9807489364;Ne;15;0;0;15
19108;"Gilužis (Įsruties g. 30)";ŽIRNIUKŲ;1660797528;Ne;3;0;1;4
19109;"Gilužis (Įsruties g. 30)";ŽIRNIUKŲ;1584356386;Ne;6;0;1;7
19110;"Gilužis (Įsruties g. 30)";ŽIRNIUKŲ;8845494720;Ne;11;0;0;11
19111;"Gilužis (Įsruties g. 30)";ŽIRNIUKŲ;3355341868;Ne;13;0;0;13
19112;"Gilužis (Įsruties g. 30)";ŽIRNIUKŲ;1710906417;Ne;5;0;0;5
19113;"Gilužis (Įsruties g. 30)";ŽIRNIUKŲ;2831924292;Ne;13;0;0;13
19114;"Gilužis (Įsruties g. 30)";ŽIRNIUKŲ;3250662431;Ne;2;1;4;7
19115;"Gilužis (Įsruties g. 30)";ŽIRNIUKŲ;8078194153;Ne;6;0;0;6
19116;"Gilužis (Įsruties g. 30)";ŽIRNIUKŲ;3224917490;Ne;11;0;0;11
19117;"Gilužis (Įsruties g. 30)";ŽIRNIUKŲ;3272561030;Ne;9;0;0;9
19118;"Gilužis (Įsruties g. 30)";ŽIRNIUKŲ;7620828905;Ne;3;0;1;4
19119;"Gilužis (Įsruties g. 30)";ŽIRNIUKŲ;3504412599;Ne;12;0;0;12
19120;"Pilaitukas (Įsruties g. 27)";ŠNEKUČIAI;5118977299;Ne;1;0;0;1
19121;"Pilaitukas (Įsruties g. 27)";ŠNEKUČIAI;9940643503;Taip;5;0;0;5
19122;"Pilaitukas (Įsruties g. 27)";ŠNEKUČIAI;1445759374;Taip;3;0;0;3
19123;"Pilaitukas (Įsruties g. 27)";ŠNEKUČIAI;1859101624;Taip;1;0;0;1
19124;"Pilaitukas (Įsruties g. 27)";ŠNEKUČIAI;8479229073;Ne;3;0;0;3
19125;"Pilaitukas (Įsruties g. 27)";ŠNEKUČIAI;9731380502;Ne;3;0;0;3
19126;"Pilaitukas (Įsruties g. 27)";ŠNEKUČIAI;7224121082;Ne;8;0;0;8
19127;"Pilaitukas (Įsruties g. 27)";ŠNEKUČIAI;8801482035;Ne;7;0;0;7
19128;"Pilaitukas (Įsruties g. 27)";ŠNEKUČIAI;9622989196;Ne;7;0;0;7
19129;"Pilaitukas (Įsruties g. 27)";ŠNEKUČIAI;1356473379;Ne;0;20;0;20
19130;"Pilaitukas (Įsruties g. 27)";ŠNEKUČIAI;2883122532;Ne;2;0;0;2
19131;"Pilaitukas (Įsruties g. 27)";ŠNEKUČIAI;2883122532;Ne;2;0;0;2
19132;"Pilaitukas (Įsruties g. 27)";ŠNEKUČIAI;2883122532;Ne;2;0;0;2
19133;"Pilaitukas (Įsruties g. 27)";ŠNEKUČIAI;2939090118;Ne;1;0;0;1
19134;"Pilaitukas (Įsruties g. 27)";ŠNEKUČIAI;6092611227;Taip;6;0;0;6
19135;"Pilaitukas (Įsruties g. 27)";ŠNEKUČIAI;4567479900;Ne;13;0;0;13
19136;"Pilaitukas (Įsruties g. 27)";ŠNEKUČIAI;3653807287;Ne;1;0;0;1
19137;"Pilaitukas (Įsruties g. 27)";SMALSUČIAI;1974429718;Ne;13;0;0;13
19138;"Pilaitukas (Įsruties g. 27)";SMALSUČIAI;4544849086;Ne;11;0;0;11
19139;"Pilaitukas (Įsruties g. 27)";SMALSUČIAI;6496708020;Taip;7;0;0;7
19140;"Pilaitukas (Įsruties g. 27)";SMALSUČIAI;4608105047;Ne;16;0;0;16
19141;"Pilaitukas (Įsruties g. 27)";SMALSUČIAI;8698639192;Ne;5;0;1;6
19142;"Pilaitukas (Įsruties g. 27)";SMALSUČIAI;4898803794;Ne;3;0;0;3
19143;"Pilaitukas (Įsruties g. 27)";SMALSUČIAI;3544734838;Taip;1;1;0;2
19144;"Pilaitukas (Įsruties g. 27)";SMALSUČIAI;7034013577;Ne;4;0;0;4
19145;"Pilaitukas (Įsruties g. 27)";SMALSUČIAI;1793393776;Taip;3;1;3;7
19146;"Pilaitukas (Įsruties g. 27)";SMALSUČIAI;2210253038;Taip;9;0;0;9
19147;"Pilaitukas (Įsruties g. 27)";SMALSUČIAI;5490465905;Ne;0;1;0;1
19148;"Pilaitukas (Įsruties g. 27)";SMALSUČIAI;8787181006;Ne;0;1;0;1
19149;"Pilaitukas (Įsruties g. 27)";" GUDRUČIAI";3068325053;Ne;7;0;0;7
19150;"Pilaitukas (Įsruties g. 27)";" GUDRUČIAI";1571691020;Ne;7;0;0;7
19151;"Pilaitukas (Įsruties g. 27)";" GUDRUČIAI";9186679454;Ne;0;0;1;1
19152;"Pilaitukas (Įsruties g. 27)";" GUDRUČIAI";3621245783;Ne;7;0;1;8
19153;"Pilaitukas (Įsruties g. 27)";" GUDRUČIAI";3927118900;Ne;1;0;1;2
19154;"Pilaitukas (Įsruties g. 27)";" GUDRUČIAI";5464065587;Ne;0;1;0;1
19155;"Pilaitukas (Įsruties g. 27)";" GUDRUČIAI";6844500395;Ne;0;1;0;1
19156;"Pilaitukas (Įsruties g. 27)";" GUDRUČIAI";5440233814;Ne;0;7;0;7
19157;"Pilaitukas (Įsruties g. 27)";" GUDRUČIAI";4810825253;Ne;3;0;0;3
19158;"Pilaitukas (Įsruties g. 27)";" GUDRUČIAI";3395656390;Ne;0;0;1;1
19159;"Pilaitukas (Įsruties g. 27)";" GUDRUČIAI";9774222130;Ne;1;0;2;3
19160;"Pilaitukas (Įsruties g. 27)";" GUDRUČIAI";7568744500;Ne;2;0;0;2
19161;"Pilaitukas (Įsruties g. 27)";" GUDRUČIAI";5407354218;Ne;0;4;0;4
19162;"Pilaitukas (Įsruties g. 27)";" GUDRUČIAI";5326258755;Ne;0;1;0;1
