Nr.;"Darželio pavadinimas";"Grupės pavadinimas";"Vaiko Identifikacinis Nr.";"Deklaruotas mieste";"Pateisintos dėl ligos";"Pateisintos dėl kitų priežasčių";"Nepateisintos dienos";"Praleistos dienos Viso"
1;Aitvaras;"VIJURKAI (ALERG.)";6214880713;Ne;0;1;0;1
2;Aitvaras;"VIJURKAI (ALERG.)";2566375128;Ne;0;1;0;1
3;Aitvaras;"VIJURKAI (ALERG.)";1879540041;Ne;0;11;0;11
4;Aitvaras;"VIJURKAI (ALERG.)";1532588441;Ne;0;2;0;2
5;Aitvaras;"VIJURKAI (ALERG.)";8206046301;Ne;3;1;2;6
6;Aitvaras;"VIJURKAI (ALERG.)";1347364985;Ne;0;2;0;2
7;Aitvaras;"VIJURKAI (ALERG.)";9157794193;Ne;1;3;2;6
8;Aitvaras;"VIJURKAI (ALERG.)";9562494357;Ne;0;3;0;3
9;Aitvaras;"VIJURKAI (ALERG.)";6021342178;Ne;0;2;0;2
10;Aitvaras;"VIJURKAI (ALERG.)";2650483861;Ne;0;3;0;3
11;Aitvaras;"VIJURKAI (ALERG.)";2601983670;Ne;0;4;0;4
12;Aitvaras;"VIJURKAI (ALERG.)";2895663259;Ne;2;0;2;4
13;Aitvaras;"VIJURKAI (ALERG.)";3570820823;Ne;0;2;0;2
14;Aitvaras;"VIJURKAI (ALERG.)";6444377924;Ne;0;22;0;22
15;Aitvaras;"VIJURKAI (ALERG.)";9807784148;Ne;4;0;2;6
16;Aitvaras;"VIJURKAI (ALERG.)";8641433486;Ne;4;2;2;8
17;Aitvaras;"VIJURKAI (ALERG.)";5619137905;Ne;0;2;0;2
18;Aitvaras;"SMALSUČIAI (ALERG.)";7109001184;Ne;0;2;1;3
19;Aitvaras;"SMALSUČIAI (ALERG.)";4114397590;Ne;3;3;2;8
20;Aitvaras;"SMALSUČIAI (ALERG.)";2357399981;Ne;5;0;2;7
21;Aitvaras;"SMALSUČIAI (ALERG.)";2760970218;Ne;0;1;0;1
22;Aitvaras;"SMALSUČIAI (ALERG.)";8666824607;Ne;0;5;0;5
23;Aitvaras;"SMALSUČIAI (ALERG.)";5378212904;Ne;5;3;2;10
24;Aitvaras;"SMALSUČIAI (ALERG.)";5238819066;Ne;1;0;2;3
25;Aitvaras;"SMALSUČIAI (ALERG.)";4564723798;Ne;0;0;2;2
26;Aitvaras;"SMALSUČIAI (ALERG.)";4176681907;Ne;3;5;2;10
27;Aitvaras;"SMALSUČIAI (ALERG.)";3655710511;Ne;0;2;0;2
28;Aitvaras;"SMALSUČIAI (ALERG.)";7260577885;Ne;0;3;0;3
29;Aitvaras;"SMALSUČIAI (ALERG.)";5612991255;Ne;0;3;0;3
30;Aitvaras;"SMALSUČIAI (ALERG.)";4120515569;Ne;1;7;2;10
31;Aitvaras;"SMALSUČIAI (ALERG.)";4612994715;Ne;1;2;3;6
32;Aitvaras;"SMALSUČIAI (ALERG.)";9885781306;Ne;0;2;0;2
33;Aitvaras;"SMALSUČIAI (ALERG.)";1091372798;Ne;3;4;3;10
34;Aitvaras;"SMALSUČIAI (ALERG.)";1115202169;Ne;2;1;2;5
35;Aitvaras;"SMALSUČIAI (ALERG.)";1599183050;Ne;0;0;1;1
36;Aitvaras;"SMALSUČIAI (ALERG.)";2821221241;Ne;5;2;2;9
37;Aitvaras;PADAUŽIUKAI;8065540507;Ne;20;0;2;22
38;Aitvaras;PADAUŽIUKAI;2328771385;Ne;0;14;0;14
39;Aitvaras;PADAUŽIUKAI;1288810999;Ne;10;0;2;12
40;Aitvaras;PADAUŽIUKAI;6501943902;Ne;13;2;2;17
41;Aitvaras;PADAUŽIUKAI;3101015381;Ne;5;3;2;10
42;Aitvaras;PADAUŽIUKAI;4350590529;Ne;0;4;0;4
43;Aitvaras;PADAUŽIUKAI;7777235021;Ne;4;3;4;11
44;Aitvaras;PADAUŽIUKAI;5641224483;Ne;0;3;0;3
45;Aitvaras;PADAUŽIUKAI;6214572150;Ne;9;0;2;11
46;Aitvaras;PADAUŽIUKAI;1830134108;Ne;2;1;4;7
47;Aitvaras;PADAUŽIUKAI;3178965623;Ne;0;3;0;3
48;Aitvaras;PADAUŽIUKAI;5905456814;Ne;0;2;0;2
49;Aitvaras;PADAUŽIUKAI;1761446849;Ne;10;0;4;14
50;Aitvaras;PADAUŽIUKAI;6739827530;Ne;3;2;2;7
51;Aitvaras;PADAUŽIUKAI;3735941659;Ne;10;0;3;13
52;Aitvaras;PADAUŽIUKAI;3323458595;Ne;0;2;0;2
53;Aitvaras;PADAUŽIUKAI;2807595769;Ne;8;3;2;13
54;Aitvaras;PADAUŽIUKAI;8360380303;Ne;0;6;0;6
55;Aitvaras;PADAUŽIUKAI;1252145346;Ne;10;0;2;12
56;Aitvaras;PADAUŽIUKAI;8439586875;Ne;0;2;0;2
57;Aitvaras;PADAUŽIUKAI;1594675221;Ne;6;0;4;10
58;Aitvaras;"AITVARIUKAI (ALERG.)";3639102842;Ne;0;6;0;6
59;Aitvaras;"AITVARIUKAI (ALERG.)";7243387750;Ne;8;0;2;10
60;Aitvaras;"AITVARIUKAI (ALERG.)";6587437949;Ne;0;6;0;6
61;Aitvaras;"AITVARIUKAI (ALERG.)";7461284958;Ne;0;5;0;5
62;Aitvaras;"AITVARIUKAI (ALERG.)";3394251305;Ne;0;4;0;4
63;Aitvaras;"AITVARIUKAI (ALERG.)";5635576679;Ne;0;6;0;6
64;Aitvaras;"AITVARIUKAI (ALERG.)";7988247429;Ne;2;2;3;7
65;Aitvaras;"AITVARIUKAI (ALERG.)";8770777328;Ne;0;2;0;2
66;Aitvaras;"AITVARIUKAI (ALERG.)";3653879553;Ne;3;4;2;9
67;Aitvaras;"AITVARIUKAI (ALERG.)";9721273154;Ne;10;0;2;12
68;Aitvaras;"AITVARIUKAI (ALERG.)";8543644000;Ne;6;1;2;9
69;Aitvaras;"AITVARIUKAI (ALERG.)";1859647003;Ne;0;0;2;2
70;Aitvaras;"AITVARIUKAI (ALERG.)";4204923580;Ne;7;0;2;9
71;Aitvaras;"AITVARIUKAI (ALERG.)";4777266938;Ne;12;4;2;18
72;Aitvaras;"AITVARIUKAI (ALERG.)";7568388141;Taip;0;8;0;8
73;Aitvaras;"AITVARIUKAI (ALERG.)";3954840915;Ne;0;2;0;2
74;Aitvaras;"AITVARIUKAI (ALERG.)";2146963673;Ne;0;7;0;7
75;Aitvaras;"AITVARIUKAI (ALERG.)";9763502346;Ne;7;4;2;13
76;Aitvaras;"AITVARIUKAI (ALERG.)";3775634117;Ne;3;0;2;5
77;Aitvaras;"AITVARIUKAI (ALERG.)";2615576367;Ne;8;7;2;17
78;Aitvaras;"SAULĖS ZUIKUČIAI  (ALERG.)";5711324951;Ne;0;1;0;1
79;Aitvaras;"SAULĖS ZUIKUČIAI  (ALERG.)";4106097701;Ne;0;3;0;3
80;Aitvaras;"SAULĖS ZUIKUČIAI  (ALERG.)";2184231202;Ne;0;1;0;1
81;Aitvaras;"SAULĖS ZUIKUČIAI  (ALERG.)";2478737835;Ne;0;0;2;2
82;Aitvaras;"SAULĖS ZUIKUČIAI  (ALERG.)";1136438927;Ne;0;5;0;5
83;Aitvaras;"SAULĖS ZUIKUČIAI  (ALERG.)";8137900398;Ne;0;3;0;3
84;Aitvaras;"SAULĖS ZUIKUČIAI  (ALERG.)";9147954612;Ne;4;0;4;8
85;Aitvaras;"SAULĖS ZUIKUČIAI  (ALERG.)";2511844613;Ne;12;1;2;15
86;Aitvaras;"SAULĖS ZUIKUČIAI  (ALERG.)";7907357058;Ne;8;0;2;10
87;Aitvaras;"SAULĖS ZUIKUČIAI  (ALERG.)";9534206000;Ne;2;0;4;6
88;Aitvaras;"SAULĖS ZUIKUČIAI  (ALERG.)";3737054758;Ne;3;2;2;7
89;Aitvaras;"SAULĖS ZUIKUČIAI  (ALERG.)";4646876966;Ne;0;3;0;3
90;Aitvaras;"SAULĖS ZUIKUČIAI  (ALERG.)";9271534775;Ne;8;0;2;10
91;Aitvaras;"SAULĖS ZUIKUČIAI  (ALERG.)";8849563638;Ne;0;3;0;3
92;Aitvaras;"SAULĖS ZUIKUČIAI  (ALERG.)";6950820937;Ne;5;0;5;10
93;Aitvaras;"SAULĖS ZUIKUČIAI  (ALERG.)";5252728205;Ne;8;0;2;10
94;Aitvaras;"SAULĖS ZUIKUČIAI  (ALERG.)";2744696131;Ne;0;5;0;5
95;Aitvaras;"SAULĖS ZUIKUČIAI  (ALERG.)";2373509019;Ne;4;2;2;8
96;Aitvaras;"SAULĖS ZUIKUČIAI  (ALERG.)";2624566766;Ne;10;0;3;13
97;Aitvaras;"SAULĖS ZUIKUČIAI  (ALERG.)";3677551059;Ne;0;2;0;2
98;Aitvaras;"SAULĖS ZUIKUČIAI  (ALERG.)";2547934790;Ne;8;2;2;12
99;Aitvaras;"ŽEMYNUKAI (ALERG.)";6218019092;Ne;3;0;2;5
100;Aitvaras;"ŽEMYNUKAI (ALERG.)";7560642918;Ne;2;0;2;4
101;Aitvaras;"ŽEMYNUKAI (ALERG.)";3820930777;Ne;8;13;2;23
102;Aitvaras;"ŽEMYNUKAI (ALERG.)";6624986090;Ne;7;0;6;13
103;Aitvaras;"ŽEMYNUKAI (ALERG.)";4733627644;Ne;5;5;12;22
104;Aitvaras;"ŽEMYNUKAI (ALERG.)";3104109370;Ne;0;1;1;2
105;Aitvaras;"ŽEMYNUKAI (ALERG.)";7853714142;Ne;15;0;6;21
106;Aitvaras;"ŽEMYNUKAI (ALERG.)";1949144346;Ne;0;4;0;4
107;Aitvaras;"ŽEMYNUKAI (ALERG.)";3961423273;Ne;0;4;0;4
108;Aitvaras;"ŽEMYNUKAI (ALERG.)";9947610763;Ne;3;2;2;7
109;Aitvaras;"ŽEMYNUKAI (ALERG.)";7113016866;Ne;8;12;2;22
110;Aitvaras;"ŽEMYNUKAI (ALERG.)";4377666052;Ne;4;8;3;15
111;Aitvaras;"ŽEMYNUKAI (ALERG.)";8333823078;Ne;5;3;2;10
112;Aitvaras;"ŽEMYNUKAI (ALERG.)";5623106419;Ne;4;0;4;8
113;Aitvaras;"ŽEMYNUKAI (ALERG.)";5351333397;Ne;0;12;0;12
114;Aitvaras;"ŽEMYNUKAI (ALERG.)";2065988478;Ne;6;0;7;13
115;Aitvaras;"ŽEMYNUKAI (ALERG.)";3635354769;Ne;0;32;0;32
116;Aitvaras;"ŽEMYNUKAI (ALERG.)";3851322849;Ne;5;4;3;12
117;Aitvaras;"ŽEMYNUKAI (ALERG.)";7889947603;Ne;2;0;4;6
118;Aitvaras;"ŽEMYNUKAI (ALERG.)";1662289664;Ne;3;4;2;9
119;Aitvaras;"ŽEMYNUKAI (ALERG.)";6286268740;Ne;0;3;1;4
120;Aitvaras;"LINKSMUČIAI (ALERG.)";9356533125;Ne;0;3;0;3
121;Aitvaras;"LINKSMUČIAI (ALERG.)";4721229601;Ne;10;0;4;14
122;Aitvaras;"LINKSMUČIAI (ALERG.)";7598319477;Ne;4;0;2;6
123;Aitvaras;"LINKSMUČIAI (ALERG.)";2231465856;Ne;4;1;4;9
124;Aitvaras;"LINKSMUČIAI (ALERG.)";5697675670;Ne;4;1;2;7
125;Aitvaras;"LINKSMUČIAI (ALERG.)";4394700961;Ne;15;0;4;19
126;Aitvaras;"LINKSMUČIAI (ALERG.)";8161320750;Ne;7;0;2;9
127;Aitvaras;"LINKSMUČIAI (ALERG.)";9006105693;Ne;10;0;4;14
128;Aitvaras;"LINKSMUČIAI (ALERG.)";7886218360;Ne;22;0;2;24
129;Aitvaras;"LINKSMUČIAI (ALERG.)";4897595828;Ne;16;0;2;18
130;Aitvaras;"LINKSMUČIAI (ALERG.)";2209078997;Ne;6;10;4;20
131;Aitvaras;"LINKSMUČIAI (ALERG.)";7463592589;Ne;11;0;4;15
132;Aitvaras;"LINKSMUČIAI (ALERG.)";5308153768;Ne;11;0;2;13
133;Aitvaras;"LINKSMUČIAI (ALERG.)";4954780185;Ne;6;0;3;9
134;Aitvaras;"LINKSMUČIAI (ALERG.)";9294248422;Ne;4;0;4;8
135;Aitvaras;"LINKSMUČIAI (ALERG.)";2263139249;Ne;4;5;2;11
136;Aitvaras;NAMINUKAI;3053557807;Ne;0;2;0;2
137;Aitvaras;NAMINUKAI;6126913961;Ne;4;2;2;8
138;Aitvaras;NAMINUKAI;3347213578;Ne;0;3;0;3
139;Aitvaras;NAMINUKAI;9024245490;Ne;0;4;3;7
140;Aitvaras;NAMINUKAI;8512502118;Ne;0;1;0;1
141;Aitvaras;NAMINUKAI;1376605323;Ne;0;2;0;2
142;Aitvaras;NAMINUKAI;6060880045;Ne;0;1;0;1
143;Aitvaras;NAMINUKAI;6048701733;Ne;0;6;0;6
144;Aitvaras;NAMINUKAI;4555281655;Ne;2;2;2;6
145;Aitvaras;NAMINUKAI;8043062737;Ne;0;6;0;6
146;Aitvaras;NAMINUKAI;3005447572;Ne;0;2;0;2
147;Aitvaras;NAMINUKAI;1549552392;Ne;6;3;3;12
148;Aitvaras;NAMINUKAI;4498792867;Ne;0;2;0;2
149;Aitvaras;NAMINUKAI;9490714865;Ne;7;3;2;12
150;Aitvaras;NAMINUKAI;1498630458;Ne;0;2;0;2
151;Aitvaras;NAMINUKAI;5967188507;Ne;5;0;2;7
152;Aitvaras;NAMINUKAI;5161069611;Ne;6;0;3;9
153;Aitvaras;NAMINUKAI;7934344218;Ne;5;1;2;8
154;Aitvaras;NAMINUKAI;6279152796;Ne;0;3;0;3
155;Aitvaras;ŠELMIAI;4984058405;Ne;3;2;2;7
156;Aitvaras;ŠELMIAI;9725401255;Ne;8;0;5;13
157;Aitvaras;ŠELMIAI;4547342872;Ne;0;4;0;4
158;Aitvaras;ŠELMIAI;5684526288;Ne;0;3;0;3
159;Aitvaras;ŠELMIAI;7764574135;Ne;0;2;0;2
160;Aitvaras;ŠELMIAI;5601517340;Ne;8;2;2;12
161;Aitvaras;ŠELMIAI;1019103539;Ne;8;2;2;12
162;Aitvaras;ŠELMIAI;2185746898;Ne;6;2;2;10
163;Aitvaras;ŠELMIAI;8756012613;Ne;2;0;2;4
164;Aitvaras;ŠELMIAI;1203732956;Ne;5;3;2;10
165;Aitvaras;ŠELMIAI;5782609781;Ne;12;2;3;17
166;Aitvaras;ŠELMIAI;4158520145;Ne;0;3;0;3
167;Aitvaras;ŠELMIAI;7352233454;Ne;3;2;3;8
168;Aitvaras;ŠELMIAI;1901118931;Ne;2;0;2;4
169;Aitvaras;ŠELMIAI;4812423010;Ne;5;2;2;9
170;Aitvaras;ŠELMIAI;8644983502;Ne;6;2;2;10
171;Aitvaras;ŠELMIAI;9295561516;Ne;0;3;0;3
172;Aitvaras;ŠELMIAI;6188186413;Ne;2;4;2;8
173;Aitvaras;ŠELMIAI;5886199823;Ne;10;0;2;12
174;Aitvaras;KODĖLČIUKAI;1495399113;Ne;0;2;0;2
175;Aitvaras;KODĖLČIUKAI;4613021421;Ne;0;4;0;4
176;Aitvaras;KODĖLČIUKAI;2887681961;Ne;7;2;2;11
177;Aitvaras;KODĖLČIUKAI;4760801928;Ne;10;0;2;12
178;Aitvaras;KODĖLČIUKAI;7136674662;Ne;0;4;0;4
179;Aitvaras;KODĖLČIUKAI;7922937851;Ne;0;1;0;1
180;Aitvaras;KODĖLČIUKAI;4085134058;Ne;4;1;2;7
181;Aitvaras;KODĖLČIUKAI;8746884740;Ne;8;0;2;10
182;Aitvaras;KODĖLČIUKAI;4163871634;Ne;0;8;0;8
183;Aitvaras;KODĖLČIUKAI;3988226974;Ne;0;11;0;11
184;Aitvaras;KODĖLČIUKAI;1070324386;Ne;6;2;2;10
185;Aitvaras;KODĖLČIUKAI;1599296739;Taip;8;3;2;13
186;Aitvaras;KODĖLČIUKAI;2239387580;Ne;5;1;2;8
187;Aitvaras;KODĖLČIUKAI;9949206639;Ne;8;0;2;10
188;Aitvaras;KODĖLČIUKAI;2892898328;Taip;13;2;2;17
189;Aitvaras;KODĖLČIUKAI;3749008647;Ne;2;0;5;7
190;Aitvaras;KODĖLČIUKAI;2871973045;Ne;3;2;2;7
191;Aitvaras;KODĖLČIUKAI;9218287162;Ne;13;0;2;15
192;Aitvaras;KODĖLČIUKAI;7181317805;Ne;0;4;0;4
193;Aitvaras;KODĖLČIUKAI;5093291829;Ne;9;0;4;13
194;Aitvaras;KODĖLČIUKAI;6119148164;Ne;7;1;2;10
195;Aitvaras;PABIRUČIAI;5563725441;Ne;2;0;2;4
196;Aitvaras;PABIRUČIAI;1961795617;Ne;2;0;2;4
197;Aitvaras;PABIRUČIAI;9081528512;Ne;15;0;2;17
198;Aitvaras;PABIRUČIAI;9494510876;Ne;4;2;2;8
199;Aitvaras;PABIRUČIAI;4816698202;Ne;4;0;2;6
200;Aitvaras;PABIRUČIAI;2817620246;Ne;0;0;4;4
201;Aitvaras;PABIRUČIAI;6906900852;Ne;0;2;0;2
202;Aitvaras;PABIRUČIAI;4560348711;Ne;0;1;0;1
203;Aitvaras;PABIRUČIAI;4251238917;Ne;3;0;5;8
204;Aitvaras;PABIRUČIAI;8003130815;Ne;7;0;2;9
205;Aitvaras;PABIRUČIAI;2045368104;Ne;0;2;0;2
206;Aitvaras;PABIRUČIAI;6660146833;Ne;0;2;2;4
207;Aitvaras;PABIRUČIAI;1020056632;Ne;13;0;4;17
208;Aitvaras;PABIRUČIAI;5228047718;Ne;4;1;2;7
209;Aitvaras;PABIRUČIAI;9993426833;Ne;7;0;2;9
210;Aitvaras;PABIRUČIAI;2747113542;Ne;9;8;2;19
211;Aitvaras;"SVAJOKLIAI  (ALERG.)";3429046261;Ne;0;1;0;1
212;Aitvaras;"SVAJOKLIAI  (ALERG.)";5659897032;Ne;6;4;2;12
213;Aitvaras;"SVAJOKLIAI  (ALERG.)";4618560397;Ne;0;3;0;3
214;Aitvaras;"SVAJOKLIAI  (ALERG.)";7745736525;Ne;1;0;3;4
215;Aitvaras;"SVAJOKLIAI  (ALERG.)";9209862610;Ne;3;3;2;8
216;Aitvaras;"SVAJOKLIAI  (ALERG.)";6191938291;Ne;3;0;7;10
217;Aitvaras;"SVAJOKLIAI  (ALERG.)";7006713502;Ne;7;2;2;11
218;Aitvaras;"SVAJOKLIAI  (ALERG.)";3923601422;Ne;8;2;2;12
219;Aitvaras;"SVAJOKLIAI  (ALERG.)";5790551266;Ne;4;4;3;11
220;Aitvaras;"SVAJOKLIAI  (ALERG.)";2975696317;Ne;8;0;2;10
221;Aitvaras;"SVAJOKLIAI  (ALERG.)";3891067128;Ne;2;0;2;4
222;Aitvaras;"SVAJOKLIAI  (ALERG.)";8352951885;Ne;0;8;0;8
223;Aitvaras;"SVAJOKLIAI  (ALERG.)";1448307414;Ne;0;3;0;3
224;Aitvaras;"SVAJOKLIAI  (ALERG.)";5593105541;Ne;4;0;2;6
225;Aitvaras;"SVAJOKLIAI  (ALERG.)";8963214183;Ne;0;7;0;7
226;Aitvaras;"SVAJOKLIAI  (ALERG.)";6319953077;Ne;5;2;2;9
227;Aitvaras;"SVAJOKLIAI  (ALERG.)";1131690624;Ne;0;2;0;2
228;Aitvaras;"SVAJOKLIAI  (ALERG.)";4801034095;Ne;12;3;2;17
229;Aitvaras;"SVAJOKLIAI  (ALERG.)";6916032116;Ne;3;2;5;10
230;Aitvaras;"SVAJOKLIAI  (ALERG.)";8300788433;Ne;7;5;2;14
231;Aitvaras;"SVAJOKLIAI  (ALERG.)";3026234787;Ne;13;7;2;22
232;Aitvaras;"SVAJOKLIAI  (ALERG.)";9810208704;Ne;0;14;0;14
233;Atžalėlės;Gėlytės;4284673729;Ne;8;4;2;14
234;Atžalėlės;Gėlytės;2385614957;Ne;0;2;2;4
235;Atžalėlės;Gėlytės;5432433423;Ne;0;2;0;2
236;Atžalėlės;Gėlytės;9715625283;Ne;3;2;2;7
237;Atžalėlės;Gėlytės;2131592139;Ne;2;4;2;8
238;Atžalėlės;Gėlytės;3191066669;Ne;0;0;1;1
239;Atžalėlės;Gėlytės;1722233272;Ne;0;8;0;8
240;Atžalėlės;Gėlytės;5310990513;Ne;0;2;0;2
241;Atžalėlės;Gėlytės;9189223222;Ne;0;2;0;2
242;Atžalėlės;Gėlytės;3283415814;Ne;0;4;0;4
243;Atžalėlės;Gėlytės;1146492807;Ne;0;3;1;4
244;Atžalėlės;Gėlytės;3870758086;Ne;0;3;2;5
245;Atžalėlės;Gėlytės;6202250600;Ne;0;1;1;2
246;Atžalėlės;Gėlytės;4098210138;Ne;0;2;0;2
247;Atžalėlės;Gėlytės;6177038838;Ne;1;3;4;8
248;Atžalėlės;Gėlytės;5742471497;Ne;0;2;1;3
249;Atžalėlės;Gėlytės;1137741059;Ne;8;2;2;12
250;Atžalėlės;Gėlytės;4238773173;Ne;0;3;0;3
251;Atžalėlės;Drugeliai;9481268935;Ne;1;8;2;11
252;Atžalėlės;Drugeliai;3738127350;Ne;0;6;0;6
253;Atžalėlės;Drugeliai;1423254771;Ne;3;2;2;7
254;Atžalėlės;Drugeliai;1505286928;Ne;0;7;0;7
255;Atžalėlės;Drugeliai;7483616061;Ne;0;9;0;9
256;Atžalėlės;Drugeliai;4227804985;Ne;6;0;2;8
257;Atžalėlės;Drugeliai;9053620501;Ne;0;2;0;2
258;Atžalėlės;Drugeliai;4148412941;Ne;0;8;0;8
259;Atžalėlės;Drugeliai;9054589111;Ne;0;3;0;3
260;Atžalėlės;Drugeliai;7501772398;Ne;0;2;0;2
261;Atžalėlės;Drugeliai;9346744866;Ne;0;2;0;2
262;Atžalėlės;Drugeliai;1710646812;Ne;0;0;4;4
263;Atžalėlės;Drugeliai;5972419628;Ne;0;2;0;2
264;Atžalėlės;Gandriukai;2083260403;Ne;12;3;2;17
265;Atžalėlės;Gandriukai;3692090073;Ne;9;2;2;13
266;Atžalėlės;Gandriukai;5119260525;Taip;9;0;4;13
267;Atžalėlės;Gandriukai;4293557144;Ne;16;4;2;22
268;Atžalėlės;Gandriukai;9201449702;Ne;0;0;1;1
269;Atžalėlės;Gandriukai;2078549599;Ne;3;0;2;5
270;Atžalėlės;Voveriukai;3795729265;Ne;0;5;1;6
271;Atžalėlės;Voveriukai;8201582382;Ne;6;2;3;11
272;Atžalėlės;Voveriukai;4362058013;Ne;6;2;3;11
273;Atžalėlės;Voveriukai;8819893830;Ne;0;2;9;11
274;Atžalėlės;Voveriukai;3069192413;Ne;1;0;2;3
275;Atžalėlės;Voveriukai;5705303891;Ne;0;2;0;2
276;Atžalėlės;Voveriukai;2374624441;Ne;0;3;0;3
277;Atžalėlės;Voveriukai;1212074068;Ne;3;2;2;7
278;Atžalėlės;Voveriukai;9967641617;Ne;0;3;0;3
279;Atžalėlės;Voveriukai;6723689098;Ne;0;2;1;3
280;Atžalėlės;Voveriukai;4661388894;Ne;0;7;0;7
281;Atžalėlės;Voveriukai;1538643591;Ne;0;2;0;2
282;Atžalėlės;Voveriukai;9085453655;Ne;2;0;2;4
283;Atžalėlės;Voveriukai;7196464328;Ne;4;0;5;9
284;Atžalėlės;Voveriukai;7018297883;Ne;0;2;1;3
285;Atžalėlės;Voveriukai;9508110719;Ne;0;2;0;2
286;Atžalėlės;Voveriukai;5584105084;Ne;0;0;3;3
287;Atžalėlės;Voveriukai;7522643082;Ne;0;1;0;1
288;Atžalėlės;Voveriukai;7613931447;Ne;0;1;0;1
289;Atžalėlės;Voveriukai;7510951079;Ne;0;4;0;4
290;Atžalėlės;Voveriukai;8547622670;Ne;13;2;4;19
291;Atžalėlės;Voveriukai;3143856911;Taip;0;13;0;13
292;Atžalėlės;Paukšteliai;7807313362;Ne;0;3;0;3
293;Atžalėlės;Paukšteliai;6537864486;Ne;0;2;6;8
294;Atžalėlės;Paukšteliai;8524244526;Ne;4;2;5;11
295;Atžalėlės;Paukšteliai;6873507667;Ne;0;2;0;2
296;Atžalėlės;Paukšteliai;7321516783;Ne;3;0;4;7
297;Atžalėlės;Paukšteliai;6265777690;Ne;0;6;0;6
298;Atžalėlės;Paukšteliai;1844980319;Ne;0;2;1;3
299;Atžalėlės;Paukšteliai;5997958773;Ne;0;2;1;3
300;Atžalėlės;Paukšteliai;8512283024;Ne;0;1;0;1
301;Atžalėlės;Paukšteliai;2078781673;Ne;0;2;0;2
302;Atžalėlės;Paukšteliai;1520206753;Ne;9;0;5;14
303;Atžalėlės;Paukšteliai;4790322154;Ne;0;9;0;9
304;Atžalėlės;Paukšteliai;4081717007;Ne;0;0;7;7
305;Atžalėlės;Paukšteliai;1089221288;Ne;0;0;12;12
306;Atžalėlės;Paukšteliai;4392352210;Ne;3;0;5;8
307;Atžalėlės;Meškiukai;8586739429;Ne;0;6;0;6
308;Atžalėlės;Meškiukai;9925178685;Ne;0;2;0;2
309;Atžalėlės;Meškiukai;2617568019;Ne;4;1;2;7
310;Atžalėlės;Meškiukai;4233689945;Ne;0;1;0;1
311;Atžalėlės;Meškiukai;8619613890;Ne;0;7;0;7
312;Atžalėlės;Meškiukai;3281114596;Ne;0;8;0;8
313;Atžalėlės;Meškiukai;5466374223;Ne;0;0;2;2
314;Atžalėlės;Meškiukai;2433029299;Ne;0;0;2;2
315;Atžalėlės;Meškiukai;9631336340;Ne;0;1;2;3
316;Atžalėlės;Meškiukai;2930612059;Ne;10;0;2;12
317;Atžalėlės;Meškiukai;6385777303;Ne;0;2;3;5
318;Atžalėlės;Meškiukai;2569491645;Ne;0;2;0;2
319;Atžalėlės;Meškiukai;1431197358;Ne;0;4;0;4
320;Atžalėlės;Meškiukai;4177753994;Ne;0;2;0;2
321;Atžalėlės;Meškiukai;3982090601;Ne;0;1;0;1
322;Atžalėlės;Meškiukai;3743308789;Ne;0;0;4;4
323;Atžalėlės;Meškiukai;7936991925;Ne;0;3;0;3
324;Atžalėlės;Meškiukai;8976815736;Ne;0;3;1;4
325;Atžalėlės;Saulutės;8460997063;Ne;0;2;0;2
326;Atžalėlės;Saulutės;6048763811;Ne;4;4;3;11
327;Atžalėlės;Saulutės;8313999012;Ne;0;2;0;2
328;Atžalėlės;Saulutės;2291204010;Ne;3;0;4;7
329;Atžalėlės;Saulutės;2306086573;Ne;2;0;11;13
330;Atžalėlės;Saulutės;8208908249;Ne;0;9;0;9
331;Atžalėlės;Bitutės;8396693160;Ne;0;3;0;3
332;Atžalėlės;Bitutės;6253257539;Ne;3;0;4;7
333;Atžalėlės;Bitutės;6211002805;Ne;0;0;2;2
334;Atžalėlės;Bitutės;1939076303;Ne;5;2;2;9
335;Atžalėlės;Bitutės;7052938312;Ne;0;2;0;2
336;Atžalėlės;Bitutės;8707875125;Ne;10;3;4;17
337;Atžalėlės;Bitutės;3559977339;Ne;1;0;2;3
338;Atžalėlės;Bitutės;2322329918;Ne;0;2;5;7
339;Atžalėlės;Bitutės;6368553568;Ne;0;3;6;9
340;Atžalėlės;Bitutės;5148142239;Ne;1;0;2;3
341;Atžalėlės;Bitutės;5593774275;Ne;11;2;4;17
342;Atžalėlės;Bitutės;5511148178;Ne;6;0;2;8
343;Atžalėlės;Bitutės;6594440062;Ne;0;0;1;1
344;Atžalėlės;Boružiukai;7104671423;Ne;6;2;4;12
345;Atžalėlės;Boružiukai;3119998745;Ne;22;0;0;22
346;Atžalėlės;Boružiukai;3198845538;Ne;0;2;0;2
347;Atžalėlės;Boružiukai;3998483465;Ne;0;0;4;4
348;Atžalėlės;Boružiukai;8681809797;Ne;3;2;2;7
349;Atžalėlės;Boružiukai;3590987364;Ne;0;2;2;4
350;Atžalėlės;Boružiukai;6237597328;Ne;0;3;0;3
351;Atžalėlės;Boružiukai;1383944713;Ne;2;0;0;2
352;Atžalėlės;Boružiukai;7091939299;Ne;6;0;2;8
353;Atžalėlės;Šypsenėlės;9736390705;Ne;4;2;2;8
354;Atžalėlės;Šypsenėlės;2032772143;Ne;0;0;2;2
355;Atžalėlės;Šypsenėlės;9487375092;Ne;0;3;0;3
356;Atžalėlės;Šypsenėlės;1943349835;Ne;0;0;1;1
357;Atžalėlės;Šypsenėlės;6828140775;Ne;0;0;2;2
358;Atžalėlės;Šypsenėlės;8564143904;Ne;15;0;7;22
359;Atžalėlės;Šypsenėlės;3299724612;Ne;0;2;0;2
360;Atžalėlės;Šypsenėlės;2271887521;Ne;8;2;2;12
361;Atžalėlės;Šypsenėlės;9707462467;Ne;0;1;2;3
362;Atžalėlės;Šypsenėlės;2298114905;Ne;3;2;2;7
363;Atžalėlės;Šypsenėlės;3346193393;Ne;3;0;2;5
364;Atžalėlės;Šypsenėlės;5822532151;Ne;0;3;19;22
365;Aušrelė;PASAKIUKAI;1754138341;Ne;5;2;5;12
366;Aušrelė;PASAKIUKAI;6913824678;Ne;5;2;2;9
367;Aušrelė;PASAKIUKAI;8542012622;Ne;1;8;0;9
368;Aušrelė;PASAKIUKAI;6463141345;Ne;0;2;0;2
369;Aušrelė;PASAKIUKAI;3713528812;Ne;6;7;0;13
370;Aušrelė;PASAKIUKAI;2221714044;Ne;0;2;1;3
371;Aušrelė;PASAKIUKAI;1949809977;Ne;0;0;3;3
372;Aušrelė;PASAKIUKAI;8126701466;Ne;3;2;6;11
373;Aušrelė;PASAKIUKAI;9733877752;Ne;0;1;0;1
374;Aušrelė;PASAKIUKAI;4591518039;Ne;2;2;2;6
375;Aušrelė;PASAKIUKAI;1798478023;Ne;4;0;2;6
376;Aušrelė;PASAKIUKAI;8573348956;Ne;0;6;0;6
377;Aušrelė;PASAKIUKAI;1607338052;Ne;5;0;2;7
378;Aušrelė;PASAKIUKAI;1544869163;Ne;0;0;3;3
379;Aušrelė;PASAKIUKAI;6577540623;Ne;7;1;3;11
380;Aušrelė;PASAKIUKAI;5460833944;Ne;5;1;4;10
381;Aušrelė;PASAKIUKAI;6372004855;Ne;0;9;0;9
382;Aušrelė;PASAKIUKAI;2311552230;Ne;0;0;6;6
383;Aušrelė;PASAKIUKAI;7130040621;Ne;1;2;2;5
384;Aušrelė;BORUŽĖLĖS;5733298006;Ne;0;11;0;11
385;Aušrelė;BORUŽĖLĖS;4565813136;Ne;0;1;4;5
386;Aušrelė;BORUŽĖLĖS;9877307844;Ne;7;0;0;7
387;Aušrelė;BORUŽĖLĖS;2873845920;Ne;0;5;0;5
388;Aušrelė;BORUŽĖLĖS;1458580523;Ne;5;3;2;10
389;Aušrelė;BORUŽĖLĖS;1463724119;Ne;0;2;0;2
390;Aušrelė;BORUŽĖLĖS;5904797250;Ne;3;1;3;7
391;Aušrelė;BORUŽĖLĖS;1871799626;Ne;0;0;22;22
392;Aušrelė;BORUŽĖLĖS;4924950592;Ne;4;0;2;6
393;Aušrelė;BORUŽĖLĖS;8947695521;Ne;3;9;0;12
394;Aušrelė;BORUŽĖLĖS;6672975558;Ne;4;0;8;12
395;Aušrelė;BORUŽĖLĖS;8799928392;Ne;0;0;3;3
396;Aušrelė;BORUŽĖLĖS;5801943729;Ne;0;6;0;6
397;Aušrelė;BORUŽĖLĖS;5866673884;Ne;0;2;2;4
398;Aušrelė;BORUŽĖLĖS;6418762623;Ne;0;5;0;5
399;Aušrelė;BORUŽĖLĖS;8835689988;Ne;0;4;1;5
400;Aušrelė;BORUŽĖLĖS;8689174023;Ne;0;2;0;2
401;Aušrelė;BORUŽĖLĖS;7966060521;Ne;5;4;0;9
402;Aušrelė;BORUŽĖLĖS;5358736178;Ne;0;2;5;7
403;Aušrelė;SMALSUČIAI;6761263775;Ne;7;4;2;13
404;Aušrelė;SMALSUČIAI;3015028879;Ne;0;4;0;4
405;Aušrelė;SMALSUČIAI;5935579452;Ne;0;1;1;2
406;Aušrelė;SMALSUČIAI;2863655361;Ne;0;2;1;3
407;Aušrelė;SMALSUČIAI;2390128933;Ne;0;2;1;3
408;Aušrelė;SMALSUČIAI;8503309819;Ne;3;0;2;5
409;Aušrelė;SMALSUČIAI;2827216981;Ne;0;2;0;2
410;Aušrelė;SMALSUČIAI;9443641849;Ne;0;2;6;8
411;Aušrelė;SMALSUČIAI;7930717076;Ne;0;2;0;2
412;Aušrelė;SMALSUČIAI;7609339123;Ne;0;8;0;8
413;Aušrelė;SMALSUČIAI;1556010005;Ne;0;2;0;2
414;Aušrelė;SMALSUČIAI;5478028396;Ne;0;7;0;7
415;Aušrelė;SMALSUČIAI;7070013052;Ne;9;2;2;13
416;Aušrelė;SMALSUČIAI;3581155949;Ne;0;3;0;3
417;Aušrelė;SMALSUČIAI;6507218940;Ne;0;2;0;2
418;Aušrelė;SMALSUČIAI;2266390402;Ne;0;11;0;11
419;Aušrelė;SMALSUČIAI;8032661062;Ne;0;2;3;5
420;Aušrelė;SMALSUČIAI;1976613166;Ne;0;4;1;5
421;Aušrelė;KODĖLČIUKAI;7723159748;Ne;3;1;2;6
422;Aušrelė;KODĖLČIUKAI;7367268748;Ne;0;2;0;2
423;Aušrelė;KODĖLČIUKAI;5712867880;Ne;0;0;1;1
424;Aušrelė;KODĖLČIUKAI;3623813061;Ne;0;1;0;1
425;Aušrelė;KODĖLČIUKAI;4288695809;Ne;0;2;0;2
426;Aušrelė;KODĖLČIUKAI;8693750994;Ne;3;2;2;7
427;Aušrelė;KODĖLČIUKAI;7327544406;Ne;0;2;0;2
428;Aušrelė;KODĖLČIUKAI;9566144610;Ne;5;2;0;7
429;Aušrelė;KODĖLČIUKAI;6308519574;Ne;0;3;0;3
430;Aušrelė;KODĖLČIUKAI;6186758486;Ne;0;0;1;1
431;Aušrelė;KODĖLČIUKAI;3320399046;Ne;0;8;2;10
432;Aušrelė;KODĖLČIUKAI;6911735462;Ne;5;2;2;9
433;Aušrelė;KODĖLČIUKAI;4248808572;Ne;0;9;0;9
434;Aušrelė;KODĖLČIUKAI;5046027475;Ne;5;17;0;22
435;Aušrelė;KODĖLČIUKAI;8338569001;Ne;4;3;2;9
436;Aušrelė;KODĖLČIUKAI;2766357229;Ne;1;0;2;3
437;Aušrelė;KODĖLČIUKAI;7515666888;Ne;0;1;1;2
438;Aušrelė;KODĖLČIUKAI;8862488358;Ne;7;2;2;11
439;Aušrelė;KODĖLČIUKAI;4882556718;Ne;0;5;1;6
440;Aušrelė;KODĖLČIUKAI;6321332888;Ne;0;3;0;3
441;Aušrelė;KODĖLČIUKAI;8341539501;Ne;0;2;0;2
442;Aušrelė;PELĖDŽIUKAI;4725588671;Ne;0;2;0;2
443;Aušrelė;PELĖDŽIUKAI;3223092149;Ne;0;16;0;16
444;Aušrelė;PELĖDŽIUKAI;8580241126;Ne;0;2;14;16
445;Aušrelė;PELĖDŽIUKAI;4227228548;Ne;0;8;0;8
446;Aušrelė;PELĖDŽIUKAI;8996445434;Ne;0;8;0;8
447;Aušrelė;PELĖDŽIUKAI;8411336992;Ne;3;1;2;6
448;Aušrelė;PELĖDŽIUKAI;8917907028;Ne;0;2;0;2
449;Aušrelė;PELĖDŽIUKAI;7494298336;Ne;0;14;0;14
450;Aušrelė;PELĖDŽIUKAI;4012186237;Ne;0;0;1;1
451;Aušrelė;PELĖDŽIUKAI;3738923947;Ne;0;1;0;1
452;Aušrelė;PELĖDŽIUKAI;1642358593;Ne;0;2;0;2
453;Aušrelė;PELĖDŽIUKAI;2294224426;Ne;0;2;0;2
454;Aušrelė;PELĖDŽIUKAI;1276792874;Ne;3;8;0;11
455;Aušrelė;PELĖDŽIUKAI;8210698019;Ne;7;2;2;11
456;Aušrelė;PELĖDŽIUKAI;9004934832;Ne;0;0;1;1
457;Aušrelė;AITVARIUKAI;6833654667;Ne;0;2;0;2
458;Aušrelė;AITVARIUKAI;8102749675;Ne;0;3;0;3
459;Aušrelė;AITVARIUKAI;4595435635;Ne;0;7;0;7
460;Aušrelė;AITVARIUKAI;9608444990;Ne;0;4;0;4
461;Aušrelė;AITVARIUKAI;6434548772;Ne;0;2;1;3
462;Aušrelė;AITVARIUKAI;7978186455;Ne;0;10;0;10
463;Aušrelė;AITVARIUKAI;5602774323;Ne;0;2;0;2
464;Aušrelė;AITVARIUKAI;5708459561;Ne;0;2;0;2
465;Aušrelė;AITVARIUKAI;1039180129;Ne;0;6;0;6
466;Aušrelė;AITVARIUKAI;3807967685;Ne;0;0;1;1
467;Aušrelė;AITVARIUKAI;6081100604;Ne;0;2;1;3
468;Aušrelė;AITVARIUKAI;7847650967;Ne;0;1;0;1
469;Aušrelė;AITVARIUKAI;4942168388;Ne;0;5;0;5
470;Aušrelė;AITVARIUKAI;7788139791;Ne;0;1;3;4
471;Aušrelė;BITUTĖS;1741716341;Ne;0;9;0;9
472;Aušrelė;BITUTĖS;4989544273;Ne;0;7;0;7
473;Aušrelė;BITUTĖS;9960201865;Ne;3;4;2;9
474;Aušrelė;BITUTĖS;2071674661;Ne;0;19;0;19
475;Aušrelė;BITUTĖS;1450827353;Ne;0;10;0;10
476;Aušrelė;BITUTĖS;5598494461;Ne;0;6;0;6
477;Aušrelė;BITUTĖS;4935192851;Ne;0;2;0;2
478;Aušrelė;BITUTĖS;1931955562;Ne;0;6;0;6
479;Aušrelė;BITUTĖS;6591538425;Taip;0;15;0;15
480;Aušrelė;BITUTĖS;8203256528;Ne;0;18;0;18
481;Aušrelė;BITUTĖS;5741252819;Ne;0;18;0;18
482;Aušrelė;BITUTĖS;1243825974;Ne;0;8;0;8
483;Aušrelė;BITUTĖS;2468245186;Ne;0;2;0;2
484;Aušrelė;BITUTĖS;5266959731;Ne;8;0;2;10
485;Aušrelė;BITUTĖS;2545065554;Ne;0;15;0;15
486;Aušrelė;BITUTĖS;2543313198;Ne;0;3;0;3
487;Aušrelė;BITUTĖS;3288449407;Ne;0;11;0;11
488;Aušrelė;ŽIRNIUKAI;8833081700;Ne;0;1;0;1
489;Aušrelė;ŽIRNIUKAI;7028068342;Ne;3;0;6;9
490;Aušrelė;ŽIRNIUKAI;9274178180;Ne;3;3;3;9
491;Aušrelė;ŽIRNIUKAI;2543352192;Ne;8;1;2;11
492;Aušrelė;ŽIRNIUKAI;1528883001;Ne;0;15;0;15
493;Aušrelė;ŽIRNIUKAI;3023414781;Ne;0;2;2;4
494;Aušrelė;ŽIRNIUKAI;2582979005;Taip;0;2;0;2
495;Aušrelė;ŽIRNIUKAI;9884818480;Ne;0;2;0;2
496;Aušrelė;ŽIRNIUKAI;5429867368;Ne;0;1;0;1
497;Aušrelė;ŽIRNIUKAI;1138257807;Ne;0;10;0;10
498;Aušrelė;ŽIRNIUKAI;1451587500;Ne;5;0;6;11
499;Aušrelė;ŽIRNIUKAI;5689460984;Ne;5;2;2;9
500;Aušrelė;ŽIRNIUKAI;4260768468;Ne;4;7;0;11
501;Aušrelė;ŽIRNIUKAI;3295471821;Ne;0;11;0;11
502;Aušrelė;ŽIRNIUKAI;9476721640;Ne;0;2;0;2
503;Aušrelė;GRYBUKAI;2466858636;Taip;20;2;0;22
504;Aušrelė;GRYBUKAI;4213141410;Ne;6;0;4;10
505;Aušrelė;GRYBUKAI;6287520834;Ne;7;2;2;11
506;Aušrelė;GRYBUKAI;2450164324;Ne;5;2;2;9
507;Aušrelė;GRYBUKAI;2236345596;Ne;8;0;2;10
508;Aušrelė;GRYBUKAI;6902592468;Ne;0;0;1;1
509;Aušrelė;GRYBUKAI;2845543931;Ne;13;2;2;17
510;Aušrelė;GRYBUKAI;4063895292;Ne;0;14;0;14
511;Aušrelė;GRYBUKAI;4719347430;Ne;9;2;2;13
512;Aušrelė;GRYBUKAI;9093567659;Ne;7;2;2;11
513;Aušrelė;GRYBUKAI;5409930406;Ne;15;2;2;19
514;Aušrelė;GRYBUKAI;7058664271;Taip;8;0;2;10
515;Aušrelė;GRYBUKAI;1934623405;Ne;4;0;3;7
516;Aušrelė;GRYBUKAI;8103112254;Ne;8;0;3;11
517;Aušrelė;GRYBUKAI;7670935967;Ne;13;0;2;15
518;Aušrelė;GRYBUKAI;9007129980;Ne;0;3;0;3
519;Aušrelė;GRYBUKAI;5709799539;Ne;3;1;2;6
520;Aušrelė;GRYBUKAI;8724802289;Ne;3;1;2;6
521;Aušrelė;GRYBUKAI;9075395810;Ne;3;2;2;7
522;Aušrelė;GRYBUKAI;4840787696;Ne;0;11;0;11
523;Aušrelė;DRUGELIAI;1209824814;Ne;1;0;2;3
524;Aušrelė;DRUGELIAI;2737402297;Ne;0;11;0;11
525;Aušrelė;DRUGELIAI;3813270658;Ne;0;1;0;1
526;Aušrelė;DRUGELIAI;4254737302;Ne;0;0;1;1
527;Aušrelė;DRUGELIAI;4464947621;Ne;0;17;0;17
528;Aušrelė;DRUGELIAI;9126040500;Ne;0;4;0;4
529;Aušrelė;DRUGELIAI;7286960315;Ne;0;2;0;2
530;Aušrelė;DRUGELIAI;8102293098;Ne;3;2;2;7
531;Aušrelė;DRUGELIAI;2266835623;Ne;0;5;0;5
532;Aušrelė;DRUGELIAI;1094141305;Ne;7;1;4;12
533;Aušrelė;DRUGELIAI;9514049590;Ne;6;0;2;8
534;Aušrelė;DRUGELIAI;5815844340;Ne;0;7;0;7
535;Aušrelė;DRUGELIAI;5668908532;Ne;0;8;0;8
536;Aušrelė;DRUGELIAI;9819729046;Ne;2;3;4;9
537;Aušrelė;DRUGELIAI;5698248175;Ne;13;0;2;15
538;Aušrelė;DRUGELIAI;2116411914;Ne;0;1;0;1
539;Aušrelė;NYKŠTUKAI;9914518299;Ne;3;2;0;5
540;Aušrelė;NYKŠTUKAI;4297417711;Ne;2;2;2;6
541;Aušrelė;NYKŠTUKAI;7964156691;Taip;0;16;0;16
542;Aušrelė;NYKŠTUKAI;7140465960;Ne;1;2;2;5
543;Aušrelė;NYKŠTUKAI;7937067384;Ne;7;0;2;9
544;Aušrelė;NYKŠTUKAI;8099338305;Ne;7;1;0;8
545;Aušrelė;NYKŠTUKAI;4282189556;Ne;0;4;0;4
546;Aušrelė;NYKŠTUKAI;1950091527;Taip;8;0;2;10
547;Aušrelė;NYKŠTUKAI;8378225406;Ne;1;7;0;8
548;Aušrelė;NYKŠTUKAI;3259828075;Ne;6;2;3;11
549;Aušrelė;NYKŠTUKAI;6474867237;Ne;5;2;2;9
550;Aušrelė;NYKŠTUKAI;2645772675;Ne;3;2;2;7
551;Aušrelė;NYKŠTUKAI;8829298943;Ne;0;2;0;2
552;Aušrelė;NYKŠTUKAI;5018495543;Ne;13;0;4;17
553;Aušrelė;SPINDULIUKAI;8848358559;Ne;0;2;0;2
554;Aušrelė;SPINDULIUKAI;3194122285;Ne;0;2;0;2
555;Aušrelė;SPINDULIUKAI;8801906679;Ne;1;3;2;6
556;Aušrelė;SPINDULIUKAI;1446194971;Ne;0;10;0;10
557;Aušrelė;SPINDULIUKAI;2319188134;Ne;0;0;1;1
558;Aušrelė;SPINDULIUKAI;8997650487;Ne;0;0;1;1
559;Aušrelė;SPINDULIUKAI;5274919078;Ne;3;17;2;22
560;Aušrelė;SPINDULIUKAI;2981314491;Taip;0;2;0;2
561;Aušrelė;SPINDULIUKAI;2441221298;Ne;0;1;0;1
562;Aušrelė;SPINDULIUKAI;8427699400;Ne;0;2;0;2
563;Aušrelė;SPINDULIUKAI;8797157671;Ne;6;0;4;10
564;Aušrelė;SPINDULIUKAI;3646395136;Ne;0;5;0;5
565;Aušrelė;SPINDULIUKAI;9973824348;Ne;7;2;2;11
566;Aušrelė;SPINDULIUKAI;8438945369;Ne;0;8;0;8
567;Aušrelė;SPINDULIUKAI;3072503569;Ne;0;1;0;1
568;Aušrelė;SPINDULIUKAI;9938762910;Ne;0;1;0;1
569;Aušrelė;SPINDULIUKAI;2846574130;Ne;3;0;4;7
570;Beržynėlis;SVIRPLIUKAI;7360345539;Ne;3;11;0;14
571;Beržynėlis;SVIRPLIUKAI;4134371415;Ne;3;2;0;5
572;Beržynėlis;SVIRPLIUKAI;7278860816;Ne;7;1;2;10
573;Beržynėlis;SVIRPLIUKAI;4013099670;Ne;2;5;2;9
574;Beržynėlis;SVIRPLIUKAI;8404801225;Ne;3;0;4;7
575;Beržynėlis;SVIRPLIUKAI;7953957525;Ne;2;5;4;11
576;Beržynėlis;SVIRPLIUKAI;3841363368;Ne;4;0;2;6
577;Beržynėlis;SVIRPLIUKAI;3418730586;Ne;2;1;2;5
578;Beržynėlis;SVIRPLIUKAI;1468551784;Ne;3;0;2;5
579;Beržynėlis;SVIRPLIUKAI;2221708263;Ne;9;0;2;11
580;Beržynėlis;SVIRPLIUKAI;6516665294;Ne;0;5;1;6
581;Beržynėlis;SVIRPLIUKAI;9580286493;Ne;1;3;0;4
582;Beržynėlis;SVIRPLIUKAI;6673910279;Ne;0;17;0;17
583;Beržynėlis;SVIRPLIUKAI;8701990625;Ne;3;8;2;13
584;Beržynėlis;SVIRPLIUKAI;5027712732;Ne;5;2;2;9
585;Beržynėlis;SVIRPLIUKAI;7555487759;Ne;4;0;2;6
586;Beržynėlis;SVIRPLIUKAI;7788532819;Ne;7;2;4;13
587;Beržynėlis;SVIRPLIUKAI;3315079004;Ne;2;0;5;7
588;Beržynėlis;SVIRPLIUKAI;8533912024;Ne;13;5;2;20
589;Beržynėlis;SVIRPLIUKAI;4978363316;Ne;9;0;2;11
590;Beržynėlis;SVIRPLIUKAI;5864265458;Ne;8;6;2;16
591;Beržynėlis;PELEDŽIUKAI;5473666098;Ne;0;4;0;4
592;Beržynėlis;PELEDŽIUKAI;9088059487;Ne;0;2;0;2
593;Beržynėlis;PELEDŽIUKAI;6337962165;Ne;2;4;0;6
594;Beržynėlis;PELEDŽIUKAI;7589778533;Ne;0;3;0;3
595;Beržynėlis;PELEDŽIUKAI;8591800387;Ne;2;4;0;6
596;Beržynėlis;PELEDŽIUKAI;6739927917;Ne;0;2;3;5
597;Beržynėlis;PELEDŽIUKAI;2971686368;Ne;4;3;2;9
598;Beržynėlis;PELEDŽIUKAI;9409317403;Ne;0;2;0;2
599;Beržynėlis;PELEDŽIUKAI;9305279614;Ne;0;2;2;4
600;Beržynėlis;PELEDŽIUKAI;1325972861;Ne;1;0;4;5
601;Beržynėlis;PELEDŽIUKAI;5856519538;Ne;0;12;0;12
602;Beržynėlis;PELEDŽIUKAI;8114761925;Ne;0;2;0;2
603;Beržynėlis;PELEDŽIUKAI;9896122318;Ne;0;1;2;3
604;Beržynėlis;PELEDŽIUKAI;4970999989;Ne;6;0;2;8
605;Beržynėlis;PELEDŽIUKAI;4035764376;Ne;0;2;0;2
606;Beržynėlis;PELEDŽIUKAI;5308596559;Ne;1;4;3;8
607;Beržynėlis;PELEDŽIUKAI;8881566865;Ne;0;0;2;2
608;Beržynėlis;PELEDŽIUKAI;4161974847;Ne;1;4;0;5
609;Beržynėlis;ŽIOGELIAI;7903644161;Ne;0;2;1;3
610;Beržynėlis;ŽIOGELIAI;3100097647;Ne;15;0;2;17
611;Beržynėlis;ŽIOGELIAI;7084666673;Ne;2;1;2;5
612;Beržynėlis;ŽIOGELIAI;1707585750;Ne;2;0;5;7
613;Beržynėlis;ŽIOGELIAI;4382068779;Ne;5;0;4;9
614;Beržynėlis;ŽIOGELIAI;1831776326;Ne;4;0;0;4
615;Beržynėlis;ŽIOGELIAI;1118349439;Ne;16;0;4;20
616;Beržynėlis;ŽIOGELIAI;6592330036;Ne;4;2;5;11
617;Beržynėlis;ŽIOGELIAI;1503903200;Ne;3;1;4;8
618;Beržynėlis;ŽIOGELIAI;3593785967;Ne;0;1;0;1
619;Beržynėlis;ŽIOGELIAI;7972993168;Ne;4;2;3;9
620;Beržynėlis;ŽIOGELIAI;5049057730;Ne;3;0;2;5
621;Beržynėlis;ŽIOGELIAI;2583982025;Ne;0;2;1;3
622;Beržynėlis;ŽIOGELIAI;6932094459;Ne;0;2;1;3
623;Beržynėlis;ŽIOGELIAI;2155662035;Ne;3;0;2;5
624;Beržynėlis;ŽIOGELIAI;7870888327;Ne;2;0;2;4
625;Beržynėlis;ŽIOGELIAI;1558469002;Ne;0;0;3;3
626;Beržynėlis;ŽIOGELIAI;8665581794;Ne;0;0;13;13
627;Beržynėlis;ŽIOGELIAI;7806800327;Ne;0;0;22;22
628;Beržynėlis;ŽVIRBLIUKAI;2193460960;Ne;1;2;2;5
629;Beržynėlis;ŽVIRBLIUKAI;2482395208;Ne;1;2;2;5
630;Beržynėlis;ŽVIRBLIUKAI;2892553878;Ne;0;2;0;2
631;Beržynėlis;ŽVIRBLIUKAI;4466393687;Ne;0;4;0;4
632;Beržynėlis;ŽVIRBLIUKAI;4774769217;Ne;0;14;0;14
633;Beržynėlis;ŽVIRBLIUKAI;8280378527;Ne;0;1;0;1
634;Beržynėlis;ŽVIRBLIUKAI;6713134631;Ne;0;2;0;2
635;Beržynėlis;ŽVIRBLIUKAI;5593146590;Ne;0;2;0;2
636;Beržynėlis;ŽVIRBLIUKAI;9754455116;Ne;0;7;0;7
637;Beržynėlis;ŽVIRBLIUKAI;3334994408;Ne;20;0;2;22
638;Beržynėlis;ŽVIRBLIUKAI;9777841895;Ne;0;22;0;22
639;Beržynėlis;ŽVIRBLIUKAI;6293884233;Ne;1;2;2;5
640;Beržynėlis;ŽVIRBLIUKAI;3209966996;Ne;0;4;1;5
641;Beržynėlis;ŽVIRBLIUKAI;5194416351;Ne;8;2;2;12
642;Beržynėlis;ŽVIRBLIUKAI;1228384088;Ne;3;0;3;6
643;Beržynėlis;ŽVIRBLIUKAI;5189335842;Ne;3;0;2;5
644;Beržynėlis;ŽVIRBLIUKAI;6864823739;Ne;20;0;2;22
645;Beržynėlis;ŽVIRBLIUKAI;3484188772;Ne;4;2;2;8
646;Beržynėlis;ŽIRNIUKAI;4944466205;Ne;8;0;2;10
647;Beržynėlis;ŽIRNIUKAI;6392773584;Ne;0;4;0;4
648;Beržynėlis;ŽIRNIUKAI;2154631640;Ne;0;0;2;2
649;Beržynėlis;ŽIRNIUKAI;9899702275;Ne;3;0;2;5
650;Beržynėlis;ŽIRNIUKAI;1320866413;Ne;5;0;2;7
651;Beržynėlis;ŽIRNIUKAI;5979829045;Ne;4;2;2;8
652;Beržynėlis;ŽIRNIUKAI;8027685774;Ne;20;0;2;22
653;Beržynėlis;ŽIRNIUKAI;2615367518;Ne;0;5;3;8
654;Beržynėlis;ŽIRNIUKAI;1986523281;Ne;3;0;4;7
655;Beržynėlis;ŽIRNIUKAI;4587584948;Ne;0;2;0;2
656;Beržynėlis;ŽIRNIUKAI;9901466559;Ne;6;0;2;8
657;Beržynėlis;VIŠČIUKAI;9480959071;Ne;3;0;2;5
658;Beržynėlis;VIŠČIUKAI;8716270335;Ne;15;0;4;19
659;Beržynėlis;VIŠČIUKAI;4248556027;Ne;15;0;2;17
660;Beržynėlis;VIŠČIUKAI;7017827446;Taip;0;2;0;2
661;Beržynėlis;VIŠČIUKAI;4308655600;Ne;0;2;1;3
662;Beržynėlis;VIŠČIUKAI;3192897091;Ne;6;0;4;10
663;Beržynėlis;VIŠČIUKAI;8052073990;Ne;1;0;3;4
664;Beržynėlis;VIŠČIUKAI;5630272112;Ne;0;2;1;3
665;Beržynėlis;VIŠČIUKAI;6514295883;Ne;4;0;7;11
666;Beržynėlis;VIŠČIUKAI;1051991834;Ne;4;2;2;8
667;Beržynėlis;VIŠČIUKAI;6312255348;Ne;3;1;2;6
668;Beržynėlis;VIŠČIUKAI;4786786104;Ne;0;3;0;3
669;Birutės;SKRUZDELIUKŲ;4968068043;Ne;7;0;0;7
670;Birutės;SKRUZDELIUKŲ;1761065941;Ne;6;2;0;8
671;Birutės;SKRUZDELIUKŲ;9610268046;Ne;8;0;1;9
672;Birutės;SKRUZDELIUKŲ;4027700332;Ne;3;0;0;3
673;Birutės;SKRUZDELIUKŲ;7685356079;Ne;4;0;1;5
674;Birutės;SKRUZDELIUKŲ;8636113039;Ne;7;4;0;11
675;Birutės;SKRUZDELIUKŲ;9411016611;Ne;0;0;1;1
676;Birutės;SKRUZDELIUKŲ;7119951690;Ne;10;2;0;12
677;Birutės;SKRUZDELIUKŲ;1945532852;Ne;0;2;1;3
678;Birutės;SKRUZDELIUKŲ;5154903444;Ne;0;2;1;3
679;Birutės;SKRUZDELIUKŲ;9541516589;Ne;5;0;2;7
680;Birutės;SKRUZDELIUKŲ;6815916679;Ne;6;2;0;8
681;Birutės;SKRUZDELIUKŲ;9187671201;Ne;4;2;1;7
682;Birutės;SKRUZDELIUKŲ;2140552221;Ne;0;0;3;3
683;Birutės;SKRUZDELIUKŲ;8413760872;Ne;9;2;0;11
684;Birutės;SKRUZDELIUKŲ;7940403585;Ne;0;4;0;4
685;Birutės;SKRUZDELIUKŲ;4375683234;Ne;0;2;0;2
686;Birutės;SKRUZDELIUKŲ;8432173636;Ne;0;0;3;3
687;Birutės;SKRUZDELIUKŲ;9904827482;Ne;0;3;0;3
688;Birutės;SKRUZDELIUKŲ;2859160609;Ne;6;2;0;8
689;Birutės;SKRUZDELIUKŲ;9479697733;Ne;0;2;1;3
690;Birutės;SKRUZDELIUKŲ;2329522074;Ne;0;1;1;2
691;Birutės;SKRUZDELIUKŲ;1072357835;Ne;0;4;1;5
692;Birutės;BITUČIŲ;2866807046;Ne;0;0;2;2
693;Birutės;BITUČIŲ;7477555732;Ne;0;0;2;2
694;Birutės;BITUČIŲ;3991168916;Ne;2;0;3;5
695;Birutės;BITUČIŲ;7859284810;Ne;0;0;2;2
696;Birutės;BITUČIŲ;9147604398;Ne;5;0;3;8
697;Birutės;BITUČIŲ;3562960250;Ne;0;0;4;4
698;Birutės;BITUČIŲ;4647941243;Ne;0;0;2;2
699;Birutės;BITUČIŲ;6931635742;Ne;0;0;2;2
700;Birutės;BITUČIŲ;5443447213;Ne;7;0;4;11
701;Birutės;BITUČIŲ;8736343179;Ne;6;0;5;11
702;Birutės;BITUČIŲ;9627882026;Ne;0;0;1;1
703;Birutės;BITUČIŲ;2046634392;Ne;0;0;1;1
704;Birutės;BITUČIŲ;3993249933;Ne;0;0;1;1
705;Birutės;BITUČIŲ;4102490815;Ne;0;2;1;3
706;Birutės;BITUČIŲ;3584029960;Ne;13;0;3;16
707;Birutės;BITUČIŲ;7875884277;Ne;14;1;2;17
708;Birutės;BORUŽIUKAI;5893851353;Ne;12;2;0;14
709;Birutės;BORUŽIUKAI;5457357625;Ne;0;2;1;3
710;Birutės;BORUŽIUKAI;5869137292;Ne;4;1;0;5
711;Birutės;BORUŽIUKAI;5026442722;Ne;0;6;0;6
712;Birutės;BORUŽIUKAI;6977276295;Ne;15;0;0;15
713;Birutės;BORUŽIUKAI;9289922622;Ne;0;0;3;3
714;Birutės;BORUŽIUKAI;8011210158;Ne;9;0;0;9
715;Birutės;BORUŽIUKAI;9263238557;Ne;0;3;0;3
716;Birutės;BORUŽIUKAI;4488481136;Ne;0;0;6;6
717;Birutės;BORUŽIUKAI;6460415179;Ne;0;2;1;3
718;Birutės;BORUŽIUKAI;6973898557;Ne;0;1;0;1
719;Birutės;BORUŽIUKAI;7033907787;Ne;0;0;2;2
720;Birutės;BORUŽIUKAI;5745377474;Ne;12;2;0;14
721;Birutės;BORUŽIUKAI;5897671273;Ne;6;0;2;8
722;Birutės;BORUŽIUKAI;2016711225;Ne;3;2;0;5
723;Birutės;BORUŽIUKAI;7712882120;Ne;0;0;1;1
724;Birutės;BORUŽIUKAI;7741922416;Ne;0;16;0;16
725;Birutės;BORUŽIUKAI;1776142202;Ne;0;0;1;1
726;Birutės;BORUŽIUKAI;4906874758;Ne;0;1;0;1
727;Birutės;BORUŽIUKAI;2681370776;Taip;0;0;5;5
728;Birutės;BORUŽIUKAI;7398022393;Ne;5;2;2;9
729;Birutės;DRUGELIAI;8854957814;Ne;3;0;2;5
730;Birutės;DRUGELIAI;6263985683;Ne;9;1;0;10
731;Birutės;DRUGELIAI;5957267018;Ne;3;0;3;6
732;Birutės;DRUGELIAI;1442496209;Ne;4;1;0;5
733;Birutės;DRUGELIAI;2318034045;Ne;5;0;2;7
734;Birutės;DRUGELIAI;3516719248;Ne;0;2;2;4
735;Birutės;DRUGELIAI;5688633357;Ne;10;0;5;15
736;Birutės;DRUGELIAI;8559820030;Ne;10;2;10;22
737;Birutės;DRUGELIAI;9307655828;Ne;2;0;4;6
738;Birutės;DRUGELIAI;3115571205;Ne;0;5;0;5
739;Birutės;DRUGELIAI;4674152995;Ne;0;2;0;2
740;Birutės;DRUGELIAI;5177528200;Ne;0;0;6;6
741;Birutės;DRUGELIAI;3391101786;Ne;0;0;2;2
742;Birutės;DRUGELIAI;2257683802;Ne;0;0;2;2
743;Birutės;DRUGELIAI;7336936451;Ne;0;13;0;13
744;Birutės;DRUGELIAI;4995437657;Ne;2;0;2;4
745;Bitutė;Aitvariukų;4474600934;Ne;5;0;2;7
746;Bitutė;Aitvariukų;5606049201;Ne;5;3;5;13
747;Bitutė;Aitvariukų;6035394425;Ne;18;4;2;24
748;Bitutė;Aitvariukų;7132616264;Ne;6;9;2;17
749;Bitutė;Aitvariukų;6030674568;Ne;25;0;3;28
750;Bitutė;Aitvariukų;9747786638;Ne;4;3;2;9
751;Bitutė;Aitvariukų;8259512455;Ne;4;3;5;12
752;Bitutė;Aitvariukų;2899217019;Ne;10;0;4;14
753;Bitutė;Aitvariukų;8670124052;Ne;0;2;1;3
754;Bitutė;Aitvariukų;1340530611;Ne;2;7;2;11
755;Bitutė;Aitvariukų;6759511692;Ne;0;2;0;2
756;Bitutė;Aitvariukų;4164058783;Ne;11;0;3;14
757;Bitutė;Aitvariukų;8908052679;Ne;2;0;0;2
758;Bitutė;Aitvariukų;4924483609;Ne;7;4;2;13
759;Bitutė;Aitvariukų;7447624247;Ne;5;4;2;11
760;Bitutė;Aitvariukų;5880651175;Ne;0;0;4;4
761;Bitutė;Aitvariukų;7433169909;Ne;0;9;0;9
762;Bitutė;Ežiukų;5126303823;Ne;9;1;2;12
763;Bitutė;Ežiukų;4764586168;Ne;5;2;2;9
764;Bitutė;Ežiukų;8905075899;Ne;0;0;3;3
765;Bitutė;Ežiukų;3600670185;Ne;0;2;0;2
766;Bitutė;Ežiukų;6341806464;Ne;2;0;0;2
767;Bitutė;Ežiukų;2812580726;Ne;0;4;3;7
768;Bitutė;Ežiukų;8186706520;Ne;0;22;0;22
769;Bitutė;Ežiukų;5378885117;Ne;1;3;2;6
770;Bitutė;Ežiukų;2122052883;Ne;2;2;2;6
771;Bitutė;Ežiukų;4444523140;Ne;0;7;2;9
772;Bitutė;Ežiukų;4024758152;Ne;0;2;0;2
773;Bitutė;Ežiukų;6194712643;Ne;0;2;0;2
774;Bitutė;Ežiukų;4468366941;Ne;2;2;2;6
775;Bitutė;Ežiukų;5188828679;Ne;0;6;0;6
776;Bitutė;Ežiukų;8109028957;Ne;0;6;0;6
777;Bitutė;Ežiukų;3156654672;Ne;0;5;2;7
778;Bitutė;Ežiukų;9106644834;Ne;0;7;1;8
779;Bitutė;Ežiukų;1397711778;Ne;0;2;0;2
780;Bitutė;Ežiukų;5146691157;Ne;1;0;0;1
781;Bitutė;Žvirbliukų;1290146001;Ne;14;0;3;17
782;Bitutė;Žvirbliukų;6226996242;Ne;7;10;0;17
783;Bitutė;Žvirbliukų;1460746240;Ne;2;0;2;4
784;Bitutė;Žvirbliukų;3359918177;Ne;8;2;2;12
785;Bitutė;Žvirbliukų;9352292654;Taip;5;9;3;17
786;Bitutė;Žvirbliukų;2819417600;Ne;0;2;0;2
787;Bitutė;Žvirbliukų;5421744666;Ne;12;0;0;12
788;Bitutė;Žvirbliukų;9780599803;Ne;13;2;2;17
789;Bitutė;Žvirbliukų;7741454857;Ne;26;0;2;28
790;Bitutė;Žvirbliukų;6091108131;Ne;17;0;2;19
791;Bitutė;Žvirbliukų;4617493676;Ne;32;0;0;32
792;Bitutė;Žvirbliukų;3860047703;Taip;7;0;3;10
793;Bitutė;Žvirbliukų;5375847129;Ne;0;2;0;2
794;Bitutė;Žvirbliukų;3806852067;Ne;16;3;2;21
795;Bitutė;Žvirbliukų;3528436838;Ne;15;0;3;18
796;Bitutė;Žvirbliukų;2583001947;Ne;10;0;2;12
797;Bitutė;Žvirbliukų;2129484313;Ne;3;0;2;5
798;Bitutė;Žvirbliukų;2144809294;Ne;9;0;5;14
799;Bitutė;Žvirbliukų;7013249141;Ne;21;0;3;24
800;Bitutė;Žvirbliukų;4524571780;Ne;13;2;4;19
801;Bitutė;Gandriukų;8373296210;Ne;8;2;2;12
802;Bitutė;Gandriukų;8789574593;Ne;0;2;0;2
803;Bitutė;Gandriukų;1985958540;Ne;0;2;0;2
804;Bitutė;Gandriukų;8743960488;Ne;0;2;0;2
805;Bitutė;Gandriukų;9451529077;Ne;0;3;0;3
806;Bitutė;Gandriukų;9217178863;Ne;0;2;0;2
807;Bitutė;Gandriukų;4639968278;Ne;8;3;3;14
808;Bitutė;Gandriukų;1907876695;Ne;0;2;0;2
809;Bitutė;Gandriukų;7720798466;Ne;1;2;2;5
810;Bitutė;Gandriukų;1662815358;Ne;0;3;0;3
811;Bitutė;Gandriukų;1733189730;Ne;0;3;0;3
812;Bitutė;Gandriukų;4566919587;Ne;12;2;6;20
813;Bitutė;Gandriukų;9966437881;Ne;0;2;0;2
814;Bitutė;Gandriukų;2806899030;Ne;0;12;0;12
815;Bitutė;Gandriukų;1241863345;Ne;8;3;2;13
816;Bitutė;Gandriukų;9465186207;Ne;4;8;2;14
817;Bitutė;Gandriukų;2658405980;Ne;0;6;0;6
818;Bitutė;Pelėdžiukai;2444289145;Ne;11;0;2;13
819;Bitutė;Pelėdžiukai;3517750478;Ne;4;0;2;6
820;Bitutė;Pelėdžiukai;3804171750;Ne;0;2;0;2
821;Bitutė;Pelėdžiukai;8545377054;Ne;0;0;2;2
822;Bitutė;Pelėdžiukai;5406667195;Ne;0;3;0;3
823;Bitutė;Pelėdžiukai;4458990772;Ne;1;3;4;8
824;Bitutė;Pelėdžiukai;3723040682;Ne;0;2;0;2
825;Bitutė;Pelėdžiukai;5291764696;Ne;0;0;3;3
826;Bitutė;Pelėdžiukai;6014726741;Ne;0;1;2;3
827;Bitutė;Pelėdžiukai;4527880105;Ne;3;2;1;6
828;Bitutė;Pelėdžiukai;2190439190;Ne;0;13;0;13
829;Bitutė;Pelėdžiukai;9834697190;Ne;0;0;1;1
830;Bitutė;Pelėdžiukai;7113693496;Ne;0;6;1;7
831;Bitutė;Pelėdžiukai;9523588597;Ne;2;0;2;4
832;Bitutė;Pelėdžiukai;7047262367;Ne;9;2;0;11
833;Bitutė;Pelėdžiukai;2483462846;Ne;5;2;2;9
834;Bitutė;Pelėdžiukai;9166624750;Ne;0;2;0;2
835;Bitutė;Pelėdžiukai;8373105196;Ne;1;6;2;9
836;Bitutė;Boružėlių;8276590981;Ne;26;0;4;30
837;Bitutė;Boružėlių;3026526421;Ne;2;0;3;5
838;Bitutė;Boružėlių;7503203424;Ne;8;0;6;14
839;Bitutė;Boružėlių;1711888057;Ne;6;0;2;8
840;Bitutė;Boružėlių;8355346371;Ne;8;0;2;10
841;Bitutė;Boružėlių;9545405359;Ne;1;0;4;5
842;Bitutė;Boružėlių;9691450767;Ne;3;0;7;10
843;Bitutė;Boružėlių;3170266155;Ne;5;0;5;10
844;Bitutė;Boružėlių;6455582149;Ne;9;0;3;12
845;Bitutė;Boružėlių;8011051470;Ne;5;0;8;13
846;Bitutė;Boružėlių;9521938997;Ne;2;0;3;5
847;Bitutė;Boružėlių;9668365838;Ne;8;7;4;19
848;Bitutė;Boružėlių;3870675531;Ne;6;0;5;11
849;Bitutė;Boružėlių;7095475821;Taip;6;0;2;8
850;Bitutė;Boružėlių;6255439813;Ne;18;1;2;21
851;Bitutė;Boružėlių;2623999429;Ne;0;1;0;1
852;Bitutė;Boružėlių;6840722112;Ne;3;0;3;6
853;Bitutė;Boružėlių;4884898917;Ne;1;10;4;15
854;Bitutė;Boružėlių;4869423833;Ne;6;0;6;12
855;Bitutė;Boružėlių;5071978105;Ne;0;0;4;4
856;Bitutė;Šokliukų;8211710975;Ne;15;2;2;19
857;Bitutė;Šokliukų;8872286273;Ne;6;2;4;12
858;Bitutė;Šokliukų;5169768042;Ne;0;10;0;10
859;Bitutė;Šokliukų;1348548294;Ne;5;3;2;10
860;Bitutė;Šokliukų;7318555933;Ne;0;5;0;5
861;Bitutė;Šokliukų;1012702386;Ne;5;3;0;8
862;Bitutė;Šokliukų;9924340801;Ne;0;2;0;2
863;Bitutė;Šokliukų;7165511381;Ne;4;11;2;17
864;Bitutė;Šokliukų;2853616585;Ne;0;2;2;4
865;Bitutė;Šokliukų;5109258680;Ne;5;1;2;8
866;Bitutė;Šokliukų;3417576747;Ne;10;0;3;13
867;Bitutė;Šokliukų;8422448947;Ne;3;5;2;10
868;Bitutė;Šokliukų;7926482326;Ne;7;4;2;13
869;Bitutė;Šokliukų;5876700984;Ne;0;4;0;4
870;Bitutė;Šokliukų;2177537591;Ne;10;4;0;14
871;Bitutė;Šokliukų;5759407291;Ne;0;2;0;2
872;Bitutė;Šokliukų;4471813998;Ne;0;2;0;2
873;Bitutė;Šokliukų;9234090775;Ne;9;1;0;10
874;Bitutė;Drugelių;9094567866;Ne;0;0;3;3
875;Bitutė;Drugelių;5759595005;Ne;10;0;3;13
876;Bitutė;Drugelių;2085899696;Ne;3;2;2;7
877;Bitutė;Drugelių;2029309955;Ne;5;2;2;9
878;Bitutė;Drugelių;5845408472;Ne;3;3;2;8
879;Bitutė;Drugelių;3611348253;Ne;0;2;2;4
880;Bitutė;Drugelių;8727525320;Ne;0;2;1;3
881;Bitutė;Drugelių;5796600501;Ne;1;0;2;3
882;Bitutė;Drugelių;1558826102;Ne;8;0;2;10
883;Bitutė;Drugelių;6325890676;Ne;21;0;3;24
884;Bitutė;Drugelių;2848732083;Ne;4;0;4;8
885;Bitutė;Drugelių;5278510767;Ne;3;1;2;6
886;Bitutė;Drugelių;8962725357;Ne;0;7;0;7
887;Bitutė;Drugelių;5471241132;Ne;3;0;4;7
888;Bitutė;Drugelių;1218462939;Ne;1;2;2;5
889;Bitutė;Drugelių;8008237092;Ne;6;2;10;18
890;Bitutė;Drugelių;4545188971;Ne;25;1;2;28
891;Bitutė;Drugelių;9492898584;Ne;8;1;2;11
892;Bitutė;Kiškučių;3603716923;Ne;8;4;4;16
893;Bitutė;Kiškučių;5181958187;Ne;9;6;6;21
894;Bitutė;Kiškučių;4480187618;Ne;1;0;2;3
895;Bitutė;Kiškučių;4926289620;Ne;5;0;6;11
896;Bitutė;Kiškučių;7694916340;Ne;1;0;4;5
897;Bitutė;Kiškučių;5061164237;Ne;2;1;2;5
898;Bitutė;Kiškučių;8130382253;Ne;3;1;2;6
899;Bitutė;Kiškučių;5869737425;Ne;12;0;6;18
900;Bitutė;Kiškučių;5220694242;Ne;6;0;2;8
901;Bitutė;Kiškučių;8303932330;Ne;0;1;3;4
902;Bitutė;Kiškučių;8642411661;Ne;0;1;4;5
903;Bitutė;Kiškučių;9909017070;Ne;0;3;0;3
904;Bitutė;Kiškučių;3811028304;Ne;14;2;2;18
905;Bitutė;Kiškučių;9592567172;Ne;3;10;2;15
906;Bitutė;Kiškučių;7535583229;Ne;0;0;2;2
907;Bitutė;Kiškučių;7619112317;Ne;0;3;0;3
908;Bitutė;Kiškučių;8896842164;Ne;2;0;3;5
909;Bitutė;Kiškučių;8561037889;Ne;3;2;2;7
910;Bitutė;"Viščiukų ";2707925569;Ne;12;0;4;16
911;Bitutė;"Viščiukų ";9872069356;Ne;13;0;6;19
912;Bitutė;"Viščiukų ";7341046095;Ne;8;0;9;17
913;Bitutė;"Viščiukų ";9325422338;Ne;9;14;0;23
914;Bitutė;"Viščiukų ";1147029462;Taip;25;0;2;27
915;Bitutė;"Viščiukų ";9653424274;Ne;5;2;5;12
916;Bitutė;"Viščiukų ";3318389039;Ne;18;0;2;20
917;Bitutė;"Viščiukų ";7301966217;Ne;2;0;3;5
918;Bitutė;"Viščiukų ";4864590214;Taip;27;0;3;30
919;Bitutė;"Viščiukų ";5111232226;Ne;3;2;2;7
920;Bitutė;"Viščiukų ";7384402285;Ne;5;0;5;10
921;Bitutė;"Viščiukų ";6045476884;Ne;10;2;2;14
922;Bitutė;"Viščiukų ";7566001042;Ne;7;0;6;13
923;Bitutė;"Viščiukų ";2368846393;Ne;6;0;4;10
924;Bitutė;"Viščiukų ";4041036896;Ne;2;0;2;4
925;Bitutė;"Skruzdėliukai ";5686278261;Ne;9;2;2;13
926;Bitutė;"Skruzdėliukai ";1423694056;Ne;0;0;3;3
927;Bitutė;"Skruzdėliukai ";5942493696;Ne;0;2;2;4
928;Bitutė;"Skruzdėliukai ";6311396261;Ne;1;3;2;6
929;Bitutė;"Skruzdėliukai ";7145036085;Ne;7;0;2;9
930;Bitutė;"Skruzdėliukai ";2252157473;Ne;0;0;3;3
931;Bitutė;"Skruzdėliukai ";6169426273;Ne;1;2;2;5
932;Bitutė;"Skruzdėliukai ";4513783927;Ne;0;0;2;2
933;Bitutė;"Skruzdėliukai ";8667259778;Ne;3;0;1;4
934;Bitutė;"Skruzdėliukai ";8607718704;Ne;2;0;1;3
935;Bitutė;"Skruzdėliukai ";4413880918;Ne;24;0;2;26
936;Bitutė;"Skruzdėliukai ";9436414962;Ne;3;3;2;8
937;Bitutė;"Skruzdėliukai ";9864771568;Ne;5;2;1;8
938;Bitutė;"Skruzdėliukai ";6353690252;Ne;5;0;4;9
939;Bitutė;"Skruzdėliukai ";2160735504;Ne;3;0;2;5
940;Bitutė;"Skruzdėliukai ";1387310054;Ne;2;0;0;2
941;Bitutė;"Skruzdėliukai ";7245807233;Ne;13;0;3;16
942;Bitutė;"Skruzdėliukai ";4467090141;Ne;2;0;1;3
943;Bitutė;"Skruzdėliukai ";5433617195;Ne;0;11;0;11
944;Bitutė;"Skruzdėliukai ";2391170362;Ne;0;10;1;11
945;Bitutė;"Skruzdėliukai ";5490753578;Ne;6;0;7;13
946;Bitutė;"Nykštukų ";1677780832;Ne;5;2;4;11
947;Bitutė;"Nykštukų ";7093067437;Ne;0;2;1;3
948;Bitutė;"Nykštukų ";7494665747;Ne;4;0;4;8
949;Bitutė;"Nykštukų ";9392119453;Ne;0;32;0;32
950;Bitutė;"Nykštukų ";7618391238;Ne;0;6;0;6
951;Bitutė;"Nykštukų ";7201520408;Ne;0;22;0;22
952;Bitutė;"Nykštukų ";3564872382;Ne;0;0;1;1
953;Bitutė;"Nykštukų ";2779363539;Ne;4;3;2;9
954;Bitutė;"Nykštukų ";1094120235;Ne;3;0;2;5
955;Bitutė;"Nykštukų ";8344844253;Ne;27;0;4;31
956;Bitutė;"Nykštukų ";4341037730;Ne;0;5;0;5
957;Bitutė;"Nykštukų ";6591026369;Ne;1;4;2;7
958;Bitutė;"Nykštukų ";3430153178;Ne;6;2;2;10
959;Bitutė;"Nykštukų ";3938392405;Ne;5;0;5;10
960;Bitutė;"Nykštukų ";5974397461;Ne;8;0;2;10
961;Bitutė;"Nykštukų ";1124437382;Ne;0;2;2;4
962;Coliukė;"Bitutės (A.Kojelavičiaus g. 298)";6725408547;Ne;0;0;6;6
963;Coliukė;"Bitutės (A.Kojelavičiaus g. 298)";2167230398;Ne;0;8;0;8
964;Coliukė;"Bitutės (A.Kojelavičiaus g. 298)";5349969025;Ne;3;0;5;8
965;Coliukė;"Bitutės (A.Kojelavičiaus g. 298)";8767261039;Ne;11;1;4;16
966;Coliukė;"Bitutės (A.Kojelavičiaus g. 298)";7345905007;Ne;5;1;5;11
967;Coliukė;"Bitutės (A.Kojelavičiaus g. 298)";1968467455;Ne;0;2;0;2
968;Coliukė;"Bitutės (A.Kojelavičiaus g. 298)";9462610674;Ne;3;2;2;7
969;Coliukė;"Bitutės (A.Kojelavičiaus g. 298)";4188233426;Ne;0;4;2;6
970;Coliukė;"Bitutės (A.Kojelavičiaus g. 298)";9331485675;Ne;0;2;2;4
971;Coliukė;"Bitutės (A.Kojelavičiaus g. 298)";9879369365;Ne;3;3;2;8
972;Coliukė;"Bitutės (A.Kojelavičiaus g. 298)";4845247006;Ne;0;1;0;1
973;Coliukė;"Bitutės (A.Kojelavičiaus g. 298)";9885547263;Ne;3;2;2;7
974;Coliukė;"Bitutės (A.Kojelavičiaus g. 298)";8517128464;Ne;0;1;0;1
975;Coliukė;"Bitutės (A.Kojelavičiaus g. 298)";7358018315;Ne;6;1;5;12
976;Coliukė;"Bitutės (A.Kojelavičiaus g. 298)";9688432169;Ne;3;0;3;6
977;Coliukė;"Bitutės (A.Kojelavičiaus g. 298)";8478006305;Ne;0;2;5;7
978;Coliukė;"Bitutės (A.Kojelavičiaus g. 298)";9352547729;Ne;0;3;2;5
979;Coliukė;"Bitutės (A.Kojelavičiaus g. 298)";9750447455;Ne;3;2;6;11
980;Coliukė;"Bitutės (A.Kojelavičiaus g. 298)";7621095517;Ne;0;2;0;2
981;Coliukė;"Bitutės (A.Kojelavičiaus g. 298)";2385917598;Ne;0;0;2;2
982;Coliukė;"Bitutės (A.Kojelavičiaus g. 298)";1390751418;Ne;0;1;2;3
983;Coliukė;"Bitutės (A.Kojelavičiaus g. 298)";4881447596;Ne;5;2;2;9
984;Coliukė;"Bitutės (A.Kojelavičiaus g. 298)";2151108735;Ne;4;6;2;12
985;Coliukė;"Boružėlės.spec. (Karklėnų g. 15)";5756690199;Ne;7;0;3;10
986;Coliukė;"Boružėlės.spec. (Karklėnų g. 15)";4422823135;Ne;9;1;4;14
987;Coliukė;"Boružėlės.spec. (Karklėnų g. 15)";2947495861;Ne;9;1;4;14
988;Coliukė;"Boružėlės.spec. (Karklėnų g. 15)";5008183731;Ne;0;1;7;8
989;Coliukė;"Boružėlės.spec. (Karklėnų g. 15)";1134875499;Ne;0;0;5;5
990;Coliukė;"Boružėlės.spec. (Karklėnų g. 15)";2351866339;Ne;3;0;2;5
991;Coliukė;"Boružėlės.spec. (Karklėnų g. 15)";3270283626;Ne;4;2;3;9
992;Coliukė;"Boružėlės.spec. (Karklėnų g. 15)";1326014786;Ne;2;0;7;9
993;Coliukė;"Boružėlės.spec. (Karklėnų g. 15)";7513522378;Ne;0;1;0;1
994;Coliukė;"Boružėlės.spec. (Karklėnų g. 15)";3905904092;Ne;3;1;5;9
995;Coliukė;"Boružėlės.spec. (Karklėnų g. 15)";6534433593;Ne;5;0;2;7
996;Coliukė;"Nykštukai (A.Kojelavičiaus g. 298)";4149083597;Ne;3;0;2;5
997;Coliukė;"Nykštukai (A.Kojelavičiaus g. 298)";5481656345;Ne;0;3;0;3
998;Coliukė;"Nykštukai (A.Kojelavičiaus g. 298)";6483218499;Ne;13;2;2;17
999;Coliukė;"Nykštukai (A.Kojelavičiaus g. 298)";1590896552;Ne;0;3;0;3
1000;Coliukė;"Nykštukai (A.Kojelavičiaus g. 298)";4887837499;Ne;2;0;1;3
1001;Coliukė;"Nykštukai (A.Kojelavičiaus g. 298)";1465212393;Ne;8;6;4;18
1002;Coliukė;"Nykštukai (A.Kojelavičiaus g. 298)";1516038730;Ne;4;0;5;9
1003;Coliukė;"Nykštukai (A.Kojelavičiaus g. 298)";7164457313;Ne;0;7;0;7
1004;Coliukė;"Nykštukai (A.Kojelavičiaus g. 298)";6441253648;Ne;5;2;2;9
1005;Coliukė;"Nykštukai (A.Kojelavičiaus g. 298)";4537756081;Ne;0;8;0;8
1006;Coliukė;"Nykštukai (A.Kojelavičiaus g. 298)";3719547522;Ne;5;5;2;12
1007;Coliukė;"Nykštukai (A.Kojelavičiaus g. 298)";5450167562;Ne;0;1;0;1
1008;Coliukė;"Nykštukai (A.Kojelavičiaus g. 298)";9498557347;Ne;0;7;0;7
1009;Coliukė;"Nykštukai (A.Kojelavičiaus g. 298)";3384332079;Ne;0;1;2;3
1010;Coliukė;"Nykštukai (A.Kojelavičiaus g. 298)";1198781036;Ne;3;3;2;8
1011;Coliukė;"Nykštukai (A.Kojelavičiaus g. 298)";5283583324;Ne;0;2;0;2
1012;Coliukė;"Nykštukai (A.Kojelavičiaus g. 298)";9334564869;Ne;18;2;2;22
1013;Coliukė;"Nykštukai (A.Kojelavičiaus g. 298)";2321127662;Ne;2;0;6;8
1014;Coliukė;"Nykštukai (A.Kojelavičiaus g. 298)";1575061659;Ne;1;2;2;5
1015;Coliukė;"Nykštukai (A.Kojelavičiaus g. 298)";3678496820;Ne;2;0;0;2
1016;Coliukė;"Nykštukai (A.Kojelavičiaus g. 298)";8715608220;Ne;0;4;0;4
1017;Coliukė;"Nykštukai (A.Kojelavičiaus g. 298)";3908791146;Ne;3;1;2;6
1018;Coliukė;"Nykštukai (A.Kojelavičiaus g. 298)";4635299740;Ne;0;12;0;12
1019;Coliukė;"Gėlytės (A.Kojelavičiaus g. 304) ";6226741104;Ne;0;5;0;5
1020;Coliukė;"Gėlytės (A.Kojelavičiaus g. 304) ";1415007991;Ne;1;0;3;4
1021;Coliukė;"Gėlytės (A.Kojelavičiaus g. 304) ";3712638808;Taip;0;1;0;1
1022;Coliukė;"Gėlytės (A.Kojelavičiaus g. 304) ";7500857860;Ne;4;0;6;10
1023;Coliukė;"Gėlytės (A.Kojelavičiaus g. 304) ";2952029073;Ne;0;0;1;1
1024;Coliukė;"Gėlytės (A.Kojelavičiaus g. 304) ";4757165137;Ne;14;0;3;17
1025;Coliukė;"Gėlytės (A.Kojelavičiaus g. 304) ";3693899535;Ne;3;2;2;7
1026;Coliukė;"Gėlytės (A.Kojelavičiaus g. 304) ";3419764892;Taip;16;0;2;18
1027;Coliukė;"Gėlytės (A.Kojelavičiaus g. 304) ";7259282073;Ne;0;17;0;17
1028;Coliukė;"Gėlytės (A.Kojelavičiaus g. 304) ";4618661887;Ne;22;0;0;22
1029;Coliukė;"Gėlytės (A.Kojelavičiaus g. 304) ";4327259627;Ne;0;3;0;3
1030;Coliukė;"Drugeliai  (A.Kojelavičiaus g. 304)  ";6675290003;Ne;11;2;2;15
1031;Coliukė;"Drugeliai  (A.Kojelavičiaus g. 304)  ";8202294275;Ne;9;0;4;13
1032;Coliukė;"Drugeliai  (A.Kojelavičiaus g. 304)  ";8849541084;Ne;0;6;0;6
1033;Coliukė;"Drugeliai  (A.Kojelavičiaus g. 304)  ";8756465257;Ne;3;3;2;8
1034;Coliukė;"Drugeliai  (A.Kojelavičiaus g. 304)  ";6102405328;Ne;0;0;5;5
1035;Coliukė;"Drugeliai  (A.Kojelavičiaus g. 304)  ";1861955437;Ne;0;3;0;3
1036;Coliukė;"Drugeliai  (A.Kojelavičiaus g. 304)  ";1220834062;Taip;0;1;0;1
1037;Coliukė;"Drugeliai  (A.Kojelavičiaus g. 304)  ";3392367716;Ne;0;2;0;2
1038;Coliukė;"Drugeliai  (A.Kojelavičiaus g. 304)  ";6611713551;Ne;20;0;2;22
1039;Coliukė;"Drugeliai  (A.Kojelavičiaus g. 304)  ";6755886435;Ne;0;2;1;3
1040;Coliukė;"Drugeliai  (A.Kojelavičiaus g. 304)  ";1220385522;Ne;0;0;1;1
1041;Coliukė;"Drugeliai  (A.Kojelavičiaus g. 304)  ";1452034828;Ne;7;2;4;13
1042;Coliukė;"Drugeliai  (A.Kojelavičiaus g. 304)  ";6816085304;Ne;0;11;0;11
1043;Coliukė;"Drugeliai  (A.Kojelavičiaus g. 304)  ";6941719947;Taip;0;2;0;2
1044;Coliukė;"Drugeliai  (A.Kojelavičiaus g. 304)  ";5347456579;Ne;4;0;2;6
1045;Coliukė;"Drugeliai  (A.Kojelavičiaus g. 304)  ";8606195508;Taip;7;0;6;13
1046;Coliukė;"Drugeliai  (A.Kojelavičiaus g. 304)  ";2247086548;Ne;3;2;2;7
1047;Coliukė;"Drugeliai  (A.Kojelavičiaus g. 304)  ";9664610507;Ne;11;1;4;16
1048;Čiauškutis;BITUTĖS;7893181156;Ne;0;0;2;2
1049;Čiauškutis;BITUTĖS;7976738303;Ne;3;0;4;7
1050;Čiauškutis;BITUTĖS;4026881335;Ne;0;0;2;2
1051;Čiauškutis;BITUTĖS;9753680961;Ne;1;0;2;3
1052;Čiauškutis;BITUTĖS;4852837431;Ne;0;0;2;2
1053;Čiauškutis;BITUTĖS;4652951382;Ne;0;0;6;6
1054;Čiauškutis;BITUTĖS;3837360101;Ne;0;1;0;1
1055;Čiauškutis;BITUTĖS;2319237497;Ne;11;0;4;15
1056;Čiauškutis;BITUTĖS;1765857419;Ne;0;2;0;2
1057;Čiauškutis;BITUTĖS;7282041196;Ne;0;21;1;22
1058;Čiauškutis;ŽVIRBLIUKAI;5125518366;Ne;5;0;5;10
1059;Čiauškutis;ŽVIRBLIUKAI;4962200863;Ne;7;0;5;12
1060;Čiauškutis;ŽVIRBLIUKAI;7324659239;Ne;0;0;2;2
1061;Čiauškutis;ŽVIRBLIUKAI;9759888353;Ne;0;2;0;2
1062;Čiauškutis;ŽVIRBLIUKAI;1032711865;Ne;0;0;2;2
1063;Čiauškutis;ŽVIRBLIUKAI;4599018314;Ne;0;0;5;5
1064;Čiauškutis;ŽVIRBLIUKAI;1288177637;Ne;0;0;2;2
1065;Čiauškutis;ŽVIRBLIUKAI;7359935733;Ne;3;0;4;7
1066;Čiauškutis;ŽVIRBLIUKAI;5368435217;Ne;0;2;1;3
1067;Čiauškutis;ŽVIRBLIUKAI;8925047375;Ne;5;0;4;9
1068;Čiauškutis;SAULUTĖS;1158816422;Ne;0;20;2;22
1069;Čiauškutis;SAULUTĖS;7239878097;Ne;7;2;2;11
1070;Čiauškutis;SAULUTĖS;7489733038;Ne;0;2;2;4
1071;Čiauškutis;SAULUTĖS;2237570705;Ne;1;0;2;3
1072;Čiauškutis;SAULUTĖS;3724324861;Ne;0;19;3;22
1073;Čiauškutis;SAULUTĖS;8580034134;Ne;1;2;6;9
1074;Čiauškutis;SAULUTĖS;2445742257;Ne;9;10;3;22
1075;Čiauškutis;SAULUTĖS;2737503753;Ne;5;0;3;8
1076;Čiauškutis;SAULUTĖS;7428833348;Ne;0;2;3;5
1077;Čiauškutis;SAULUTĖS;2686038029;Ne;0;0;1;1
1078;Čiauškutis;EŽIUKAI;9565722619;Ne;0;14;5;19
1079;Čiauškutis;EŽIUKAI;7654242839;Ne;4;2;3;9
1080;Čiauškutis;EŽIUKAI;9294208012;Ne;0;0;1;1
1081;Čiauškutis;EŽIUKAI;8297774828;Ne;0;1;0;1
1082;Čiauškutis;EŽIUKAI;6303770262;Ne;5;0;2;7
1083;Čiauškutis;EŽIUKAI;2380881303;Ne;0;2;0;2
1084;Čiauškutis;EŽIUKAI;2829031299;Ne;0;0;1;1
1085;Čiauškutis;EŽIUKAI;5666325776;Ne;0;0;6;6
1086;Čiauškutis;DRUGELIAI;4681902267;Ne;0;2;2;4
1087;Čiauškutis;DRUGELIAI;9959952114;Ne;0;0;4;4
1088;Čiauškutis;DRUGELIAI;1928404791;Ne;0;2;0;2
1089;Čiauškutis;DRUGELIAI;1234494170;Ne;0;0;2;2
1090;Čiauškutis;DRUGELIAI;5404165993;Ne;0;0;1;1
1091;Čiauškutis;DRUGELIAI;9897499968;Ne;4;16;2;22
1092;Čiauškutis;DRUGELIAI;7135435979;Ne;0;2;0;2
1093;Čiauškutis;DRUGELIAI;6726124641;Ne;0;2;3;5
1094;Čiauškutis;GENELIAI;5957587644;Ne;10;2;0;12
1095;Čiauškutis;GENELIAI;5052137859;Ne;0;22;0;22
1096;Čiauškutis;GENELIAI;8876608072;Ne;0;2;7;9
1097;Čiauškutis;GENELIAI;3650541072;Ne;0;5;0;5
1098;Čiauškutis;GENELIAI;6785604459;Ne;7;12;3;22
1099;Čiauškutis;GENELIAI;8679018030;Ne;6;2;3;11
1100;Čiauškutis;GENELIAI;7851357992;Ne;7;2;8;17
1101;Čiauškutis;GENELIAI;7928675053;Ne;0;21;1;22
1102;Čiauškutis;GENELIAI;3644842573;Ne;0;2;0;2
1103;Čiauškutis;GENELIAI;1113437256;Ne;18;2;2;22
1104;Čiauškutis;LINKSMUČIAI;7184626362;Ne;0;1;0;1
1105;Čiauškutis;LINKSMUČIAI;8689127061;Ne;0;2;9;11
1106;Čiauškutis;LINKSMUČIAI;5910818962;Ne;1;2;2;5
1107;Čiauškutis;LINKSMUČIAI;4881821738;Ne;0;1;3;4
1108;Čiauškutis;LINKSMUČIAI;4881821738;Ne;0;1;3;4
1109;Čiauškutis;LINKSMUČIAI;7526975680;Ne;0;0;1;1
1110;Čiauškutis;LINKSMUČIAI;6146321785;Ne;0;2;0;2
1111;Čiauškutis;LINKSMUČIAI;6434727608;Ne;0;2;1;3
1112;Čiauškutis;LINKSMUČIAI;1733251156;Ne;0;2;2;4
1113;Čiauškutis;KIŠKUČIAI;1900086424;Ne;0;3;0;3
1114;Čiauškutis;KIŠKUČIAI;3465024013;Ne;0;18;4;22
1115;Čiauškutis;KIŠKUČIAI;2271458332;Ne;0;0;1;1
1116;Čiauškutis;KIŠKUČIAI;9754417066;Ne;0;18;4;22
1117;Čiauškutis;KIŠKUČIAI;5589764935;Ne;6;0;8;14
1118;Čiauškutis;KIŠKUČIAI;4169517353;Ne;0;1;1;2
1119;Čiauškutis;KIŠKUČIAI;3126627913;Ne;1;2;5;8
1120;Čiauškutis;LAPIUKAI;6810906239;Ne;0;18;4;22
1121;Čiauškutis;LAPIUKAI;9460608737;Ne;0;0;8;8
1122;Čiauškutis;LAPIUKAI;9928767253;Ne;0;19;3;22
1123;Čiauškutis;LAPIUKAI;9702568740;Ne;17;3;2;22
1124;Čiauškutis;LAPIUKAI;5427045039;Ne;2;16;4;22
1125;Čiauškutis;LAPIUKAI;8737871477;Ne;0;20;2;22
1126;Čiauškutis;LAPIUKAI;5842585542;Ne;0;22;0;22
1127;Čiauškutis;LAPIUKAI;6940865564;Ne;3;17;2;22
1128;Čiauškutis;MEŠKUČIAI;2172687454;Ne;0;2;0;2
1129;Čiauškutis;MEŠKUČIAI;3660195990;Ne;10;0;3;13
1130;Čiauškutis;MEŠKUČIAI;6109859056;Ne;0;0;2;2
1131;Čiauškutis;MEŠKUČIAI;4213259879;Ne;6;3;4;13
1132;Čiauškutis;MEŠKUČIAI;1515680948;Ne;0;0;5;5
1133;Čiauškutis;MEŠKUČIAI;6608678558;Ne;0;2;5;7
1134;Čiauškutis;MEŠKUČIAI;7714816675;Ne;9;2;4;15
1135;Čiauškutis;MEŠKUČIAI;9684750515;Ne;3;0;2;5
1136;Čiauškutis;PELĖDŽIUKAI;7931998640;Ne;0;2;3;5
1137;Čiauškutis;PELĖDŽIUKAI;3700692073;Ne;0;0;1;1
1138;Čiauškutis;PELĖDŽIUKAI;6615319751;Ne;13;0;2;15
1139;Čiauškutis;PELĖDŽIUKAI;3298272815;Ne;15;0;4;19
1140;Čiauškutis;NYKŠTUKAI;8948893335;Ne;6;2;2;10
1141;Čiauškutis;NYKŠTUKAI;2633243682;Ne;4;1;2;7
1142;Čiauškutis;NYKŠTUKAI;4037117222;Ne;0;0;2;2
1143;Čiauškutis;NYKŠTUKAI;6705934636;Ne;4;2;2;8
1144;Čiauškutis;NYKŠTUKAI;2044220236;Ne;0;0;4;4
1145;Čiauškutis;NYKŠTUKAI;7335655769;Ne;7;2;3;12
1146;Čiauškutis;NYKŠTUKAI;5686690700;Ne;8;2;4;14
1147;Čiauškutis;NYKŠTUKAI;5734665607;Ne;0;0;1;1
1148;Čiauškutis;NYKŠTUKAI;6051208732;Ne;3;2;2;7
1149;Čiauškutis;NYKŠTUKAI;8626682787;Ne;3;0;4;7
1150;Delfinukas;Boružėlių;8444134791;Ne;5;1;2;8
1151;Delfinukas;Boružėlių;5320485170;Ne;3;2;2;7
1152;Delfinukas;Boružėlių;6878446154;Ne;2;8;2;12
1153;Delfinukas;Boružėlių;1970318187;Ne;10;0;5;15
1154;Delfinukas;Boružėlių;7752786752;Ne;10;0;5;15
1155;Delfinukas;Boružėlių;2459046463;Ne;20;0;2;22
1156;Delfinukas;Boružėlių;2323767897;Ne;13;2;3;18
1157;Delfinukas;Boružėlių;2830904360;Ne;3;0;3;6
1158;Delfinukas;Boružėlių;3015726598;Taip;8;2;2;12
1159;Delfinukas;Boružėlių;1843845065;Ne;6;0;5;11
1160;Delfinukas;Boružėlių;2716595364;Ne;13;2;2;17
1161;Delfinukas;Boružėlių;2450560824;Ne;5;11;6;22
1162;Delfinukas;Saulytės;8315269427;Ne;5;0;5;10
1163;Delfinukas;Saulytės;4215887291;Ne;0;5;0;5
1164;Delfinukas;Saulytės;3631520143;Ne;6;4;2;12
1165;Delfinukas;Saulytės;9424966984;Taip;0;0;5;5
1166;Delfinukas;Saulytės;6069600728;Taip;6;0;4;10
1167;Delfinukas;Saulytės;9729550922;Taip;0;1;0;1
1168;Delfinukas;Saulytės;1404270345;Ne;0;10;0;10
1169;Delfinukas;Saulytės;3842160990;Ne;0;3;0;3
1170;Delfinukas;Saulytės;8402529296;Ne;4;2;2;8
1171;Delfinukas;Saulytės;5642328792;Ne;7;2;2;11
1172;Delfinukas;Saulytės;8176576958;Taip;6;0;6;12
1173;Delfinukas;Saulytės;8275943176;Taip;0;2;4;6
1174;Delfinukas;Saulytės;8085530134;Taip;0;13;0;13
1175;Delfinukas;Saulytės;8148610460;Taip;0;10;0;10
1176;Delfinukas;Saulytės;8186312409;Ne;5;2;2;9
1177;Delfinukas;Saulytės;1873630966;Ne;0;3;0;3
1178;Delfinukas;Saulytės;1953356983;Taip;6;0;4;10
1179;Delfinukas;Pelėdžiukų;3940838205;Taip;0;4;0;4
1180;Delfinukas;Pelėdžiukų;8774145277;Taip;0;8;0;8
1181;Delfinukas;Pelėdžiukų;6113662246;Taip;8;2;12;22
1182;Delfinukas;Pelėdžiukų;4710894128;Taip;0;2;1;3
1183;Delfinukas;Pelėdžiukų;1526129772;Taip;1;1;4;6
1184;Delfinukas;Pelėdžiukų;8659309242;Taip;0;8;0;8
1185;Delfinukas;Pelėdžiukų;8267992425;Ne;0;8;0;8
1186;Delfinukas;Pelėdžiukų;9319874239;Taip;0;2;0;2
1187;Delfinukas;Pelėdžiukų;2809947323;Ne;0;0;5;5
1188;Delfinukas;Pelėdžiukų;4096274346;Taip;8;2;4;14
1189;Delfinukas;Pelėdžiukų;5246300518;Taip;4;0;3;7
1190;Delfinukas;Pelėdžiukų;2420308954;Ne;5;1;2;8
1191;Delfinukas;Pelėdžiukų;6286748047;Taip;0;16;0;16
1192;Delfinukas;Pelėdžiukų;4465504676;Taip;0;4;0;4
1193;Delfinukas;Pelėdžiukų;6282501549;Ne;8;7;2;17
1194;Delfinukas;Pelėdžiukų;6025384346;Ne;8;0;4;12
1195;Delfinukas;Varliukų;4949220786;Ne;8;2;4;14
1196;Delfinukas;Varliukų;2792051636;Taip;3;2;5;10
1197;Delfinukas;Varliukų;4780352568;Ne;5;1;4;10
1198;Delfinukas;Varliukų;3577180085;Taip;6;0;4;10
1199;Delfinukas;Varliukų;6115370195;Ne;1;0;2;3
1200;Delfinukas;Varliukų;3050258185;Ne;6;0;4;10
1201;Delfinukas;Varliukų;7976681530;Ne;0;0;4;4
1202;Delfinukas;Varliukų;4338259551;Ne;1;5;2;8
1203;Delfinukas;Varliukų;6301601832;Ne;3;0;4;7
1204;Delfinukas;Varliukų;5095713834;Ne;13;1;4;18
1205;Delfinukas;Varliukų;5964021733;Ne;4;0;4;8
1206;Delfinukas;Varliukų;5821591959;Ne;10;4;2;16
1207;Delfinukas;Varliukų;5138840297;Ne;1;1;2;4
1208;Delfinukas;Varliukų;7072060541;Ne;4;1;2;7
1209;Delfinukas;Varliukų;3797355501;Ne;10;1;2;13
1210;Delfinukas;Varliukų;4751611934;Ne;0;3;0;3
1211;Delfinukas;Varliukų;4254414928;Ne;8;2;4;14
1212;Delfinukas;Varliukų;7359531377;Ne;7;2;4;13
1213;Delfinukas;Varpelių;8913681176;Ne;0;6;1;7
1214;Delfinukas;Varpelių;9514189769;Ne;0;4;0;4
1215;Delfinukas;Varpelių;3818558339;Ne;0;0;3;3
1216;Delfinukas;Varpelių;1484123788;Ne;2;1;5;8
1217;Delfinukas;Varpelių;9218154624;Ne;9;0;4;13
1218;Delfinukas;Varpelių;8950528288;Ne;0;0;2;2
1219;Delfinukas;Varpelių;8829835426;Ne;0;0;3;3
1220;Delfinukas;Varpelių;6938708939;Ne;0;2;0;2
1221;Delfinukas;Varpelių;9898427089;Ne;12;1;2;15
1222;Delfinukas;Varpelių;2730512600;Ne;3;3;2;8
1223;Delfinukas;Varpelių;8911433659;Ne;0;0;2;2
1224;Delfinukas;Varpelių;6952314149;Ne;8;1;13;22
1225;Delfinukas;Varpelių;3795705735;Ne;0;5;0;5
1226;Delfinukas;Varpelių;4101463768;Ne;0;0;3;3
1227;Delfinukas;Varpelių;5467211088;Ne;6;2;2;10
1228;Delfinukas;Varpelių;7780893730;Ne;0;1;0;1
1229;Delfinukas;Varpelių;6071660741;Ne;6;4;3;13
1230;Delfinukas;Drugeliai;7615519932;Ne;4;2;2;8
1231;Delfinukas;Drugeliai;6604115681;Ne;8;7;2;17
1232;Delfinukas;Drugeliai;5990192934;Ne;10;2;4;16
1233;Delfinukas;Drugeliai;9635669748;Ne;2;7;2;11
1234;Delfinukas;Drugeliai;8526813977;Ne;2;7;2;11
1235;Delfinukas;Drugeliai;6873181103;Ne;0;5;0;5
1236;Delfinukas;Drugeliai;4484804360;Ne;0;5;0;5
1237;Delfinukas;Drugeliai;8328481987;Ne;8;3;2;13
1238;Delfinukas;Drugeliai;6992505341;Ne;0;2;2;4
1239;Delfinukas;Drugeliai;8129592398;Ne;3;1;3;7
1240;Delfinukas;Drugeliai;9927854348;Ne;3;0;2;5
1241;Delfinukas;Drugeliai;2756574162;Ne;0;4;1;5
1242;Delfinukas;Drugeliai;2985669766;Ne;7;1;2;10
1243;Delfinukas;Drugeliai;7609115506;Ne;8;2;2;12
1244;Delfinukas;Drugeliai;6457042338;Ne;15;5;2;22
1245;Delfinukas;Drugeliai;3134897964;Ne;5;3;2;10
1246;Delfinukas;Drugeliai;8411289299;Ne;0;2;0;2
1247;Delfinukas;Drugeliai;2683746435;Ne;3;0;3;6
1248;Delfinukas;Žuvytės;1918878505;Ne;6;1;4;11
1249;Delfinukas;Žuvytės;1575125658;Taip;8;1;2;11
1250;Delfinukas;Žuvytės;7354837777;Ne;14;0;2;16
1251;Delfinukas;Žuvytės;8884939114;Ne;4;3;2;9
1252;Delfinukas;Žuvytės;9253061888;Ne;6;0;4;10
1253;Delfinukas;Žuvytės;1296440609;Ne;10;0;4;14
1254;Delfinukas;Žuvytės;5665463557;Ne;8;0;4;12
1255;Delfinukas;Žuvytės;5646198202;Ne;4;0;3;7
1256;Delfinukas;Žuvytės;9686085316;Ne;4;0;5;9
1257;Delfinukas;Žuvytės;7464957954;Ne;12;0;4;16
1258;Delfinukas;Žuvytės;5281161835;Ne;9;0;5;14
1259;Delfinukas;Žuvytės;2425621326;Ne;8;0;2;10
1260;Delfinukas;Žuvytės;4782384361;Ne;7;0;5;12
1261;Delfinukas;Žuvytės;6865463448;Ne;5;1;5;11
1262;Delfinukas;Žuvytės;9773069890;Ne;11;0;4;15
1263;Delfinukas;Žuvytės;5397241026;Ne;3;5;2;10
1264;Delfinukas;Delfinai;5241426445;Ne;0;3;0;3
1265;Delfinukas;Delfinai;8099120371;Taip;7;2;4;13
1266;Delfinukas;Delfinai;7663934825;Ne;0;6;0;6
1267;Delfinukas;Delfinai;2382077576;Ne;0;1;0;1
1268;Delfinukas;Delfinai;7629622746;Ne;0;1;0;1
1269;Delfinukas;Delfinai;1922513830;Taip;3;0;2;5
1270;Delfinukas;Delfinai;6270012707;Ne;3;5;2;10
1271;Delfinukas;Delfinai;8085481968;Ne;0;2;0;2
1272;Delfinukas;Delfinai;8415516743;Ne;3;0;4;7
1273;Delfinukas;Delfinai;4855210424;Taip;0;1;3;4
1274;Delfinukas;Delfinai;3465399369;Taip;3;0;2;5
1275;Delfinukas;Delfinai;2890469172;Ne;20;0;2;22
1276;Delfinukas;Paukšteliai;7366145460;Ne;3;0;2;5
1277;Delfinukas;Paukšteliai;6002086491;Ne;0;2;1;3
1278;Delfinukas;Paukšteliai;1164720538;Ne;2;5;2;9
1279;Delfinukas;Paukšteliai;9351906710;Ne;3;0;2;5
1280;Delfinukas;Paukšteliai;9629225917;Ne;0;0;1;1
1281;Delfinukas;Paukšteliai;9332794060;Ne;8;0;2;10
1282;Delfinukas;Paukšteliai;6650725760;Ne;16;0;4;20
1283;Delfinukas;Paukšteliai;9776618488;Ne;13;0;2;15
1284;Delfinukas;Paukšteliai;4561911078;Ne;2;0;7;9
1285;Delfinukas;Paukšteliai;9289866851;Ne;13;0;4;17
1286;Delfinukas;Paukšteliai;1746566943;Ne;8;0;4;12
1287;Delfinukas;Paukšteliai;2186801708;Ne;3;8;2;13
1288;Delfinukas;Kiškučiai;5585334518;Ne;0;4;0;4
1289;Delfinukas;Kiškučiai;4196156707;Ne;0;2;0;2
1290;Delfinukas;Kiškučiai;5443027988;Ne;0;8;0;8
1291;Delfinukas;Kiškučiai;6301767635;Ne;18;0;2;20
1292;Delfinukas;Kiškučiai;4488260667;Ne;0;2;1;3
1293;Delfinukas;Kiškučiai;9184207705;Ne;0;4;0;4
1294;Delfinukas;Kiškučiai;2163238846;Ne;10;0;2;12
1295;Delfinukas;Kiškučiai;9747075687;Ne;0;13;0;13
1296;Delfinukas;Kiškučiai;4327924499;Ne;9;0;4;13
1297;Delfinukas;Kiškučiai;7312438969;Taip;2;1;2;5
1298;Delfinukas;Kiškučiai;6693756145;Ne;6;0;6;12
1299;Delfinukas;Kiškučiai;3205671100;Taip;0;4;1;5
1300;Delfinukas;Kiškučiai;4755699845;Ne;12;2;2;16
1301;Delfinukas;Kiškučiai;5164599763;Taip;11;0;4;15
1302;Delfinukas;Kiškučiai;9586646352;Ne;0;0;1;1
1303;Delfinukas;Kiškučiai;3487670354;Ne;2;1;4;7
1304;Delfinukas;Kiškučiai;9073634575;Ne;7;0;2;9
1305;Delfinukas;BITUTĖS;9719348837;Taip;10;0;3;13
1306;Delfinukas;BITUTĖS;6601922746;Ne;16;0;2;18
1307;Delfinukas;BITUTĖS;8896957908;Ne;11;0;4;15
1308;Delfinukas;BITUTĖS;3239635507;Ne;4;0;4;8
1309;Delfinukas;BITUTĖS;5339993544;Taip;0;2;2;4
1310;Delfinukas;BITUTĖS;6929926768;Taip;0;8;0;8
1311;Delfinukas;BITUTĖS;5557399916;Ne;8;3;3;14
1312;Delfinukas;BITUTĖS;8937594052;Taip;7;2;4;13
1313;Delfinukas;BITUTĖS;5179080544;Taip;15;3;2;20
1314;Delfinukas;BITUTĖS;7727263761;Ne;7;0;4;11
1315;Delfinukas;BITUTĖS;9941631164;Ne;3;9;2;14
1316;Delfinukas;BITUTĖS;4198261848;Taip;3;4;2;9
1317;Delfinukas;BITUTĖS;8081895401;Ne;8;0;2;10
1318;Delfinukas;BITUTĖS;9195828884;Ne;8;5;2;15
1319;Delfinukas;BITUTĖS;8552371520;Ne;7;0;4;11
1320;Delfinukas;BITUTĖS;2377204734;Ne;2;8;2;12
1321;Delfinukas;BITUTĖS;6243471374;Ne;4;9;2;15
1322;Delfinukas;BITUTĖS;4303234827;Ne;18;2;2;22
1323;Delfinukas;BITUTĖS;6325092903;Ne;9;2;4;15
1324;Drevinukas;ZUIKUČIAI;5500759834;Ne;0;0;1;1
1325;Drevinukas;ZUIKUČIAI;9817317105;Ne;2;0;3;5
1326;Drevinukas;ZUIKUČIAI;1595081335;Ne;1;4;4;9
1327;Drevinukas;ZUIKUČIAI;2646799484;Ne;3;0;4;7
1328;Drevinukas;ZUIKUČIAI;2772424629;Ne;0;2;5;7
1329;Drevinukas;ZUIKUČIAI;5928234487;Ne;0;2;0;2
1330;Drevinukas;ZUIKUČIAI;8873060121;Ne;0;0;3;3
1331;Drevinukas;ZUIKUČIAI;1567790084;Ne;0;0;6;6
1332;Drevinukas;ZUIKUČIAI;3293457412;Ne;0;7;0;7
1333;Drevinukas;ZUIKUČIAI;6243097297;Ne;1;2;6;9
1334;Drevinukas;ZUIKUČIAI;5704489483;Ne;2;0;2;4
1335;Drevinukas;ZUIKUČIAI;5887233286;Ne;0;3;0;3
1336;Drevinukas;ZUIKUČIAI;3381363132;Ne;7;3;4;14
1337;Drevinukas;ZUIKUČIAI;9174977150;Ne;0;2;0;2
1338;Drevinukas;ZUIKUČIAI;4243045398;Ne;22;0;0;22
1339;Drevinukas;ZUIKUČIAI;4309475233;Ne;22;0;0;22
1340;Drevinukas;ZUIKUČIAI;6393960467;Ne;0;5;1;6
1341;Drevinukas;ZUIKUČIAI;5578749226;Ne;3;0;4;7
1342;Drevinukas;AŽUOLIUKŲ;1644656704;Ne;0;4;0;4
1343;Drevinukas;AŽUOLIUKŲ;5721031754;Ne;3;2;2;7
1344;Drevinukas;AŽUOLIUKŲ;4714478955;Ne;0;2;0;2
1345;Drevinukas;AŽUOLIUKŲ;8701250912;Ne;4;0;2;6
1346;Drevinukas;AŽUOLIUKŲ;8143614891;Ne;0;9;0;9
1347;Drevinukas;AŽUOLIUKŲ;5673244101;Ne;0;3;0;3
1348;Drevinukas;AŽUOLIUKŲ;3643007998;Ne;0;4;2;6
1349;Drevinukas;AŽUOLIUKŲ;4262951360;Ne;7;0;3;10
1350;Drevinukas;AŽUOLIUKŲ;7689145214;Ne;0;2;0;2
1351;Drevinukas;AŽUOLIUKŲ;4572837478;Ne;0;8;0;8
1352;Drevinukas;AŽUOLIUKŲ;1564065835;Ne;0;6;0;6
1353;Drevinukas;AŽUOLIUKŲ;9289471118;Ne;0;1;0;1
1354;Drevinukas;AŽUOLIUKŲ;9915130747;Ne;0;7;0;7
1355;Drevinukas;AŽUOLIUKŲ;6891793135;Ne;0;2;0;2
1356;Drevinukas;AŽUOLIUKŲ;1058927778;Ne;0;3;0;3
1357;Drevinukas;AŽUOLIUKŲ;9534007163;Ne;14;0;4;18
1358;Drevinukas;AŽUOLIUKŲ;2300338724;Ne;7;5;2;14
1359;Drevinukas;AŽUOLIUKŲ;3725760478;Ne;0;2;0;2
1360;Drevinukas;AŽUOLIUKŲ;5436821826;Ne;0;6;0;6
1361;Drevinukas;AŽUOLIUKŲ;6165662595;Ne;1;0;5;6
1362;Drevinukas;AŽUOLIUKŲ;2740093399;Ne;0;5;0;5
1363;Drevinukas;PELĖDŽIUKAI;3032536983;Ne;0;2;0;2
1364;Drevinukas;PELĖDŽIUKAI;3392249574;Ne;1;2;2;5
1365;Drevinukas;PELĖDŽIUKAI;5524567803;Ne;0;2;1;3
1366;Drevinukas;PELĖDŽIUKAI;9016985238;Ne;0;0;1;1
1367;Drevinukas;PELĖDŽIUKAI;2929598743;Ne;5;3;2;10
1368;Drevinukas;PELĖDŽIUKAI;4076576850;Ne;0;2;6;8
1369;Drevinukas;PELĖDŽIUKAI;6373230526;Ne;0;2;0;2
1370;Drevinukas;PELĖDŽIUKAI;7642022439;Ne;0;2;0;2
1371;Drevinukas;PELĖDŽIUKAI;6316000019;Ne;0;0;3;3
1372;Drevinukas;PELĖDŽIUKAI;4404254932;Ne;2;7;2;11
1373;Drevinukas;PELĖDŽIUKAI;2378493422;Ne;12;2;4;18
1374;Drevinukas;PELĖDŽIUKAI;1859208322;Ne;9;2;2;13
1375;Drevinukas;PELĖDŽIUKAI;8984653958;Ne;0;2;0;2
1376;Drevinukas;PELĖDŽIUKAI;5620887702;Ne;4;2;2;8
1377;Drevinukas;PELĖDŽIUKAI;2281463885;Ne;0;2;0;2
1378;Drevinukas;PELĖDŽIUKAI;5875459639;Ne;0;3;0;3
1379;Drevinukas;PELĖDŽIUKAI;6582186497;Ne;0;1;0;1
1380;Drevinukas;PELĖDŽIUKAI;7218201733;Ne;1;2;2;5
1381;Drevinukas;BORUŽĖLĖS;4242944055;Ne;0;2;0;2
1382;Drevinukas;BORUŽĖLĖS;6492987985;Ne;1;0;2;3
1383;Drevinukas;BORUŽĖLĖS;6645506336;Ne;9;8;2;19
1384;Drevinukas;BORUŽĖLĖS;9845207619;Ne;2;0;1;3
1385;Drevinukas;BORUŽĖLĖS;9517560132;Ne;18;2;2;22
1386;Drevinukas;BORUŽĖLĖS;6895472558;Ne;9;0;3;12
1387;Drevinukas;BORUŽĖLĖS;4147987057;Ne;0;6;0;6
1388;Drevinukas;BORUŽĖLĖS;6680003214;Ne;0;0;1;1
1389;Drevinukas;BORUŽĖLĖS;9695419813;Ne;0;2;0;2
1390;Drevinukas;BORUŽĖLĖS;8694887879;Ne;0;2;3;5
1391;Drevinukas;BORUŽĖLĖS;3192583690;Ne;0;1;1;2
1392;Drevinukas;BORUŽĖLĖS;6659263391;Ne;0;1;1;2
1393;Drevinukas;BORUŽĖLĖS;8719022482;Taip;0;1;1;2
1394;Drevinukas;BORUŽĖLĖS;5860361695;Ne;1;2;2;5
1395;Drevinukas;BORUŽĖLĖS;4588368596;Ne;6;0;2;8
1396;Drevinukas;BORUŽĖLĖS;2571295179;Ne;0;8;0;8
1397;Drevinukas;BORUŽĖLĖS;2820241608;Ne;0;4;0;4
1398;Drevinukas;BORUŽĖLĖS;8940838262;Ne;0;3;1;4
1399;Drevinukas;BORUŽĖLĖS;2179736991;Ne;0;0;3;3
1400;Drevinukas;BITUTĖS;5348609358;Ne;0;12;0;12
1401;Drevinukas;BITUTĖS;2312241894;Ne;0;0;2;2
1402;Drevinukas;BITUTĖS;5394143000;Ne;5;0;2;7
1403;Drevinukas;BITUTĖS;3871506691;Ne;0;1;0;1
1404;Drevinukas;BITUTĖS;6914111231;Ne;0;1;0;1
1405;Drevinukas;BITUTĖS;3377957769;Ne;3;1;2;6
1406;Drevinukas;BITUTĖS;2423143170;Ne;8;0;0;8
1407;Drevinukas;BITUTĖS;1343431478;Ne;0;1;0;1
1408;Drevinukas;BITUTĖS;1829421385;Ne;0;2;0;2
1409;Drevinukas;BITUTĖS;8262224710;Ne;0;5;0;5
1410;Drevinukas;BITUTĖS;4203106313;Ne;2;2;4;8
1411;Drevinukas;BITUTĖS;8385750920;Ne;1;1;2;4
1412;Drevinukas;BITUTĖS;9513405583;Ne;0;2;0;2
1413;Drevinukas;BITUTĖS;8896207423;Ne;3;1;2;6
1414;Drevinukas;BITUTĖS;4662426451;Ne;0;2;1;3
1415;Drevinukas;BITUTĖS;3617533357;Ne;7;13;2;22
1416;Drevinukas;NYKŠTUKAI;9105675010;Ne;2;0;0;2
1417;Drevinukas;NYKŠTUKAI;3611870655;Ne;3;0;4;7
1418;Drevinukas;NYKŠTUKAI;1094428951;Ne;2;0;0;2
1419;Drevinukas;NYKŠTUKAI;9283862598;Ne;11;0;2;13
1420;Drevinukas;NYKŠTUKAI;2201342382;Ne;2;0;1;3
1421;Drevinukas;NYKŠTUKAI;4759293403;Ne;7;1;2;10
1422;Drevinukas;NYKŠTUKAI;9004568476;Ne;1;2;2;5
1423;Drevinukas;NYKŠTUKAI;9715586195;Ne;0;6;2;8
1424;Drevinukas;NYKŠTUKAI;1368495173;Ne;0;9;0;9
1425;Drevinukas;NYKŠTUKAI;8284025903;Ne;0;2;0;2
1426;Drevinukas;NYKŠTUKAI;8654858364;Ne;3;3;4;10
1427;Drevinukas;NYKŠTUKAI;5445104383;Ne;4;0;2;6
1428;Drevinukas;NYKŠTUKAI;2662147175;Ne;7;0;4;11
1429;Drevinukas;NYKŠTUKAI;7801920518;Ne;15;2;2;19
1430;Drevinukas;NYKŠTUKAI;1570356979;Ne;8;5;2;15
1431;Drevinukas;NYKŠTUKAI;8877080179;Ne;2;0;2;4
1432;Drevinukas;NYKŠTUKAI;6492711565;Taip;1;1;2;4
1433;Drevinukas;NYKŠTUKAI;7316996793;Ne;0;4;0;4
1434;Drevinukas;NYKŠTUKAI;3408981880;Ne;0;1;0;1
1435;Drevinukas;NYKŠTUKAI;8953871512;Ne;22;0;0;22
1436;Drevinukas;NYKŠTUKAI;3983656958;Ne;5;2;4;11
1437;Drevinukas;SMALSUČIAI;7241671439;Ne;3;3;2;8
1438;Drevinukas;SMALSUČIAI;2246885419;Ne;0;13;0;13
1439;Drevinukas;SMALSUČIAI;7863529560;Ne;0;1;0;1
1440;Drevinukas;SMALSUČIAI;8107900397;Ne;3;0;3;6
1441;Drevinukas;SMALSUČIAI;1757626792;Ne;0;1;0;1
1442;Drevinukas;SMALSUČIAI;5666172450;Ne;7;0;6;13
1443;Drevinukas;SMALSUČIAI;1478224813;Ne;1;2;2;5
1444;Drevinukas;SMALSUČIAI;9707576704;Ne;4;3;4;11
1445;Drevinukas;SMALSUČIAI;2971775004;Ne;3;0;2;5
1446;Drevinukas;SMALSUČIAI;2888797405;Ne;2;1;2;5
1447;Drevinukas;SMALSUČIAI;5614413092;Ne;0;0;4;4
1448;Drevinukas;SMALSUČIAI;4372760590;Ne;2;0;2;4
1449;Drevinukas;SMALSUČIAI;1934875187;Ne;0;1;2;3
1450;Drevinukas;SMALSUČIAI;3177600122;Ne;3;1;2;6
1451;Drevinukas;ŽVIRBLIUKAI;2274377462;Ne;0;0;2;2
1452;Drevinukas;ŽVIRBLIUKAI;5702650036;Ne;0;5;0;5
1453;Drevinukas;ŽVIRBLIUKAI;5928679046;Ne;19;0;2;21
1454;Drevinukas;ŽVIRBLIUKAI;5785185025;Ne;11;0;4;15
1455;Drevinukas;ŽVIRBLIUKAI;8482376948;Ne;12;0;2;14
1456;Drevinukas;ŽVIRBLIUKAI;5640493477;Ne;3;0;2;5
1457;Drevinukas;ŽVIRBLIUKAI;7970286765;Ne;8;0;2;10
1458;Drevinukas;ŽVIRBLIUKAI;3598394850;Ne;14;0;2;16
1459;Drevinukas;ŽVIRBLIUKAI;2968317659;Taip;4;2;4;10
1460;Drevinukas;ŽVIRBLIUKAI;9583532096;Ne;0;0;4;4
1461;Drevinukas;ŽVIRBLIUKAI;6858049220;Ne;14;0;2;16
1462;Drevinukas;ŽVIRBLIUKAI;7639360777;Ne;11;0;4;15
1463;Drevinukas;ŽVIRBLIUKAI;5536448847;Ne;10;0;4;14
1464;Drevinukas;ŽVIRBLIUKAI;7600838895;Ne;4;0;5;9
1465;Drevinukas;ŽVIRBLIUKAI;3049662927;Ne;3;0;2;5
1466;Drevinukas;ŽVIRBLIUKAI;4371848878;Ne;0;0;4;4
1467;Drugelis;NYKŠTUKŲ;9316073597;Ne;0;2;0;2
1468;Drugelis;NYKŠTUKŲ;3551095669;Ne;0;2;3;5
1469;Drugelis;NYKŠTUKŲ;1785724340;Ne;6;4;2;12
1470;Drugelis;NYKŠTUKŲ;7447519502;Ne;0;2;0;2
1471;Drugelis;NYKŠTUKŲ;4523513611;Ne;0;2;0;2
1472;Drugelis;NYKŠTUKŲ;6594452094;Ne;0;2;2;4
1473;Drugelis;NYKŠTUKŲ;5122256823;Ne;0;1;0;1
1474;Drugelis;NYKŠTUKŲ;4825232236;Ne;0;0;3;3
1475;Drugelis;NYKŠTUKŲ;7477547789;Ne;0;2;0;2
1476;Drugelis;NYKŠTUKŲ;8717445483;Ne;0;2;1;3
1477;Drugelis;NYKŠTUKŲ;4471405682;Ne;0;2;0;2
1478;Drugelis;NYKŠTUKŲ;4867387611;Ne;0;6;0;6
1479;Drugelis;NYKŠTUKŲ;8070030439;Ne;0;1;0;1
1480;Drugelis;NYKŠTUKŲ;3061896520;Ne;0;1;0;1
1481;Drugelis;NYKŠTUKŲ;4927896706;Ne;0;1;1;2
1482;Drugelis;NYKŠTUKŲ;5692743298;Ne;0;2;2;4
1483;Drugelis;NYKŠTUKŲ;6452921695;Ne;4;3;6;13
1484;Drugelis;NYKŠTUKŲ;5902687211;Ne;0;2;3;5
1485;Drugelis;NYKŠTUKŲ;8591548746;Ne;0;2;2;4
1486;Drugelis;NYKŠTUKŲ;5515894973;Ne;1;2;2;5
1487;Drugelis;SMALSUČIŲ;5121351234;Ne;8;0;6;14
1488;Drugelis;SMALSUČIŲ;5000965458;Ne;4;6;2;12
1489;Drugelis;SMALSUČIŲ;9683350741;Ne;3;6;4;13
1490;Drugelis;SMALSUČIŲ;1617833459;Ne;0;10;1;11
1491;Drugelis;SMALSUČIŲ;4058293462;Ne;3;0;2;5
1492;Drugelis;SMALSUČIŲ;4805858183;Ne;3;3;3;9
1493;Drugelis;SMALSUČIŲ;9650052415;Ne;0;2;3;5
1494;Drugelis;SMALSUČIŲ;5533529267;Ne;0;6;0;6
1495;Drugelis;SMALSUČIŲ;3733097479;Ne;1;2;2;5
1496;Drugelis;SMALSUČIŲ;2196445523;Ne;1;2;2;5
1497;Drugelis;SMALSUČIŲ;3645668411;Ne;1;2;2;5
1498;Drugelis;SMALSUČIŲ;3261462674;Ne;1;2;2;5
1499;Drugelis;SMALSUČIŲ;8186338261;Ne;4;0;4;8
1500;Drugelis;SMALSUČIŲ;2644563881;Ne;0;0;1;1
1501;Drugelis;SMALSUČIŲ;6613520046;Ne;1;2;2;5
1502;Drugelis;SMALSUČIŲ;6890441262;Ne;1;4;2;7
1503;Drugelis;SMALSUČIŲ;3509593041;Ne;0;0;2;2
1504;Drugelis;SMALSUČIŲ;1417298801;Ne;0;0;4;4
1505;Drugelis;SMALSUČIŲ;1074913909;Ne;0;0;2;2
1506;Drugelis;MUMINUKŲ;7390061272;Ne;3;0;4;7
1507;Drugelis;MUMINUKŲ;3311620018;Ne;3;0;2;5
1508;Drugelis;MUMINUKŲ;5661335344;Ne;0;0;2;2
1509;Drugelis;MUMINUKŲ;6038184222;Ne;0;2;3;5
1510;Drugelis;MUMINUKŲ;9851124145;Ne;0;0;2;2
1511;Drugelis;MUMINUKŲ;7253876812;Ne;0;2;1;3
1512;Drugelis;MUMINUKŲ;1816845006;Ne;0;8;0;8
1513;Drugelis;MUMINUKŲ;1666992752;Ne;0;0;2;2
1514;Drugelis;MUMINUKŲ;9510744779;Ne;0;2;1;3
1515;Drugelis;MUMINUKŲ;9907121223;Ne;0;6;0;6
1516;Drugelis;MUMINUKŲ;8500348389;Ne;0;4;0;4
1517;Drugelis;MUMINUKŲ;1858504360;Ne;0;1;0;1
1518;Drugelis;MUMINUKŲ;8366330478;Ne;4;0;2;6
1519;Drugelis;MUMINUKŲ;8107970910;Ne;5;0;2;7
1520;Drugelis;MUMINUKŲ;8282807535;Ne;10;0;4;14
1521;Drugelis;MUMINUKŲ;3293212749;Ne;0;2;0;2
1522;Drugelis;MUMINUKŲ;2256221485;Ne;0;2;0;2
1523;Drugelis;MUMINUKŲ;9588931333;Ne;9;2;2;13
1524;Drugelis;MUMINUKŲ;3176174057;Taip;0;7;0;7
1525;Drugelis;MUMINUKŲ;1761596625;Ne;0;2;6;8
1526;Drugelis;MUMINUKŲ;6390802189;Ne;0;2;0;2
1527;Drugelis;PŪKUOTUKAI;3560294703;Ne;3;1;4;8
1528;Drugelis;PŪKUOTUKAI;1215586620;Ne;2;2;2;6
1529;Drugelis;PŪKUOTUKAI;9005448398;Ne;4;2;2;8
1530;Drugelis;PŪKUOTUKAI;6504082488;Ne;0;5;0;5
1531;Drugelis;PŪKUOTUKAI;7321544601;Ne;2;1;2;5
1532;Drugelis;PŪKUOTUKAI;9296067137;Ne;7;6;2;15
1533;Drugelis;PŪKUOTUKAI;9855121078;Ne;0;2;6;8
1534;Drugelis;PŪKUOTUKAI;6068102133;Ne;3;1;2;6
1535;Drugelis;PŪKUOTUKAI;7825151440;Ne;1;1;3;5
1536;Drugelis;PŪKUOTUKAI;4812322553;Ne;0;2;2;4
1537;Drugelis;PŪKUOTUKAI;3081918342;Ne;13;2;2;17
1538;Drugelis;PŪKUOTUKAI;6032568621;Ne;1;2;4;7
1539;Drugelis;PŪKUOTUKAI;4580456500;Ne;2;2;2;6
1540;Drugelis;PŪKUOTUKAI;8259051898;Ne;10;2;2;14
1541;Drugelis;PŪKUOTUKAI;2573357635;Ne;9;0;2;11
1542;Drugelis;PŪKUOTUKAI;3567930528;Ne;8;5;3;16
1543;Drugelis;PŪKUOTUKAI;1808917187;Ne;9;2;2;13
1544;Drugelis;PŪKUOTUKAI;5995208093;Ne;8;2;7;17
1545;Drugelis;PŪKUOTUKAI;6965297550;Ne;1;4;2;7
1546;Drugelis;PŪKUOTUKAI;3800496237;Ne;9;0;4;13
1547;Drugelis;PŪKUOTUKAI;5557284298;Taip;4;0;2;6
1548;Drugelis;PŪKUOTUKAI;8438128438;Ne;3;0;4;7
1549;Drugelis;SPINDULIUKAI;7775085427;Ne;1;9;2;12
1550;Drugelis;SPINDULIUKAI;5129433046;Taip;2;0;4;6
1551;Drugelis;SPINDULIUKAI;2456724368;Ne;0;1;0;1
1552;Drugelis;SPINDULIUKAI;5538435916;Ne;0;12;0;12
1553;Drugelis;SPINDULIUKAI;3473680112;Ne;0;2;1;3
1554;Drugelis;SPINDULIUKAI;4361777186;Ne;14;0;6;20
1555;Drugelis;SPINDULIUKAI;2105023760;Ne;9;0;4;13
1556;Drugelis;SPINDULIUKAI;9226673535;Ne;1;0;5;6
1557;Drugelis;SPINDULIUKAI;5773336517;Ne;9;1;2;12
1558;Drugelis;SPINDULIUKAI;7160648094;Ne;2;2;2;6
1559;Drugelis;SPINDULIUKAI;5276647563;Ne;1;0;3;4
1560;Drugelis;SPINDULIUKAI;3883341684;Ne;0;11;11;22
1561;Drugelis;SPINDULIUKAI;5970909950;Ne;10;0;12;22
1562;Drugelis;SPINDULIUKAI;9908380623;Ne;14;0;4;18
1563;Drugelis;SPINDULIUKAI;4347439776;Ne;13;0;4;17
1564;Drugelis;SPINDULIUKAI;4061717129;Ne;0;1;0;1
1565;Drugelis;KIŠKUČIAI;3603051567;Ne;0;0;1;1
1566;Drugelis;KIŠKUČIAI;4628926113;Ne;7;3;0;10
1567;Drugelis;KIŠKUČIAI;7307032077;Ne;0;3;0;3
1568;Drugelis;KIŠKUČIAI;1213610973;Taip;0;2;0;2
1569;Drugelis;KIŠKUČIAI;9211760307;Ne;0;0;3;3
1570;Drugelis;KIŠKUČIAI;6071997970;Ne;0;5;0;5
1571;Drugelis;KIŠKUČIAI;8819853863;Ne;5;0;2;7
1572;Drugelis;KIŠKUČIAI;5950704328;Ne;0;7;0;7
1573;Drugelis;KIŠKUČIAI;9900296726;Ne;9;2;4;15
1574;Drugelis;KIŠKUČIAI;4898099506;Ne;0;2;1;3
1575;Drugelis;KIŠKUČIAI;6997707085;Ne;0;2;0;2
1576;Drugelis;KIŠKUČIAI;1375535260;Ne;2;0;2;4
1577;Drugelis;KIŠKUČIAI;5857726963;Ne;7;0;5;12
1578;Drugelis;KIŠKUČIAI;1817932444;Ne;4;1;5;10
1579;Drugelis;KIŠKUČIAI;8891228382;Ne;0;0;1;1
1580;Drugelis;KIŠKUČIAI;2729246397;Ne;14;0;3;17
1581;"Du gaideliai";Uodelių;5189121339;Ne;2;1;2;5
1582;"Du gaideliai";Uodelių;8624394105;Ne;0;4;4;8
1583;"Du gaideliai";Uodelių;9506572113;Ne;10;0;6;16
1584;"Du gaideliai";Uodelių;6224116229;Ne;3;0;3;6
1585;"Du gaideliai";Uodelių;5514521078;Ne;0;2;8;10
1586;"Du gaideliai";Uodelių;6630053388;Ne;11;0;4;15
1587;"Du gaideliai";Uodelių;3654057453;Ne;0;1;2;3
1588;"Du gaideliai";Uodelių;8921985681;Ne;0;9;12;21
1589;"Du gaideliai";Uodelių;5225949099;Ne;0;1;0;1
1590;"Du gaideliai";Uodelių;2122841302;Ne;10;1;2;13
1591;"Du gaideliai";Uodelių;3206388799;Taip;10;0;4;14
1592;"Du gaideliai";Uodelių;2084660815;Ne;0;3;0;3
1593;"Du gaideliai";Uodelių;7153424410;Ne;0;1;0;1
1594;"Du gaideliai";Uodelių;4799107717;Ne;0;3;0;3
1595;"Du gaideliai";Uodelių;5113352673;Ne;2;0;2;4
1596;"Du gaideliai";Uodelių;6054058539;Taip;0;6;0;6
1597;"Du gaideliai";Uodelių;9832883242;Ne;6;0;2;8
1598;"Du gaideliai";Uodelių;5016914497;Ne;0;0;10;10
1599;"Du gaideliai";Uodelių;4759244471;Ne;8;0;4;12
1600;"Du gaideliai";Uodelių;7855653537;Ne;17;0;0;17
1601;"Du gaideliai";OŽIUKŲ;6942798420;Ne;5;2;2;9
1602;"Du gaideliai";OŽIUKŲ;8174023197;Ne;8;1;2;11
1603;"Du gaideliai";OŽIUKŲ;8420400705;Ne;0;16;0;16
1604;"Du gaideliai";OŽIUKŲ;7372149799;Ne;0;8;0;8
1605;"Du gaideliai";OŽIUKŲ;2826490663;Ne;3;0;2;5
1606;"Du gaideliai";OŽIUKŲ;4157021754;Ne;1;3;0;4
1607;"Du gaideliai";OŽIUKŲ;1968978650;Ne;0;7;0;7
1608;"Du gaideliai";OŽIUKŲ;5291934919;Ne;3;4;2;9
1609;"Du gaideliai";OŽIUKŲ;2564259600;Ne;10;0;2;12
1610;"Du gaideliai";OŽIUKŲ;6132405512;Ne;0;8;4;12
1611;"Du gaideliai";OŽIUKŲ;2756525592;Ne;0;7;0;7
1612;"Du gaideliai";OŽIUKŲ;9126780620;Ne;3;2;2;7
1613;"Du gaideliai";OŽIUKŲ;9374869616;Ne;0;2;1;3
1614;"Du gaideliai";OŽIUKŲ;5726096980;Ne;3;12;2;17
1615;"Du gaideliai";OŽIUKŲ;4408537397;Ne;0;2;1;3
1616;"Du gaideliai";OŽIUKŲ;1527839162;Ne;3;0;2;5
1617;"Du gaideliai";OŽIUKŲ;8896316882;Ne;0;2;0;2
1618;"Du gaideliai";OŽIUKŲ;5809089345;Ne;8;0;2;10
1619;"Du gaideliai";OŽIUKŲ;5867716168;Ne;7;2;2;11
1620;"Du gaideliai";OŽIUKŲ;1882241729;Taip;0;2;0;2
1621;"Du gaideliai";OŽIUKŲ;2616106413;Ne;7;0;2;9
1622;"Du gaideliai";OŽIUKŲ;9934568135;Ne;11;3;0;14
1623;"Du gaideliai";Vištyčių;2100449108;Ne;0;10;1;11
1624;"Du gaideliai";Vištyčių;7033276798;Ne;0;3;0;3
1625;"Du gaideliai";Vištyčių;8744467866;Ne;22;0;0;22
1626;"Du gaideliai";Vištyčių;3019797369;Ne;2;1;0;3
1627;"Du gaideliai";Vištyčių;9356275460;Taip;8;1;3;12
1628;"Du gaideliai";Vištyčių;6204233540;Ne;0;4;0;4
1629;"Du gaideliai";Vištyčių;2845145754;Ne;0;11;0;11
1630;"Du gaideliai";Vištyčių;7726490359;Ne;17;0;0;17
1631;"Du gaideliai";Vištyčių;5788923258;Ne;0;0;10;10
1632;"Du gaideliai";Vištyčių;6762171696;Ne;0;3;1;4
1633;"Du gaideliai";Vištyčių;6053941133;Ne;4;2;2;8
1634;"Du gaideliai";Vištyčių;5728374219;Ne;8;0;2;10
1635;"Du gaideliai";Vištyčių;5611102395;Ne;0;5;0;5
1636;"Du gaideliai";Vištyčių;8410547195;Ne;0;2;1;3
1637;"Du gaideliai";Vištyčių;6120647567;Ne;0;9;0;9
1638;"Du gaideliai";Vištyčių;2905083899;Taip;0;0;1;1
1639;"Du gaideliai";Vištyčių;9585785202;Ne;0;9;0;9
1640;"Du gaideliai";Vištyčių;2151825222;Ne;0;7;2;9
1641;"Du gaideliai";Vištyčių;8043896286;Ne;0;2;1;3
1642;"Du gaideliai";GAIDŽIUKŲ;2635903222;Ne;3;0;2;5
1643;"Du gaideliai";GAIDŽIUKŲ;6669130831;Ne;5;0;4;9
1644;"Du gaideliai";GAIDŽIUKŲ;2240947701;Ne;0;4;0;4
1645;"Du gaideliai";GAIDŽIUKŲ;3507387826;Ne;0;6;0;6
1646;"Du gaideliai";GAIDŽIUKŲ;4144269068;Ne;0;19;0;19
1647;"Du gaideliai";GAIDŽIUKŲ;1785976627;Ne;3;1;2;6
1648;"Du gaideliai";GAIDŽIUKŲ;8047413507;Ne;0;4;0;4
1649;"Du gaideliai";GAIDŽIUKŲ;9568647033;Ne;2;2;4;8
1650;"Du gaideliai";GAIDŽIUKŲ;5894974508;Ne;0;2;0;2
1651;"Du gaideliai";GAIDŽIUKŲ;6247706405;Ne;2;1;4;7
1652;"Du gaideliai";GAIDŽIUKŲ;1135098595;Ne;3;0;2;5
1653;"Du gaideliai";GAIDŽIUKŲ;3370029981;Ne;0;2;0;2
1654;"Du gaideliai";GAIDŽIUKŲ;1751328192;Ne;1;2;2;5
1655;"Du gaideliai";GAIDŽIUKŲ;5652662610;Ne;3;1;2;6
1656;"Du gaideliai";GAIDŽIUKŲ;6870356241;Ne;0;2;0;2
1657;"Du gaideliai";GAIDŽIUKŲ;5103483956;Ne;0;2;0;2
1658;"Du gaideliai";GAIDŽIUKŲ;3854355215;Ne;0;2;3;5
1659;"Du gaideliai";GAIDŽIUKŲ;3849899284;Ne;0;3;0;3
1660;"Du gaideliai";Musyčių;8280439976;Ne;9;0;2;11
1661;"Du gaideliai";Musyčių;8819197022;Ne;3;3;3;9
1662;"Du gaideliai";Musyčių;6826558709;Ne;13;3;3;19
1663;"Du gaideliai";Musyčių;3058039700;Ne;7;0;4;11
1664;"Du gaideliai";Musyčių;7556954721;Ne;2;1;2;5
1665;"Du gaideliai";Musyčių;3601150560;Ne;0;1;0;1
1666;"Du gaideliai";Musyčių;3519099395;Ne;0;2;2;4
1667;"Du gaideliai";Musyčių;9561040908;Ne;4;4;3;11
1668;"Du gaideliai";Musyčių;9477645505;Ne;3;3;2;8
1669;"Du gaideliai";Musyčių;2266999698;Ne;0;1;0;1
1670;"Du gaideliai";Musyčių;1048130675;Taip;8;9;3;20
1671;"Du gaideliai";Musyčių;1706627632;Ne;18;2;2;22
1672;"Du gaideliai";Musyčių;5625164689;Ne;4;0;4;8
1673;"Du gaideliai";MALŪNO;9330406774;Ne;9;2;7;18
1674;"Du gaideliai";MALŪNO;4995471264;Ne;4;3;5;12
1675;"Du gaideliai";MALŪNO;2135080469;Ne;0;0;2;2
1676;"Du gaideliai";MALŪNO;9289309829;Ne;4;1;1;6
1677;"Du gaideliai";MALŪNO;8427621976;Ne;2;0;0;2
1678;"Du gaideliai";MALŪNO;5028947424;Ne;0;1;5;6
1679;"Du gaideliai";MALŪNO;2613120460;Ne;1;3;4;8
1680;"Du gaideliai";MALŪNO;3469559577;Ne;3;0;3;6
1681;"Du gaideliai";MALŪNO;8197231934;Ne;3;0;2;5
1682;"Du gaideliai";MALŪNO;2261152926;Ne;1;0;6;7
1683;"Du gaideliai";MALŪNO;4792733524;Ne;6;1;3;10
1684;"Du gaideliai";MALŪNO;9698314519;Ne;1;1;1;3
1685;"Du gaideliai";MALŪNO;6169869542;Ne;4;0;3;7
1686;"Du gaideliai";MALŪNO;4939339357;Ne;3;0;2;5
1687;Eglutė;RAMUNĖ;2998190195;Ne;3;2;2;7
1688;Eglutė;RAMUNĖ;4099257155;Ne;0;3;0;3
1689;Eglutė;RAMUNĖ;6009794480;Ne;0;17;0;17
1690;Eglutė;RAMUNĖ;7984911632;Ne;0;2;0;2
1691;Eglutė;RAMUNĖ;6539887315;Ne;0;0;2;2
1692;Eglutė;RAMUNĖ;4252256130;Ne;3;0;2;5
1693;Eglutė;RAMUNĖ;8534997648;Ne;0;0;5;5
1694;Eglutė;RAMUNĖ;7234851379;Ne;8;0;4;12
1695;Eglutė;RAMUNĖ;5636437290;Ne;8;1;2;11
1696;Eglutė;RAMUNĖ;5190045146;Ne;0;7;0;7
1697;Eglutė;RAMUNĖ;3985929379;Ne;2;0;0;2
1698;Eglutė;RAMUNĖ;1842517164;Ne;9;0;2;11
1699;Eglutė;RAMUNĖ;7703290039;Ne;0;6;0;6
1700;Eglutė;RAMUNĖ;7530638623;Ne;0;2;0;2
1701;Eglutė;RAMUNĖ;2121177107;Ne;0;0;3;3
1702;Eglutė;RAMUNĖ;2357276888;Ne;0;12;0;12
1703;Eglutė;RAMUNĖ;2816913563;Ne;0;2;0;2
1704;Eglutė;RAMUNĖ;7098548563;Ne;0;2;7;9
1705;Eglutė;RAMUNĖ;7811667336;Ne;0;5;0;5
1706;Eglutė;RAMUNĖ;6146679388;Ne;15;2;5;22
1707;Eglutė;RAMUNĖ;5166183300;Ne;0;13;0;13
1708;Eglutė;PELĖDŽIUKAI;3883122650;Ne;0;7;0;7
1709;Eglutė;PELĖDŽIUKAI;7859815752;Ne;4;2;2;8
1710;Eglutė;PELĖDŽIUKAI;4176597208;Ne;0;4;1;5
1711;Eglutė;PELĖDŽIUKAI;7758643349;Ne;0;7;0;7
1712;Eglutė;PELĖDŽIUKAI;6483580751;Ne;0;6;0;6
1713;Eglutė;PELĖDŽIUKAI;4490295754;Ne;2;4;2;8
1714;Eglutė;PELĖDŽIUKAI;5924994736;Ne;0;2;0;2
1715;Eglutė;PELĖDŽIUKAI;1759383841;Ne;0;3;0;3
1716;Eglutė;PELĖDŽIUKAI;6597261061;Ne;0;7;0;7
1717;Eglutė;PELĖDŽIUKAI;9046652370;Ne;4;2;5;11
1718;Eglutė;PELĖDŽIUKAI;9356785605;Ne;4;3;2;9
1719;Eglutė;PELĖDŽIUKAI;8943684351;Ne;0;2;4;6
1720;Eglutė;PELĖDŽIUKAI;1932785408;Ne;6;1;5;12
1721;Eglutė;PELĖDŽIUKAI;8165126017;Ne;0;2;1;3
1722;Eglutė;PELĖDŽIUKAI;9967488317;Ne;0;4;2;6
1723;Eglutė;PELĖDŽIUKAI;3584247594;Ne;0;2;0;2
1724;Eglutė;PELĖDŽIUKAI;5678727198;Ne;5;2;8;15
1725;Eglutė;PELĖDŽIUKAI;1835565594;Ne;3;2;2;7
1726;Eglutė;PELĖDŽIUKAI;4027143502;Ne;0;1;0;1
1727;Eglutė;PELĖDŽIUKAI;2611896463;Ne;3;4;2;9
1728;Eglutė;KODĖLČIUKAI;7831541089;Ne;5;4;2;11
1729;Eglutė;KODĖLČIUKAI;7735192219;Ne;0;4;0;4
1730;Eglutė;KODĖLČIUKAI;3430016771;Ne;0;16;0;16
1731;Eglutė;KODĖLČIUKAI;6382927775;Ne;0;10;0;10
1732;Eglutė;KODĖLČIUKAI;7919553451;Ne;0;11;0;11
1733;Eglutė;KODĖLČIUKAI;7658345479;Ne;0;3;0;3
1734;Eglutė;KODĖLČIUKAI;7229612001;Ne;0;4;0;4
1735;Eglutė;KODĖLČIUKAI;5779671024;Ne;2;2;0;4
1736;Eglutė;KODĖLČIUKAI;5783776734;Ne;0;16;0;16
1737;Eglutė;KODĖLČIUKAI;4490541539;Ne;0;2;0;2
1738;Eglutė;KODĖLČIUKAI;5407757245;Ne;0;0;1;1
1739;Eglutė;KODĖLČIUKAI;3719202688;Ne;7;2;2;11
1740;Eglutė;KODĖLČIUKAI;3237476593;Ne;0;1;0;1
1741;Eglutė;KODĖLČIUKAI;9542103745;Ne;7;0;4;11
1742;Eglutė;KODĖLČIUKAI;3848175048;Ne;0;1;0;1
1743;Eglutė;KODĖLČIUKAI;6653111225;Ne;2;2;2;6
1744;Eglutė;KODĖLČIUKAI;1122907387;Ne;0;4;0;4
1745;Eglutė;KODĖLČIUKAI;9686836846;Ne;7;2;2;11
1746;Eglutė;KODĖLČIUKAI;3650609128;Ne;6;0;4;10
1747;Eglutė;KODĖLČIUKAI;8847930854;Ne;0;7;0;7
1748;Eglutė;KODĖLČIUKAI;5592515139;Ne;4;1;3;8
1749;Eglutė;OBUOLIUKAI;5704418881;Ne;0;0;2;2
1750;Eglutė;OBUOLIUKAI;3488060437;Ne;0;6;0;6
1751;Eglutė;OBUOLIUKAI;8698242107;Ne;9;1;8;18
1752;Eglutė;OBUOLIUKAI;1630732306;Ne;0;4;0;4
1753;Eglutė;OBUOLIUKAI;9381529574;Ne;8;0;2;10
1754;Eglutė;OBUOLIUKAI;9150254806;Ne;0;2;0;2
1755;Eglutė;OBUOLIUKAI;2107488723;Ne;0;0;5;5
1756;Eglutė;OBUOLIUKAI;4539946535;Ne;7;0;2;9
1757;Eglutė;OBUOLIUKAI;8749425471;Ne;0;2;0;2
1758;Eglutė;OBUOLIUKAI;5103022009;Ne;4;3;2;9
1759;Eglutė;OBUOLIUKAI;1460628870;Ne;11;0;2;13
1760;Eglutė;OBUOLIUKAI;8542684582;Ne;0;2;3;5
1761;Eglutė;OBUOLIUKAI;7313013331;Ne;2;0;1;3
1762;Eglutė;OBUOLIUKAI;3089527202;Ne;0;4;0;4
1763;Eglutė;OBUOLIUKAI;3091697091;Ne;0;1;0;1
1764;Eglutė;OBUOLIUKAI;8037564034;Ne;6;2;4;12
1765;Eglutė;OBUOLIUKAI;3051637136;Ne;7;2;4;13
1766;Eglutė;OBUOLIUKAI;2669400743;Ne;0;1;0;1
1767;Eglutė;OBUOLIUKAI;3011330968;Ne;0;3;0;3
1768;Eglutė;OBUOLIUKAI;4823811890;Ne;15;2;5;22
1769;Eglutė;OBUOLIUKAI;4151258155;Ne;13;0;4;17
1770;Eglutė;OBUOLIUKAI;6965837585;Ne;0;2;0;2
1771;Eglutė;OBUOLIUKAI;9292940501;Ne;4;4;2;10
1772;Eglutė;KAŠTONAS;3107823269;Ne;4;2;2;8
1773;Eglutė;KAŠTONAS;3799824061;Ne;10;0;4;14
1774;Eglutė;KAŠTONAS;8655425408;Ne;6;2;2;10
1775;Eglutė;KAŠTONAS;1380219881;Ne;5;0;2;7
1776;Eglutė;KAŠTONAS;7027121333;Ne;3;2;2;7
1777;Eglutė;KAŠTONAS;1744942011;Ne;6;1;2;9
1778;Eglutė;KAŠTONAS;8384141923;Ne;16;2;2;20
1779;Eglutė;KAŠTONAS;3903612086;Ne;0;4;0;4
1780;Eglutė;KAŠTONAS;3112281182;Ne;11;1;2;14
1781;Eglutė;KAŠTONAS;1432716037;Ne;0;6;0;6
1782;Eglutė;KAŠTONAS;9542684993;Ne;0;0;2;2
1783;Eglutė;KAŠTONAS;6967074765;Ne;10;2;2;14
1784;Eglutė;KAŠTONAS;6679186715;Ne;18;0;2;20
1785;Eglutė;KAŠTONAS;9054104040;Ne;5;2;2;9
1786;Eglutė;KAŠTONAS;9193920390;Ne;0;8;0;8
1787;Eglutė;KAŠTONAS;8246870069;Ne;0;2;0;2
1788;Eglutė;KAŠTONAS;8721209423;Ne;4;2;7;13
1789;Eglutė;KAŠTONAS;7789753835;Ne;0;9;0;9
1790;Eglutė;KAŠTONAS;7114040071;Ne;18;2;2;22
1791;Eglutė;KAŠTONAS;7254436716;Ne;0;12;0;12
1792;Eglutė;KAŠTONAS;2192673126;Ne;2;0;0;2
1793;Eglutė;EŽIUKAI;1422631723;Ne;2;12;0;14
1794;Eglutė;EŽIUKAI;6709551046;Ne;2;2;2;6
1795;Eglutė;EŽIUKAI;6093932811;Ne;13;2;2;17
1796;Eglutė;EŽIUKAI;2651867769;Ne;0;0;1;1
1797;Eglutė;EŽIUKAI;3473388722;Ne;0;2;0;2
1798;Eglutė;EŽIUKAI;9402686801;Ne;3;8;2;13
1799;Eglutė;EŽIUKAI;2597978713;Ne;0;12;0;12
1800;Eglutė;EŽIUKAI;4451772812;Ne;8;2;4;14
1801;Eglutė;EŽIUKAI;8493750509;Ne;0;0;1;1
1802;Eglutė;EŽIUKAI;9929681000;Ne;0;9;0;9
1803;Eglutė;EŽIUKAI;6105927493;Ne;0;0;1;1
1804;Eglutė;EŽIUKAI;4560670047;Ne;2;2;2;6
1805;Eglutė;EŽIUKAI;1048451048;Ne;3;2;2;7
1806;Eglutė;EŽIUKAI;6279703448;Ne;0;17;0;17
1807;Eglutė;EŽIUKAI;6142326330;Ne;0;17;0;17
1808;Eglutė;EŽIUKAI;9728550000;Ne;0;0;2;2
1809;Eglutė;EŽIUKAI;1534556744;Ne;0;6;0;6
1810;Eglutė;EŽIUKAI;7598993411;Ne;10;2;4;16
1811;Eglutė;EŽIUKAI;4047404616;Ne;14;2;4;20
1812;Eglutė;EŽIUKAI;4230594049;Ne;8;2;4;14
1813;Eglutė;EŽIUKAI;8797889347;Ne;0;7;0;7
1814;Eglutė;EŽIUKAI;3006381069;Ne;0;1;0;1
1815;Eglutė;EŽIUKAI;3870885357;Ne;0;2;0;2
1816;Eglutė;GILĖ;6550999480;Ne;0;6;0;6
1817;Eglutė;GILĖ;2857760751;Ne;7;0;2;9
1818;Eglutė;GILĖ;8129230197;Ne;0;5;2;7
1819;Eglutė;GILĖ;1393626624;Ne;8;2;2;12
1820;Eglutė;GILĖ;9746021019;Ne;6;2;2;10
1821;Eglutė;GILĖ;5013664843;Ne;6;0;4;10
1822;Eglutė;GILĖ;2276311106;Ne;0;6;0;6
1823;Eglutė;GILĖ;5645197324;Ne;0;1;0;1
1824;Eglutė;GILĖ;2615824395;Ne;22;0;0;22
1825;Eglutė;GILĖ;3605053253;Taip;0;11;0;11
1826;Eglutė;GILĖ;1531942494;Taip;0;11;0;11
1827;Eglutė;GILĖ;5840014240;Ne;3;3;2;8
1828;Eglutė;GILĖ;9758104910;Ne;8;2;4;14
1829;Eglutė;GILĖ;9515238936;Ne;11;1;2;14
1830;Eglutė;GILĖ;6309529738;Ne;2;3;2;7
1831;Eglutė;SAULUTĖ;9741776217;Ne;0;12;0;12
1832;Eglutė;SAULUTĖ;5285593057;Ne;0;0;4;4
1833;Eglutė;SAULUTĖ;3091324735;Ne;0;2;0;2
1834;Eglutė;SAULUTĖ;8739346084;Ne;0;6;0;6
1835;Eglutė;SAULUTĖ;5518570006;Ne;0;5;0;5
1836;Eglutė;SAULUTĖ;5805450838;Ne;5;1;2;8
1837;Eglutė;SAULUTĖ;9084576953;Ne;0;2;5;7
1838;Eglutė;SAULUTĖ;4489150480;Ne;0;10;0;10
1839;Eglutė;SAULUTĖ;2425927050;Ne;0;15;0;15
1840;Eglutė;SAULUTĖ;5006042568;Ne;0;3;0;3
1841;Eglutė;SAULUTĖ;5275306818;Ne;0;0;7;7
1842;Eglutė;SAULUTĖ;2621445549;Ne;0;0;3;3
1843;Eglutė;SAULUTĖ;6328900251;Ne;0;2;2;4
1844;Eglutė;SAULUTĖ;9661883776;Ne;0;1;0;1
1845;Eglutė;SAULUTĖ;5505398901;Ne;0;2;0;2
1846;Eglutė;SAULUTĖ;8799063905;Ne;0;2;0;2
1847;Eglutė;SAULUTĖ;6572235324;Ne;1;2;2;5
1848;Eglutė;SAULUTĖ;1923176808;Ne;1;2;2;5
1849;Eglutė;SAULUTĖ;2872597971;Ne;3;0;4;7
1850;Eglutė;SAULUTĖ;3690266358;Ne;0;2;0;2
1851;Eglutė;ŠARKELĖ;1667851586;Ne;7;0;2;9
1852;Eglutė;ŠARKELĖ;8410302338;Ne;8;0;2;10
1853;Eglutė;ŠARKELĖ;1715411901;Ne;0;0;1;1
1854;Eglutė;ŠARKELĖ;9875724921;Ne;5;0;4;9
1855;Eglutė;ŠARKELĖ;7564179845;Taip;7;1;2;10
1856;Eglutė;ŠARKELĖ;6773894090;Ne;7;0;2;9
1857;Eglutė;ŠARKELĖ;5146804510;Ne;4;0;4;8
1858;Eglutė;ŠARKELĖ;7231828805;Ne;0;11;0;11
1859;Eglutė;ŠARKELĖ;7618937988;Ne;3;0;2;5
1860;Eglutė;ŠARKELĖ;6805213753;Ne;7;0;4;11
1861;Eglutė;ŠARKELĖ;4427853197;Ne;3;0;1;4
1862;Eglutė;ŠARKELĖ;3368734808;Ne;5;0;17;22
1863;Eglutė;ŠARKELĖ;4465995209;Ne;5;0;6;11
1864;Eglutė;ŠARKELĖ;2666894761;Ne;6;0;2;8
1865;Eglutė;ŠARKELĖ;4697026463;Ne;9;2;4;15
1866;Eglutė;ŠARKELĖ;9795027066;Ne;9;0;2;11
1867;Eglutė;ŠARKELĖ;3974970972;Taip;0;15;0;15
1868;Eglutė;ŠARKELĖ;2950414583;Ne;15;2;5;22
1869;Eglutė;ŠARKELĖ;6171697873;Ne;4;2;3;9
1870;Eglutė;ŠARKELĖ;6631296204;Ne;6;0;3;9
1871;Eglutė;NYKŠTUKAI;3210398495;Ne;5;3;2;10
1872;Eglutė;NYKŠTUKAI;4056836413;Ne;0;4;0;4
1873;Eglutė;NYKŠTUKAI;2546506486;Ne;0;0;4;4
1874;Eglutė;NYKŠTUKAI;3319230753;Ne;5;2;2;9
1875;Eglutė;NYKŠTUKAI;6173724448;Ne;7;0;4;11
1876;Eglutė;NYKŠTUKAI;4357784237;Ne;9;2;4;15
1877;Eglutė;NYKŠTUKAI;2073980883;Ne;0;9;0;9
1878;Eglutė;NYKŠTUKAI;2643648862;Ne;3;0;4;7
1879;Eglutė;NYKŠTUKAI;9415802329;Ne;12;0;4;16
1880;Eglutė;NYKŠTUKAI;2824749988;Ne;9;0;4;13
1881;Eglutė;NYKŠTUKAI;4508182019;Ne;6;1;2;9
1882;Eglutė;NYKŠTUKAI;5840899666;Ne;10;3;4;17
1883;Eglutė;NYKŠTUKAI;4759435431;Ne;3;0;3;6
1884;Eglutė;ŽIRNIUKAI;3706904006;Ne;3;0;5;8
1885;Eglutė;ŽIRNIUKAI;9538253415;Ne;0;3;0;3
1886;Eglutė;ŽIRNIUKAI;4539511980;Ne;3;0;2;5
1887;Eglutė;ŽIRNIUKAI;6898851909;Ne;7;0;2;9
1888;Eglutė;ŽIRNIUKAI;1645141463;Ne;10;0;4;14
1889;Eglutė;ŽIRNIUKAI;1950577531;Ne;4;1;3;8
1890;Eglutė;ŽIRNIUKAI;8640230418;Ne;7;0;4;11
1891;Eglutė;ŽIRNIUKAI;6469399675;Ne;6;0;4;10
1892;Eglutė;ŽIRNIUKAI;5991097138;Ne;4;0;6;10
1893;Eglutė;ŽIRNIUKAI;4959909718;Ne;0;2;0;2
1894;Eglutė;ŽIRNIUKAI;1861429195;Ne;0;0;6;6
1895;Eglutė;ŽIRNIUKAI;5328886016;Ne;0;11;0;11
1896;Eglutė;ŽIRNIUKAI;7022013669;Ne;2;1;2;5
1897;Eglutė;ŽIRNIUKAI;1894519722;Ne;0;2;0;2
1898;Eglutė;BORUŽIUKAI;5982037450;Ne;4;0;2;6
1899;Eglutė;BORUŽIUKAI;7994301287;Ne;0;10;0;10
1900;Eglutė;BORUŽIUKAI;9300315869;Ne;13;0;0;13
1901;Eglutė;BORUŽIUKAI;4476918512;Taip;13;0;7;20
1902;Eglutė;BORUŽIUKAI;8751687849;Ne;5;0;2;7
1903;Eglutė;BORUŽIUKAI;3228447710;Ne;12;0;2;14
1904;Eglutė;BORUŽIUKAI;7288367894;Ne;8;2;4;14
1905;Eglutė;BORUŽIUKAI;1446642492;Ne;10;2;2;14
1906;Eglutė;BORUŽIUKAI;4254216169;Ne;8;0;4;12
1907;Eglutė;BORUŽIUKAI;9894789541;Ne;22;0;0;22
1908;Eglutė;BORUŽIUKAI;1699040995;Ne;3;0;2;5
1909;Eglutė;BORUŽIUKAI;7184265921;Ne;5;0;2;7
1910;Eglutė;BORUŽIUKAI;6966897830;Ne;5;0;2;7
1911;Eglutė;BORUŽIUKAI;9925814376;Ne;22;0;0;22
1912;Eglutė;BORUŽIUKAI;3444532702;Ne;20;0;2;22
1913;"Geniukų kalvė";SAULUTĖS;4329782598;Ne;10;5;2;17
1914;"Geniukų kalvė";SAULUTĖS;8932671578;Ne;2;12;2;16
1915;"Geniukų kalvė";SAULUTĖS;9522911738;Ne;3;1;3;7
1916;"Geniukų kalvė";SAULUTĖS;5348211316;Ne;0;1;0;1
1917;"Geniukų kalvė";SAULUTĖS;4946218794;Ne;0;2;2;4
1918;"Geniukų kalvė";SAULUTĖS;4525874796;Ne;0;2;0;2
1919;"Geniukų kalvė";SAULUTĖS;4745451344;Ne;0;2;3;5
1920;"Geniukų kalvė";SAULUTĖS;9768077014;Ne;0;2;1;3
1921;"Geniukų kalvė";SAULUTĖS;3889643236;Ne;0;1;0;1
1922;"Geniukų kalvė";SAULUTĖS;6102906310;Ne;0;2;0;2
1923;"Geniukų kalvė";SAULUTĖS;6016735700;Ne;0;4;0;4
1924;"Geniukų kalvė";SAULUTĖS;9976423099;Ne;3;0;2;5
1925;"Geniukų kalvė";SAULUTĖS;5180240547;Ne;2;2;2;6
1926;"Geniukų kalvė";SAULUTĖS;7140298387;Ne;7;2;4;13
1927;"Geniukų kalvė";SAULUTĖS;7006566384;Ne;0;0;1;1
1928;"Geniukų kalvė";SAULUTĖS;2525115674;Ne;2;0;2;4
1929;"Geniukų kalvė";SAULUTĖS;1571869318;Ne;0;2;0;2
1930;"Geniukų kalvė";BITUTĖS;5587035951;Ne;4;1;4;9
1931;"Geniukų kalvė";BITUTĖS;9323779212;Ne;6;0;2;8
1932;"Geniukų kalvė";BITUTĖS;4908674542;Ne;0;1;1;2
1933;"Geniukų kalvė";BITUTĖS;2110578252;Ne;0;4;1;5
1934;"Geniukų kalvė";BITUTĖS;8577323715;Ne;3;2;2;7
1935;"Geniukų kalvė";BITUTĖS;7453065865;Ne;10;0;6;16
1936;"Geniukų kalvė";BITUTĖS;8570015975;Ne;1;0;2;3
1937;"Geniukų kalvė";BITUTĖS;9455124402;Ne;0;0;2;2
1938;"Geniukų kalvė";BITUTĖS;4633553106;Ne;7;0;4;11
1939;"Geniukų kalvė";BITUTĖS;3669378459;Ne;8;0;2;10
1940;"Geniukų kalvė";BITUTĖS;4201333532;Ne;5;6;3;14
1941;"Geniukų kalvė";BITUTĖS;5102325807;Ne;12;3;2;17
1942;"Geniukų kalvė";BITUTĖS;1492140432;Ne;7;0;4;11
1943;"Geniukų kalvė";BITUTĖS;1426555835;Ne;0;2;0;2
1944;"Geniukų kalvė";BITUTĖS;7747615302;Ne;3;10;2;15
1945;"Geniukų kalvė";BITUTĖS;4691978116;Ne;10;0;3;13
1946;"Geniukų kalvė";BITUTĖS;6111168227;Ne;0;2;0;2
1947;"Geniukų kalvė";BITUTĖS;7744441981;Ne;0;0;2;2
1948;"Geniukų kalvė";BITUTĖS;1209268848;Ne;0;0;2;2
1949;"Geniukų kalvė";BITUTĖS;6351861630;Ne;8;2;2;12
1950;"Geniukų kalvė";BITUTĖS;6214681079;Ne;0;9;0;9
1951;"Geniukų kalvė";BITUTĖS;3221034847;Ne;3;1;2;6
1952;"Geniukų kalvė";BITUTĖS;2813336498;Ne;5;0;2;7
1953;"Geniukų kalvė";KIŠKUČIAI;5253380852;Ne;1;0;2;3
1954;"Geniukų kalvė";KIŠKUČIAI;2684344984;Ne;6;0;2;8
1955;"Geniukų kalvė";KIŠKUČIAI;5078771341;Ne;0;1;0;1
1956;"Geniukų kalvė";KIŠKUČIAI;4849740486;Ne;2;0;2;4
1957;"Geniukų kalvė";KIŠKUČIAI;9730758999;Ne;0;2;2;4
1958;"Geniukų kalvė";KIŠKUČIAI;9579750299;Ne;6;0;4;10
1959;"Geniukų kalvė";KIŠKUČIAI;9543553237;Ne;0;0;1;1
1960;"Geniukų kalvė";KIŠKUČIAI;2032408983;Ne;0;0;1;1
1961;"Geniukų kalvė";KIŠKUČIAI;9386761753;Ne;9;0;2;11
1962;"Geniukų kalvė";KIŠKUČIAI;4864216994;Ne;3;0;2;5
1963;"Geniukų kalvė";KIŠKUČIAI;6188518268;Ne;0;18;0;18
1964;"Geniukų kalvė";KIŠKUČIAI;1945456486;Ne;0;0;2;2
1965;"Geniukų kalvė";KIŠKUČIAI;3887137828;Ne;11;0;2;13
1966;"Geniukų kalvė";KIŠKUČIAI;2396085192;Ne;0;5;2;7
1967;"Geniukų kalvė";KIŠKUČIAI;8760512032;Ne;8;0;2;10
1968;"Geniukų kalvė";KIŠKUČIAI;4249054993;Ne;3;2;3;8
1969;"Geniukų kalvė";KIŠKUČIAI;1642514752;Ne;0;0;3;3
1970;"Geniukų kalvė";KIŠKUČIAI;9199949456;Ne;3;0;2;5
1971;"Geniukų kalvė";KIŠKUČIAI;9368537477;Ne;4;0;4;8
1972;"Geniukų kalvė";KIŠKUČIAI;6022259388;Ne;2;13;2;17
1973;"Geniukų kalvė";KIŠKUČIAI;8340662627;Ne;0;2;2;4
1974;"Geniukų kalvė";KIŠKUČIAI;5817320560;Ne;5;0;5;10
1975;"Geniukų kalvė";VYTURĖLIAI;4958738745;Ne;0;3;0;3
1976;"Geniukų kalvė";VYTURĖLIAI;9069256760;Ne;1;2;2;5
1977;"Geniukų kalvė";VYTURĖLIAI;2665955524;Ne;1;0;2;3
1978;"Geniukų kalvė";VYTURĖLIAI;5161535756;Ne;7;3;2;12
1979;"Geniukų kalvė";VYTURĖLIAI;3493492581;Ne;0;2;0;2
1980;"Geniukų kalvė";VYTURĖLIAI;3193006249;Ne;0;1;0;1
1981;"Geniukų kalvė";VYTURĖLIAI;6828079735;Ne;0;2;0;2
1982;"Geniukų kalvė";VYTURĖLIAI;2205515766;Ne;0;1;0;1
1983;"Geniukų kalvė";VYTURĖLIAI;8769761434;Ne;0;2;3;5
1984;"Geniukų kalvė";VYTURĖLIAI;1454724752;Ne;3;2;2;7
1985;"Geniukų kalvė";VYTURĖLIAI;1891205998;Ne;0;2;0;2
1986;"Geniukų kalvė";VYTURĖLIAI;3085228868;Ne;0;2;2;4
1987;"Geniukų kalvė";VYTURĖLIAI;3297360222;Ne;4;3;3;10
1988;"Geniukų kalvė";VYTURĖLIAI;6794151223;Ne;0;3;0;3
1989;"Geniukų kalvė";VYTURĖLIAI;4777155321;Ne;3;2;2;7
1990;"Geniukų kalvė";VYTURĖLIAI;9643242164;Ne;3;5;2;10
1991;"Geniukų kalvė";VYTURĖLIAI;5684792148;Ne;4;2;2;8
1992;"Geniukų kalvė";DRUGELIAI;2217221922;Ne;0;2;0;2
1993;"Geniukų kalvė";DRUGELIAI;1811866428;Ne;0;2;0;2
1994;"Geniukų kalvė";DRUGELIAI;8271041553;Ne;0;3;0;3
1995;"Geniukų kalvė";DRUGELIAI;1237228692;Ne;0;3;0;3
1996;"Geniukų kalvė";DRUGELIAI;3055777730;Ne;0;3;0;3
1997;"Geniukų kalvė";DRUGELIAI;8770345339;Ne;0;1;7;8
1998;"Geniukų kalvė";DRUGELIAI;1051563985;Ne;0;2;0;2
1999;"Geniukų kalvė";DRUGELIAI;5146141771;Ne;0;1;2;3
2000;"Geniukų kalvė";DRUGELIAI;6174114461;Ne;0;2;1;3
2001;"Geniukų kalvė";DRUGELIAI;1611845627;Ne;0;2;0;2
2002;"Geniukų kalvė";DRUGELIAI;6237208661;Ne;0;6;0;6
2003;"Geniukų kalvė";DRUGELIAI;2659298240;Ne;0;3;0;3
2004;"Geniukų kalvė";DRUGELIAI;9677583445;Ne;0;5;0;5
2005;"Geniukų kalvė";DRUGELIAI;6737863183;Ne;0;4;0;4
2006;"Geniukų kalvė";DRUGELIAI;5704223824;Ne;0;3;0;3
2007;"Geniukų kalvė";DRUGELIAI;3166309530;Ne;0;2;0;2
2008;"Geniukų kalvė";"SAULĖS ZUIKUČIAI";7033628178;Ne;0;5;0;5
2009;"Geniukų kalvė";"SAULĖS ZUIKUČIAI";7082945033;Ne;2;0;3;5
2010;"Geniukų kalvė";"SAULĖS ZUIKUČIAI";2313382307;Ne;0;2;1;3
2011;"Geniukų kalvė";"SAULĖS ZUIKUČIAI";8309953586;Ne;2;0;3;5
2012;"Geniukų kalvė";"SAULĖS ZUIKUČIAI";7500079028;Ne;6;0;3;9
2013;"Geniukų kalvė";"SAULĖS ZUIKUČIAI";8071493871;Ne;3;2;5;10
2014;"Geniukų kalvė";"SAULĖS ZUIKUČIAI";1718428600;Ne;0;0;1;1
2015;"Geniukų kalvė";"SAULĖS ZUIKUČIAI";8914605154;Ne;0;2;0;2
2016;"Geniukų kalvė";"SAULĖS ZUIKUČIAI";6016585056;Ne;4;0;6;10
2017;"Geniukų kalvė";"SAULĖS ZUIKUČIAI";2816691996;Ne;0;2;0;2
2018;"Geniukų kalvė";"SAULĖS ZUIKUČIAI";5512172533;Ne;0;6;0;6
2019;"Geniukų kalvė";"SAULĖS ZUIKUČIAI";1375674317;Ne;0;3;0;3
2020;"Geniukų kalvė";"SAULĖS ZUIKUČIAI";4722801116;Ne;0;1;0;1
2021;"Geniukų kalvė";"SAULĖS ZUIKUČIAI";5763009912;Ne;0;5;0;5
2022;"Geniukų kalvė";"SAULĖS ZUIKUČIAI";5245434552;Ne;1;3;2;6
2023;"Geniukų kalvė";"SAULĖS ZUIKUČIAI";5725034297;Ne;0;9;0;9
2024;"Geniukų kalvė";"SAULĖS ZUIKUČIAI";1499735818;Ne;3;1;2;6
2025;"Geniukų kalvė";"SAULĖS ZUIKUČIAI";4186376527;Ne;0;4;1;5
2026;"Geniukų kalvė";"SAULĖS ZUIKUČIAI";5161600326;Ne;8;0;10;18
2027;"Geniukų kalvė";"SAULĖS ZUIKUČIAI";4975437036;Ne;0;0;1;1
2028;"Geniukų kalvė";"SAULĖS ZUIKUČIAI";1277485419;Ne;0;4;0;4
2029;"Geniukų kalvė";SMALSUČIAI;2499796674;Ne;2;0;2;4
2030;"Geniukų kalvė";SMALSUČIAI;5974481787;Ne;3;1;4;8
2031;"Geniukų kalvė";SMALSUČIAI;7915720190;Ne;3;1;4;8
2032;"Geniukų kalvė";SMALSUČIAI;8985466295;Ne;2;3;2;7
2033;"Geniukų kalvė";SMALSUČIAI;5129841490;Ne;12;2;2;16
2034;"Geniukų kalvė";SMALSUČIAI;5705917381;Ne;3;1;2;6
2035;"Geniukų kalvė";SMALSUČIAI;4231659246;Ne;0;0;2;2
2036;"Geniukų kalvė";SMALSUČIAI;2300947427;Ne;0;6;0;6
2037;"Geniukų kalvė";SMALSUČIAI;2596680448;Ne;0;2;0;2
2038;"Geniukų kalvė";SMALSUČIAI;4405381922;Ne;2;2;0;4
2039;"Geniukų kalvė";SMALSUČIAI;3627418555;Ne;3;12;2;17
2040;"Geniukų kalvė";SMALSUČIAI;9155681194;Ne;3;3;3;9
2041;"Geniukų kalvė";SMALSUČIAI;7440029486;Ne;2;4;2;8
2042;"Geniukų kalvė";SMALSUČIAI;6168422514;Ne;10;2;4;16
2043;"Geniukų kalvė";SMALSUČIAI;6514696294;Ne;0;6;0;6
2044;"Geniukų kalvė";SMALSUČIAI;1573612317;Ne;3;3;2;8
2045;"Geniukų kalvė";SMALSUČIAI;6138451393;Ne;0;4;0;4
2046;"Geniukų kalvė";RUDNOSIUKAI;7079072084;Ne;2;0;6;8
2047;"Geniukų kalvė";RUDNOSIUKAI;6060825704;Ne;0;9;2;11
2048;"Geniukų kalvė";RUDNOSIUKAI;6149037133;Ne;0;8;0;8
2049;"Geniukų kalvė";RUDNOSIUKAI;5883913787;Ne;0;2;0;2
2050;"Geniukų kalvė";RUDNOSIUKAI;9696452101;Ne;0;1;1;2
2051;"Geniukų kalvė";RUDNOSIUKAI;5205178173;Ne;8;2;3;13
2052;"Geniukų kalvė";RUDNOSIUKAI;9847003556;Ne;4;0;2;6
2053;"Geniukų kalvė";RUDNOSIUKAI;5443596677;Ne;0;1;0;1
2054;"Geniukų kalvė";RUDNOSIUKAI;7300853810;Ne;0;2;0;2
2055;"Geniukų kalvė";RUDNOSIUKAI;2839299179;Ne;0;0;1;1
2056;"Geniukų kalvė";RUDNOSIUKAI;4664026888;Ne;1;0;2;3
2057;"Geniukų kalvė";RUDNOSIUKAI;3852896932;Ne;1;0;2;3
2058;"Geniukų kalvė";RUDNOSIUKAI;2165793561;Ne;0;8;0;8
2059;"Geniukų kalvė";RUDNOSIUKAI;4985606198;Ne;0;0;6;6
2060;"Geniukų kalvė";RUDNOSIUKAI;3631181701;Ne;0;0;1;1
2061;"Geniukų kalvė";RUDNOSIUKAI;2798750158;Ne;0;3;0;3
2062;"Geniukų kalvė";RUDNOSIUKAI;4476754204;Ne;0;0;3;3
2063;"Geniukų kalvė";PELĖDŽIUKAI;6783296167;Ne;2;0;4;6
2064;"Geniukų kalvė";PELĖDŽIUKAI;1844495906;Ne;3;2;2;7
2065;"Geniukų kalvė";PELĖDŽIUKAI;7234620406;Ne;2;0;2;4
2066;"Geniukų kalvė";PELĖDŽIUKAI;5744371590;Ne;2;0;2;4
2067;"Geniukų kalvė";PELĖDŽIUKAI;5847488152;Ne;7;2;3;12
2068;"Geniukų kalvė";PELĖDŽIUKAI;4890413509;Ne;3;0;4;7
2069;"Geniukų kalvė";PELĖDŽIUKAI;2490231586;Ne;6;0;2;8
2070;"Geniukų kalvė";PELĖDŽIUKAI;9319251542;Ne;0;2;3;5
2071;"Geniukų kalvė";PELĖDŽIUKAI;7310171451;Ne;1;7;2;10
2072;"Geniukų kalvė";PELĖDŽIUKAI;8653679467;Ne;0;5;0;5
2073;"Geniukų kalvė";PELĖDŽIUKAI;9820642056;Ne;0;3;2;5
2074;"Geniukų kalvė";PELĖDŽIUKAI;5115570519;Ne;0;0;2;2
2075;"Geniukų kalvė";PELĖDŽIUKAI;1179440839;Ne;1;0;2;3
2076;"Geniukų kalvė";PELĖDŽIUKAI;8277880528;Taip;2;0;4;6
2077;"Geniukų kalvė";PELĖDŽIUKAI;4037514656;Ne;6;2;4;12
2078;"Geniukų kalvė";PELĖDŽIUKAI;2884835744;Ne;5;0;4;9
2079;"Geniukų kalvė";PELĖDŽIUKAI;9958205266;Ne;1;0;4;5
2080;"Geniukų kalvė";PELĖDŽIUKAI;9107673658;Ne;1;0;3;4
2081;"Geniukų kalvė";PELĖDŽIUKAI;3921191150;Ne;0;0;2;2
2082;"Geniukų kalvė";BORUŽĖLĖS;7561521903;Ne;4;0;4;8
2083;"Geniukų kalvė";BORUŽĖLĖS;2312298671;Ne;7;2;4;13
2084;"Geniukų kalvė";BORUŽĖLĖS;8217855034;Ne;0;9;0;9
2085;"Geniukų kalvė";BORUŽĖLĖS;1068112116;Ne;8;0;2;10
2086;"Geniukų kalvė";BORUŽĖLĖS;1421857914;Ne;9;0;4;13
2087;"Geniukų kalvė";BORUŽĖLĖS;1558977259;Ne;0;1;2;3
2088;"Geniukų kalvė";BORUŽĖLĖS;7736527608;Ne;0;1;0;1
2089;"Geniukų kalvė";BORUŽĖLĖS;4805806745;Ne;4;0;3;7
2090;"Geniukų kalvė";BORUŽĖLĖS;1383717352;Ne;4;0;3;7
2091;"Geniukų kalvė";BORUŽĖLĖS;3071724778;Ne;3;2;3;8
2092;"Geniukų kalvė";BORUŽĖLĖS;2302465593;Ne;5;2;6;13
2093;"Geniukų kalvė";BORUŽĖLĖS;3024701779;Ne;0;10;0;10
2094;"Geniukų kalvė";BORUŽĖLĖS;1822730314;Ne;10;0;5;15
2095;"Geniukų kalvė";BORUŽĖLĖS;3015544833;Ne;8;3;5;16
2096;"Geniukų kalvė";BORUŽĖLĖS;9264121921;Ne;0;9;2;11
2097;"Geniukų kalvė";BORUŽĖLĖS;3071147714;Ne;8;2;2;12
2098;"Geniukų kalvė";BORUŽĖLĖS;7776771879;Ne;0;0;2;2
2099;"Geniukų kalvė";BORUŽĖLĖS;9446649021;Ne;0;2;1;3
2100;"Geniukų kalvė";BORUŽĖLĖS;1733621845;Ne;10;0;2;12
2101;"Geniukų kalvė";BORUŽĖLĖS;9445669807;Ne;3;0;2;5
2102;"Geniukų kalvė";PAGRANDUKAI;8525540366;Ne;0;0;2;2
2103;"Geniukų kalvė";PAGRANDUKAI;8214399001;Ne;3;5;2;10
2104;"Geniukų kalvė";PAGRANDUKAI;4651934103;Ne;0;0;2;2
2105;"Geniukų kalvė";PAGRANDUKAI;2905400583;Ne;3;2;2;7
2106;"Geniukų kalvė";PAGRANDUKAI;2584997232;Ne;8;3;3;14
2107;"Geniukų kalvė";PAGRANDUKAI;3430336639;Ne;3;2;2;7
2108;"Geniukų kalvė";PAGRANDUKAI;1330046867;Ne;12;0;4;16
2109;"Geniukų kalvė";PAGRANDUKAI;9669738771;Ne;0;2;0;2
2110;"Geniukų kalvė";PAGRANDUKAI;3446219974;Ne;0;1;0;1
2111;"Geniukų kalvė";PAGRANDUKAI;9483545114;Ne;8;2;4;14
2112;"Geniukų kalvė";PAGRANDUKAI;8987495724;Ne;0;3;1;4
2113;"Geniukų kalvė";PAGRANDUKAI;1060081499;Ne;2;2;4;8
2114;"Geniukų kalvė";PAGRANDUKAI;3961089171;Taip;3;3;2;8
2115;"Geniukų kalvė";PAGRANDUKAI;9261284850;Ne;0;2;3;5
2116;"Geniukų kalvė";PAGRANDUKAI;3110653516;Ne;3;5;2;10
2117;"Geniukų kalvė";NYKŠTUKAI;9322790214;Ne;0;3;2;5
2118;"Geniukų kalvė";NYKŠTUKAI;6680434763;Ne;0;10;0;10
2119;"Geniukų kalvė";NYKŠTUKAI;7161460256;Ne;6;2;3;11
2120;"Geniukų kalvė";NYKŠTUKAI;3484288126;Ne;3;0;4;7
2121;"Geniukų kalvė";NYKŠTUKAI;9111691146;Ne;0;2;0;2
2122;"Geniukų kalvė";NYKŠTUKAI;7093135374;Ne;0;0;1;1
2123;"Geniukų kalvė";NYKŠTUKAI;3227799882;Ne;11;2;4;17
2124;"Geniukų kalvė";NYKŠTUKAI;1639585179;Ne;0;2;1;3
2125;"Geniukų kalvė";NYKŠTUKAI;4251353237;Ne;0;0;15;15
2126;"Geniukų kalvė";NYKŠTUKAI;6262489669;Ne;3;2;2;7
2127;"Geniukų kalvė";NYKŠTUKAI;3942415928;Ne;0;7;0;7
2128;"Geniukų kalvė";NYKŠTUKAI;1828348351;Ne;5;2;3;10
2129;"Geniukų kalvė";NYKŠTUKAI;1842445148;Taip;5;0;3;8
2130;"Geniukų kalvė";NYKŠTUKAI;3601085940;Ne;1;0;2;3
2131;Gelvonėlis;ĄŽUOLIUKAI;2329699993;Taip;3;3;2;8
2132;Gelvonėlis;ĄŽUOLIUKAI;9058956012;Ne;3;2;2;7
2133;Gelvonėlis;ĄŽUOLIUKAI;4111774915;Ne;0;3;0;3
2134;Gelvonėlis;ĄŽUOLIUKAI;3677100165;Ne;16;0;2;18
2135;Gelvonėlis;ĄŽUOLIUKAI;7449710008;Ne;0;3;0;3
2136;Gelvonėlis;ĄŽUOLIUKAI;8163855482;Ne;4;0;2;6
2137;Gelvonėlis;ĄŽUOLIUKAI;3942630720;Ne;0;8;0;8
2138;Gelvonėlis;ĄŽUOLIUKAI;1453271708;Taip;0;2;0;2
2139;Gelvonėlis;ĄŽUOLIUKAI;9756155028;Ne;18;0;2;20
2140;Gelvonėlis;ĄŽUOLIUKAI;8206816148;Ne;8;0;3;11
2141;Gelvonėlis;ĄŽUOLIUKAI;1274119900;Taip;0;13;0;13
2142;Gelvonėlis;ĄŽUOLIUKAI;1403890893;Ne;0;0;6;6
2143;Gelvonėlis;ĄŽUOLIUKAI;2519955694;Ne;1;1;2;4
2144;Gelvonėlis;ĄŽUOLIUKAI;6620102515;Ne;0;0;2;2
2145;Gelvonėlis;ĄŽUOLIUKAI;6451006729;Ne;2;0;0;2
2146;Gelvonėlis;ĄŽUOLIUKAI;4190673346;Ne;10;6;2;18
2147;Gelvonėlis;ĄŽUOLIUKAI;2289745479;Ne;10;0;2;12
2148;Gelvonėlis;ĄŽUOLIUKAI;4913415466;Ne;0;0;5;5
2149;Gelvonėlis;ŽVIRBLIUKAI;5024860112;Ne;0;5;0;5
2150;Gelvonėlis;ŽVIRBLIUKAI;8987012601;Ne;8;0;2;10
2151;Gelvonėlis;ŽVIRBLIUKAI;1112841066;Ne;0;16;0;16
2152;Gelvonėlis;ŽVIRBLIUKAI;4156493586;Ne;3;12;2;17
2153;Gelvonėlis;ŽVIRBLIUKAI;8003522011;Ne;5;3;4;12
2154;Gelvonėlis;ŽVIRBLIUKAI;9900244859;Ne;11;0;3;14
2155;Gelvonėlis;ŽVIRBLIUKAI;4027647695;Ne;9;0;2;11
2156;Gelvonėlis;ŽVIRBLIUKAI;5713586282;Ne;3;2;2;7
2157;Gelvonėlis;ŽVIRBLIUKAI;8560940316;Ne;0;2;0;2
2158;Gelvonėlis;ŽVIRBLIUKAI;5874473596;Ne;0;5;0;5
2159;Gelvonėlis;ŽVIRBLIUKAI;8540204705;Ne;0;1;0;1
2160;Gelvonėlis;ŽVIRBLIUKAI;8124516993;Ne;13;2;4;19
2161;Gelvonėlis;ŽVIRBLIUKAI;7888968558;Ne;1;2;4;7
2162;Gelvonėlis;ŽVIRBLIUKAI;6261019627;Ne;0;1;7;8
2163;Gelvonėlis;ŽVIRBLIUKAI;6467749949;Ne;0;0;1;1
2164;Gelvonėlis;RASELĖS;1925203042;Ne;0;2;2;4
2165;Gelvonėlis;RASELĖS;5996128423;Ne;10;1;2;13
2166;Gelvonėlis;RASELĖS;9149117970;Ne;0;2;0;2
2167;Gelvonėlis;RASELĖS;6451557430;Ne;0;1;0;1
2168;Gelvonėlis;RASELĖS;1802520150;Ne;0;2;1;3
2169;Gelvonėlis;RASELĖS;3192542909;Ne;3;7;3;13
2170;Gelvonėlis;RASELĖS;9622818893;Ne;0;0;2;2
2171;Gelvonėlis;RASELĖS;2638430817;Ne;0;2;6;8
2172;Gelvonėlis;RASELĖS;6949090250;Ne;0;0;1;1
2173;Gelvonėlis;RASELĖS;1462716950;Ne;4;5;2;11
2174;Gelvonėlis;RASELĖS;9600526942;Ne;0;5;0;5
2175;Gelvonėlis;RASELĖS;1387948936;Ne;0;8;0;8
2176;Gelvonėlis;RASELĖS;9650922918;Ne;0;1;0;1
2177;Gelvonėlis;RASELĖS;5790038422;Ne;0;2;0;2
2178;Gelvonėlis;RASELĖS;1587584701;Ne;0;0;1;1
2179;Gelvonėlis;RASELĖS;7450074548;Ne;9;2;6;17
2180;Gelvonėlis;SAULUTĖ;7392743619;Taip;2;0;4;6
2181;Gelvonėlis;SAULUTĖ;1368982977;Taip;0;2;0;2
2182;Gelvonėlis;SAULUTĖ;4550077609;Taip;0;0;2;2
2183;Gelvonėlis;SAULUTĖ;1734685590;Taip;2;0;4;6
2184;Gelvonėlis;SAULUTĖ;3719670896;Taip;0;5;0;5
2185;Gelvonėlis;SAULUTĖ;1672409070;Ne;6;0;6;12
2186;Gelvonėlis;SAULUTĖ;3771796903;Ne;10;0;3;13
2187;Gelvonėlis;SAULUTĖ;4268590631;Ne;0;0;2;2
2188;Gelvonėlis;SAULUTĖ;5598186460;Ne;0;1;0;1
2189;Gelvonėlis;SAULUTĖ;9767254134;Ne;1;1;2;4
2190;Gelvonėlis;SAULUTĖ;2452711535;Ne;0;3;0;3
2191;Gelvonėlis;SAULUTĖ;3371560338;Ne;2;2;2;6
2192;Gelvonėlis;SAULUTĖ;4228323474;Ne;0;2;0;2
2193;Gelvonėlis;SAULUTĖ;2800795052;Ne;0;5;0;5
2194;Gelvonėlis;SAULUTĖ;6206837435;Ne;0;0;1;1
2195;Gelvonėlis;SAULUTĖ;6840560863;Ne;2;0;4;6
2196;Gelvonėlis;PELĖDŽIUKAI;6604992169;Ne;8;2;2;12
2197;Gelvonėlis;PELĖDŽIUKAI;8508450500;Ne;0;9;0;9
2198;Gelvonėlis;PELĖDŽIUKAI;6556472766;Ne;0;2;0;2
2199;Gelvonėlis;PELĖDŽIUKAI;7182180008;Ne;0;3;0;3
2200;Gelvonėlis;PELĖDŽIUKAI;8976258838;Ne;7;0;3;10
2201;Gelvonėlis;PELĖDŽIUKAI;6598178467;Ne;0;3;3;6
2202;Gelvonėlis;PELĖDŽIUKAI;8885088900;Ne;0;3;1;4
2203;Gelvonėlis;PELĖDŽIUKAI;2400289466;Ne;0;2;3;5
2204;Gelvonėlis;PELĖDŽIUKAI;9493536517;Ne;0;2;0;2
2205;Gelvonėlis;PELĖDŽIUKAI;9059244134;Ne;0;2;0;2
2206;Gelvonėlis;PELĖDŽIUKAI;1987204544;Ne;0;3;0;3
2207;Gelvonėlis;PELĖDŽIUKAI;2288951845;Ne;0;2;0;2
2208;Gelvonėlis;PELĖDŽIUKAI;2515471132;Ne;1;0;3;4
2209;Gelvonėlis;PELĖDŽIUKAI;4281431471;Ne;0;0;6;6
2210;Gelvonėlis;PELĖDŽIUKAI;6319058542;Ne;0;1;0;1
2211;Gelvonėlis;PELĖDŽIUKAI;9538571448;Ne;0;2;0;2
2212;Gelvonėlis;PELĖDŽIUKAI;9147186080;Ne;3;0;2;5
2213;Gelvonėlis;PELĖDŽIUKAI;7195164378;Ne;4;2;3;9
2214;Gelvonėlis;PELĖDŽIUKAI;8704971956;Ne;0;0;2;2
2215;Gelvonėlis;DRUGELIAI;2407650243;Ne;0;4;1;5
2216;Gelvonėlis;DRUGELIAI;2407650243;Ne;0;4;1;5
2217;Gelvonėlis;DRUGELIAI;7262185834;Ne;1;2;2;5
2218;Gelvonėlis;DRUGELIAI;2498523344;Ne;0;17;0;17
2219;Gelvonėlis;DRUGELIAI;7733244178;Ne;0;3;0;3
2220;Gelvonėlis;DRUGELIAI;1252450619;Ne;7;0;4;11
2221;Gelvonėlis;DRUGELIAI;7811394993;Ne;7;0;4;11
2222;Gelvonėlis;DRUGELIAI;6197211003;Ne;0;2;0;2
2223;Gelvonėlis;DRUGELIAI;1723279380;Ne;12;0;2;14
2224;Gelvonėlis;DRUGELIAI;4125444433;Ne;0;3;0;3
2225;Gelvonėlis;DRUGELIAI;5104092000;Ne;0;3;0;3
2226;Gelvonėlis;DRUGELIAI;5301772700;Ne;0;3;0;3
2227;Gelvonėlis;DRUGELIAI;7408801401;Ne;3;0;2;5
2228;Gelvonėlis;DRUGELIAI;4738577955;Ne;8;5;2;15
2229;Gelvonėlis;DRUGELIAI;3452557722;Ne;8;0;4;12
2230;Gelvonėlis;DRUGELIAI;2045223350;Ne;3;9;2;14
2231;Gelvonėlis;DRUGELIAI;5535353908;Ne;6;0;4;10
2232;Gelvonėlis;DRUGELIAI;5850515555;Taip;9;2;4;15
2233;Gelvonėlis;VARPELIAI;6131268672;Ne;16;0;2;18
2234;Gelvonėlis;VARPELIAI;4088437014;Ne;15;5;2;22
2235;Gelvonėlis;VARPELIAI;3150970953;Ne;7;0;6;13
2236;Gelvonėlis;VARPELIAI;2896360160;Ne;0;1;1;2
2237;Gelvonėlis;VARPELIAI;4162701876;Ne;0;1;0;1
2238;Gelvonėlis;VARPELIAI;8365647638;Ne;0;1;0;1
2239;Gelvonėlis;VARPELIAI;9386056584;Ne;2;0;0;2
2240;Gelvonėlis;VARPELIAI;2114734415;Ne;7;2;5;14
2241;Gelvonėlis;VARPELIAI;2645337382;Taip;2;0;2;4
2242;Gelvonėlis;VARPELIAI;3813000890;Ne;0;0;1;1
2243;Gelvonėlis;VARPELIAI;6662081736;Ne;3;0;2;5
2244;Gelvonėlis;VARPELIAI;5379820728;Ne;0;0;3;3
2245;Gelvonėlis;VARPELIAI;7938324572;Ne;0;6;0;6
2246;Gelvonėlis;VARPELIAI;1984082487;Ne;0;19;0;19
2247;Gelvonėlis;BORUŽĖLĖS;8209225630;Ne;0;2;1;3
2248;Gelvonėlis;BORUŽĖLĖS;6554989142;Ne;0;2;0;2
2249;Gelvonėlis;BORUŽĖLĖS;8056058298;Ne;0;2;0;2
2250;Gelvonėlis;BORUŽĖLĖS;2434789595;Ne;0;2;0;2
2251;Gelvonėlis;BORUŽĖLĖS;2698853686;Ne;2;0;0;2
2252;Gelvonėlis;BORUŽĖLĖS;4112607183;Ne;0;2;2;4
2253;Gelvonėlis;BORUŽĖLĖS;6243360625;Ne;0;8;0;8
2254;Gelvonėlis;BORUŽĖLĖS;1712926391;Ne;0;2;7;9
2255;Gelvonėlis;BORUŽĖLĖS;6647585785;Ne;1;0;7;8
2256;Gelvonėlis;BORUŽĖLĖS;1539850989;Ne;0;0;2;2
2257;Gelvonėlis;BORUŽĖLĖS;8973272332;Ne;0;2;0;2
2258;Gelvonėlis;BORUŽĖLĖS;9849765037;Ne;0;2;2;4
2259;Gelvonėlis;BORUŽĖLĖS;3846916445;Ne;0;2;0;2
2260;Gelvonėlis;BORUŽĖLĖS;4749071286;Ne;0;4;0;4
2261;Gelvonėlis;BORUŽĖLĖS;3926733474;Ne;1;2;4;7
2262;Gelvonėlis;BORUŽĖLĖS;4620517551;Ne;3;0;3;6
2263;Gelvonėlis;BORUŽĖLĖS;6598688551;Ne;7;0;2;9
2264;Gelvonėlis;BORUŽĖLĖS;6680287456;Ne;0;4;2;6
2265;Gelvonėlis;BORUŽĖLĖS;2752664352;Ne;1;4;2;7
2266;Gelvonėlis;NYKŠTUKAI;9150177446;Ne;7;2;4;13
2267;Gelvonėlis;NYKŠTUKAI;5311057148;Ne;3;3;4;10
2268;Gelvonėlis;NYKŠTUKAI;9266138595;Ne;22;0;0;22
2269;Gelvonėlis;NYKŠTUKAI;6740297512;Ne;17;0;2;19
2270;Gelvonėlis;NYKŠTUKAI;2302268767;Ne;15;0;2;17
2271;Gelvonėlis;NYKŠTUKAI;4723497260;Ne;4;0;3;7
2272;Gelvonėlis;NYKŠTUKAI;8962769076;Ne;13;0;5;18
2273;Gelvonėlis;NYKŠTUKAI;3173327297;Ne;1;2;2;5
2274;Gelvonėlis;NYKŠTUKAI;2820416461;Ne;4;0;4;8
2275;Gelvonėlis;NYKŠTUKAI;9529938060;Ne;0;2;0;2
2276;Gelvonėlis;NYKŠTUKAI;6072327798;Ne;0;12;0;12
2277;Gelvonėlis;NYKŠTUKAI;4423931995;Ne;0;0;1;1
2278;Gelvonėlis;NYKŠTUKAI;2195887907;Ne;5;0;4;9
2279;Gelvonėlis;NYKŠTUKAI;4244879840;Ne;8;0;2;10
2280;Gelvonėlis;NYKŠTUKAI;1167713450;Ne;14;0;2;16
2281;Gelvonėlis;NYKŠTUKAI;8863386276;Ne;12;0;2;14
2282;Gelvonėlis;NYKŠTUKAI;4827817614;Ne;0;0;2;2
2283;Gelvonėlis;BITUTĖS;6534527571;Ne;0;8;0;8
2284;Gelvonėlis;BITUTĖS;1105838340;Ne;5;7;2;14
2285;Gelvonėlis;BITUTĖS;5865866507;Ne;3;7;3;13
2286;Gelvonėlis;BITUTĖS;5444127599;Ne;2;4;2;8
2287;Gelvonėlis;BITUTĖS;1980703633;Ne;0;0;1;1
2288;Gelvonėlis;BITUTĖS;5633162524;Ne;0;1;0;1
2289;Gelvonėlis;BITUTĖS;6330751030;Ne;0;3;0;3
2290;Gelvonėlis;BITUTĖS;6710189985;Ne;16;0;2;18
2291;Gelvonėlis;BITUTĖS;5281400074;Ne;1;1;1;3
2292;Gelvonėlis;BITUTĖS;3514762919;Ne;0;9;0;9
2293;Gelvonėlis;BITUTĖS;8792171281;Ne;0;2;0;2
2294;Gelvonėlis;BITUTĖS;7850553299;Ne;0;5;1;6
2295;Gelvonėlis;BITUTĖS;1730718430;Ne;17;0;1;18
2296;Gelvonėlis;BITUTĖS;8480138654;Ne;2;3;0;5
2297;Gelvonėlis;BITUTĖS;5816373550;Ne;0;1;1;2
2298;Gelvonėlis;BITUTĖS;4380468764;Ne;5;6;4;15
2299;Gelvonėlis;BITUTĖS;3961569387;Ne;0;3;0;3
2300;Gelvonėlis;BITUTĖS;4388024957;Ne;0;2;5;7
2301;Gelvonėlis;RAMUNĖLĖS;1104204810;Ne;4;2;2;8
2302;Gelvonėlis;RAMUNĖLĖS;1355774181;Ne;3;2;3;8
2303;Gelvonėlis;RAMUNĖLĖS;2774170680;Ne;0;5;0;5
2304;Gelvonėlis;RAMUNĖLĖS;9403505858;Ne;0;18;0;18
2305;Gelvonėlis;RAMUNĖLĖS;7686930719;Ne;4;0;4;8
2306;Gelvonėlis;RAMUNĖLĖS;4450990418;Ne;0;1;0;1
2307;Gelvonėlis;RAMUNĖLĖS;7419947442;Ne;1;0;2;3
2308;Gelvonėlis;RAMUNĖLĖS;6883156109;Ne;0;5;0;5
2309;Gelvonėlis;RAMUNĖLĖS;1562829157;Ne;0;1;0;1
2310;Gelvonėlis;RAMUNĖLĖS;1661034338;Ne;3;0;2;5
2311;Gelvonėlis;RAMUNĖLĖS;2821485779;Ne;5;0;2;7
2312;Gelvonėlis;RAMUNĖLĖS;7301596834;Taip;5;0;2;7
2313;Gelvonėlis;RAMUNĖLĖS;9046297659;Ne;0;15;0;15
2314;Gelvonėlis;RAMUNĖLĖS;7654781219;Ne;0;7;0;7
2315;Gelvonėlis;RAMUNĖLĖS;7464963101;Ne;9;0;4;13
2316;Gelvonėlis;RAMUNĖLĖS;1938685620;Ne;10;0;2;12
2317;Gelvonėlis;RIEŠUTĖLIAI;3368423382;Ne;4;3;2;9
2318;Gelvonėlis;RIEŠUTĖLIAI;5461812139;Ne;0;4;0;4
2319;Gelvonėlis;RIEŠUTĖLIAI;5986018609;Ne;0;2;0;2
2320;Gelvonėlis;RIEŠUTĖLIAI;8532801167;Ne;0;2;0;2
2321;Gelvonėlis;RIEŠUTĖLIAI;4208103106;Ne;0;4;0;4
2322;Gelvonėlis;RIEŠUTĖLIAI;8766702456;Ne;0;2;0;2
2323;Gelvonėlis;RIEŠUTĖLIAI;6305084811;Ne;10;0;7;17
2324;Gelvonėlis;RIEŠUTĖLIAI;2005647155;Ne;8;2;2;12
2325;Gelvonėlis;RIEŠUTĖLIAI;5934077931;Ne;0;6;0;6
2326;Gelvonėlis;RIEŠUTĖLIAI;6471921512;Ne;0;3;0;3
2327;Gelvonėlis;RIEŠUTĖLIAI;3448444552;Ne;0;7;0;7
2328;Gelvonėlis;RIEŠUTĖLIAI;4832167372;Ne;7;3;2;12
2329;Gelvonėlis;RIEŠUTĖLIAI;9301814935;Ne;0;4;0;4
2330;Gelvonėlis;RIEŠUTĖLIAI;1466616814;Ne;0;2;0;2
2331;Gelvonėlis;RIEŠUTĖLIAI;2015807805;Ne;13;3;2;18
2332;Gelvonėlis;RIEŠUTĖLIAI;9323228591;Ne;0;4;3;7
2333;Gelvonėlis;RIEŠUTĖLIAI;2360728722;Ne;7;7;2;16
2334;Gelvonėlis;RIEŠUTĖLIAI;9132529216;Ne;5;2;2;9
2335;"Gervelė (Dzūkų g. 32)";ŽIRNIUKAI;7140356352;Ne;9;0;5;14
2336;"Gervelė (Dzūkų g. 32)";ŽIRNIUKAI;3170062234;Ne;1;0;2;3
2337;"Gervelė (Dzūkų g. 32)";ŽIRNIUKAI;8598429197;Ne;2;0;3;5
2338;"Gervelė (Dzūkų g. 32)";ŽIRNIUKAI;9294388176;Ne;0;0;2;2
2339;"Gervelė (Dzūkų g. 32)";ŽIRNIUKAI;5608916470;Ne;0;2;0;2
2340;"Gervelė (Dzūkų g. 32)";ŽIRNIUKAI;8098158634;Taip;1;2;2;5
2341;"Gervelė (Dzūkų g. 32)";ŽIRNIUKAI;7205673717;Ne;0;2;3;5
2342;"Gervelė (Dzūkų g. 32)";ŽIRNIUKAI;1226130732;Taip;0;5;2;7
2343;"Gervelė (Dzūkų g. 32)";ŽIRNIUKAI;9884946783;Ne;10;1;4;15
2344;"Gervelė (Dzūkų g. 32)";ŽIRNIUKAI;4174471780;Ne;20;0;2;22
2345;"Gervelė (Dzūkų g. 32)";ŽIRNIUKAI;6424240375;Ne;4;0;3;7
2346;"Gervelė (Dzūkų g. 32)";ŽIRNIUKAI;8882442987;Ne;5;0;2;7
2347;"Gervelė (Dzūkų g. 32)";ŽIRNIUKAI;1777909973;Ne;8;0;4;12
2348;"Gervelė (Dzūkų g. 32)";ŽIRNIUKAI;1400829693;Ne;0;0;5;5
2349;"Gervelė (Dzūkų g. 32)";ŽIRNIUKAI;4661861470;Ne;3;0;6;9
2350;"Gervelė (Dzūkų g. 32)";LAŠIUKAI;2523056808;Ne;0;3;2;5
2351;"Gervelė (Dzūkų g. 32)";LAŠIUKAI;2563081304;Ne;0;2;0;2
2352;"Gervelė (Dzūkų g. 32)";LAŠIUKAI;6844406500;Ne;3;3;2;8
2353;"Gervelė (Dzūkų g. 32)";LAŠIUKAI;8811086908;Ne;0;3;2;5
2354;"Gervelė (Dzūkų g. 32)";LAŠIUKAI;2046282471;Ne;13;0;6;19
2355;"Gervelė (Dzūkų g. 32)";LAŠIUKAI;1573560581;Ne;0;2;0;2
2356;"Gervelė (Dzūkų g. 32)";LAŠIUKAI;9133101055;Ne;0;0;2;2
2357;"Gervelė (Dzūkų g. 32)";LAŠIUKAI;7192663882;Ne;0;0;1;1
2358;"Gervelė (Dzūkų g. 32)";LAŠIUKAI;1024397071;Ne;6;0;6;12
2359;"Gervelė (Dzūkų g. 32)";LAŠIUKAI;1783612448;Ne;1;3;6;10
2360;"Gervelė (Dzūkų g. 32)";LAŠIUKAI;7040713170;Ne;0;2;4;6
2361;"Gervelė (Dzūkų g. 32)";LAŠIUKAI;6227091658;Ne;3;5;2;10
2362;"Gervelė (Dzūkų g. 32)";LAŠIUKAI;4075328330;Ne;0;0;4;4
2363;"Gervelė (Dzūkų g. 32)";LAŠIUKAI;7394199974;Ne;1;0;5;6
2364;"Gervelė (Dzūkų g. 32)";LAŠIUKAI;5497737178;Taip;3;0;6;9
2365;"Gervelė (Dzūkų g. 32)";LAŠIUKAI;5480025851;Ne;0;0;4;4
2366;"Gervelė (Dzūkų g. 32)";LAŠIUKAI;7363767471;Ne;15;0;5;20
2367;"Gervelė (Dzūkų g. 32)";LAŠIUKAI;4932912245;Taip;8;5;4;17
2368;"Gervelė (Dzūkų g. 32)";LAŠIUKAI;1808067249;Ne;3;0;5;8
2369;"Gervelė (Dzūkų g. 32)";PABIRUČIAI;1637204236;Ne;0;2;1;3
2370;"Gervelė (Dzūkų g. 32)";PABIRUČIAI;8157865822;Ne;0;2;0;2
2371;"Gervelė (Dzūkų g. 32)";PABIRUČIAI;7924884022;Ne;8;0;5;13
2372;"Gervelė (Dzūkų g. 32)";PABIRUČIAI;3702908570;Ne;0;0;2;2
2373;"Gervelė (Dzūkų g. 32)";PABIRUČIAI;1323074335;Ne;3;0;7;10
2374;"Gervelė (Dzūkų g. 32)";PABIRUČIAI;5799823801;Ne;1;1;2;4
2375;"Gervelė (Dzūkų g. 32)";PABIRUČIAI;6058944385;Ne;0;0;10;10
2376;"Gervelė (Dzūkų g. 32)";PABIRUČIAI;3647044817;Ne;0;2;2;4
2377;"Gervelė (Dzūkų g. 32)";PABIRUČIAI;2446758975;Ne;5;1;4;10
2378;"Gervelė (Dzūkų g. 32)";PABIRUČIAI;2413995770;Ne;0;3;1;4
2379;"Gervelė (Dzūkų g. 32)";PABIRUČIAI;1353920541;Ne;3;8;4;15
2380;"Gervelė (Dzūkų g. 32)";PABIRUČIAI;6895415337;Ne;3;2;4;9
2381;"Gervelė (Dzūkų g. 32)";PABIRUČIAI;8533480337;Ne;8;2;2;12
2382;"Gervelė (Dzūkų g. 32)";PABIRUČIAI;8287867336;Ne;0;3;2;5
2383;"Gervelė (Dzūkų g. 32)";PABIRUČIAI;2186818108;Ne;0;0;3;3
2384;"Gervelė (Dzūkų g. 32)";PABIRUČIAI;9799715031;Ne;0;0;11;11
2385;"Gervelė (Dzūkų g. 32)";PABIRUČIAI;8439479958;Ne;3;2;3;8
2386;"Gervelė (Dzūkų g. 32)";BITUTĖS;5360362280;Ne;0;0;3;3
2387;"Gervelė (Dzūkų g. 32)";BITUTĖS;5360362280;Ne;0;0;3;3
2388;"Gervelė (Dzūkų g. 32)";BITUTĖS;7317091881;Ne;10;0;5;15
2389;"Gervelė (Dzūkų g. 32)";BITUTĖS;6228025635;Ne;5;0;3;8
2390;"Gervelė (Dzūkų g. 32)";BITUTĖS;6951455424;Ne;0;0;3;3
2391;"Gervelė (Dzūkų g. 32)";BITUTĖS;9977349707;Ne;5;2;4;11
2392;"Gervelė (Dzūkų g. 32)";BITUTĖS;3333885493;Ne;6;0;4;10
2393;"Gervelė (Dzūkų g. 32)";BITUTĖS;4295743997;Ne;0;3;1;4
2394;"Gervelė (Dzūkų g. 32)";BITUTĖS;1112844296;Ne;0;0;2;2
2395;"Gervelė (Dzūkų g. 32)";BITUTĖS;7935059565;Ne;6;0;2;8
2396;"Gervelė (Dzūkų g. 32)";BITUTĖS;5267617723;Ne;6;0;5;11
2397;"Gervelė (Dzūkų g. 32)";BITUTĖS;5953552777;Ne;0;6;2;8
2398;"Gervelė (Dzūkų g. 32)";BITUTĖS;4038179503;Ne;0;2;2;4
2399;"Gervelė (Dzūkų g. 32)";BITUTĖS;1160084928;Ne;7;0;6;13
2400;"Gervelė (Dzūkų g. 32)";BITUTĖS;6287806975;Taip;0;5;4;9
2401;"Gervelė (Dzūkų g. 32)";BITUTĖS;5685222621;Ne;5;2;3;10
2402;"Gervelė (Dzūkų g. 32)";BITUTĖS;5167248493;Ne;5;0;3;8
2403;"Gervelė (Dzūkų g. 32)";BITUTĖS;9291855374;Ne;10;0;4;14
2404;"Gervelė (Dzūkų g. 32)";BITUTĖS;6431701403;Ne;5;0;3;8
2405;"Gervelė (Dzūkų g. 32)";BURATINO;9239897472;Ne;5;2;2;9
2406;"Gervelė (Dzūkų g. 32)";BURATINO;9982951468;Ne;20;0;2;22
2407;"Gervelė (Dzūkų g. 32)";BURATINO;4775822341;Ne;0;9;0;9
2408;"Gervelė (Dzūkų g. 32)";BURATINO;2913622440;Ne;0;2;8;10
2409;"Gervelė (Dzūkų g. 32)";BURATINO;4434618210;Ne;0;2;0;2
2410;"Gervelė (Dzūkų g. 32)";BURATINO;6166476760;Ne;0;0;3;3
2411;"Gervelė (Dzūkų g. 32)";BURATINO;4516538272;Ne;2;2;4;8
2412;"Gervelė (Dzūkų g. 32)";BURATINO;3723783633;Ne;0;2;3;5
2413;"Gervelė (Dzūkų g. 32)";BURATINO;8472436632;Taip;0;2;0;2
2414;"Gervelė (Dzūkų g. 32)";BURATINO;1655678792;Ne;0;6;1;7
2415;"Gervelė (Dzūkų g. 32)";BURATINO;9697299387;Ne;0;2;5;7
2416;"Gervelė (Dzūkų g. 32)";BURATINO;7300458249;Ne;5;2;2;9
2417;"Gervelė (Dzūkų g. 32)";BURATINO;7998812497;Ne;5;2;4;11
2418;"Gervelė (Dzūkų g. 32)";BURATINO;5737517940;Ne;1;2;4;7
2419;"Gervelė (Dzūkų g. 32)";BURATINO;6595410865;Ne;0;2;3;5
2420;"Gervelė (Dzūkų g. 32)";BURATINO;1328359434;Ne;6;0;4;10
2421;"Gervelė (Dzūkų g. 32)";BURATINO;1932916710;Ne;8;3;6;17
2422;"Gervelė (Dzūkų g. 32)";BURATINO;2080374597;Ne;1;2;3;6
2423;"Gervelė (Dzūkų g. 32)";BURATINO;9768014964;Ne;0;1;2;3
2424;"Gervelė (Dzūkų g. 32)";BURATINO;2359854614;Ne;13;0;5;18
2425;"Gervelė (Dzūkų g. 32)";VIŠČIUKŲ;5375779904;Ne;0;0;6;6
2426;"Gervelė (Dzūkų g. 32)";VIŠČIUKŲ;3928187363;Ne;5;0;3;8
2427;"Gervelė (Dzūkų g. 32)";VIŠČIUKŲ;4112178405;Ne;0;2;0;2
2428;"Gervelė (Dzūkų g. 32)";VIŠČIUKŲ;8193126684;Ne;6;0;2;8
2429;"Gervelė (Dzūkų g. 32)";VIŠČIUKŲ;7152159380;Ne;3;0;4;7
2430;"Gervelė (Dzūkų g. 32)";VIŠČIUKŲ;6503715631;Taip;5;0;2;7
2431;"Gervelė (Dzūkų g. 32)";VIŠČIUKŲ;6224319208;Ne;0;0;2;2
2432;"Gervelė (Dzūkų g. 32)";VIŠČIUKŲ;6071962550;Ne;17;0;2;19
2433;"Gervelė (Dzūkų g. 32)";VIŠČIUKŲ;8456221074;Ne;7;0;2;9
2434;"Gervelė (Dzūkų g. 32)";VIŠČIUKŲ;9738262953;Ne;18;2;2;22
2435;"Gervelė (Dzūkų g. 32)";VIŠČIUKŲ;9685104548;Ne;0;0;1;1
2436;"Gervelė (Dzūkų g. 32)";VIŠČIUKŲ;8792240321;Ne;0;0;2;2
2437;"Gervelė (Dzūkų g. 32)";VIŠČIUKŲ;8392147716;Ne;0;2;2;4
2438;"Gilužis (Vydūno g. 11A)";Skruzdėliukų;8628253655;Ne;0;12;0;12
2439;"Gilužis (Vydūno g. 11A)";Skruzdėliukų;9783700319;Ne;13;0;4;17
2440;"Gilužis (Vydūno g. 11A)";Skruzdėliukų;4509741536;Ne;6;3;2;11
2441;"Gilužis (Vydūno g. 11A)";Skruzdėliukų;2221786284;Ne;4;2;2;8
2442;"Gilužis (Vydūno g. 11A)";Skruzdėliukų;3002266577;Ne;0;4;2;6
2443;"Gilužis (Vydūno g. 11A)";Skruzdėliukų;5497242500;Ne;0;7;0;7
2444;"Gilužis (Vydūno g. 11A)";Skruzdėliukų;5190752112;Ne;3;2;2;7
2445;"Gilužis (Vydūno g. 11A)";Skruzdėliukų;2440762487;Ne;3;2;2;7
2446;"Gilužis (Vydūno g. 11A)";Skruzdėliukų;9104005195;Ne;0;2;0;2
2447;"Gilužis (Vydūno g. 11A)";Skruzdėliukų;5394693502;Ne;0;2;2;4
2448;"Gilužis (Vydūno g. 11A)";Skruzdėliukų;4106792355;Ne;0;1;0;1
2449;"Gilužis (Vydūno g. 11A)";Skruzdėliukų;4876074981;Ne;2;2;2;6
2450;"Gilužis (Vydūno g. 11A)";Skruzdėliukų;2633680406;Ne;0;12;0;12
2451;"Gilužis (Vydūno g. 11A)";Skruzdėliukų;4455977087;Ne;10;2;2;14
2452;"Gilužis (Vydūno g. 11A)";Skruzdėliukų;4475698906;Ne;8;2;2;12
2453;"Gilužis (Vydūno g. 11A)";Skruzdėliukų;1085130813;Ne;5;2;2;9
2454;"Gilužis (Vydūno g. 11A)";Skruzdėliukų;2615087717;Ne;4;0;2;6
2455;"Gilužis (Vydūno g. 11A)";Skruzdėliukų;2516315604;Ne;6;1;2;9
2456;"Gilužis (Vydūno g. 11A)";Skruzdėliukų;2706629834;Ne;9;0;2;11
2457;"Gilužis (Vydūno g. 11A)";Skruzdėliukų;5556674867;Ne;7;0;4;11
2458;"Gilužis (Vydūno g. 11A)";Skruzdėliukų;6831107153;Taip;13;0;2;15
2459;"Gilužis (Vydūno g. 11A)";Skruzdėliukų;8852862161;Taip;13;0;2;15
2460;"Gilužis (Vydūno g. 11A)";Skruzdėliukų;2955779117;Taip;17;0;2;19
2461;"Gilužis (Vydūno g. 11A)";Nykštukų;3132445117;Ne;0;5;0;5
2462;"Gilužis (Vydūno g. 11A)";Nykštukų;4147821853;Ne;0;2;0;2
2463;"Gilužis (Vydūno g. 11A)";Nykštukų;7937643339;Ne;0;3;0;3
2464;"Gilužis (Vydūno g. 11A)";Nykštukų;3473889426;Ne;0;2;0;2
2465;"Gilužis (Vydūno g. 11A)";Nykštukų;9362581908;Ne;0;2;0;2
2466;"Gilužis (Vydūno g. 11A)";Nykštukų;8899557365;Ne;0;2;2;4
2467;"Gilužis (Vydūno g. 11A)";Nykštukų;2661894041;Ne;3;1;2;6
2468;"Gilužis (Vydūno g. 11A)";Nykštukų;7228498662;Ne;0;1;0;1
2469;"Gilužis (Vydūno g. 11A)";Nykštukų;3335512812;Ne;0;3;0;3
2470;"Gilužis (Vydūno g. 11A)";Nykštukų;1459273692;Ne;3;2;2;7
2471;"Gilužis (Vydūno g. 11A)";Nykštukų;4156613717;Ne;0;4;0;4
2472;"Gilužis (Vydūno g. 11A)";Nykštukų;5713786735;Ne;0;2;0;2
2473;"Gilužis (Vydūno g. 11A)";Nykštukų;4956685016;Ne;2;0;2;4
2474;"Gilužis (Vydūno g. 11A)";Nykštukų;6315155554;Ne;0;1;0;1
2475;"Gilužis (Vydūno g. 11A)";Nykštukų;4541291716;Ne;0;8;0;8
2476;"Gilužis (Vydūno g. 11A)";Nykštukų;8522552650;Ne;8;4;4;16
2477;"Gilužis (Vydūno g. 11A)";Nykštukų;3176305306;Ne;0;2;0;2
2478;"Gilužis (Vydūno g. 11A)";Nykštukų;4094486541;Ne;3;2;2;7
2479;"Gilužis (Vydūno g. 11A)";Nykštukų;6493142538;Ne;0;4;1;5
2480;"Gilužis (Vydūno g. 11A)";Nykštukų;5088561405;Ne;0;4;0;4
2481;"Gilužis (Vydūno g. 11A)";Bitučių;4841014668;Ne;2;2;0;4
2482;"Gilužis (Vydūno g. 11A)";Bitučių;3399162399;Ne;0;12;0;12
2483;"Gilužis (Vydūno g. 11A)";Bitučių;5973671038;Ne;0;13;0;13
2484;"Gilužis (Vydūno g. 11A)";Bitučių;1634295583;Ne;0;4;2;6
2485;"Gilužis (Vydūno g. 11A)";Bitučių;4360261750;Ne;0;4;2;6
2486;"Gilužis (Vydūno g. 11A)";Bitučių;5728341732;Ne;0;2;2;4
2487;"Gilužis (Vydūno g. 11A)";Bitučių;6931726275;Ne;0;2;0;2
2488;"Gilužis (Vydūno g. 11A)";Bitučių;1867185320;Ne;0;4;0;4
2489;"Gilužis (Vydūno g. 11A)";Bitučių;3429435736;Ne;8;1;1;10
2490;"Gilužis (Vydūno g. 11A)";Bitučių;8539946703;Taip;0;22;0;22
2491;"Gilužis (Vydūno g. 11A)";Bitučių;9000351000;Ne;7;3;0;10
2492;"Gilužis (Vydūno g. 11A)";Bitučių;5366174839;Ne;5;2;0;7
2493;"Gilužis (Vydūno g. 11A)";Bitučių;5162397237;Ne;0;4;0;4
2494;"Gilužis (Vydūno g. 11A)";Bitučių;7250617867;Ne;10;0;2;12
2495;"Gilužis (Vydūno g. 11A)";Bitučių;9053608903;Ne;8;10;1;19
2496;"Gilužis (Vydūno g. 11A)";Bitučių;6115776872;Ne;6;0;3;9
2497;"Gilužis (Vydūno g. 11A)";Bitučių;5651799121;Ne;4;0;4;8
2498;"Gilužis (Vydūno g. 11A)";Bitučių;1334619137;Ne;0;1;0;1
2499;"Gilužis (Vydūno g. 11A)";Bitučių;2950813185;Ne;0;3;0;3
2500;"Gilužis (Vydūno g. 11A)";Bitučių;6515525848;Ne;0;5;0;5
2501;"Gilužis (Vydūno g. 11A)";Bitučių;2345403784;Ne;9;2;2;13
2502;"Gilužis (Vydūno g. 11A)";Kačiukų;1273655212;Ne;0;5;0;5
2503;"Gilužis (Vydūno g. 11A)";Kačiukų;4978922821;Ne;0;4;0;4
2504;"Gilužis (Vydūno g. 11A)";Kačiukų;2945406185;Ne;0;4;0;4
2505;"Gilužis (Vydūno g. 11A)";Kačiukų;1582241363;Ne;0;2;3;5
2506;"Gilužis (Vydūno g. 11A)";Kačiukų;7330938312;Ne;4;0;6;10
2507;"Gilužis (Vydūno g. 11A)";Kačiukų;6571132974;Ne;0;8;9;17
2508;"Gilužis (Vydūno g. 11A)";Kačiukų;7001112696;Ne;1;0;5;6
2509;"Gilužis (Vydūno g. 11A)";Kačiukų;9034842169;Ne;0;0;4;4
2510;"Gilužis (Vydūno g. 11A)";Kačiukų;6966795180;Ne;0;12;0;12
2511;"Gilužis (Vydūno g. 11A)";Kačiukų;5128383851;Ne;0;10;7;17
2512;"Gilužis (Vydūno g. 11A)";Kačiukų;8318405114;Ne;2;2;2;6
2513;"Gilužis (Vydūno g. 11A)";Kačiukų;7826015897;Ne;0;6;0;6
2514;"Gilužis (Vydūno g. 11A)";Kačiukų;4403218878;Ne;2;3;2;7
2515;"Gilužis (Vydūno g. 11A)";Kačiukų;3419281756;Ne;0;1;0;1
2516;"Gilužis (Vydūno g. 11A)";Kačiukų;1862524255;Ne;0;2;0;2
2517;"Gilužis (Vydūno g. 11A)";Kačiukų;9421351780;Ne;0;0;3;3
2518;"Gilužis (Vydūno g. 11A)";Kačiukų;4128387076;Ne;3;2;3;8
2519;"Gilužis (Vydūno g. 11A)";Kačiukų;7042664923;Ne;0;2;1;3
2520;"Gilužis (Vydūno g. 11A)";Kačiukų;9097165155;Ne;2;0;0;2
2521;"Gilužis (Vydūno g. 11A)";Kačiukų;8762534617;Ne;0;14;0;14
2522;"Gilužis (Vydūno g. 11A)";Kačiukų;5641406427;Ne;10;0;3;13
2523;"Gilužis (Vydūno g. 11A)";Pelėdžiukų;5217748032;Ne;0;6;0;6
2524;"Gilužis (Vydūno g. 11A)";Pelėdžiukų;7998695149;Ne;0;1;0;1
2525;"Gilužis (Vydūno g. 11A)";Pelėdžiukų;7742783427;Ne;0;1;0;1
2526;"Gilužis (Vydūno g. 11A)";Pelėdžiukų;7358572344;Ne;0;5;0;5
2527;"Gilužis (Vydūno g. 11A)";Pelėdžiukų;4617259961;Ne;0;1;1;2
2528;"Gilužis (Vydūno g. 11A)";Pelėdžiukų;1222370750;Ne;6;4;2;12
2529;"Gilužis (Vydūno g. 11A)";Pelėdžiukų;9503516686;Ne;0;2;0;2
2530;"Gilužis (Vydūno g. 11A)";Pelėdžiukų;9833451628;Ne;0;4;0;4
2531;"Gilužis (Vydūno g. 11A)";Pelėdžiukų;6270071724;Ne;0;2;0;2
2532;"Gilužis (Vydūno g. 11A)";Pelėdžiukų;4051726208;Ne;5;2;2;9
2533;"Gilužis (Vydūno g. 11A)";Pelėdžiukų;7092060789;Ne;8;3;2;13
2534;"Gilužis (Vydūno g. 11A)";Pelėdžiukų;4435227217;Ne;0;1;0;1
2535;"Gilužis (Vydūno g. 11A)";Pelėdžiukų;1804218972;Ne;4;3;2;9
2536;"Gilužis (Vydūno g. 11A)";Pelėdžiukų;2434419240;Ne;0;2;0;2
2537;"Gilužis (Vydūno g. 11A)";Pelėdžiukų;3166161973;Ne;0;4;0;4
2538;"Gilužis (Vydūno g. 11A)";Pelėdžiukų;5070988982;Ne;4;3;2;9
2539;"Gilužis (Vydūno g. 11A)";Pelėdžiukų;6093514885;Ne;0;2;0;2
2540;"Gilužis (Vydūno g. 11A)";Pelėdžiukų;2869506388;Ne;2;1;2;5
2541;"Gilužis (Vydūno g. 11A)";Pelėdžiukų;9520409342;Ne;0;2;0;2
2542;"Gilužis (Vydūno g. 11A)";Pelėdžiukų;9186274541;Ne;2;1;2;5
2543;"Gilužis (Vydūno g. 11A)";Drugelių;6121625070;Ne;0;22;0;22
2544;"Gilužis (Vydūno g. 11A)";Drugelių;1770064694;Ne;0;1;0;1
2545;"Gilužis (Vydūno g. 11A)";Drugelių;9092013248;Ne;0;12;0;12
2546;"Gilužis (Vydūno g. 11A)";Drugelių;9109883577;Ne;2;1;4;7
2547;"Gilužis (Vydūno g. 11A)";Drugelių;8006465211;Ne;0;1;0;1
2548;"Gilužis (Vydūno g. 11A)";Drugelių;5118401707;Ne;1;0;2;3
2549;"Gilužis (Vydūno g. 11A)";Drugelių;3190597262;Ne;7;1;4;12
2550;"Gilužis (Vydūno g. 11A)";Drugelių;2988856911;Ne;3;2;2;7
2551;"Gilužis (Vydūno g. 11A)";Drugelių;3532863024;Ne;0;22;0;22
2552;"Gilužis (Vydūno g. 11A)";Drugelių;1376645277;Ne;3;3;2;8
2553;"Gilužis (Vydūno g. 11A)";Drugelių;1410870589;Ne;10;3;2;15
2554;"Gilužis (Vydūno g. 11A)";Drugelių;6786334223;Ne;0;0;1;1
2555;"Gilužis (Vydūno g. 11A)";Drugelių;9112993465;Ne;3;0;4;7
2556;"Gilužis (Vydūno g. 11A)";Drugelių;6429142049;Ne;8;1;2;11
2557;"Gilužis (Vydūno g. 11A)";Drugelių;7731169885;Ne;1;1;2;4
2558;"Gilužis (Vydūno g. 11A)";Drugelių;1093643746;Ne;0;9;0;9
2559;"Gilužis (Vydūno g. 11A)";Drugelių;3902713866;Ne;0;2;1;3
2560;"Gilužis (Vydūno g. 11A)";Drugelių;6950139609;Ne;0;0;5;5
2561;"Gilužis (Vydūno g. 11A)";Drugelių;2397231165;Ne;4;1;3;8
2562;"Gilužis (Vydūno g. 11A)";Saulučių;5705945483;Ne;0;10;1;11
2563;"Gilužis (Vydūno g. 11A)";Saulučių;8237963602;Ne;7;0;3;10
2564;"Gilužis (Vydūno g. 11A)";Saulučių;6914566889;Ne;3;2;2;7
2565;"Gilužis (Vydūno g. 11A)";Saulučių;5306278297;Ne;14;0;4;18
2566;"Gilužis (Vydūno g. 11A)";Saulučių;1054809163;Ne;16;0;2;18
2567;"Gilužis (Vydūno g. 11A)";Saulučių;7887970476;Ne;0;2;0;2
2568;"Gilužis (Vydūno g. 11A)";Saulučių;6507021182;Ne;3;2;0;5
2569;"Gilužis (Vydūno g. 11A)";Saulučių;4652281185;Ne;3;0;4;7
2570;"Gilužis (Vydūno g. 11A)";Saulučių;2364391112;Ne;2;0;2;4
2571;"Gilužis (Vydūno g. 11A)";Saulučių;7068801003;Ne;2;0;0;2
2572;"Gilužis (Vydūno g. 11A)";Saulučių;3081351563;Ne;4;0;5;9
2573;"Gilužis (Vydūno g. 11A)";Saulučių;1015379578;Ne;0;1;0;1
2574;"Gilužis (Vydūno g. 11A)";Saulučių;7247606321;Ne;7;2;2;11
2575;"Gilužis (Vydūno g. 11A)";Saulučių;2915024298;Ne;5;0;2;7
2576;"Gilužis (Vydūno g. 11A)";Saulučių;2567788346;Ne;0;0;6;6
2577;"Gilužis (Vydūno g. 11A)";Saulučių;8717811266;Ne;3;0;3;6
2578;"Gilužis (Vydūno g. 11A)";Saulučių;7487731015;Ne;0;0;3;3
2579;"Gilužis (Vydūno g. 11A)";Saulučių;5079154238;Ne;6;0;3;9
2580;"Gilužis (Vydūno g. 11A)";Saulučių;5490128851;Ne;2;0;3;5
2581;"Gilužis (Vydūno g. 11A)";Saulučių;5784201106;Ne;5;0;2;7
2582;"Gilužis (Vydūno g. 11A)";Saulučių;8904873416;Ne;2;0;3;5
2583;"Gilužis (Vydūno g. 11A)";Obuoliukų;8201769917;Ne;0;7;0;7
2584;"Gilužis (Vydūno g. 11A)";Obuoliukų;9892608223;Ne;0;6;1;7
2585;"Gilužis (Vydūno g. 11A)";Obuoliukų;4058698645;Ne;3;1;2;6
2586;"Gilužis (Vydūno g. 11A)";Obuoliukų;1540018160;Ne;8;3;2;13
2587;"Gilužis (Vydūno g. 11A)";Obuoliukų;7716908903;Ne;3;0;2;5
2588;"Gilužis (Vydūno g. 11A)";Obuoliukų;3131597174;Ne;3;3;2;8
2589;"Gilužis (Vydūno g. 11A)";Obuoliukų;6239369861;Ne;5;0;2;7
2590;"Gilužis (Vydūno g. 11A)";Obuoliukų;6172360933;Ne;0;2;0;2
2591;"Gilužis (Vydūno g. 11A)";Obuoliukų;7398446674;Ne;5;2;2;9
2592;"Gilužis (Vydūno g. 11A)";Obuoliukų;4592380105;Ne;10;3;4;17
2593;"Gilužis (Vydūno g. 11A)";Obuoliukų;4242362889;Ne;0;5;1;6
2594;"Gilužis (Vydūno g. 11A)";Obuoliukų;7560732216;Ne;0;5;1;6
2595;"Gilužis (Vydūno g. 11A)";Obuoliukų;5476140202;Ne;0;3;0;3
2596;"Gilužis (Vydūno g. 11A)";Obuoliukų;8194444043;Ne;8;0;2;10
2597;"Gilužis (Vydūno g. 11A)";Obuoliukų;7606394325;Ne;6;2;2;10
2598;"Gilužis (Vydūno g. 11A)";Obuoliukų;6737884137;Ne;5;8;2;15
2599;"Gilužis (Vydūno g. 11A)";Obuoliukų;6825745985;Ne;0;3;0;3
2600;"Gilužis (Vydūno g. 11A)";Obuoliukų;3458957423;Ne;5;2;2;9
2601;"Gilužis (Vydūno g. 11A)";Obuoliukų;8900414658;Ne;0;2;0;2
2602;"Gilužis (Vydūno g. 11A)";Obuoliukų;3219101391;Ne;6;2;2;10
2603;"Gilužis (Vydūno g. 11A)";Obuoliukų;4528131001;Ne;3;2;2;7
2604;"Gilužis (Vydūno g. 11A)";Obuoliukų;5895659747;Ne;5;8;2;15
2605;"Gilužis (Vydūno g. 11A)";Obuoliukų;3331616067;Ne;8;2;2;12
2606;"Gilužis (Vydūno g. 11A)";KIŠKUČIŲ;5744027226;Ne;0;2;0;2
2607;"Gilužis (Vydūno g. 11A)";KIŠKUČIŲ;8639633038;Ne;0;3;0;3
2608;"Gilužis (Vydūno g. 11A)";KIŠKUČIŲ;5721924532;Ne;3;4;2;9
2609;"Gilužis (Vydūno g. 11A)";KIŠKUČIŲ;9484221435;Ne;0;1;0;1
2610;"Gilužis (Vydūno g. 11A)";KIŠKUČIŲ;2680643896;Ne;8;2;2;12
2611;"Gilužis (Vydūno g. 11A)";KIŠKUČIŲ;5685074731;Ne;5;0;2;7
2612;"Gilužis (Vydūno g. 11A)";KIŠKUČIŲ;7632771776;Ne;2;1;6;9
2613;"Gilužis (Vydūno g. 11A)";KIŠKUČIŲ;7477282548;Ne;2;0;0;2
2614;"Gilužis (Vydūno g. 11A)";KIŠKUČIŲ;9061835019;Ne;0;4;1;5
2615;"Gilužis (Vydūno g. 11A)";KIŠKUČIŲ;7560574633;Ne;0;0;2;2
2616;"Gilužis (Vydūno g. 11A)";KIŠKUČIŲ;4199633620;Ne;6;3;4;13
2617;"Gilužis (Vydūno g. 11A)";KIŠKUČIŲ;9851612698;Ne;9;0;2;11
2618;"Gilužis (Vydūno g. 11A)";KIŠKUČIŲ;1391410955;Ne;10;0;2;12
2619;"Gilužis (Vydūno g. 11A)";KIŠKUČIŲ;6383469680;Ne;0;11;0;11
2620;"Gilužis (Vydūno g. 11A)";KIŠKUČIŲ;3171560628;Ne;0;1;1;2
2621;"Gilužis (Vydūno g. 11A)";KIŠKUČIŲ;4347319425;Ne;1;2;2;5
2622;"Gilužis (Vydūno g. 11A)";KIŠKUČIŲ;8591741716;Ne;5;0;2;7
2623;"Gilužis (Vydūno g. 11A)";KIŠKUČIŲ;8877445672;Ne;5;0;2;7
2624;"Gilužis (Vydūno g. 11A)";KIŠKUČIŲ;9489594782;Ne;0;4;0;4
2625;"Gilužis (Vydūno g. 11A)";KIŠKUČIŲ;7696478568;Taip;2;0;0;2
2626;"Gilužis (Vydūno g. 11A)";Meškučių;7263432152;Ne;5;0;2;7
2627;"Gilužis (Vydūno g. 11A)";Meškučių;4655266106;Ne;10;0;0;10
2628;"Gilužis (Vydūno g. 11A)";Meškučių;3800593189;Ne;0;11;4;15
2629;"Gilužis (Vydūno g. 11A)";Meškučių;4174307847;Ne;0;1;0;1
2630;"Gilužis (Vydūno g. 11A)";Meškučių;8393554697;Ne;3;9;2;14
2631;"Gilužis (Vydūno g. 11A)";Meškučių;8301535013;Ne;8;1;2;11
2632;"Gilužis (Vydūno g. 11A)";Meškučių;2939982311;Ne;0;10;0;10
2633;"Gilužis (Vydūno g. 11A)";Meškučių;3365778697;Ne;11;2;4;17
2634;"Gilužis (Vydūno g. 11A)";Meškučių;7912093880;Taip;9;2;2;13
2635;"Gilužis (Vydūno g. 11A)";Meškučių;2389277783;Ne;0;3;0;3
2636;"Gilužis (Vydūno g. 11A)";Meškučių;2500949029;Ne;5;3;2;10
2637;"Gilužis (Vydūno g. 11A)";Meškučių;4741129495;Ne;11;2;4;17
2638;"Gilužis (Vydūno g. 11A)";Meškučių;7992750316;Ne;0;22;0;22
2639;"Gilužis (Vydūno g. 11A)";Meškučių;5505153657;Ne;0;2;0;2
2640;"Gilužis (Vydūno g. 11A)";Meškučių;2577554894;Ne;6;2;2;10
2641;"Gilužis (Vydūno g. 11A)";Meškučių;3148477315;Ne;10;0;2;12
2642;"Gilužis (Vydūno g. 11A)";Meškučių;1068375927;Ne;5;0;4;9
2643;"Gilužis (Vydūno g. 11A)";Meškučių;8476240141;Ne;0;0;1;1
2644;"Gilužis (Vydūno g. 11A)";Meškučių;6185280967;Ne;6;3;2;11
2645;"Gilužis (Vydūno g. 11A)";Meškučių;5177805719;Ne;0;9;0;9
2646;"Gilužis (Vydūno g. 11A)";Meškučių;7045940267;Ne;5;0;2;7
2647;"Gilužis (Vydūno g. 11A)";Meškučių;5654754316;Ne;9;3;2;14
2648;"Gilužis (Vydūno g. 11A)";Pagrandukai;6884146146;Ne;0;3;2;5
2649;"Gilužis (Vydūno g. 11A)";Pagrandukai;6920910054;Ne;8;9;2;19
2650;"Gilužis (Vydūno g. 11A)";Pagrandukai;6501973647;Ne;0;3;0;3
2651;"Gilužis (Vydūno g. 11A)";Pagrandukai;5397975739;Ne;0;3;0;3
2652;"Gilužis (Vydūno g. 11A)";Pagrandukai;2328338059;Ne;0;2;0;2
2653;"Gilužis (Vydūno g. 11A)";Pagrandukai;5376639182;Ne;0;4;0;4
2654;"Gilužis (Vydūno g. 11A)";Pagrandukai;5378701300;Ne;5;2;2;9
2655;"Gilužis (Vydūno g. 11A)";Pagrandukai;3366788027;Ne;5;2;2;9
2656;"Gilužis (Vydūno g. 11A)";Pagrandukai;5184511012;Ne;11;1;4;16
2657;"Gilužis (Vydūno g. 11A)";Pagrandukai;9587502317;Ne;11;1;4;16
2658;"Gilužis (Vydūno g. 11A)";Pagrandukai;5334441484;Ne;3;2;2;7
2659;"Gilužis (Vydūno g. 11A)";Pagrandukai;6485579727;Ne;0;0;2;2
2660;"Gilužis (Vydūno g. 11A)";Pagrandukai;8477445384;Ne;11;0;2;13
2661;"Gilužis (Vydūno g. 11A)";Pagrandukai;1758670627;Ne;2;0;2;4
2662;"Gilužis (Vydūno g. 11A)";Pagrandukai;6766559505;Taip;4;1;2;7
2663;"Gilužis (Vydūno g. 11A)";Pagrandukai;5737505086;Ne;8;2;2;12
2664;"Gilužis (Vydūno g. 11A)";Pagrandukai;3729538163;Ne;0;2;1;3
2665;"Gilužis (Vydūno g. 11A)";Pagrandukai;6207304860;Ne;6;1;2;9
2666;"Gilužis (Vydūno g. 11A)";Pagrandukai;5921538837;Ne;9;3;2;14
2667;"Gilužis (Vydūno g. 11A)";Pagrandukai;9846916206;Taip;2;4;2;8
2668;"Gilužis (Vydūno g. 11A)";Pagrandukai;9325927745;Ne;11;6;2;19
2669;"Gilužis (Vydūno g. 11A)";Pagrandukai;4927117901;Ne;3;2;2;7
2670;"Gilužis (Vydūno g. 11A)";Boružėlių;5581417252;Ne;2;6;2;10
2671;"Gilužis (Vydūno g. 11A)";Boružėlių;2819680099;Ne;0;3;0;3
2672;"Gilužis (Vydūno g. 11A)";Boružėlių;1209632075;Ne;8;2;2;12
2673;"Gilužis (Vydūno g. 11A)";Boružėlių;9753512366;Ne;3;2;2;7
2674;"Gilužis (Vydūno g. 11A)";Boružėlių;1541283216;Ne;0;0;2;2
2675;"Gilužis (Vydūno g. 11A)";Boružėlių;6514483362;Ne;0;0;4;4
2676;"Gilužis (Vydūno g. 11A)";Boružėlių;5664892047;Ne;0;2;0;2
2677;"Gilužis (Vydūno g. 11A)";Boružėlių;3379889899;Ne;12;0;2;14
2678;"Gilužis (Vydūno g. 11A)";Boružėlių;3917385813;Ne;0;2;1;3
2679;"Gilužis (Vydūno g. 11A)";Boružėlių;3194397689;Ne;3;0;2;5
2680;"Gilužis (Vydūno g. 11A)";Boružėlių;6586605929;Ne;6;3;4;13
2681;"Gilužis (Vydūno g. 11A)";Boružėlių;3279830266;Ne;3;2;2;7
2682;"Gilužis (Vydūno g. 11A)";Boružėlių;9676661005;Ne;3;0;2;5
2683;"Gilužis (Vydūno g. 11A)";Boružėlių;1306757860;Ne;3;0;2;5
2684;"Gilužis (Vydūno g. 11A)";Boružėlių;1604096952;Ne;4;0;2;6
2685;"Gilužis (Vydūno g. 11A)";Boružėlių;4266998302;Ne;2;0;0;2
2686;"Gintarėlis (Didlaukio g. 35)";PAPŪGĖLĖS;6402043654;Ne;5;0;2;7
2687;"Gintarėlis (Didlaukio g. 35)";PAPŪGĖLĖS;6558614008;Ne;7;2;4;13
2688;"Gintarėlis (Didlaukio g. 35)";PAPŪGĖLĖS;4348245746;Ne;3;0;2;5
2689;"Gintarėlis (Didlaukio g. 35)";PAPŪGĖLĖS;7372735642;Ne;6;0;2;8
2690;"Gintarėlis (Didlaukio g. 35)";PAPŪGĖLĖS;3091731769;Ne;6;2;2;10
2691;"Gintarėlis (Didlaukio g. 35)";PAPŪGĖLĖS;6484966941;Ne;0;5;2;7
2692;"Gintarėlis (Didlaukio g. 35)";PAPŪGĖLĖS;9476258741;Ne;0;2;2;4
2693;"Gintarėlis (Didlaukio g. 35)";PAPŪGĖLĖS;9004590065;Ne;9;2;2;13
2694;"Gintarėlis (Didlaukio g. 35)";PAPŪGĖLĖS;2624469768;Ne;0;2;0;2
2695;"Gintarėlis (Didlaukio g. 35)";PAPŪGĖLĖS;8784796186;Ne;0;2;0;2
2696;"Gintarėlis (Didlaukio g. 35)";PAPŪGĖLĖS;9622824643;Ne;11;1;4;16
2697;"Gintarėlis (Didlaukio g. 35)";PAPŪGĖLĖS;8516817506;Ne;3;1;2;6
2698;"Gintarėlis (Didlaukio g. 35)";PAPŪGĖLĖS;4809352525;Ne;0;2;0;2
2699;"Gintarėlis (Didlaukio g. 35)";PAPŪGĖLĖS;1371258551;Ne;8;1;2;11
2700;"Gintarėlis (Didlaukio g. 35)";PAPŪGĖLĖS;9970786396;Ne;0;4;4;8
2701;"Gintarėlis (Didlaukio g. 35)";PAPŪGĖLĖS;7118758040;Ne;3;6;2;11
2702;"Gintarėlis (Didlaukio g. 35)";PAPŪGĖLĖS;8213388778;Ne;3;0;3;6
2703;"Gintarėlis (Didlaukio g. 35)";PAPŪGĖLĖS;8355089218;Ne;1;0;2;3
2704;"Gintarėlis (Didlaukio g. 35)";PAPŪGĖLĖS;8471302686;Ne;8;0;2;10
2705;"Gintarėlis (Didlaukio g. 35)";PAPŪGĖLĖS;1909958944;Ne;3;4;2;9
2706;"Gintarėlis (Didlaukio g. 35)";PAPŪGĖLĖS;7980775632;Ne;0;15;0;15
2707;"Gintarėlis (Didlaukio g. 35)";SPINDULIUKAI;8498936096;Ne;0;13;0;13
2708;"Gintarėlis (Didlaukio g. 35)";SPINDULIUKAI;8913652291;Ne;4;2;2;8
2709;"Gintarėlis (Didlaukio g. 35)";SPINDULIUKAI;2485750596;Ne;2;2;5;9
2710;"Gintarėlis (Didlaukio g. 35)";SPINDULIUKAI;8610886062;Ne;1;4;3;8
2711;"Gintarėlis (Didlaukio g. 35)";SPINDULIUKAI;1033624080;Ne;0;1;0;1
2712;"Gintarėlis (Didlaukio g. 35)";SPINDULIUKAI;5811396263;Ne;0;5;1;6
2713;"Gintarėlis (Didlaukio g. 35)";SPINDULIUKAI;2919700367;Ne;8;3;2;13
2714;"Gintarėlis (Didlaukio g. 35)";SPINDULIUKAI;1511718436;Ne;0;9;0;9
2715;"Gintarėlis (Didlaukio g. 35)";SPINDULIUKAI;2595566032;Ne;0;4;1;5
2716;"Gintarėlis (Didlaukio g. 35)";SPINDULIUKAI;9141438560;Ne;0;4;0;4
2717;"Gintarėlis (Didlaukio g. 35)";SPINDULIUKAI;2235045173;Ne;0;2;0;2
2718;"Gintarėlis (Didlaukio g. 35)";SPINDULIUKAI;9494521554;Ne;6;2;2;10
2719;"Gintarėlis (Didlaukio g. 35)";SPINDULIUKAI;7494884360;Ne;0;3;0;3
2720;"Gintarėlis (Didlaukio g. 35)";SPINDULIUKAI;1648843117;Ne;0;4;1;5
2721;"Gintarėlis (Didlaukio g. 35)";SPINDULIUKAI;7147842224;Ne;0;2;0;2
2722;"Gintarėlis (Didlaukio g. 35)";SPINDULIUKAI;5783939567;Ne;0;1;1;2
2723;"Gintarėlis (Didlaukio g. 35)";SPINDULIUKAI;7674351459;Ne;1;3;2;6
2724;"Gintarėlis (Didlaukio g. 35)";SPINDULIUKAI;1861324153;Ne;0;8;0;8
2725;"Gintarėlis (Didlaukio g. 35)";SPINDULIUKAI;3457974670;Ne;0;2;1;3
2726;"Gintarėlis (Didlaukio g. 35)";SPINDULIUKAI;6080108998;Ne;0;2;0;2
2727;"Gintarėlis (Didlaukio g. 35)";SPINDULIUKAI;6655645997;Ne;0;2;0;2
2728;"Gintarėlis (Didlaukio g. 35)";SPINDULIUKAI;4484711857;Ne;1;2;2;5
2729;"Gintarėlis (Didlaukio g. 35)";SPINDULIUKAI;6292664833;Ne;2;0;2;4
2730;"Gintarėlis (Didlaukio g. 35)";LAŠIUKAI;6377674849;Ne;0;2;0;2
2731;"Gintarėlis (Didlaukio g. 35)";LAŠIUKAI;3820683506;Ne;0;3;0;3
2732;"Gintarėlis (Didlaukio g. 35)";LAŠIUKAI;2904118045;Ne;1;0;2;3
2733;"Gintarėlis (Didlaukio g. 35)";LAŠIUKAI;5717123412;Ne;5;1;2;8
2734;"Gintarėlis (Didlaukio g. 35)";LAŠIUKAI;3794027499;Ne;3;2;2;7
2735;"Gintarėlis (Didlaukio g. 35)";LAŠIUKAI;7813187438;Ne;0;3;0;3
2736;"Gintarėlis (Didlaukio g. 35)";LAŠIUKAI;9234476307;Ne;1;2;2;5
2737;"Gintarėlis (Didlaukio g. 35)";LAŠIUKAI;6561070982;Ne;4;2;2;8
2738;"Gintarėlis (Didlaukio g. 35)";LAŠIUKAI;2203238888;Ne;0;2;0;2
2739;"Gintarėlis (Didlaukio g. 35)";LAŠIUKAI;3484172382;Ne;0;2;0;2
2740;"Gintarėlis (Didlaukio g. 35)";LAŠIUKAI;2256002308;Ne;3;2;3;8
2741;"Gintarėlis (Didlaukio g. 35)";LAŠIUKAI;1327681704;Ne;0;2;0;2
2742;"Gintarėlis (Didlaukio g. 35)";LAŠIUKAI;3987801707;Ne;8;1;2;11
2743;"Gintarėlis (Didlaukio g. 35)";LAŠIUKAI;7123016029;Ne;0;22;0;22
2744;"Gintarėlis (Didlaukio g. 35)";LAŠIUKAI;3000371147;Ne;0;5;0;5
2745;"Gintarėlis (Didlaukio g. 35)";LAŠIUKAI;7976989629;Ne;4;0;4;8
2746;"Gintarėlis (Didlaukio g. 35)";LAŠIUKAI;8982034601;Ne;0;2;2;4
2747;"Gintarėlis (Didlaukio g. 35)";LAŠIUKAI;6545866812;Ne;0;11;1;12
2748;"Gintarėlis (Didlaukio g. 35)";LAŠIUKAI;5467958458;Ne;0;3;0;3
2749;"Gintarėlis (Didlaukio g. 35)";MEŠKUČIAI;2926488239;Ne;0;2;0;2
2750;"Gintarėlis (Didlaukio g. 35)";MEŠKUČIAI;6618240550;Ne;0;4;0;4
2751;"Gintarėlis (Didlaukio g. 35)";MEŠKUČIAI;8790078624;Ne;0;2;0;2
2752;"Gintarėlis (Didlaukio g. 35)";MEŠKUČIAI;2518840573;Ne;0;2;0;2
2753;"Gintarėlis (Didlaukio g. 35)";MEŠKUČIAI;5187894822;Ne;7;2;2;11
2754;"Gintarėlis (Didlaukio g. 35)";MEŠKUČIAI;3630567294;Ne;8;4;2;14
2755;"Gintarėlis (Didlaukio g. 35)";MEŠKUČIAI;5181872438;Ne;0;5;0;5
2756;"Gintarėlis (Didlaukio g. 35)";MEŠKUČIAI;1565802953;Ne;0;22;0;22
2757;"Gintarėlis (Didlaukio g. 35)";MEŠKUČIAI;2072435242;Ne;0;2;0;2
2758;"Gintarėlis (Didlaukio g. 35)";MEŠKUČIAI;7989239799;Ne;0;2;0;2
2759;"Gintarėlis (Didlaukio g. 35)";MEŠKUČIAI;4356211536;Ne;9;1;2;12
2760;"Gintarėlis (Didlaukio g. 35)";MEŠKUČIAI;6636835034;Ne;0;4;0;4
2761;"Gintarėlis (Didlaukio g. 35)";MEŠKUČIAI;3830154353;Ne;0;2;0;2
2762;"Gintarėlis (Didlaukio g. 35)";MEŠKUČIAI;3947405446;Ne;8;1;2;11
2763;"Gintarėlis (Didlaukio g. 35)";MEŠKUČIAI;7948438165;Ne;0;2;0;2
2764;"Gintarėlis (Didlaukio g. 35)";MEŠKUČIAI;4642142931;Ne;0;3;0;3
2765;"Gintarėlis (Didlaukio g. 35)";MEŠKUČIAI;6711753930;Ne;0;2;0;2
2766;"Gintarėlis (Didlaukio g. 35)";MEŠKUČIAI;9017592249;Ne;0;3;2;5
2767;"Gintarėlis (Didlaukio g. 35)";MEŠKUČIAI;8375475174;Ne;8;4;2;14
2768;"Gintarėlis (Didlaukio g. 35)";MEŠKUČIAI;7029401386;Ne;0;1;2;3
2769;"Gintarėlis (Didlaukio g. 35)";MEŠKUČIAI;3271736540;Ne;0;4;1;5
2770;"Gintarėlis (Didlaukio g. 35)";KAČIUKAI;5569843168;Ne;0;5;0;5
2771;"Gintarėlis (Didlaukio g. 35)";KAČIUKAI;3665764153;Ne;3;3;2;8
2772;"Gintarėlis (Didlaukio g. 35)";KAČIUKAI;9774056578;Ne;3;3;2;8
2773;"Gintarėlis (Didlaukio g. 35)";KAČIUKAI;2212296954;Ne;0;1;1;2
2774;"Gintarėlis (Didlaukio g. 35)";KAČIUKAI;3825700024;Ne;0;1;0;1
2775;"Gintarėlis (Didlaukio g. 35)";KAČIUKAI;7057877483;Ne;0;1;0;1
2776;"Gintarėlis (Didlaukio g. 35)";KAČIUKAI;9825811100;Ne;1;0;2;3
2777;"Gintarėlis (Didlaukio g. 35)";KAČIUKAI;7875981690;Ne;0;2;1;3
2778;"Gintarėlis (Didlaukio g. 35)";KAČIUKAI;2544338275;Ne;0;2;1;3
2779;"Gintarėlis (Didlaukio g. 35)";KAČIUKAI;9963329170;Taip;0;2;0;2
2780;"Gintarėlis (Didlaukio g. 35)";KAČIUKAI;7182964126;Ne;0;1;1;2
2781;"Gintarėlis (Didlaukio g. 35)";KAČIUKAI;4754929282;Ne;0;1;1;2
2782;"Gintarėlis (Didlaukio g. 35)";KAČIUKAI;5214984111;Ne;0;7;0;7
2783;"Gintarėlis (Didlaukio g. 35)";KAČIUKAI;1011749698;Ne;7;4;6;17
2784;"Gintarėlis (Didlaukio g. 35)";KAČIUKAI;8261770154;Ne;0;15;0;15
2785;"Gintarėlis (Didlaukio g. 35)";KAČIUKAI;7061545258;Ne;3;1;2;6
2786;"Gintarėlis (Didlaukio g. 35)";KAČIUKAI;5436695400;Ne;0;2;1;3
2787;"Gintarėlis (Didlaukio g. 35)";KAČIUKAI;5921751507;Ne;0;4;1;5
2788;"Gintarėlis (Didlaukio g. 35)";KAČIUKAI;9450900915;Ne;0;0;3;3
2789;"Gintarėlis (Didlaukio g. 35)";KAČIUKAI;5153948767;Ne;0;2;0;2
2790;"Gintarėlis (Didlaukio g. 35)";KAČIUKAI;3814485627;Ne;0;4;1;5
2791;"Gintarėlis (Didlaukio g. 35)";KAČIUKAI;1571260478;Ne;5;4;4;13
2792;"Gintarėlis (Didlaukio g. 35)";KAČIUKAI;9244715396;Ne;0;4;0;4
2793;"Gintarėlis (Didlaukio g. 35)";KAČIUKAI;3015327416;Ne;0;0;2;2
2794;"Gintarėlis (Didlaukio g. 35)";KIŠKUČIAI;3921015919;Ne;3;1;2;6
2795;"Gintarėlis (Didlaukio g. 35)";KIŠKUČIAI;7143014339;Ne;0;1;2;3
2796;"Gintarėlis (Didlaukio g. 35)";KIŠKUČIAI;1918879534;Ne;3;0;2;5
2797;"Gintarėlis (Didlaukio g. 35)";KIŠKUČIAI;7509100750;Ne;5;2;3;10
2798;"Gintarėlis (Didlaukio g. 35)";KIŠKUČIAI;6239242631;Ne;3;0;2;5
2799;"Gintarėlis (Didlaukio g. 35)";KIŠKUČIAI;5965570522;Ne;0;2;0;2
2800;"Gintarėlis (Didlaukio g. 35)";KIŠKUČIAI;8286814809;Ne;0;1;0;1
2801;"Gintarėlis (Didlaukio g. 35)";KIŠKUČIAI;3839660368;Ne;0;4;0;4
2802;"Gintarėlis (Didlaukio g. 35)";KIŠKUČIAI;5509394003;Ne;5;0;3;8
2803;"Gintarėlis (Didlaukio g. 35)";KIŠKUČIAI;3538300416;Ne;0;3;0;3
2804;"Gintarėlis (Didlaukio g. 35)";KIŠKUČIAI;9501012756;Ne;6;0;4;10
2805;"Gintarėlis (Didlaukio g. 35)";KIŠKUČIAI;7059730814;Ne;0;2;0;2
2806;"Gintarėlis (Didlaukio g. 35)";KIŠKUČIAI;1326797813;Ne;0;4;0;4
2807;"Gintarėlis (Didlaukio g. 35)";KIŠKUČIAI;7629635034;Taip;3;2;2;7
2808;"Gintarėlis (Didlaukio g. 35)";KIŠKUČIAI;1918458858;Ne;12;0;2;14
2809;"Gintarėlis (Didlaukio g. 35)";KIŠKUČIAI;2234295991;Ne;0;2;0;2
2810;"Gintarėlis (Didlaukio g. 35)";KIŠKUČIAI;8410642485;Ne;3;0;4;7
2811;"Gintarėlis (Didlaukio g. 35)";KIŠKUČIAI;3235154374;Ne;0;2;4;6
2812;"Gintarėlis (Didlaukio g. 35)";KIŠKUČIAI;6047468576;Ne;3;2;4;9
2813;"Gintarėlis (Didlaukio g. 35)";KIŠKUČIAI;4266286613;Ne;0;1;2;3
2814;"Gintarėlis (Didlaukio g. 35)";BORUŽĖLĖS;9915228593;Ne;1;1;2;4
2815;"Gintarėlis (Didlaukio g. 35)";BORUŽĖLĖS;4278770021;Ne;0;3;0;3
2816;"Gintarėlis (Didlaukio g. 35)";BORUŽĖLĖS;2499727321;Ne;7;2;2;11
2817;"Gintarėlis (Didlaukio g. 35)";BORUŽĖLĖS;2949035147;Ne;3;4;2;9
2818;"Gintarėlis (Didlaukio g. 35)";BORUŽĖLĖS;5991638696;Ne;0;2;0;2
2819;"Gintarėlis (Didlaukio g. 35)";BORUŽĖLĖS;6563281778;Ne;0;3;0;3
2820;"Gintarėlis (Didlaukio g. 35)";BORUŽĖLĖS;6133476137;Ne;7;3;2;12
2821;"Gintarėlis (Didlaukio g. 35)";BORUŽĖLĖS;6751822184;Ne;3;4;2;9
2822;"Gintarėlis (Didlaukio g. 35)";BORUŽĖLĖS;8721340357;Ne;0;10;2;12
2823;"Gintarėlis (Didlaukio g. 35)";BORUŽĖLĖS;6138593853;Ne;3;0;2;5
2824;"Gintarėlis (Didlaukio g. 35)";BORUŽĖLĖS;1482227839;Ne;1;5;3;9
2825;"Gintarėlis (Didlaukio g. 35)";BORUŽĖLĖS;3876016666;Ne;2;0;3;5
2826;"Gintarėlis (Didlaukio g. 35)";BORUŽĖLĖS;5338409090;Ne;0;2;0;2
2827;"Gintarėlis (Didlaukio g. 35)";BORUŽĖLĖS;8403881160;Ne;6;6;2;14
2828;"Gintarėlis (Didlaukio g. 35)";BORUŽĖLĖS;4462515146;Ne;0;2;0;2
2829;"Gintarėlis (Didlaukio g. 35)";BORUŽĖLĖS;2809388552;Ne;3;3;4;10
2830;"Gintarėlis (Didlaukio g. 35)";BORUŽĖLĖS;4686913324;Ne;2;0;2;4
2831;"Gintarėlis (Didlaukio g. 35)";BORUŽĖLĖS;2488622623;Ne;0;2;3;5
2832;"Gintarėlis (Didlaukio g. 35)";BORUŽĖLĖS;2482981227;Ne;8;0;4;12
2833;"Gintarėlis (Didlaukio g. 35)";BORUŽĖLĖS;8279078612;Ne;8;0;2;10
2834;"Gintarėlis (Didlaukio g. 35)";BORUŽĖLĖS;4146454470;Ne;8;0;4;12
2835;"Gintarėlis (Didlaukio g. 35)";EŽIUKAI;1082941468;Ne;0;3;1;4
2836;"Gintarėlis (Didlaukio g. 35)";EŽIUKAI;8529974367;Ne;0;6;1;7
2837;"Gintarėlis (Didlaukio g. 35)";EŽIUKAI;6991746305;Ne;0;9;0;9
2838;"Gintarėlis (Didlaukio g. 35)";EŽIUKAI;3357866319;Ne;0;2;0;2
2839;"Gintarėlis (Didlaukio g. 35)";EŽIUKAI;2814569415;Ne;3;5;2;10
2840;"Gintarėlis (Didlaukio g. 35)";EŽIUKAI;5355691986;Ne;0;4;0;4
2841;"Gintarėlis (Didlaukio g. 35)";EŽIUKAI;5796729245;Ne;0;4;1;5
2842;"Gintarėlis (Didlaukio g. 35)";EŽIUKAI;9915887420;Ne;0;4;1;5
2843;"Gintarėlis (Didlaukio g. 35)";EŽIUKAI;3792697409;Ne;2;2;4;8
2844;"Gintarėlis (Didlaukio g. 35)";EŽIUKAI;8287685690;Ne;0;4;0;4
2845;"Gintarėlis (Didlaukio g. 35)";EŽIUKAI;7815317644;Ne;0;3;0;3
2846;"Gintarėlis (Didlaukio g. 35)";EŽIUKAI;2165332442;Ne;0;3;0;3
2847;"Gintarėlis (Didlaukio g. 35)";EŽIUKAI;6914904213;Ne;0;2;0;2
2848;"Gintarėlis (Didlaukio g. 35)";EŽIUKAI;1696337909;Ne;0;2;0;2
2849;"Gintarėlis (Didlaukio g. 35)";EŽIUKAI;8116557698;Ne;0;2;0;2
2850;"Gintarėlis (Didlaukio g. 35)";EŽIUKAI;6862629244;Ne;0;2;0;2
2851;"Gintarėlis (Didlaukio g. 35)";EŽIUKAI;3398936974;Ne;0;0;1;1
2852;"Gintarėlis (Didlaukio g. 35)";EŽIUKAI;8704248985;Ne;0;8;0;8
2853;"Gintarėlis (Didlaukio g. 35)";"SAULĖS ZUIKUČIAI";4087751760;Ne;0;0;2;2
2854;"Gintarėlis (Didlaukio g. 35)";"SAULĖS ZUIKUČIAI";7004430575;Ne;0;2;4;6
2855;"Gintarėlis (Didlaukio g. 35)";"SAULĖS ZUIKUČIAI";5103780852;Ne;0;2;2;4
2856;"Gintarėlis (Didlaukio g. 35)";"SAULĖS ZUIKUČIAI";4579612197;Ne;0;0;5;5
2857;"Gintarėlis (Didlaukio g. 35)";"SAULĖS ZUIKUČIAI";4127749930;Ne;5;1;4;10
2858;"Gintarėlis (Didlaukio g. 35)";"SAULĖS ZUIKUČIAI";5594809861;Ne;0;14;0;14
2859;"Gintarėlis (Didlaukio g. 35)";"SAULĖS ZUIKUČIAI";5593638575;Ne;0;3;1;4
2860;"Gintarėlis (Didlaukio g. 35)";"SAULĖS ZUIKUČIAI";5064767935;Ne;11;0;4;15
2861;"Gintarėlis (Didlaukio g. 35)";"SAULĖS ZUIKUČIAI";8170509526;Ne;0;22;0;22
2862;"Gintarėlis (Didlaukio g. 35)";"SAULĖS ZUIKUČIAI";1408481989;Ne;0;4;0;4
2863;"Gintarėlis (Didlaukio g. 35)";"SAULĖS ZUIKUČIAI";5109775795;Ne;4;0;5;9
2864;"Gintarėlis (Didlaukio g. 35)";"SAULĖS ZUIKUČIAI";4811778274;Ne;7;4;2;13
2865;"Gintarėlis (Didlaukio g. 35)";"SAULĖS ZUIKUČIAI";1158055621;Ne;4;0;4;8
2866;"Gintarėlis (Didlaukio g. 35)";"SAULĖS ZUIKUČIAI";1474802737;Ne;7;4;2;13
2867;"Gintarėlis (Didlaukio g. 35)";"SAULĖS ZUIKUČIAI";4199030732;Ne;9;4;2;15
2868;"Gintarėlis (Didlaukio g. 35)";Šypsenėlės;3575375401;Ne;8;2;6;16
2869;"Gintarėlis (Didlaukio g. 35)";Šypsenėlės;3575375401;Ne;8;2;6;16
2870;"Gintarėlis (Didlaukio g. 35)";Šypsenėlės;3575375401;Ne;8;2;6;16
2871;"Gintarėlis (Didlaukio g. 35)";Šypsenėlės;9020619501;Ne;0;1;0;1
2872;"Gintarėlis (Didlaukio g. 35)";Šypsenėlės;5120761293;Ne;0;2;0;2
2873;"Gintarėlis (Didlaukio g. 35)";Šypsenėlės;9413836091;Ne;0;2;0;2
2874;"Gintarėlis (Didlaukio g. 35)";Šypsenėlės;7337543180;Ne;0;2;0;2
2875;"Gintarėlis (Didlaukio g. 35)";Šypsenėlės;7337543180;Ne;0;2;0;2
2876;"Gintarėlis (Didlaukio g. 35)";Šypsenėlės;7337543180;Ne;0;2;0;2
2877;"Gintarėlis (Didlaukio g. 35)";Šypsenėlės;1567290856;Ne;0;0;2;2
2878;"Gintarėlis (Didlaukio g. 35)";Šypsenėlės;7661638176;Taip;0;2;0;2
2879;"Gintarėlis (Didlaukio g. 35)";Šypsenėlės;9477018713;Ne;8;0;4;12
2880;"Gintarėlis (Didlaukio g. 35)";Šypsenėlės;9477018713;Ne;8;0;4;12
2881;"Gintarėlis (Didlaukio g. 35)";Šypsenėlės;9477018713;Ne;8;0;4;12
2882;"Gintarėlis (Didlaukio g. 35)";Šypsenėlės;3088663209;Ne;0;4;0;4
2883;"Gintarėlis (Didlaukio g. 35)";Šypsenėlės;3459439843;Ne;8;2;2;12
2884;"Gintarėlis (Didlaukio g. 35)";Šypsenėlės;1872534206;Ne;0;2;0;2
2885;"Gintarėlis (Didlaukio g. 35)";Šypsenėlės;4334349824;Ne;0;3;0;3
2886;"Gintarėlis (Didlaukio g. 35)";Šypsenėlės;8768094601;Ne;8;2;2;12
2887;"Gintarėlis (Didlaukio g. 35)";Šypsenėlės;5834772263;Ne;6;0;4;10
2888;"Gintarėlis (Didlaukio g. 35)";Šypsenėlės;4915783145;Ne;0;8;0;8
2889;"Gintarėlis (Didlaukio g. 35)";Šypsenėlės;1367305617;Ne;8;2;2;12
2890;"Gintarėlis (Didlaukio g. 35)";Šypsenėlės;1875958358;Ne;3;0;2;5
2891;"Gintarėlis (Didlaukio g. 35)";Šypsenėlės;4079793067;Ne;0;0;2;2
2892;"Gintarėlis (Didlaukio g. 35)";Smalsučiai;7486822380;Ne;0;2;5;7
2893;"Gintarėlis (Didlaukio g. 35)";Smalsučiai;8387819754;Ne;3;2;2;7
2894;"Gintarėlis (Didlaukio g. 35)";Smalsučiai;8292698645;Ne;2;3;3;8
2895;"Gintarėlis (Didlaukio g. 35)";Smalsučiai;5748677965;Ne;3;0;3;6
2896;"Gintarėlis (Didlaukio g. 35)";Smalsučiai;1876292168;Ne;9;0;6;15
2897;"Gintarėlis (Didlaukio g. 35)";Smalsučiai;9980747501;Ne;0;1;0;1
2898;"Gintarėlis (Didlaukio g. 35)";Smalsučiai;8754068506;Ne;3;5;2;10
2899;"Gintarėlis (Didlaukio g. 35)";Smalsučiai;1537528341;Taip;3;2;3;8
2900;"Gintarėlis (Didlaukio g. 35)";Smalsučiai;4757160835;Ne;0;0;4;4
2901;"Gintarėlis (Didlaukio g. 35)";Smalsučiai;6578588403;Ne;3;1;2;6
2902;"Gintarėlis (Didlaukio g. 35)";Smalsučiai;8815001033;Ne;0;1;0;1
2903;"Gintarėlis (Didlaukio g. 35)";Smalsučiai;1433395471;Taip;2;0;5;7
2904;"Gintarėlis (Didlaukio g. 35)";Smalsučiai;1766430091;Ne;0;2;2;4
2905;"Gintarėlis (Didlaukio g. 35)";Smalsučiai;9787141660;Ne;2;0;3;5
2906;"Gintarėlis (Didlaukio g. 35)";Smalsučiai;9533972547;Ne;11;0;4;15
2907;"Gintarėlis (Didlaukio g. 35)";Smalsučiai;1337062268;Ne;4;0;6;10
2908;"Gintarėlis (Didlaukio g. 35)";Gintariukai;6244066576;Ne;0;22;0;22
2909;"Gintarėlis (Didlaukio g. 35)";Gintariukai;6056471440;Ne;4;6;2;12
2910;"Gintarėlis (Didlaukio g. 35)";Gintariukai;9374716095;Ne;0;3;1;4
2911;"Gintarėlis (Didlaukio g. 35)";Gintariukai;8999913328;Ne;3;12;2;17
2912;"Gintarėlis (Didlaukio g. 35)";Gintariukai;1359894648;Ne;5;0;2;7
2913;"Gintarėlis (Didlaukio g. 35)";Gintariukai;6357825030;Ne;4;2;4;10
2914;"Gintarėlis (Didlaukio g. 35)";Gintariukai;3044631569;Ne;5;0;7;12
2915;"Gintarėlis (Didlaukio g. 35)";Gintariukai;1848386512;Ne;4;6;4;14
2916;"Gintarėlis (Didlaukio g. 35)";Gintariukai;7427026272;Ne;7;2;4;13
2917;"Gintarėlis (Didlaukio g. 35)";GILIUKAI;1981825456;Ne;0;7;0;7
2918;"Gintarėlis (Didlaukio g. 35)";GILIUKAI;3973889495;Ne;7;0;2;9
2919;"Gintarėlis (Didlaukio g. 35)";GILIUKAI;4749559606;Ne;0;2;5;7
2920;"Gintarėlis (Didlaukio g. 35)";GILIUKAI;4458703839;Ne;8;3;2;13
2921;"Gintarėlis (Didlaukio g. 35)";GILIUKAI;2178808286;Ne;4;4;2;10
2922;"Gintarėlis (Didlaukio g. 35)";GILIUKAI;9073499040;Ne;0;4;2;6
2923;"Gintarėlis (Didlaukio g. 35)";GILIUKAI;6711773127;Ne;8;4;2;14
2924;"Gintarėlis (Didlaukio g. 35)";GILIUKAI;6547060300;Ne;0;5;0;5
2925;"Gintarėlis (Didlaukio g. 35)";GILIUKAI;5930354746;Ne;0;5;0;5
2926;"Gintarėlis (Didlaukio g. 35)";GILIUKAI;8805356168;Ne;3;4;3;10
2927;"Gintarėlis (Didlaukio g. 35)";GILIUKAI;4751066825;Ne;0;3;0;3
2928;"Gintarėlis (Didlaukio g. 35)";GILIUKAI;7562170082;Ne;0;17;0;17
2929;"Gintarėlis (Didlaukio g. 35)";GILIUKAI;7418672923;Ne;8;1;2;11
2930;"Gintarėlis (Didlaukio g. 35)";GILIUKAI;1039098192;Ne;1;4;4;9
2931;"Gintarėlis (Didlaukio g. 35)";GILIUKAI;9191264261;Ne;2;0;4;6
2932;"Gintarėlis (Didlaukio g. 35)";GILIUKAI;6042885133;Ne;2;1;2;5
2933;"Gintarėlis (Didlaukio g. 35)";GILIUKAI;3232990779;Ne;6;3;2;11
2934;"Gintarėlis (Didlaukio g. 35)";GILIUKAI;2920734274;Ne;5;1;4;10
2935;"Gintarėlis (Didlaukio g. 35)";GILIUKAI;8613554277;Ne;8;2;2;12
2936;"Gintarėlis (Didlaukio g. 35)";GILIUKAI;5202442681;Ne;1;0;2;3
2937;"Gintarėlis (Didlaukio g. 35)";GILIUKAI;7573269886;Ne;4;2;2;8
2938;Giraitė;Aviliukas;4292730355;Ne;0;2;0;2
2939;Giraitė;Aviliukas;7001163828;Ne;2;2;4;8
2940;Giraitė;Aviliukas;6159650070;Ne;3;2;4;9
2941;Giraitė;Aviliukas;5275912609;Ne;0;0;2;2
2942;Giraitė;Aviliukas;4758750245;Ne;8;0;2;10
2943;Giraitė;Aviliukas;2219854347;Ne;6;0;2;8
2944;Giraitė;Aviliukas;2338867192;Ne;8;0;2;10
2945;Giraitė;Aviliukas;3719285343;Ne;1;0;4;5
2946;Giraitė;Aviliukas;3085107071;Ne;0;0;1;1
2947;Giraitė;Aviliukas;7807844145;Ne;0;2;1;3
2948;Giraitė;Aviliukas;3757900478;Ne;6;2;2;10
2949;Giraitė;Aviliukas;7876457529;Ne;3;0;3;6
2950;Giraitė;Aviliukas;3992069614;Ne;2;2;3;7
2951;Giraitė;Aviliukas;6121586335;Ne;0;2;5;7
2952;Giraitė;Aviliukas;4440444700;Ne;7;3;2;12
2953;Giraitė;Aviliukas;6296485105;Ne;6;0;3;9
2954;Giraitė;Aviliukas;5356944812;Ne;3;0;2;5
2955;Giraitė;Aviliukas;4554565631;Ne;6;0;0;6
2956;Giraitė;Aviliukas;2031462126;Ne;3;7;2;12
2957;Giraitė;LapiukaI;6141730004;Ne;3;2;2;7
2958;Giraitė;LapiukaI;6325909670;Ne;0;2;0;2
2959;Giraitė;LapiukaI;7831526566;Ne;2;0;2;4
2960;Giraitė;LapiukaI;2740656695;Ne;0;12;0;12
2961;Giraitė;LapiukaI;5030697729;Ne;0;2;1;3
2962;Giraitė;LapiukaI;1921430434;Ne;0;1;0;1
2963;Giraitė;LapiukaI;5006156109;Ne;0;2;0;2
2964;Giraitė;LapiukaI;4663343304;Ne;4;0;2;6
2965;Giraitė;LapiukaI;5382004098;Ne;0;3;0;3
2966;Giraitė;LapiukaI;4811513778;Ne;0;6;0;6
2967;Giraitė;LapiukaI;1974159110;Ne;8;2;6;16
2968;Giraitė;LapiukaI;5532639133;Ne;4;3;4;11
2969;Giraitė;LapiukaI;5902161665;Ne;0;7;0;7
2970;Giraitė;LapiukaI;4955786826;Ne;0;3;0;3
2971;Giraitė;LapiukaI;4260343903;Ne;0;7;0;7
2972;Giraitė;LapiukaI;9088123796;Ne;10;2;2;14
2973;Giraitė;LapiukaI;7772177095;Ne;0;3;0;3
2974;Giraitė;LapiukaI;2880342138;Ne;1;0;2;3
2975;Giraitė;LapiukaI;9503157590;Ne;1;2;2;5
2976;Giraitė;LapiukaI;5471577047;Ne;0;2;0;2
2977;Giraitė;Voveriukai;8612554184;Ne;0;7;0;7
2978;Giraitė;Voveriukai;1436302175;Ne;0;0;5;5
2979;Giraitė;Voveriukai;2064019596;Ne;0;2;0;2
2980;Giraitė;Voveriukai;3039445733;Ne;3;3;5;11
2981;Giraitė;Voveriukai;8050306951;Ne;5;0;2;7
2982;Giraitė;Voveriukai;6378362980;Ne;0;0;2;2
2983;Giraitė;Voveriukai;1262854023;Ne;0;3;1;4
2984;Giraitė;Voveriukai;1126576745;Ne;4;0;4;8
2985;Giraitė;Voveriukai;4719547384;Ne;0;2;0;2
2986;Giraitė;Voveriukai;1772997796;Ne;22;0;0;22
2987;Giraitė;Voveriukai;4008393576;Ne;2;2;0;4
2988;Giraitė;Voveriukai;9281071794;Ne;3;0;0;3
2989;Giraitė;Voveriukai;9766107773;Ne;11;0;2;13
2990;Giraitė;Voveriukai;9386943162;Ne;4;0;2;6
2991;Giraitė;Voveriukai;4749790368;Ne;1;2;2;5
2992;Giraitė;Voveriukai;3613828494;Ne;7;0;3;10
2993;Giraitė;Voveriukai;2686885139;Taip;1;0;4;5
2994;Giraitė;Voveriukai;2726766768;Ne;12;3;2;17
2995;Giraitė;Voveriukai;6565165993;Ne;0;5;1;6
2996;Giraitė;Voveriukai;7392324344;Ne;8;0;3;11
2997;Giraitė;Grybukai;7354834895;Ne;2;2;2;6
2998;Giraitė;Grybukai;8799195526;Ne;0;2;2;4
2999;Giraitė;Grybukai;2177856916;Ne;0;6;0;6
3000;Giraitė;Grybukai;4387282125;Ne;0;2;0;2
3001;Giraitė;Grybukai;6225092500;Ne;7;2;2;11
3002;Giraitė;Grybukai;6265908751;Ne;0;1;0;1
3003;Giraitė;Grybukai;4137699629;Ne;5;2;4;11
3004;Giraitė;Grybukai;7919088987;Ne;0;2;2;4
3005;Giraitė;Grybukai;4822168634;Ne;0;0;1;1
3006;Giraitė;Grybukai;4773517160;Ne;20;0;2;22
3007;Giraitė;Grybukai;7739516049;Ne;0;2;0;2
3008;Giraitė;Grybukai;5616242311;Ne;0;2;6;8
3009;Giraitė;Grybukai;2074303013;Ne;0;2;0;2
3010;Giraitė;Grybukai;6963656869;Ne;0;2;0;2
3011;Giraitė;Grybukai;4932174149;Ne;0;3;1;4
3012;Giraitė;Grybukai;2088867630;Ne;0;2;0;2
3013;Giraitė;Grybukai;3875214088;Ne;0;2;3;5
3014;Giraitė;Grybukai;5202562049;Ne;0;2;0;2
3015;Giraitė;Grybukai;7441871219;Ne;0;3;0;3
3016;Giraitė;Grybukai;3607198556;Ne;0;6;3;9
3017;Giraitė;Grybukai;1583733838;Ne;0;1;0;1
3018;Giraitė;Riešutėliai;5365264259;Ne;0;0;12;12
3019;Giraitė;Riešutėliai;3158451613;Ne;8;0;4;12
3020;Giraitė;Riešutėliai;7910736839;Ne;0;0;3;3
3021;Giraitė;Riešutėliai;3308792461;Ne;0;0;3;3
3022;Giraitė;Riešutėliai;7423115504;Ne;1;0;2;3
3023;Giraitė;Riešutėliai;3116241918;Ne;0;0;1;1
3024;Giraitė;Riešutėliai;6838184704;Ne;3;6;2;11
3025;Giraitė;Riešutėliai;5161383686;Ne;0;3;0;3
3026;Giraitė;Riešutėliai;5148257412;Ne;1;2;2;5
3027;Giraitė;Riešutėliai;7566944002;Ne;0;2;0;2
3028;Giraitė;Riešutėliai;3839432744;Ne;0;0;3;3
3029;Giraitė;Riešutėliai;9144465313;Ne;0;0;2;2
3030;Giraitė;Riešutėliai;6288016799;Ne;4;0;2;6
3031;Giraitė;Riešutėliai;3278871662;Ne;0;2;1;3
3032;Giraitė;Riešutėliai;4168934880;Ne;2;3;2;7
3033;Giraitė;Riešutėliai;6337090583;Ne;7;0;7;14
3034;Giraitė;Riešutėliai;3843211767;Ne;0;0;2;2
3035;Giraitė;Meškiukai;5870376620;Ne;2;0;2;4
3036;Giraitė;Meškiukai;5447466102;Ne;9;4;2;15
3037;Giraitė;Meškiukai;5574589536;Ne;0;17;1;18
3038;Giraitė;Meškiukai;7744101334;Ne;0;3;0;3
3039;Giraitė;Meškiukai;5876711899;Ne;3;0;2;5
3040;Giraitė;Meškiukai;9589760939;Ne;3;2;2;7
3041;Giraitė;Meškiukai;4500393769;Ne;0;3;0;3
3042;Giraitė;Meškiukai;3144724475;Ne;0;7;0;7
3043;Giraitė;Meškiukai;5525538498;Ne;0;0;7;7
3044;Giraitė;Meškiukai;2867735227;Ne;4;0;2;6
3045;Giraitė;Meškiukai;4681342624;Ne;5;1;2;8
3046;Giraitė;Meškiukai;4431964254;Ne;2;0;3;5
3047;Giraitė;Meškiukai;9669849051;Ne;0;2;0;2
3048;Giraitė;Meškiukai;4946664007;Ne;0;3;0;3
3049;Giraitė;Meškiukai;1170698327;Ne;1;0;3;4
3050;Giraitė;Meškiukai;6865072274;Ne;10;0;5;15
3051;Giraitė;Meškiukai;3108521607;Ne;0;9;0;9
3052;Giraitė;Meškiukai;3612494313;Ne;0;0;2;2
3053;Giraitė;Meškiukai;2076989836;Ne;2;2;2;6
3054;Giraitė;Meškiukai;8139743188;Ne;0;2;0;2
3055;Giraitė;Uogelės;1729871315;Ne;0;1;0;1
3056;Giraitė;Uogelės;4317544803;Ne;0;2;0;2
3057;Giraitė;Uogelės;9927102264;Ne;3;0;3;6
3058;Giraitė;Uogelės;4121361794;Ne;0;2;0;2
3059;Giraitė;Uogelės;4843415587;Ne;0;4;0;4
3060;Giraitė;Uogelės;2732715332;Ne;8;0;2;10
3061;Giraitė;Uogelės;2307307454;Ne;0;2;1;3
3062;Giraitė;Uogelės;2102237550;Ne;0;2;0;2
3063;Giraitė;Uogelės;6065010363;Ne;0;2;1;3
3064;Giraitė;Uogelės;5255040944;Ne;0;3;0;3
3065;Giraitė;Uogelės;7094750784;Taip;0;9;0;9
3066;Giraitė;Uogelės;4009092043;Ne;0;1;0;1
3067;Giraitė;Uogelės;1356340471;Taip;4;2;4;10
3068;Giraitė;Uogelės;7377939409;Ne;0;3;1;4
3069;Giraitė;Uogelės;4288937528;Ne;2;0;3;5
3070;Giraitė;Uogelės;6293111179;Ne;1;2;2;5
3071;Giraitė;Uogelės;4680913596;Ne;13;0;2;15
3072;Giraitė;Šaltinėlis;3334974747;Ne;0;0;4;4
3073;Giraitė;Šaltinėlis;1125576830;Ne;5;0;4;9
3074;Giraitė;Šaltinėlis;2223501723;Ne;4;0;4;8
3075;Giraitė;Šaltinėlis;3262098794;Ne;4;0;4;8
3076;Giraitė;Šaltinėlis;8938565070;Ne;4;2;2;8
3077;Giraitė;Šaltinėlis;4094300540;Ne;6;5;2;13
3078;Giraitė;Šaltinėlis;3978249830;Ne;8;2;2;12
3079;Giraitė;Šaltinėlis;7831610906;Ne;15;0;3;18
3080;Giraitė;Šaltinėlis;8686898517;Ne;7;0;4;11
3081;Giraitė;Šaltinėlis;9566341270;Ne;1;0;3;4
3082;Giraitė;Šaltinėlis;8928574407;Ne;0;0;2;2
3083;Giraitė;Šaltinėlis;6897620778;Ne;13;0;2;15
3084;Giraitė;Šaltinėlis;2652478107;Ne;1;0;2;3
3085;Giraitė;Šaltinėlis;3498087339;Ne;7;0;2;9
3086;Giraitė;Boružėlės;5543356573;Ne;3;0;2;5
3087;Giraitė;Boružėlės;8552588816;Ne;11;0;4;15
3088;Giraitė;Boružėlės;4315974617;Ne;4;0;4;8
3089;Giraitė;Boružėlės;2782467129;Ne;7;0;2;9
3090;Giraitė;Boružėlės;7149126803;Ne;5;0;5;10
3091;Giraitė;Boružėlės;6989400181;Ne;2;11;2;15
3092;Giraitė;Boružėlės;8163272129;Ne;5;0;4;9
3093;Giraitė;Boružėlės;2463291913;Ne;2;2;2;6
3094;Giraitė;Boružėlės;9611196852;Ne;0;3;0;3
3095;Giraitė;Boružėlės;2483204684;Ne;2;0;2;4
3096;Giraitė;Boružėlės;3643975279;Ne;1;6;2;9
3097;Giraitė;Boružėlės;3620400530;Ne;3;0;2;5
3098;Giraitė;Boružėlės;4876614491;Ne;5;2;4;11
3099;Giraitė;Boružėlės;3035520579;Ne;3;0;2;5
3100;Giraitė;Boružėlės;2344506210;Ne;11;0;4;15
3101;Giraitė;Gandriukai;8525380061;Ne;0;4;2;6
3102;Giraitė;Gandriukai;4851987149;Ne;8;2;4;14
3103;Giraitė;Gandriukai;7008670489;Ne;0;2;0;2
3104;Giraitė;Gandriukai;6277788515;Ne;0;0;1;1
3105;Giraitė;Gandriukai;7767820565;Ne;1;0;2;3
3106;Giraitė;Gandriukai;8819218663;Ne;0;2;2;4
3107;Giraitė;Gandriukai;7269074498;Ne;2;1;2;5
3108;Giraitė;Gandriukai;1490748887;Ne;2;0;0;2
3109;Giraitė;Gandriukai;7789414361;Ne;5;3;5;13
3110;Giraitė;Gandriukai;9850432917;Ne;5;0;4;9
3111;Giraitė;Gandriukai;2313273738;Ne;0;1;0;1
3112;Giraitė;Gandriukai;8101302584;Ne;9;0;6;15
3113;Giraitė;Gandriukai;9307640828;Ne;5;0;2;7
3114;Giraitė;Gandriukai;3027761044;Ne;0;2;0;2
3115;Giraitė;Gandriukai;4371263826;Ne;3;2;2;7
3116;Giraitė;Gandriukai;1227555563;Ne;2;0;2;4
3117;Giraitė;ŽVIRBLIUKAI;8461725999;Ne;0;0;2;2
3118;Giraitė;ŽVIRBLIUKAI;7395332578;Ne;0;2;1;3
3119;Giraitė;ŽVIRBLIUKAI;5086296808;Ne;0;13;0;13
3120;Giraitė;ŽVIRBLIUKAI;9669916418;Ne;1;0;4;5
3121;Giraitė;ŽVIRBLIUKAI;3481695682;Ne;0;5;0;5
3122;Giraitė;ŽVIRBLIUKAI;7551981095;Ne;0;2;0;2
3123;Giraitė;ŽVIRBLIUKAI;7678134658;Ne;0;0;1;1
3124;Giraitė;ŽVIRBLIUKAI;9471560738;Ne;0;4;0;4
3125;Giraitė;ŽVIRBLIUKAI;6677278422;Ne;5;2;2;9
3126;Giraitė;ŽVIRBLIUKAI;7230351549;Ne;1;0;4;5
3127;Giraitė;ŽVIRBLIUKAI;9114364139;Ne;0;2;0;2
3128;Giraitė;ŽVIRBLIUKAI;9392127689;Ne;0;2;0;2
3129;Giraitė;ŽVIRBLIUKAI;2416162886;Ne;0;2;0;2
3130;Giraitė;ŽVIRBLIUKAI;7543605905;Ne;0;10;0;10
3131;Giraitė;ŽVIRBLIUKAI;8128401630;Ne;13;0;2;15
3132;Giraitė;ŽVIRBLIUKAI;4233170371;Ne;11;2;2;15
3133;Giraitė;ŽVIRBLIUKAI;8871979627;Ne;1;0;0;1
3134;Giraitė;ŽVIRBLIUKAI;3214528809;Ne;0;0;1;1
3135;Giraitė;ŽVIRBLIUKAI;5548434439;Ne;0;0;1;1
3136;Giraitė;ŽVIRBLIUKAI;4450822125;Ne;0;1;0;1
3137;Giraitė;ŽVIRBLIUKAI;6474975269;Ne;0;2;1;3
3138;Giraitė;Kiškeliai;8259691835;Ne;8;0;2;10
3139;Giraitė;Kiškeliai;8782435144;Ne;0;0;2;2
3140;Giraitė;Kiškeliai;3457058930;Ne;0;4;1;5
3141;Giraitė;Kiškeliai;9503522932;Ne;0;0;3;3
3142;Giraitė;Kiškeliai;3599734091;Ne;12;0;0;12
3143;Giraitė;Kiškeliai;4964803735;Ne;6;0;5;11
3144;Giraitė;Kiškeliai;8148626841;Ne;3;0;2;5
3145;Giraitė;Kiškeliai;9459699089;Ne;22;0;0;22
3146;Gudrutis;Gandriukų;3264829331;Ne;0;0;2;2
3147;Gudrutis;Gandriukų;7143849852;Ne;0;0;1;1
3148;Gudrutis;Gandriukų;4600814480;Ne;0;0;1;1
3149;Gudrutis;Gandriukų;5931281687;Ne;0;1;5;6
3150;Gudrutis;Gandriukų;5498218329;Ne;0;2;3;5
3151;Gudrutis;Gandriukų;3760014407;Ne;0;2;0;2
3152;Gudrutis;Gandriukų;9454206104;Ne;4;0;4;8
3153;Gudrutis;Gandriukų;5911423362;Ne;2;0;3;5
3154;Gudrutis;Gandriukų;3316297441;Ne;0;5;0;5
3155;Gudrutis;Gandriukų;1170008457;Ne;12;0;0;12
3156;Gudrutis;Gandriukų;7930414623;Ne;2;2;2;6
3157;Gudrutis;Gandriukų;6307643172;Ne;2;0;2;4
3158;Gudrutis;Gandriukų;7531077386;Ne;0;1;2;3
3159;Gudrutis;Gandriukų;2278368966;Ne;2;0;2;4
3160;Gudrutis;Gandriukų;3000289515;Ne;0;1;0;1
3161;Gudrutis;Gandriukų;6458053920;Ne;0;2;3;5
3162;Gudrutis;Gandriukų;2256458624;Ne;0;0;1;1
3163;Gudrutis;Gandriukų;2784392885;Ne;0;0;2;2
3164;Gudrutis;Gandriukų;1588396018;Ne;0;7;0;7
3165;Gudrutis;Gandriukų;3136349573;Ne;0;7;2;9
3166;Gudrutis;Gandriukų;5257913623;Ne;2;0;0;2
3167;Gudrutis;"Saulės zuikučių";7934673005;Ne;0;0;3;3
3168;Gudrutis;"Saulės zuikučių";2199222671;Ne;2;0;0;2
3169;Gudrutis;"Saulės zuikučių";1587454709;Ne;0;5;0;5
3170;Gudrutis;"Saulės zuikučių";1670550212;Ne;12;1;4;17
3171;Gudrutis;"Saulės zuikučių";5241856014;Ne;0;0;1;1
3172;Gudrutis;"Saulės zuikučių";8500911420;Ne;2;1;2;5
3173;Gudrutis;"Saulės zuikučių";5408444872;Ne;2;0;1;3
3174;Gudrutis;"Saulės zuikučių";5728436444;Ne;0;2;0;2
3175;Gudrutis;"Saulės zuikučių";3281890659;Ne;0;6;0;6
3176;Gudrutis;"Saulės zuikučių";5585248878;Ne;0;4;0;4
3177;Gudrutis;"Saulės zuikučių";1384696362;Ne;0;0;2;2
3178;Gudrutis;"Saulės zuikučių";2994309084;Ne;0;0;2;2
3179;Gudrutis;"Saulės zuikučių";9044566825;Taip;0;3;4;7
3180;Gudrutis;"Saulės zuikučių";9683107780;Ne;0;2;0;2
3181;Gudrutis;"Saulės zuikučių";1197649093;Ne;0;0;8;8
3182;Gudrutis;"Saulės zuikučių";8598450150;Ne;11;0;4;15
3183;Gudrutis;"Saulės zuikučių";2484715724;Ne;11;0;4;15
3184;Gudrutis;Pelėdžiukų;7955353991;Ne;0;2;1;3
3185;Gudrutis;Pelėdžiukų;2197278086;Ne;0;2;2;4
3186;Gudrutis;Pelėdžiukų;6358318238;Ne;0;2;3;5
3187;Gudrutis;Pelėdžiukų;7942601528;Ne;0;2;0;2
3188;Gudrutis;Pelėdžiukų;8774935740;Ne;12;0;7;19
3189;Gudrutis;Pelėdžiukų;4844838728;Ne;0;2;0;2
3190;Gudrutis;Pelėdžiukų;1685531183;Ne;2;0;1;3
3191;Gudrutis;Pelėdžiukų;9253468183;Ne;1;3;2;6
3192;Gudrutis;Pelėdžiukų;1051407930;Ne;0;0;1;1
3193;Gudrutis;Pelėdžiukų;7755882832;Ne;3;0;2;5
3194;Gudrutis;Pelėdžiukų;2487363252;Ne;0;0;1;1
3195;Gudrutis;Pelėdžiukų;9297898193;Taip;7;0;3;10
3196;Gudrutis;Pelėdžiukų;7663746093;Ne;2;2;2;6
3197;Gudrutis;Pelėdžiukų;8512130106;Ne;0;3;0;3
3198;Gudrutis;Pelėdžiukų;3919786807;Ne;0;2;6;8
3199;Gudrutis;Pelėdžiukų;1485530468;Ne;7;0;0;7
3200;Gudrutis;Pelėdžiukų;2118820249;Ne;2;0;2;4
3201;Gudrutis;Pelėdžiukų;5508723821;Ne;0;5;0;5
3202;Gudrutis;BITUČIŲ;6700254479;Ne;0;2;18;20
3203;Gudrutis;BITUČIŲ;7773150642;Ne;0;2;2;4
3204;Gudrutis;BITUČIŲ;2293472716;Ne;0;5;0;5
3205;Gudrutis;BITUČIŲ;6835038962;Ne;0;2;3;5
3206;Gudrutis;BITUČIŲ;6731806925;Ne;0;2;7;9
3207;Gudrutis;BITUČIŲ;2118727861;Ne;2;2;4;8
3208;Gudrutis;BITUČIŲ;9701111916;Ne;0;2;2;4
3209;Gudrutis;BITUČIŲ;1725920873;Ne;2;2;9;13
3210;Gudrutis;BITUČIŲ;1901358996;Ne;3;1;3;7
3211;Gudrutis;BITUČIŲ;7664517480;Ne;0;0;1;1
3212;Gudrutis;BITUČIŲ;9847597133;Ne;0;1;2;3
3213;Gudrutis;BITUČIŲ;3646335609;Ne;0;1;4;5
3214;Gudrutis;BITUČIŲ;7871991275;Ne;0;2;1;3
3215;Gudrutis;BITUČIŲ;5580618896;Ne;0;2;1;3
3216;Gudrutis;BITUČIŲ;2468434676;Ne;0;2;1;3
3217;Gudrutis;BITUČIŲ;3625838131;Ne;0;5;0;5
3218;Gudrutis;BITUČIŲ;2337493193;Ne;0;2;0;2
3219;Gudrutis;BITUČIŲ;2408038213;Ne;0;1;0;1
3220;Gudrutis;BITUČIŲ;2764843216;Ne;0;1;2;3
3221;Gudrutis;BITUČIŲ;1012579870;Ne;0;2;1;3
3222;Gudrutis;BITUČIŲ;8165828215;Ne;0;2;0;2
3223;Gudrutis;BITUČIŲ;8240340213;Ne;0;2;1;3
3224;Gudrutis;Boružėlių;4623428212;Ne;0;0;6;6
3225;Gudrutis;Boružėlių;9893732913;Ne;0;0;3;3
3226;Gudrutis;Boružėlių;2807547699;Ne;2;8;0;10
3227;Gudrutis;Boružėlių;6326258371;Ne;3;2;4;9
3228;Gudrutis;Boružėlių;7033634744;Ne;0;2;2;4
3229;Gudrutis;Boružėlių;3959030593;Ne;0;0;5;5
3230;Gudrutis;Boružėlių;4672748361;Ne;0;0;4;4
3231;Gudrutis;Boružėlių;8081931247;Ne;0;0;4;4
3232;Gudrutis;Boružėlių;5382755416;Ne;2;0;6;8
3233;Gudrutis;Boružėlių;4546694746;Ne;0;2;3;5
3234;Gudrutis;Boružėlių;9948022627;Ne;8;0;4;12
3235;Gudrutis;Boružėlių;4540855641;Ne;7;0;4;11
3236;Gudrutis;Boružėlių;1277537891;Ne;17;0;0;17
3237;Gudrutis;Boružėlių;5121141955;Ne;1;0;4;5
3238;Gudrutis;Boružėlių;4691454736;Ne;7;0;5;12
3239;Gudrutis;Drugeliai;2497248749;Ne;2;0;4;6
3240;Gudrutis;Drugeliai;6284712576;Ne;0;0;3;3
3241;Gudrutis;Drugeliai;3797656483;Ne;0;2;3;5
3242;Gudrutis;Drugeliai;9200644104;Ne;0;2;3;5
3243;Gudrutis;Drugeliai;9096764346;Ne;3;7;2;12
3244;Gudrutis;Drugeliai;5306281458;Ne;0;22;0;22
3245;Gudrutis;Drugeliai;8783180638;Ne;0;22;0;22
3246;Gudrutis;Drugeliai;1737001982;Ne;10;2;2;14
3247;Gudrutis;Drugeliai;8525851058;Ne;0;0;2;2
3248;Gudrutis;Drugeliai;8080976400;Ne;2;0;2;4
3249;Gudrutis;Drugeliai;9808350750;Ne;0;2;0;2
3250;Gudrutis;Drugeliai;6101410750;Ne;3;0;2;5
3251;Gudrutis;Drugeliai;5710348070;Ne;8;0;5;13
3252;Gudrutis;Drugeliai;8843761360;Ne;8;0;5;13
3253;Gudrutis;Drugeliai;5590297232;Ne;2;0;3;5
3254;Gudrutis;Drugeliai;5093267385;Ne;1;0;8;9
3255;Gudrutis;Drugeliai;1364145110;Ne;5;2;4;11
3256;Gudrutis;Drugeliai;8803747496;Ne;8;2;12;22
3257;Gudrutis;Drugeliai;9714712791;Ne;0;0;2;2
3258;Gudrutis;Drugeliai;6063661969;Ne;11;0;6;17
3259;Gudrutis;Drugeliai;2435945253;Ne;0;0;3;3
3260;Gudrutis;Drugeliai;6268669142;Taip;0;2;4;6
3261;Jurginėlis;Ąžuoliukai;7309052653;Ne;8;0;3;11
3262;Jurginėlis;Ąžuoliukai;2501462080;Ne;1;0;2;3
3263;Jurginėlis;Ąžuoliukai;8571054905;Ne;10;0;2;12
3264;Jurginėlis;Ąžuoliukai;6168508647;Ne;5;0;2;7
3265;Jurginėlis;Ąžuoliukai;5861832676;Ne;0;0;1;1
3266;Jurginėlis;Ąžuoliukai;3933113321;Ne;0;17;0;17
3267;Jurginėlis;Ąžuoliukai;5861418459;Ne;0;12;0;12
3268;Jurginėlis;Ąžuoliukai;5869170503;Ne;2;0;4;6
3269;Jurginėlis;Ąžuoliukai;3562210465;Ne;1;0;1;2
3270;Jurginėlis;Ąžuoliukai;6202225321;Ne;5;1;2;8
3271;Jurginėlis;Ąžuoliukai;7081618073;Ne;3;0;2;5
3272;Jurginėlis;Ąžuoliukai;6851855147;Ne;0;0;1;1
3273;Jurginėlis;Ąžuoliukai;9029587175;Ne;5;0;2;7
3274;Jurginėlis;Ąžuoliukai;9889620429;Ne;5;0;2;7
3275;Jurginėlis;Ąžuoliukai;3324811458;Ne;4;0;2;6
3276;Jurginėlis;Ąžuoliukai;6153432639;Ne;11;0;2;13
3277;Jurginėlis;Ąžuoliukai;8174251359;Ne;5;0;5;10
3278;Jurginėlis;Ąžuoliukai;2447025385;Ne;18;0;0;18
3279;Jurginėlis;Ąžuoliukai;5313627252;Ne;21;0;0;21
3280;Jurginėlis;Žiogeliai;8159210242;Ne;0;22;0;22
3281;Jurginėlis;Žiogeliai;7251598691;Ne;0;7;0;7
3282;Jurginėlis;Žiogeliai;7010130915;Ne;1;0;4;5
3283;Jurginėlis;Žiogeliai;7907096012;Ne;1;4;4;9
3284;Jurginėlis;Žiogeliai;7250246853;Ne;0;5;0;5
3285;Jurginėlis;Žiogeliai;6438669072;Ne;2;0;2;4
3286;Jurginėlis;Žiogeliai;7300018733;Ne;8;1;2;11
3287;Jurginėlis;Žiogeliai;4674128568;Ne;0;2;0;2
3288;Jurginėlis;Žiogeliai;9305884152;Ne;2;2;0;4
3289;Jurginėlis;Žiogeliai;9716328349;Ne;0;22;0;22
3290;Jurginėlis;Žiogeliai;4441183185;Ne;0;1;0;1
3291;Jurginėlis;Žiogeliai;4502564783;Ne;0;1;0;1
3292;Jurginėlis;Žiogeliai;1937927553;Ne;9;0;4;13
3293;Jurginėlis;Žiogeliai;7527178332;Ne;8;2;4;14
3294;Jurginėlis;Žiogeliai;4682125116;Ne;1;6;2;9
3295;Jurginėlis;Žiogeliai;3920971621;Ne;5;0;2;7
3296;Jurginėlis;Žiogeliai;5037980414;Ne;0;0;2;2
3297;Jurginėlis;Pelėdžiukų;8844614653;Ne;3;0;3;6
3298;Jurginėlis;Pelėdžiukų;1303323955;Ne;9;0;2;11
3299;Jurginėlis;Pelėdžiukų;6856023398;Ne;3;0;3;6
3300;Jurginėlis;Pelėdžiukų;4466955830;Ne;8;0;4;12
3301;Jurginėlis;Pelėdžiukų;6932501634;Ne;0;0;3;3
3302;Jurginėlis;Pelėdžiukų;6285599044;Ne;4;2;3;9
3303;Jurginėlis;Pelėdžiukų;5043815909;Ne;0;0;1;1
3304;Jurginėlis;Pelėdžiukų;9901171406;Ne;1;0;2;3
3305;Jurginėlis;Pelėdžiukų;2982526236;Ne;2;0;3;5
3306;Jurginėlis;Pelėdžiukų;4233910766;Ne;6;0;4;10
3307;Jurginėlis;Pelėdžiukų;1537710974;Ne;4;3;2;9
3308;Jurginėlis;Pelėdžiukų;6594025023;Ne;8;2;2;12
3309;Jurginėlis;Pelėdžiukų;6124147401;Ne;0;2;0;2
3310;Jurginėlis;Pelėdžiukų;6648657850;Ne;8;0;2;10
3311;Jurginėlis;Pelėdžiukų;9139025010;Ne;0;5;0;5
3312;Jurginėlis;Pelėdžiukų;7554346190;Ne;6;0;5;11
3313;Jurginėlis;Pelėdžiukų;4555257132;Taip;0;0;6;6
3314;Jurginėlis;Boružėlių;6806704355;Ne;3;0;2;5
3315;Jurginėlis;Boružėlių;3091019969;Ne;3;2;3;8
3316;Jurginėlis;Boružėlių;9288380246;Ne;0;0;1;1
3317;Jurginėlis;Boružėlių;2548920722;Ne;7;2;2;11
3318;Jurginėlis;Boružėlių;7288921301;Ne;2;2;2;6
3319;Jurginėlis;Boružėlių;2263818210;Ne;2;0;2;4
3320;Jurginėlis;Boružėlių;4827340942;Ne;12;2;2;16
3321;Jurginėlis;Boružėlių;2225892248;Ne;2;2;2;6
3322;Jurginėlis;Boružėlių;6579565337;Ne;3;2;2;7
3323;Jurginėlis;Boružėlių;3462969423;Ne;0;1;0;1
3324;Jurginėlis;Boružėlių;7990015623;Ne;3;3;2;8
3325;Jurginėlis;Boružėlių;7486778826;Ne;0;11;0;11
3326;Jurginėlis;Boružėlių;4158502752;Ne;0;2;1;3
3327;Jurginėlis;Boružėlių;5242359650;Taip;0;9;0;9
3328;Jurginėlis;Boružėlių;2214809186;Ne;5;2;2;9
3329;Jurginėlis;Boružėlių;3284464951;Ne;0;18;0;18
3330;Jurginėlis;Boružėlių;8144038013;Ne;3;2;3;8
3331;Jurginėlis;Bitučių;9882919290;Ne;0;2;0;2
3332;Jurginėlis;Bitučių;5984893389;Ne;0;8;0;8
3333;Jurginėlis;Bitučių;3079495897;Ne;8;2;4;14
3334;Jurginėlis;Bitučių;8727844649;Ne;0;2;8;10
3335;Jurginėlis;Bitučių;1455749921;Ne;0;10;0;10
3336;Jurginėlis;Bitučių;7809274980;Ne;1;0;2;3
3337;Jurginėlis;Bitučių;2417314519;Ne;0;2;0;2
3338;Jurginėlis;Bitučių;6968528293;Ne;0;6;0;6
3339;Jurginėlis;Bitučių;9507571301;Ne;0;0;1;1
3340;Jurginėlis;Bitučių;8779807396;Ne;3;2;3;8
3341;Jurginėlis;Bitučių;9760394658;Ne;3;2;3;8
3342;Jurginėlis;Bitučių;8443412187;Ne;0;0;1;1
3343;Jurginėlis;Bitučių;4967548277;Ne;3;2;2;7
3344;Jurginėlis;Bitučių;2925253653;Ne;3;7;2;12
3345;Jurginėlis;Bitučių;1340689348;Ne;0;2;0;2
3346;Jurginėlis;Bitučių;2221708420;Ne;0;2;4;6
3347;Jurginėlis;Bitučių;6181547354;Ne;0;22;0;22
3348;Jurginėlis;Bitučių;2490875633;Ne;0;10;1;11
3349;Jurginėlis;Bitučių;4689913361;Ne;0;1;2;3
3350;Jurginėlis;Bitučių;9101617374;Ne;3;2;2;7
3351;Jurginėlis;Skruzdeliukų;1351306981;Ne;8;0;3;11
3352;Jurginėlis;Skruzdeliukų;9146039217;Ne;0;2;0;2
3353;Jurginėlis;Skruzdeliukų;3558752347;Ne;5;2;2;9
3354;Jurginėlis;Skruzdeliukų;5734506036;Ne;0;7;0;7
3355;Jurginėlis;Skruzdeliukų;3699180485;Ne;0;6;0;6
3356;Jurginėlis;Skruzdeliukų;1634502874;Ne;11;0;2;13
3357;Jurginėlis;Skruzdeliukų;4981043400;Ne;2;0;0;2
3358;Jurginėlis;Skruzdeliukų;1763849354;Ne;10;0;2;12
3359;Jurginėlis;Skruzdeliukų;4944292549;Ne;0;5;0;5
3360;Jurginėlis;Skruzdeliukų;9506129699;Ne;9;1;2;12
3361;Jurginėlis;Skruzdeliukų;9550110246;Ne;6;2;2;10
3362;Jurginėlis;Skruzdeliukų;3541542063;Ne;2;0;2;4
3363;Jurginėlis;Skruzdeliukų;1204999684;Ne;2;3;2;7
3364;Jurginėlis;Skruzdeliukų;9937405742;Ne;13;1;4;18
3365;Jurginėlis;Skruzdeliukų;1726968598;Ne;0;17;0;17
3366;Jurginėlis;Skruzdeliukų;2332714713;Ne;15;2;2;19
3367;Jurginėlis;Skruzdeliukų;9961083854;Ne;2;3;2;7
3368;Jurginėlis;Skruzdeliukų;6542567172;Ne;0;8;0;8
3369;Jurginėlis;Skruzdeliukų;1582948463;Ne;3;3;2;8
3370;Jurginėlis;Drugelių;2025403481;Ne;0;1;5;6
3371;Jurginėlis;Drugelių;9065349248;Ne;4;0;5;9
3372;Jurginėlis;Drugelių;8341951659;Ne;0;9;0;9
3373;Jurginėlis;Drugelių;7795042485;Taip;6;0;2;8
3374;Jurginėlis;Drugelių;5138832895;Ne;3;0;4;7
3375;Jurginėlis;Drugelių;5751977493;Ne;3;0;5;8
3376;Jurginėlis;Drugelių;3466562781;Ne;0;0;3;3
3377;Jurginėlis;Drugelių;6068645621;Ne;5;6;4;15
3378;Jurginėlis;Drugelių;4276237094;Ne;4;1;2;7
3379;Jurginėlis;Drugelių;3527520303;Ne;3;0;5;8
3380;Jurginėlis;Drugelių;5874949368;Ne;14;0;2;16
3381;Jurginėlis;Drugelių;7349309693;Ne;0;3;0;3
3382;Jurginėlis;Drugelių;3063084253;Ne;3;0;5;8
3383;Jurginėlis;Drugelių;7409019574;Ne;2;0;0;2
3384;Jurginėlis;Drugelių;5928303681;Ne;2;2;0;4
3385;Jurginėlis;Drugelių;5476486516;Ne;7;0;0;7
3386;Jurginėlis;Drugelių;8536084383;Ne;0;0;2;2
3387;Jurginėlis;Žibučių;4979618298;Ne;2;0;4;6
3388;Jurginėlis;Žibučių;6636147085;Ne;12;3;7;22
3389;Jurginėlis;Žibučių;1438159631;Ne;1;2;0;3
3390;Jurginėlis;Žibučių;1336429135;Ne;5;2;3;10
3391;Jurginėlis;Žibučių;6948834218;Ne;5;2;5;12
3392;Jurginėlis;Žibučių;7721612113;Ne;3;2;3;8
3393;Jurginėlis;Žibučių;6988386438;Ne;1;0;2;3
3394;Jurginėlis;Žibučių;5936508522;Ne;8;17;2;27
3395;Jurginėlis;Žibučių;6717892969;Ne;0;2;0;2
3396;Jurginėlis;Žibučių;7977676733;Ne;7;0;2;9
3397;Jurginėlis;Žibučių;7530846375;Ne;6;2;2;10
3398;Jurginėlis;Žibučių;3861311860;Ne;3;0;2;5
3399;Jurginėlis;Žibučių;1263601087;Ne;6;3;2;11
3400;Jurginėlis;Žibučių;5549766339;Ne;10;6;4;20
3401;Jurginėlis;Žibučių;4429780802;Ne;0;2;0;2
3402;Jurginėlis;Žibučių;8968718021;Ne;6;3;2;11
3403;Jurginėlis;Žibučių;2782553941;Ne;16;0;3;19
3404;Jurginėlis;Žibučių;6259461257;Ne;3;0;2;5
3405;Jurginėlis;Žibučių;7252041334;Ne;6;2;0;8
3406;Jurginėlis;Zuikučių;5958832413;Ne;0;2;0;2
3407;Jurginėlis;Zuikučių;4432849717;Ne;0;5;0;5
3408;Jurginėlis;Zuikučių;6587382160;Ne;5;0;2;7
3409;Jurginėlis;Zuikučių;8097652962;Ne;8;2;2;12
3410;Jurginėlis;Zuikučių;4763313715;Ne;8;0;3;11
3411;Jurginėlis;Zuikučių;6671759364;Ne;2;0;1;3
3412;Jurginėlis;Zuikučių;6197396872;Ne;2;0;2;4
3413;Jurginėlis;Zuikučių;8937404520;Ne;0;0;1;1
3414;Jurginėlis;Zuikučių;8823175066;Ne;5;1;5;11
3415;Jurginėlis;Zuikučių;8161347781;Ne;0;10;0;10
3416;Jurginėlis;Zuikučių;7283697595;Ne;0;0;3;3
3417;Jurginėlis;Zuikučių;4113264904;Ne;11;0;3;14
3418;Jurginėlis;Zuikučių;8117563141;Ne;0;0;5;5
3419;Jurginėlis;Zuikučių;5652597514;Ne;0;0;5;5
3420;Jurginėlis;Zuikučių;6341896288;Ne;3;0;4;7
3421;Jurginėlis;Zuikučių;3530906368;Ne;7;2;5;14
3422;Jurginėlis;Zuikučių;4292932046;Ne;1;0;0;1
3423;Jurginėlis;Viščiukų;1405338657;Ne;11;0;3;14
3424;Jurginėlis;Viščiukų;2211222679;Ne;4;6;2;12
3425;Jurginėlis;Viščiukų;9366610698;Ne;7;1;1;9
3426;Jurginėlis;Viščiukų;8050408300;Ne;9;0;4;13
3427;Jurginėlis;Viščiukų;2378007686;Ne;25;0;3;28
3428;Jurginėlis;Viščiukų;6657367395;Ne;0;2;1;3
3429;Jurginėlis;Viščiukų;8050843105;Taip;0;0;5;5
3430;Jurginėlis;Viščiukų;9556978001;Ne;11;13;4;28
3431;Jurginėlis;Viščiukų;6550401531;Taip;2;1;2;5
3432;Jurginėlis;Viščiukų;1449454050;Ne;13;0;6;19
3433;Jurginėlis;Viščiukų;9742427362;Ne;0;10;0;10
3434;Jurginėlis;Viščiukų;7684663210;Ne;14;0;2;16
3435;Jurginėlis;Viščiukų;6135184014;Ne;4;2;6;12
3436;Jurginėlis;Viščiukų;4515820114;Ne;0;5;0;5
3437;Jurginėlis;Meškiukų;6584048242;Ne;0;0;2;2
3438;Jurginėlis;Meškiukų;2652507538;Taip;10;0;4;14
3439;Jurginėlis;Meškiukų;4645348169;Ne;3;2;4;9
3440;Jurginėlis;Meškiukų;8348637578;Ne;4;0;4;8
3441;Jurginėlis;Meškiukų;2292944123;Ne;1;0;3;4
3442;Jurginėlis;Meškiukų;6266328957;Ne;3;2;2;7
3443;Jurginėlis;Meškiukų;7424513586;Ne;0;8;0;8
3444;Jurginėlis;Meškiukų;5945075337;Ne;0;0;1;1
3445;Jurginėlis;Meškiukų;5472986119;Ne;5;0;0;5
3446;Jurginėlis;Meškiukų;5105758563;Ne;11;0;4;15
3447;Jurginėlis;Meškiukų;7892411156;Ne;1;0;3;4
3448;Jurginėlis;Meškiukų;2967314352;Ne;3;2;2;7
3449;Jurginėlis;Meškiukų;7053226448;Ne;0;2;2;4
3450;Jurginėlis;Gandriukų;6306274502;Taip;2;0;2;4
3451;Jurginėlis;Gandriukų;9603380131;Ne;5;0;6;11
3452;Jurginėlis;Gandriukų;7193314762;Ne;3;0;2;5
3453;Jurginėlis;Gandriukų;4506484183;Ne;3;0;3;6
3454;Jurginėlis;Gandriukų;5474358669;Ne;22;0;0;22
3455;Jurginėlis;Gandriukų;2595002682;Ne;13;0;5;18
3456;Jurginėlis;Gandriukų;5866358319;Ne;3;1;2;6
3457;Jurginėlis;Gandriukų;1598578487;Ne;16;0;2;18
3458;Jurginėlis;Gandriukų;4644476606;Ne;7;0;3;10
3459;Jurginėlis;Gandriukų;3230200231;Ne;0;4;0;4
3460;Jurginėlis;Gandriukų;7636442845;Ne;13;0;2;15
3461;Jurginėlis;Gandriukų;1286603999;Ne;3;5;2;10
3462;Jurginėlis;Gandriukų;4617952912;Ne;3;2;3;8
3463;Jurginėlis;Gandriukų;3672557409;Ne;2;3;4;9
3464;Jurginėlis;Gandriukų;1043529560;Ne;7;2;4;13
3465;Jurginėlis;Gandriukų;1888949640;Ne;0;32;0;32
3466;Jurginėlis;Gandriukų;5688209539;Ne;2;0;0;2
3467;Jurginėlis;Gandriukų;2084877917;Ne;6;0;7;13
3468;Karuselė;PAGRANDUKAS;1621482372;Ne;0;9;0;9
3469;Karuselė;PAGRANDUKAS;3330374479;Ne;10;7;1;18
3470;Karuselė;PAGRANDUKAS;6183785840;Ne;0;7;0;7
3471;Karuselė;PAGRANDUKAS;9130534156;Ne;4;0;2;6
3472;Karuselė;PAGRANDUKAS;3660843696;Ne;0;0;2;2
3473;Karuselė;PAGRANDUKAS;5132581245;Ne;0;5;0;5
3474;Karuselė;PAGRANDUKAS;2412418335;Ne;3;2;2;7
3475;Karuselė;PAGRANDUKAS;7393434659;Ne;0;1;0;1
3476;Karuselė;PAGRANDUKAS;5695697634;Ne;0;3;0;3
3477;Karuselė;PAGRANDUKAS;6004882312;Ne;0;9;0;9
3478;Karuselė;PAGRANDUKAS;6856800484;Ne;0;2;0;2
3479;Karuselė;PAGRANDUKAS;3972815393;Ne;4;3;4;11
3480;Karuselė;PAGRANDUKAS;8157193503;Ne;3;5;2;10
3481;Karuselė;PAGRANDUKAS;9651192437;Ne;2;0;2;4
3482;Karuselė;PAGRANDUKAS;7916589127;Ne;0;3;0;3
3483;Karuselė;PAGRANDUKAS;7564618678;Ne;0;14;0;14
3484;Karuselė;PAGRANDUKAS;6546648346;Ne;0;8;0;8
3485;Karuselė;PAGRANDUKAS;8182071103;Ne;0;1;0;1
3486;Karuselė;NYKŠTUKAS;4966362343;Ne;8;1;4;13
3487;Karuselė;NYKŠTUKAS;9997776739;Ne;3;2;2;7
3488;Karuselė;NYKŠTUKAS;4445214427;Ne;0;10;0;10
3489;Karuselė;NYKŠTUKAS;5216815933;Ne;0;1;0;1
3490;Karuselė;NYKŠTUKAS;7817417459;Ne;13;2;3;18
3491;Karuselė;NYKŠTUKAS;9654804545;Ne;0;14;0;14
3492;Karuselė;NYKŠTUKAS;6581798125;Ne;0;1;0;1
3493;Karuselė;NYKŠTUKAS;1486577955;Ne;12;3;2;17
3494;Karuselė;NYKŠTUKAS;5697305819;Ne;1;5;2;8
3495;Karuselė;NYKŠTUKAS;8007341411;Ne;7;2;0;9
3496;Karuselė;NYKŠTUKAS;4363388969;Ne;10;0;2;12
3497;Karuselė;NYKŠTUKAS;4296509304;Ne;5;2;4;11
3498;Karuselė;NYKŠTUKAS;9243932017;Ne;0;4;3;7
3499;Karuselė;NYKŠTUKAS;5986973796;Ne;2;4;2;8
3500;Karuselė;NYKŠTUKAS;9999461542;Ne;13;3;2;18
3501;Karuselė;NYKŠTUKAS;9385698812;Ne;5;9;1;15
3502;Karuselė;NYKŠTUKAS;4868770355;Ne;5;0;2;7
3503;Karuselė;NYKŠTUKAS;1084415930;Ne;0;1;0;1
3504;Karuselė;NYKŠTUKAS;9071878406;Ne;0;1;0;1
3505;Karuselė;NYKŠTUKAS;1078396181;Ne;8;3;2;13
3506;Karuselė;BITUTĖ;8175498192;Ne;0;4;0;4
3507;Karuselė;BITUTĖ;5951045233;Ne;2;4;2;8
3508;Karuselė;BITUTĖ;7977133699;Ne;3;2;2;7
3509;Karuselė;BITUTĖ;6165548450;Ne;0;5;0;5
3510;Karuselė;BITUTĖ;4435125556;Ne;0;3;0;3
3511;Karuselė;BITUTĖ;3049506194;Ne;0;9;0;9
3512;Karuselė;BITUTĖ;7733032142;Ne;0;3;0;3
3513;Karuselė;BITUTĖ;1412890120;Ne;0;3;0;3
3514;Karuselė;BITUTĖ;5135054911;Ne;0;3;0;3
3515;Karuselė;BITUTĖ;4130693235;Ne;4;3;4;11
3516;Karuselė;BITUTĖ;8012963667;Ne;0;2;0;2
3517;Karuselė;BITUTĖ;9340167973;Ne;4;4;0;8
3518;Karuselė;BITUTĖ;6826455161;Ne;0;4;3;7
3519;Karuselė;BITUTĖ;3661917922;Ne;0;1;0;1
3520;Karuselė;BITUTĖ;2727440190;Ne;0;2;0;2
3521;Karuselė;BITUTĖ;2306922755;Ne;5;4;1;10
3522;Karuselė;BITUTĖ;6062361348;Ne;0;3;0;3
3523;Karuselė;BITUTĖ;9996567374;Ne;0;2;0;2
3524;Karuselė;BITUTĖ;2529641529;Ne;0;4;0;4
3525;Karuselė;BITUTĖ;4262640017;Ne;0;2;0;2
3526;Karuselė;BITUTĖ;6495631086;Ne;0;3;0;3
3527;Karuselė;BITUTĖ;8406462155;Ne;10;2;2;14
3528;Karuselė;BITUTĖ;2247913568;Ne;0;3;0;3
3529;Karuselė;BORUŽĖLĖ;7030946179;Ne;4;0;7;11
3530;Karuselė;BORUŽĖLĖ;6283563118;Ne;4;0;2;6
3531;Karuselė;BORUŽĖLĖ;9303194274;Ne;8;5;2;15
3532;Karuselė;BORUŽĖLĖ;7817670288;Ne;7;0;2;9
3533;Karuselė;BORUŽĖLĖ;7986277964;Ne;7;0;2;9
3534;Karuselė;BORUŽĖLĖ;5397256562;Ne;8;1;2;11
3535;Karuselė;BORUŽĖLĖ;8004953571;Ne;1;4;2;7
3536;Karuselė;BORUŽĖLĖ;8357973162;Ne;7;1;0;8
3537;Karuselė;BORUŽĖLĖ;8689140295;Ne;4;1;2;7
3538;Karuselė;BORUŽĖLĖ;7430518094;Ne;2;6;2;10
3539;Karuselė;BORUŽĖLĖ;9995800164;Ne;10;0;2;12
3540;Karuselė;BORUŽĖLĖ;8664628232;Ne;9;0;4;13
3541;Karuselė;BORUŽĖLĖ;8234778310;Ne;5;0;4;9
3542;Karuselė;BORUŽĖLĖ;7869324652;Ne;6;0;3;9
3543;Karuselė;BORUŽĖLĖ;5519366758;Ne;4;0;4;8
3544;Karuselė;BORUŽĖLĖ;6669293437;Ne;5;0;2;7
3545;Karuselė;BORUŽĖLĖ;1004895817;Ne;10;1;2;13
3546;Karuselė;UOGELĖ;1119373532;Ne;19;1;1;21
3547;Karuselė;UOGELĖ;2135332292;Ne;5;9;2;16
3548;Karuselė;UOGELĖ;8441520423;Ne;7;0;5;12
3549;Karuselė;UOGELĖ;9463553056;Ne;0;18;0;18
3550;Karuselė;UOGELĖ;8671884362;Ne;5;0;2;7
3551;Karuselė;UOGELĖ;4871960780;Ne;5;0;1;6
3552;Karuselė;UOGELĖ;3551143062;Ne;5;3;4;12
3553;Karuselė;UOGELĖ;8257771271;Ne;0;21;0;21
3554;Karuselė;UOGELĖ;7749015193;Ne;0;22;0;22
3555;Karuselė;UOGELĖ;2993499990;Ne;7;5;2;14
3556;Karuselė;UOGELĖ;3075592618;Ne;11;0;4;15
3557;Karuselė;UOGELĖ;2450390957;Ne;0;16;0;16
3558;Karuselė;UOGELĖ;7535451590;Ne;10;9;1;20
3559;Karuselė;UOGELĖ;4302662341;Ne;0;25;0;25
3560;Karuselė;UOGELĖ;4865727149;Ne;8;2;2;12
3561;Karuselė;UOGELĖ;8952114853;Ne;0;17;0;17
3562;Karuselė;UOGELĖ;9649615834;Ne;11;0;2;13
3563;Karuselė;UOGELĖ;3885475525;Ne;0;10;0;10
3564;Karuselė;UOGELĖ;6562490670;Ne;17;2;1;20
3565;Karuselė;UOGELĖ;4799230363;Ne;23;0;2;25
3566;Karuselė;GINTARĖLIS;3773170060;Ne;3;2;2;7
3567;Karuselė;GINTARĖLIS;3904453423;Ne;0;3;1;4
3568;Karuselė;GINTARĖLIS;7489136297;Ne;3;1;2;6
3569;Karuselė;GINTARĖLIS;3534074990;Ne;0;2;0;2
3570;Karuselė;GINTARĖLIS;7540323186;Ne;5;2;2;9
3571;Karuselė;GINTARĖLIS;8481143199;Ne;11;2;3;16
3572;Karuselė;GINTARĖLIS;3157893936;Ne;0;1;0;1
3573;Karuselė;GINTARĖLIS;8409412605;Ne;8;2;4;14
3574;Karuselė;GINTARĖLIS;7599328323;Ne;5;2;2;9
3575;Karuselė;GINTARĖLIS;2688863117;Ne;3;2;2;7
3576;Karuselė;GINTARĖLIS;7439791054;Ne;3;2;6;11
3577;Karuselė;GINTARĖLIS;3696384277;Ne;0;3;0;3
3578;Karuselė;GINTARĖLIS;2945027875;Ne;0;21;0;21
3579;Karuselė;GINTARĖLIS;8855096080;Ne;2;0;2;4
3580;Karuselė;GINTARĖLIS;9116238924;Ne;0;2;1;3
3581;Karuselė;GINTARĖLIS;6433987745;Ne;6;2;5;13
3582;Karuselė;GINTARĖLIS;9763326660;Ne;0;3;3;6
3583;Karuselė;GINTARĖLIS;9479962436;Taip;0;2;0;2
3584;Karuselė;GINTARĖLIS;6232570825;Ne;0;0;2;2
3585;Karuselė;GINTARĖLIS;3471091687;Ne;0;4;2;6
3586;Karuselė;GINTARĖLIS;4103816990;Ne;2;0;3;5
3587;Karuselė;GINTARĖLIS;4325959483;Ne;6;1;2;9
3588;Karuselė;GINTARĖLIS;6785226197;Ne;0;0;6;6
3589;Karuselė;SAULUTĖ;5627583683;Ne;6;2;2;10
3590;Karuselė;SAULUTĖ;2242659064;Ne;0;12;0;12
3591;Karuselė;SAULUTĖ;5704218177;Ne;1;4;3;8
3592;Karuselė;SAULUTĖ;5146709341;Ne;3;2;1;6
3593;Karuselė;SAULUTĖ;7814525717;Ne;3;3;2;8
3594;Karuselė;SAULUTĖ;8331985564;Ne;0;3;0;3
3595;Karuselė;SAULUTĖ;9400171357;Ne;3;0;2;5
3596;Karuselė;SAULUTĖ;9656723409;Ne;6;1;2;9
3597;Karuselė;SAULUTĖ;5766390337;Ne;0;3;0;3
3598;Karuselė;SAULUTĖ;4879654321;Ne;1;3;0;4
3599;Karuselė;SAULUTĖ;5803808409;Ne;0;8;0;8
3600;Karuselė;SAULUTĖ;2269840705;Ne;3;0;2;5
3601;Karuselė;SAULUTĖ;3149575456;Ne;7;3;2;12
3602;Karuselė;SAULUTĖ;5640656442;Ne;12;2;1;15
3603;Karuselė;SAULUTĖ;9451789237;Ne;2;2;2;6
3604;Karuselė;SAULUTĖ;9450841251;Ne;4;1;2;7
3605;Karuselė;SAULUTĖ;8830559511;Ne;5;2;5;12
3606;Karuselė;SAULUTĖ;3228100488;Ne;3;1;2;6
3607;Karuselė;SAULUTĖ;5830080035;Ne;4;2;3;9
3608;Karuselė;SAULUTĖ;9985033530;Ne;0;4;2;6
3609;Karuselė;SAULUTĖ;4211688032;Ne;3;2;0;5
3610;Karuselė;SAULUTĖ;5802996641;Ne;0;13;0;13
3611;Karuselė;SAULUTĖ;7501323454;Ne;1;4;3;8
3612;Karuselė;TIGRIUKAS;9561892809;Taip;6;3;2;11
3613;Karuselė;TIGRIUKAS;9726299722;Ne;0;4;0;4
3614;Karuselė;TIGRIUKAS;1576201225;Ne;7;1;2;10
3615;Karuselė;TIGRIUKAS;9344514262;Ne;2;2;0;4
3616;Karuselė;TIGRIUKAS;7131255599;Ne;13;1;2;16
3617;Karuselė;TIGRIUKAS;4180604225;Ne;13;1;2;16
3618;Karuselė;TIGRIUKAS;2397938004;Ne;5;2;1;8
3619;Karuselė;TIGRIUKAS;3605966015;Ne;7;2;2;11
3620;Karuselė;TIGRIUKAS;9633656827;Ne;0;1;0;1
3621;Karuselė;TIGRIUKAS;9252093125;Ne;17;0;1;18
3622;Karuselė;TIGRIUKAS;5176597751;Ne;0;2;0;2
3623;Karuselė;TIGRIUKAS;6656808100;Ne;0;4;0;4
3624;Karuselė;TIGRIUKAS;8474027736;Ne;0;7;0;7
3625;Karuselė;TIGRIUKAS;2549599594;Ne;13;0;4;17
3626;Karuselė;TIGRIUKAS;9394220081;Ne;3;4;2;9
3627;Karuselė;TIGRIUKAS;7618984957;Ne;7;1;2;10
3628;Karuselė;TIGRIUKAS;6678283260;Ne;8;0;4;12
3629;Karuselė;TIGRIUKAS;9736020767;Ne;2;0;2;4
3630;Karuselė;TIGRIUKAS;5964942317;Ne;3;12;0;15
3631;Karuselė;VAIVORYKŠTĖ;1289442716;Ne;1;0;3;4
3632;Karuselė;VAIVORYKŠTĖ;9855242602;Ne;0;7;0;7
3633;Karuselė;VAIVORYKŠTĖ;8063412271;Ne;10;7;1;18
3634;Karuselė;VAIVORYKŠTĖ;3514315636;Ne;0;1;0;1
3635;Karuselė;VAIVORYKŠTĖ;8085919723;Ne;0;1;0;1
3636;Karuselė;VAIVORYKŠTĖ;1581504806;Ne;2;0;0;2
3637;Karuselė;VAIVORYKŠTĖ;6424622497;Ne;0;2;0;2
3638;Karuselė;VAIVORYKŠTĖ;5855430678;Ne;2;0;0;2
3639;Karuselė;VAIVORYKŠTĖ;5128774216;Ne;0;8;0;8
3640;Karuselė;VAIVORYKŠTĖ;2757263085;Ne;0;2;0;2
3641;Karuselė;VAIVORYKŠTĖ;4110024673;Ne;0;4;2;6
3642;Karuselė;VAIVORYKŠTĖ;9400856559;Ne;0;4;0;4
3643;Karuselė;VAIVORYKŠTĖ;1083786182;Ne;0;4;0;4
3644;Karuselė;VAIVORYKŠTĖ;5998868204;Ne;0;2;0;2
3645;Karuselė;VAIVORYKŠTĖ;6734936247;Ne;3;2;2;7
3646;Karuselė;VAIVORYKŠTĖ;3082636224;Ne;0;2;3;5
3647;Karuselė;VAIVORYKŠTĖ;4749086136;Ne;2;1;3;6
3648;Karuselė;VAIVORYKŠTĖ;8371081106;Ne;3;8;0;11
3649;Karuselė;"AUKSINĖ ŽUVELĖ";1344025242;Ne;23;0;2;25
3650;Karuselė;"AUKSINĖ ŽUVELĖ";6048980111;Ne;12;0;2;14
3651;Karuselė;"AUKSINĖ ŽUVELĖ";9535490329;Ne;16;0;2;18
3652;Karuselė;"AUKSINĖ ŽUVELĖ";5313839511;Ne;24;0;2;26
3653;Karuselė;"AUKSINĖ ŽUVELĖ";8074453862;Ne;8;4;2;14
3654;Karuselė;"AUKSINĖ ŽUVELĖ";5912561598;Ne;14;3;1;18
3655;Karuselė;"AUKSINĖ ŽUVELĖ";3728662112;Ne;18;2;2;22
3656;Karuselė;"AUKSINĖ ŽUVELĖ";9170947196;Ne;13;2;2;17
3657;Karuselė;"AUKSINĖ ŽUVELĖ";9814977329;Ne;7;0;2;9
3658;Karuselė;"AUKSINĖ ŽUVELĖ";4982029137;Ne;16;0;2;18
3659;Karuselė;"AUKSINĖ ŽUVELĖ";3408146969;Ne;19;4;2;25
3660;Karuselė;"AUKSINĖ ŽUVELĖ";3464711958;Ne;0;32;0;32
3661;Karuselė;"AUKSINĖ ŽUVELĖ";1044597936;Ne;6;6;2;14
3662;Karuselė;"AUKSINĖ ŽUVELĖ";6932524178;Ne;9;0;2;11
3663;Karuselė;RAMUNĖ;6319361312;Ne;3;0;5;8
3664;Karuselė;RAMUNĖ;5666333470;Ne;0;2;0;2
3665;Karuselė;RAMUNĖ;6370060620;Ne;0;0;2;2
3666;Karuselė;RAMUNĖ;6844148347;Ne;1;2;2;5
3667;Karuselė;RAMUNĖ;7250708607;Taip;3;5;2;10
3668;Karuselė;RAMUNĖ;3890681011;Ne;9;0;2;11
3669;Karuselė;RAMUNĖ;6469579272;Ne;22;0;0;22
3670;Karuselė;RAMUNĖ;4707292159;Ne;2;1;2;5
3671;Karuselė;RAMUNĖ;5926712250;Ne;13;0;2;15
3672;Karuselė;RAMUNĖ;1427836663;Taip;1;0;4;5
3673;Karuselė;RAMUNĖ;3008219926;Ne;3;2;2;7
3674;Karuselė;RAMUNĖ;5736966465;Ne;3;0;4;7
3675;Karuselė;RAMUNĖ;9789687336;Ne;7;1;5;13
3676;Karuselė;RAMUNĖ;2843226066;Ne;5;0;7;12
3677;Karuselė;RAMUNĖ;3276397300;Ne;11;7;2;20
3678;Karuselė;VILKELIS;7721986618;Ne;0;2;0;2
3679;Karuselė;VILKELIS;6300348828;Ne;0;2;0;2
3680;Karuselė;VILKELIS;3485160781;Ne;12;0;0;12
3681;Karuselė;VILKELIS;2500977616;Ne;5;11;2;18
3682;Karuselė;VILKELIS;8238334389;Ne;4;0;2;6
3683;Karuselė;VILKELIS;5036757881;Ne;8;4;2;14
3684;Karuselė;VILKELIS;7794320463;Ne;14;1;2;17
3685;Karuselė;VILKELIS;7052993128;Ne;22;0;0;22
3686;Karuselė;VILKELIS;7480485777;Ne;7;0;1;8
3687;Karuselė;VILKELIS;6341570221;Ne;3;2;3;8
3688;Karuselė;VILKELIS;3622914118;Ne;0;3;0;3
3689;Karuselė;VILKELIS;4566201460;Ne;7;0;4;11
3690;Karuselė;VILKELIS;8848085495;Ne;12;2;2;16
3691;Karuselė;VILKELIS;8362740639;Ne;12;2;0;14
3692;Karuselė;VILKELIS;2842034472;Ne;0;2;1;3
3693;Karuselė;VILKELIS;8531556390;Ne;0;3;0;3
3694;Karuselė;VILKELIS;4757820179;Ne;2;2;2;6
3695;Karuselė;VILKELIS;9415377698;Ne;0;2;0;2
3696;Karuselė;VILKELIS;2260731421;Ne;0;1;0;1
3697;Karuselė;VILKELIS;4196250786;Ne;2;3;0;5
3698;Karuselė;VILKELIS;3460470459;Ne;0;3;0;3
3699;Kaštonas;NYKŠTUKAI;8145965849;Ne;0;2;0;2
3700;Kaštonas;NYKŠTUKAI;2178971789;Ne;5;2;0;7
3701;Kaštonas;NYKŠTUKAI;2361839733;Ne;0;2;0;2
3702;Kaštonas;NYKŠTUKAI;4782280933;Ne;9;0;0;9
3703;Kaštonas;NYKŠTUKAI;1258105498;Ne;0;1;0;1
3704;Kaštonas;NYKŠTUKAI;8766848385;Ne;3;0;0;3
3705;Kaštonas;NYKŠTUKAI;3251132542;Ne;0;2;0;2
3706;Kaštonas;NYKŠTUKAI;1501441973;Ne;0;2;0;2
3707;Kaštonas;NYKŠTUKAI;5948707303;Ne;0;4;0;4
3708;Kaštonas;NYKŠTUKAI;1027896631;Ne;0;3;0;3
3709;Kaštonas;NYKŠTUKAI;4854158033;Ne;2;4;0;6
3710;Kaštonas;NYKŠTUKAI;8158855458;Ne;10;7;0;17
3711;Kaštonas;NYKŠTUKAI;4353473162;Ne;0;1;0;1
3712;Kaštonas;NYKŠTUKAI;3456815576;Ne;3;10;0;13
3713;Kaštonas;NYKŠTUKAI;5350239917;Ne;8;2;0;10
3714;Kaštonas;NYKŠTUKAI;6515739350;Ne;3;2;0;5
3715;Kaštonas;NYKŠTUKAI;2281935638;Ne;3;2;0;5
3716;Kaštonas;DRUGELIAI;8486955652;Ne;4;3;0;7
3717;Kaštonas;DRUGELIAI;2106924435;Ne;6;2;0;8
3718;Kaštonas;DRUGELIAI;8483888152;Ne;7;2;0;9
3719;Kaštonas;DRUGELIAI;7408901858;Ne;4;7;0;11
3720;Kaštonas;DRUGELIAI;2832688622;Ne;3;4;0;7
3721;Kaštonas;DRUGELIAI;9061158412;Ne;0;10;0;10
3722;Kaštonas;DRUGELIAI;5884427036;Ne;6;3;0;9
3723;Kaštonas;DRUGELIAI;1141693073;Ne;4;0;0;4
3724;Kaštonas;DRUGELIAI;6251564828;Ne;4;2;0;6
3725;Kaštonas;DRUGELIAI;5969052108;Ne;2;2;0;4
3726;Kaštonas;DRUGELIAI;8166925991;Ne;0;4;0;4
3727;Kaštonas;DRUGELIAI;4215759647;Ne;0;11;0;11
3728;Kaštonas;DRUGELIAI;5307755844;Ne;0;1;0;1
3729;Kaštonas;DRUGELIAI;8257643251;Ne;8;3;0;11
3730;Kaštonas;DRUGELIAI;4384907654;Ne;4;5;0;9
3731;Kaštonas;DRUGELIAI;1976138680;Ne;7;0;0;7
3732;Kaštonas;DRUGELIAI;7992154554;Ne;0;3;0;3
3733;Kaštonas;DRUGELIAI;7698074598;Ne;6;4;0;10
3734;Kaštonas;DRUGELIAI;1862173525;Ne;0;1;0;1
3735;Kaštonas;KIŠKUČIAI;4552007726;Ne;7;2;0;9
3736;Kaštonas;KIŠKUČIAI;2020612346;Ne;0;16;0;16
3737;Kaštonas;KIŠKUČIAI;6585977073;Ne;13;0;0;13
3738;Kaštonas;KIŠKUČIAI;7383219978;Ne;9;11;0;20
3739;Kaštonas;KIŠKUČIAI;4641535612;Ne;3;11;0;14
3740;Kaštonas;KIŠKUČIAI;4708114402;Ne;5;0;0;5
3741;Kaštonas;KIŠKUČIAI;2057499534;Ne;16;0;0;16
3742;Kaštonas;KIŠKUČIAI;6749679348;Ne;5;2;0;7
3743;Kaštonas;KIŠKUČIAI;3860613494;Ne;0;3;0;3
3744;Kaštonas;KIŠKUČIAI;9778140363;Ne;20;0;0;20
3745;Kaštonas;KIŠKUČIAI;7290414209;Ne;4;14;0;18
3746;Kaštonas;KIŠKUČIAI;9356018629;Ne;0;3;2;5
3747;Kaštonas;KIŠKUČIAI;9320223622;Ne;0;9;0;9
3748;Kaštonas;KIŠKUČIAI;4095137806;Ne;7;4;0;11
3749;Kaštonas;KIŠKUČIAI;6425908247;Ne;8;0;0;8
3750;Kaštonas;KIŠKUČIAI;2874873326;Ne;13;2;0;15
3751;Kaštonas;KIŠKUČIAI;6934262510;Ne;0;9;0;9
3752;Kaštonas;KIŠKUČIAI;9034859988;Ne;5;1;0;6
3753;Kaštonas;KIŠKUČIAI;9249007247;Ne;10;2;0;12
3754;Kaštonas;KIŠKUČIAI;2218450479;Ne;10;3;0;13
3755;Kaštonas;BITUTĖS;1207372235;Ne;10;2;0;12
3756;Kaštonas;BITUTĖS;9298372326;Ne;0;3;0;3
3757;Kaštonas;BITUTĖS;4115242811;Ne;12;0;0;12
3758;Kaštonas;BITUTĖS;6896372095;Ne;8;2;0;10
3759;Kaštonas;BITUTĖS;4020980625;Ne;7;0;0;7
3760;Kaštonas;BITUTĖS;1684641447;Ne;17;2;0;19
3761;Kaštonas;BITUTĖS;1761520786;Ne;5;0;0;5
3762;Kaštonas;BITUTĖS;8250964197;Ne;1;14;0;15
3763;Kaštonas;BITUTĖS;7946379086;Ne;2;0;0;2
3764;Kaštonas;BITUTĖS;9285927858;Ne;0;15;0;15
3765;Kaštonas;BITUTĖS;9903176616;Ne;0;4;0;4
3766;Kaštonas;BITUTĖS;8275673303;Ne;4;2;0;6
3767;Kaštonas;BITUTĖS;1614180834;Ne;5;2;0;7
3768;Kaštonas;BITUTĖS;2877124424;Ne;0;6;0;6
3769;Kaštonas;BITUTĖS;1031628633;Ne;0;1;0;1
3770;Kaštonas;BITUTĖS;4551111709;Ne;0;1;0;1
3771;Kaštonas;BITUTĖS;7291448857;Ne;3;2;0;5
3772;Kaštonas;BITUTĖS;4837002666;Taip;17;0;0;17
3773;Kaštonas;BITUTĖS;6175014441;Ne;2;3;0;5
3774;Kaštonas;BITUTĖS;1748975865;Ne;0;13;0;13
3775;Kaštonas;BITUTĖS;8151333699;Ne;7;2;0;9
3776;Kaštonas;MEŠKIUKAI;2228759708;Ne;1;2;0;3
3777;Kaštonas;MEŠKIUKAI;6613837801;Ne;0;8;0;8
3778;Kaštonas;MEŠKIUKAI;6263544162;Ne;0;5;0;5
3779;Kaštonas;MEŠKIUKAI;8775608339;Ne;0;3;0;3
3780;Kaštonas;MEŠKIUKAI;6289073634;Ne;6;5;0;11
3781;Kaštonas;MEŠKIUKAI;4616084852;Ne;5;2;0;7
3782;Kaštonas;MEŠKIUKAI;5157500600;Ne;0;2;0;2
3783;Kaštonas;MEŠKIUKAI;6967725663;Ne;5;2;0;7
3784;Kaštonas;MEŠKIUKAI;4308169582;Ne;1;4;1;6
3785;Kaštonas;MEŠKIUKAI;6589898580;Ne;3;8;0;11
3786;Kaštonas;MEŠKIUKAI;4824511567;Ne;0;2;0;2
3787;Kaštonas;MEŠKIUKAI;3961661158;Ne;0;2;0;2
3788;Kaštonas;MEŠKIUKAI;8318869054;Ne;5;2;0;7
3789;Kaštonas;MEŠKIUKAI;2434765663;Ne;0;2;0;2
3790;Kaštonas;MEŠKIUKAI;8867446698;Ne;3;2;0;5
3791;Kaštonas;MEŠKIUKAI;4444087861;Ne;3;2;1;6
3792;Kaštonas;MEŠKIUKAI;9379171183;Ne;0;2;3;5
3793;Kaštonas;MEŠKIUKAI;6254250706;Ne;0;5;0;5
3794;Kaštonas;MEŠKIUKAI;1262404954;Ne;0;5;0;5
3795;Kaštonas;MEŠKIUKAI;9014726465;Ne;10;2;0;12
3796;Kaštonas;MEŠKIUKAI;2165890763;Ne;4;1;0;5
3797;Kaštonas;MEŠKIUKAI;3383390078;Ne;6;4;0;10
3798;Kaštonas;BORUŽĖLĖS;8637978949;Ne;0;22;0;22
3799;Kaštonas;BORUŽĖLĖS;6891429484;Ne;9;0;0;9
3800;Kaštonas;BORUŽĖLĖS;6442448667;Ne;0;2;0;2
3801;Kaštonas;BORUŽĖLĖS;2345742465;Ne;2;1;0;3
3802;Kaštonas;BORUŽĖLĖS;5060824071;Ne;0;5;0;5
3803;Kaštonas;BORUŽĖLĖS;7141682810;Ne;0;6;0;6
3804;Kaštonas;BORUŽĖLĖS;3279850526;Ne;7;0;0;7
3805;Kaštonas;BORUŽĖLĖS;3944883841;Ne;3;0;0;3
3806;Kaštonas;BORUŽĖLĖS;4285107537;Ne;19;0;0;19
3807;Kaštonas;BORUŽĖLĖS;3153834010;Ne;19;0;0;19
3808;Kaštonas;BORUŽĖLĖS;8820616057;Ne;5;5;0;10
3809;Kaštonas;BORUŽĖLĖS;3839816548;Ne;15;3;0;18
3810;Kaštonas;BORUŽĖLĖS;5329898590;Ne;11;0;0;11
3811;Kaštonas;BORUŽĖLĖS;2356291627;Ne;0;2;0;2
3812;Kaštonas;BORUŽĖLĖS;5158983059;Ne;3;1;0;4
3813;"Krivūlė (Lydos g. 5)";SPINDULIUKAI;3913058095;Ne;0;0;3;3
3814;"Krivūlė (Lydos g. 5)";SPINDULIUKAI;1840809151;Ne;0;2;0;2
3815;"Krivūlė (Lydos g. 5)";SPINDULIUKAI;7335245963;Ne;0;2;0;2
3816;"Krivūlė (Lydos g. 5)";SPINDULIUKAI;5802739148;Ne;0;9;0;9
3817;"Krivūlė (Lydos g. 5)";SPINDULIUKAI;5667934115;Ne;0;2;1;3
3818;"Krivūlė (Lydos g. 5)";SPINDULIUKAI;8348288864;Ne;0;2;1;3
3819;"Krivūlė (Lydos g. 5)";SPINDULIUKAI;7155162698;Ne;1;2;2;5
3820;"Krivūlė (Lydos g. 5)";SPINDULIUKAI;1151179495;Ne;0;2;0;2
3821;"Krivūlė (Lydos g. 5)";SPINDULIUKAI;9320613086;Ne;2;0;6;8
3822;"Krivūlė (Lydos g. 5)";SPINDULIUKAI;4750075323;Ne;5;0;2;7
3823;"Krivūlė (Lydos g. 5)";SPINDULIUKAI;3852793979;Ne;0;9;0;9
3824;"Krivūlė (Lydos g. 5)";SPINDULIUKAI;3184820008;Ne;0;0;11;11
3825;"Krivūlė (Lydos g. 5)";SPINDULIUKAI;7149268223;Ne;0;0;5;5
3826;"Krivūlė (Lydos g. 5)";SPINDULIUKAI;7025398689;Ne;0;0;2;2
3827;"Krivūlė (Lydos g. 5)";SPINDULIUKAI;7615253880;Ne;0;0;5;5
3828;"Krivūlė (Lydos g. 5)";SPINDULIUKAI;4943482123;Ne;4;0;3;7
3829;"Krivūlė (Lydos g. 5)";SPINDULIUKAI;9815421737;Ne;5;0;6;11
3830;"Krivūlė (Lydos g. 5)";SPINDULIUKAI;4619224314;Ne;0;22;0;22
3831;"Krivūlė (Lydos g. 5)";SPINDULIUKAI;3999214263;Ne;0;0;7;7
3832;"Krivūlė (Lydos g. 5)";BORUŽĖLĖS;3357889614;Ne;2;0;0;2
3833;"Krivūlė (Lydos g. 5)";BORUŽĖLĖS;8711082048;Ne;0;0;6;6
3834;"Krivūlė (Lydos g. 5)";BORUŽĖLĖS;2915437387;Ne;0;5;3;8
3835;"Krivūlė (Lydos g. 5)";BORUŽĖLĖS;8304613793;Ne;5;0;3;8
3836;"Krivūlė (Lydos g. 5)";BORUŽĖLĖS;9030517214;Ne;0;0;2;2
3837;"Krivūlė (Lydos g. 5)";BORUŽĖLĖS;7102769750;Ne;0;2;0;2
3838;"Krivūlė (Lydos g. 5)";BORUŽĖLĖS;6854278025;Ne;5;1;2;8
3839;"Krivūlė (Lydos g. 5)";BORUŽĖLĖS;4944001828;Ne;0;0;2;2
3840;"Krivūlė (Lydos g. 5)";BORUŽĖLĖS;2240949291;Ne;0;0;11;11
3841;"Krivūlė (Lydos g. 5)";BORUŽĖLĖS;9732635621;Ne;0;0;1;1
3842;"Krivūlė (Lydos g. 5)";BORUŽĖLĖS;3368847042;Ne;10;0;5;15
3843;"Krivūlė (Lydos g. 5)";BORUŽĖLĖS;3230340284;Ne;0;0;2;2
3844;"Krivūlė (Lydos g. 5)";BORUŽĖLĖS;6283777399;Ne;0;2;5;7
3845;"Krivūlė (Lydos g. 5)";BORUŽĖLĖS;4454327278;Ne;6;2;7;15
3846;"Krivūlė (Lydos g. 5)";DRUGELIŲ;6004925249;Ne;0;2;0;2
3847;"Krivūlė (Lydos g. 5)";DRUGELIŲ;2654066358;Ne;1;0;2;3
3848;"Krivūlė (Lydos g. 5)";DRUGELIŲ;5113297248;Ne;0;2;2;4
3849;"Krivūlė (Lydos g. 5)";DRUGELIŲ;9306686488;Ne;0;2;1;3
3850;"Krivūlė (Lydos g. 5)";DRUGELIŲ;5596874303;Ne;4;2;7;13
3851;"Krivūlė (Lydos g. 5)";DRUGELIŲ;4297876008;Ne;5;0;2;7
3852;"Krivūlė (Lydos g. 5)";DRUGELIŲ;2138125571;Ne;0;2;4;6
3853;"Krivūlė (Lydos g. 5)";DRUGELIŲ;2711010212;Ne;0;4;1;5
3854;"Krivūlė (Lydos g. 5)";DRUGELIŲ;7781918674;Ne;0;4;1;5
3855;"Krivūlė (Lydos g. 5)";DRUGELIŲ;3246787504;Ne;1;0;4;5
3856;"Krivūlė (Lydos g. 5)";DRUGELIŲ;3605506478;Ne;0;8;3;11
3857;"Krivūlė (Lydos g. 5)";DRUGELIŲ;4896656209;Ne;0;8;3;11
3858;"Krivūlė (Lydos g. 5)";DRUGELIŲ;5531566792;Ne;0;0;3;3
3859;"Krivūlė (Lydos g. 5)";DRUGELIŲ;1171226193;Ne;0;0;9;9
3860;"Krivūlė (Lydos g. 5)";DRUGELIŲ;5683183310;Ne;3;0;4;7
3861;"Krivūlė (Lydos g. 5)";DRUGELIŲ;1815336153;Ne;0;2;0;2
3862;"Krivūlė (Lydos g. 5)";DRUGELIŲ;6832582194;Ne;0;0;6;6
3863;"Krivūlė (Lydos g. 5)";DRUGELIŲ;3350866777;Ne;0;0;4;4
3864;"Krivūlė (Lydos g. 5)";"BITUTĖS (VALDOFRO)";3769812444;Ne;0;5;0;5
3865;"Krivūlė (Lydos g. 5)";"BITUTĖS (VALDOFRO)";5128760019;Ne;0;5;0;5
3866;"Krivūlė (Lydos g. 5)";"BITUTĖS (VALDOFRO)";2647149927;Ne;0;2;0;2
3867;"Krivūlė (Lydos g. 5)";"BITUTĖS (VALDOFRO)";9632352765;Ne;0;2;0;2
3868;"Krivūlė (Lydos g. 5)";"BITUTĖS (VALDOFRO)";8834855616;Ne;0;4;3;7
3869;"Krivūlė (Lydos g. 5)";"BITUTĖS (VALDOFRO)";3655576855;Ne;0;0;3;3
3870;"Krivūlė (Lydos g. 5)";"BITUTĖS (VALDOFRO)";1561180871;Ne;0;9;0;9
3871;"Krivūlė (Lydos g. 5)";"BITUTĖS (VALDOFRO)";9702372816;Ne;0;0;5;5
3872;"Krivūlė (Lydos g. 5)";"BITUTĖS (VALDOFRO)";8105688948;Ne;0;2;6;8
3873;"Krivūlė (Lydos g. 5)";"BITUTĖS (VALDOFRO)";1932209134;Ne;0;0;6;6
3874;"Krivūlė (Lydos g. 5)";"BITUTĖS (VALDOFRO)";7768827505;Ne;3;0;2;5
3875;"Krivūlė (Lydos g. 5)";"BITUTĖS (VALDOFRO)";7199431924;Ne;3;2;2;7
3876;"Krivūlė (Lydos g. 5)";"BITUTĖS (VALDOFRO)";7714519095;Ne;0;0;7;7
3877;"Krivūlė (Lydos g. 5)";"BITUTĖS (VALDOFRO)";9409899522;Ne;0;0;3;3
3878;"Krivūlė (Lydos g. 5)";"BITUTĖS (VALDOFRO)";6365743037;Ne;0;2;1;3
3879;"Krivūlė (Lydos g. 5)";"BITUTĖS (VALDOFRO)";8748668583;Ne;0;0;5;5
3880;"Krivūlė (Lydos g. 5)";"BITUTĖS (VALDOFRO)";6830712749;Ne;2;0;5;7
3881;"Krivūlė (Lydos g. 5)";"BITUTĖS (VALDOFRO)";5600651110;Ne;1;2;6;9
3882;"Krivūlė (Lydos g. 5)";"BITUTĖS (VALDOFRO)";8352493729;Ne;0;0;5;5
3883;"Krivūlė (Lydos g. 5)";"BITUTĖS (VALDOFRO)";9229817861;Ne;0;0;6;6
3884;"Krivūlė (Lydos g. 5)";"BITUTĖS (VALDOFRO)";1220698436;Ne;0;0;7;7
3885;"Krivūlė (Lydos g. 5)";"BITUTĖS (VALDOFRO)";9388352593;Ne;1;0;5;6
3886;"Krivūlė (Lydos g. 5)";"BITUTĖS (VALDOFRO)";4699320250;Ne;0;0;6;6
3887;"Krivūlė (Lydos g. 5)";EŽIUKAI;8042185027;Ne;0;0;9;9
3888;"Krivūlė (Lydos g. 5)";EŽIUKAI;3616024832;Ne;0;2;1;3
3889;"Krivūlė (Lydos g. 5)";EŽIUKAI;7242596817;Ne;0;7;0;7
3890;"Krivūlė (Lydos g. 5)";EŽIUKAI;5369083173;Ne;0;0;3;3
3891;"Krivūlė (Lydos g. 5)";EŽIUKAI;9051038248;Ne;6;0;11;17
3892;"Krivūlė (Lydos g. 5)";EŽIUKAI;3144577262;Ne;0;0;3;3
3893;"Krivūlė (Lydos g. 5)";EŽIUKAI;2607716072;Ne;3;0;6;9
3894;"Krivūlė (Lydos g. 5)";EŽIUKAI;3836712448;Ne;0;0;2;2
3895;"Krivūlė (Lydos g. 5)";EŽIUKAI;8873132189;Ne;0;0;2;2
3896;"Krivūlė (Lydos g. 5)";EŽIUKAI;2430372719;Ne;0;2;0;2
3897;"Krivūlė (Lydos g. 5)";EŽIUKAI;1893542120;Ne;2;0;9;11
3898;"Krivūlė (Lydos g. 5)";EŽIUKAI;1622229289;Ne;0;2;4;6
3899;"Krivūlė (Lydos g. 5)";EŽIUKAI;2157856704;Ne;0;2;1;3
3900;"Krivūlė (Lydos g. 5)";EŽIUKAI;4547087565;Ne;0;0;1;1
3901;"Krivūlė (Lydos g. 5)";EŽIUKAI;1189206089;Ne;0;0;9;9
3902;"Krivūlė (Lydos g. 5)";EŽIUKAI;1125863541;Ne;0;0;3;3
3903;"Krivūlė (Lydos g. 5)";EŽIUKAI;2448906549;Ne;0;0;1;1
3904;"Krivūlė (Lydos g. 5)";EŽIUKAI;6248684084;Ne;0;0;1;1
3905;"Krivūlė (Lydos g. 5)";NYKŠTUKAI;9820383193;Ne;0;2;8;10
3906;"Krivūlė (Lydos g. 5)";NYKŠTUKAI;2742783991;Ne;0;2;3;5
3907;"Krivūlė (Lydos g. 5)";NYKŠTUKAI;9401810791;Ne;0;0;1;1
3908;"Krivūlė (Lydos g. 5)";NYKŠTUKAI;8713384668;Ne;0;0;2;2
3909;"Krivūlė (Lydos g. 5)";NYKŠTUKAI;8767554721;Ne;0;1;1;2
3910;"Krivūlė (Lydos g. 5)";NYKŠTUKAI;9529242858;Ne;0;0;2;2
3911;"Krivūlė (Lydos g. 5)";NYKŠTUKAI;8898023612;Ne;0;2;0;2
3912;"Krivūlė (Lydos g. 5)";NYKŠTUKAI;5768244312;Ne;0;5;1;6
3913;"Krivūlė (Lydos g. 5)";NYKŠTUKAI;7540940063;Ne;0;2;0;2
3914;"Krivūlė (Lydos g. 5)";NYKŠTUKAI;7262017017;Ne;3;1;2;6
3915;"Krivūlė (Lydos g. 5)";NYKŠTUKAI;6548893885;Ne;0;2;2;4
3916;"Krivūlė (Lydos g. 5)";NYKŠTUKAI;8674468359;Ne;0;0;5;5
3917;"Krivūlė (Lydos g. 5)";NYKŠTUKAI;8047735389;Ne;0;2;0;2
3918;"Krivūlė (Lydos g. 5)";NYKŠTUKAI;6466188552;Ne;22;0;0;22
3919;"Kodėlčiukas (Laisvės pr. 59)";Saulutės;1725624698;Ne;3;0;4;7
3920;"Kodėlčiukas (Laisvės pr. 59)";Saulutės;7509476161;Ne;5;0;4;9
3921;"Kodėlčiukas (Laisvės pr. 59)";Saulutės;7327247516;Ne;0;2;0;2
3922;"Kodėlčiukas (Laisvės pr. 59)";Saulutės;1645680526;Ne;1;5;2;8
3923;"Kodėlčiukas (Laisvės pr. 59)";Saulutės;8992265000;Ne;0;4;0;4
3924;"Kodėlčiukas (Laisvės pr. 59)";Saulutės;6285018663;Ne;3;0;2;5
3925;"Kodėlčiukas (Laisvės pr. 59)";Saulutės;1033969800;Ne;0;1;0;1
3926;"Kodėlčiukas (Laisvės pr. 59)";Saulutės;2433094435;Ne;2;1;2;5
3927;"Kodėlčiukas (Laisvės pr. 59)";Saulutės;9042404309;Ne;0;2;0;2
3928;"Kodėlčiukas (Laisvės pr. 59)";Saulutės;3276075664;Ne;0;0;1;1
3929;"Kodėlčiukas (Laisvės pr. 59)";Saulutės;7611485881;Ne;1;2;2;5
3930;"Kodėlčiukas (Laisvės pr. 59)";Saulutės;7561763602;Ne;8;2;2;12
3931;"Kodėlčiukas (Laisvės pr. 59)";Saulutės;2289687766;Ne;0;4;0;4
3932;"Kodėlčiukas (Laisvės pr. 59)";Saulutės;1992569595;Ne;6;2;5;13
3933;"Kodėlčiukas (Laisvės pr. 59)";Saulutės;9527296531;Ne;0;2;12;14
3934;"Kodėlčiukas (Laisvės pr. 59)";Saulutės;8070400563;Ne;0;0;3;3
3935;"Kodėlčiukas (Laisvės pr. 59)";Saulutės;8447045958;Ne;3;1;3;7
3936;"Kodėlčiukas (Laisvės pr. 59)";Saulutės;2542104903;Ne;3;6;2;11
3937;"Kodėlčiukas (Laisvės pr. 59)";Saulutės;2162480212;Ne;0;0;1;1
3938;"Kodėlčiukas (Laisvės pr. 59)";Nežiniukai;9226992006;Ne;9;0;4;13
3939;"Kodėlčiukas (Laisvės pr. 59)";Nežiniukai;9404369378;Ne;18;0;2;20
3940;"Kodėlčiukas (Laisvės pr. 59)";Nežiniukai;2301454083;Ne;0;2;0;2
3941;"Kodėlčiukas (Laisvės pr. 59)";Nežiniukai;6041087039;Ne;10;0;2;12
3942;"Kodėlčiukas (Laisvės pr. 59)";Nežiniukai;8439867734;Ne;7;0;4;11
3943;"Kodėlčiukas (Laisvės pr. 59)";Nežiniukai;8734412840;Ne;1;2;5;8
3944;"Kodėlčiukas (Laisvės pr. 59)";Nežiniukai;1682040192;Ne;3;1;0;4
3945;"Kodėlčiukas (Laisvės pr. 59)";Nežiniukai;3060543464;Ne;3;0;2;5
3946;"Kodėlčiukas (Laisvės pr. 59)";Nežiniukai;7167508091;Ne;1;2;4;7
3947;"Kodėlčiukas (Laisvės pr. 59)";Nežiniukai;8644416746;Ne;2;0;5;7
3948;"Kodėlčiukas (Laisvės pr. 59)";Nežiniukai;6164851553;Ne;3;0;4;7
3949;"Kodėlčiukas (Laisvės pr. 59)";Nežiniukai;8435298904;Ne;12;1;5;18
3950;"Kodėlčiukas (Laisvės pr. 59)";Gintarėliai;5891546827;Ne;15;0;2;17
3951;"Kodėlčiukas (Laisvės pr. 59)";Gintarėliai;7710811301;Taip;4;3;2;9
3952;"Kodėlčiukas (Laisvės pr. 59)";Gintarėliai;9085395350;Ne;0;0;3;3
3953;"Kodėlčiukas (Laisvės pr. 59)";Gintarėliai;6409157827;Ne;2;0;4;6
3954;"Kodėlčiukas (Laisvės pr. 59)";Gintarėliai;8101197864;Ne;0;0;3;3
3955;"Kodėlčiukas (Laisvės pr. 59)";Gintarėliai;2543628770;Ne;8;5;4;17
3956;"Kodėlčiukas (Laisvės pr. 59)";Gintarėliai;8911944991;Taip;7;12;3;22
3957;"Kodėlčiukas (Laisvės pr. 59)";Gintarėliai;6670171992;Ne;4;0;2;6
3958;"Kodėlčiukas (Laisvės pr. 59)";Gintarėliai;2465920649;Ne;3;0;4;7
3959;"Kodėlčiukas (Laisvės pr. 59)";Gintarėliai;8348024909;Ne;5;5;3;13
3960;"Kodėlčiukas (Laisvės pr. 59)";Gintarėliai;4293763647;Ne;8;0;2;10
3961;"Kodėlčiukas (Laisvės pr. 59)";Gintarėliai;3878358193;Ne;5;0;4;9
3962;"Kodėlčiukas (Laisvės pr. 59)";Gintarėliai;6935233288;Ne;8;0;4;12
3963;"Kodėlčiukas (Laisvės pr. 59)";Gintarėliai;1835522972;Ne;15;0;2;17
3964;"Kodėlčiukas (Laisvės pr. 59)";Gintarėliai;9418778626;Ne;7;0;2;9
3965;"Kodėlčiukas (Laisvės pr. 59)";Gintarėliai;5541555127;Ne;3;1;6;10
3966;"Kodėlčiukas (Laisvės pr. 59)";Gintarėliai;8759498015;Ne;2;0;2;4
3967;"Kodėlčiukas (Laisvės pr. 59)";Gintarėliai;4986413731;Ne;12;0;4;16
3968;"Kodėlčiukas (Laisvės pr. 59)";Gintarėliai;2802895479;Ne;8;5;2;15
3969;"Kodėlčiukas (Laisvės pr. 59)";Gintarėliai;9914565606;Ne;4;1;2;7
3970;"Kodėlčiukas (Laisvės pr. 59)";Gintarėliai;7686420784;Ne;9;0;2;11
3971;"Kodėlčiukas (Laisvės pr. 59)";Gintarėliai;3037267215;Taip;0;2;2;4
3972;"Kodėlčiukas (Laisvės pr. 59)";Šnekučiai;6761903865;Ne;0;4;0;4
3973;"Kodėlčiukas (Laisvės pr. 59)";Šnekučiai;3778271049;Ne;11;2;4;17
3974;"Kodėlčiukas (Laisvės pr. 59)";Šnekučiai;7510273691;Ne;6;3;2;11
3975;"Kodėlčiukas (Laisvės pr. 59)";Šnekučiai;5075801618;Ne;0;2;1;3
3976;"Kodėlčiukas (Laisvės pr. 59)";Šnekučiai;5952121209;Ne;0;7;0;7
3977;"Kodėlčiukas (Laisvės pr. 59)";Šnekučiai;2351468626;Ne;0;1;3;4
3978;"Kodėlčiukas (Laisvės pr. 59)";Šnekučiai;9208137169;Ne;0;3;3;6
3979;"Kodėlčiukas (Laisvės pr. 59)";Šnekučiai;5876187643;Ne;0;1;0;1
3980;"Kodėlčiukas (Laisvės pr. 59)";Šnekučiai;4866089623;Ne;0;3;0;3
3981;"Kodėlčiukas (Laisvės pr. 59)";Šnekučiai;1206798597;Ne;0;7;0;7
3982;"Kodėlčiukas (Laisvės pr. 59)";Šnekučiai;9169500252;Ne;0;2;0;2
3983;"Kodėlčiukas (Laisvės pr. 59)";Šnekučiai;4941186694;Ne;0;11;2;13
3984;"Kodėlčiukas (Laisvės pr. 59)";Šnekučiai;6587593805;Ne;0;0;2;2
3985;"Kodėlčiukas (Laisvės pr. 59)";Šnekučiai;1074477043;Ne;0;1;1;2
3986;"Kodėlčiukas (Laisvės pr. 59)";Šnekučiai;9724373368;Ne;0;7;0;7
3987;"Kodėlčiukas (Laisvės pr. 59)";Šnekučiai;2819860331;Ne;0;1;0;1
3988;"Kodėlčiukas (Laisvės pr. 59)";Šnekučiai;3403889915;Ne;0;2;0;2
3989;"Kodėlčiukas (Laisvės pr. 59)";Šnekučiai;4230906452;Ne;0;2;3;5
3990;"Kodėlčiukas (Laisvės pr. 59)";Šnekučiai;1889809198;Ne;0;2;0;2
3991;"Kodėlčiukas (Laisvės pr. 59)";Pabiručiai;9278139998;Ne;3;0;2;5
3992;"Kodėlčiukas (Laisvės pr. 59)";Pabiručiai;6008027505;Ne;1;4;2;7
3993;"Kodėlčiukas (Laisvės pr. 59)";Pabiručiai;5894631257;Ne;2;1;2;5
3994;"Kodėlčiukas (Laisvės pr. 59)";Pabiručiai;6065858518;Ne;1;1;2;4
3995;"Kodėlčiukas (Laisvės pr. 59)";Pabiručiai;8586746296;Ne;0;1;1;2
3996;"Kodėlčiukas (Laisvės pr. 59)";Pabiručiai;9480926599;Ne;10;3;2;15
3997;"Kodėlčiukas (Laisvės pr. 59)";Pabiručiai;9511144369;Ne;0;1;3;4
3998;"Kodėlčiukas (Laisvės pr. 59)";Pabiručiai;7246943802;Ne;4;2;3;9
3999;"Kodėlčiukas (Laisvės pr. 59)";Pabiručiai;8189938439;Ne;2;0;2;4
4000;"Kodėlčiukas (Laisvės pr. 59)";Pabiručiai;5587200800;Ne;0;0;5;5
4001;"Kodėlčiukas (Laisvės pr. 59)";Pabiručiai;1433623973;Ne;3;1;2;6
4002;"Kodėlčiukas (Laisvės pr. 59)";Pabiručiai;1087808091;Ne;3;0;3;6
4003;"Kodėlčiukas (Laisvės pr. 59)";Pabiručiai;7570122834;Ne;0;2;0;2
4004;"Kodėlčiukas (Laisvės pr. 59)";Pabiručiai;5801430256;Ne;3;8;2;13
4005;"Kodėlčiukas (Laisvės pr. 59)";Pabiručiai;7455949617;Ne;1;0;3;4
4006;"Kodėlčiukas (Laisvės pr. 59)";Pabiručiai;1039982141;Ne;0;0;2;2
4007;"Kodėlčiukas (Laisvės pr. 59)";Pabiručiai;4507928289;Ne;1;0;2;3
4008;"Kodėlčiukas (Laisvės pr. 59)";Pabiručiai;9830842598;Ne;12;0;4;16
4009;"Kodėlčiukas (Laisvės pr. 59)";Pabiručiai;8291672306;Ne;0;0;2;2
4010;"Kodėlčiukas (Laisvės pr. 59)";Pabiručiai;3882838712;Ne;0;0;2;2
4011;"Kodėlčiukas (Laisvės pr. 59)";Pabiručiai;8635107742;Ne;0;0;2;2
4012;"Kodėlčiukas (Laisvės pr. 59)";Pabiručiai;5064526349;Ne;12;1;5;18
4013;"Kodėlčiukas (Laisvės pr. 59)";Smalsučiai;6950802941;Ne;3;0;2;5
4014;"Kodėlčiukas (Laisvės pr. 59)";Smalsučiai;6045564826;Ne;5;0;2;7
4015;"Kodėlčiukas (Laisvės pr. 59)";Smalsučiai;7136890681;Ne;0;0;2;2
4016;"Kodėlčiukas (Laisvės pr. 59)";Smalsučiai;7971932716;Ne;3;0;2;5
4017;"Kodėlčiukas (Laisvės pr. 59)";Smalsučiai;7282579315;Ne;3;0;4;7
4018;"Kodėlčiukas (Laisvės pr. 59)";Smalsučiai;6905424567;Ne;0;2;2;4
4019;"Kodėlčiukas (Laisvės pr. 59)";Smalsučiai;5443377251;Taip;0;2;1;3
4020;"Kodėlčiukas (Laisvės pr. 59)";Smalsučiai;6074758814;Ne;0;12;0;12
4021;"Kodėlčiukas (Laisvės pr. 59)";Smalsučiai;3150006441;Ne;1;0;2;3
4022;"Kodėlčiukas (Laisvės pr. 59)";Smalsučiai;1302383608;Ne;8;1;3;12
4023;"Kodėlčiukas (Laisvės pr. 59)";Smalsučiai;7626940433;Ne;0;2;0;2
4024;"Kodėlčiukas (Laisvės pr. 59)";Smalsučiai;5729391456;Ne;0;2;4;6
4025;"Kodėlčiukas (Laisvės pr. 59)";Smalsučiai;7286497455;Ne;4;2;2;8
4026;"Kodėlčiukas (Laisvės pr. 59)";Smalsučiai;1699358514;Ne;3;1;2;6
4027;"Kodėlčiukas (Laisvės pr. 59)";Smalsučiai;3473981974;Ne;0;0;6;6
4028;"Kodėlčiukas (Laisvės pr. 59)";Smalsučiai;4038168647;Ne;3;7;4;14
4029;"Kodėlčiukas (Laisvės pr. 59)";Smalsučiai;6000831611;Ne;0;2;1;3
4030;"Kodėlčiukas (Laisvės pr. 59)";Smalsučiai;1160612316;Ne;3;1;2;6
4031;"Kodėlčiukas (Laisvės pr. 59)";Smalsučiai;3470151604;Ne;2;0;3;5
4032;"Kodėlčiukas (Laisvės pr. 59)";Smalsučiai;5921714669;Ne;2;6;2;10
4033;"Kodėlčiukas (Laisvės pr. 59)";Smalsučiai;6764015170;Ne;0;4;0;4
4034;"Kodėlčiukas (Laisvės pr. 59)";Giliukai;9754425363;Ne;0;1;0;1
4035;"Kodėlčiukas (Laisvės pr. 59)";Giliukai;5587782917;Ne;5;0;2;7
4036;"Kodėlčiukas (Laisvės pr. 59)";Giliukai;8100861190;Taip;6;1;2;9
4037;"Kodėlčiukas (Laisvės pr. 59)";Giliukai;7639341503;Ne;0;1;0;1
4038;"Kodėlčiukas (Laisvės pr. 59)";Giliukai;8017465692;Ne;7;5;0;12
4039;"Kodėlčiukas (Laisvės pr. 59)";Giliukai;7937365710;Ne;9;0;4;13
4040;"Kodėlčiukas (Laisvės pr. 59)";Giliukai;9733831323;Ne;3;0;2;5
4041;"Kodėlčiukas (Laisvės pr. 59)";Giliukai;7007386353;Ne;6;2;2;10
4042;"Kodėlčiukas (Laisvės pr. 59)";Giliukai;9721353724;Ne;3;0;2;5
4043;"Kodėlčiukas (Laisvės pr. 59)";Giliukai;2943146610;Ne;0;1;0;1
4044;"Kodėlčiukas (Laisvės pr. 59)";Giliukai;5573845415;Taip;8;0;3;11
4045;"Kodėlčiukas (Laisvės pr. 59)";Giliukai;2122779530;Ne;0;2;0;2
4046;"Kodėlčiukas (Laisvės pr. 59)";Giliukai;8785157050;Ne;0;20;0;20
4047;"Kodėlčiukas (Laisvės pr. 59)";Giliukai;9992204262;Ne;0;4;3;7
4048;"Kodėlčiukas (Laisvės pr. 59)";Giliukai;6643473339;Ne;0;3;0;3
4049;"Kodėlčiukas (Laisvės pr. 59)";Giliukai;3130715310;Ne;0;4;0;4
4050;"Kodėlčiukas (Laisvės pr. 59)";Giliukai;3686259290;Ne;0;4;0;4
4051;"Kodėlčiukas (Laisvės pr. 59)";Giliukai;2928885561;Ne;0;0;1;1
4052;"Kodėlčiukas (Laisvės pr. 59)";Giliukai;5909222351;Ne;8;0;2;10
4053;"Kodėlčiukas (Laisvės pr. 59)";Gudručiai;1191430672;Ne;7;0;4;11
4054;"Kodėlčiukas (Laisvės pr. 59)";Gudručiai;6988515253;Ne;3;5;2;10
4055;"Kodėlčiukas (Laisvės pr. 59)";Gudručiai;3385551650;Ne;5;0;2;7
4056;"Kodėlčiukas (Laisvės pr. 59)";Gudručiai;7318908956;Ne;0;2;1;3
4057;"Kodėlčiukas (Laisvės pr. 59)";Gudručiai;7430239198;Ne;3;1;4;8
4058;"Kodėlčiukas (Laisvės pr. 59)";Gudručiai;8400610717;Ne;5;0;4;9
4059;"Kodėlčiukas (Laisvės pr. 59)";Gudručiai;7116594055;Ne;0;0;6;6
4060;"Kodėlčiukas (Laisvės pr. 59)";Gudručiai;7326475644;Ne;11;0;2;13
4061;"Kodėlčiukas (Laisvės pr. 59)";Gudručiai;9483378853;Ne;0;2;2;4
4062;"Kodėlčiukas (Laisvės pr. 59)";Gudručiai;4687333060;Ne;0;4;0;4
4063;"Kodėlčiukas (Laisvės pr. 59)";Gudručiai;1491160730;Ne;0;0;1;1
4064;"Kodėlčiukas (Laisvės pr. 59)";Gudručiai;2216791610;Ne;3;2;2;7
4065;"Kodėlčiukas (Laisvės pr. 59)";Gudručiai;2987907651;Ne;10;2;4;16
4066;"Kodėlčiukas (Laisvės pr. 59)";Gudručiai;9028856983;Ne;7;2;2;11
4067;"Kodėlčiukas (Laisvės pr. 59)";Gudručiai;1588132166;Ne;3;3;2;8
4068;"Kodėlčiukas (Laisvės pr. 59)";Gudručiai;6014084915;Ne;3;3;3;9
4069;"Kodėlčiukas (Laisvės pr. 59)";Gudručiai;3068084704;Ne;2;4;2;8
4070;"Kodėlčiukas (Laisvės pr. 59)";Gudručiai;6985788287;Ne;0;0;4;4
4071;"Kodėlčiukas (Laisvės pr. 59)";Gudručiai;3427610168;Ne;8;2;4;14
4072;"Kodėlčiukas (Laisvės pr. 59)";Žirniukai;2402290604;Ne;7;0;2;9
4073;"Kodėlčiukas (Laisvės pr. 59)";Žirniukai;6522019070;Ne;4;2;2;8
4074;"Kodėlčiukas (Laisvės pr. 59)";Žirniukai;3053949510;Taip;9;5;2;16
4075;"Kodėlčiukas (Laisvės pr. 59)";Žirniukai;5325660102;Ne;0;3;3;6
4076;"Kodėlčiukas (Laisvės pr. 59)";Žirniukai;8429572505;Ne;0;8;1;9
4077;"Kodėlčiukas (Laisvės pr. 59)";Žirniukai;4321485862;Ne;3;0;4;7
4078;"Kodėlčiukas (Laisvės pr. 59)";Žirniukai;1550287298;Ne;4;0;4;8
4079;"Kodėlčiukas (Laisvės pr. 59)";Žirniukai;9045733092;Ne;13;0;4;17
4080;"Kodėlčiukas (Laisvės pr. 59)";Žirniukai;4341694264;Ne;8;0;2;10
4081;"Kodėlčiukas (Laisvės pr. 59)";Žirniukai;4597473929;Taip;0;0;1;1
4082;"Kodėlčiukas (Laisvės pr. 59)";Žirniukai;9702236745;Ne;0;10;0;10
4083;"Kodėlčiukas (Laisvės pr. 59)";Žirniukai;7189930025;Ne;2;2;2;6
4084;"Kodėlčiukas (Laisvės pr. 59)";Žirniukai;2002468844;Taip;0;0;2;2
4085;"Kodėlčiukas (Laisvės pr. 59)";Žirniukai;4530733149;Ne;0;2;0;2
4086;"Kodėlčiukas (Laisvės pr. 59)";Žirniukai;4896921433;Ne;0;1;0;1
4087;"Kodėlčiukas (Laisvės pr. 59)";Katinėliai;4730433849;Ne;2;0;4;6
4088;"Kodėlčiukas (Laisvės pr. 59)";Katinėliai;4995538090;Ne;3;0;4;7
4089;"Kodėlčiukas (Laisvės pr. 59)";Katinėliai;8045906704;Ne;3;0;1;4
4090;"Kodėlčiukas (Laisvės pr. 59)";Katinėliai;7306085848;Ne;8;0;2;10
4091;"Kodėlčiukas (Laisvės pr. 59)";Katinėliai;5650077893;Ne;6;0;2;8
4092;"Kodėlčiukas (Laisvės pr. 59)";Katinėliai;3239314295;Ne;4;0;4;8
4093;"Kodėlčiukas (Laisvės pr. 59)";Katinėliai;9221561862;Ne;0;0;3;3
4094;"Kodėlčiukas (Laisvės pr. 59)";Katinėliai;6355536268;Ne;3;0;3;6
4095;"Kodėlčiukas (Laisvės pr. 59)";Katinėliai;2147517344;Ne;9;7;2;18
4096;"Kodėlčiukas (Laisvės pr. 59)";Katinėliai;2119041584;Ne;2;2;2;6
4097;"Kodėlčiukas (Laisvės pr. 59)";Katinėliai;2291665527;Ne;0;0;2;2
4098;"Kodėlčiukas (Laisvės pr. 59)";Katinėliai;1570599010;Ne;1;4;2;7
4099;"Kodėlčiukas (Laisvės pr. 59)";Katinėliai;4727546035;Ne;0;15;0;15
4100;"Kodėlčiukas (Laisvės pr. 59)";Katinėliai;6011097577;Taip;14;0;5;19
4101;"Kodėlčiukas (Laisvės pr. 59)";Katinėliai;4028114251;Ne;7;0;3;10
4102;"Kodėlčiukas (Laisvės pr. 59)";Nykštukai;2722591942;Ne;3;0;2;5
4103;"Kodėlčiukas (Laisvės pr. 59)";Nykštukai;5719244938;Ne;10;0;6;16
4104;"Kodėlčiukas (Laisvės pr. 59)";Nykštukai;4643616472;Ne;4;2;2;8
4105;"Kodėlčiukas (Laisvės pr. 59)";Nykštukai;6498584861;Ne;4;2;2;8
4106;"Kodėlčiukas (Laisvės pr. 59)";Nykštukai;8324804944;Ne;13;0;2;15
4107;"Kodėlčiukas (Laisvės pr. 59)";Nykštukai;1776582488;Ne;0;0;3;3
4108;"Kodėlčiukas (Laisvės pr. 59)";Nykštukai;2394070354;Ne;8;2;2;12
4109;"Kodėlčiukas (Laisvės pr. 59)";Nykštukai;3018381817;Ne;9;2;4;15
4110;"Kodėlčiukas (Laisvės pr. 59)";Nykštukai;9330345860;Ne;12;0;4;16
4111;"Kodėlčiukas (Laisvės pr. 59)";Nykštukai;9645711345;Ne;4;0;3;7
4112;"Kodėlčiukas (Laisvės pr. 59)";Nykštukai;3663726193;Taip;1;0;2;3
4113;"Kodėlčiukas (Laisvės pr. 59)";Nykštukai;3509994698;Ne;11;0;5;16
4114;"Kodėlčiukas (Laisvės pr. 59)";Nykštukai;8943422067;Ne;2;0;2;4
4115;"Kodėlčiukas (Laisvės pr. 59)";Nykštukai;3737512833;Taip;6;0;2;8
4116;"Kodėlčiukas (Laisvės pr. 59)";Nykštukai;8399334364;Ne;6;0;2;8
4117;"Kodėlčiukas (Laisvės pr. 59)";Nykštukai;1498607108;Ne;1;0;1;2
4118;"Kodėlčiukas (Laisvės pr. 59)";Nykštukai;7963235116;Ne;8;0;5;13
4119;"Kodėlčiukas (Laisvės pr. 59)";ŽIOGELIAI;8769409404;Taip;0;0;2;2
4120;"Kodėlčiukas (Laisvės pr. 59)";ŽIOGELIAI;5189091564;Ne;0;0;1;1
4121;"Kodėlčiukas (Laisvės pr. 59)";ŽIOGELIAI;6745245907;Ne;12;0;2;14
4122;"Kodėlčiukas (Laisvės pr. 59)";ŽIOGELIAI;9055399463;Ne;5;0;1;6
4123;"Kodėlčiukas (Laisvės pr. 59)";ŽIOGELIAI;2081199093;Ne;22;0;0;22
4124;"Kodėlčiukas (Laisvės pr. 59)";ŽIOGELIAI;5115939251;Ne;3;0;2;5
4125;"Kodėlčiukas (Laisvės pr. 59)";ŽIOGELIAI;3603781385;Ne;0;6;0;6
4126;"Kodėlčiukas (Laisvės pr. 59)";ŽIOGELIAI;6749972956;Ne;5;0;3;8
4127;"Kodėlčiukas (Laisvės pr. 59)";ŽIOGELIAI;2189949450;Ne;0;0;2;2
4128;"Kodėlčiukas (Laisvės pr. 59)";ŽIOGELIAI;7497358286;Ne;0;2;4;6
4129;"Kodėlčiukas (Laisvės pr. 59)";ŽIOGELIAI;2990546939;Ne;0;0;1;1
4130;"Kodėlčiukas (Laisvės pr. 59)";ŽIOGELIAI;4089558399;Ne;1;0;7;8
4131;"Kodėlčiukas (Laisvės pr. 59)";ŽIOGELIAI;6843492891;Ne;1;0;2;3
4132;"Kodėlčiukas (Laisvės pr. 59)";ŽIOGELIAI;2933909503;Ne;5;0;4;9
4133;"Kodėlčiukas (Laisvės pr. 59)";BITUTĖS;8144034996;Ne;3;0;2;5
4134;"Kodėlčiukas (Laisvės pr. 59)";BITUTĖS;4444145328;Ne;1;0;2;3
4135;"Kodėlčiukas (Laisvės pr. 59)";BITUTĖS;6007820210;Ne;8;2;2;12
4136;"Kodėlčiukas (Laisvės pr. 59)";BITUTĖS;9844479346;Ne;14;0;4;18
4137;"Kodėlčiukas (Laisvės pr. 59)";BITUTĖS;7251390043;Ne;2;0;2;4
4138;"Kodėlčiukas (Laisvės pr. 59)";BITUTĖS;6580462777;Ne;8;0;3;11
4139;"Kodėlčiukas (Laisvės pr. 59)";BITUTĖS;6800848383;Ne;0;3;0;3
4140;"Kodėlčiukas (Laisvės pr. 59)";BITUTĖS;5023273477;Ne;2;0;2;4
4141;"Kodėlčiukas (Laisvės pr. 59)";BITUTĖS;3970337050;Ne;8;0;3;11
4142;"Kodėlčiukas (Laisvės pr. 59)";BITUTĖS;7539430546;Ne;2;0;6;8
4143;"Kodėlčiukas (Laisvės pr. 59)";BITUTĖS;7148837596;Ne;3;0;2;5
4144;"Kodėlčiukas (Laisvės pr. 59)";BITUTĖS;5474194439;Ne;13;0;2;15
4145;"Kodėlčiukas (Laisvės pr. 59)";BITUTĖS;2272657477;Ne;6;0;2;8
4146;"Kodėlčiukas (Laisvės pr. 59)";VYŠNIUKAI;7705057116;Ne;4;0;4;8
4147;"Kodėlčiukas (Laisvės pr. 59)";VYŠNIUKAI;7643398934;Ne;7;2;5;14
4148;"Kodėlčiukas (Laisvės pr. 59)";VYŠNIUKAI;8799798070;Ne;0;0;3;3
4149;"Kodėlčiukas (Laisvės pr. 59)";VYŠNIUKAI;7119815662;Ne;11;2;4;17
4150;"Kodėlčiukas (Laisvės pr. 59)";VYŠNIUKAI;9398732476;Taip;9;4;4;17
4151;"Kodėlčiukas (Laisvės pr. 59)";VYŠNIUKAI;2720748563;Ne;1;0;2;3
4152;"Kodėlčiukas (Laisvės pr. 59)";VYŠNIUKAI;2871111867;Ne;0;3;0;3
4153;"Kodėlčiukas (Laisvės pr. 59)";VYŠNIUKAI;9914322177;Ne;1;0;2;3
4154;"Kodėlčiukas (Laisvės pr. 59)";VYŠNIUKAI;1925590099;Ne;1;0;2;3
4155;"Kodėlčiukas (Laisvės pr. 59)";VYŠNIUKAI;7242653444;Ne;1;0;3;4
4156;"Kodėlčiukas (Laisvės pr. 59)";VYŠNIUKAI;2298734536;Ne;0;4;0;4
4157;"Kodėlčiukas (Laisvės pr. 59)";VYŠNIUKAI;6261333618;Ne;1;0;0;1
4158;"Kodėlčiukas (Laisvės pr. 59)";VYŠNIUKAI;1808211253;Ne;6;3;2;11
4159;"Kodėlčiukas (Laisvės pr. 59)";VYŠNIUKAI;5178305435;Ne;4;0;2;6
4160;"Kodėlčiukas (Laisvės pr. 59)";VYŠNIUKAI;5061852590;Ne;0;2;1;3
4161;"Kodėlčiukas (Laisvės pr. 59)";VYŠNIUKAI;4782931414;Ne;0;2;0;2
4162;"Kodėlčiukas (Laisvės pr. 59)";VYŠNIUKAI;3938536446;Ne;0;0;6;6
4163;"Kodėlčiukas (Laisvės pr. 59)";BORUŽĖLĖS;2340866110;Taip;4;2;6;12
4164;"Kodėlčiukas (Laisvės pr. 59)";BORUŽĖLĖS;6726383331;Ne;0;2;2;4
4165;"Kodėlčiukas (Laisvės pr. 59)";BORUŽĖLĖS;1568628843;Ne;0;9;0;9
4166;"Kodėlčiukas (Laisvės pr. 59)";BORUŽĖLĖS;2438891967;Ne;7;0;2;9
4167;"Kodėlčiukas (Laisvės pr. 59)";BORUŽĖLĖS;3156788328;Ne;3;0;4;7
4168;"Kodėlčiukas (Laisvės pr. 59)";BORUŽĖLĖS;7186835214;Ne;2;0;3;5
4169;"Kodėlčiukas (Laisvės pr. 59)";BORUŽĖLĖS;8829986201;Ne;3;2;2;7
4170;"Kodėlčiukas (Laisvės pr. 59)";BORUŽĖLĖS;4529565626;Ne;4;0;2;6
4171;"Kodėlčiukas (Laisvės pr. 59)";BORUŽĖLĖS;9020265248;Ne;1;0;4;5
4172;"Kodėlčiukas (Laisvės pr. 59)";BORUŽĖLĖS;2313607716;Ne;5;0;6;11
4173;"Kodėlčiukas (Laisvės pr. 59)";BORUŽĖLĖS;9209671311;Ne;9;0;2;11
4174;"Kodėlčiukas (Laisvės pr. 59)";BORUŽĖLĖS;9736751250;Ne;5;4;5;14
4175;"Kodėlčiukas (Laisvės pr. 59)";BORUŽĖLĖS;7227149646;Ne;4;0;2;6
4176;"Kodėlčiukas (Laisvės pr. 59)";BORUŽĖLĖS;1197049907;Ne;4;0;5;9
4177;"Kodėlčiukas (Laisvės pr. 59)";BORUŽĖLĖS;3985455729;Ne;0;2;0;2
4178;"Kodėlčiukas (Laisvės pr. 59)";BORUŽĖLĖS;5068611716;Taip;8;0;3;11
4179;"Kodėlčiukas (Laisvės pr. 59)";BORUŽĖLĖS;7910205296;Ne;6;2;2;10
4180;"Kodėlčiukas (Laisvės pr. 59)";BORUŽĖLĖS;1047209628;Ne;4;0;4;8
4181;"Kodėlčiukas (Laisvės pr. 59)";BORUŽĖLĖS;8932472612;Ne;1;0;4;5
4182;"Kodėlčiukas (Laisvės pr. 59)";VYTURĖLIAI;6714818379;Ne;0;7;0;7
4183;"Kodėlčiukas (Laisvės pr. 59)";VYTURĖLIAI;4218096561;Ne;0;10;0;10
4184;"Kodėlčiukas (Laisvės pr. 59)";VYTURĖLIAI;4514764005;Ne;0;2;1;3
4185;"Kodėlčiukas (Laisvės pr. 59)";VYTURĖLIAI;2169307879;Ne;15;0;4;19
4186;"Kodėlčiukas (Laisvės pr. 59)";VYTURĖLIAI;4585226357;Ne;0;0;3;3
4187;"Kodėlčiukas (Laisvės pr. 59)";VYTURĖLIAI;4884233329;Ne;0;0;4;4
4188;"Kodėlčiukas (Laisvės pr. 59)";VYTURĖLIAI;8263945732;Ne;14;0;4;18
4189;"Kodėlčiukas (Laisvės pr. 59)";VYTURĖLIAI;7612531087;Ne;0;2;0;2
4190;"Kodėlčiukas (Laisvės pr. 59)";VYTURĖLIAI;2904858964;Ne;0;14;0;14
4191;"Kodėlčiukas (Laisvės pr. 59)";VYTURĖLIAI;3413659259;Ne;4;2;3;9
4192;"Kodėlčiukas (Laisvės pr. 59)";VYTURĖLIAI;9673271313;Ne;7;0;2;9
4193;"Kodėlčiukas (Laisvės pr. 59)";VYTURĖLIAI;5710301153;Ne;1;0;4;5
4194;"Kodėlčiukas (Laisvės pr. 59)";VYTURĖLIAI;5474125905;Ne;0;10;0;10
4195;"Kodėlčiukas (Laisvės pr. 59)";VYTURĖLIAI;2298099102;Ne;3;7;2;12
4196;"Kodėlčiukas (Laisvės pr. 59)";VYTURĖLIAI;5181211722;Ne;3;0;2;5
4197;"Kodėlčiukas (Laisvės pr. 59)";VYTURĖLIAI;3472862544;Taip;2;0;1;3
4198;"Kodėlčiukas (Laisvės pr. 59)";VYTURĖLIAI;7778188733;Ne;9;0;4;13
4199;"Kodėlčiukas (Laisvės pr. 59)";VYTURĖLIAI;6476445296;Ne;1;2;2;5
4200;"Kodėlčiukas (Laisvės pr. 59)";DRUGELIAI;4165123345;Ne;0;2;0;2
4201;"Kodėlčiukas (Laisvės pr. 59)";DRUGELIAI;5772071707;Ne;2;0;0;2
4202;"Kodėlčiukas (Laisvės pr. 59)";DRUGELIAI;1149682376;Ne;0;3;0;3
4203;"Kodėlčiukas (Laisvės pr. 59)";DRUGELIAI;7587203481;Ne;0;6;1;7
4204;"Kodėlčiukas (Laisvės pr. 59)";DRUGELIAI;2353960861;Ne;2;3;0;5
4205;"Kodėlčiukas (Laisvės pr. 59)";DRUGELIAI;6103959702;Ne;3;2;5;10
4206;"Kodėlčiukas (Laisvės pr. 59)";DRUGELIAI;3267687337;Ne;0;2;1;3
4207;"Kodėlčiukas (Laisvės pr. 59)";DRUGELIAI;5505788210;Ne;1;0;2;3
4208;"Kodėlčiukas (Laisvės pr. 59)";DRUGELIAI;5577154148;Ne;0;3;0;3
4209;"Kodėlčiukas (Laisvės pr. 59)";DRUGELIAI;8547039654;Ne;0;2;0;2
4210;"Kodėlčiukas (Laisvės pr. 59)";DRUGELIAI;4202423480;Ne;0;2;2;4
4211;"Kodėlčiukas (Laisvės pr. 59)";DRUGELIAI;9979034031;Ne;0;3;0;3
4212;"Kodėlčiukas (Laisvės pr. 59)";DRUGELIAI;3240221130;Ne;0;1;0;1
4213;"Kodėlčiukas (Laisvės pr. 59)";DRUGELIAI;9139424911;Ne;9;0;6;15
4214;"Kodėlčiukas (Laisvės pr. 59)";DRUGELIAI;5197946954;Ne;4;0;5;9
4215;"Kodėlčiukas (Laisvės pr. 59)";DRUGELIAI;3651073383;Ne;0;1;1;2
4216;"Kodėlčiukas (Laisvės pr. 59)";DRUGELIAI;3854719881;Ne;4;2;5;11
4217;"Kodėlčiukas (Laisvės pr. 59)";DRUGELIAI;8315176054;Ne;0;4;2;6
4218;"Kodėlčiukas (Laisvės pr. 59)";DRUGELIAI;7908217415;Ne;6;0;4;10
4219;"Kodėlčiukas (Laisvės pr. 59)";DRUGELIAI;4937929385;Ne;10;0;2;12
4220;"Kodėlčiukas (Laisvės pr. 59)";OBUOLIUKAI;8784531004;Ne;0;2;0;2
4221;"Kodėlčiukas (Laisvės pr. 59)";OBUOLIUKAI;1289342844;Ne;3;3;5;11
4222;"Kodėlčiukas (Laisvės pr. 59)";OBUOLIUKAI;8208448849;Ne;1;0;2;3
4223;"Kodėlčiukas (Laisvės pr. 59)";OBUOLIUKAI;1683506414;Ne;0;0;1;1
4224;"Kodėlčiukas (Laisvės pr. 59)";OBUOLIUKAI;3315862631;Ne;0;1;0;1
4225;"Kodėlčiukas (Laisvės pr. 59)";OBUOLIUKAI;5896726125;Ne;12;0;0;12
4226;"Kodėlčiukas (Laisvės pr. 59)";OBUOLIUKAI;3168418461;Ne;3;4;2;9
4227;"Kodėlčiukas (Laisvės pr. 59)";OBUOLIUKAI;9645987751;Ne;3;4;2;9
4228;"Kodėlčiukas (Laisvės pr. 59)";OBUOLIUKAI;5860975805;Ne;0;2;0;2
4229;"Kodėlčiukas (Laisvės pr. 59)";OBUOLIUKAI;8782155591;Ne;0;0;6;6
4230;"Kodėlčiukas (Laisvės pr. 59)";OBUOLIUKAI;2005453189;Ne;0;3;0;3
4231;"Kodėlčiukas (Laisvės pr. 59)";OBUOLIUKAI;5173730926;Ne;0;3;0;3
4232;"Kodėlčiukas (Laisvės pr. 59)";OBUOLIUKAI;3442449482;Ne;2;0;4;6
4233;"Kodėlčiukas (Laisvės pr. 59)";OBUOLIUKAI;7946010973;Ne;5;5;2;12
4234;"Kodėlčiukas (Laisvės pr. 59)";OBUOLIUKAI;5342852235;Ne;0;10;0;10
4235;"Kodėlčiukas (Laisvės pr. 59)";OBUOLIUKAI;8563412043;Ne;3;1;0;4
4236;"Kodėlčiukas (Laisvės pr. 59)";OBUOLIUKAI;4026784012;Ne;8;0;4;12
4237;"Kodėlčiukas (Laisvės pr. 59)";OBUOLIUKAI;2114176689;Ne;3;0;2;5
4238;"Kodėlčiukas (Laisvės pr. 59)";OBUOLIUKAI;3033687110;Ne;3;2;2;7
4239;"Kodėlčiukas (Laisvės pr. 59)";OBUOLIUKAI;5252261660;Taip;3;7;2;12
4240;Kurpaitė;Viščiukų;9825971721;Ne;0;6;0;6
4241;Kurpaitė;Viščiukų;4572559234;Ne;11;0;4;15
4242;Kurpaitė;Viščiukų;1370461809;Ne;1;2;2;5
4243;Kurpaitė;Viščiukų;4855231867;Ne;0;1;0;1
4244;Kurpaitė;Viščiukų;9299294437;Ne;0;0;2;2
4245;Kurpaitė;Viščiukų;9761100202;Ne;17;0;2;19
4246;Kurpaitė;Viščiukų;1558096975;Ne;0;5;0;5
4247;Kurpaitė;Viščiukų;7973054986;Ne;0;2;0;2
4248;Kurpaitė;Viščiukų;5629017875;Ne;15;2;4;21
4249;Kurpaitė;Viščiukų;4423261705;Ne;0;5;0;5
4250;Kurpaitė;Viščiukų;5234784564;Ne;0;22;0;22
4251;Kurpaitė;Viščiukų;2772566963;Ne;13;2;2;17
4252;Kurpaitė;Viščiukų;7375966869;Taip;0;6;0;6
4253;Kurpaitė;Gėlyčių;5952306163;Ne;0;7;0;7
4254;Kurpaitė;Gėlyčių;3139272175;Ne;0;5;0;5
4255;Kurpaitė;Gėlyčių;4769611100;Ne;3;0;2;5
4256;Kurpaitė;Gėlyčių;2373582223;Ne;0;22;0;22
4257;Kurpaitė;Gėlyčių;2157581956;Ne;0;13;0;13
4258;Kurpaitė;Gėlyčių;5175919323;Ne;0;13;0;13
4259;Kurpaitė;Gėlyčių;7194351335;Ne;19;0;2;21
4260;Kurpaitė;Gėlyčių;5701318496;Ne;0;9;0;9
4261;Kurpaitė;Gėlyčių;2744439309;Ne;0;5;0;5
4262;Kurpaitė;Gėlyčių;3481813493;Ne;0;4;0;4
4263;Kurpaitė;Gėlyčių;8402747029;Ne;0;5;0;5
4264;Kurpaitė;Gėlyčių;5557028481;Ne;11;4;2;17
4265;Kurpaitė;Gėlyčių;5447826458;Ne;0;16;0;16
4266;Kurpaitė;Gėlyčių;2867842844;Ne;22;0;0;22
4267;Kurpaitė;Gėlyčių;6859316204;Ne;1;0;2;3
4268;Kurpaitė;Drugelių;8868415451;Ne;0;5;0;5
4269;Kurpaitė;Drugelių;1273426668;Ne;0;5;0;5
4270;Kurpaitė;Drugelių;1413326858;Ne;1;0;2;3
4271;Kurpaitė;Drugelių;6568580994;Ne;0;12;0;12
4272;Kurpaitė;Drugelių;5396599834;Ne;7;5;2;14
4273;Kurpaitė;Drugelių;1752006477;Ne;6;0;6;12
4274;Kurpaitė;Drugelių;2757100599;Ne;5;5;2;12
4275;Kurpaitė;Drugelių;3989274600;Ne;0;2;0;2
4276;Kurpaitė;Drugelių;4426311033;Ne;0;5;0;5
4277;Kurpaitė;Drugelių;1927773278;Ne;0;10;0;10
4278;Kurpaitė;Drugelių;9221882007;Ne;0;2;0;2
4279;Kurpaitė;Drugelių;8361612709;Ne;0;15;0;15
4280;Kurpaitė;Drugelių;4754807319;Ne;0;8;0;8
4281;Kurpaitė;Drugelių;1964193512;Ne;0;5;0;5
4282;Kurpaitė;Drugelių;2294408486;Ne;0;0;6;6
4283;Kurpaitė;Pelyčių;7546409044;Ne;0;12;0;12
4284;Kurpaitė;Pelyčių;1209441106;Ne;0;3;1;4
4285;Kurpaitė;Pelyčių;4519369081;Ne;0;2;0;2
4286;Kurpaitė;Pelyčių;7897713994;Ne;0;4;0;4
4287;Kurpaitė;Pelyčių;5609161523;Ne;6;2;2;10
4288;Kurpaitė;Pelyčių;9480290430;Ne;0;2;0;2
4289;Kurpaitė;Pelyčių;4188925256;Ne;0;4;0;4
4290;Kurpaitė;Pelyčių;3634641300;Ne;0;4;0;4
4291;Kurpaitė;Pelyčių;5844470373;Ne;0;2;3;5
4292;Kurpaitė;Pelyčių;9200404698;Ne;0;5;0;5
4293;Kurpaitė;Pelyčių;1864484931;Ne;1;4;2;7
4294;Kurpaitė;Pelyčių;8069116180;Ne;8;4;10;22
4295;Kurpaitė;Pelyčių;9384218589;Ne;0;21;0;21
4296;Kurpaitė;Pelyčių;6309468728;Ne;12;3;2;17
4297;Kurpaitė;Pelyčių;2827617670;Ne;0;6;0;6
4298;Kurpaitė;Pelyčių;4168882748;Ne;0;15;0;15
4299;"Kūlverstukas (Suvalkų g. 6)";Saulutės;4846324136;Ne;0;8;5;13
4300;"Kūlverstukas (Suvalkų g. 6)";Saulutės;7505926208;Ne;6;0;2;8
4301;"Kūlverstukas (Suvalkų g. 6)";Saulutės;1014630718;Ne;6;0;2;8
4302;"Kūlverstukas (Suvalkų g. 6)";Saulutės;5340239466;Ne;0;2;0;2
4303;"Kūlverstukas (Suvalkų g. 6)";Saulutės;8294873714;Ne;0;4;2;6
4304;"Kūlverstukas (Suvalkų g. 6)";Saulutės;8353856412;Ne;4;2;3;9
4305;"Kūlverstukas (Suvalkų g. 6)";Saulutės;5719828293;Ne;0;0;1;1
4306;"Kūlverstukas (Suvalkų g. 6)";Saulutės;5391554530;Ne;0;5;0;5
4307;"Kūlverstukas (Suvalkų g. 6)";Saulutės;8964753108;Ne;1;0;2;3
4308;"Kūlverstukas (Suvalkų g. 6)";Saulutės;2389231051;Ne;1;0;2;3
4309;"Kūlverstukas (Suvalkų g. 6)";Saulutės;6710735721;Ne;0;3;0;3
4310;"Kūlverstukas (Suvalkų g. 6)";Saulutės;1067182820;Ne;0;2;1;3
4311;"Kūlverstukas (Suvalkų g. 6)";Saulutės;3196099819;Ne;0;0;2;2
4312;"Kūlverstukas (Suvalkų g. 6)";Saulutės;8333084277;Ne;0;2;2;4
4313;"Kūlverstukas (Suvalkų g. 6)";Saulutės;8896967083;Ne;3;4;3;10
4314;"Kūlverstukas (Suvalkų g. 6)";Peledžiukai;8853848991;Ne;0;4;0;4
4315;"Kūlverstukas (Suvalkų g. 6)";Peledžiukai;4073233921;Ne;0;4;0;4
4316;"Kūlverstukas (Suvalkų g. 6)";Peledžiukai;3238807604;Ne;0;7;0;7
4317;"Kūlverstukas (Suvalkų g. 6)";Peledžiukai;1932066021;Ne;0;2;1;3
4318;"Kūlverstukas (Suvalkų g. 6)";Peledžiukai;9655585527;Ne;10;4;2;16
4319;"Kūlverstukas (Suvalkų g. 6)";Peledžiukai;5345423038;Ne;0;12;0;12
4320;"Kūlverstukas (Suvalkų g. 6)";Peledžiukai;3270176280;Ne;0;2;0;2
4321;"Kūlverstukas (Suvalkų g. 6)";Peledžiukai;4285624305;Ne;0;1;0;1
4322;"Kūlverstukas (Suvalkų g. 6)";Peledžiukai;6894291912;Ne;5;10;2;17
4323;"Kūlverstukas (Suvalkų g. 6)";Peledžiukai;3224736003;Ne;0;9;3;12
4324;"Kūlverstukas (Suvalkų g. 6)";Peledžiukai;2762230590;Ne;0;2;0;2
4325;"Kūlverstukas (Suvalkų g. 6)";Peledžiukai;2450625415;Ne;1;2;2;5
4326;"Kūlverstukas (Suvalkų g. 6)";Peledžiukai;2101490038;Ne;0;2;2;4
4327;"Kūlverstukas (Suvalkų g. 6)";Peledžiukai;8319255735;Ne;0;1;7;8
4328;"Kūlverstukas (Suvalkų g. 6)";Peledžiukai;1795306946;Ne;5;6;2;13
4329;"Kūlverstukas (Suvalkų g. 6)";Peledžiukai;7118949795;Ne;0;1;0;1
4330;"Kūlverstukas (Suvalkų g. 6)";Peledžiukai;4173514390;Ne;0;0;2;2
4331;"Kūlverstukas (Suvalkų g. 6)";Peledžiukai;3448880105;Ne;12;4;6;22
4332;"Kūlverstukas (Suvalkų g. 6)";Peledžiukai;4532151103;Ne;1;1;2;4
4333;"Kūlverstukas (Suvalkų g. 6)";Gelytės;3811616695;Ne;2;0;2;4
4334;"Kūlverstukas (Suvalkų g. 6)";Gelytės;1939668692;Ne;7;3;3;13
4335;"Kūlverstukas (Suvalkų g. 6)";Gelytės;8618967238;Ne;0;1;1;2
4336;"Kūlverstukas (Suvalkų g. 6)";Gelytės;1679412281;Ne;0;0;2;2
4337;"Kūlverstukas (Suvalkų g. 6)";Gelytės;9777005699;Ne;0;22;0;22
4338;"Kūlverstukas (Suvalkų g. 6)";Gelytės;4694784301;Ne;10;0;4;14
4339;"Kūlverstukas (Suvalkų g. 6)";Gelytės;8599785196;Ne;8;3;4;15
4340;"Kūlverstukas (Suvalkų g. 6)";Gelytės;2082087440;Ne;5;0;2;7
4341;"Kūlverstukas (Suvalkų g. 6)";Gelytės;6916013898;Ne;0;5;1;6
4342;"Kūlverstukas (Suvalkų g. 6)";Gelytės;1062604474;Ne;2;0;2;4
4343;"Kūlverstukas (Suvalkų g. 6)";Gelytės;1985177751;Ne;0;9;2;11
4344;"Kūlverstukas (Suvalkų g. 6)";Gelytės;2924333435;Ne;0;3;3;6
4345;"Kūlverstukas (Suvalkų g. 6)";Gelytės;9787833724;Ne;1;0;3;4
4346;"Kūlverstukas (Suvalkų g. 6)";Gelytės;3370339665;Ne;5;0;2;7
4347;"Kūlverstukas (Suvalkų g. 6)";Gelytės;3712773480;Ne;0;14;0;14
4348;"Kūlverstukas (Suvalkų g. 6)";Bitutės;8510004509;Ne;14;0;2;16
4349;"Kūlverstukas (Suvalkų g. 6)";Bitutės;1710691463;Ne;17;2;0;19
4350;"Kūlverstukas (Suvalkų g. 6)";Bitutės;6820256485;Ne;5;1;5;11
4351;"Kūlverstukas (Suvalkų g. 6)";Bitutės;8630469988;Ne;1;0;4;5
4352;"Kūlverstukas (Suvalkų g. 6)";Bitutės;5359152614;Ne;0;8;2;10
4353;"Kūlverstukas (Suvalkų g. 6)";Bitutės;7536805404;Ne;7;0;2;9
4354;"Kūlverstukas (Suvalkų g. 6)";Bitutės;3603297769;Ne;7;7;0;14
4355;"Kūlverstukas (Suvalkų g. 6)";Bitutės;1651670859;Ne;0;0;6;6
4356;"Kūlverstukas (Suvalkų g. 6)";Bitutės;3667698628;Ne;13;0;2;15
4357;"Kūlverstukas (Suvalkų g. 6)";Bitutės;4211069122;Ne;12;0;4;16
4358;"Kūlverstukas (Suvalkų g. 6)";Bitutės;5401016434;Ne;5;0;4;9
4359;"Kūlverstukas (Suvalkų g. 6)";Bitutės;3348354269;Ne;9;0;5;14
4360;Lakštingala;Saulutės;2156571482;Ne;10;2;2;14
4361;Lakštingala;Saulutės;2084960114;Ne;0;0;4;4
4362;Lakštingala;Saulutės;3911509979;Ne;0;1;4;5
4363;Lakštingala;Saulutės;1598639284;Ne;8;2;12;22
4364;Lakštingala;Saulutės;3723986383;Ne;5;2;2;9
4365;Lakštingala;Saulutės;1243254166;Ne;0;8;0;8
4366;Lakštingala;Saulutės;9457533516;Ne;0;0;1;1
4367;Lakštingala;Saulutės;6567480562;Ne;13;0;2;15
4368;Lakštingala;Saulutės;9495341480;Ne;0;6;0;6
4369;Lakštingala;Saulutės;2543779273;Ne;3;3;2;8
4370;Lakštingala;Saulutės;2093953744;Ne;0;4;0;4
4371;Lakštingala;Saulutės;1074616528;Ne;0;0;4;4
4372;Lakštingala;Saulutės;5432816139;Ne;0;1;0;1
4373;Lakštingala;Saulutės;8679582358;Ne;22;0;0;22
4374;Lakštingala;Saulutės;5815240975;Ne;0;8;1;9
4375;Lakštingala;Saulutės;3369263112;Ne;6;2;4;12
4376;Lakštingala;Saulutės;8717764626;Ne;0;1;2;3
4377;Lakštingala;Saulutės;8160825203;Ne;0;1;0;1
4378;Lakštingala;Saulutės;6780591792;Ne;1;2;2;5
4379;Lakštingala;Saulutės;1220858944;Ne;0;1;0;1
4380;Lakštingala;Saulutės;4032030375;Ne;0;4;3;7
4381;Lakštingala;Saulutės;3839016986;Ne;0;1;0;1
4382;Lakštingala;Saulutės;9628476764;Ne;0;1;2;3
4383;Lakštingala;Saulutės;4344553248;Ne;0;0;6;6
4384;Lakštingala;Nykštukai;6861300785;Ne;0;1;1;2
4385;Lakštingala;Nykštukai;8915978498;Ne;0;6;0;6
4386;Lakštingala;Nykštukai;9578079018;Ne;0;6;0;6
4387;Lakštingala;Nykštukai;5943711793;Ne;3;2;9;14
4388;Lakštingala;Nykštukai;4027377037;Ne;0;0;2;2
4389;Lakštingala;Nykštukai;1561903802;Ne;0;0;2;2
4390;Lakštingala;Nykštukai;9420187643;Ne;0;4;3;7
4391;Lakštingala;Nykštukai;9339816191;Ne;0;5;0;5
4392;Lakštingala;Nykštukai;4045740078;Ne;0;5;0;5
4393;Lakštingala;Nykštukai;8310446552;Ne;0;0;5;5
4394;Lakštingala;Nykštukai;8063735934;Ne;0;2;0;2
4395;Lakštingala;Nykštukai;7396235662;Ne;1;2;3;6
4396;Lakštingala;Nykštukai;3863174791;Ne;0;2;2;4
4397;Lakštingala;Nykštukai;4725848201;Ne;0;0;5;5
4398;Lakštingala;Nykštukai;2165808562;Ne;5;2;7;14
4399;Lakštingala;Nykštukai;5539054769;Ne;0;2;0;2
4400;Lakštingala;Nykštukai;8421786788;Ne;0;0;1;1
4401;Lakštingala;Nykštukai;6974936332;Ne;0;0;3;3
4402;Lakštingala;Nykštukai;8764728846;Ne;0;2;0;2
4403;Lakštingala;Nykštukai;8663938939;Taip;3;0;2;5
4404;Lakštingala;Nykštukai;6231045485;Ne;0;0;1;1
4405;Lakštingala;Nykštukai;5165517709;Ne;0;2;0;2
4406;Lakštingala;Nykštukai;5965026791;Ne;8;0;4;12
4407;Lakštingala;Bitutės;6234559044;Ne;0;7;0;7
4408;Lakštingala;Bitutės;5727308039;Ne;3;2;2;7
4409;Lakštingala;Bitutės;5051773825;Ne;5;2;2;9
4410;Lakštingala;Bitutės;9390342572;Ne;1;2;2;5
4411;Lakštingala;Bitutės;2130192341;Ne;0;2;0;2
4412;Lakštingala;Bitutės;8171357606;Ne;0;5;0;5
4413;Lakštingala;Bitutės;8165998647;Ne;2;3;0;5
4414;Lakštingala;Bitutės;9774836470;Ne;0;3;0;3
4415;Lakštingala;Bitutės;1958696382;Ne;0;4;0;4
4416;Lakštingala;Bitutės;1587899391;Ne;1;4;4;9
4417;Lakštingala;Bitutės;9694524137;Ne;1;3;4;8
4418;Lakštingala;Bitutės;1458348357;Ne;18;2;2;22
4419;Lakštingala;Bitutės;4542992319;Ne;8;2;2;12
4420;Lakštingala;Bitutės;7272454093;Ne;5;3;0;8
4421;Lakštingala;Bitutės;5949665703;Ne;15;2;2;19
4422;Lakštingala;Bitutės;4722328994;Ne;3;2;2;7
4423;Lakštingala;Bitutės;2593030897;Ne;3;2;2;7
4424;Lakštingala;Bitutės;6565318145;Ne;0;3;0;3
4425;Lakštingala;Bitutės;4384468922;Ne;0;13;0;13
4426;Lakštingala;Bitutės;6908873466;Ne;0;2;0;2
4427;Lakštingala;Bitutės;5379344261;Ne;0;2;2;4
4428;Lakštingala;Bitutės;7929034243;Ne;0;10;0;10
4429;Lakštingala;Bitutės;5854794141;Ne;0;6;0;6
4430;Lakštingala;Bitutės;2423761155;Ne;13;2;2;17
4431;Lakštingala;Bitutės;5920907667;Ne;0;17;0;17
4432;Lakštingala;Pūkeliai;9093654437;Ne;1;0;1;2
4433;Lakštingala;Pūkeliai;3877448215;Ne;0;0;1;1
4434;Lakštingala;Pūkeliai;6148942052;Ne;9;0;4;13
4435;Lakštingala;Pūkeliai;7623917384;Ne;6;0;2;8
4436;Lakštingala;Pūkeliai;6011421835;Ne;7;0;2;9
4437;Lakštingala;Pūkeliai;8861428074;Ne;5;0;2;7
4438;Lakštingala;Pūkeliai;2673030043;Ne;2;0;5;7
4439;Lakštingala;Pūkeliai;2346497467;Ne;16;0;2;18
4440;Lakštingala;Pūkeliai;2010478542;Ne;14;0;0;14
4441;Lakštingala;Pūkeliai;1903292595;Ne;13;0;4;17
4442;Lakštingala;Pūkeliai;6764453371;Ne;0;0;2;2
4443;Lakštingala;Pūkeliai;9894103692;Ne;9;0;4;13
4444;Lakštingala;Pūkeliai;1371422364;Ne;6;0;2;8
4445;Lakštingala;Pūkeliai;6285766353;Ne;5;0;2;7
4446;Lakštingala;Pūkeliai;3752408599;Ne;0;0;3;3
4447;Lakštingala;Pūkeliai;9183206191;Ne;4;0;4;8
4448;Lakštingala;Pūkeliai;2611117446;Ne;7;0;5;12
4449;Lakštingala;Pūkeliai;5524522038;Ne;7;0;3;10
4450;Lakštingala;Pūkeliai;5890760362;Ne;5;0;2;7
4451;Lakštingala;Pūkeliai;5583075385;Ne;13;0;4;17
4452;Lakštingala;Pūkeliai;4234177812;Ne;8;0;4;12
4453;Lakštingala;Pūkeliai;5903339111;Ne;17;0;4;21
4454;Lakštingala;Aitvariukai;1474796466;Ne;2;0;2;4
4455;Lakštingala;Aitvariukai;9629855134;Ne;0;0;4;4
4456;Lakštingala;Aitvariukai;4546036762;Ne;0;0;3;3
4457;Lakštingala;Aitvariukai;6219896499;Ne;0;0;3;3
4458;Lakštingala;Aitvariukai;7876311404;Ne;0;0;1;1
4459;Lakštingala;Aitvariukai;1248909711;Ne;3;0;4;7
4460;Lakštingala;Aitvariukai;9676872125;Ne;1;0;3;4
4461;Lakštingala;Aitvariukai;9083753159;Ne;0;0;4;4
4462;Lakštingala;Aitvariukai;7879280198;Ne;0;7;2;9
4463;Lakštingala;Aitvariukai;4403673558;Taip;3;12;2;17
4464;Lakštingala;Aitvariukai;5693413287;Ne;5;0;4;9
4465;Lakštingala;Aitvariukai;7240426529;Ne;9;0;4;13
4466;Lakštingala;Aitvariukai;8558000223;Ne;10;0;2;12
4467;Lakštingala;Aitvariukai;5244646855;Ne;0;0;3;3
4468;Lakštingala;Aitvariukai;5602079341;Ne;13;0;4;17
4469;Lakštingala;Aitvariukai;7404386777;Ne;0;0;2;2
4470;Lakštingala;Aitvariukai;3166474163;Ne;2;0;5;7
4471;Lakštingala;Aitvariukai;8609822839;Ne;0;11;4;15
4472;Lakštingala;Aitvariukai;6180443056;Ne;7;0;6;13
4473;Lakštingala;Aitvariukai;6389721877;Ne;5;0;5;10
4474;Lakštingala;Aitvariukai;4211861355;Ne;6;0;6;12
4475;Lakštingala;Boružiukai;1898853302;Ne;0;1;1;2
4476;Lakštingala;Boružiukai;8284565948;Ne;0;8;0;8
4477;Lakštingala;Boružiukai;4857448665;Ne;0;2;2;4
4478;Lakštingala;Boružiukai;1863034132;Ne;0;3;1;4
4479;Lakštingala;Boružiukai;9879064676;Ne;2;2;2;6
4480;Lakštingala;Boružiukai;2941128360;Ne;0;1;0;1
4481;Lakštingala;Boružiukai;8217315818;Ne;0;3;2;5
4482;Lakštingala;Boružiukai;6292331193;Ne;3;2;3;8
4483;Lakštingala;Boružiukai;3509165175;Ne;2;4;2;8
4484;Lakštingala;Boružiukai;4179366572;Ne;4;4;2;10
4485;Lakštingala;Boružiukai;9489982241;Ne;0;4;0;4
4486;Lakštingala;Boružiukai;3993759015;Ne;16;2;0;18
4487;Lakštingala;Boružiukai;5445945319;Ne;4;2;4;10
4488;Lakštingala;Boružiukai;2652305131;Ne;0;6;0;6
4489;Lakštingala;Boružiukai;9725851433;Ne;3;0;2;5
4490;Lakštingala;Boružiukai;1655202909;Ne;0;4;1;5
4491;Lakštingala;Boružiukai;6009631424;Ne;0;2;0;2
4492;Lakštingala;Boružiukai;9375002191;Ne;3;4;4;11
4493;Lakštingala;Boružiukai;7963839249;Ne;0;4;4;8
4494;Lakštingala;Boružiukai;5162605666;Ne;3;3;3;9
4495;Lakštingala;Boružiukai;2073818724;Ne;2;2;2;6
4496;Lakštingala;Boružiukai;7994475429;Ne;0;2;0;2
4497;Lakštingala;Boružiukai;2266870318;Ne;0;6;2;8
4498;Lakštingala;Boružiukai;9346986726;Ne;0;2;0;2
4499;Lakštingala;Žiogeliai;8404025659;Ne;10;0;4;14
4500;Lakštingala;Žiogeliai;4113993067;Ne;0;4;0;4
4501;Lakštingala;Žiogeliai;6981178960;Ne;0;2;6;8
4502;Lakštingala;Žiogeliai;3908175786;Ne;0;0;21;21
4503;Lakštingala;Žiogeliai;9860169528;Ne;0;0;5;5
4504;Lakštingala;Žiogeliai;4935753482;Ne;0;2;7;9
4505;Lakštingala;Žiogeliai;5008933316;Ne;0;2;1;3
4506;Lakštingala;Žiogeliai;3439681068;Ne;0;2;0;2
4507;Lakštingala;Žiogeliai;3766986041;Ne;5;5;7;17
4508;Lakštingala;Žiogeliai;1974950823;Ne;11;0;5;16
4509;Lakštingala;Žiogeliai;6561743084;Ne;4;1;4;9
4510;Lakštingala;Žiogeliai;1226908540;Ne;0;0;2;2
4511;Lakštingala;Žiogeliai;3951057865;Ne;16;0;2;18
4512;Lakštingala;Žiogeliai;1494530289;Ne;0;0;5;5
4513;Lakštingala;Žiogeliai;7661973162;Ne;5;0;3;8
4514;Lakštingala;Žiogeliai;7104398627;Ne;13;2;2;17
4515;Lakštingala;Žiogeliai;7361353346;Ne;0;7;1;8
4516;Lakštingala;Žiogeliai;4790291839;Ne;6;2;2;10
4517;Lakštingala;Žiogeliai;8351970017;Ne;3;2;4;9
4518;Lakštingala;Žiogeliai;8333832673;Ne;1;5;2;8
4519;Lakštingala;Žiogeliai;5849662446;Ne;0;10;0;10
4520;Lakštingala;Žiogeliai;5854343571;Ne;0;0;4;4
4521;Lakštingala;SPINDULIUKAI;4365413054;Ne;0;2;6;8
4522;Lakštingala;SPINDULIUKAI;9762500668;Ne;0;2;0;2
4523;Lakštingala;SPINDULIUKAI;7640007392;Ne;0;5;0;5
4524;Lakštingala;SPINDULIUKAI;1619201521;Ne;0;1;0;1
4525;Lakštingala;SPINDULIUKAI;2022621678;Ne;0;2;2;4
4526;Lakštingala;SPINDULIUKAI;8429523368;Ne;6;2;2;10
4527;Lakštingala;SPINDULIUKAI;6668075753;Ne;0;2;2;4
4528;Lakštingala;SPINDULIUKAI;9081653166;Ne;0;4;0;4
4529;Lakštingala;SPINDULIUKAI;4698879435;Ne;3;0;2;5
4530;Lakštingala;SPINDULIUKAI;8722490845;Ne;3;1;2;6
4531;Lakštingala;SPINDULIUKAI;3823860988;Ne;0;0;2;2
4532;Lakštingala;SPINDULIUKAI;7141840160;Ne;0;2;0;2
4533;Lakštingala;SPINDULIUKAI;3282771613;Ne;0;2;2;4
4534;Lakštingala;SPINDULIUKAI;2795341401;Ne;0;3;9;12
4535;Lakštingala;SPINDULIUKAI;9052256710;Ne;0;0;1;1
4536;Lakštingala;SPINDULIUKAI;8130468345;Ne;0;2;0;2
4537;Lakštingala;SPINDULIUKAI;2626498928;Ne;0;5;0;5
4538;Lakštingala;SPINDULIUKAI;3531056799;Ne;0;0;1;1
4539;Lakštingala;SPINDULIUKAI;9441296489;Ne;1;0;2;3
4540;Lakštingala;SPINDULIUKAI;6606640383;Ne;2;0;3;5
4541;Lakštingala;Pėledžiukai;6135103377;Ne;0;2;0;2
4542;Lakštingala;Pėledžiukai;4774354751;Ne;0;0;10;10
4543;Lakštingala;Pėledžiukai;8375506323;Ne;0;1;2;3
4544;Lakštingala;Pėledžiukai;2738882466;Ne;2;0;0;2
4545;Lakštingala;Pėledžiukai;8075192528;Ne;0;4;3;7
4546;Lakštingala;Pėledžiukai;4270513515;Ne;0;4;0;4
4547;Lakštingala;Pėledžiukai;2514377385;Ne;0;4;0;4
4548;Lakštingala;Pėledžiukai;6161860331;Ne;5;0;2;7
4549;Lakštingala;Pėledžiukai;6866935290;Ne;7;3;2;12
4550;Lakštingala;Pėledžiukai;8787118512;Ne;3;4;3;10
4551;Lakštingala;Pėledžiukai;6805882038;Ne;0;4;0;4
4552;Lakštingala;Pėledžiukai;7139669240;Ne;0;4;5;9
4553;Lakštingala;Pėledžiukai;9502994399;Ne;0;22;0;22
4554;Lakštingala;Pėledžiukai;9431022632;Ne;0;2;3;5
4555;Lakštingala;Pėledžiukai;9856189053;Ne;3;4;2;9
4556;Lakštingala;Pėledžiukai;4608719006;Ne;0;7;0;7
4557;Lakštingala;Pėledžiukai;5812491783;Ne;7;0;3;10
4558;Lakštingala;Pėledžiukai;9899997020;Ne;5;0;2;7
4559;Lakštingala;Pėledžiukai;6369696598;Ne;3;2;2;7
4560;Lakštingala;Pėledžiukai;9297542026;Ne;0;11;0;11
4561;Lakštingala;Pėledžiukai;3618452008;Ne;0;1;0;1
4562;Lakštingala;Katinėliai;7351891043;Ne;6;2;4;12
4563;Lakštingala;Katinėliai;2610113024;Ne;3;0;6;9
4564;Lakštingala;Katinėliai;6685195244;Ne;0;2;1;3
4565;Lakštingala;Katinėliai;8444696089;Ne;2;0;2;4
4566;Lakštingala;Katinėliai;4896401452;Ne;0;1;0;1
4567;Lakštingala;Katinėliai;7987187638;Ne;15;2;2;19
4568;Lakštingala;Katinėliai;8900191763;Ne;15;2;2;19
4569;Lakštingala;Katinėliai;5682152095;Ne;0;2;6;8
4570;Lakštingala;Katinėliai;9923491804;Ne;4;2;3;9
4571;Lakštingala;Katinėliai;2599217481;Ne;1;2;2;5
4572;Lakštingala;Katinėliai;2029350217;Ne;0;2;1;3
4573;Lakštingala;Katinėliai;6180366812;Ne;0;1;0;1
4574;Lakštingala;Katinėliai;3899425918;Ne;13;1;4;18
4575;Lakštingala;Katinėliai;4165688458;Ne;0;2;0;2
4576;Lakštingala;Katinėliai;3213575443;Ne;3;0;3;6
4577;Lakštingala;Katinėliai;2841048627;Ne;0;5;2;7
4578;Lakštingala;Katinėliai;1643794450;Ne;0;1;0;1
4579;Lakštingala;Katinėliai;1279172936;Ne;5;0;3;8
4580;Lakštingala;Katinėliai;2333102026;Ne;0;2;0;2
4581;Lakštingala;Katinėliai;2662167519;Ne;0;2;0;2
4582;Lakštingala;Katinėliai;3227628813;Ne;15;0;2;17
4583;Lakštingala;Katinėliai;2770661353;Ne;8;0;7;15
4584;Lakštingala;Deimantėliai;2114708431;Ne;10;2;2;14
4585;Lakštingala;Deimantėliai;8074211850;Ne;6;1;4;11
4586;Lakštingala;Deimantėliai;6749980386;Ne;3;1;2;6
4587;Lakštingala;Deimantėliai;9072843429;Ne;0;2;0;2
4588;Lakštingala;Deimantėliai;8938720617;Ne;2;0;2;4
4589;Lakštingala;Deimantėliai;4903094629;Ne;0;10;0;10
4590;Lakštingala;Deimantėliai;7853382073;Ne;0;2;7;9
4591;Lakštingala;Deimantėliai;1276857151;Ne;4;2;4;10
4592;Lakštingala;Deimantėliai;6971655647;Ne;0;4;1;5
4593;Lakštingala;Deimantėliai;7043519686;Ne;16;0;2;18
4594;Lakštingala;Deimantėliai;4976683143;Ne;5;0;4;9
4595;Lakštingala;Deimantėliai;7078051438;Ne;2;2;3;7
4596;Lakštingala;Deimantėliai;8571415914;Ne;0;2;3;5
4597;Lakštingala;Deimantėliai;8711116860;Ne;2;2;2;6
4598;Lakštingala;Deimantėliai;2886415541;Ne;1;4;2;7
4599;Lakštingala;Deimantėliai;5980402440;Ne;0;3;2;5
4600;Lakštingala;Deimantėliai;1661358666;Ne;2;0;2;4
4601;Lakštingala;Deimantėliai;9312563560;Ne;2;0;2;4
4602;Lakštingala;Deimantėliai;4199371972;Ne;0;6;0;6
4603;Lakštingala;KIŠKUČIAI;6520436055;Ne;14;2;2;18
4604;Lakštingala;KIŠKUČIAI;3208321841;Ne;0;4;2;6
4605;Lakštingala;KIŠKUČIAI;5464460112;Ne;0;1;0;1
4606;Lakštingala;KIŠKUČIAI;6970022417;Ne;0;0;4;4
4607;Lakštingala;KIŠKUČIAI;5730122965;Ne;0;3;0;3
4608;Lakštingala;KIŠKUČIAI;4140403601;Ne;5;2;2;9
4609;Lakštingala;KIŠKUČIAI;5119365443;Ne;2;2;0;4
4610;Lakštingala;KIŠKUČIAI;6689018476;Ne;0;15;0;15
4611;Lakštingala;KIŠKUČIAI;7017047366;Ne;4;2;2;8
4612;Lakštingala;KIŠKUČIAI;9539081376;Ne;0;0;6;6
4613;Lakštingala;KIŠKUČIAI;4854843534;Ne;5;0;2;7
4614;Lakštingala;KIŠKUČIAI;9162902701;Ne;2;0;5;7
4615;Lakštingala;KIŠKUČIAI;5455119187;Ne;9;0;2;11
4616;Lakštingala;KIŠKUČIAI;1113674539;Ne;2;1;6;9
4617;Lakštingala;KIŠKUČIAI;4370431439;Ne;2;1;2;5
4618;Lakštingala;KIŠKUČIAI;1898108870;Ne;9;2;11;22
4619;Lakštingala;KIŠKUČIAI;2998581623;Ne;8;2;2;12
4620;Lakštingala;KIŠKUČIAI;8414220381;Ne;5;0;2;7
4621;Lakštingala;KIŠKUČIAI;7817830649;Ne;5;6;2;13
4622;Lakštingala;KIŠKUČIAI;4653006161;Ne;0;1;0;1
4623;Lakštingala;KIŠKUČIAI;1831078544;Ne;2;0;3;5
4624;Lašelis;VIŠČIUKAI;6477439886;Ne;8;3;3;14
4625;Lašelis;VIŠČIUKAI;6912802425;Ne;11;2;2;15
4626;Lašelis;VIŠČIUKAI;6857428142;Ne;14;1;2;17
4627;Lašelis;VIŠČIUKAI;5759317067;Ne;2;3;2;7
4628;Lašelis;VIŠČIUKAI;1367955273;Ne;0;18;0;18
4629;Lašelis;VIŠČIUKAI;2702582486;Ne;3;2;5;10
4630;Lašelis;VIŠČIUKAI;2824852871;Ne;0;22;0;22
4631;Lašelis;VIŠČIUKAI;1294930990;Ne;13;0;4;17
4632;Lašelis;VIŠČIUKAI;2121080776;Taip;1;0;0;1
4633;Lašelis;VIŠČIUKAI;4427263877;Ne;3;12;2;17
4634;Lašelis;VIŠČIUKAI;1168408482;Ne;3;3;2;8
4635;Lašelis;VIŠČIUKAI;4748156580;Ne;1;3;8;12
4636;Lašelis;VIŠČIUKAI;4860925464;Ne;0;2;2;4
4637;Lašelis;VIŠČIUKAI;2915806799;Ne;0;5;0;5
4638;Lašelis;VIŠČIUKAI;2900106941;Ne;3;11;2;16
4639;Lašelis;VIŠČIUKAI;2748888134;Ne;8;2;3;13
4640;Lašelis;VIŠČIUKAI;2022728457;Ne;4;2;2;8
4641;Lašelis;ŠYPSENA;4113842551;Ne;0;3;0;3
4642;Lašelis;ŠYPSENA;6317716501;Ne;3;0;2;5
4643;Lašelis;ŠYPSENA;7502668870;Ne;0;4;0;4
4644;Lašelis;ŠYPSENA;8905080707;Ne;3;3;2;8
4645;Lašelis;ŠYPSENA;7784416134;Ne;0;2;0;2
4646;Lašelis;ŠYPSENA;4051058266;Ne;0;2;0;2
4647;Lašelis;ŠYPSENA;2991487552;Ne;7;1;0;8
4648;Lašelis;ŠYPSENA;7418586100;Ne;13;1;3;17
4649;Lašelis;ŠYPSENA;1429188137;Ne;2;0;0;2
4650;Lašelis;ŠYPSENA;1131591230;Ne;3;0;5;8
4651;Lašelis;ŠYPSENA;1343964112;Ne;2;0;2;4
4652;Lašelis;ŠYPSENA;7811809908;Ne;5;0;2;7
4653;Lašelis;ŠYPSENA;1882188961;Ne;3;0;2;5
4654;Lašelis;ŠYPSENA;4893073148;Ne;0;1;0;1
4655;Lašelis;ŠYPSENA;2210081848;Ne;0;2;0;2
4656;Lašelis;ŠYPSENA;8834899622;Ne;6;0;4;10
4657;Lašelis;ŠYPSENA;4805028666;Ne;3;0;3;6
4658;Lašelis;ŠYPSENA;1511922965;Ne;0;1;1;2
4659;Lašelis;NYKŠTUKAI;2509469243;Ne;17;3;2;22
4660;Lašelis;NYKŠTUKAI;4832223461;Ne;0;3;3;6
4661;Lašelis;NYKŠTUKAI;5416590600;Ne;10;2;4;16
4662;Lašelis;NYKŠTUKAI;1490179832;Ne;0;12;0;12
4663;Lašelis;NYKŠTUKAI;3995905195;Ne;0;22;0;22
4664;Lašelis;NYKŠTUKAI;1060784180;Ne;12;0;2;14
4665;Lašelis;NYKŠTUKAI;6137626795;Ne;9;0;3;12
4666;Lašelis;NYKŠTUKAI;1635921119;Ne;0;2;0;2
4667;Lašelis;NYKŠTUKAI;6836452490;Ne;4;1;3;8
4668;Lašelis;NYKŠTUKAI;4933598046;Ne;1;3;6;10
4669;Lašelis;NYKŠTUKAI;9664015801;Ne;0;7;0;7
4670;Lašelis;NYKŠTUKAI;1983312896;Ne;0;7;0;7
4671;Lašelis;NYKŠTUKAI;1279052767;Ne;2;2;2;6
4672;Lašelis;NYKŠTUKAI;8906479495;Ne;9;0;7;16
4673;Lašelis;NYKŠTUKAI;2606193652;Ne;0;2;1;3
4674;Lašelis;NYKŠTUKAI;9434932943;Ne;4;7;2;13
4675;Lašelis;NYKŠTUKAI;2593126568;Ne;5;0;4;9
4676;Lašelis;SAULUTĖ;3495676199;Ne;0;1;3;4
4677;Lašelis;SAULUTĖ;1085950130;Ne;0;1;0;1
4678;Lašelis;SAULUTĖ;1175045927;Taip;0;4;0;4
4679;Lašelis;SAULUTĖ;5931015581;Ne;0;0;2;2
4680;Lašelis;SAULUTĖ;8132517365;Ne;1;4;2;7
4681;Lašelis;SAULUTĖ;1244168190;Ne;0;0;2;2
4682;Lašelis;SAULUTĖ;4566547120;Taip;2;3;2;7
4683;Lašelis;SAULUTĖ;9647340725;Ne;4;6;2;12
4684;Lašelis;SAULUTĖ;1042560186;Taip;0;5;2;7
4685;Lašelis;SAULUTĖ;1035888733;Ne;0;0;4;4
4686;Lašelis;SAULUTĖ;1926439959;Ne;0;3;2;5
4687;Lašelis;SAULUTĖ;4508779926;Ne;0;1;0;1
4688;Lašelis;SAULUTĖ;1415345442;Ne;8;0;5;13
4689;Lašelis;SAULUTĖ;8318512396;Taip;1;0;3;4
4690;Lašelis;SAULUTĖ;8814796010;Ne;6;0;4;10
4691;Lašelis;SAULUTĖ;2223293390;Taip;0;0;1;1
4692;Lašelis;SAULUTĖ;2886967297;Ne;1;4;2;7
4693;Lašelis;SAULUTĖ;3805049682;Ne;3;7;2;12
4694;Lašelis;SAULUTĖ;2401058384;Ne;0;2;1;3
4695;Lašelis;SAULUTĖ;3675606390;Ne;14;4;2;20
4696;Lašelis;BORUŽĖLĖS;3180139334;Ne;0;27;0;27
4697;Lašelis;BORUŽĖLĖS;5000188106;Ne;7;5;2;14
4698;Lašelis;BORUŽĖLĖS;6203027620;Ne;6;0;1;7
4699;Lašelis;BORUŽĖLĖS;7619426839;Ne;10;3;12;25
4700;Lašelis;BORUŽĖLĖS;8718481664;Ne;6;0;3;9
4701;Lašelis;BORUŽĖLĖS;3130271837;Ne;8;0;2;10
4702;Lašelis;BORUŽĖLĖS;2871149756;Ne;28;2;2;32
4703;Lašelis;BORUŽĖLĖS;7920615797;Ne;11;3;6;20
4704;Lašelis;BORUŽĖLĖS;8212250478;Ne;13;10;2;25
4705;Lašelis;BORUŽĖLĖS;1675784376;Ne;16;5;6;27
4706;Lašelis;BORUŽĖLĖS;6275226824;Ne;0;0;5;5
4707;Lašelis;BORUŽĖLĖS;6751223169;Ne;8;0;3;11
4708;Lašelis;BORUŽĖLĖS;7432843976;Ne;12;0;4;16
4709;Lašelis;BORUŽĖLĖS;3183193902;Ne;20;5;2;27
4710;Lašelis;BORUŽĖLĖS;8063361528;Ne;8;2;2;12
4711;Lašelis;BORUŽĖLĖS;9879208797;Ne;14;0;4;18
4712;Lašelis;SKRUZDELIUKAI;5535348173;Ne;8;7;2;17
4713;Lašelis;SKRUZDELIUKAI;7704247097;Ne;6;0;7;13
4714;Lašelis;SKRUZDELIUKAI;4571213887;Ne;2;0;1;3
4715;Lašelis;SKRUZDELIUKAI;7367252046;Ne;14;0;4;18
4716;Lašelis;SKRUZDELIUKAI;9364834089;Ne;14;2;4;20
4717;Lašelis;SKRUZDELIUKAI;2200081600;Ne;13;1;2;16
4718;Lašelis;SKRUZDELIUKAI;6130824517;Ne;6;4;4;14
4719;Lašelis;SKRUZDELIUKAI;9905868465;Ne;4;0;2;6
4720;Lašelis;SKRUZDELIUKAI;6947939251;Ne;13;0;4;17
4721;Lašelis;SKRUZDELIUKAI;9394906598;Ne;13;1;5;19
4722;Lašelis;SKRUZDELIUKAI;9976394850;Ne;4;16;2;22
4723;Lašelis;SKRUZDELIUKAI;7610658433;Ne;15;0;4;19
4724;Lašelis;SKRUZDELIUKAI;4802629905;Ne;4;4;5;13
4725;Lašelis;SKRUZDELIUKAI;4487717519;Ne;9;2;2;13
4726;Lazdynėlis;BITUTĖS;1748260780;Ne;3;2;2;7
4727;Lazdynėlis;BITUTĖS;2044188250;Ne;0;2;2;4
4728;Lazdynėlis;BITUTĖS;2032759165;Taip;4;0;2;6
4729;Lazdynėlis;BITUTĖS;4545757725;Ne;0;2;0;2
4730;Lazdynėlis;BITUTĖS;6920441303;Ne;0;2;0;2
4731;Lazdynėlis;BITUTĖS;4153294595;Ne;0;1;3;4
4732;Lazdynėlis;BITUTĖS;7910561870;Ne;3;2;2;7
4733;Lazdynėlis;BITUTĖS;6963058612;Ne;8;7;2;17
4734;Lazdynėlis;BITUTĖS;9761942869;Ne;3;8;2;13
4735;Lazdynėlis;BITUTĖS;6276697479;Ne;3;0;5;8
4736;Lazdynėlis;BITUTĖS;9886856760;Ne;5;1;2;8
4737;Lazdynėlis;BITUTĖS;2998606948;Ne;4;1;4;9
4738;Lazdynėlis;BITUTĖS;6415858184;Ne;0;2;0;2
4739;Lazdynėlis;BITUTĖS;5796381191;Ne;0;22;0;22
4740;Lazdynėlis;BITUTĖS;5557752248;Ne;0;2;0;2
4741;Lazdynėlis;BITUTĖS;4771173060;Ne;0;0;2;2
4742;Lazdynėlis;BITUTĖS;1355954767;Ne;3;1;4;8
4743;Lazdynėlis;BITUTĖS;1070172991;Ne;0;2;0;2
4744;Lazdynėlis;BITUTĖS;8037918468;Ne;0;0;1;1
4745;Lazdynėlis;EŽIUKAI;3040417651;Ne;0;2;2;4
4746;Lazdynėlis;EŽIUKAI;7945472048;Ne;3;0;5;8
4747;Lazdynėlis;EŽIUKAI;1168433014;Ne;0;0;7;7
4748;Lazdynėlis;EŽIUKAI;7655218276;Ne;0;3;2;5
4749;Lazdynėlis;EŽIUKAI;6031442797;Ne;0;5;0;5
4750;Lazdynėlis;EŽIUKAI;7561833526;Ne;1;2;3;6
4751;Lazdynėlis;EŽIUKAI;3764854654;Ne;1;4;2;7
4752;Lazdynėlis;EŽIUKAI;8340712398;Ne;3;0;2;5
4753;Lazdynėlis;EŽIUKAI;1499729462;Ne;2;3;6;11
4754;Lazdynėlis;EŽIUKAI;2294873565;Ne;0;2;1;3
4755;Lazdynėlis;EŽIUKAI;2911152510;Ne;0;2;2;4
4756;Lazdynėlis;EŽIUKAI;3036055537;Ne;1;2;0;3
4757;Lazdynėlis;EŽIUKAI;4745610579;Ne;2;0;0;2
4758;Lazdynėlis;EŽIUKAI;6817162699;Ne;0;2;0;2
4759;Lazdynėlis;EŽIUKAI;8530159773;Ne;0;0;1;1
4760;Lazdynėlis;EŽIUKAI;7552873109;Ne;9;3;2;14
4761;Lazdynėlis;EŽIUKAI;9519409694;Ne;0;2;0;2
4762;Lazdynėlis;EŽIUKAI;2526260625;Ne;3;2;2;7
4763;Lazdynėlis;EŽIUKAI;2933025284;Ne;0;2;0;2
4764;Lazdynėlis;BORUŽIUKAI;8337458289;Ne;0;22;0;22
4765;Lazdynėlis;BORUŽIUKAI;7692056055;Ne;5;2;2;9
4766;Lazdynėlis;BORUŽIUKAI;6394994841;Ne;0;0;5;5
4767;Lazdynėlis;BORUŽIUKAI;2009941344;Ne;4;2;2;8
4768;Lazdynėlis;BORUŽIUKAI;1653216959;Ne;4;0;2;6
4769;Lazdynėlis;BORUŽIUKAI;4190852647;Ne;0;2;0;2
4770;Lazdynėlis;BORUŽIUKAI;2058909635;Ne;0;22;0;22
4771;Lazdynėlis;BORUŽIUKAI;3105363578;Ne;0;22;0;22
4772;Lazdynėlis;BORUŽIUKAI;5622254334;Ne;1;2;3;6
4773;Lazdynėlis;BORUŽIUKAI;7587041613;Ne;6;2;2;10
4774;Lazdynėlis;BORUŽIUKAI;2632078843;Ne;0;22;0;22
4775;Lazdynėlis;BORUŽIUKAI;5756228709;Ne;3;3;2;8
4776;Lazdynėlis;BORUŽIUKAI;1707231039;Ne;0;22;0;22
4777;Lazdynėlis;BORUŽIUKAI;6413861274;Ne;2;0;2;4
4778;Lazdynėlis;BORUŽIUKAI;8030743153;Ne;2;0;4;6
4779;Lazdynėlis;BORUŽIUKAI;4642875037;Ne;0;9;0;9
4780;Lazdynėlis;BORUŽIUKAI;1722503577;Ne;4;4;3;11
4781;Lazdynėlis;BORUŽIUKAI;4595080695;Ne;0;22;0;22
4782;Lazdynėlis;BORUŽIUKAI;4958640516;Ne;3;1;2;6
4783;Lazdynėlis;BORUŽIUKAI;3351966091;Ne;0;22;0;22
4784;Lazdynėlis;BORUŽIUKAI;9548866880;Ne;5;3;4;12
4785;Lazdynėlis;BORUŽIUKAI;4266414341;Ne;3;3;2;8
4786;Lazdynėlis;BORUŽIUKAI;6633585181;Ne;9;0;4;13
4787;Lazdynėlis;KAČIUKAI;2958520599;Ne;0;8;6;14
4788;Lazdynėlis;KAČIUKAI;6657174602;Ne;0;2;0;2
4789;Lazdynėlis;KAČIUKAI;2013752858;Ne;0;1;3;4
4790;Lazdynėlis;KAČIUKAI;2586187455;Ne;0;5;0;5
4791;Lazdynėlis;KAČIUKAI;1450181711;Ne;0;2;0;2
4792;Lazdynėlis;KAČIUKAI;5562900372;Ne;0;1;1;2
4793;Lazdynėlis;KAČIUKAI;4881322530;Ne;0;2;1;3
4794;Lazdynėlis;KAČIUKAI;8159928299;Ne;0;1;1;2
4795;Lazdynėlis;KAČIUKAI;4462819848;Ne;0;7;2;9
4796;Lazdynėlis;KAČIUKAI;9693153118;Ne;0;2;0;2
4797;Lazdynėlis;KAČIUKAI;7719697394;Ne;0;2;0;2
4798;Lazdynėlis;KAČIUKAI;4055450300;Ne;3;3;2;8
4799;Lazdynėlis;KAČIUKAI;3362193379;Ne;0;2;0;2
4800;Lazdynėlis;KAČIUKAI;6056618348;Ne;0;0;1;1
4801;Lazdynėlis;KAČIUKAI;3667994076;Ne;0;2;3;5
4802;Lazdynėlis;KAČIUKAI;1668899344;Ne;0;2;1;3
4803;Lazdynėlis;VOVERIUKAI;1039874409;Ne;2;2;2;6
4804;Lazdynėlis;VOVERIUKAI;1312649234;Ne;0;2;1;3
4805;Lazdynėlis;VOVERIUKAI;9362249595;Ne;0;2;1;3
4806;Lazdynėlis;VOVERIUKAI;6352480127;Ne;0;1;1;2
4807;Lazdynėlis;VOVERIUKAI;2354549025;Ne;0;0;1;1
4808;Lazdynėlis;VOVERIUKAI;5407785006;Ne;0;2;0;2
4809;Lazdynėlis;VOVERIUKAI;6814362584;Ne;0;0;3;3
4810;Lazdynėlis;VOVERIUKAI;7208223612;Ne;0;10;0;10
4811;Lazdynėlis;VOVERIUKAI;4293473176;Ne;2;2;2;6
4812;Lazdynėlis;VOVERIUKAI;2723284353;Ne;0;6;0;6
4813;Lazdynėlis;VOVERIUKAI;9219327706;Ne;0;3;1;4
4814;Lazdynėlis;VOVERIUKAI;6008610525;Ne;0;0;2;2
4815;Lazdynėlis;VOVERIUKAI;4031719765;Ne;0;2;0;2
4816;Lazdynėlis;VOVERIUKAI;7006931682;Ne;0;2;0;2
4817;Lazdynėlis;VOVERIUKAI;6582898708;Ne;0;0;1;1
4818;Lazdynėlis;RIEŠUTĖLIAI;3086059608;Ne;0;1;1;2
4819;Lazdynėlis;RIEŠUTĖLIAI;2478218103;Ne;0;2;0;2
4820;Lazdynėlis;RIEŠUTĖLIAI;5987500024;Ne;2;0;2;4
4821;Lazdynėlis;RIEŠUTĖLIAI;2453740823;Ne;3;1;0;4
4822;Lazdynėlis;RIEŠUTĖLIAI;4552505857;Ne;0;3;1;4
4823;Lazdynėlis;RIEŠUTĖLIAI;7545621720;Ne;0;1;2;3
4824;Lazdynėlis;RIEŠUTĖLIAI;3239107488;Ne;0;2;0;2
4825;Lazdynėlis;RIEŠUTĖLIAI;8942906327;Ne;0;22;0;22
4826;Lazdynėlis;RIEŠUTĖLIAI;3062924645;Ne;0;2;0;2
4827;Lazdynėlis;RIEŠUTĖLIAI;4092363029;Ne;1;2;2;5
4828;Lazdynėlis;RIEŠUTĖLIAI;3250913116;Ne;4;3;3;10
4829;Lazdynėlis;RIEŠUTĖLIAI;8529192130;Ne;6;3;4;13
4830;Lazdynėlis;RIEŠUTĖLIAI;5354852979;Ne;3;1;2;6
4831;Lazdynėlis;RIEŠUTĖLIAI;9930553716;Ne;5;0;2;7
4832;Lazdynėlis;RIEŠUTĖLIAI;6831456807;Ne;7;2;3;12
4833;Lazdynėlis;RIEŠUTĖLIAI;4795464133;Ne;3;1;2;6
4834;Lazdynėlis;RIEŠUTĖLIAI;7754329238;Ne;6;2;2;10
4835;Lazdynėlis;RIEŠUTĖLIAI;1488371861;Ne;2;0;2;4
4836;Lazdynėlis;RIEŠUTĖLIAI;9582702244;Ne;0;4;0;4
4837;Lazdynėlis;ANČIUKAI;3587681925;Ne;0;2;2;4
4838;Lazdynėlis;ANČIUKAI;4183342119;Ne;1;0;2;3
4839;Lazdynėlis;ANČIUKAI;8978670259;Ne;4;2;2;8
4840;Lazdynėlis;ANČIUKAI;4189563297;Ne;1;0;0;1
4841;Lazdynėlis;ANČIUKAI;2416662141;Ne;0;1;0;1
4842;Lazdynėlis;ANČIUKAI;6575706614;Ne;1;2;2;5
4843;Lazdynėlis;ANČIUKAI;4687709867;Ne;4;1;2;7
4844;Lazdynėlis;ANČIUKAI;8927785463;Ne;5;0;4;9
4845;Lazdynėlis;ANČIUKAI;6284781209;Ne;8;2;2;12
4846;Lazdynėlis;ANČIUKAI;7646625115;Ne;2;3;2;7
4847;Lazdynėlis;ANČIUKAI;1246581188;Ne;5;2;2;9
4848;Lazdynėlis;ANČIUKAI;7261983723;Ne;0;2;0;2
4849;Lazdynėlis;ANČIUKAI;7386794107;Ne;2;0;2;4
4850;Lazdynėlis;ANČIUKAI;9724741469;Ne;10;2;2;14
4851;Lazdynėlis;ANČIUKAI;3060705012;Ne;1;1;2;4
4852;Lazdynėlis;GUDRUČIAI;9407743178;Ne;0;2;0;2
4853;Lazdynėlis;GUDRUČIAI;3357092509;Ne;9;2;5;16
4854;Lazdynėlis;GUDRUČIAI;6994408527;Ne;1;2;2;5
4855;Lazdynėlis;GUDRUČIAI;2514035189;Ne;0;2;3;5
4856;Lazdynėlis;GUDRUČIAI;5889772626;Ne;0;1;1;2
4857;Lazdynėlis;GUDRUČIAI;6559543013;Ne;0;2;1;3
4858;Lazdynėlis;GUDRUČIAI;6164180360;Ne;0;2;0;2
4859;Lazdynėlis;GUDRUČIAI;3062408541;Ne;4;2;2;8
4860;Lazdynėlis;GUDRUČIAI;3779983775;Ne;3;6;2;11
4861;Lazdynėlis;GUDRUČIAI;5051632567;Ne;9;2;2;13
4862;Lazdynėlis;GUDRUČIAI;4550819172;Ne;0;6;0;6
4863;Lazdynėlis;GUDRUČIAI;8314002741;Ne;1;0;2;3
4864;Lazdynėlis;GUDRUČIAI;3365726271;Ne;4;1;4;9
4865;Lazdynėlis;GUDRUČIAI;7941793866;Ne;3;3;2;8
4866;Lazdynėlis;GUDRUČIAI;8003673668;Ne;1;0;2;3
4867;Lazdynėlis;MEŠKIUKAI;4094713096;Ne;6;1;6;13
4868;Lazdynėlis;MEŠKIUKAI;4267469349;Ne;0;0;1;1
4869;Lazdynėlis;MEŠKIUKAI;3427972329;Ne;0;0;1;1
4870;Lazdynėlis;MEŠKIUKAI;6941986839;Ne;0;22;0;22
4871;Lazdynėlis;MEŠKIUKAI;3697808826;Ne;6;1;4;11
4872;Lazdynėlis;MEŠKIUKAI;2812633983;Ne;0;1;2;3
4873;Lazdynėlis;MEŠKIUKAI;9590507486;Ne;3;0;5;8
4874;Lazdynėlis;MEŠKIUKAI;5982766841;Ne;0;2;0;2
4875;Lazdynėlis;MEŠKIUKAI;1984546310;Ne;0;0;2;2
4876;Lazdynėlis;MEŠKIUKAI;4408660083;Ne;0;2;0;2
4877;Lazdynėlis;MEŠKIUKAI;8567304224;Ne;7;0;2;9
4878;Lazdynėlis;MEŠKIUKAI;4366502064;Ne;5;0;2;7
4879;Lazdynėlis;MEŠKIUKAI;5301881620;Ne;0;0;1;1
4880;Lazdynėlis;MEŠKIUKAI;8473007295;Ne;10;0;2;12
4881;Liepsnelė;Zuikučiai;3774949481;Ne;6;0;0;6
4882;Liepsnelė;Varpeliai;9868489949;Ne;24;0;0;24
4883;Markučiai;Žirniukų;3525681034;Ne;0;1;0;1
4884;Markučiai;Žirniukų;7312533881;Ne;0;1;3;4
4885;Markučiai;Žirniukų;8934965409;Ne;0;2;0;2
4886;Markučiai;Žirniukų;8360526946;Ne;0;16;1;17
4887;Markučiai;Žirniukų;7244815252;Ne;5;0;3;8
4888;Markučiai;Žirniukų;2096169972;Ne;0;2;1;3
4889;Markučiai;Žirniukų;3073404128;Ne;0;3;0;3
4890;Markučiai;Žirniukų;5614488534;Ne;5;1;2;8
4891;Markučiai;Žirniukų;2367999201;Ne;3;0;7;10
4892;Markučiai;Žirniukų;4242575616;Ne;0;4;0;4
4893;Markučiai;Žirniukų;2099285475;Ne;8;2;12;22
4894;Markučiai;Žirniukų;2344252204;Ne;12;1;4;17
4895;Markučiai;Žirniukų;9576412366;Ne;0;2;0;2
4896;Markučiai;Žirniukų;1395241501;Ne;3;0;0;3
4897;Markučiai;Žirniukų;2539486337;Ne;4;0;6;10
4898;Markučiai;Žirniukų;8046320044;Ne;3;0;3;6
4899;Markučiai;Žirniukų;2060024771;Ne;14;0;2;16
4900;Markučiai;Žirniukų;6815286823;Ne;9;0;2;11
4901;Markučiai;Nykštukų;7507551844;Ne;2;2;2;6
4902;Markučiai;Nykštukų;9545967631;Ne;2;2;2;6
4903;Markučiai;Nykštukų;6121911851;Ne;2;0;2;4
4904;Markučiai;Nykštukų;6898055631;Ne;3;1;2;6
4905;Markučiai;Nykštukų;3378749042;Ne;3;5;6;14
4906;Markučiai;Nykštukų;1884388847;Ne;8;2;2;12
4907;Markučiai;Nykštukų;2170380827;Ne;3;0;2;5
4908;Markučiai;Nykštukų;4485929800;Ne;3;0;4;7
4909;Markučiai;Nykštukų;5183244346;Ne;3;2;2;7
4910;Markučiai;Nykštukų;7624913025;Ne;0;8;0;8
4911;Markučiai;Nykštukų;4679710493;Ne;3;0;6;9
4912;Markučiai;Nykštukų;2994895532;Ne;4;4;3;11
4913;Markučiai;Nykštukų;4846899377;Ne;3;1;2;6
4914;Markučiai;Nykštukų;4150956779;Ne;3;3;2;8
4915;Markučiai;Nykštukų;4920107818;Ne;3;10;2;15
4916;Markučiai;Nykštukų;7680126946;Ne;9;2;5;16
4917;Markučiai;Nykštukų;4222017733;Ne;9;0;4;13
4918;Markučiai;Nykštukų;3414015064;Ne;7;0;5;12
4919;Markučiai;Nykštukų;7642401516;Ne;0;7;0;7
4920;Markučiai;Nykštukų;8055783293;Ne;8;0;4;12
4921;Markučiai;Pelėdžiukų;9180404247;Ne;4;2;4;10
4922;Markučiai;Pelėdžiukų;4653663237;Ne;4;0;6;10
4923;Markučiai;Pelėdžiukų;7947287013;Ne;2;0;1;3
4924;Markučiai;Pelėdžiukų;5522654429;Ne;6;2;2;10
4925;Markučiai;Pelėdžiukų;7539605426;Ne;8;0;2;10
4926;Markučiai;Pelėdžiukų;8888538915;Ne;5;1;2;8
4927;Markučiai;Pelėdžiukų;1799946177;Ne;5;0;2;7
4928;Markučiai;Pelėdžiukų;7809719827;Ne;3;2;4;9
4929;Markučiai;Pelėdžiukų;4860961508;Ne;3;2;2;7
4930;Markučiai;Pelėdžiukų;6569807889;Ne;0;1;0;1
4931;Markučiai;Pelėdžiukų;5269411010;Ne;6;0;4;10
4932;Markučiai;Pelėdžiukų;1524727903;Ne;3;3;2;8
4933;Markučiai;Pelėdžiukų;1622197135;Ne;1;0;3;4
4934;Markučiai;Pelėdžiukų;8839679529;Ne;8;0;14;22
4935;Markučiai;Boružėlių;1171899107;Ne;0;7;2;9
4936;Markučiai;Boružėlių;8078777204;Ne;9;2;4;15
4937;Markučiai;Boružėlių;8244065962;Ne;0;3;0;3
4938;Markučiai;Boružėlių;5902165968;Ne;0;2;0;2
4939;Markučiai;Boružėlių;5981692282;Ne;3;3;2;8
4940;Markučiai;Boružėlių;3739566642;Ne;12;5;2;19
4941;Markučiai;Boružėlių;6868394315;Ne;0;2;3;5
4942;Markučiai;Boružėlių;7634475536;Ne;0;2;0;2
4943;Markučiai;Boružėlių;5663147778;Ne;6;3;3;12
4944;Markučiai;Boružėlių;8271830626;Ne;1;4;7;12
4945;Markučiai;Boružėlių;3315824027;Ne;4;5;3;12
4946;Markučiai;Boružėlių;5562960498;Ne;0;13;4;17
4947;Markučiai;Boružėlių;6260010822;Ne;0;2;0;2
4948;Markučiai;Boružėlių;6740434675;Ne;0;1;1;2
4949;Markučiai;Boružėlių;6707310242;Ne;5;2;4;11
4950;Markučiai;Boružėlių;9631684972;Ne;0;2;4;6
4951;Markučiai;Boružėlių;4911787595;Ne;0;2;0;2
4952;Markučiai;Boružėlių;1587323435;Ne;0;32;0;32
4953;Markučiai;Bitučių;1720541082;Ne;2;0;2;4
4954;Markučiai;Bitučių;8792524832;Ne;3;4;4;11
4955;Markučiai;Bitučių;9518247571;Ne;4;8;4;16
4956;Markučiai;Bitučių;9027071539;Ne;0;1;1;2
4957;Markučiai;Bitučių;8748794886;Ne;4;2;2;8
4958;Markučiai;Bitučių;7387460586;Ne;0;2;0;2
4959;Markučiai;Bitučių;8950442843;Ne;4;7;4;15
4960;Markučiai;Bitučių;2840564082;Ne;5;2;4;11
4961;Markučiai;Bitučių;3926993383;Ne;10;8;4;22
4962;Markučiai;Bitučių;6530101961;Ne;5;2;9;16
4963;Markučiai;Bitučių;1908302738;Ne;0;2;7;9
4964;Markučiai;Bitučių;7056367646;Ne;14;2;7;23
4965;Markučiai;Bitučių;8195584468;Ne;11;2;4;17
4966;Markučiai;Bitučių;2049497686;Ne;10;2;4;16
4967;Markučiai;Bitučių;8541042547;Ne;0;1;0;1
4968;Markučiai;Bitučių;1447116821;Ne;0;0;3;3
4969;Markučiai;Bitučių;2931958829;Ne;0;2;3;5
4970;Markučiai;Bitučių;9303448709;Ne;0;1;4;5
4971;Markučiai;Drugelių;2537459830;Ne;0;0;1;1
4972;Markučiai;Drugelių;2288910885;Ne;0;2;5;7
4973;Markučiai;Drugelių;3544565354;Ne;5;2;2;9
4974;Markučiai;Drugelių;6992161129;Ne;5;0;4;9
4975;Markučiai;Drugelių;9412129807;Ne;8;5;2;15
4976;Markučiai;Drugelių;6979218594;Ne;12;0;2;14
4977;Markučiai;Drugelių;3491734422;Ne;0;0;12;12
4978;Markučiai;Drugelių;3491734422;Ne;0;0;12;12
4979;Markučiai;Drugelių;3491734422;Ne;0;0;12;12
4980;Markučiai;Drugelių;3832641521;Ne;13;0;4;17
4981;Markučiai;Drugelių;4520724770;Ne;10;0;2;12
4982;Markučiai;Drugelių;9391866085;Ne;12;0;5;17
4983;Markučiai;Drugelių;9073616238;Ne;9;0;4;13
4984;Markučiai;Drugelių;2967726802;Ne;8;0;3;11
4985;Markučiai;Drugelių;6684544229;Ne;10;0;5;15
4986;Markučiai;Drugelių;3487571241;Ne;5;0;6;11
4987;Markučiai;Drugelių;1433469476;Ne;0;2;2;4
4988;Markučiai;Drugelių;7110705287;Ne;6;0;11;17
4989;Markučiai;Drugelių;6055822200;Ne;8;2;2;12
4990;Markučiai;Skruzdėliukų;5566529492;Ne;7;0;2;9
4991;Markučiai;Skruzdėliukų;8105747904;Ne;3;3;4;10
4992;Markučiai;Skruzdėliukų;6617799980;Ne;2;5;0;7
4993;Markučiai;Skruzdėliukų;7580249913;Ne;4;0;2;6
4994;Markučiai;Skruzdėliukų;2246646548;Ne;10;0;4;14
4995;Markučiai;Skruzdėliukų;9921530582;Ne;0;0;3;3
4996;Markučiai;Skruzdėliukų;6759427415;Ne;8;2;9;19
4997;Markučiai;Skruzdėliukų;4820576711;Ne;2;0;1;3
4998;Markučiai;Skruzdėliukų;8774323234;Ne;1;0;2;3
4999;Markučiai;Skruzdėliukų;7881183912;Ne;0;4;0;4
5000;Markučiai;Skruzdėliukų;9338996275;Ne;1;0;3;4
5001;Markučiai;Skruzdėliukų;5180034556;Ne;2;0;2;4
5002;Markučiai;Skruzdėliukų;4383128686;Ne;3;3;4;10
5003;Markučiai;Skruzdėliukų;8679791696;Ne;0;2;0;2
5004;Markučiai;Skruzdėliukų;2647189399;Ne;0;0;2;2
5005;Markučiai;Skruzdėliukų;3077125574;Ne;0;5;0;5
5006;Markučiai;Skruzdėliukų;1711102751;Ne;6;0;4;10
5007;Markučiai;ZUIKUČIŲ;8722494948;Ne;15;0;2;17
5008;Markučiai;ZUIKUČIŲ;8649978914;Ne;8;0;4;12
5009;Markučiai;ZUIKUČIŲ;6415773081;Ne;2;3;2;7
5010;Markučiai;ZUIKUČIŲ;5027052978;Ne;9;0;2;11
5011;Markučiai;ZUIKUČIŲ;6747211291;Ne;8;0;4;12
5012;Markučiai;ZUIKUČIŲ;8921802809;Ne;6;0;5;11
5013;Markučiai;ZUIKUČIŲ;8811544042;Ne;0;10;6;16
5014;Markučiai;ZUIKUČIŲ;7307805203;Ne;8;0;4;12
5015;Markučiai;ZUIKUČIŲ;6385023139;Ne;7;3;4;14
5016;Markučiai;ZUIKUČIŲ;8661268341;Ne;5;4;6;15
5017;Markučiai;ZUIKUČIŲ;1632196228;Ne;4;0;5;9
5018;Markučiai;ZUIKUČIŲ;7704433720;Ne;9;0;2;11
5019;Markučiai;ZUIKUČIŲ;2937486382;Ne;6;0;2;8
5020;Markučiai;ZUIKUČIŲ;9746041097;Ne;3;0;2;5
5021;Markučiai;ŽIOGELIŲ;3859363657;Ne;1;1;6;8
5022;Markučiai;ŽIOGELIŲ;3306931221;Ne;1;2;3;6
5023;Markučiai;ŽIOGELIŲ;9249362647;Ne;3;0;4;7
5024;Markučiai;ŽIOGELIŲ;7425442727;Ne;8;0;4;12
5025;Markučiai;ŽIOGELIŲ;6293219533;Ne;3;2;5;10
5026;Markučiai;ŽIOGELIŲ;9395009057;Ne;8;0;6;14
5027;Markučiai;ŽIOGELIŲ;4306059458;Ne;2;0;2;4
5028;Markučiai;ŽIOGELIŲ;5934853242;Ne;7;0;2;9
5029;Markučiai;ŽIOGELIŲ;8489604005;Ne;0;1;4;5
5030;Markučiai;ŽIOGELIŲ;1989450429;Ne;1;1;6;8
5031;Markučiai;ŽIOGELIŲ;6469869116;Ne;15;1;4;20
5032;Markučiai;ŽIOGELIŲ;7299207983;Taip;9;2;4;15
5033;Markučiai;ŽIOGELIŲ;5429666204;Ne;12;0;4;16
5034;Markučiai;ŽIOGELIŲ;4590625976;Ne;5;0;7;12
5035;Markučiai;Ežiukių;5474990334;Ne;0;22;0;22
5036;Markučiai;Ežiukių;4829322890;Ne;16;0;4;20
5037;Markučiai;Ežiukių;8045995558;Ne;11;0;6;17
5038;Markučiai;Ežiukių;9448972984;Ne;3;0;2;5
5039;Markučiai;Ežiukių;9462937261;Ne;4;0;9;13
5040;Markučiai;Ežiukių;2109460312;Ne;20;0;2;22
5041;Markučiai;Ežiukių;8085781929;Ne;0;0;2;2
5042;Markučiai;Ežiukių;2222934026;Ne;8;0;4;12
5043;Markučiai;Ežiukių;7266459848;Ne;1;2;6;9
5044;Markučiai;Ežiukių;3942674807;Ne;0;0;5;5
5045;Markučiai;Ežiukių;8338320308;Ne;0;0;5;5
5046;Markučiai;Ežiukių;1376430548;Ne;1;0;5;6
5047;Markučiai;Ežiukių;8670849222;Ne;0;3;4;7
5048;Mažylis;"2 DARŽELIO GR.";4639389587;Ne;7;0;5;12
5049;Mažylis;"2 DARŽELIO GR.";1500475643;Ne;4;0;1;5
5050;Mažylis;"2 DARŽELIO GR.";8259994523;Ne;0;0;1;1
5051;Mažylis;"2 DARŽELIO GR.";4347489809;Ne;0;0;3;3
5052;Mažylis;"2 DARŽELIO GR.";5297935198;Ne;5;1;3;9
5053;Mažylis;"2 DARŽELIO GR.";1993916098;Ne;2;0;0;2
5054;Mažylis;"2 DARŽELIO GR.";4309902086;Ne;0;0;1;1
5055;Mažylis;"2 DARŽELIO GR.";5727207294;Ne;0;0;1;1
5056;Mažylis;"2 DARŽELIO GR.";8871998701;Ne;3;2;7;12
5057;Mažylis;"2 DARŽELIO GR.";3064367996;Ne;0;10;0;10
5058;Mažylis;"2 DARŽELIO GR.";6500577246;Ne;0;0;2;2
5059;Mažylis;"2 DARŽELIO GR.";4557902728;Ne;15;0;2;17
5060;Mažylis;"2 DARŽELIO GR.";3098913589;Ne;4;0;5;9
5061;Mažylis;"2 DARŽELIO GR.";4201114033;Ne;0;0;1;1
5062;Mažylis;"2 DARŽELIO GR.";2110320072;Ne;0;2;0;2
5063;Mažylis;"2 DARŽELIO GR.";7810360699;Ne;13;0;4;17
5064;Mažylis;"2 DARŽELIO GR.";3911343193;Ne;0;5;3;8
5065;Mažylis;"4 PRIEŠMOKYKLINĖ GR.";2979849055;Ne;0;0;2;2
5066;Mažylis;"4 PRIEŠMOKYKLINĖ GR.";6162880220;Ne;0;2;4;6
5067;Mažylis;"4 PRIEŠMOKYKLINĖ GR.";6009637985;Ne;0;0;3;3
5068;Mažylis;"4 PRIEŠMOKYKLINĖ GR.";1762105763;Ne;3;2;5;10
5069;Mažylis;"4 PRIEŠMOKYKLINĖ GR.";2672500259;Ne;0;0;7;7
5070;Mažylis;"4 PRIEŠMOKYKLINĖ GR.";2935175014;Ne;13;0;3;16
5071;Mažylis;"4 PRIEŠMOKYKLINĖ GR.";8135596731;Ne;3;0;2;5
5072;Mažylis;"4 PRIEŠMOKYKLINĖ GR.";8866980930;Ne;0;1;0;1
5073;Mažylis;"4 PRIEŠMOKYKLINĖ GR.";2704741847;Ne;0;3;3;6
5074;Mažylis;"4 PRIEŠMOKYKLINĖ GR.";8297427176;Ne;2;0;0;2
5075;Mažylis;"4 PRIEŠMOKYKLINĖ GR.";5870983755;Ne;0;0;1;1
5076;Mažylis;"4 PRIEŠMOKYKLINĖ GR.";3327673298;Ne;0;6;2;8
5077;Mažylis;"4 PRIEŠMOKYKLINĖ GR.";5685988186;Ne;0;2;0;2
5078;Mažylis;"4 PRIEŠMOKYKLINĖ GR.";4280547746;Ne;1;2;3;6
5079;Mažylis;"4 PRIEŠMOKYKLINĖ GR.";9447747294;Ne;0;2;5;7
5080;Mažylis;"4 PRIEŠMOKYKLINĖ GR.";4542742002;Ne;0;0;4;4
5081;Mažylis;"4 PRIEŠMOKYKLINĖ GR.";4553092508;Ne;0;0;2;2
5082;Mažylis;"4 PRIEŠMOKYKLINĖ GR.";2031457519;Ne;0;2;3;5
5083;Mažylis;"4 PRIEŠMOKYKLINĖ GR.";5102030168;Ne;1;0;0;1
5084;Mažylis;"4 PRIEŠMOKYKLINĖ GR.";3308427647;Ne;0;2;1;3
5085;Mažylis;"4 PRIEŠMOKYKLINĖ GR.";7923522942;Ne;0;0;4;4
5086;Mažylis;"3 DARŽELIO GR.";9401388775;Ne;0;0;2;2
5087;Mažylis;"3 DARŽELIO GR.";4817146074;Ne;5;2;2;9
5088;Mažylis;"3 DARŽELIO GR.";7106648054;Ne;0;5;0;5
5089;Mažylis;"3 DARŽELIO GR.";6809320247;Ne;0;1;9;10
5090;Mažylis;"3 DARŽELIO GR.";7652390515;Ne;0;0;7;7
5091;Mažylis;"3 DARŽELIO GR.";8639480781;Ne;0;2;0;2
5092;Mažylis;"3 DARŽELIO GR.";9341935211;Ne;6;0;7;13
5093;Mažylis;"3 DARŽELIO GR.";2989562406;Ne;3;0;4;7
5094;Mažylis;"3 DARŽELIO GR.";1151737098;Ne;13;2;2;17
5095;Mažylis;"3 DARŽELIO GR.";7642914458;Ne;4;3;4;11
5096;Mažylis;"3 DARŽELIO GR.";5938312001;Ne;0;0;2;2
5097;Mažylis;"3 DARŽELIO GR.";2119733659;Ne;0;0;1;1
5098;Mažylis;"3 DARŽELIO GR.";2319506343;Ne;2;2;4;8
5099;Mažylis;"3 DARŽELIO GR.";9416161833;Ne;2;0;3;5
5100;Mažylis;"3 DARŽELIO GR.";9807376076;Ne;0;7;0;7
5101;Mažylis;"3 DARŽELIO GR.";4592795281;Ne;10;0;5;15
5102;Mažylis;"3 DARŽELIO GR.";8999239172;Ne;0;2;0;2
5103;Mažylis;"6 DARŽELIO GR.";5388105083;Ne;0;7;2;9
5104;Mažylis;"6 DARŽELIO GR.";8589124394;Ne;0;0;1;1
5105;Mažylis;"6 DARŽELIO GR.";3641990617;Ne;0;0;2;2
5106;Mažylis;"6 DARŽELIO GR.";1892136590;Ne;0;2;0;2
5107;Mažylis;"6 DARŽELIO GR.";9479398581;Ne;8;2;2;12
5108;Mažylis;"6 DARŽELIO GR.";1381828313;Ne;0;0;3;3
5109;Mažylis;"6 DARŽELIO GR.";7725286603;Ne;0;2;4;6
5110;Mažylis;"6 DARŽELIO GR.";3615636349;Ne;0;0;4;4
5111;Mažylis;"6 DARŽELIO GR.";9894955253;Ne;0;0;6;6
5112;Mažylis;"6 DARŽELIO GR.";3400122626;Ne;0;6;2;8
5113;Mažylis;"6 DARŽELIO GR.";6270840529;Ne;15;0;7;22
5114;Mažylis;"6 DARŽELIO GR.";4100492642;Ne;0;0;5;5
5115;Mažylis;"6 DARŽELIO GR.";6492768766;Ne;4;0;5;9
5116;Mažylis;"6 DARŽELIO GR.";1555305826;Ne;0;2;11;13
5117;Mažylis;"6 DARŽELIO GR.";5977423702;Ne;3;0;2;5
5118;Mažylis;"6 DARŽELIO GR.";9562863405;Ne;2;0;7;9
5119;Mažylis;"6 DARŽELIO GR.";9981751097;Ne;0;0;4;4
5120;Mažylis;"6 DARŽELIO GR.";5137132420;Ne;11;4;2;17
5121;Mažylis;"1 NAUJA (LOPŠELIS)";1233510409;Ne;4;0;3;7
5122;Mažylis;"1 NAUJA (LOPŠELIS)";4688933880;Ne;1;7;2;10
5123;Mažylis;"1 NAUJA (LOPŠELIS)";6441787213;Ne;4;0;5;9
5124;Mažylis;"1 NAUJA (LOPŠELIS)";1578050891;Ne;4;0;3;7
5125;Mažylis;"1 NAUJA (LOPŠELIS)";4828287511;Ne;0;0;9;9
5126;Mažylis;"1 NAUJA (LOPŠELIS)";8084695989;Ne;0;0;7;7
5127;Mažylis;"1 NAUJA (LOPŠELIS)";9416048380;Ne;1;0;4;5
5128;Mažylis;"1 NAUJA (LOPŠELIS)";2159387617;Ne;0;0;5;5
5129;Mažylis;"1 NAUJA (LOPŠELIS)";1174743283;Ne;0;0;5;5
5130;Mažylis;"1 NAUJA (LOPŠELIS)";3898781037;Ne;0;2;15;17
5131;Mažylis;"1 NAUJA (LOPŠELIS)";7940550309;Ne;0;0;6;6
5132;Mažylis;"1 NAUJA (LOPŠELIS)";2331014727;Ne;0;0;8;8
5133;Mažylis;"1 NAUJA (LOPŠELIS)";4373022569;Ne;0;0;2;2
5134;Mažylis;"1 NAUJA (LOPŠELIS)";9436368612;Ne;0;0;5;5
5135;Mažylis;"5 DARŽELIO GR.";8655053217;Ne;5;0;2;7
5136;Mažylis;"5 DARŽELIO GR.";1058725505;Ne;7;2;2;11
5137;Mažylis;"5 DARŽELIO GR.";1219174313;Ne;10;0;2;12
5138;Mažylis;"5 DARŽELIO GR.";9111101357;Ne;12;0;3;15
5139;Mažylis;"5 DARŽELIO GR.";6728351360;Ne;1;0;0;1
5140;Mažylis;"5 DARŽELIO GR.";6272047137;Ne;5;0;3;8
5141;Mažylis;"5 DARŽELIO GR.";7255856938;Ne;2;0;7;9
5142;Mažylis;"5 DARŽELIO GR.";2795618410;Ne;0;2;3;5
5143;Mažylis;"5 DARŽELIO GR.";4987487972;Ne;13;0;3;16
5144;Mažylis;"5 DARŽELIO GR.";9727982334;Ne;4;0;4;8
5145;Mažylis;"5 DARŽELIO GR.";2723677422;Ne;2;0;5;7
5146;Mažylis;"5 DARŽELIO GR.";7252955092;Ne;10;0;6;16
5147;Mažylis;"5 DARŽELIO GR.";3072841295;Ne;6;0;3;9
5148;Mažylis;"5 DARŽELIO GR.";4796712246;Ne;0;0;5;5
5149;Mažylis;"5 DARŽELIO GR.";7933156766;Ne;0;6;2;8
5150;Mažylis;"5 DARŽELIO GR.";7419432731;Ne;2;0;2;4
5151;Mažylis;"5 DARŽELIO GR.";2425437724;Ne;0;0;9;9
5152;Medynėlis;BITUTĖS;6238256156;Ne;0;5;0;5
5153;Medynėlis;BITUTĖS;8711567312;Ne;0;0;6;6
5154;Medynėlis;BITUTĖS;2993705115;Ne;0;4;2;6
5155;Medynėlis;BITUTĖS;1504612730;Ne;0;6;0;6
5156;Medynėlis;BITUTĖS;5522261530;Ne;3;3;4;10
5157;Medynėlis;BITUTĖS;6576401514;Ne;3;0;1;4
5158;Medynėlis;BITUTĖS;4107846958;Taip;0;4;3;7
5159;Medynėlis;BITUTĖS;7296044569;Ne;8;1;4;13
5160;Medynėlis;BITUTĖS;4418330478;Ne;8;0;2;10
5161;Medynėlis;BITUTĖS;6074296305;Ne;0;2;0;2
5162;Medynėlis;BITUTĖS;6815521895;Ne;0;2;0;2
5163;Medynėlis;BITUTĖS;4374464298;Ne;0;2;3;5
5164;Medynėlis;BITUTĖS;8107171123;Ne;2;3;2;7
5165;Medynėlis;BITUTĖS;4545707752;Ne;4;0;4;8
5166;Medynėlis;BITUTĖS;4419503239;Ne;0;5;0;5
5167;Medynėlis;BITUTĖS;7870261906;Ne;0;3;2;5
5168;Medynėlis;BITUTĖS;6466874318;Ne;2;2;2;6
5169;Medynėlis;BITUTĖS;2798305000;Ne;0;2;0;2
5170;Medynėlis;BITUTĖS;4598267411;Ne;1;2;2;5
5171;Medynėlis;BITUTĖS;5194220650;Ne;8;7;2;17
5172;Medynėlis;BITUTĖS;4243521511;Ne;0;2;0;2
5173;Medynėlis;DRUGELIAI;9670396828;Ne;4;0;2;6
5174;Medynėlis;DRUGELIAI;5551121950;Ne;3;1;2;6
5175;Medynėlis;DRUGELIAI;2627421550;Ne;0;2;0;2
5176;Medynėlis;DRUGELIAI;2794274146;Ne;0;4;0;4
5177;Medynėlis;DRUGELIAI;2932544910;Ne;0;2;0;2
5178;Medynėlis;DRUGELIAI;9079900803;Ne;0;3;0;3
5179;Medynėlis;DRUGELIAI;9355165862;Ne;0;2;0;2
5180;Medynėlis;DRUGELIAI;9184868565;Ne;0;2;0;2
5181;Medynėlis;DRUGELIAI;6706028300;Ne;0;2;0;2
5182;Medynėlis;DRUGELIAI;6955467123;Ne;0;2;0;2
5183;Medynėlis;DRUGELIAI;5785463517;Ne;0;2;0;2
5184;Medynėlis;DRUGELIAI;4468967036;Ne;0;2;0;2
5185;Medynėlis;DRUGELIAI;9438854582;Ne;2;2;2;6
5186;Medynėlis;DRUGELIAI;1901805808;Ne;0;2;0;2
5187;Medynėlis;DRUGELIAI;5784691118;Ne;0;2;0;2
5188;Medynėlis;DRUGELIAI;3856908872;Ne;0;2;0;2
5189;Medynėlis;DRUGELIAI;5158507933;Ne;5;0;2;7
5190;Medynėlis;DRUGELIAI;7501831333;Ne;0;2;0;2
5191;Medynėlis;DRUGELIAI;2097758483;Ne;0;5;0;5
5192;Medynėlis;DRUGELIAI;4267654911;Ne;0;6;0;6
5193;Medynėlis;SKRUZDĖLIUKAI;2218838971;Ne;0;0;3;3
5194;Medynėlis;SKRUZDĖLIUKAI;1206480760;Ne;8;0;2;10
5195;Medynėlis;SKRUZDĖLIUKAI;3790099536;Ne;8;0;2;10
5196;Medynėlis;SKRUZDĖLIUKAI;9336656351;Ne;3;0;3;6
5197;Medynėlis;SKRUZDĖLIUKAI;7085226543;Ne;0;0;4;4
5198;Medynėlis;SKRUZDĖLIUKAI;5049081242;Ne;2;0;3;5
5199;Medynėlis;SKRUZDĖLIUKAI;4910857912;Ne;0;1;0;1
5200;Medynėlis;SKRUZDĖLIUKAI;6824842361;Ne;2;0;2;4
5201;Medynėlis;SKRUZDĖLIUKAI;1283602655;Ne;1;2;2;5
5202;Medynėlis;SKRUZDĖLIUKAI;4817353132;Ne;4;0;2;6
5203;Medynėlis;SKRUZDĖLIUKAI;7613699868;Ne;6;0;2;8
5204;Medynėlis;SKRUZDĖLIUKAI;3556203620;Ne;4;1;6;11
5205;Medynėlis;SKRUZDĖLIUKAI;4626655069;Ne;0;3;0;3
5206;Medynėlis;SKRUZDĖLIUKAI;6896823412;Ne;0;2;0;2
5207;Medynėlis;SKRUZDĖLIUKAI;5677747582;Ne;0;4;0;4
5208;Medynėlis;SKRUZDĖLIUKAI;3480190692;Taip;2;0;2;4
5209;Medynėlis;SKRUZDĖLIUKAI;5581973770;Ne;8;0;4;12
5210;Medynėlis;VOVERIUKAI;8275097931;Ne;0;2;1;3
5211;Medynėlis;VOVERIUKAI;1026253778;Ne;13;0;2;15
5212;Medynėlis;VOVERIUKAI;2523474347;Ne;0;5;0;5
5213;Medynėlis;VOVERIUKAI;5302122600;Ne;5;0;6;11
5214;Medynėlis;VOVERIUKAI;6609111216;Ne;4;0;7;11
5215;Medynėlis;VOVERIUKAI;6624835214;Ne;6;1;2;9
5216;Medynėlis;VOVERIUKAI;2160081492;Ne;7;5;2;14
5217;Medynėlis;VOVERIUKAI;4035587227;Ne;8;2;3;13
5218;Medynėlis;VOVERIUKAI;8162771849;Ne;7;0;8;15
5219;Medynėlis;VOVERIUKAI;9725019515;Ne;0;0;2;2
5220;Medynėlis;VOVERIUKAI;3185760752;Ne;1;0;4;5
5221;Medynėlis;VOVERIUKAI;1404831377;Ne;10;0;2;12
5222;Medynėlis;VOVERIUKAI;7814008588;Ne;7;0;5;12
5223;Medynėlis;VOVERIUKAI;5610660982;Ne;7;2;2;11
5224;Medynėlis;VOVERIUKAI;6282113738;Ne;0;3;0;3
5225;Medynėlis;VOVERIUKAI;4153545500;Ne;3;2;2;7
5226;Medynėlis;VOVERIUKAI;8299034970;Ne;2;5;2;9
5227;Medynėlis;VOVERIUKAI;7675101600;Ne;0;2;0;2
5228;Medynėlis;VOVERIUKAI;1668143166;Ne;10;2;5;17
5229;Medynėlis;VOVERIUKAI;1608019909;Ne;6;0;2;8
5230;Medynėlis;VOVERIUKAI;4010058673;Ne;7;0;2;9
5231;Medynėlis;VOVERIUKAI;6502531749;Taip;11;0;5;16
5232;Medynėlis;VOVERIUKAI;9076139419;Ne;0;0;3;3
5233;Medynėlis;MEŠKIUKAI;7140184593;Ne;3;0;3;6
5234;Medynėlis;MEŠKIUKAI;3365026025;Ne;2;4;2;8
5235;Medynėlis;MEŠKIUKAI;4488439037;Ne;3;2;4;9
5236;Medynėlis;MEŠKIUKAI;4100792567;Ne;0;2;1;3
5237;Medynėlis;MEŠKIUKAI;6101613567;Ne;0;2;0;2
5238;Medynėlis;MEŠKIUKAI;1056744101;Ne;0;3;4;7
5239;Medynėlis;MEŠKIUKAI;6485314750;Ne;1;2;3;6
5240;Medynėlis;MEŠKIUKAI;7455041214;Ne;0;1;0;1
5241;Medynėlis;MEŠKIUKAI;5028189785;Ne;0;0;2;2
5242;Medynėlis;MEŠKIUKAI;3761845905;Ne;0;2;1;3
5243;Medynėlis;MEŠKIUKAI;9825580191;Ne;0;2;0;2
5244;Medynėlis;MEŠKIUKAI;7272017225;Ne;0;5;0;5
5245;Medynėlis;MEŠKIUKAI;2784942324;Ne;0;2;0;2
5246;Medynėlis;MEŠKIUKAI;4092824377;Ne;4;2;2;8
5247;Medynėlis;MEŠKIUKAI;1475701065;Ne;0;2;0;2
5248;Medynėlis;MEŠKIUKAI;3674134340;Ne;0;3;0;3
5249;Medynėlis;MEŠKIUKAI;4645171858;Ne;2;3;3;8
5250;Medynėlis;MEŠKIUKAI;6107849795;Ne;2;2;3;7
5251;Medynėlis;PELĖDŽIUKAI;4222917765;Ne;0;2;0;2
5252;Medynėlis;PELĖDŽIUKAI;1621499650;Ne;0;2;0;2
5253;Medynėlis;PELĖDŽIUKAI;6681155625;Ne;0;2;0;2
5254;Medynėlis;PELĖDŽIUKAI;2702814930;Ne;0;0;3;3
5255;Medynėlis;PELĖDŽIUKAI;6211076154;Ne;8;0;2;10
5256;Medynėlis;PELĖDŽIUKAI;5658868407;Ne;2;1;7;10
5257;Medynėlis;PELĖDŽIUKAI;6975191449;Ne;18;0;2;20
5258;Medynėlis;PELĖDŽIUKAI;3905440176;Ne;0;0;2;2
5259;Medynėlis;PELĖDŽIUKAI;8441629302;Ne;3;3;3;9
5260;Medynėlis;PELĖDŽIUKAI;4783894465;Ne;0;13;4;17
5261;Medynėlis;PELĖDŽIUKAI;3761140697;Ne;12;0;4;16
5262;Medynėlis;PELĖDŽIUKAI;5330900656;Ne;12;0;3;15
5263;Medynėlis;PELĖDŽIUKAI;1142044361;Taip;1;3;4;8
5264;Medynėlis;PELĖDŽIUKAI;8719860414;Ne;0;0;2;2
5265;Medynėlis;PELĖDŽIUKAI;4897227188;Ne;9;2;5;16
5266;Medynėlis;PELĖDŽIUKAI;9873696787;Taip;7;0;9;16
5267;Medynėlis;PELĖDŽIUKAI;6802308420;Ne;0;3;0;3
5268;Medynėlis;PELĖDŽIUKAI;2339692406;Ne;12;0;2;14
5269;Medynėlis;PELĖDŽIUKAI;3947494044;Ne;0;3;4;7
5270;Medynėlis;PELĖDŽIUKAI;3295727210;Ne;3;2;2;7
5271;Medynėlis;PELĖDŽIUKAI;2234994999;Taip;2;0;2;4
5272;Medynėlis;BORUŽIUKAI;6622963662;Ne;1;0;1;2
5273;Medynėlis;BORUŽIUKAI;3638155321;Ne;0;3;1;4
5274;Medynėlis;BORUŽIUKAI;9290099536;Taip;3;2;2;7
5275;Medynėlis;BORUŽIUKAI;1500986498;Ne;2;0;0;2
5276;Medynėlis;BORUŽIUKAI;6924524346;Ne;0;8;0;8
5277;Medynėlis;BORUŽIUKAI;2877881247;Ne;0;9;0;9
5278;Medynėlis;BORUŽIUKAI;3709984586;Ne;8;0;2;10
5279;Medynėlis;BORUŽIUKAI;6470879334;Ne;0;1;1;2
5280;Medynėlis;BORUŽIUKAI;2379829985;Ne;4;2;3;9
5281;Medynėlis;BORUŽIUKAI;4145591997;Ne;0;2;0;2
5282;Medynėlis;BORUŽIUKAI;6926408544;Ne;1;0;2;3
5283;Medynėlis;BORUŽIUKAI;5391199861;Ne;0;2;2;4
5284;Medynėlis;BORUŽIUKAI;9485498942;Ne;0;2;0;2
5285;Medynėlis;BORUŽIUKAI;6095795724;Ne;0;2;2;4
5286;Medynėlis;BORUŽIUKAI;7914358405;Ne;0;2;0;2
5287;Medynėlis;BORUŽIUKAI;7695626630;Ne;0;2;0;2
5288;Medynėlis;BORUŽIUKAI;2816510180;Ne;0;0;2;2
5289;Medynėlis;BORUŽIUKAI;3538656650;Ne;0;10;0;10
5290;Medynėlis;BORUŽIUKAI;6993176904;Ne;0;2;0;2
5291;Medynėlis;BORUŽIUKAI;5389909872;Ne;3;0;1;4
5292;Medynėlis;BORUŽIUKAI;9418978658;Ne;2;0;0;2
5293;Medynėlis;BORUŽIUKAI;9705185906;Ne;1;2;2;5
5294;Medynėlis;EŽIUKAI;9729505759;Ne;2;0;2;4
5295;Medynėlis;EŽIUKAI;8125271445;Taip;3;6;2;11
5296;Medynėlis;EŽIUKAI;9847006679;Ne;3;0;3;6
5297;Medynėlis;EŽIUKAI;7317307957;Ne;3;2;3;8
5298;Medynėlis;EŽIUKAI;7860869675;Ne;5;10;1;16
5299;Medynėlis;EŽIUKAI;4471168173;Taip;0;2;2;4
5300;Medynėlis;EŽIUKAI;1062269215;Ne;5;2;2;9
5301;Medynėlis;EŽIUKAI;5197757730;Ne;4;0;3;7
5302;Medynėlis;EŽIUKAI;5333502849;Ne;0;2;2;4
5303;Medynėlis;EŽIUKAI;6536626390;Ne;5;0;5;10
5304;Medynėlis;EŽIUKAI;8953622684;Ne;0;3;0;3
5305;Medynėlis;EŽIUKAI;3230747109;Ne;5;3;4;12
5306;Medynėlis;EŽIUKAI;9175884049;Taip;0;0;1;1
5307;Medynėlis;EŽIUKAI;8609650186;Ne;8;0;2;10
5308;Medynėlis;EŽIUKAI;6826409129;Ne;8;0;2;10
5309;Medynėlis;EŽIUKAI;2929100410;Ne;1;2;2;5
5310;Medynėlis;EŽIUKAI;6359536923;Taip;4;0;4;8
5311;Medynėlis;EŽIUKAI;2676262920;Ne;22;0;0;22
5312;Medynėlis;EŽIUKAI;5339084041;Taip;12;0;2;14
5313;Medynėlis;EŽIUKAI;5766492584;Ne;2;0;0;2
5314;Medynėlis;EŽIUKAI;6561927001;Ne;3;2;2;7
5315;Medynėlis;EŽIUKAI;8838774666;Taip;5;12;2;19
5316;Medynėlis;EŽIUKAI;6349817783;Ne;3;0;0;3
5317;Medynėlis;ZUIKUČIAI;9857514451;Ne;7;0;6;13
5318;Medynėlis;ZUIKUČIAI;4498233742;Ne;0;0;7;7
5319;Medynėlis;ZUIKUČIAI;6641009653;Ne;8;1;4;13
5320;Medynėlis;ZUIKUČIAI;6730475188;Ne;3;1;2;6
5321;Medynėlis;ZUIKUČIAI;2896713695;Ne;0;0;3;3
5322;Medynėlis;ZUIKUČIAI;2512917914;Ne;5;0;4;9
5323;Medynėlis;ZUIKUČIAI;6888812634;Ne;7;0;1;8
5324;Medynėlis;ZUIKUČIAI;8904493539;Ne;1;0;0;1
5325;Medynėlis;ZUIKUČIAI;1260839046;Ne;4;0;4;8
5326;Medynėlis;ZUIKUČIAI;8542591286;Ne;6;0;4;10
5327;Medynėlis;ZUIKUČIAI;7312016138;Ne;18;0;2;20
5328;Medynėlis;ZUIKUČIAI;6847727830;Ne;6;0;3;9
5329;Medynėlis;ZUIKUČIAI;3048797634;Ne;0;10;0;10
5330;Medynėlis;KAČIUKAI;2735961000;Ne;10;0;4;14
5331;Medynėlis;KAČIUKAI;3187000487;Ne;3;2;2;7
5332;Medynėlis;KAČIUKAI;3079549158;Ne;6;0;2;8
5333;Medynėlis;KAČIUKAI;1616551970;Ne;7;0;2;9
5334;Medynėlis;KAČIUKAI;7737665102;Ne;4;0;2;6
5335;Medynėlis;KAČIUKAI;1840127319;Ne;10;0;4;14
5336;Medynėlis;KAČIUKAI;2259408744;Ne;10;0;6;16
5337;Medynėlis;KAČIUKAI;5096386323;Ne;9;0;2;11
5338;Medynėlis;KAČIUKAI;2322666023;Ne;5;0;5;10
5339;Medynėlis;KAČIUKAI;9352913210;Ne;0;5;0;5
5340;Medynėlis;KAČIUKAI;4328794578;Ne;3;0;2;5
5341;Medynėlis;KAČIUKAI;9389418983;Ne;9;0;6;15
5342;Medynėlis;KAČIUKAI;2032064340;Ne;0;0;1;1
5343;Medynėlis;KAČIUKAI;2507106460;Taip;2;0;3;5
5344;Medynėlis;KAČIUKAI;8879923257;Ne;2;0;2;4
5345;Medynėlis;KAČIUKAI;7488521058;Ne;3;5;2;10
5346;Medynėlis;KAČIUKAI;8382537735;Ne;0;0;2;2
5347;Medynėlis;KAČIUKAI;7268418306;Ne;0;2;1;3
5348;Medynėlis;KAČIUKAI;2028112718;Ne;5;0;3;8
5349;Medynėlis;PELIUKAI;6614028601;Ne;2;0;5;7
5350;Medynėlis;PELIUKAI;8439619837;Ne;0;2;0;2
5351;Medynėlis;PELIUKAI;9352391583;Ne;6;2;3;11
5352;Medynėlis;PELIUKAI;4040542730;Ne;0;10;0;10
5353;Medynėlis;PELIUKAI;6989524053;Ne;0;2;3;5
5354;Medynėlis;PELIUKAI;9774213537;Ne;0;2;2;4
5355;Medynėlis;PELIUKAI;7129951535;Ne;2;0;4;6
5356;Medynėlis;PELIUKAI;9977590259;Ne;3;1;7;11
5357;Medynėlis;PELIUKAI;7170801214;Ne;3;4;2;9
5358;Medynėlis;PELIUKAI;9373849916;Ne;3;0;3;6
5359;Medynėlis;PELIUKAI;8678054784;Ne;0;2;0;2
5360;Medynėlis;PELIUKAI;6569938649;Ne;0;0;1;1
5361;Medynėlis;PELIUKAI;6462589513;Ne;0;2;1;3
5362;Medynėlis;PELIUKAI;4204366008;Ne;0;3;0;3
5363;Medynėlis;PELIUKAI;3348520838;Ne;0;3;0;3
5364;Medynėlis;PELIUKAI;4444555055;Ne;0;0;5;5
5365;Medynėlis;PELIUKAI;2231990831;Ne;1;0;4;5
5366;Medynėlis;PELIUKAI;8887092965;Ne;8;1;2;11
5367;Medynėlis;PELIUKAI;3299495310;Ne;0;2;4;6
5368;Medynėlis;ANČIUKAI;8175602822;Ne;0;1;0;1
5369;Medynėlis;ANČIUKAI;9536473088;Ne;0;6;0;6
5370;Medynėlis;ANČIUKAI;2409824337;Ne;2;0;0;2
5371;Medynėlis;ANČIUKAI;4006434252;Ne;5;0;2;7
5372;Medynėlis;ANČIUKAI;8994120910;Ne;10;0;3;13
5373;Medynėlis;ANČIUKAI;6948059114;Ne;10;0;3;13
5374;Medynėlis;ANČIUKAI;9288258906;Ne;3;4;2;9
5375;Medynėlis;ANČIUKAI;4869007055;Ne;15;0;2;17
5376;Medynėlis;ANČIUKAI;9025913427;Ne;15;0;2;17
5377;Medynėlis;ANČIUKAI;7661220337;Ne;4;0;3;7
5378;Medynėlis;ANČIUKAI;3739441317;Ne;6;0;4;10
5379;Medynėlis;ANČIUKAI;6208391418;Ne;0;0;2;2
5380;Medynėlis;ANČIUKAI;1936512553;Ne;0;3;2;5
5381;Medynėlis;ANČIUKAI;1864754712;Ne;19;0;2;21
5382;Molinukas;NYKŠTUKAI;4974513900;Ne;0;2;2;4
5383;Molinukas;NYKŠTUKAI;8313486714;Ne;3;1;2;6
5384;Molinukas;NYKŠTUKAI;8608465121;Ne;4;7;2;13
5385;Molinukas;NYKŠTUKAI;1826463800;Ne;1;2;2;5
5386;Molinukas;NYKŠTUKAI;3043679624;Ne;6;2;4;12
5387;Molinukas;NYKŠTUKAI;4992887072;Ne;3;0;2;5
5388;Molinukas;NYKŠTUKAI;8769667823;Ne;12;0;2;14
5389;Molinukas;NYKŠTUKAI;1651103318;Ne;0;0;1;1
5390;Molinukas;NYKŠTUKAI;1970929144;Ne;0;2;0;2
5391;Molinukas;NYKŠTUKAI;1292778118;Ne;0;0;1;1
5392;Molinukas;NYKŠTUKAI;3510936830;Ne;3;2;4;9
5393;Molinukas;NYKŠTUKAI;1907287249;Ne;0;2;0;2
5394;Molinukas;NYKŠTUKAI;7825545164;Ne;7;0;4;11
5395;Molinukas;NYKŠTUKAI;6190443233;Ne;6;0;5;11
5396;Molinukas;NYKŠTUKAI;6531106368;Ne;10;0;2;12
5397;Molinukas;NYKŠTUKAI;4122429163;Ne;3;4;2;9
5398;Molinukas;NYKŠTUKAI;8660958288;Ne;2;1;2;5
5399;Molinukas;NYKŠTUKAI;2862680065;Ne;5;2;2;9
5400;Molinukas;NYKŠTUKAI;3382913312;Ne;0;0;12;12
5401;Molinukas;NYKŠTUKAI;3331982964;Ne;0;2;0;2
5402;Molinukas;NYKŠTUKAI;2842168450;Ne;2;2;4;8
5403;Molinukas;NYKŠTUKAI;4044289280;Ne;4;0;4;8
5404;Molinukas;ZUIKUČIŲ;9203375647;Ne;3;3;2;8
5405;Molinukas;ZUIKUČIŲ;2982968605;Ne;9;2;4;15
5406;Molinukas;ZUIKUČIŲ;8479427729;Ne;0;0;2;2
5407;Molinukas;ZUIKUČIŲ;4225457772;Ne;4;0;2;6
5408;Molinukas;ZUIKUČIŲ;8114735116;Ne;0;6;0;6
5409;Molinukas;ZUIKUČIŲ;5597119459;Ne;3;10;2;15
5410;Molinukas;ZUIKUČIŲ;8582985479;Ne;5;0;5;10
5411;Molinukas;ZUIKUČIŲ;8490020853;Ne;4;0;5;9
5412;Molinukas;ZUIKUČIŲ;2651732418;Ne;13;0;2;15
5413;Molinukas;ZUIKUČIŲ;8988478990;Ne;1;2;2;5
5414;Molinukas;ZUIKUČIŲ;1059002689;Ne;0;12;0;12
5415;Molinukas;ZUIKUČIŲ;5302191209;Ne;13;2;4;19
5416;Molinukas;ZUIKUČIŲ;1605039166;Ne;13;0;2;15
5417;Molinukas;ZUIKUČIŲ;6804127471;Ne;13;0;2;15
5418;Molinukas;ZUIKUČIŲ;2878262979;Ne;0;0;5;5
5419;Molinukas;ZUIKUČIŲ;7441251480;Ne;0;0;4;4
5420;Molinukas;ZUIKUČIŲ;4733315902;Ne;0;2;7;9
5421;Molinukas;ZUIKUČIŲ;2595941277;Ne;0;0;4;4
5422;Molinukas;ZUIKUČIŲ;2706981559;Ne;2;3;2;7
5423;Molinukas;ZUIKUČIŲ;6638634402;Ne;3;0;3;6
5424;Molinukas;ZUIKUČIŲ;3516132254;Ne;3;0;2;5
5425;Molinukas;ZUIKUČIŲ;4718396549;Ne;0;2;3;5
5426;Molinukas;ZUIKUČIŲ;3577613732;Ne;0;0;2;2
5427;Molinukas;ZUIKUČIŲ;9972204424;Ne;9;0;4;13
5428;Molinukas;ZUIKUČIŲ;3419958136;Ne;7;0;4;11
5429;Molinukas;ZUIKUČIŲ;2789279432;Ne;5;2;2;9
5430;Molinukas;SRAIGIUKŲ;4806350914;Ne;0;2;4;6
5431;Molinukas;SRAIGIUKŲ;2757744826;Ne;6;2;2;10
5432;Molinukas;SRAIGIUKŲ;7451224160;Ne;0;2;1;3
5433;Molinukas;SRAIGIUKŲ;4475594896;Ne;8;2;2;12
5434;Molinukas;SRAIGIUKŲ;2348120316;Ne;0;2;0;2
5435;Molinukas;SRAIGIUKŲ;7623051674;Ne;7;2;2;11
5436;Molinukas;SRAIGIUKŲ;9448910819;Ne;0;2;0;2
5437;Molinukas;SRAIGIUKŲ;4101644021;Ne;0;2;5;7
5438;Molinukas;SRAIGIUKŲ;1651650182;Ne;0;2;0;2
5439;Molinukas;SRAIGIUKŲ;5580968328;Ne;8;0;2;10
5440;Molinukas;SRAIGIUKŲ;6353165459;Ne;0;3;0;3
5441;Molinukas;SRAIGIUKŲ;9293819449;Ne;0;2;3;5
5442;Molinukas;SRAIGIUKŲ;8536615996;Ne;0;0;3;3
5443;Molinukas;SRAIGIUKŲ;6087698882;Ne;0;2;0;2
5444;Molinukas;SRAIGIUKŲ;7602239077;Ne;3;2;3;8
5445;Molinukas;SRAIGIUKŲ;4171978721;Ne;0;2;2;4
5446;Molinukas;SRAIGIUKŲ;6681397435;Ne;7;2;5;14
5447;Molinukas;SRAIGIUKŲ;5525772579;Ne;0;11;0;11
5448;Molinukas;SRAIGIUKŲ;5876669121;Ne;1;2;2;5
5449;Molinukas;SRAIGIUKŲ;8053608348;Ne;2;2;2;6
5450;Molinukas;SRAIGIUKŲ;6014990150;Ne;0;2;0;2
5451;Molinukas;VOVERIUKAI;3469196411;Ne;0;1;1;2
5452;Molinukas;VOVERIUKAI;4583155940;Ne;2;0;2;4
5453;Molinukas;VOVERIUKAI;8541456847;Ne;4;7;3;14
5454;Molinukas;VOVERIUKAI;2286586693;Ne;14;0;2;16
5455;Molinukas;VOVERIUKAI;9413396859;Ne;3;0;5;8
5456;Molinukas;VOVERIUKAI;6898958282;Ne;6;0;2;8
5457;Molinukas;VOVERIUKAI;4000190261;Ne;0;0;2;2
5458;Molinukas;VOVERIUKAI;5685582215;Ne;8;4;5;17
5459;Molinukas;VOVERIUKAI;2356814145;Ne;3;2;5;10
5460;Molinukas;VOVERIUKAI;7446607510;Ne;0;12;0;12
5461;Molinukas;VOVERIUKAI;9667704959;Ne;8;1;6;15
5462;Molinukas;VOVERIUKAI;8516451290;Ne;10;0;5;15
5463;Molinukas;VOVERIUKAI;3030169626;Ne;4;2;4;10
5464;Molinukas;VOVERIUKAI;4209143136;Ne;14;0;2;16
5465;Molinukas;VOVERIUKAI;5648861702;Ne;14;0;2;16
5466;Molinukas;VOVERIUKAI;4957226547;Ne;4;2;4;10
5467;Molinukas;VOVERIUKAI;8865966572;Ne;13;0;4;17
5468;Molinukas;VOVERIUKAI;4950808381;Ne;4;10;1;15
5469;Molinukas;VOVERIUKAI;7378643086;Ne;1;2;3;6
5470;Molinukas;VOVERIUKAI;2779700726;Ne;4;2;5;11
5471;Molinukas;VOVERIUKAI;6832647220;Ne;0;3;7;10
5472;Molinukas;VOVERIUKAI;9318837973;Ne;6;0;4;10
5473;Molinukas;VOVERIUKAI;8247270556;Ne;5;0;2;7
5474;Molinukas;ŽVIRBLIUKŲ;2935945686;Ne;0;2;7;9
5475;Molinukas;ŽVIRBLIUKŲ;2090783609;Ne;4;0;3;7
5476;Molinukas;ŽVIRBLIUKŲ;9850656596;Ne;0;0;10;10
5477;Molinukas;ŽVIRBLIUKŲ;7052683028;Ne;11;0;2;13
5478;Molinukas;ŽVIRBLIUKŲ;6324308817;Ne;0;2;0;2
5479;Molinukas;ŽVIRBLIUKŲ;8578781383;Ne;0;1;1;2
5480;Molinukas;ŽVIRBLIUKŲ;6006474519;Ne;18;2;2;22
5481;Molinukas;ŽVIRBLIUKŲ;1768984445;Ne;15;0;2;17
5482;Molinukas;ŽVIRBLIUKŲ;9936048965;Ne;3;1;2;6
5483;Molinukas;KAČIUKŲ;8973341322;Ne;1;0;2;3
5484;Molinukas;KAČIUKŲ;4356610282;Ne;4;0;9;13
5485;Molinukas;KAČIUKŲ;5166540248;Ne;4;0;3;7
5486;Molinukas;KAČIUKŲ;5834614345;Ne;4;0;3;7
5487;Molinukas;KAČIUKŲ;5665993086;Ne;0;1;0;1
5488;Molinukas;KAČIUKŲ;7349691727;Ne;0;6;0;6
5489;Molinukas;KAČIUKŲ;7192221243;Ne;0;2;0;2
5490;Molinukas;KAČIUKŲ;2866461509;Ne;11;0;3;14
5491;Molinukas;KAČIUKŲ;6096244346;Ne;2;0;4;6
5492;Molinukas;KAČIUKŲ;2537694744;Ne;4;0;3;7
5493;"Naminukas (Smėlio g. 13)";Drugeliai;6776805494;Ne;0;4;3;7
5494;"Naminukas (Smėlio g. 13)";Drugeliai;2395070574;Ne;0;6;2;8
5495;"Naminukas (Smėlio g. 13)";Drugeliai;5534073614;Ne;0;2;0;2
5496;"Naminukas (Smėlio g. 13)";Drugeliai;2132345627;Ne;0;3;1;4
5497;"Naminukas (Smėlio g. 13)";Drugeliai;1302119260;Ne;4;3;0;7
5498;"Naminukas (Smėlio g. 13)";Drugeliai;2864905392;Ne;2;7;0;9
5499;"Naminukas (Smėlio g. 13)";Drugeliai;7406775925;Ne;0;3;0;3
5500;"Naminukas (Smėlio g. 13)";Drugeliai;1333462200;Ne;0;2;3;5
5501;"Naminukas (Smėlio g. 13)";Drugeliai;5468218968;Ne;0;3;0;3
5502;"Naminukas (Smėlio g. 13)";Drugeliai;5713661641;Ne;0;4;1;5
5503;"Naminukas (Smėlio g. 13)";Drugeliai;6581925461;Ne;0;1;0;1
5504;"Naminukas (Smėlio g. 13)";Drugeliai;3320805432;Ne;0;1;1;2
5505;"Naminukas (Smėlio g. 13)";Drugeliai;9689866363;Ne;0;3;0;3
5506;"Naminukas (Smėlio g. 13)";Drugeliai;2198493034;Ne;8;0;2;10
5507;"Naminukas (Smėlio g. 13)";Drugeliai;8141324449;Ne;1;3;1;5
5508;"Naminukas (Smėlio g. 13)";Drugeliai;8564586014;Ne;10;2;2;14
5509;"Naminukas (Smėlio g. 13)";Drugeliai;3236525642;Ne;0;3;2;5
5510;"Naminukas (Smėlio g. 13)";Drugeliai;7347998152;Ne;0;4;0;4
5511;"Naminukas (Smėlio g. 13)";Drugeliai;7272465847;Ne;6;2;2;10
5512;"Naminukas (Smėlio g. 13)";Drugeliai;7471964981;Ne;10;3;0;13
5513;"Naminukas (Smėlio g. 13)";Drugeliai;8760638670;Ne;3;2;3;8
5514;"Naminukas (Smėlio g. 13)";Drugeliai;1648466517;Ne;0;3;0;3
5515;"Naminukas (Smėlio g. 13)";Bitutės;6057391542;Ne;8;3;3;14
5516;"Naminukas (Smėlio g. 13)";Bitutės;3546140753;Ne;5;0;2;7
5517;"Naminukas (Smėlio g. 13)";Bitutės;6351199828;Ne;0;2;0;2
5518;"Naminukas (Smėlio g. 13)";Bitutės;4624191456;Ne;10;0;4;14
5519;"Naminukas (Smėlio g. 13)";Bitutės;4671626416;Ne;10;5;1;16
5520;"Naminukas (Smėlio g. 13)";Bitutės;4941814027;Ne;0;2;1;3
5521;"Naminukas (Smėlio g. 13)";Bitutės;2179061425;Ne;0;3;0;3
5522;"Naminukas (Smėlio g. 13)";Bitutės;2270868598;Ne;0;1;0;1
5523;"Naminukas (Smėlio g. 13)";Bitutės;1095955939;Ne;0;3;0;3
5524;"Naminukas (Smėlio g. 13)";Bitutės;4422173848;Ne;13;0;4;17
5525;"Naminukas (Smėlio g. 13)";Bitutės;5741698937;Ne;0;4;0;4
5526;"Naminukas (Smėlio g. 13)";Bitutės;7717132979;Ne;0;9;0;9
5527;"Naminukas (Smėlio g. 13)";Bitutės;9357758815;Ne;0;0;2;2
5528;"Naminukas (Smėlio g. 13)";Bitutės;7807791056;Ne;0;2;6;8
5529;"Naminukas (Smėlio g. 13)";Bitutės;1217359876;Ne;0;7;0;7
5530;"Naminukas (Smėlio g. 13)";Bitutės;5465843371;Ne;8;0;2;10
5531;"Naminukas (Smėlio g. 13)";Bitutės;3550698982;Ne;0;2;3;5
5532;"Naminukas (Smėlio g. 13)";Paukšteliai;3501921619;Ne;0;3;0;3
5533;"Naminukas (Smėlio g. 13)";Paukšteliai;7297661383;Ne;0;2;0;2
5534;"Naminukas (Smėlio g. 13)";Paukšteliai;5056487802;Ne;0;4;0;4
5535;"Naminukas (Smėlio g. 13)";Paukšteliai;3438010199;Ne;6;0;7;13
5536;"Naminukas (Smėlio g. 13)";Paukšteliai;4998565160;Ne;0;9;0;9
5537;"Naminukas (Smėlio g. 13)";Paukšteliai;9405784626;Ne;0;2;5;7
5538;"Naminukas (Smėlio g. 13)";Paukšteliai;2583886896;Ne;0;4;0;4
5539;"Naminukas (Smėlio g. 13)";Paukšteliai;4778385421;Ne;0;1;10;11
5540;"Naminukas (Smėlio g. 13)";Paukšteliai;6178500478;Ne;0;2;0;2
5541;"Naminukas (Smėlio g. 13)";Paukšteliai;9440685520;Ne;0;2;0;2
5542;"Naminukas (Smėlio g. 13)";Paukšteliai;1406418130;Ne;1;0;6;7
5543;"Naminukas (Smėlio g. 13)";Paukšteliai;2012656186;Ne;0;0;3;3
5544;"Naminukas (Smėlio g. 13)";Paukšteliai;8470716196;Ne;0;2;1;3
5545;"Naminukas (Smėlio g. 13)";Paukšteliai;3727828033;Ne;0;2;0;2
5546;"Naminukas (Smėlio g. 13)";Paukšteliai;2652538212;Ne;0;2;1;3
5547;"Naminukas (Smėlio g. 13)";Paukšteliai;5280419144;Ne;3;1;2;6
5548;"Naminukas (Smėlio g. 13)";Paukšteliai;7107752795;Ne;0;4;0;4
5549;"Naminukas (Smėlio g. 13)";Paukšteliai;3018465520;Ne;2;7;2;11
5550;"Naminukas (Smėlio g. 13)";Paukšteliai;2551242973;Ne;0;2;2;4
5551;"Naminukas (Smėlio g. 13)";Paukšteliai;2113378945;Ne;5;4;0;9
5552;"Naminukas (Smėlio g. 13)";Paukšteliai;7450368045;Ne;0;2;0;2
5553;"Naminukas (Smėlio g. 13)";"NYKŠTUKAI ";7646186458;Ne;0;2;2;4
5554;"Naminukas (Smėlio g. 13)";"NYKŠTUKAI ";5519447152;Ne;0;6;2;8
5555;"Naminukas (Smėlio g. 13)";"NYKŠTUKAI ";1286329245;Ne;0;14;4;18
5556;"Naminukas (Smėlio g. 13)";"NYKŠTUKAI ";1618802271;Ne;3;0;2;5
5557;"Naminukas (Smėlio g. 13)";"NYKŠTUKAI ";1591540165;Ne;3;0;2;5
5558;"Naminukas (Smėlio g. 13)";"NYKŠTUKAI ";1118193598;Ne;0;0;3;3
5559;"Naminukas (Smėlio g. 13)";"NYKŠTUKAI ";8102805098;Ne;0;1;0;1
5560;"Naminukas (Smėlio g. 13)";"NYKŠTUKAI ";5498798560;Ne;0;0;2;2
5561;"Naminukas (Smėlio g. 13)";"NYKŠTUKAI ";5984789325;Ne;11;2;0;13
5562;"Naminukas (Smėlio g. 13)";"NYKŠTUKAI ";9891722891;Ne;5;0;2;7
5563;"Naminukas (Smėlio g. 13)";"NYKŠTUKAI ";7703842464;Ne;3;0;5;8
5564;"Naminukas (Smėlio g. 13)";"NYKŠTUKAI ";9518670147;Ne;1;0;4;5
5565;Nykštukas;SMAGURIAI;7320458031;Ne;2;2;4;8
5566;Nykštukas;SMAGURIAI;7432373335;Ne;0;2;0;2
5567;Nykštukas;SMAGURIAI;6337924089;Ne;20;0;2;22
5568;Nykštukas;SMAGURIAI;2748970206;Ne;0;4;0;4
5569;Nykštukas;SMAGURIAI;3441133631;Ne;0;4;0;4
5570;Nykštukas;SMAGURIAI;7562216310;Ne;0;6;2;8
5571;Nykštukas;SMAGURIAI;6594118834;Ne;5;1;2;8
5572;Nykštukas;SMAGURIAI;2455221957;Ne;0;2;0;2
5573;Nykštukas;SMAGURIAI;5429377807;Ne;3;2;2;7
5574;Nykštukas;SMAGURIAI;4071479304;Ne;6;0;2;8
5575;Nykštukas;SMAGURIAI;2910587300;Ne;3;5;3;11
5576;Nykštukas;SMAGURIAI;2770385957;Ne;1;0;5;6
5577;Nykštukas;SMAGURIAI;8695794490;Ne;1;5;2;8
5578;Nykštukas;SMAGURIAI;5085577592;Ne;0;1;0;1
5579;Nykštukas;SMAGURIAI;5281616311;Ne;6;2;2;10
5580;Nykštukas;SMAGURIAI;8372380734;Ne;0;2;2;4
5581;Nykštukas;SMAGURIAI;6672148719;Ne;0;14;0;14
5582;Nykštukas;SMAGURIAI;5718555692;Ne;0;7;0;7
5583;Nykštukas;SMAGURIAI;7564154155;Ne;12;0;2;14
5584;Nykštukas;SMALSIUKAI;6285425127;Ne;16;0;3;19
5585;Nykštukas;SMALSIUKAI;6786896381;Ne;12;2;2;16
5586;Nykštukas;SMALSIUKAI;4490310109;Ne;0;2;0;2
5587;Nykštukas;SMALSIUKAI;2947976429;Ne;3;0;5;8
5588;Nykštukas;SMALSIUKAI;6883272732;Ne;11;0;2;13
5589;Nykštukas;SMALSIUKAI;8919778025;Ne;6;8;2;16
5590;Nykštukas;SMALSIUKAI;8827094160;Ne;6;2;2;10
5591;Nykštukas;SMALSIUKAI;9887096503;Ne;6;2;2;10
5592;Nykštukas;SMALSIUKAI;4323166473;Ne;0;9;0;9
5593;Nykštukas;SMALSIUKAI;4622095064;Taip;0;2;0;2
5594;Nykštukas;SMALSIUKAI;4955003100;Ne;3;0;3;6
5595;Nykštukas;SMALSIUKAI;5103512898;Ne;7;0;0;7
5596;Nykštukas;SMALSIUKAI;8667489439;Ne;3;0;2;5
5597;Nykštukas;SMALSIUKAI;7603500691;Ne;3;2;4;9
5598;Nykštukas;SMALSIUKAI;7266550834;Ne;7;2;2;11
5599;Nykštukas;SMALSIUKAI;6563871327;Ne;4;2;2;8
5600;Nykštukas;SMALSIUKAI;8819485547;Ne;8;0;4;12
5601;Nykštukas;SMALSIUKAI;5010715255;Ne;0;3;1;4
5602;Nykštukas;SMALSIUKAI;8047072198;Taip;8;2;2;12
5603;Nykštukas;SMALSIUKAI;4499337321;Ne;9;0;2;11
5604;Nykštukas;SMALSIUKAI;5359280641;Ne;2;2;4;8
5605;Nykštukas;AITVARIUKAI;6923345088;Ne;0;1;0;1
5606;Nykštukas;AITVARIUKAI;9319066179;Ne;2;0;2;4
5607;Nykštukas;AITVARIUKAI;2177539882;Ne;0;2;0;2
5608;Nykštukas;AITVARIUKAI;9595654681;Ne;0;0;2;2
5609;Nykštukas;AITVARIUKAI;2232317366;Ne;0;2;0;2
5610;Nykštukas;AITVARIUKAI;7332769878;Ne;0;2;0;2
5611;Nykštukas;AITVARIUKAI;7896338372;Ne;3;0;2;5
5612;Nykštukas;AITVARIUKAI;2208319289;Ne;0;1;0;1
5613;Nykštukas;AITVARIUKAI;5285669371;Ne;0;0;2;2
5614;Nykštukas;AITVARIUKAI;8548820023;Ne;1;2;2;5
5615;Nykštukas;AITVARIUKAI;9545178064;Ne;8;0;2;10
5616;Nykštukas;AITVARIUKAI;3561627809;Ne;0;1;1;2
5617;Nykštukas;AITVARIUKAI;5972246871;Ne;2;3;2;7
5618;Nykštukas;AITVARIUKAI;5538446312;Ne;2;0;1;3
5619;Nykštukas;AITVARIUKAI;4822304386;Ne;0;0;1;1
5620;Nykštukas;AITVARIUKAI;4177690371;Ne;0;0;2;2
5621;Nykštukas;AITVARIUKAI;5292127770;Ne;10;0;2;12
5622;Nykštukas;DAINORĖLIAI;7730918105;Ne;3;4;2;9
5623;Nykštukas;DAINORĖLIAI;8475127245;Ne;3;2;2;7
5624;Nykštukas;DAINORĖLIAI;1122600949;Ne;3;0;3;6
5625;Nykštukas;DAINORĖLIAI;9776630115;Ne;0;6;0;6
5626;Nykštukas;DAINORĖLIAI;9524639831;Ne;5;2;4;11
5627;Nykštukas;DAINORĖLIAI;3367348573;Ne;0;7;0;7
5628;Nykštukas;DAINORĖLIAI;5961945345;Ne;8;0;1;9
5629;Nykštukas;DAINORĖLIAI;6561696818;Ne;2;0;1;3
5630;Nykštukas;DAINORĖLIAI;1283453188;Ne;2;0;1;3
5631;Nykštukas;DAINORĖLIAI;1167614164;Ne;0;3;2;5
5632;Nykštukas;DAINORĖLIAI;7473124310;Taip;2;0;2;4
5633;Nykštukas;DAINORĖLIAI;1174618721;Ne;0;6;0;6
5634;Nykštukas;DAINORĖLIAI;8681884252;Ne;0;2;0;2
5635;Nykštukas;DAINORĖLIAI;5255726742;Ne;0;2;0;2
5636;Nykštukas;DAINORĖLIAI;9027355399;Ne;0;8;0;8
5637;Nykštukas;DAINORĖLIAI;4893494144;Ne;0;6;0;6
5638;Nykštukas;DAINORĖLIAI;8318089070;Ne;4;0;4;8
5639;Nykštukas;DAINORĖLIAI;2727074729;Ne;0;14;0;14
5640;Nykštukas;POKŠTUKAI;7382271765;Ne;3;6;2;11
5641;Nykštukas;POKŠTUKAI;2649916049;Ne;8;2;2;12
5642;Nykštukas;POKŠTUKAI;1796016501;Ne;18;2;2;22
5643;Nykštukas;POKŠTUKAI;5958711585;Ne;4;5;4;13
5644;Nykštukas;POKŠTUKAI;3999004312;Ne;12;3;0;15
5645;Nykštukas;POKŠTUKAI;6719999304;Ne;0;8;0;8
5646;Nykštukas;POKŠTUKAI;8148163137;Ne;0;7;0;7
5647;Nykštukas;POKŠTUKAI;3843163586;Ne;1;2;2;5
5648;Nykštukas;POKŠTUKAI;3507649457;Taip;0;3;0;3
5649;Nykštukas;POKŠTUKAI;3428031037;Ne;0;5;0;5
5650;Nykštukas;POKŠTUKAI;4508625009;Ne;3;4;2;9
5651;Nykštukas;POKŠTUKAI;6698622575;Ne;0;2;2;4
5652;Nykštukas;POKŠTUKAI;2982662650;Ne;3;6;2;11
5653;Nykštukas;POKŠTUKAI;2627736026;Ne;0;14;0;14
5654;Nykštukas;POKŠTUKAI;4401103119;Ne;7;3;2;12
5655;Nykštukas;POKŠTUKAI;9703895923;Ne;3;7;2;12
5656;Nykštukas;KODĖLČIUKAI;8168579152;Ne;8;2;4;14
5657;Nykštukas;KODĖLČIUKAI;9285820767;Ne;3;2;2;7
5658;Nykštukas;KODĖLČIUKAI;2685400939;Ne;8;12;2;22
5659;Nykštukas;KODĖLČIUKAI;3278960733;Ne;0;4;1;5
5660;Nykštukas;KODĖLČIUKAI;5934979528;Ne;5;2;3;10
5661;Nykštukas;KODĖLČIUKAI;3760617860;Ne;3;3;4;10
5662;Nykštukas;KODĖLČIUKAI;8042479133;Ne;7;0;3;10
5663;Nykštukas;KODĖLČIUKAI;6345791450;Ne;10;2;2;14
5664;Nykštukas;KODĖLČIUKAI;6999380958;Ne;0;0;1;1
5665;Nykštukas;KODĖLČIUKAI;6794885966;Ne;0;2;3;5
5666;Nykštukas;KODĖLČIUKAI;7616459970;Ne;0;2;0;2
5667;Nykštukas;KODĖLČIUKAI;2623254163;Ne;5;3;3;11
5668;Nykštukas;KODĖLČIUKAI;9296449928;Ne;18;2;2;22
5669;Nykštukas;KODĖLČIUKAI;2992219360;Ne;12;0;2;14
5670;Nykštukas;KODĖLČIUKAI;4667303597;Ne;3;0;2;5
5671;Nykštukas;KODĖLČIUKAI;8804969886;Ne;0;1;1;2
5672;Nykštukas;KODĖLČIUKAI;3552386621;Ne;6;2;2;10
5673;Nykštukas;KODĖLČIUKAI;2692551262;Ne;0;1;0;1
5674;Nykštukas;KODĖLČIUKAI;6607025451;Ne;0;5;3;8
5675;Nykštukas;PASAKORIAI;2661110617;Ne;2;5;2;9
5676;Nykštukas;PASAKORIAI;3040001373;Taip;0;1;0;1
5677;Nykštukas;PASAKORIAI;1855278809;Taip;6;0;2;8
5678;Nykštukas;PASAKORIAI;8640715657;Ne;0;2;0;2
5679;Nykštukas;PASAKORIAI;5504584349;Ne;3;2;2;7
5680;Nykštukas;PASAKORIAI;7990462246;Ne;0;4;0;4
5681;Nykštukas;PASAKORIAI;1379378120;Ne;0;0;2;2
5682;Nykštukas;PASAKORIAI;9413198245;Ne;0;1;0;1
5683;Nykštukas;PASAKORIAI;2518342041;Ne;0;2;0;2
5684;Nykštukas;PASAKORIAI;7828733135;Ne;0;4;0;4
5685;Nykštukas;PASAKORIAI;4480184458;Ne;0;1;0;1
5686;Nykštukas;PASAKORIAI;4090494707;Ne;0;4;0;4
5687;Nykštukas;PASAKORIAI;3026598985;Ne;3;0;2;5
5688;Nykštukas;PASAKORIAI;9714310539;Ne;0;2;0;2
5689;Nykštukas;PASAKORIAI;4795301170;Taip;0;2;0;2
5690;Nykštukas;PASAKORIAI;1579064341;Taip;9;0;2;11
5691;Nykštukas;PASAKORIAI;4992654449;Ne;4;2;6;12
5692;Nykštukas;PASAKORIAI;5337728911;Ne;15;0;2;17
5693;Nykštukas;PASAKORIAI;9509051946;Ne;0;12;0;12
5694;Nykštukas;PASAKORIAI;3496434361;Ne;0;2;0;2
5695;Nykštukas;GUDRUČIAI;9871410323;Ne;0;5;0;5
5696;Nykštukas;GUDRUČIAI;4559818614;Ne;0;13;0;13
5697;Nykštukas;GUDRUČIAI;9250827058;Ne;0;2;0;2
5698;Nykštukas;GUDRUČIAI;7447202642;Ne;0;2;0;2
5699;Nykštukas;GUDRUČIAI;1714708754;Ne;0;3;0;3
5700;Nykštukas;GUDRUČIAI;5157799354;Ne;0;4;2;6
5701;Nykštukas;GUDRUČIAI;4325369395;Ne;3;5;2;10
5702;Nykštukas;GUDRUČIAI;6630804505;Ne;0;2;0;2
5703;Nykštukas;GUDRUČIAI;8363202198;Ne;0;2;0;2
5704;Nykštukas;GUDRUČIAI;7326535810;Ne;0;6;0;6
5705;Nykštukas;GUDRUČIAI;9712596180;Ne;0;0;1;1
5706;Nykštukas;GUDRUČIAI;9941937734;Ne;6;0;2;8
5707;Nykštukas;GUDRUČIAI;2494482185;Ne;0;1;1;2
5708;Nykštukas;GUDRUČIAI;3619459404;Ne;0;3;0;3
5709;Nykštukas;GUDRUČIAI;7604740418;Ne;0;0;2;2
5710;Nykštukas;GUDRUČIAI;2970293467;Ne;2;9;2;13
5711;Nykštukas;GUDRUČIAI;2881323571;Ne;7;2;2;11
5712;Nykštukas;GUDRUČIAI;9940519259;Ne;0;2;2;4
5713;Nykštukas;GUDRUČIAI;9023823445;Ne;0;2;0;2
5714;Nykštukas;GUDRUČIAI;8361758895;Ne;0;6;0;6
5715;Nykštukas;NAMINUKAI;7176519994;Ne;3;9;2;14
5716;Nykštukas;NAMINUKAI;2440574056;Ne;4;1;2;7
5717;Nykštukas;NAMINUKAI;4064016871;Ne;0;2;0;2
5718;Nykštukas;NAMINUKAI;9054070492;Ne;0;3;0;3
5719;Nykštukas;NAMINUKAI;6519078450;Ne;0;1;0;1
5720;Nykštukas;NAMINUKAI;6106373554;Ne;0;3;0;3
5721;Nykštukas;NAMINUKAI;4925214655;Ne;0;1;0;1
5722;Nykštukas;NAMINUKAI;5032283848;Ne;0;2;2;4
5723;Nykštukas;NAMINUKAI;7494444468;Taip;1;7;2;10
5724;Nykštukas;NAMINUKAI;3925958632;Taip;1;7;2;10
5725;Nykštukas;NAMINUKAI;6338717583;Taip;0;4;0;4
5726;Nykštukas;NAMINUKAI;7976689381;Ne;0;1;2;3
5727;Nykštukas;NAMINUKAI;9686815141;Ne;0;2;0;2
5728;Nykštukas;NAMINUKAI;9575291096;Taip;0;2;1;3
5729;Nykštukas;NAMINUKAI;4503830456;Ne;0;2;0;2
5730;Nykštukas;NAMINUKAI;4040123876;Ne;0;12;0;12
5731;Nykštukas;NAMINUKAI;1088633575;Ne;0;1;0;1
5732;Nykštukas;NAMINUKAI;8874850019;Ne;0;18;0;18
5733;Nykštukas;NAMINUKAI;1510338621;Ne;7;2;4;13
5734;Nykštukas;NAMINUKAI;3405633312;Taip;0;2;0;2
5735;Nykštukas;KŪLVERSTUKAI;7078264994;Ne;0;0;1;1
5736;Nykštukas;KŪLVERSTUKAI;3660330885;Ne;8;4;2;14
5737;Nykštukas;KŪLVERSTUKAI;4897443402;Ne;0;2;0;2
5738;Nykštukas;KŪLVERSTUKAI;6778384400;Ne;2;2;6;10
5739;Nykštukas;KŪLVERSTUKAI;6888025109;Ne;0;7;0;7
5740;Nykštukas;KŪLVERSTUKAI;8642152911;Ne;2;0;2;4
5741;Nykštukas;KŪLVERSTUKAI;6071938183;Ne;5;0;6;11
5742;Nykštukas;KŪLVERSTUKAI;7310647095;Ne;7;0;2;9
5743;Nykštukas;KŪLVERSTUKAI;5297046545;Ne;0;0;2;2
5744;Nykštukas;KŪLVERSTUKAI;8414521116;Ne;1;0;3;4
5745;Nykštukas;KŪLVERSTUKAI;1666098441;Ne;0;1;0;1
5746;Nykštukas;KŪLVERSTUKAI;9177683618;Ne;18;0;2;20
5747;Nykštukas;KŪLVERSTUKAI;1077620433;Ne;0;3;3;6
5748;Nykštukas;TREPSIUKAI;8701731017;Ne;0;4;0;4
5749;Nykštukas;TREPSIUKAI;2995258838;Ne;2;11;2;15
5750;Nykštukas;TREPSIUKAI;9484110969;Ne;0;17;0;17
5751;Nykštukas;TREPSIUKAI;1355881784;Ne;10;2;4;16
5752;Nykštukas;TREPSIUKAI;1721306926;Ne;7;2;2;11
5753;Nykštukas;TREPSIUKAI;2974110726;Ne;5;10;2;17
5754;Nykštukas;TREPSIUKAI;7311244803;Ne;0;2;0;2
5755;Nykštukas;TREPSIUKAI;8194411836;Ne;0;5;0;5
5756;Nykštukas;TREPSIUKAI;5183022629;Ne;1;0;2;3
5757;Nykštukas;TREPSIUKAI;6298299835;Ne;0;3;0;3
5758;Nykštukas;TREPSIUKAI;2759786932;Ne;0;4;2;6
5759;Nykštukas;TREPSIUKAI;4755908241;Ne;3;1;2;6
5760;Nykštukas;ŽIRNIUKAI;1594734231;Ne;0;0;4;4
5761;Nykštukas;ŽIRNIUKAI;7908029688;Ne;0;1;0;1
5762;Nykštukas;ŽIRNIUKAI;7299329150;Ne;0;3;5;8
5763;Nykštukas;ŽIRNIUKAI;1218443707;Ne;3;2;4;9
5764;Nykštukas;ŽIRNIUKAI;7535385367;Taip;0;2;0;2
5765;Nykštukas;ŽIRNIUKAI;6709760898;Ne;0;2;0;2
5766;Nykštukas;ŽIRNIUKAI;2670682135;Ne;0;1;0;1
5767;Nykštukas;ŽIRNIUKAI;1366524995;Ne;0;2;0;2
5768;Nykštukas;ŽIRNIUKAI;2800783215;Ne;3;3;4;10
5769;Nykštukas;ŽIRNIUKAI;2620150024;Ne;4;3;5;12
5770;Nykštukas;ŽIRNIUKAI;3032028847;Ne;0;3;2;5
5771;Nykštukas;ŽIRNIUKAI;4144437365;Ne;0;2;2;4
5772;Nykštukas;ŽIRNIUKAI;6884714823;Ne;0;1;0;1
5773;Nykštukas;ŽIRNIUKAI;1616644404;Ne;0;3;2;5
5774;Nykštukas;ŽIRNIUKAI;9270615518;Ne;0;1;0;1
5775;Nykštukas;ŽIRNIUKAI;2078586374;Ne;0;1;0;1
5776;Nykštukas;ŽIRNIUKAI;1102203704;Ne;0;1;0;1
5777;Ozas;Smalsučiai;4066900299;Ne;6;0;5;11
5778;Ozas;Smalsučiai;4694561135;Taip;1;0;4;5
5779;Ozas;Smalsučiai;4792735767;Ne;6;5;2;13
5780;Ozas;Smalsučiai;5651665799;Ne;0;0;3;3
5781;Ozas;Smalsučiai;7756424421;Ne;15;0;4;19
5782;Ozas;Smalsučiai;4334162942;Ne;0;0;2;2
5783;Ozas;Smalsučiai;1507372220;Ne;0;0;2;2
5784;Ozas;Smalsučiai;7884934528;Ne;8;0;4;12
5785;Ozas;Smalsučiai;7298628220;Ne;0;0;3;3
5786;Ozas;Smalsučiai;1112829748;Ne;0;0;2;2
5787;Ozas;Smalsučiai;1699412266;Ne;0;5;2;7
5788;Ozas;Smalsučiai;8833452950;Ne;0;0;5;5
5789;Ozas;Smalsučiai;2189280675;Ne;14;0;4;18
5790;Ozas;Smalsučiai;6922447926;Ne;0;0;3;3
5791;Ozas;Smalsučiai;8860029000;Ne;8;0;4;12
5792;Ozas;Smalsučiai;7786745329;Ne;0;0;4;4
5793;Ozas;Smalsučiai;1398871402;Ne;3;0;2;5
5794;Ozas;Drugeliai;1866535603;Taip;6;3;5;14
5795;Ozas;Drugeliai;4673128698;Ne;0;1;1;2
5796;Ozas;Drugeliai;7870419810;Ne;4;2;2;8
5797;Ozas;Drugeliai;2869987587;Ne;7;1;4;12
5798;Ozas;Drugeliai;5926100815;Ne;0;1;1;2
5799;Ozas;Drugeliai;9178967858;Ne;4;0;2;6
5800;Ozas;Drugeliai;5677543279;Ne;2;0;0;2
5801;Ozas;Drugeliai;2454569369;Ne;0;2;2;4
5802;Ozas;Drugeliai;8713970306;Ne;0;0;2;2
5803;Ozas;Drugeliai;1803782282;Ne;0;5;0;5
5804;Ozas;Drugeliai;2819545359;Ne;6;0;4;10
5805;Ozas;Drugeliai;3994760698;Ne;3;1;4;8
5806;Ozas;Drugeliai;7922667688;Ne;8;0;6;14
5807;Ozas;Drugeliai;1536889312;Ne;12;0;4;16
5808;Ozas;Drugeliai;8897904793;Ne;3;0;6;9
5809;Ozas;Drugeliai;3723247420;Ne;6;0;6;12
5810;Ozas;Drugeliai;1489355274;Ne;0;4;0;4
5811;Ozas;Drugeliai;9655492678;Ne;20;0;2;22
5812;Ozas;Drugeliai;1062591107;Taip;5;0;2;7
5813;Ozas;Drugeliai;3967307153;Ne;13;0;4;17
5814;Ozas;Boružėlės;3037323341;Ne;8;3;2;13
5815;Ozas;Boružėlės;6346123124;Ne;13;0;4;17
5816;Ozas;Boružėlės;3133776891;Ne;0;3;0;3
5817;Ozas;Boružėlės;2139224651;Ne;8;1;2;11
5818;Ozas;Boružėlės;9506090620;Ne;3;2;2;7
5819;Ozas;Boružėlės;5172367556;Ne;0;2;0;2
5820;Ozas;Boružėlės;8923372952;Ne;0;10;2;12
5821;Ozas;Boružėlės;7617839839;Ne;3;15;2;20
5822;Ozas;Boružėlės;6392066805;Ne;0;0;5;5
5823;Ozas;Boružėlės;8781771299;Ne;3;0;2;5
5824;Ozas;Boružėlės;3817138493;Ne;0;11;0;11
5825;Ozas;Boružėlės;8371368881;Ne;5;0;8;13
5826;Ozas;Boružėlės;6476147361;Ne;0;0;1;1
5827;Ozas;Boružėlės;4994121247;Ne;7;3;2;12
5828;Ozas;Boružėlės;3902722274;Ne;13;0;5;18
5829;Ozas;Boružėlės;7585213159;Ne;0;1;0;1
5830;Ozas;Boružėlės;6315443248;Ne;0;8;0;8
5831;Ozas;Boružėlės;6186850614;Ne;3;2;7;12
5832;Ozas;Boružėlės;6318419889;Ne;6;3;2;11
5833;Ozas;Boružėlės;7787473586;Ne;8;0;2;10
5834;Ozas;Žiogeliai;7461521320;Ne;0;3;2;5
5835;Ozas;Žiogeliai;6257625501;Ne;1;2;2;5
5836;Ozas;Žiogeliai;7402290524;Ne;3;2;2;7
5837;Ozas;Žiogeliai;1562277866;Ne;0;5;0;5
5838;Ozas;Žiogeliai;4571583671;Ne;0;2;0;2
5839;Ozas;Žiogeliai;5682027094;Ne;1;6;8;15
5840;Ozas;Žiogeliai;4942550213;Ne;6;3;6;15
5841;Ozas;Žiogeliai;8676986286;Ne;0;4;4;8
5842;Ozas;Žiogeliai;2345112767;Ne;0;2;2;4
5843;Ozas;Žiogeliai;5420952391;Ne;0;7;2;9
5844;Ozas;Žiogeliai;9929822317;Ne;0;0;1;1
5845;Ozas;Žiogeliai;2837228320;Ne;2;3;2;7
5846;Ozas;Žiogeliai;2617258206;Ne;0;6;0;6
5847;Ozas;Žiogeliai;4030056504;Ne;0;0;3;3
5848;Ozas;Žiogeliai;5156383727;Ne;0;4;0;4
5849;Ozas;Žiogeliai;3770045761;Ne;4;3;2;9
5850;Ozas;Žiogeliai;7264789334;Ne;0;2;0;2
5851;Ozas;Žiogeliai;7165299220;Taip;9;2;2;13
5852;Ozas;Bitutės;4220780257;Ne;0;2;3;5
5853;Ozas;Bitutės;1161776624;Ne;0;2;2;4
5854;Ozas;Bitutės;4227555342;Ne;0;2;2;4
5855;Ozas;Bitutės;7499756171;Ne;0;12;0;12
5856;Ozas;Bitutės;2705294874;Ne;0;0;1;1
5857;Ozas;Bitutės;2369544599;Ne;0;3;2;5
5858;Ozas;Bitutės;3329391600;Ne;0;2;1;3
5859;Ozas;Bitutės;4699369567;Ne;0;2;0;2
5860;Ozas;Bitutės;8304671844;Ne;0;2;0;2
5861;Ozas;Bitutės;9772085405;Ne;4;2;2;8
5862;Ozas;Bitutės;7051699003;Ne;8;0;2;10
5863;Ozas;Bitutės;5383877034;Ne;0;2;5;7
5864;Ozas;Bitutės;1117208248;Ne;2;2;4;8
5865;Ozas;Bitutės;6811181735;Ne;0;4;3;7
5866;Ozas;Bitutės;8622621570;Ne;3;2;3;8
5867;Ozas;Bitutės;4260123123;Ne;0;2;1;3
5868;Ozas;Bitutės;7494307084;Ne;0;4;0;4
5869;Ozas;Bitutės;1895519949;Ne;0;2;1;3
5870;Ozas;Bitutės;1475005204;Ne;0;0;1;1
5871;Ozas;Bitutės;5968428143;Ne;4;0;2;6
5872;Ozas;Bitutės;4286058360;Ne;4;2;6;12
5873;Ozas;Aitvarėliai;1144679735;Ne;8;2;2;12
5874;Ozas;Aitvarėliai;2773182934;Ne;3;0;4;7
5875;Ozas;Aitvarėliai;4357737538;Ne;1;0;3;4
5876;Ozas;Aitvarėliai;5642468671;Ne;10;2;4;16
5877;Ozas;Aitvarėliai;1045890394;Ne;3;2;3;8
5878;Ozas;Aitvarėliai;7686706482;Ne;0;2;0;2
5879;Ozas;Aitvarėliai;2395567376;Ne;0;2;1;3
5880;Ozas;Aitvarėliai;5383739203;Ne;0;2;0;2
5881;Ozas;Aitvarėliai;4583818638;Ne;1;0;3;4
5882;Ozas;Aitvarėliai;2165291778;Ne;5;9;2;16
5883;Ozas;Aitvarėliai;8754244281;Ne;13;2;2;17
5884;Ozas;Aitvarėliai;6646671212;Ne;7;2;2;11
5885;Ozas;Aitvarėliai;9443843603;Ne;4;2;4;10
5886;Ozas;Aitvarėliai;3238019756;Ne;4;8;2;14
5887;Ozas;Aitvarėliai;8987796218;Ne;9;3;2;14
5888;Ozas;Aitvarėliai;3783477511;Ne;4;0;2;6
5889;Ozas;Aitvarėliai;6778987483;Ne;4;0;3;7
5890;Ozas;Aitvarėliai;7009893338;Taip;0;0;1;1
5891;Ozas;Aitvarėliai;4891451748;Ne;0;6;0;6
5892;Ozas;Aitvarėliai;9813020279;Ne;0;0;1;1
5893;Ozas;Aitvarėliai;2922370952;Ne;0;2;1;3
5894;Ozas;Aitvarėliai;2544858937;Ne;2;2;3;7
5895;Ozas;Voveraitės;8178298861;Ne;6;0;2;8
5896;Ozas;Voveraitės;6263062055;Ne;1;6;4;11
5897;Ozas;Voveraitės;9195536968;Ne;4;13;2;19
5898;Ozas;Voveraitės;2991511872;Ne;1;2;2;5
5899;Ozas;Voveraitės;5016547315;Ne;0;1;0;1
5900;Ozas;Voveraitės;1564826076;Ne;0;2;4;6
5901;Ozas;Voveraitės;2511477658;Ne;0;3;0;3
5902;Ozas;Voveraitės;1240233169;Ne;20;0;2;22
5903;Ozas;Voveraitės;6088757991;Ne;0;3;0;3
5904;Ozas;Voveraitės;5822871838;Ne;0;3;0;3
5905;Ozas;Voveraitės;2635045515;Ne;0;3;0;3
5906;Ozas;Voveraitės;6499549095;Ne;6;2;2;10
5907;Ozas;Voveraitės;6666591428;Ne;0;5;0;5
5908;Ozas;Voveraitės;2297650260;Ne;0;2;6;8
5909;Ozas;Voveraitės;7908028909;Ne;0;5;0;5
5910;Ozas;Voveraitės;9762737217;Ne;3;2;2;7
5911;Ozas;Voveraitės;7421484648;Ne;20;0;2;22
5912;Ozas;Voveraitės;1997125531;Taip;1;4;2;7
5913;Ozas;Voveraitės;5751808248;Ne;1;0;2;3
5914;Ozas;Voveraitės;4556076744;Ne;5;0;4;9
5915;Ozas;Voveraitės;8503041003;Ne;0;0;2;2
5916;Ozas;Voveraitės;6053885086;Ne;7;0;2;9
5917;Ozas;Voveraitės;7978092840;Ne;0;2;0;2
5918;Ozas;Kodelčiukai;8743467101;Ne;0;4;0;4
5919;Ozas;Kodelčiukai;8696127374;Ne;0;4;0;4
5920;Ozas;Kodelčiukai;3704303636;Ne;0;1;0;1
5921;Ozas;Kodelčiukai;2573702751;Ne;8;0;2;10
5922;Ozas;Kodelčiukai;3412369198;Ne;0;4;0;4
5923;Ozas;Kodelčiukai;2951875705;Ne;0;1;0;1
5924;Ozas;Kodelčiukai;7305274617;Ne;9;9;2;20
5925;Ozas;Kodelčiukai;9306887706;Ne;4;2;3;9
5926;Ozas;Kodelčiukai;1348751454;Ne;4;9;2;15
5927;Ozas;Kodelčiukai;9322080266;Ne;2;3;2;7
5928;Ozas;Kodelčiukai;6809992664;Taip;0;5;0;5
5929;Ozas;Kodelčiukai;4516291572;Ne;0;1;0;1
5930;Ozas;Kodelčiukai;4287719751;Ne;8;5;2;15
5931;Ozas;Kodelčiukai;9620747099;Ne;3;2;2;7
5932;Ozas;Kodelčiukai;5216695220;Ne;3;2;2;7
5933;Ozas;Kodelčiukai;8779047802;Ne;2;0;2;4
5934;Ozas;Kodelčiukai;6783755555;Taip;0;7;0;7
5935;Ozas;Kodelčiukai;8222112564;Ne;2;4;2;8
5936;Ozas;Kodelčiukai;8797919230;Ne;0;0;1;1
5937;Ozas;Kodelčiukai;4573329075;Taip;7;0;3;10
5938;Ozas;Pelėdžiukai;4640897674;Ne;0;2;0;2
5939;Ozas;Pelėdžiukai;9277208213;Ne;2;0;2;4
5940;Ozas;Pelėdžiukai;8040293681;Ne;2;0;7;9
5941;Ozas;Pelėdžiukai;1856258542;Ne;0;2;3;5
5942;Ozas;Pelėdžiukai;5922569280;Ne;3;1;2;6
5943;Ozas;Pelėdžiukai;7640409923;Ne;0;3;0;3
5944;Ozas;Pelėdžiukai;4601869799;Ne;2;2;3;7
5945;Ozas;Pelėdžiukai;7125754645;Ne;3;7;3;13
5946;Ozas;Pelėdžiukai;2824133388;Ne;1;1;3;5
5947;Ozas;Pelėdžiukai;2637531106;Taip;0;2;0;2
5948;Ozas;Pelėdžiukai;7287989663;Ne;0;2;0;2
5949;Ozas;Pelėdžiukai;6819000895;Ne;0;2;0;2
5950;Ozas;Pelėdžiukai;4886045470;Ne;8;3;2;13
5951;Ozas;Pelėdžiukai;3212050416;Ne;3;2;2;7
5952;Ozas;Pelėdžiukai;3725141591;Ne;0;0;1;1
5953;Ozas;Pelėdžiukai;3711403511;Ne;0;7;3;10
5954;Ozas;Pelėdžiukai;5392929222;Ne;20;0;2;22
5955;Ozas;Pelėdžiukai;7038928164;Taip;0;0;1;1
5956;Ozas;Pelėdžiukai;2281337233;Ne;0;0;6;6
5957;Ozas;Pelėdžiukai;9334268998;Ne;4;0;3;7
5958;Ozas;"Kačiukai ";4857216527;Ne;0;0;2;2
5959;Ozas;"Kačiukai ";7776754188;Ne;8;0;4;12
5960;Ozas;"Kačiukai ";5097380041;Ne;0;0;6;6
5961;Ozas;"Kačiukai ";3109261153;Ne;8;2;2;12
5962;Ozas;"Kačiukai ";9781398468;Ne;0;0;1;1
5963;Ozas;"Kačiukai ";8488500486;Ne;0;0;2;2
5964;Ozas;"Kačiukai ";4595986358;Ne;0;2;2;4
5965;Ozas;"Kačiukai ";5421245991;Ne;0;2;0;2
5966;Ozas;"Kačiukai ";9781527964;Ne;7;9;4;20
5967;Ozas;"Kačiukai ";4514798132;Ne;11;0;5;16
5968;Ozas;"Kačiukai ";2522810593;Ne;0;1;0;1
5969;Ozas;"Kačiukai ";3269417874;Ne;0;4;0;4
5970;Ozas;"Kačiukai ";5866709636;Ne;6;8;2;16
5971;Ozas;"Kačiukai ";6632795981;Ne;3;0;4;7
5972;Ozas;"Kačiukai ";2599175140;Ne;0;1;6;7
5973;Ozas;"Kačiukai ";2030429825;Taip;3;2;2;7
5974;Ozas;"Kačiukai ";7885855133;Ne;3;0;2;5
5975;Ozas;"Kačiukai ";5761120671;Ne;1;0;5;6
5976;Ozas;Ančiukų;3472468379;Ne;13;0;2;15
5977;Ozas;Ančiukų;6512655578;Ne;12;0;4;16
5978;Ozas;Ančiukų;1092988354;Ne;11;0;2;13
5979;Ozas;Ančiukų;5811261087;Ne;10;0;5;15
5980;Ozas;Ančiukų;4424628807;Ne;2;0;5;7
5981;Ozas;Ančiukų;4347607193;Taip;20;0;2;22
5982;Ozas;Ančiukų;6894358457;Ne;8;0;4;12
5983;Ozas;Ančiukų;1671756798;Ne;8;0;2;10
5984;Ozas;Ančiukų;5163358861;Ne;0;1;6;7
5985;Ozas;Ančiukų;6653963888;Ne;6;0;2;8
5986;Ozas;Ančiukų;7611417346;Ne;3;0;5;8
5987;Ozas;Ančiukų;6305438823;Ne;8;2;2;12
5988;Ozas;Ančiukų;4941588023;Ne;0;4;6;10
5989;Ozas;Ančiukų;8772165816;Ne;8;0;4;12
5990;Ozas;Ančiukų;4978274341;Ne;5;0;4;9
5991;Ozas;Ančiukų;4910534724;Ne;1;0;3;4
5992;Ozas;Nykškukų;9319720476;Ne;20;0;2;22
5993;Ozas;Nykškukų;3540922740;Ne;0;0;4;4
5994;Ozas;Nykškukų;2794839285;Ne;6;0;8;14
5995;Ozas;Nykškukų;2326431805;Ne;0;6;0;6
5996;Ozas;Nykškukų;2334870680;Ne;6;0;6;12
5997;Ozas;Nykškukų;7005571081;Ne;6;0;6;12
5998;Ozas;Nykškukų;3201905363;Ne;5;1;4;10
5999;Ozas;Nykškukų;1760627703;Ne;19;0;2;21
6000;Ozas;Nykškukų;5126356120;Ne;8;1;2;11
6001;Ozas;Nykškukų;2490578190;Ne;10;6;2;18
6002;Ozas;Nykškukų;3310335918;Ne;5;0;6;11
6003;Ozas;Nykškukų;7789232957;Ne;19;0;2;21
6004;Ozas;Nykškukų;2531635671;Ne;0;1;5;6
6005;Ozas;Nykškukų;7556190089;Taip;8;0;8;16
6006;Ozas;Nykškukų;9685593404;Ne;4;0;5;9
6007;Ozas;Nykškukų;5008732127;Ne;10;0;2;12
6008;Pabiručiai;Voveriukų;4539246865;Ne;0;5;0;5
6009;Pabiručiai;Voveriukų;1498738549;Ne;0;13;0;13
6010;Pabiručiai;Voveriukų;2349337471;Ne;0;2;0;2
6011;Pabiručiai;Voveriukų;9564303781;Ne;0;0;5;5
6012;Pabiručiai;Voveriukų;4312364951;Ne;0;10;0;10
6013;Pabiručiai;Voveriukų;3756731363;Ne;0;1;8;9
6014;Pabiručiai;Voveriukų;7985360502;Ne;0;2;1;3
6015;Pabiručiai;Voveriukų;3936426174;Ne;0;1;5;6
6016;Pabiručiai;Voveriukų;4069564285;Ne;0;2;0;2
6017;Pabiručiai;Voveriukų;7278334800;Ne;0;1;0;1
6018;Pabiručiai;Voveriukų;5232678556;Ne;0;3;0;3
6019;Pabiručiai;Voveriukų;7066037017;Ne;0;3;0;3
6020;Pabiručiai;Voveriukų;5549851164;Ne;0;2;0;2
6021;Pabiručiai;Voveriukų;2514312233;Ne;0;3;0;3
6022;Pabiručiai;Voveriukų;7606274875;Ne;0;3;0;3
6023;Pabiručiai;Voveriukų;9356327400;Ne;0;3;0;3
6024;Pabiručiai;Voveriukų;4813206044;Ne;0;15;0;15
6025;Pabiručiai;Voveriukų;7846758352;Ne;0;3;0;3
6026;Pabiručiai;Boružiukų;6401188653;Ne;0;3;0;3
6027;Pabiručiai;Boružiukų;1673473814;Ne;0;4;2;6
6028;Pabiručiai;Boružiukų;5686769648;Ne;0;4;6;10
6029;Pabiručiai;Boružiukų;7524993271;Ne;0;3;1;4
6030;Pabiručiai;Boružiukų;5708597471;Ne;0;12;0;12
6031;Pabiručiai;Boružiukų;7046122545;Ne;0;4;0;4
6032;Pabiručiai;Boružiukų;3096466200;Ne;0;5;0;5
6033;Pabiručiai;Boružiukų;4301904533;Ne;0;1;0;1
6034;Pabiručiai;Boružiukų;8175565139;Ne;0;2;0;2
6035;Pabiručiai;Boružiukų;8236964683;Ne;0;2;0;2
6036;Pabiručiai;Boružiukų;1240057541;Ne;0;11;0;11
6037;Pabiručiai;Boružiukų;1671027282;Ne;0;3;0;3
6038;Pabiručiai;Boružiukų;3759350345;Ne;3;11;2;16
6039;Pabiručiai;Boružiukų;3151360288;Ne;0;4;0;4
6040;Pabiručiai;Boružiukų;9299393363;Ne;0;4;1;5
6041;Pabiručiai;Boružiukų;1484291546;Ne;1;3;2;6
6042;Pabiručiai;Boružiukų;2771769336;Ne;0;6;0;6
6043;Pabiručiai;Boružiukų;2607840684;Ne;0;2;0;2
6044;Pabiručiai;Boružiukų;4681771534;Ne;0;2;0;2
6045;Pabiručiai;Boružiukų;7050339198;Ne;3;7;2;12
6046;Pabiručiai;Boružiukų;4798503931;Ne;0;0;1;1
6047;Pabiručiai;Boružiukų;1429061018;Ne;0;2;0;2
6048;Pabiručiai;Katinėlių;8649685325;Taip;2;0;2;4
6049;Pabiručiai;Katinėlių;5737214746;Ne;3;2;2;7
6050;Pabiručiai;Katinėlių;4929129093;Ne;0;17;0;17
6051;Pabiručiai;Katinėlių;2141365015;Ne;11;0;2;13
6052;Pabiručiai;Katinėlių;7914642744;Ne;8;0;2;10
6053;Pabiručiai;Katinėlių;1099080685;Ne;0;19;0;19
6054;Pabiručiai;Katinėlių;3011601512;Taip;7;0;2;9
6055;Pabiručiai;Katinėlių;4852287574;Ne;0;0;1;1
6056;Pabiručiai;Katinėlių;3826505104;Taip;5;0;4;9
6057;Pabiručiai;Katinėlių;6678717039;Ne;6;4;2;12
6058;Pabiručiai;Katinėlių;7798837336;Ne;5;5;2;12
6059;Pabiručiai;Katinėlių;7339565412;Ne;4;0;3;7
6060;Pabiručiai;Katinėlių;6742744014;Ne;0;4;0;4
6061;Pabiručiai;Katinėlių;1206012259;Ne;0;5;0;5
6062;Pabiručiai;Katinėlių;9790360371;Ne;1;1;2;4
6063;Pabiručiai;Katinėlių;9890225918;Ne;0;7;0;7
6064;Pabiručiai;Katinėlių;7980170279;Ne;3;0;4;7
6065;Pabiručiai;Katinėlių;5923385276;Ne;0;1;2;3
6066;Pabiručiai;Katinėlių;1138743823;Ne;1;9;2;12
6067;Pabiručiai;Katinėlių;4931180848;Ne;4;0;7;11
6068;Pabiručiai;Katinėlių;1652633130;Ne;12;1;2;15
6069;Pabiručiai;Katinėlių;9813153308;Ne;4;0;3;7
6070;Pabiručiai;Katinėlių;6508093808;Ne;4;3;6;13
6071;Pabiručiai;Žiogelių;3531292373;Ne;0;2;0;2
6072;Pabiručiai;Žiogelių;1247522345;Ne;8;2;3;13
6073;Pabiručiai;Žiogelių;9878655387;Ne;3;2;2;7
6074;Pabiručiai;Žiogelių;8092886420;Ne;0;13;0;13
6075;Pabiručiai;Žiogelių;4012537474;Ne;0;0;20;20
6076;Pabiručiai;Žiogelių;7561916887;Ne;5;0;12;17
6077;Pabiručiai;Žiogelių;9651695086;Ne;0;11;0;11
6078;Pabiručiai;Žiogelių;5050966784;Ne;0;2;0;2
6079;Pabiručiai;Žiogelių;4096412988;Ne;3;0;4;7
6080;Pabiručiai;Žiogelių;4876140467;Ne;8;0;4;12
6081;Pabiručiai;Žiogelių;5862643827;Ne;1;2;5;8
6082;Pabiručiai;Žiogelių;6014791534;Ne;2;0;0;2
6083;Pabiručiai;Žiogelių;5704073222;Ne;6;0;2;8
6084;Pabiručiai;Žiogelių;5019580409;Taip;0;2;5;7
6085;Pabiručiai;Žiogelių;8870657682;Ne;5;0;3;8
6086;Pabiručiai;Žiogelių;2924005478;Ne;3;0;2;5
6087;Pabiručiai;Žiogelių;8668524776;Ne;0;8;0;8
6088;Pabiručiai;Žiogelių;6513943228;Ne;2;0;2;4
6089;Pabiručiai;Žiogelių;4755427277;Ne;0;0;1;1
6090;Pabiručiai;Žiogelių;7873575929;Ne;2;0;6;8
6091;Pabiručiai;Smalsiukai;2869383175;Ne;0;0;1;1
6092;Pabiručiai;Smalsiukai;7677235214;Ne;0;0;2;2
6093;Pabiručiai;Smalsiukai;9676561758;Ne;0;4;0;4
6094;Pabiručiai;Smalsiukai;7090116276;Ne;0;1;4;5
6095;Pabiručiai;Smalsiukai;4408666547;Ne;0;1;1;2
6096;Pabiručiai;Smalsiukai;6935913132;Ne;3;0;2;5
6097;Pabiručiai;Smalsiukai;1344711015;Ne;0;1;0;1
6098;Pabiručiai;Smalsiukai;7663581089;Ne;0;2;2;4
6099;Pabiručiai;Smalsiukai;7248314871;Ne;2;0;1;3
6100;Pabiručiai;Smalsiukai;9610623364;Ne;0;5;0;5
6101;Pabiručiai;Smalsiukai;8897462614;Ne;0;3;0;3
6102;Pabiručiai;Smalsiukai;2332338995;Ne;11;1;3;15
6103;Pabiručiai;Smalsiukai;4258226042;Ne;0;4;0;4
6104;Pabiručiai;Smalsiukai;3511851810;Ne;5;4;3;12
6105;Pabiručiai;Smalsiukai;6686039601;Ne;6;4;3;13
6106;Pabiručiai;Smalsiukai;5420231066;Ne;0;1;0;1
6107;Pabiručiai;Smalsiukai;8840885039;Ne;0;2;1;3
6108;Pabiručiai;Smalsiukai;9779260044;Ne;0;0;2;2
6109;Pabiručiai;Smalsiukai;2771891999;Ne;8;0;4;12
6110;Pabiručiai;Smalsiukai;7295052694;Taip;0;11;0;11
6111;Pabiručiai;Smalsiukai;6834663627;Ne;6;12;2;20
6112;Pabiručiai;Kiškučiai;3368607302;Ne;5;0;1;6
6113;Pabiručiai;Kiškučiai;9589005897;Ne;0;16;0;16
6114;Pabiručiai;Kiškučiai;9353062804;Ne;0;4;2;6
6115;Pabiručiai;Kiškučiai;1582754284;Ne;22;0;0;22
6116;Pabiručiai;Kiškučiai;4462744848;Ne;0;16;0;16
6117;Pabiručiai;Kiškučiai;5621183663;Ne;0;9;0;9
6118;Pabiručiai;Kiškučiai;5497318373;Ne;0;1;0;1
6119;Pabiručiai;Kiškučiai;9417138573;Ne;0;2;0;2
6120;Pabiručiai;Kiškučiai;1515270273;Ne;0;1;0;1
6121;Pabiručiai;Kiškučiai;2688728915;Ne;7;7;2;16
6122;Pabiručiai;Kiškučiai;5166525832;Ne;0;4;0;4
6123;Pabiručiai;Kiškučiai;8409455566;Ne;0;4;0;4
6124;Pabiručiai;Kiškučiai;1028312285;Ne;0;3;0;3
6125;Pabiručiai;Kiškučiai;5717534175;Ne;0;7;0;7
6126;Pabiručiai;Kiškučiai;3408518493;Ne;0;8;0;8
6127;Pabiručiai;Kiškučiai;7653129291;Ne;0;12;0;12
6128;Pabiručiai;Kiškučiai;7073230645;Taip;0;3;0;3
6129;Pabiručiai;Kiškučiai;8820585407;Ne;0;2;0;2
6130;Pabiručiai;Kiškučiai;7572077461;Ne;3;3;2;8
6131;Pabiručiai;Kiškučiai;5767879226;Ne;0;2;0;2
6132;Pabiručiai;Kiškučiai;6073797962;Taip;0;4;0;4
6133;Pabiručiai;"Pėledžiukai ";9834824219;Ne;0;10;0;10
6134;Pabiručiai;"Pėledžiukai ";7961879916;Ne;0;2;0;2
6135;Pabiručiai;"Pėledžiukai ";9050994322;Ne;0;3;0;3
6136;Pabiručiai;"Pėledžiukai ";1049154287;Ne;0;0;2;2
6137;Pabiručiai;"Pėledžiukai ";6697518151;Ne;0;6;0;6
6138;Pabiručiai;"Pėledžiukai ";2596301235;Ne;4;2;0;6
6139;Pabiručiai;"Pėledžiukai ";4333645528;Ne;0;4;0;4
6140;Pabiručiai;"Pėledžiukai ";6289025538;Ne;0;10;0;10
6141;Pabiručiai;"Pėledžiukai ";2812291058;Ne;0;0;2;2
6142;Pabiručiai;"Pėledžiukai ";2343561322;Ne;1;3;2;6
6143;Pabiručiai;"Pėledžiukai ";3674583662;Ne;0;5;0;5
6144;Pabiručiai;"Pėledžiukai ";8268101318;Ne;0;7;0;7
6145;Pabiručiai;"Pėledžiukai ";2147165934;Ne;6;2;2;10
6146;Pabiručiai;"Pėledžiukai ";7385149524;Ne;0;1;0;1
6147;Pabiručiai;"Pėledžiukai ";7203091216;Ne;0;0;1;1
6148;Pabiručiai;"Pėledžiukai ";3224195892;Ne;0;1;3;4
6149;Pabiručiai;"Pėledžiukai ";1852744763;Ne;0;0;7;7
6150;Pabiručiai;"Pėledžiukai ";5165268747;Ne;0;6;0;6
6151;Pabiručiai;"Pėledžiukai ";1971996148;Ne;0;2;0;2
6152;Pabiručiai;"Kodelčiūkai ";5950654594;Ne;0;0;3;3
6153;Pabiručiai;"Kodelčiūkai ";8775727677;Ne;0;4;0;4
6154;Pabiručiai;"Kodelčiūkai ";2295503584;Ne;0;9;0;9
6155;Pabiručiai;"Kodelčiūkai ";4595458527;Ne;0;2;1;3
6156;Pabiručiai;"Kodelčiūkai ";9067653417;Ne;2;0;2;4
6157;Pabiručiai;"Kodelčiūkai ";5247780866;Ne;0;2;0;2
6158;Pabiručiai;"Kodelčiūkai ";3433419710;Ne;6;2;3;11
6159;Pabiručiai;"Kodelčiūkai ";6386335808;Ne;9;0;2;11
6160;Pabiručiai;"Kodelčiūkai ";5010271037;Ne;0;1;0;1
6161;Pabiručiai;"Kodelčiūkai ";9538339883;Ne;0;3;0;3
6162;Pabiručiai;"Kodelčiūkai ";8149732126;Ne;2;1;0;3
6163;Pabiručiai;"Kodelčiūkai ";7289131864;Ne;0;1;0;1
6164;Pabiručiai;"Kodelčiūkai ";6209553290;Ne;8;0;3;11
6165;Pabiručiai;"Kodelčiūkai ";3497466298;Ne;5;10;1;16
6166;Pabiručiai;"Kodelčiūkai ";8179285338;Ne;0;8;0;8
6167;Pabiručiai;"Kodelčiūkai ";1234230729;Ne;5;0;2;7
6168;Pabiručiai;"Kodelčiūkai ";2519371211;Ne;13;0;4;17
6169;Pabiručiai;"Kodelčiūkai ";5211115955;Ne;2;0;1;3
6170;Pabiručiai;"Kodelčiūkai ";2433997383;Ne;11;2;5;18
6171;Pabiručiai;"Peliukų ";3702521810;Ne;0;5;0;5
6172;Pabiručiai;"Peliukų ";1947729077;Ne;3;0;4;7
6173;Pabiručiai;"Peliukų ";7182565608;Taip;0;1;0;1
6174;Pabiručiai;"Peliukų ";7644854044;Ne;0;10;0;10
6175;Pabiručiai;"Peliukų ";9806520732;Taip;0;5;6;11
6176;Pabiručiai;"Peliukų ";8551913254;Ne;0;0;3;3
6177;Pabiručiai;"Peliukų ";1638037202;Ne;0;0;3;3
6178;Pabiručiai;"Peliukų ";6603404126;Ne;0;5;0;5
6179;Pabiručiai;"Peliukų ";1414752034;Ne;0;5;0;5
6180;Pabiručiai;"Peliukų ";5562214231;Ne;5;0;4;9
6181;Pabiručiai;"Peliukų ";2860703696;Ne;7;2;2;11
6182;Pabiručiai;"Peliukų ";3128998397;Ne;0;2;0;2
6183;Pabiručiai;"Peliukų ";1707526401;Ne;0;0;3;3
6184;Pabiručiai;"Viščiukų ";8048012241;Ne;8;0;4;12
6185;Pabiručiai;"Viščiukų ";2757879842;Ne;5;0;8;13
6186;Pabiručiai;"Viščiukų ";7101741906;Ne;0;0;7;7
6187;Pabiručiai;"Viščiukų ";3372218487;Ne;6;0;6;12
6188;Pabiručiai;"Viščiukų ";6044682613;Ne;5;0;4;9
6189;Pabiručiai;"Viščiukų ";7537470611;Ne;0;2;1;3
6190;Pabiručiai;"Viščiukų ";6581286069;Ne;8;0;3;11
6191;Pabiručiai;"Viščiukų ";3400423825;Ne;2;1;2;5
6192;Pabiručiai;"Viščiukų ";2116533837;Ne;12;0;1;13
6193;Pabiručiai;"Viščiukų ";5561666659;Ne;5;0;5;10
6194;Pabiručiai;"Viščiukų ";7183696280;Ne;0;3;0;3
6195;Pabiručiai;"Viščiukų ";6547174468;Ne;1;0;2;3
6196;Pabiručiai;"Viščiukų ";4554910957;Ne;6;2;4;12
6197;Pabiručiai;"Viščiukų ";7840617265;Ne;4;0;2;6
6198;Pabiručiai;"Viščiukų ";1424717472;Ne;3;0;6;9
6199;Pabiručiai;"Drugelių ";9890868992;Ne;12;0;3;15
6200;Pabiručiai;"Drugelių ";2556330147;Ne;0;17;0;17
6201;Pabiručiai;"Drugelių ";3004152898;Ne;0;11;0;11
6202;Pabiručiai;"Drugelių ";6481162347;Ne;7;0;2;9
6203;Pabiručiai;"Drugelių ";4701982784;Ne;3;0;4;7
6204;Pabiručiai;"Drugelių ";5147367745;Ne;8;0;3;11
6205;Pabiručiai;"Drugelių ";6612530931;Ne;10;0;4;14
6206;Pabiručiai;"Drugelių ";3189763918;Taip;0;8;0;8
6207;Pabiručiai;"Drugelių ";8268444485;Ne;1;0;4;5
6208;Pabiručiai;"Drugelių ";8066935182;Ne;3;0;3;6
6209;Pabiručiai;"Drugelių ";6831781849;Ne;8;0;2;10
6210;Pabiručiai;"Drugelių ";9878338803;Ne;5;0;6;11
6211;Pabiručiai;"Drugelių ";9297511341;Ne;5;0;3;8
6212;Pabiručiai;"Drugelių ";3886340836;Ne;8;0;6;14
6213;Pabiručiai;"Drugelių ";7067604564;Ne;3;0;11;14
6214;Pabiručiai;"Drugelių ";3486322043;Ne;18;0;2;20
6215;Pabiručiai;ŽIRNIUKŲ;9507212682;Ne;0;7;0;7
6216;Pabiručiai;ŽIRNIUKŲ;3239143202;Ne;20;0;2;22
6217;Pabiručiai;ŽIRNIUKŲ;8756826405;Ne;3;2;3;8
6218;Pabiručiai;ŽIRNIUKŲ;6059282085;Ne;6;2;3;11
6219;Pabiručiai;ŽIRNIUKŲ;4600476221;Ne;3;3;3;9
6220;Pabiručiai;ŽIRNIUKŲ;9042431134;Ne;5;0;2;7
6221;Pabiručiai;ŽIRNIUKŲ;1537534207;Ne;0;0;1;1
6222;Pabiručiai;ŽIRNIUKŲ;2142523078;Ne;10;0;4;14
6223;Pabiručiai;ŽIRNIUKŲ;4229089612;Ne;6;2;3;11
6224;Pabiručiai;ŽIRNIUKŲ;8834001928;Ne;5;4;2;11
6225;Pabiručiai;ŽIRNIUKŲ;9185016818;Ne;15;2;1;18
6226;Pabiručiai;ŽIRNIUKŲ;2141466782;Ne;3;2;4;9
6227;Pabiručiai;ŽIRNIUKŲ;9748002526;Ne;0;2;3;5
6228;Pabiručiai;ŽIRNIUKŲ;5436055219;Ne;4;1;4;9
6229;Pabiručiai;ŽIRNIUKŲ;6601800828;Ne;3;0;5;8
6230;Pabiručiai;ŽIRNIUKŲ;8074555646;Ne;2;1;3;6
6231;Pabiručiai;ŽIRNIUKŲ;7045558084;Ne;8;0;4;12
6232;Pagrandukas;Saulytės;6915087488;Ne;0;6;0;6
6233;Pagrandukas;Saulytės;6349387692;Ne;0;1;0;1
6234;Pagrandukas;Saulytės;8186092469;Ne;0;7;0;7
6235;Pagrandukas;Saulytės;2934300533;Ne;0;13;0;13
6236;Pagrandukas;Saulytės;1548697124;Ne;0;4;0;4
6237;Pagrandukas;Saulytės;6711830251;Ne;7;3;2;12
6238;Pagrandukas;Saulytės;7146697128;Ne;0;5;0;5
6239;Pagrandukas;Saulytės;3157676207;Ne;0;4;0;4
6240;Pagrandukas;Saulytės;7511097160;Ne;0;5;0;5
6241;Pagrandukas;Saulytės;3783160018;Ne;0;2;0;2
6242;Pagrandukas;Saulytės;7454863899;Ne;0;6;0;6
6243;Pagrandukas;Saulytės;5560372136;Ne;0;1;0;1
6244;Pagrandukas;Saulytės;1766912463;Ne;0;3;0;3
6245;Pagrandukas;Saulytės;9849054467;Ne;2;2;2;6
6246;Pagrandukas;Saulytės;8024910647;Ne;0;2;0;2
6247;Pagrandukas;Saulytės;8481502330;Ne;3;4;2;9
6248;Pagrandukas;Saulytės;7160305478;Ne;0;7;0;7
6249;Pagrandukas;Saulytės;6388805960;Ne;9;2;4;15
6250;Pagrandukas;Saulytės;8836178193;Ne;0;7;0;7
6251;Pagrandukas;Saulytės;7157549179;Ne;0;2;0;2
6252;Pagrandukas;Saulytės;3494047045;Ne;0;3;0;3
6253;Pagrandukas;Zuikučiai;7834436515;Ne;0;2;0;2
6254;Pagrandukas;Zuikučiai;7435609306;Ne;0;0;3;3
6255;Pagrandukas;Zuikučiai;5903416384;Ne;5;2;2;9
6256;Pagrandukas;Zuikučiai;2439891231;Ne;0;0;7;7
6257;Pagrandukas;Zuikučiai;6710887776;Ne;0;0;7;7
6258;Pagrandukas;Zuikučiai;7665811353;Ne;0;0;3;3
6259;Pagrandukas;Zuikučiai;2212787835;Ne;2;3;3;8
6260;Pagrandukas;Zuikučiai;6449029299;Ne;0;0;4;4
6261;Pagrandukas;Zuikučiai;1405820070;Ne;3;0;6;9
6262;Pagrandukas;Zuikučiai;1054107640;Ne;6;2;2;10
6263;Pagrandukas;Zuikučiai;1885539883;Ne;0;2;0;2
6264;Pagrandukas;Zuikučiai;1795582354;Ne;0;3;0;3
6265;Pagrandukas;Zuikučiai;2822538227;Ne;0;0;2;2
6266;Pagrandukas;Zuikučiai;1587839122;Ne;1;0;2;3
6267;Pagrandukas;Zuikučiai;2101505576;Ne;3;0;6;9
6268;Pagrandukas;Zuikučiai;6765346578;Ne;3;0;4;7
6269;Pagrandukas;Zuikučiai;5922595170;Ne;2;0;2;4
6270;Pagrandukas;Zuikučiai;5030928303;Ne;0;2;0;2
6271;Pagrandukas;Zuikučiai;9139212151;Ne;3;2;8;13
6272;Pagrandukas;Zuikučiai;8643993939;Ne;0;10;0;10
6273;Pagrandukas;Zuikučiai;5021106231;Ne;4;2;2;8
6274;Pagrandukas;Boružėlių;5330598431;Ne;6;0;2;8
6275;Pagrandukas;Boružėlių;9141829963;Ne;0;1;2;3
6276;Pagrandukas;Boružėlių;3643271023;Ne;4;2;5;11
6277;Pagrandukas;Boružėlių;7897742424;Ne;3;0;2;5
6278;Pagrandukas;Boružėlių;3313757952;Ne;8;0;2;10
6279;Pagrandukas;Boružėlių;4013188468;Ne;8;0;4;12
6280;Pagrandukas;Boružėlių;8812047984;Ne;6;2;5;13
6281;Pagrandukas;Boružėlių;2893099852;Ne;2;3;4;9
6282;Pagrandukas;Boružėlių;7219415600;Ne;0;1;0;1
6283;Pagrandukas;Boružėlių;1552515788;Ne;1;0;2;3
6284;Pagrandukas;Boružėlių;6506518248;Ne;0;24;0;24
6285;Pagrandukas;Boružėlių;2244308184;Ne;0;2;1;3
6286;Pagrandukas;Boružėlių;4730178155;Ne;4;0;4;8
6287;Pagrandukas;Boružėlių;8869609106;Ne;8;0;4;12
6288;Pagrandukas;Boružėlių;2752197975;Ne;2;0;6;8
6289;Pagrandukas;Boružėlių;8948739929;Ne;8;2;4;14
6290;Pagrandukas;Boružėlių;9390682686;Ne;5;0;2;7
6291;Pagrandukas;Bitutės;1583104760;Ne;3;3;2;8
6292;Pagrandukas;Bitutės;5649084353;Ne;5;1;2;8
6293;Pagrandukas;Bitutės;5821945401;Ne;5;0;2;7
6294;Pagrandukas;Bitutės;7675694987;Ne;6;2;2;10
6295;Pagrandukas;Bitutės;3709131197;Ne;3;1;2;6
6296;Pagrandukas;Bitutės;2764732768;Ne;0;1;2;3
6297;Pagrandukas;Bitutės;9987717045;Ne;8;3;2;13
6298;Pagrandukas;Bitutės;4771506131;Ne;0;0;6;6
6299;Pagrandukas;Bitutės;9798727946;Ne;8;0;5;13
6300;Pagrandukas;Bitutės;5464426019;Ne;3;0;4;7
6301;Pagrandukas;Bitutės;6845210200;Ne;0;10;3;13
6302;Pagrandukas;Bitutės;6090721838;Ne;8;0;4;12
6303;Pagrandukas;Bitutės;6129335910;Ne;3;0;12;15
6304;Pagrandukas;Bitutės;1780452241;Ne;0;5;0;5
6305;Pagrandukas;Bitutės;3795172018;Ne;0;0;3;3
6306;Pagrandukas;Bitutės;7147518086;Ne;15;2;2;19
6307;Pagrandukas;Bitutės;5604315555;Ne;0;0;2;2
6308;Pagrandukas;Bitutės;7784155503;Ne;0;0;2;2
6309;Pagrandukas;Bitutės;7605508460;Ne;0;5;0;5
6310;Pagrandukas;Bitutės;6304701617;Ne;0;2;0;2
6311;Pagrandukas;Bitutės;5511396314;Ne;0;7;0;7
6312;Pagrandukas;Bitutės;2481532396;Ne;6;1;4;11
6313;Pagrandukas;Pelėdžiukai;1714449109;Ne;0;5;0;5
6314;Pagrandukas;Pelėdžiukai;7764147734;Ne;0;2;0;2
6315;Pagrandukas;Pelėdžiukai;8633116370;Ne;0;2;0;2
6316;Pagrandukas;Pelėdžiukai;8167118045;Ne;0;0;1;1
6317;Pagrandukas;Pelėdžiukai;3390664086;Ne;0;6;0;6
6318;Pagrandukas;Pelėdžiukai;6011346969;Ne;0;1;0;1
6319;Pagrandukas;Pelėdžiukai;1077792535;Ne;0;3;0;3
6320;Pagrandukas;Pelėdžiukai;9583471280;Ne;0;3;0;3
6321;Pagrandukas;Pelėdžiukai;2640777376;Ne;3;0;2;5
6322;Pagrandukas;Pelėdžiukai;4910151924;Ne;7;0;2;9
6323;Pagrandukas;Pelėdžiukai;9431513632;Ne;0;2;0;2
6324;Pagrandukas;Pelėdžiukai;1977974235;Ne;0;2;0;2
6325;Pagrandukas;Pelėdžiukai;7238694532;Ne;2;4;4;10
6326;Pagrandukas;Pelėdžiukai;8789320226;Ne;0;0;2;2
6327;Pagrandukas;Pelėdžiukai;3569618725;Ne;3;6;4;13
6328;Pagrandukas;Pelėdžiukai;7498372078;Ne;0;2;0;2
6329;Pagrandukas;ŠYPSENĖLIŲ;4627387596;Ne;0;0;4;4
6330;Pagrandukas;ŠYPSENĖLIŲ;7173561328;Ne;4;0;4;8
6331;Pagrandukas;ŠYPSENĖLIŲ;1101989969;Ne;0;0;3;3
6332;Pagrandukas;ŠYPSENĖLIŲ;5701479990;Ne;0;0;7;7
6333;Pagrandukas;ŠYPSENĖLIŲ;9981610798;Ne;0;3;0;3
6334;Pagrandukas;ŠYPSENĖLIŲ;8027783692;Ne;0;0;3;3
6335;Pagrandukas;ŠYPSENĖLIŲ;2904880156;Ne;8;0;2;10
6336;Pagrandukas;ŠYPSENĖLIŲ;5173633710;Ne;0;0;6;6
6337;Pagrandukas;ŠYPSENĖLIŲ;6057078416;Ne;4;0;7;11
6338;Pagrandukas;ŠYPSENĖLIŲ;1855833141;Ne;0;0;2;2
6339;Pagrandukas;ŠYPSENĖLIŲ;1475375452;Ne;0;0;8;8
6340;Pagrandukas;ŠYPSENĖLIŲ;8475724797;Ne;2;0;2;4
6341;Pagrandukas;ŠYPSENĖLIŲ;5272914210;Ne;3;0;7;10
6342;Pagrandukas;ŠYPSENĖLIŲ;6517393406;Ne;0;0;4;4
6343;Pagrandukas;ŠYPSENĖLIŲ;4094086585;Ne;0;0;5;5
6344;Pagrandukas;ŠYPSENĖLIŲ;6306635507;Ne;0;7;0;7
6345;Pagrandukas;ŠYPSENĖLIŲ;5060059491;Ne;0;0;7;7
6346;Pagrandukas;ŠYPSENĖLIŲ;1728795744;Ne;0;0;2;2
6347;Pagrandukas;ŠYPSENĖLIŲ;8728782427;Ne;0;0;5;5
6348;Pagrandukas;ŠYPSENĖLIŲ;8638429638;Ne;2;0;4;6
6349;Pagrandukas;ŠYPSENĖLIŲ;1055791686;Ne;0;0;6;6
6350;Pakalnutė;Pagrandukai;7475119623;Ne;0;2;0;2
6351;Pakalnutė;Pagrandukai;9677810607;Ne;4;2;3;9
6352;Pakalnutė;Pagrandukai;5275833872;Ne;5;0;4;9
6353;Pakalnutė;Pagrandukai;5943686565;Ne;0;0;1;1
6354;Pakalnutė;Pagrandukai;2296079246;Ne;3;2;4;9
6355;Pakalnutė;Pagrandukai;9313588621;Ne;1;2;2;5
6356;Pakalnutė;Pagrandukai;7962849592;Ne;0;2;0;2
6357;Pakalnutė;Pagrandukai;5180015882;Ne;7;2;2;11
6358;Pakalnutė;Pagrandukai;3794283102;Ne;0;7;0;7
6359;Pakalnutė;Pagrandukai;3070652992;Ne;0;3;0;3
6360;Pakalnutė;Pagrandukai;7477188659;Ne;0;1;0;1
6361;Pakalnutė;Pagrandukai;8522585063;Ne;0;2;0;2
6362;Pakalnutė;Pagrandukai;4390444128;Ne;0;3;0;3
6363;Pakalnutė;Pagrandukai;2642359967;Ne;8;2;2;12
6364;Pakalnutė;Pagrandukai;7417131378;Ne;0;0;2;2
6365;Pakalnutė;Pagrandukai;6708041407;Ne;0;0;1;1
6366;Pakalnutė;Pagrandukai;1883500676;Ne;5;2;4;11
6367;Pakalnutė;Pagrandukai;9537826109;Ne;0;2;0;2
6368;Pakalnutė;Pagrandukai;7669135310;Ne;0;0;3;3
6369;Pakalnutė;Pagrandukai;5407487415;Ne;0;10;0;10
6370;Pakalnutė;"Pelėdžiukų ";8730363504;Ne;11;0;5;16
6371;Pakalnutė;"Pelėdžiukų ";6002425101;Ne;10;0;2;12
6372;Pakalnutė;"Pelėdžiukų ";6592271501;Ne;1;5;2;8
6373;Pakalnutė;"Pelėdžiukų ";7028010813;Ne;2;0;0;2
6374;Pakalnutė;"Pelėdžiukų ";9167525974;Ne;2;0;0;2
6375;Pakalnutė;"Pelėdžiukų ";6981958616;Ne;6;0;3;9
6376;Pakalnutė;"Pelėdžiukų ";3139358443;Ne;15;0;4;19
6377;Pakalnutė;"Pelėdžiukų ";1999933222;Ne;0;0;1;1
6378;Pakalnutė;"Pelėdžiukų ";1783674258;Ne;0;3;0;3
6379;Pakalnutė;"Pelėdžiukų ";9624523658;Ne;3;2;3;8
6380;Pakalnutė;"Pelėdžiukų ";9517878047;Ne;6;0;2;8
6381;Pakalnutė;"Pelėdžiukų ";1307260377;Ne;0;6;0;6
6382;Pakalnutė;"Pelėdžiukų ";6555749105;Ne;8;0;2;10
6383;Pakalnutė;"Pelėdžiukų ";9253328160;Ne;15;0;2;17
6384;Pakalnutė;"Pelėdžiukų ";6866535420;Ne;7;2;2;11
6385;Pakalnutė;Ežiukai;5058727058;Ne;8;2;2;12
6386;Pakalnutė;Ežiukai;4052166895;Ne;5;0;2;7
6387;Pakalnutė;Ežiukai;9323200833;Taip;5;3;2;10
6388;Pakalnutė;Ežiukai;9781993614;Ne;0;0;2;2
6389;Pakalnutė;Ežiukai;6029905101;Ne;4;0;4;8
6390;Pakalnutė;Ežiukai;7734657452;Ne;6;0;3;9
6391;Pakalnutė;Ežiukai;8081932074;Ne;1;0;4;5
6392;Pakalnutė;Ežiukai;7881545979;Ne;0;10;0;10
6393;Pakalnutė;Ežiukai;8080989574;Ne;10;0;2;12
6394;Pakalnutė;Ežiukai;5911381706;Ne;0;4;2;6
6395;Pakalnutė;Ežiukai;2755412687;Ne;2;0;0;2
6396;Pakalnutė;Ežiukai;8236718590;Ne;4;1;4;9
6397;Pakalnutė;Ežiukai;3064391379;Ne;14;0;2;16
6398;Pakalnutė;Ežiukai;2015778005;Ne;0;0;3;3
6399;Pakalnutė;Ežiukai;8329725085;Ne;2;0;2;4
6400;Pakalnutė;Ežiukai;1662773049;Ne;4;0;6;10
6401;Pakalnutė;Ežiukai;4961361687;Ne;0;3;1;4
6402;Pakalnutė;Ežiukai;5685361033;Ne;0;1;2;3
6403;Pakalnutė;Skruzdėliukų;4033813807;Ne;10;0;2;12
6404;Pakalnutė;Skruzdėliukų;7503936754;Ne;1;0;3;4
6405;Pakalnutė;Skruzdėliukų;5409476517;Ne;0;14;0;14
6406;Pakalnutė;Skruzdėliukų;2670302354;Ne;2;0;0;2
6407;Pakalnutė;Skruzdėliukų;7105369111;Ne;3;0;0;3
6408;Pakalnutė;Skruzdėliukų;6944726166;Ne;6;0;4;10
6409;Pakalnutė;Skruzdėliukų;1195872320;Ne;0;2;0;2
6410;Pakalnutė;Skruzdėliukų;3211633472;Ne;3;2;2;7
6411;Pakalnutė;Skruzdėliukų;4423348418;Ne;0;4;0;4
6412;Pakalnutė;Skruzdėliukų;6055727963;Ne;4;2;3;9
6413;Pakalnutė;Skruzdėliukų;3215438452;Taip;3;1;2;6
6414;Pakalnutė;Skruzdėliukų;9681515221;Ne;3;0;2;5
6415;Pakalnutė;Skruzdėliukų;8496839980;Ne;8;2;4;14
6416;Pakalnutė;Skruzdėliukų;9336711927;Ne;4;0;0;4
6417;Pakalnutė;Skruzdėliukų;5356902834;Ne;6;0;2;8
6418;Pakalnutė;Skruzdėliukų;1540045675;Ne;0;5;0;5
6419;Pakalnutė;Skruzdėliukų;8768704484;Ne;0;0;1;1
6420;Pakalnutė;Skruzdėliukų;6675588261;Ne;17;0;2;19
6421;Pakalnutė;Bitučių;8461220770;Ne;0;2;0;2
6422;Pakalnutė;Bitučių;2367683002;Ne;0;2;0;2
6423;Pakalnutė;Bitučių;2765220889;Ne;0;4;0;4
6424;Pakalnutė;Bitučių;9445909071;Ne;0;7;0;7
6425;Pakalnutė;Bitučių;5532458706;Ne;2;4;2;8
6426;Pakalnutė;Bitučių;7526989580;Ne;1;2;2;5
6427;Pakalnutė;Bitučių;5941955322;Ne;0;2;0;2
6428;Pakalnutė;Bitučių;3306334576;Ne;9;0;2;11
6429;Pakalnutė;Bitučių;2095540372;Ne;1;3;2;6
6430;Pakalnutė;Bitučių;5342592825;Ne;0;1;0;1
6431;Pakalnutė;Bitučių;5464143742;Ne;9;2;6;17
6432;Pakalnutė;Bitučių;6351193702;Ne;2;2;2;6
6433;Pakalnutė;Bitučių;2070744110;Ne;0;2;0;2
6434;Pakalnutė;Bitučių;3965390135;Ne;0;2;3;5
6435;Pakalnutė;Bitučių;5355198213;Ne;0;3;2;5
6436;Pakalnutė;Bitučių;4533467194;Ne;0;0;1;1
6437;Pakalnutė;Bitučių;4523766424;Ne;0;4;3;7
6438;Pakalnutė;Bitučių;4452372238;Ne;2;3;3;8
6439;Pakalnutė;Bitučių;2992768162;Ne;0;3;0;3
6440;Pakalnutė;Bitučių;9505524183;Ne;0;15;0;15
6441;Pakalnutė;Bitučių;8900756351;Ne;5;2;0;7
6442;Pakalnutė;Bitučių;1330092247;Ne;7;2;4;13
6443;Pakalnutė;Bitučių;3267680599;Ne;0;2;2;4
6444;Pakalnutė;Boružiukų;6798939288;Ne;0;3;0;3
6445;Pakalnutė;Boružiukų;7357431226;Ne;6;2;2;10
6446;Pakalnutė;Boružiukų;4934095931;Ne;0;2;0;2
6447;Pakalnutė;Boružiukų;5039000154;Ne;0;1;0;1
6448;Pakalnutė;Boružiukų;2835611316;Ne;3;1;4;8
6449;Pakalnutė;Boružiukų;4950195858;Ne;1;2;3;6
6450;Pakalnutė;Boružiukų;4927086034;Ne;2;2;2;6
6451;Pakalnutė;Boružiukų;6557165567;Ne;0;2;0;2
6452;Pakalnutė;Boružiukų;3677709759;Ne;2;0;3;5
6453;Pakalnutė;Boružiukų;2597900983;Ne;1;4;2;7
6454;Pakalnutė;Boružiukų;2062721289;Ne;0;4;1;5
6455;Pakalnutė;Boružiukų;1340022702;Ne;5;2;2;9
6456;Pakalnutė;Boružiukų;6228196996;Ne;2;0;3;5
6457;Pakalnutė;Boružiukų;5619262190;Ne;0;2;0;2
6458;Pakalnutė;Boružiukų;8553182620;Ne;0;2;0;2
6459;Pakalnutė;Boružiukų;3840499737;Ne;0;2;1;3
6460;Pakalnutė;Boružiukų;4220368864;Ne;1;3;2;6
6461;Pakalnutė;Boružiukų;7151877991;Ne;0;2;1;3
6462;Pakalnutė;Boružiukų;4353883274;Ne;6;2;3;11
6463;Pakalnutė;Boružiukų;8823232039;Ne;0;1;0;1
6464;Pakalnutė;Meškiukų;2101821362;Ne;0;3;0;3
6465;Pakalnutė;Meškiukų;4069910346;Taip;0;6;0;6
6466;Pakalnutė;Meškiukų;4313652059;Ne;0;6;0;6
6467;Pakalnutė;Meškiukų;7084798190;Ne;0;10;0;10
6468;Pakalnutė;Meškiukų;6133481935;Ne;0;3;0;3
6469;Pakalnutė;Meškiukų;3693337607;Ne;0;2;0;2
6470;Pakalnutė;Meškiukų;8576580816;Ne;0;1;0;1
6471;Pakalnutė;Meškiukų;7696196458;Ne;0;8;0;8
6472;Pakalnutė;Meškiukų;9327477300;Ne;0;2;0;2
6473;Pakalnutė;Nykštukai;9918277117;Taip;1;0;2;3
6474;Pakalnutė;Nykštukai;3870628774;Ne;0;0;4;4
6475;Pakalnutė;Nykštukai;8324219868;Ne;0;0;1;1
6476;Pakalnutė;Nykštukai;1864990681;Ne;0;0;1;1
6477;Pakalnutė;Nykštukai;2063766287;Ne;8;1;2;11
6478;Pakalnutė;Nykštukai;6528913736;Ne;0;6;0;6
6479;Pakalnutė;Nykštukai;8217779439;Ne;8;1;2;11
6480;Pakalnutė;Nykštukai;6206296685;Ne;2;0;0;2
6481;Pakalnutė;Nykštukai;8855237588;Ne;2;0;0;2
6482;Pakalnutė;Nykštukai;9443826616;Ne;2;0;0;2
6483;Pakalnutė;Nykštukai;7024440142;Ne;0;3;0;3
6484;Pakalnutė;Nykštukai;2578170222;Ne;2;0;1;3
6485;Pakalnutė;Nykštukai;3967515235;Ne;0;2;0;2
6486;Pakalnutė;Nykštukai;5377715404;Ne;4;0;4;8
6487;Pakalnutė;Nykštukai;3938091521;Ne;0;15;0;15
6488;Pakalnutė;Nykštukai;4971065032;Ne;1;0;2;3
6489;Pakalnutė;"Zuikučių ";3992958274;Ne;8;7;2;17
6490;Pakalnutė;"Zuikučių ";7665013940;Ne;0;0;4;4
6491;Pakalnutė;"Zuikučių ";5366218312;Ne;0;0;2;2
6492;Pakalnutė;"Zuikučių ";9093281442;Ne;13;0;4;17
6493;Pakalnutė;"Zuikučių ";5712352356;Ne;11;2;4;17
6494;Pakalnutė;"Zuikučių ";6346936964;Ne;11;0;4;15
6495;Pakalnutė;"Zuikučių ";8678783379;Ne;0;0;3;3
6496;Pakalnutė;"Zuikučių ";7200174700;Ne;0;2;4;6
6497;Pakalnutė;"Zuikučių ";2364777781;Ne;9;0;2;11
6498;Pakalnutė;"Zuikučių ";6817504559;Ne;1;0;2;3
6499;Pakalnutė;"Zuikučių ";4926207043;Ne;7;2;2;11
6500;Pakalnutė;"Zuikučių ";9324190244;Ne;8;7;2;17
6501;Pakalnutė;"Zuikučių ";1044084070;Ne;0;0;1;1
6502;Pakalnutė;"Zuikučių ";4587376166;Ne;1;0;5;6
6503;Pakalnutė;"Zuikučių ";7696333378;Ne;0;22;0;22
6504;Pakalnutė;"Zuikučių ";5328042222;Ne;4;2;2;8
6505;Pakalnutė;"Drugelių ";5441477374;Ne;0;10;0;10
6506;Pakalnutė;"Drugelių ";7369661890;Ne;1;0;2;3
6507;Pakalnutė;"Drugelių ";5135811550;Ne;0;2;0;2
6508;Pakalnutė;"Drugelių ";7766653114;Ne;1;2;4;7
6509;Pakalnutė;"Drugelių ";9620000116;Ne;4;7;4;15
6510;Pakalnutė;"Drugelių ";5502444590;Ne;0;0;1;1
6511;Pakalnutė;"Drugelių ";3730712580;Ne;0;0;4;4
6512;Pakalnutė;"Drugelių ";1824418095;Ne;0;1;0;1
6513;Pakalnutė;"Drugelių ";4220406978;Ne;0;2;0;2
6514;Pakalnutė;"Drugelių ";5069038636;Ne;0;22;0;22
6515;Pakalnutė;"Drugelių ";7047587606;Ne;15;4;0;19
6516;Pakalnutė;"Drugelių ";2653667596;Ne;2;2;3;7
6517;Pakalnutė;"Drugelių ";2197533802;Ne;5;2;4;11
6518;Pakalnutė;"Drugelių ";1791607977;Ne;0;2;0;2
6519;Pakalnutė;"Drugelių ";4127500142;Ne;0;0;2;2
6520;Pakalnutė;"Drugelių ";9295709508;Ne;1;2;5;8
6521;Pakalnutė;"Drugelių ";6924023022;Ne;2;0;2;4
6522;Pakalnutė;"Drugelių ";8105507156;Ne;0;4;0;4
6523;Pakalnutė;Žvirbliukų;7421275778;Ne;4;1;2;7
6524;Pakalnutė;Žvirbliukų;3190067149;Ne;0;11;0;11
6525;Pakalnutė;Žvirbliukų;8010667913;Ne;16;0;2;18
6526;Pakalnutė;Žvirbliukų;5531209454;Ne;22;0;0;22
6527;Pakalnutė;Žvirbliukų;3342793992;Ne;2;0;0;2
6528;Pakalnutė;Žvirbliukų;7258417347;Ne;5;0;2;7
6529;Pakalnutė;Žvirbliukų;5878352514;Ne;2;0;2;4
6530;Pakalnutė;Žvirbliukų;7782295402;Ne;5;2;2;9
6531;Pakalnutė;Žvirbliukų;7547661599;Taip;2;2;6;10
6532;Pakalnutė;Žvirbliukų;4469974699;Ne;4;2;2;8
6533;Pakalnutė;Žvirbliukų;6159955311;Ne;3;0;2;5
6534;Pakalnutė;Žvirbliukų;3903972025;Ne;1;1;2;4
6535;Pakalnutė;Žvirbliukų;3458404368;Ne;3;1;6;10
6536;Pakalnutė;Žvirbliukų;5683073863;Ne;3;0;2;5
6537;Pakalnutė;Žvirbliukų;8394290574;Ne;2;0;1;3
6538;Pakalnutė;Žvirbliukų;8104124782;Ne;22;0;0;22
6539;Pakalnutė;Žvirbliukų;1368254053;Ne;6;0;2;8
6540;Pakalnutė;Žvirbliukų;6361966325;Ne;6;0;2;8
6541;Panerių;Rūtelė;9268618414;Ne;4;0;3;7
6542;Panerių;Rūtelė;3190117304;Taip;0;9;0;9
6543;Panerių;Rūtelė;8693113275;Taip;11;0;6;17
6544;Panerių;Rūtelė;9630302749;Ne;0;0;1;1
6545;Panerių;Rūtelė;3057714143;Ne;1;2;0;3
6546;Panerių;Rūtelė;9432171719;Ne;4;2;4;10
6547;Panerių;Rūtelė;1717129076;Ne;15;0;4;19
6548;Panerių;Rūtelė;2035822976;Ne;3;0;6;9
6549;Panerių;Rūtelė;9729731866;Ne;0;0;3;3
6550;Panerių;Rūtelė;6583134855;Ne;0;0;5;5
6551;Panerių;Rūtelė;4161189870;Ne;4;0;6;10
6552;Panerių;Rūtelė;9004310393;Ne;3;0;2;5
6553;Panerių;Rūtelė;3948776877;Ne;0;0;4;4
6554;Panerių;Rūtelė;8514805919;Ne;0;2;0;2
6555;Panerių;Rūtelė;2751334281;Ne;0;2;4;6
6556;Panerių;Rūtelė;1339256258;Ne;7;0;4;11
6557;Panerių;Rūtelė;3882802840;Ne;0;0;3;3
6558;Panerių;Gėlytės;5452996791;Ne;1;0;2;3
6559;Panerių;Gėlytės;3112608087;Taip;0;10;0;10
6560;Panerių;Gėlytės;5100874548;Taip;0;0;2;2
6561;Panerių;Gėlytės;9955613696;Ne;3;2;2;7
6562;Panerių;Gėlytės;6304387432;Ne;6;2;2;10
6563;Panerių;Gėlytės;7166964095;Ne;0;0;2;2
6564;Panerių;Gėlytės;7657860513;Taip;0;10;0;10
6565;Panerių;Gėlytės;4716214117;Ne;0;3;0;3
6566;Panerių;Gėlytės;4369979548;Taip;0;2;0;2
6567;Panerių;Gėlytės;9014387764;Ne;0;3;0;3
6568;Panerių;Gėlytės;3273655606;Ne;2;0;2;4
6569;Panerių;Gėlytės;8067240250;Ne;2;0;5;7
6570;Panerių;Gėlytės;8407995549;Ne;3;5;2;10
6571;Panerių;Gėlytės;3502494751;Ne;6;0;3;9
6572;Panerių;Gėlytės;6574858142;Ne;11;0;5;16
6573;Panerių;Gėlytės;6653710644;Ne;0;2;2;4
6574;Panerių;Gėlytės;4957564440;Ne;0;2;1;3
6575;Panerių;Gėlytės;7976634590;Taip;2;0;5;7
6576;Panerių;Gėlytės;1985780685;Ne;9;0;4;13
6577;Panerių;Boružė;5938568445;Ne;6;0;4;10
6578;Panerių;Boružė;8204542330;Ne;15;0;2;17
6579;Panerių;Boružė;9834947195;Ne;3;2;2;7
6580;Panerių;Boružė;7665286465;Ne;11;0;3;14
6581;Panerių;Boružė;7674680327;Ne;6;0;3;9
6582;Panerių;Boružė;2411155582;Ne;0;0;2;2
6583;Panerių;Boružė;9658945394;Ne;2;0;2;4
6584;Panerių;Boružė;5243109212;Ne;14;0;4;18
6585;Panerių;Boružė;7516118069;Ne;0;2;0;2
6586;Panerių;Boružė;9157312277;Ne;9;0;4;13
6587;Panerių;Boružė;5836583423;Ne;2;0;0;2
6588;Panerių;Boružė;6903412424;Ne;0;2;0;2
6589;Panerių;Boružė;7200320230;Ne;2;6;2;10
6590;Papartis;ZUIKUČIAI;8874222586;Ne;3;5;2;10
6591;Papartis;ZUIKUČIAI;2446379598;Ne;6;0;3;9
6592;Papartis;ZUIKUČIAI;3054883426;Ne;3;2;2;7
6593;Papartis;ZUIKUČIAI;1191546794;Ne;0;5;2;7
6594;Papartis;ZUIKUČIAI;7619963429;Ne;2;5;2;9
6595;Papartis;ZUIKUČIAI;8958880558;Ne;0;3;1;4
6596;Papartis;ZUIKUČIAI;4380030213;Ne;5;2;5;12
6597;Papartis;ZUIKUČIAI;4906248064;Ne;0;6;1;7
6598;Papartis;ZUIKUČIAI;8447326505;Ne;0;2;0;2
6599;Papartis;ZUIKUČIAI;1919362027;Ne;0;0;2;2
6600;Papartis;ZUIKUČIAI;4640068595;Ne;0;0;1;1
6601;Papartis;ZUIKUČIAI;9375751990;Ne;5;2;2;9
6602;Papartis;ZUIKUČIAI;5786648402;Ne;0;2;1;3
6603;Papartis;ZUIKUČIAI;5579899922;Ne;3;0;4;7
6604;Papartis;ZUIKUČIAI;9358310527;Ne;1;5;2;8
6605;Papartis;ZUIKUČIAI;5363926529;Ne;2;8;2;12
6606;Papartis;ZUIKUČIAI;1722192450;Ne;0;3;0;3
6607;Papartis;ZUIKUČIAI;8897061283;Ne;9;0;0;9
6608;Papartis;DRUGELIAI;8005876431;Ne;0;22;0;22
6609;Papartis;DRUGELIAI;6664178454;Ne;7;0;0;7
6610;Papartis;DRUGELIAI;2432516496;Ne;1;4;3;8
6611;Papartis;DRUGELIAI;7742769931;Ne;1;1;5;7
6612;Papartis;DRUGELIAI;8305560946;Ne;2;0;0;2
6613;Papartis;DRUGELIAI;4778327620;Ne;0;5;0;5
6614;Papartis;DRUGELIAI;7486667034;Ne;0;0;1;1
6615;Papartis;DRUGELIAI;7331682622;Ne;7;3;2;12
6616;Papartis;DRUGELIAI;2824078830;Ne;0;2;5;7
6617;Papartis;DRUGELIAI;8782882575;Ne;6;2;0;8
6618;Papartis;DRUGELIAI;1405767603;Ne;0;3;1;4
6619;Papartis;DRUGELIAI;6435625940;Ne;3;2;2;7
6620;Papartis;DRUGELIAI;7187797639;Ne;2;0;0;2
6621;Papartis;DRUGELIAI;3411472740;Ne;6;2;7;15
6622;Papartis;DRUGELIAI;8277830926;Ne;4;0;2;6
6623;Papartis;DRUGELIAI;1759982543;Ne;0;4;1;5
6624;Papartis;DRUGELIAI;4689046394;Ne;0;3;0;3
6625;Papartis;DRUGELIAI;5430993785;Ne;5;1;0;6
6626;Papartis;ŽVIRBLIUKAI;9380951144;Ne;3;0;3;6
6627;Papartis;ŽVIRBLIUKAI;2812347963;Ne;0;8;0;8
6628;Papartis;ŽVIRBLIUKAI;3685642787;Ne;3;0;2;5
6629;Papartis;ŽVIRBLIUKAI;8420752169;Ne;5;2;2;9
6630;Papartis;ŽVIRBLIUKAI;4016297254;Ne;20;0;2;22
6631;Papartis;ŽVIRBLIUKAI;6585372451;Ne;2;2;2;6
6632;Papartis;ŽVIRBLIUKAI;6734567714;Ne;0;1;0;1
6633;Papartis;ŽVIRBLIUKAI;4597039190;Ne;2;5;0;7
6634;Papartis;ŽVIRBLIUKAI;1352401881;Ne;6;0;4;10
6635;Papartis;ŽVIRBLIUKAI;1231594320;Ne;3;1;2;6
6636;Papartis;ŽVIRBLIUKAI;3539507686;Ne;0;3;0;3
6637;Papartis;ŽVIRBLIUKAI;5465955537;Ne;1;2;5;8
6638;Papartis;ŽVIRBLIUKAI;6346776139;Ne;7;0;4;11
6639;Papartis;ŽVIRBLIUKAI;3595627659;Ne;2;0;2;4
6640;Papartis;ŽVIRBLIUKAI;6977513472;Ne;0;2;0;2
6641;Papartis;ŽVIRBLIUKAI;5323875279;Ne;8;5;2;15
6642;Papartis;ŽVIRBLIUKAI;5070767260;Ne;0;0;1;1
6643;Papartis;PELĖDŽIUKAI;9502229005;Ne;0;2;1;3
6644;Papartis;PELĖDŽIUKAI;1559196767;Ne;0;2;1;3
6645;Papartis;PELĖDŽIUKAI;5652560002;Ne;3;2;2;7
6646;Papartis;PELĖDŽIUKAI;6360881137;Ne;0;1;1;2
6647;Papartis;PELĖDŽIUKAI;6794076631;Ne;0;2;1;3
6648;Papartis;PELĖDŽIUKAI;6941978169;Ne;3;0;1;4
6649;Papartis;PELĖDŽIUKAI;4203241118;Ne;0;2;1;3
6650;Papartis;PELĖDŽIUKAI;9285319899;Ne;0;3;0;3
6651;Papartis;PELĖDŽIUKAI;5942160584;Ne;8;2;2;12
6652;Papartis;PELĖDŽIUKAI;9922091482;Ne;1;3;2;6
6653;Papartis;PELĖDŽIUKAI;1680412204;Ne;0;0;1;1
6654;Papartis;PELĖDŽIUKAI;6423401656;Ne;0;2;0;2
6655;Papartis;PELĖDŽIUKAI;9384670351;Ne;0;3;1;4
6656;Papartis;PELĖDŽIUKAI;4509843536;Ne;3;2;4;9
6657;Papartis;PELĖDŽIUKAI;6883101103;Ne;0;2;1;3
6658;Papartis;PELĖDŽIUKAI;4878190663;Ne;9;1;2;12
6659;Papartis;PELĖDŽIUKAI;9900023788;Ne;2;0;0;2
6660;Papartis;PELĖDŽIUKAI;9704930584;Ne;0;2;0;2
6661;Papartis;PELĖDŽIUKAI;9072635586;Ne;0;4;4;8
6662;Papartis;PELĖDŽIUKAI;1442806517;Ne;0;2;0;2
6663;Papartis;SAULUTĖS;8836419340;Ne;0;3;0;3
6664;Papartis;SAULUTĖS;8187136860;Ne;2;0;0;2
6665;Papartis;SAULUTĖS;6408828474;Ne;7;1;1;9
6666;Papartis;SAULUTĖS;1428163291;Ne;12;0;0;12
6667;Papartis;SAULUTĖS;6436061438;Ne;5;0;2;7
6668;Papartis;SAULUTĖS;8423259604;Ne;0;6;0;6
6669;Papartis;SAULUTĖS;4887468138;Ne;2;0;1;3
6670;Papartis;SAULUTĖS;8866437550;Ne;2;0;0;2
6671;Papartis;SAULUTĖS;9731930047;Ne;13;0;2;15
6672;Papartis;SAULUTĖS;3948323728;Ne;5;0;2;7
6673;Papartis;SAULUTĖS;2004327439;Ne;2;0;0;2
6674;Papartis;SAULUTĖS;6199807321;Ne;11;2;3;16
6675;Papartis;SAULUTĖS;4767287348;Ne;10;4;2;16
6676;Papartis;SAULUTĖS;4983959118;Ne;17;0;2;19
6677;Papartis;SAULUTĖS;6352542412;Ne;4;0;3;7
6678;Papartis;GANDRIUKAI;4969807705;Ne;0;1;0;1
6679;Papartis;GANDRIUKAI;5383936595;Ne;0;5;0;5
6680;Papartis;GANDRIUKAI;1698871014;Ne;7;7;2;16
6681;Papartis;GANDRIUKAI;6274608449;Ne;7;3;5;15
6682;Papartis;GANDRIUKAI;6664773988;Ne;0;3;0;3
6683;Papartis;GANDRIUKAI;8875490564;Ne;4;0;4;8
6684;Papartis;GANDRIUKAI;2921187615;Ne;6;0;3;9
6685;Papartis;GANDRIUKAI;5128663521;Ne;2;0;2;4
6686;Papartis;GANDRIUKAI;4500675679;Ne;0;4;0;4
6687;Papartis;GANDRIUKAI;7203919287;Ne;0;8;0;8
6688;Papartis;GANDRIUKAI;1486770896;Ne;3;0;3;6
6689;Papartis;GANDRIUKAI;5132031416;Ne;13;1;2;16
6690;Papartis;GANDRIUKAI;3395306653;Ne;13;7;2;22
6691;Papartis;GANDRIUKAI;1616537800;Ne;0;3;0;3
6692;Papartis;GANDRIUKAI;8303599213;Ne;0;2;0;2
6693;Papartis;GANDRIUKAI;9326439257;Ne;5;0;4;9
6694;Papartis;GANDRIUKAI;8410744610;Ne;4;3;2;9
6695;Papartis;AITVARELIAI;8891856856;Ne;0;2;0;2
6696;Papartis;AITVARELIAI;6889782462;Taip;0;3;0;3
6697;Papartis;AITVARELIAI;5736456872;Ne;0;1;0;1
6698;Papartis;AITVARELIAI;3040269026;Ne;0;1;0;1
6699;Papartis;AITVARELIAI;8532558577;Ne;3;3;2;8
6700;Papartis;AITVARELIAI;4918854899;Ne;0;3;0;3
6701;Papartis;AITVARELIAI;5252947502;Ne;11;3;4;18
6702;Papartis;AITVARELIAI;1916222143;Ne;0;3;0;3
6703;Papartis;AITVARELIAI;7018190169;Ne;0;1;0;1
6704;Papartis;AITVARELIAI;7803854703;Ne;0;2;0;2
6705;Papartis;AITVARELIAI;4261270064;Ne;3;1;2;6
6706;Papartis;AITVARELIAI;6416605464;Ne;3;0;2;5
6707;Papartis;AITVARELIAI;1266338760;Ne;0;1;0;1
6708;Papartis;AITVARELIAI;7504793827;Ne;8;0;2;10
6709;Papartis;AITVARELIAI;7156767639;Ne;0;6;0;6
6710;Papartis;AITVARELIAI;5268226380;Ne;0;1;1;2
6711;Papartis;AITVARELIAI;2116140075;Ne;7;1;0;8
6712;Papartis;AITVARELIAI;3896803048;Ne;6;2;2;10
6713;Papartis;AITVARELIAI;4138926711;Taip;3;0;2;5
6714;Papartis;AITVARELIAI;8989172483;Ne;14;0;6;20
6715;Papartis;SMALSUČIAI;5660932637;Ne;8;3;2;13
6716;Papartis;SMALSUČIAI;3576856223;Ne;0;5;0;5
6717;Papartis;SMALSUČIAI;5259754395;Ne;0;7;0;7
6718;Papartis;SMALSUČIAI;1157298413;Ne;3;0;0;3
6719;Papartis;SMALSUČIAI;3107245976;Ne;2;0;0;2
6720;Papartis;SMALSUČIAI;1381195839;Ne;0;0;1;1
6721;Papartis;SMALSUČIAI;5959006739;Ne;8;0;4;12
6722;Papartis;SMALSUČIAI;6776383676;Ne;8;0;2;10
6723;Papartis;SMALSUČIAI;2079105902;Ne;3;0;3;6
6724;Papartis;SMALSUČIAI;9838432144;Ne;2;3;0;5
6725;Papartis;SMALSUČIAI;9884399306;Ne;2;3;0;5
6726;Papartis;SMALSUČIAI;1511111597;Ne;1;0;4;5
6727;Papartis;SMALSUČIAI;8055310718;Ne;3;0;2;5
6728;Papartis;SMALSUČIAI;3490370261;Ne;11;2;4;17
6729;Papartis;SMALSUČIAI;1566259150;Ne;0;0;3;3
6730;Papartis;SMALSUČIAI;1159418157;Ne;2;6;4;12
6731;Papartis;SMALSUČIAI;4087823915;Ne;0;0;5;5
6732;Papartis;SMALSUČIAI;1293528737;Ne;4;0;2;6
6733;Papartis;"ŽIRNIUKAI ";3310893254;Ne;6;0;4;10
6734;Papartis;"ŽIRNIUKAI ";1073755384;Ne;15;0;2;17
6735;Papartis;"ŽIRNIUKAI ";7647225316;Ne;8;4;2;14
6736;Papartis;"ŽIRNIUKAI ";1210592579;Ne;0;0;1;1
6737;Papartis;"ŽIRNIUKAI ";1519815331;Ne;9;1;3;13
6738;Papartis;"ŽIRNIUKAI ";4158525314;Ne;15;0;5;20
6739;Papartis;"ŽIRNIUKAI ";4978398085;Ne;12;3;2;17
6740;Papartis;"ŽIRNIUKAI ";9746397380;Ne;9;0;7;16
6741;Papartis;"ŽIRNIUKAI ";4952279543;Taip;0;14;0;14
6742;Papartis;"ŽIRNIUKAI ";5276806556;Ne;8;2;2;12
6743;Papartis;"ŽIRNIUKAI ";2521609574;Taip;9;0;3;12
6744;Papartis;"ŽIRNIUKAI ";7617558492;Ne;11;0;4;15
6745;Papartis;"ŽIRNIUKAI ";8412962815;Ne;5;0;2;7
6746;Papartis;"ŽIRNIUKAI ";2772758899;Ne;7;2;4;13
6747;Papartis;"ŽIRNIUKAI ";1183123161;Taip;1;0;3;4
6748;Papartis;"ŽIRNIUKAI ";1150772988;Ne;4;3;2;9
6749;Papartis;"ŽIRNIUKAI ";9518392031;Ne;8;0;3;11
6750;Papartis;"ŽIRNIUKAI ";1614261572;Ne;3;4;4;11
6751;Papartis;"ŽIRNIUKAI ";8834463589;Ne;0;1;0;1
6752;Papartis;BORUŽĖLĖS;4156776066;Ne;5;0;5;10
6753;Papartis;BORUŽĖLĖS;4394324806;Ne;15;0;2;17
6754;Papartis;BORUŽĖLĖS;4128791207;Ne;15;0;2;17
6755;Papartis;BORUŽĖLĖS;1713966292;Ne;4;0;2;6
6756;Papartis;BORUŽĖLĖS;6512648672;Ne;1;19;2;22
6757;Papartis;BORUŽĖLĖS;6971029839;Ne;5;0;2;7
6758;Papartis;BORUŽĖLĖS;3671248088;Ne;0;3;0;3
6759;Papartis;BORUŽĖLĖS;3033128518;Ne;3;1;4;8
6760;Papartis;BORUŽĖLĖS;3138701373;Ne;7;0;3;10
6761;Papartis;BORUŽĖLĖS;4800482635;Ne;4;0;2;6
6762;Papartis;BORUŽĖLĖS;2833918272;Taip;3;0;2;5
6763;Papartis;BORUŽĖLĖS;4656732095;Ne;0;0;3;3
6764;Papartis;BORUŽĖLĖS;8015824674;Ne;3;0;2;5
6765;Papartis;BORUŽĖLĖS;5459468987;Ne;7;0;4;11
6766;Papartis;VARPELIAI;8501388069;Ne;2;3;2;7
6767;Papartis;VARPELIAI;3639299679;Ne;3;2;2;7
6768;Papartis;VARPELIAI;5796633935;Ne;11;2;4;17
6769;Papartis;VARPELIAI;9141478403;Ne;18;0;2;20
6770;Papartis;VARPELIAI;5073439000;Ne;7;1;4;12
6771;Papartis;VARPELIAI;1390187546;Ne;8;0;4;12
6772;Papartis;VARPELIAI;6559847250;Ne;10;0;2;12
6773;Papartis;VARPELIAI;6053981340;Ne;10;0;2;12
6774;Papartis;VARPELIAI;5038105723;Ne;2;0;2;4
6775;Papartis;VARPELIAI;3327404107;Ne;5;0;2;7
6776;Papartis;VARPELIAI;3535455931;Ne;2;0;2;4
6777;Papartis;VARPELIAI;4839033346;Ne;8;0;3;11
6778;Papartis;VARPELIAI;5063367652;Ne;8;2;2;12
6779;Papartis;VARPELIAI;4620041887;Ne;2;0;2;4
6780;Papartis;VARPELIAI;1032653411;Ne;8;0;2;10
6781;Papartis;NYKŠTUKAI;7260304487;Ne;0;2;0;2
6782;Papartis;NYKŠTUKAI;9581159294;Ne;0;3;0;3
6783;Papartis;NYKŠTUKAI;2956950308;Ne;2;0;0;2
6784;Papartis;NYKŠTUKAI;6710049689;Ne;3;0;4;7
6785;Papartis;NYKŠTUKAI;2777359899;Ne;0;3;0;3
6786;Papartis;NYKŠTUKAI;3345085436;Ne;3;0;4;7
6787;Papartis;NYKŠTUKAI;7189999679;Ne;1;0;2;3
6788;Papartis;NYKŠTUKAI;4256878733;Ne;2;0;2;4
6789;Papartis;NYKŠTUKAI;8443731277;Ne;2;0;3;5
6790;Papartis;NYKŠTUKAI;3419374226;Ne;0;0;15;15
6791;Papartis;NYKŠTUKAI;8642079824;Ne;0;3;3;6
6792;Papartis;NYKŠTUKAI;2421158534;Ne;3;1;0;4
6793;Papartis;NYKŠTUKAI;2600724041;Ne;3;1;2;6
6794;Papartis;NYKŠTUKAI;8872914372;Ne;0;3;2;5
6795;Papartis;NYKŠTUKAI;2053568874;Ne;6;0;0;6
6796;Papartis;NYKŠTUKAI;3173271837;Ne;0;2;0;2
6797;Papartis;NYKŠTUKAI;4952700737;Ne;3;3;5;11
6798;Papartis;NYKŠTUKAI;9881509036;Ne;9;0;4;13
6799;Pasaka;Drugelių;2308992563;Ne;12;2;2;16
6800;Pasaka;Drugelių;7955645490;Ne;0;2;1;3
6801;Pasaka;Drugelių;9249389876;Ne;1;0;3;4
6802;Pasaka;Drugelių;2961210575;Ne;7;2;1;10
6803;Pasaka;Drugelių;2383607612;Ne;0;4;0;4
6804;Pasaka;Drugelių;5351364328;Ne;7;2;4;13
6805;Pasaka;Drugelių;4635912654;Ne;7;2;4;13
6806;Pasaka;Drugelių;9136521759;Ne;0;5;0;5
6807;Pasaka;Drugelių;2293613528;Ne;0;1;0;1
6808;Pasaka;Drugelių;5412931969;Ne;5;0;2;7
6809;Pasaka;Drugelių;6326056771;Ne;2;3;2;7
6810;Pasaka;Drugelių;4175157894;Ne;7;2;2;11
6811;Pasaka;Drugelių;7252498738;Ne;3;0;3;6
6812;Pasaka;Drugelių;4183646305;Ne;3;0;1;4
6813;Pasaka;Nykštukų;5768958388;Ne;4;2;4;10
6814;Pasaka;Nykštukų;2797217440;Taip;3;1;2;6
6815;Pasaka;Nykštukų;7292437626;Ne;0;3;2;5
6816;Pasaka;Nykštukų;2211744442;Ne;0;0;1;1
6817;Pasaka;Nykštukų;5912306325;Ne;5;2;2;9
6818;Pasaka;Nykštukų;2217868951;Ne;7;2;2;11
6819;Pasaka;Nykštukų;2217868951;Ne;7;2;2;11
6820;Pasaka;Nykštukų;2217868951;Ne;7;2;2;11
6821;Pasaka;Nykštukų;3066438231;Ne;0;0;4;4
6822;Pasaka;Nykštukų;3066438231;Ne;0;0;4;4
6823;Pasaka;Nykštukų;3066438231;Ne;0;0;4;4
6824;Pasaka;Nykštukų;3424189866;Ne;5;0;7;12
6825;Pasaka;Nykštukų;6821289069;Ne;2;2;2;6
6826;Pasaka;Nykštukų;3557547656;Ne;9;2;2;13
6827;Pasaka;Nykštukų;2422079450;Ne;0;2;0;2
6828;Pasaka;Nykštukų;4614626554;Ne;4;0;2;6
6829;Pasaka;Nykštukų;2121277188;Ne;3;0;2;5
6830;Pasaka;Nykštukų;8391715624;Ne;0;0;5;5
6831;Pasaka;Montesori;5240642967;Ne;2;0;3;5
6832;Pasaka;Montesori;5031538468;Ne;3;5;3;11
6833;Pasaka;Montesori;6625690696;Ne;0;1;0;1
6834;Pasaka;Montesori;4548601585;Taip;6;0;2;8
6835;Pasaka;Montesori;7887326763;Ne;1;2;2;5
6836;Pasaka;Montesori;9850592463;Ne;8;2;2;12
6837;Pasaka;Montesori;2995831258;Ne;7;0;2;9
6838;Pasaka;Montesori;6248810027;Ne;6;2;4;12
6839;Pasaka;Montesori;3620395122;Ne;0;4;0;4
6840;Pasaka;Montesori;5689164477;Ne;0;4;0;4
6841;Pasaka;Montesori;7751618911;Ne;6;2;4;12
6842;Pasaka;Montesori;5230621839;Ne;6;2;3;11
6843;Pasaka;Montesori;9471447977;Ne;0;2;1;3
6844;Pasaka;Montesori;4222952044;Ne;9;2;2;13
6845;Pasaka;Montesori;5194285627;Ne;0;2;0;2
6846;Pasaka;Montesori;5969883817;Ne;3;1;2;6
6847;Pasaka;Montesori;9488089168;Ne;7;2;2;11
6848;Pasaka;Montesori;2558448927;Ne;8;0;2;10
6849;Pasaka;Montesori;9567521319;Ne;5;0;2;7
6850;Pasaka;Žirniukų;9867183480;Ne;0;2;0;2
6851;Pasaka;Žirniukų;3783869856;Ne;0;2;0;2
6852;Pasaka;Žirniukų;2815348652;Ne;3;2;2;7
6853;Pasaka;Žirniukų;5651025350;Ne;0;2;0;2
6854;Pasaka;Žirniukų;2422958320;Ne;8;2;2;12
6855;Pasaka;Žirniukų;9438006825;Ne;0;2;3;5
6856;Pasaka;Žirniukų;9136524816;Ne;0;2;0;2
6857;Pasaka;Žirniukų;9766432049;Ne;1;2;3;6
6858;Pasaka;Žirniukų;6668421711;Ne;0;0;2;2
6859;Pasaka;Žirniukų;6387972576;Ne;6;1;5;12
6860;Pasaka;Žirniukų;4948174745;Ne;8;0;4;12
6861;Pasaka;Žirniukų;4629119214;Ne;7;0;4;11
6862;Pasaka;Žirniukų;8519108324;Ne;8;4;2;14
6863;Pasaka;Žirniukų;9950979894;Ne;3;0;3;6
6864;Pasaka;Žirniukų;5921553817;Ne;3;0;2;5
6865;Pasaka;Žirniukų;2569560383;Ne;2;10;4;16
6866;Pasaka;Žirniukų;9780490338;Ne;8;5;2;15
6867;Pasaka;"Voveriukų ";3606141216;Ne;0;13;0;13
6868;Pasaka;"Voveriukų ";5217688848;Ne;0;13;0;13
6869;Pasaka;"Voveriukų ";4171004263;Ne;4;2;2;8
6870;Pasaka;"Voveriukų ";8504575043;Ne;8;0;2;10
6871;Pasaka;"Voveriukų ";1488711275;Ne;0;2;0;2
6872;Pasaka;"Voveriukų ";1950145441;Ne;5;0;4;9
6873;Pasaka;"Voveriukų ";9588247759;Ne;0;4;0;4
6874;Pasaka;"Voveriukų ";3536862796;Ne;3;0;2;5
6875;Pasaka;"Voveriukų ";8899289832;Ne;0;0;1;1
6876;Pasaka;"Voveriukų ";4915357646;Ne;2;0;0;2
6877;Pasaka;"Voveriukų ";7176272684;Ne;3;2;2;7
6878;Pasaka;"Voveriukų ";4799036184;Ne;2;0;0;2
6879;Pasaka;"Voveriukų ";6684234474;Ne;0;12;0;12
6880;Pasaka;"Voveriukų ";9003508760;Ne;0;2;0;2
6881;Pasaka;"Voveriukų ";6925961600;Ne;0;5;0;5
6882;Pasaka;"Voveriukų ";1745181416;Ne;0;0;6;6
6883;Pasaka;"Voveriukų ";6315362421;Ne;0;2;2;4
6884;Pasaka;"Voveriukų ";6315362421;Ne;0;2;2;4
6885;Pasaka;"VALDOFRO 12";8976424908;Ne;0;1;1;2
6886;Pasaka;"VALDOFRO 12";1305541319;Ne;0;2;1;3
6887;Pasaka;"VALDOFRO 12";7682903999;Ne;0;2;0;2
6888;Pasaka;"VALDOFRO 12";6448940090;Ne;0;2;2;4
6889;Pasaka;"VALDOFRO 12";8411025450;Ne;0;4;0;4
6890;Pasaka;"VALDOFRO 12";1756831961;Ne;0;1;2;3
6891;Pasaka;"VALDOFRO 12";3840053722;Ne;6;12;4;22
6892;Pasaka;"VALDOFRO 12";8995205555;Ne;0;2;2;4
6893;Pasaka;"VALDOFRO 12";4548945364;Ne;0;0;2;2
6894;Pasaka;"VALDOFRO 12";8912822936;Ne;8;0;2;10
6895;Pasaka;"VALDOFRO 12";5244582148;Ne;0;0;2;2
6896;Pasaka;"VALDOFRO 12";2650797982;Ne;0;1;0;1
6897;Pasaka;"VALDOFRO 12";9065016148;Ne;0;2;1;3
6898;Pasaka;"VALDOFRO 12";9809498406;Ne;0;1;0;1
6899;Pasaka;"VALDOFRO 12";6920718870;Ne;2;2;5;9
6900;Pasaka;"VALDOFRO 12";1791565631;Ne;0;0;2;2
6901;Pasaka;"VALDOFRO 12";5601416284;Ne;0;2;0;2
6902;Pasaka;"VALDOFRO 12";9324220807;Ne;0;2;1;3
6903;Pasaka;"VALDORFO 2";4620573687;Ne;18;2;2;22
6904;Pasaka;"VALDORFO 2";4825373152;Ne;0;2;1;3
6905;Pasaka;"VALDORFO 2";9462745431;Ne;10;2;2;14
6906;Pasaka;"VALDORFO 2";5399148997;Ne;0;2;0;2
6907;Pasaka;"VALDORFO 2";1799326151;Ne;0;4;0;4
6908;Pasaka;"VALDORFO 2";2273629510;Ne;1;4;2;7
6909;Pasaka;"VALDORFO 2";3778182691;Ne;18;2;2;22
6910;Pasaka;"VALDORFO 2";5742479853;Ne;0;4;0;4
6911;Pasaka;"VALDORFO 2";3049361712;Ne;0;2;0;2
6912;Pasaka;"VALDORFO 2";6497042042;Ne;8;0;2;10
6913;Pasaka;"VALDORFO 2";9150761761;Ne;7;0;2;9
6914;Pasaka;"VALDORFO 2";9821858308;Ne;7;0;2;9
6915;Pasaka;"VALDORFO 2";1648043715;Ne;0;17;2;19
6916;Pasaka;"VALDORFO 2";8855436141;Ne;0;2;2;4
6917;Pasaka;"VALDORFO 2";3796844193;Ne;8;0;2;10
6918;Pasaka;"VALDORFO 2";1940341287;Ne;6;2;2;10
6919;Pasaka;Gudručiai;5687494160;Ne;3;2;2;7
6920;Pasaka;Gudručiai;3151916774;Ne;0;4;0;4
6921;Pasaka;Gudručiai;4773893970;Ne;3;4;2;9
6922;Pasaka;Gudručiai;1813068555;Ne;6;2;2;10
6923;Pasaka;Gudručiai;7546205285;Ne;1;3;2;6
6924;Pasaka;Gudručiai;4082752808;Ne;5;0;2;7
6925;Pasaka;Gudručiai;6139825302;Ne;5;2;4;11
6926;Pasaka;Gudručiai;7248640367;Ne;0;3;0;3
6927;Pasaka;Gudručiai;8277245475;Ne;1;1;2;4
6928;Pasaka;Gudručiai;1720511696;Ne;13;0;4;17
6929;Pasaka;Gudručiai;4970812899;Ne;2;0;0;2
6930;Pasaka;Gudručiai;1335408890;Ne;0;4;1;5
6931;Pasaka;Gudručiai;8873115041;Ne;5;0;2;7
6932;Pasaka;Gudručiai;5723970763;Ne;0;3;0;3
6933;Pasaka;Gudručiai;2638182985;Ne;0;3;0;3
6934;Pasaka;Gudručiai;3351338617;Ne;0;4;0;4
6935;Pasaka;Gudručiai;2963373430;Ne;2;2;0;4
6936;Pasaka;Gudručiai;3367346582;Ne;3;3;2;8
6937;Pasaka;Gudručiai;6788771605;Ne;1;4;2;7
6938;Pasaka;Bitelių;4770547514;Ne;0;0;2;2
6939;Pasaka;Bitelių;7696383564;Ne;0;6;0;6
6940;Pasaka;Bitelių;4910817298;Ne;0;3;1;4
6941;Pasaka;Bitelių;9770811826;Ne;3;0;2;5
6942;Pasaka;Bitelių;4846146925;Ne;3;0;2;5
6943;Pasaka;Bitelių;4994426702;Taip;1;0;2;3
6944;Pasaka;Bitelių;8289010515;Taip;1;0;2;3
6945;Pasaka;Bitelių;8558563996;Ne;0;1;1;2
6946;Pasaka;Bitelių;3735117473;Ne;0;0;1;1
6947;Pasaka;Bitelių;6119419213;Ne;0;3;0;3
6948;Pasaka;Bitelių;7101898684;Ne;1;1;6;8
6949;Pasaka;Bitelių;9120786116;Ne;0;2;0;2
6950;Pasaka;Bitelių;7960739321;Ne;0;8;2;10
6951;Pasaka;"Pabiručių ";5111195289;Ne;8;0;3;11
6952;Pasaka;"Pabiručių ";6182223896;Ne;8;0;3;11
6953;Pasaka;"Pabiručių ";8276520594;Ne;2;0;17;19
6954;Pasaka;"Pabiručių ";3192466285;Ne;3;0;2;5
6955;Pasaka;"Pabiručių ";3730173516;Ne;2;0;7;9
6956;Pasaka;"Pabiručių ";3546787595;Ne;0;0;1;1
6957;Pasaka;"Pabiručių ";5297950763;Ne;3;0;11;14
6958;Pasaka;"Pabiručių ";8662703330;Ne;0;2;4;6
6959;Pasaka;"Pabiručių ";6189170713;Ne;0;2;2;4
6960;Pasaka;"Pabiručių ";2963191890;Ne;10;0;0;10
6961;Pasaka;Šnekučių;1793176485;Ne;0;2;0;2
6962;Pasaka;Šnekučių;4296539838;Taip;0;2;2;4
6963;Pasaka;Šnekučių;1590306118;Ne;6;1;2;9
6964;Pasaka;Šnekučių;3240292756;Ne;1;0;2;3
6965;Pasaka;Šnekučių;4215568107;Ne;3;3;2;8
6966;Pasaka;Šnekučių;8365256755;Ne;0;4;0;4
6967;Pasaka;Šnekučių;4816441219;Ne;0;2;4;6
6968;Pasaka;Šnekučių;1795497567;Ne;2;3;2;7
6969;Pasaka;Šnekučių;8347051587;Ne;7;2;2;11
6970;Pasaka;Šnekučių;3588073618;Ne;0;2;4;6
6971;Pasaka;Šnekučių;1194745876;Ne;0;3;0;3
6972;Pasaka;Šnekučių;1749821746;Ne;8;2;2;12
6973;Pasaka;Šnekučių;1723076060;Ne;6;2;2;10
6974;Pasaka;Šnekučių;8475365713;Ne;2;3;4;9
6975;Pasaka;Šnekučių;5656511105;Ne;6;0;3;9
6976;Pasaka;"KIŠKUČIŲ (Žirmūnų g. 92)";7311929329;Ne;0;0;3;3
6977;Pasaka;"KIŠKUČIŲ (Žirmūnų g. 92)";2368681819;Ne;2;5;2;9
6978;Pasaka;"KIŠKUČIŲ (Žirmūnų g. 92)";5134067973;Taip;3;0;2;5
6979;Pasaka;"KIŠKUČIŲ (Žirmūnų g. 92)";5073970913;Ne;0;0;1;1
6980;Pasaka;"KIŠKUČIŲ (Žirmūnų g. 92)";5255764606;Ne;0;2;12;14
6981;Pasaka;"KIŠKUČIŲ (Žirmūnų g. 92)";6950137606;Ne;0;0;3;3
6982;Pasaka;"KIŠKUČIŲ (Žirmūnų g. 92)";2575986215;Ne;1;2;3;6
6983;Pasaka;"KIŠKUČIŲ (Žirmūnų g. 92)";4924664211;Ne;1;0;3;4
6984;Pasaka;"KIŠKUČIŲ (Žirmūnų g. 92)";5632714212;Ne;10;0;10;20
6985;Pasaka;"KIŠKUČIŲ (Žirmūnų g. 92)";9928518840;Ne;6;0;2;8
6986;Pasaka;"KIŠKUČIŲ (Žirmūnų g. 92)";7699290051;Ne;6;0;4;10
6987;Pasaka;"KIŠKUČIŲ (Žirmūnų g. 92)";1780063295;Ne;6;0;4;10
6988;Pasaka;"EŽIUKŲ (Žirmūnų g. 92)";4389337333;Ne;4;2;3;9
6989;Pasaka;"EŽIUKŲ (Žirmūnų g. 92)";1527027437;Ne;0;1;2;3
6990;Pasaka;"EŽIUKŲ (Žirmūnų g. 92)";9266921444;Ne;0;0;1;1
6991;Pasaka;"EŽIUKŲ (Žirmūnų g. 92)";9922357232;Ne;0;0;1;1
6992;Pasaka;"EŽIUKŲ (Žirmūnų g. 92)";7811540398;Ne;0;2;2;4
6993;Pasaka;"EŽIUKŲ (Žirmūnų g. 92)";7964569326;Ne;0;2;2;4
6994;Pasaka;"EŽIUKŲ (Žirmūnų g. 92)";4061808534;Ne;18;2;2;22
6995;Pasaka;"EŽIUKŲ (Žirmūnų g. 92)";3567879839;Ne;2;2;2;6
6996;Pasaka;"EŽIUKŲ (Žirmūnų g. 92)";4458246330;Ne;8;4;5;17
6997;Pasaka;"EŽIUKŲ (Žirmūnų g. 92)";5450477466;Ne;0;0;1;1
6998;Pasaka;"EŽIUKŲ (Žirmūnų g. 92)";9409030208;Ne;0;2;0;2
6999;Pasaka;"EŽIUKŲ (Žirmūnų g. 92)";9717417413;Ne;3;0;2;5
7000;Pasaka;"EŽIUKŲ (Žirmūnų g. 92)";6780585061;Ne;7;2;5;14
7001;Pasaka;"EŽIUKŲ (Žirmūnų g. 92)";2313200719;Ne;9;2;2;13
7002;Pasaka;"SAULUČIŲ (Žirmūnų g. 92)";1963481567;Ne;6;0;4;10
7003;Pasaka;"SAULUČIŲ (Žirmūnų g. 92)";8164697203;Ne;5;2;3;10
7004;Pasaka;"SAULUČIŲ (Žirmūnų g. 92)";6991062262;Ne;0;0;1;1
7005;Pasaka;"SAULUČIŲ (Žirmūnų g. 92)";1214817944;Ne;5;0;3;8
7006;Pasaka;"SAULUČIŲ (Žirmūnų g. 92)";6087447128;Ne;8;0;3;11
7007;Pasaka;"SAULUČIŲ (Žirmūnų g. 92)";6157459742;Ne;10;0;6;16
7008;Pasaka;"SAULUČIŲ (Žirmūnų g. 92)";9369336996;Ne;0;2;0;2
7009;Pasaka;"SAULUČIŲ (Žirmūnų g. 92)";8866484797;Ne;2;0;0;2
7010;Pasaka;"SAULUČIŲ (Žirmūnų g. 92)";3587648653;Ne;12;0;2;14
7011;Pasaka;"SAULUČIŲ (Žirmūnų g. 92)";6388657745;Ne;12;0;2;14
7012;Pasaka;"SAULUČIŲ (Žirmūnų g. 92)";6280303158;Ne;0;3;0;3
7013;Pasaka;"SAULUČIŲ (Žirmūnų g. 92)";9403892434;Ne;5;0;8;13
7014;Pasaka;"SAULUČIŲ (Žirmūnų g. 92)";8837340945;Ne;0;0;7;7
7015;Pasaka;"SAULUČIŲ (Žirmūnų g. 92)";3865755048;Ne;0;18;0;18
7016;Pasaka;"SAULUČIŲ (Žirmūnų g. 92)";1083785206;Ne;0;0;6;6
7017;Paslaptis;MONTIKI;4683384309;Ne;0;7;0;7
7018;Paslaptis;MONTIKI;4350594725;Ne;6;0;2;8
7019;Paslaptis;MONTIKI;4962917136;Ne;0;0;1;1
7020;Paslaptis;MONTIKI;5908641161;Ne;10;1;2;13
7021;Paslaptis;MONTIKI;8444751869;Ne;0;22;0;22
7022;Paslaptis;MONTIKI;1869254264;Ne;2;0;5;7
7023;Paslaptis;MONTIKI;3463582845;Ne;8;0;4;12
7024;Paslaptis;MONTIKI;4038980805;Ne;0;1;0;1
7025;Paslaptis;FRUTIKI;4130010071;Ne;0;2;0;2
7026;Paslaptis;FRUTIKI;2105441745;Ne;13;2;2;17
7027;Paslaptis;FRUTIKI;6686352764;Ne;9;0;7;16
7028;Paslaptis;FRUTIKI;6513238386;Ne;0;0;1;1
7029;Paslaptis;FRUTIKI;8457752288;Ne;2;0;4;6
7030;Paslaptis;FRUTIKI;4159590988;Ne;1;0;2;3
7031;Paslaptis;FRUTIKI;9929877115;Ne;0;0;6;6
7032;Paslaptis;FRUTIKI;6860366087;Taip;2;1;0;3
7033;Paslaptis;FRUTIKI;3572102816;Ne;3;0;4;7
7034;Paslaptis;FRUTIKI;2927014406;Ne;2;1;3;6
7035;Paslaptis;FRUTIKI;7053452493;Ne;0;1;0;1
7036;Paslaptis;FRUTIKI;8909545951;Ne;0;1;0;1
7037;Paslaptis;FRUTIKI;3963816472;Ne;3;0;4;7
7038;Paslaptis;FRUTIKI;5809630456;Ne;0;3;3;6
7039;Paslaptis;FRUTIKI;6764142182;Ne;0;3;1;4
7040;Paslaptis;FRUTIKI;9299390190;Ne;0;2;0;2
7041;Paslaptis;FRUTIKI;9497654214;Ne;0;0;15;15
7042;Paslaptis;FRUTIKI;1080710834;Ne;3;0;3;6
7043;Paslaptis;FRUTIKI;5480407965;Ne;8;2;2;12
7044;Paslaptis;KALAMBURIKI;1029321312;Ne;4;5;2;11
7045;Paslaptis;KALAMBURIKI;5852939221;Ne;0;2;1;3
7046;Paslaptis;KALAMBURIKI;3104525540;Ne;0;1;3;4
7047;Paslaptis;KALAMBURIKI;3398729758;Ne;0;0;3;3
7048;Paslaptis;KALAMBURIKI;7672102974;Ne;1;0;6;7
7049;Paslaptis;KALAMBURIKI;9100003209;Ne;3;2;2;7
7050;Paslaptis;KALAMBURIKI;3984799090;Ne;2;1;3;6
7051;Paslaptis;KALAMBURIKI;5886364670;Ne;4;0;2;6
7052;Paslaptis;KALAMBURIKI;2675089401;Ne;1;0;2;3
7053;Paslaptis;KALAMBURIKI;1557783684;Ne;1;4;5;10
7054;Paslaptis;KALAMBURIKI;5206529350;Ne;0;3;2;5
7055;Paslaptis;KALAMBURIKI;5456011928;Ne;0;4;0;4
7056;Paslaptis;KALAMBURIKI;8717111488;Taip;0;0;3;3
7057;Paslaptis;KALAMBURIKI;5646806136;Ne;3;2;2;7
7058;Paslaptis;KALAMBURIKI;4810686225;Ne;1;0;4;5
7059;Paslaptis;KALAMBURIKI;8296575784;Ne;2;1;5;8
7060;Paslaptis;KALAMBURIKI;7638521198;Ne;0;3;0;3
7061;Pasakaitė;Vieversėlių;5162170061;Ne;9;0;4;13
7062;Pasakaitė;Vieversėlių;6795204239;Ne;0;0;4;4
7063;Pasakaitė;Vieversėlių;8559244062;Ne;0;0;1;1
7064;Pasakaitė;Vieversėlių;4316883215;Ne;0;1;0;1
7065;Pasakaitė;Vieversėlių;6682010485;Ne;4;2;4;10
7066;Pasakaitė;Vieversėlių;8478538959;Ne;0;27;0;27
7067;Pasakaitė;Vieversėlių;5279719152;Ne;7;2;4;13
7068;Pasakaitė;Vieversėlių;4098119950;Ne;4;0;4;8
7069;Pasakaitė;Vieversėlių;6160327808;Ne;0;0;3;3
7070;Pasakaitė;Vieversėlių;1705913604;Ne;4;0;3;7
7071;Pasakaitė;Vieversėlių;4898974534;Ne;3;0;2;5
7072;Pasakaitė;Vieversėlių;2041179927;Ne;4;2;4;10
7073;Pasakaitė;Vieversėlių;7965916747;Ne;8;0;3;11
7074;Pasakaitė;Vieversėlių;1279728451;Ne;0;0;6;6
7075;Pasakaitė;Vieversėlių;2584717150;Ne;3;0;7;10
7076;Pasakaitė;Vieversėlių;4397797616;Ne;15;0;2;17
7077;Pasakaitė;Vieversėlių;4659277297;Ne;1;0;8;9
7078;Pasakaitė;Vieversėlių;2899659479;Ne;9;0;4;13
7079;Pasakaitė;Vieversėlių;8160163060;Ne;8;0;4;12
7080;Pasakaitė;Vieversėlių;8350808883;Ne;2;0;8;10
7081;Pasakaitė;Vieversėlių;1122248122;Ne;0;27;0;27
7082;Pasakaitė;Vieversėlių;9114337491;Ne;1;2;3;6
7083;Pasakaitė;Vieversėlių;2801785334;Ne;2;0;2;4
7084;Pasakaitė;Spindulėlių;1697755753;Ne;0;4;0;4
7085;Pasakaitė;Spindulėlių;8105641645;Ne;0;2;2;4
7086;Pasakaitė;Spindulėlių;5791927811;Taip;0;27;0;27
7087;Pasakaitė;Spindulėlių;5094404397;Taip;0;27;0;27
7088;Pasakaitė;Spindulėlių;9870015737;Ne;6;2;2;10
7089;Pasakaitė;Spindulėlių;7474100735;Ne;0;2;0;2
7090;Pasakaitė;Spindulėlių;2733800758;Ne;2;0;4;6
7091;Pasakaitė;Spindulėlių;6256000265;Ne;16;2;4;22
7092;Pasakaitė;Spindulėlių;2891089579;Ne;16;2;4;22
7093;Pasakaitė;Spindulėlių;3652896053;Ne;5;1;2;8
7094;Pasakaitė;Spindulėlių;7265623955;Ne;9;0;4;13
7095;Pasakaitė;Spindulėlių;1564611671;Ne;7;2;1;10
7096;Pasakaitė;Spindulėlių;3283593388;Ne;6;0;4;10
7097;Pasakaitė;Spindulėlių;4268438476;Ne;6;2;2;10
7098;Pasakaitė;Spindulėlių;2340908210;Ne;0;14;0;14
7099;Pasakaitė;Spindulėlių;6229020982;Ne;0;7;2;9
7100;Pasakaitė;Spindulėlių;2278658674;Ne;12;2;2;16
7101;Pasakaitė;Spindulėlių;9982451343;Ne;0;13;0;13
7102;Pasakaitė;Spindulėlių;5745073940;Ne;19;0;1;20
7103;Pasakaitė;Spindulėlių;5180059311;Ne;2;5;2;9
7104;Pasakaitė;Spindulėlių;6745120294;Ne;0;12;0;12
7105;Pasakaitė;Pasagėlių;2810892060;Ne;0;0;3;3
7106;Pasakaitė;Pasagėlių;9895144528;Ne;0;10;0;10
7107;Pasakaitė;Pasagėlių;6609127382;Ne;3;0;2;5
7108;Pasakaitė;Pasagėlių;9409907631;Ne;0;2;0;2
7109;Pasakaitė;Pasagėlių;5589440439;Ne;0;9;0;9
7110;Pasakaitė;Pasagėlių;5959875562;Ne;0;0;2;2
7111;Pasakaitė;Pasagėlių;3355268509;Ne;0;5;0;5
7112;Pasakaitė;Pasagėlių;1959599606;Ne;3;0;2;5
7113;Pasakaitė;Pasagėlių;7440327561;Ne;0;4;0;4
7114;Pasakaitė;Pasagėlių;6325408070;Ne;0;2;0;2
7115;Pasakaitė;Pasagėlių;9238905834;Taip;0;13;0;13
7116;Pasakaitė;Pasagėlių;4826492004;Ne;0;4;0;4
7117;Pasakaitė;Pasagėlių;7666033916;Ne;0;8;0;8
7118;Pasakaitė;Pasagėlių;5540251866;Ne;0;2;0;2
7119;Pasakaitė;Pasagėlių;7219080600;Ne;0;10;0;10
7120;Pasakaitė;Pasagėlių;8264189678;Ne;0;0;1;1
7121;Pasakaitė;Pasagėlių;2341175137;Ne;3;2;2;7
7122;Pasakaitė;Pasagėlių;8905681529;Ne;0;2;1;3
7123;Pasakaitė;Pasagėlių;8165055476;Ne;0;10;0;10
7124;Pasakaitė;Pasagėlių;7360801624;Ne;2;0;2;4
7125;Pasakaitė;Pasagėlių;5617173998;Ne;0;1;0;1
7126;Pasakaitė;Pasagėlių;5034077389;Ne;6;2;2;10
7127;Pasakaitė;Pasagėlių;9645230615;Ne;3;0;2;5
7128;Pasakaitė;Švyturėlių;7702359586;Ne;3;2;2;7
7129;Pasakaitė;Švyturėlių;6847782430;Ne;0;13;0;13
7130;Pasakaitė;Švyturėlių;4728731352;Ne;0;0;8;8
7131;Pasakaitė;Švyturėlių;2404448954;Ne;0;0;1;1
7132;Pasakaitė;Švyturėlių;9821617981;Ne;2;0;4;6
7133;Pasakaitė;Švyturėlių;2329827275;Ne;5;0;2;7
7134;Pasakaitė;Švyturėlių;2933474317;Ne;4;2;2;8
7135;Pasakaitė;Švyturėlių;5498393070;Ne;2;0;8;10
7136;Pasakaitė;Švyturėlių;9012098645;Ne;2;0;8;10
7137;Pasakaitė;Švyturėlių;3417077517;Ne;5;0;2;7
7138;Pasakaitė;Švyturėlių;1793453325;Ne;0;5;0;5
7139;Pasakaitė;Švyturėlių;1384552110;Taip;2;5;2;9
7140;Pasakaitė;Švyturėlių;4694818333;Ne;0;7;2;9
7141;Pasakaitė;Švyturėlių;5115067331;Ne;0;5;1;6
7142;Pasakaitė;Švyturėlių;6522727154;Ne;5;2;4;11
7143;Pasakaitė;Švyturėlių;8711237946;Ne;0;0;1;1
7144;Pasakaitė;Švyturėlių;4977052991;Ne;0;11;0;11
7145;Pasakaitė;Švyturėlių;7604996145;Ne;9;0;2;11
7146;Pasakaitė;Švyturėlių;4144569088;Ne;7;0;0;7
7147;Pasakaitė;Švyturėlių;7539851375;Ne;7;0;4;11
7148;Pasakaitė;Švyturėlių;8381083251;Ne;10;0;6;16
7149;Pasakaitė;Švyturėlių;9606533767;Ne;4;2;2;8
7150;Pasakaitė;Švyturėlių;2902368705;Ne;4;4;2;10
7151;Pasakaitė;Švyturėlių;3659371923;Ne;1;2;2;5
7152;Pasakaitė;Kodėlčiukų;8662488739;Ne;3;6;2;11
7153;Pasakaitė;Kodėlčiukų;9972985920;Taip;9;0;4;13
7154;Pasakaitė;Kodėlčiukų;5699688792;Ne;14;2;2;18
7155;Pasakaitė;Kodėlčiukų;9441990175;Taip;2;0;6;8
7156;Pasakaitė;Kodėlčiukų;1588525307;Ne;0;0;1;1
7157;Pasakaitė;Kodėlčiukų;4485053261;Ne;4;0;5;9
7158;Pasakaitė;Kodėlčiukų;9351971114;Ne;2;2;4;8
7159;Pasakaitė;Kodėlčiukų;2303884875;Ne;5;0;3;8
7160;Pasakaitė;Kodėlčiukų;9543262464;Ne;6;0;3;9
7161;Pasakaitė;Kodėlčiukų;4878562841;Ne;11;0;2;13
7162;Pasakaitė;Kodėlčiukų;2994653871;Ne;4;0;5;9
7163;Pasakaitė;Kodėlčiukų;4328440534;Ne;6;0;4;10
7164;Pasakaitė;Kodėlčiukų;4881361200;Ne;6;0;4;10
7165;Pasakaitė;Kodėlčiukų;2389832646;Ne;3;1;2;6
7166;Pasakaitė;Kodėlčiukų;7138417196;Taip;3;0;4;7
7167;Pasakaitė;Kodėlčiukų;5581264184;Ne;0;11;0;11
7168;Pasakaitė;Kodėlčiukų;8037316673;Ne;0;0;4;4
7169;Pasakaitė;Kodėlčiukų;5732009054;Ne;0;3;0;3
7170;Pasakaitė;Kodėlčiukų;2407824666;Ne;0;0;2;2
7171;Pasakaitė;Kodėlčiukų;6755983130;Ne;3;0;3;6
7172;Pasakaitė;Kodėlčiukų;2476010561;Ne;1;2;2;5
7173;Pasakaitė;Kodėlčiukų;3925034196;Ne;0;4;0;4
7174;Pasakaitė;Kodėlčiukų;9512782063;Ne;1;0;4;5
7175;Pasakaitė;Gudručių;1513903341;Ne;0;4;0;4
7176;Pasakaitė;Gudručių;3231283338;Ne;0;3;2;5
7177;Pasakaitė;Gudručių;6736879757;Ne;0;3;1;4
7178;Pasakaitė;Gudručių;2194313054;Ne;0;6;1;7
7179;Pasakaitė;Gudručių;7963057831;Ne;0;2;0;2
7180;Pasakaitė;Gudručių;9543991684;Ne;0;2;2;4
7181;Pasakaitė;Gudručių;3444442287;Ne;2;3;2;7
7182;Pasakaitė;Gudručių;3680596008;Ne;0;2;0;2
7183;Pasakaitė;Gudručių;4191875802;Ne;0;2;1;3
7184;Pasakaitė;Gudručių;4882856664;Ne;0;2;1;3
7185;Pasakaitė;Gudručių;5485965486;Ne;0;4;2;6
7186;Pasakaitė;Gudručių;7685647972;Ne;0;2;3;5
7187;Pasakaitė;Gudručių;5953162958;Ne;0;2;1;3
7188;Pasakaitė;Gudručių;2849753418;Ne;0;1;4;5
7189;Pasakaitė;Gudručių;9018830962;Ne;11;2;4;17
7190;Pasakaitė;Gudručių;6459145539;Ne;1;1;4;6
7191;Pasakaitė;Gudručių;5948958906;Ne;0;3;0;3
7192;Pasakaitė;Gudručių;1060914693;Ne;0;3;1;4
7193;Pasakaitė;Gudručių;5020801150;Ne;0;0;1;1
7194;Pasakaitė;Gudručių;3710143250;Ne;0;1;0;1
7195;Pasakaitė;Gudručių;4864779439;Taip;0;2;2;4
7196;Pasakaitė;Gudručių;1533259056;Ne;0;8;0;8
7197;Pasakaitė;Gudručių;8223662339;Ne;1;2;2;5
7198;Pasakaitė;Čiulbonėlių;7526264241;Ne;18;2;2;22
7199;Pasakaitė;Čiulbonėlių;3541877287;Ne;0;2;2;4
7200;Pasakaitė;Čiulbonėlių;4974486850;Ne;6;2;2;10
7201;Pasakaitė;Čiulbonėlių;7607522887;Ne;0;2;4;6
7202;Pasakaitė;Čiulbonėlių;3606601644;Ne;0;6;0;6
7203;Pasakaitė;Čiulbonėlių;3579498202;Ne;0;5;0;5
7204;Pasakaitė;Čiulbonėlių;1220619991;Ne;0;0;3;3
7205;Pasakaitė;Čiulbonėlių;7790937149;Ne;0;2;0;2
7206;Pasakaitė;Čiulbonėlių;3400305768;Ne;0;2;0;2
7207;Pasakaitė;Čiulbonėlių;1619513932;Ne;0;2;0;2
7208;Pasakaitė;Čiulbonėlių;4604843442;Ne;0;20;0;20
7209;Pasakaitė;Čiulbonėlių;2751828639;Ne;0;2;0;2
7210;Pasakaitė;Čiulbonėlių;1962693480;Ne;0;2;1;3
7211;Pasakaitė;Čiulbonėlių;4758073190;Ne;0;2;0;2
7212;Pasakaitė;Čiulbonėlių;5628746801;Ne;0;1;0;1
7213;Pasakaitė;Čiulbonėlių;6015360076;Ne;0;2;0;2
7214;Pasakaitė;Čiulbonėlių;1056358241;Ne;5;5;2;12
7215;Pasakaitė;Čiulbonėlių;2652882309;Ne;0;8;0;8
7216;Pasakaitė;Čiulbonėlių;1449037968;Ne;0;6;0;6
7217;Pasakaitė;Čiulbonėlių;8463220257;Ne;0;0;1;1
7218;Pasakaitė;Čiulbonėlių;2563725297;Ne;3;2;2;7
7219;Pasakaitė;Čiulbonėlių;6714500298;Ne;0;5;0;5
7220;Pasakaitė;Čiulbonėlių;1184513606;Ne;0;2;3;5
7221;Pasakaitė;"Verpstelių ";7621306769;Ne;0;1;0;1
7222;Pasakaitė;"Verpstelių ";4946855684;Ne;0;2;0;2
7223;Pasakaitė;"Verpstelių ";5556362727;Ne;0;0;3;3
7224;Pasakaitė;"Verpstelių ";7451624229;Ne;0;0;2;2
7225;Pasakaitė;"Verpstelių ";7759051761;Ne;8;2;2;12
7226;Pasakaitė;"Verpstelių ";1744216870;Ne;0;0;4;4
7227;Pasakaitė;"Verpstelių ";1425166722;Ne;0;0;3;3
7228;Pasakaitė;"Verpstelių ";7813221735;Ne;5;3;4;12
7229;Pasakaitė;"Verpstelių ";4246461594;Ne;5;0;12;17
7230;Pasakaitė;"Verpstelių ";1963102227;Ne;4;3;3;10
7231;Pasakaitė;"Verpstelių ";8267725352;Ne;3;0;7;10
7232;Pasakaitė;"Verpstelių ";8562284745;Ne;0;7;0;7
7233;Pasakaitė;"Verpstelių ";1041405418;Ne;3;7;2;12
7234;Pasakaitė;"Verpstelių ";7976921380;Ne;0;5;0;5
7235;Pasakaitė;"Verpstelių ";2505815026;Ne;4;0;6;10
7236;Pasakaitė;"Verpstelių ";1115383380;Ne;17;0;0;17
7237;Pasakaitė;"Verpstelių ";2714905466;Ne;0;0;2;2
7238;Pasakaitė;"Verpstelių ";9226989209;Ne;0;7;0;7
7239;Pasakaitė;Smalsučiai;7557414266;Ne;0;0;1;1
7240;Pasakaitė;Smalsučiai;7994712153;Ne;3;0;5;8
7241;Pasakaitė;Smalsučiai;1271645870;Ne;9;0;4;13
7242;Pasakaitė;Smalsučiai;6266150515;Taip;0;22;0;22
7243;Pasakaitė;Smalsučiai;7193659817;Ne;0;5;2;7
7244;Pasakaitė;Smalsučiai;3359676586;Ne;3;0;3;6
7245;Pasakaitė;Smalsučiai;6446178994;Ne;1;0;5;6
7246;Pasakaitė;Smalsučiai;3191302999;Ne;0;0;1;1
7247;Pasakaitė;Smalsučiai;2301346026;Ne;0;0;1;1
7248;Pasakaitė;Smalsučiai;7515747335;Ne;5;8;2;15
7249;Pasakaitė;Smalsučiai;8398100438;Ne;13;0;4;17
7250;Pasakaitė;Smalsučiai;4413770207;Ne;3;1;3;7
7251;Pasakaitė;Smalsučiai;8181710494;Ne;4;0;3;7
7252;Pasakaitė;"Čiauškučiai ";7585900157;Ne;0;0;3;3
7253;Pasakaitė;"Čiauškučiai ";2182900696;Ne;0;22;0;22
7254;Pasakaitė;"Čiauškučiai ";7378144738;Ne;3;17;2;22
7255;Pasakaitė;"Čiauškučiai ";9335770325;Ne;5;0;2;7
7256;Pasakaitė;"Čiauškučiai ";2780813752;Ne;0;22;0;22
7257;Pasakaitė;"Čiauškučiai ";5202153993;Taip;0;22;0;22
7258;Pasakaitė;"Čiauškučiai ";3329580710;Ne;1;0;2;3
7259;Pasakaitė;"Čiauškučiai ";4189572117;Ne;0;20;0;20
7260;Pasakaitė;"Čiauškučiai ";6756484192;Ne;3;0;2;5
7261;Pasakaitė;"Čiauškučiai ";6033454938;Ne;5;0;4;9
7262;Pasakaitė;"Čiauškučiai ";7118164408;Ne;10;2;4;16
7263;Pasakaitė;"Čiauškučiai ";9823031346;Ne;10;2;4;16
7264;Pasakaitė;"Čiauškučiai ";1400956305;Ne;6;0;3;9
7265;Pasakaitė;"Čiauškučiai ";9757659268;Ne;0;0;5;5
7266;Pasakaitė;Pabiručiai;1453976284;Ne;0;6;0;6
7267;Pasakaitė;Pabiručiai;9790988677;Ne;0;3;0;3
7268;Pasakaitė;Pabiručiai;5439936572;Ne;0;4;0;4
7269;Pasakaitė;Pabiručiai;3466308130;Ne;6;0;3;9
7270;Pasakaitė;Pabiručiai;9402238675;Ne;0;2;0;2
7271;Pasakaitė;Pabiručiai;4852610052;Ne;0;10;2;12
7272;Pasakaitė;Pabiručiai;9285254916;Ne;0;0;1;1
7273;Pasakaitė;Pabiručiai;6025275102;Ne;9;0;4;13
7274;Pasakaitė;Pabiručiai;7902661691;Ne;2;0;0;2
7275;Pasakaitė;Pabiručiai;2398839782;Ne;0;0;3;3
7276;Pasakaitė;Pabiručiai;3552340609;Ne;0;9;0;9
7277;Pasakaitė;Pabiručiai;2332609415;Ne;2;0;2;4
7278;Pasakaitė;Pabiručiai;4081701824;Ne;3;6;2;11
7279;Pasakaitė;Pabiručiai;3070478547;Ne;0;16;0;16
7280;Pasakaitė;Linksmučiai;8252123824;Ne;0;0;2;2
7281;Pasakaitė;Linksmučiai;4444725869;Taip;0;0;2;2
7282;Pasakaitė;Linksmučiai;3049219840;Ne;14;0;4;18
7283;Pasakaitė;Linksmučiai;9190078546;Ne;1;0;3;4
7284;Pasakaitė;Linksmučiai;5274145775;Ne;5;0;2;7
7285;Pasakaitė;Linksmučiai;9690867215;Ne;8;2;2;12
7286;Pasakaitė;Linksmučiai;1117035233;Ne;3;0;2;5
7287;Pasakaitė;Linksmučiai;5058070480;Ne;2;6;2;10
7288;Pasakaitė;Linksmučiai;9311649698;Ne;0;3;0;3
7289;Pasakaitė;Linksmučiai;5499373802;Ne;0;1;0;1
7290;Pasakaitė;Linksmučiai;4307883488;Ne;5;0;2;7
7291;Pasakaitė;Linksmučiai;4120765793;Ne;0;13;0;13
7292;Pasakaitė;Linksmučiai;3691817711;Ne;0;8;0;8
7293;Pelenė;Varpelis;2647876561;Ne;3;3;2;8
7294;Pelenė;Varpelis;8807342148;Ne;0;4;1;5
7295;Pelenė;Varpelis;2487632125;Ne;0;4;2;6
7296;Pelenė;Varpelis;5228983908;Ne;8;0;2;10
7297;Pelenė;Varpelis;3174009848;Ne;0;4;3;7
7298;Pelenė;Varpelis;6524101295;Ne;0;4;1;5
7299;Pelenė;Varpelis;4373886054;Ne;13;0;2;15
7300;Pelenė;Varpelis;8038559319;Ne;0;2;0;2
7301;Pelenė;Varpelis;7578318198;Ne;4;1;4;9
7302;Pelenė;Varpelis;4777496709;Ne;5;0;4;9
7303;Pelenė;Varpelis;9447223913;Ne;3;0;3;6
7304;Pelenė;Varpelis;6894978459;Ne;0;7;0;7
7305;Pelenė;Varpelis;9884224592;Ne;1;1;6;8
7306;Pelenė;Saulutės;4961852594;Ne;1;0;4;5
7307;Pelenė;Saulutės;8718308575;Ne;7;0;4;11
7308;Pelenė;Saulutės;6867256280;Ne;5;0;4;9
7309;Pelenė;Saulutės;4396011355;Ne;0;0;2;2
7310;Pelenė;Saulutės;5743530682;Ne;4;0;3;7
7311;Pelenė;Saulutės;6304818782;Ne;0;2;0;2
7312;Pelenė;Saulutės;1975574464;Ne;0;0;1;1
7313;Pelenė;Saulutės;3549088727;Ne;0;0;4;4
7314;Pelenė;Saulutės;5024793693;Ne;0;1;1;2
7315;Pelenė;Saulutės;2952739501;Ne;1;1;6;8
7316;Pelenė;Saulutės;6231387335;Taip;8;0;9;17
7317;Pelenė;Saulutės;4068236246;Ne;6;0;5;11
7318;Pelenė;Saulutės;3700618977;Ne;1;0;4;5
7319;Pelenė;Saulutės;5872711862;Ne;0;0;1;1
7320;Pelenė;Saulutės;6081335781;Ne;5;0;7;12
7321;Pelenė;Saulutės;2083848693;Ne;5;0;4;9
7322;Pelenė;Raktelis;4023923887;Ne;6;0;5;11
7323;Pelenė;Raktelis;4859437855;Ne;0;9;0;9
7324;Pelenė;Raktelis;5028095861;Ne;0;0;2;2
7325;Pelenė;Raktelis;8202196292;Ne;0;2;1;3
7326;Pelenė;Raktelis;5926700157;Ne;7;2;2;11
7327;Pelenė;Raktelis;5762403752;Ne;0;9;0;9
7328;Pelenė;Raktelis;7926586349;Ne;13;0;4;17
7329;Pelenė;Raktelis;2986690431;Ne;6;0;3;9
7330;Pelenė;Raktelis;4660385383;Ne;3;0;7;10
7331;Pelenė;Raktelis;4305733824;Ne;1;10;3;14
7332;Pelenė;Raktelis;5066227318;Ne;0;0;1;1
7333;Pelenė;Raktelis;8862429244;Ne;8;0;10;18
7334;Pelenė;Raktelis;9505945890;Ne;9;4;4;17
7335;Pelenė;Raktelis;8961082265;Ne;0;9;0;9
7336;Pelenė;Raktelis;2882716674;Ne;14;2;4;20
7337;Pelenė;Raktelis;4051874126;Ne;5;4;1;10
7338;Pelenė;Raktelis;5970146724;Ne;0;12;0;12
7339;Pelenė;Raktelis;1424479862;Ne;10;0;6;16
7340;Pelenė;Raktelis;1197137607;Ne;4;0;7;11
7341;Pelenė;Raktelis;9769835612;Ne;4;0;8;12
7342;Pelenė;Žvaigždutės;7064742769;Ne;0;0;3;3
7343;Pelenė;Žvaigždutės;9473901831;Ne;0;4;4;8
7344;Pelenė;Žvaigždutės;2476080951;Ne;0;0;7;7
7345;Pelenė;Žvaigždutės;5548367924;Ne;0;2;6;8
7346;Pelenė;Žvaigždutės;5031778158;Ne;0;12;0;12
7347;Pelenė;Žvaigždutės;4056676361;Ne;0;0;5;5
7348;Pelenė;Žvaigždutės;4602503400;Ne;0;7;0;7
7349;Pelenė;Žvaigždutės;2555464779;Ne;0;1;0;1
7350;Pelenė;Žvaigždutės;9530531472;Ne;0;15;0;15
7351;Pelenė;Žvaigždutės;2040256240;Ne;0;0;5;5
7352;Pelenė;Žvaigždutės;4870187198;Ne;0;2;0;2
7353;Pelenė;Žvaigždutės;7640768043;Ne;3;0;4;7
7354;Pelenė;Žvaigždutės;4856039707;Ne;0;4;0;4
7355;Pelenė;Žvaigždutės;4737217659;Taip;7;4;2;13
7356;Pelenė;Žvaigždutės;4109516555;Ne;0;9;0;9
7357;Pelenė;Žvaigždutės;5357701072;Ne;20;0;2;22
7358;Pelenė;Žvaigždutės;7426299485;Ne;0;0;5;5
7359;Pelenė;Žvaigždutės;1136986980;Ne;0;0;2;2
7360;Pelenė;Nykštukas;1060619471;Ne;1;1;3;5
7361;Pelenė;Nykštukas;9195113444;Ne;6;0;3;9
7362;Pelenė;Nykštukas;5749399210;Ne;0;4;6;10
7363;Pelenė;Nykštukas;4448592497;Ne;0;2;0;2
7364;Pelenė;Nykštukas;9075193730;Ne;0;0;2;2
7365;Pelenė;Nykštukas;5333802902;Ne;0;7;0;7
7366;Pelenė;Nykštukas;4591637887;Ne;2;0;7;9
7367;Pelenė;Nykštukas;7088493729;Ne;0;2;0;2
7368;Pelenė;Nykštukas;4090532624;Ne;9;4;2;15
7369;Pelenė;Nykštukas;8123162647;Ne;0;1;1;2
7370;Pelenė;Nykštukas;3573543545;Ne;1;0;2;3
7371;Pelenė;Nykštukas;7659625628;Ne;0;3;1;4
7372;Pelenė;Nykštukas;6375060159;Ne;3;4;2;9
7373;Pelenė;Nykštukas;2210314952;Ne;0;4;0;4
7374;Pelenė;Nykštukas;6419661741;Ne;0;2;4;6
7375;Pelenė;Nykštukas;1049199372;Ne;0;8;0;8
7376;Pelenė;Nykštukas;5063098703;Ne;0;3;2;5
7377;Pelenė;Nykštukas;4089199552;Ne;3;0;3;6
7378;Pelenė;Nykštukas;6038229659;Ne;2;4;3;9
7379;Pelenė;Nykštukas;2241816838;Ne;0;4;2;6
7380;Pelenė;Nykštukas;5389865440;Ne;1;4;2;7
7381;Pelenė;Žirniukai;8529178313;Ne;0;0;4;4
7382;Pelenė;Žirniukai;2270989478;Ne;0;15;0;15
7383;Pelenė;Žirniukai;6661371876;Ne;4;1;4;9
7384;Pelenė;Žirniukai;2590035984;Ne;0;2;0;2
7385;Pelenė;Žirniukai;9601582419;Ne;3;0;4;7
7386;Pelenė;Žirniukai;4703442187;Ne;0;0;2;2
7387;Pelenė;Žirniukai;7959433937;Ne;5;0;6;11
7388;Pelenė;Žirniukai;7057752202;Ne;0;0;1;1
7389;Pelenė;Žirniukai;7399112026;Ne;0;10;0;10
7390;Pelenė;Žirniukai;5686182866;Ne;1;2;2;5
7391;Pelenė;Žirniukai;2443906444;Ne;0;0;4;4
7392;Pelenė;Žirniukai;3863839750;Ne;4;1;4;9
7393;Pelenė;Žirniukai;5922348478;Ne;0;5;0;5
7394;Pelenė;Žirniukai;1313425695;Ne;0;3;1;4
7395;Pelenė;Žirniukai;2068793184;Ne;0;10;0;10
7396;Pelenė;Žirniukai;7383544475;Ne;0;8;0;8
7397;Pelenė;Žirniukai;1595627222;Ne;0;12;0;12
7398;Pelenė;Žirniukai;2438266396;Ne;0;9;0;9
7399;Pelenė;Žirniukai;1486025741;Ne;0;0;3;3
7400;Pelenė;Žirniukai;8685140364;Ne;0;12;0;12
7401;Pelenė;Lašeliai;7017031073;Ne;2;0;4;6
7402;Pelenė;Lašeliai;9018211726;Ne;0;4;1;5
7403;Pelenė;Lašeliai;9313153383;Ne;0;18;1;19
7404;Pelenė;Lašeliai;5836118223;Ne;0;2;6;8
7405;Pelenė;Lašeliai;6316640679;Ne;0;2;1;3
7406;Pelenė;Lašeliai;1711603372;Ne;0;12;3;15
7407;Pelenė;Lašeliai;1944933777;Ne;0;4;0;4
7408;Pelenė;Lašeliai;2303618074;Ne;0;1;2;3
7409;Pelenė;Lašeliai;6167965418;Ne;3;0;4;7
7410;Pelenė;Lašeliai;2765650058;Ne;1;0;2;3
7411;Pelenė;Lašeliai;8841183816;Ne;0;0;2;2
7412;Pelenė;Lašeliai;4431474395;Ne;0;2;5;7
7413;Pelenė;Lašeliai;9097123374;Ne;0;0;4;4
7414;Pelenė;Lašeliai;9162252512;Ne;4;3;2;9
7415;Pelenė;Lašeliai;4695104609;Ne;0;2;2;4
7416;Pelenė;Lašeliai;7148956863;Ne;0;4;0;4
7417;Pelenė;Lašeliai;3663288138;Ne;4;2;2;8
7418;Pelenė;Lašeliai;4148108151;Ne;0;2;0;2
7419;Pelenė;Lašeliai;3563882751;Ne;0;11;0;11
7420;Pelenė;Grūdelis;6790396551;Ne;1;1;5;7
7421;Pelenė;Grūdelis;6221703608;Ne;0;2;0;2
7422;Pelenė;Grūdelis;1278011268;Ne;0;1;0;1
7423;Pelenė;Grūdelis;7880284433;Ne;0;2;0;2
7424;Pelenė;Grūdelis;4989239822;Ne;2;0;2;4
7425;Pelenė;Grūdelis;2426412323;Ne;0;11;0;11
7426;Pelenė;Grūdelis;6481466282;Ne;3;3;2;8
7427;Pelenė;Grūdelis;6707167720;Ne;0;2;3;5
7428;Pelenė;Grūdelis;6267178572;Ne;0;7;0;7
7429;Pelenė;Grūdelis;1468658102;Ne;3;2;6;11
7430;Pelenė;Grūdelis;1573848786;Ne;7;0;4;11
7431;Pelenė;Grūdelis;7985634731;Ne;0;0;1;1
7432;Pelenė;Grūdelis;1555782878;Ne;1;1;3;5
7433;Pelenė;Grūdelis;7858530013;Ne;0;18;0;18
7434;Pelenė;Grūdelis;7702502252;Ne;0;4;0;4
7435;Pelenė;Grūdelis;6678273450;Ne;0;1;0;1
7436;Pelenė;Grūdelis;6648966721;Ne;0;2;3;5
7437;Pelenė;Grūdelis;2544725334;Ne;0;3;0;3
7438;Pelenė;Grūdelis;8722776919;Ne;1;2;3;6
7439;Pelenė;Grūdelis;4717895416;Ne;1;2;3;6
7440;Pelenė;Braškytė;8504675439;Ne;0;12;0;12
7441;Pelenė;Braškytė;6306403720;Ne;0;11;0;11
7442;Pelenė;Braškytė;5243889672;Ne;1;0;5;6
7443;Pelenė;Braškytė;6213281783;Ne;10;0;5;15
7444;Pelenė;Braškytė;9123459933;Ne;3;0;3;6
7445;Pelenė;Braškytė;6325462265;Ne;4;5;4;13
7446;Pelenė;Braškytė;1124834153;Ne;2;5;4;11
7447;Pelenė;Braškytė;2425992275;Ne;20;0;2;22
7448;Pelenė;Braškytė;5215324103;Ne;20;0;2;22
7449;Pelenė;Braškytė;1783529770;Ne;0;0;2;2
7450;Pelenė;Braškytė;6181640181;Ne;6;1;2;9
7451;Pelenė;Braškytė;7143533875;Ne;0;2;0;2
7452;Pelenė;Braškytė;8977625247;Ne;0;0;2;2
7453;Pelenė;Braškytė;6154342149;Ne;0;0;2;2
7454;Pelenė;Braškytė;7171545733;Ne;0;12;0;12
7455;Pelenė;Braškytė;6025404134;Ne;0;6;0;6
7456;Pelenė;Boružėlės;4955162765;Ne;9;0;6;15
7457;Pelenė;Boružėlės;3200796745;Ne;0;0;3;3
7458;Pelenė;Boružėlės;6427008429;Ne;3;8;2;13
7459;Pelenė;Boružėlės;1075220572;Ne;3;0;2;5
7460;Pelenė;Boružėlės;8325318483;Ne;2;0;2;4
7461;Pelenė;Boružėlės;8732297405;Ne;0;0;4;4
7462;Pelenė;Boružėlės;5845118981;Ne;1;4;3;8
7463;Pelenė;Boružėlės;8942422475;Ne;0;4;0;4
7464;Pelenė;Boružėlės;9554893953;Ne;0;17;0;17
7465;Pelenė;Boružėlės;7320738947;Ne;0;0;5;5
7466;Pelenė;Boružėlės;3004297722;Ne;0;9;10;19
7467;Pelenė;Boružėlės;7794147237;Ne;9;2;3;14
7468;Pelenė;Boružėlės;9772543894;Ne;2;0;2;4
7469;Pelenė;Boružėlės;6226160316;Ne;0;3;0;3
7470;Pelenė;Saldainiukai;2689903631;Ne;0;4;0;4
7471;Pelenė;Saldainiukai;4982869687;Ne;0;0;2;2
7472;Pelenė;Saldainiukai;3499827987;Ne;4;0;5;9
7473;Pelenė;Saldainiukai;8165766331;Ne;0;1;0;1
7474;Pelenė;Saldainiukai;2096373376;Ne;0;3;4;7
7475;Pelenė;Saldainiukai;1384382692;Ne;3;0;4;7
7476;Pelenė;Saldainiukai;9490816122;Ne;1;0;2;3
7477;Pelenė;Saldainiukai;4734502322;Ne;4;0;9;13
7478;Pelenė;Saldainiukai;7602432318;Ne;4;0;4;8
7479;Pelenė;Saldainiukai;2407328091;Ne;0;10;1;11
7480;Pelenė;Saldainiukai;8861981715;Ne;0;0;1;1
7481;Pelenė;Saldainiukai;7599381657;Ne;10;0;2;12
7482;Pelenė;Saldainiukai;2123466599;Ne;0;0;2;2
7483;Pelenė;Saldainiukai;9290443563;Ne;3;0;2;5
7484;Pelenė;Saldainiukai;2661260892;Ne;0;21;0;21
7485;Pelenė;Saldainiukai;2824244303;Ne;10;0;7;17
7486;Pelenė;Saldainiukai;1081582842;Ne;0;6;0;6
7487;Pelenė;Drugeliai;2540405047;Ne;2;2;6;10
7488;Pelenė;Drugeliai;5084452088;Ne;0;5;0;5
7489;Pelenė;Drugeliai;9218868317;Ne;0;2;0;2
7490;Pelenė;Drugeliai;2628676128;Ne;0;4;0;4
7491;Pelenė;Drugeliai;6834792589;Ne;0;1;3;4
7492;Pelenė;Drugeliai;1048899958;Ne;0;0;1;1
7493;Pelenė;Drugeliai;3327213856;Ne;3;2;2;7
7494;Pelenė;Drugeliai;6252972353;Ne;3;0;4;7
7495;Pelenė;Drugeliai;1274729537;Ne;0;2;0;2
7496;Pelenė;Drugeliai;1584256570;Ne;4;2;2;8
7497;Pelenė;Drugeliai;3205331614;Ne;0;2;1;3
7498;Pelenė;Drugeliai;2163737781;Ne;4;7;2;13
7499;Pelenė;Drugeliai;9004080625;Ne;0;9;0;9
7500;Pelenė;Drugeliai;7565331966;Ne;3;4;2;9
7501;Pelenė;Drugeliai;5074054534;Ne;2;1;2;5
7502;Pelenė;Drugeliai;8194354176;Ne;0;2;0;2
7503;Pelenė;Drugeliai;5579900958;Ne;3;0;4;7
7504;Pelenė;Drugeliai;9969975097;Ne;1;2;3;6
7505;Pipiras;EŽIUKAI;9728140172;Ne;0;2;0;2
7506;Pipiras;EŽIUKAI;8520454289;Ne;0;4;2;6
7507;Pipiras;EŽIUKAI;5512049762;Ne;0;4;0;4
7508;Pipiras;EŽIUKAI;5856735452;Ne;4;3;1;8
7509;Pipiras;EŽIUKAI;1711168196;Ne;0;2;0;2
7510;Pipiras;EŽIUKAI;5908707752;Ne;0;0;1;1
7511;Pipiras;EŽIUKAI;4017042461;Ne;0;8;0;8
7512;Pipiras;EŽIUKAI;4725221169;Ne;0;3;0;3
7513;Pipiras;EŽIUKAI;5059203266;Ne;0;6;1;7
7514;Pipiras;EŽIUKAI;8140314304;Ne;3;1;3;7
7515;Pipiras;EŽIUKAI;8422419380;Ne;1;2;1;4
7516;Pipiras;EŽIUKAI;6791495556;Ne;1;4;0;5
7517;Pipiras;EŽIUKAI;4811029230;Ne;0;3;5;8
7518;Pipiras;EŽIUKAI;6363349541;Ne;0;3;0;3
7519;Pipiras;EŽIUKAI;1353114929;Ne;0;2;0;2
7520;Pipiras;EŽIUKAI;4426479971;Ne;1;3;3;7
7521;Pipiras;BITUTĖS;3851239592;Ne;0;10;1;11
7522;Pipiras;BITUTĖS;1645482584;Ne;0;1;3;4
7523;Pipiras;BITUTĖS;7891664385;Ne;3;2;3;8
7524;Pipiras;BITUTĖS;9050423801;Ne;0;2;0;2
7525;Pipiras;BITUTĖS;3794537946;Ne;0;5;0;5
7526;Pipiras;BITUTĖS;5047070127;Ne;7;1;4;12
7527;Pipiras;BITUTĖS;9394456452;Ne;0;21;0;21
7528;Pipiras;BITUTĖS;9610070604;Ne;0;4;0;4
7529;Pipiras;BITUTĖS;6362968454;Ne;0;3;0;3
7530;Pipiras;BITUTĖS;9950318827;Ne;0;3;0;3
7531;Pipiras;BITUTĖS;9733577233;Ne;6;2;3;11
7532;Pipiras;BITUTĖS;8983392098;Ne;3;4;3;10
7533;Pipiras;BITUTĖS;2337751973;Ne;0;18;0;18
7534;Pipiras;BITUTĖS;9540765088;Taip;0;0;3;3
7535;Pipiras;BITUTĖS;5735018704;Ne;2;0;0;2
7536;Pipiras;BITUTĖS;6306414173;Ne;2;0;5;7
7537;Pipiras;NYKŠTUKAI;6696824728;Taip;0;4;0;4
7538;Pipiras;NYKŠTUKAI;2016718354;Ne;0;4;0;4
7539;Pipiras;NYKŠTUKAI;1169481984;Ne;3;4;3;10
7540;Pipiras;NYKŠTUKAI;4198534687;Ne;0;6;0;6
7541;Pipiras;NYKŠTUKAI;4458730479;Ne;0;1;0;1
7542;Pipiras;NYKŠTUKAI;3980950261;Ne;0;3;0;3
7543;Pipiras;NYKŠTUKAI;7828638329;Ne;0;3;0;3
7544;Pipiras;NYKŠTUKAI;6775489564;Ne;0;2;12;14
7545;Pipiras;NYKŠTUKAI;7747049622;Ne;8;3;2;13
7546;Pipiras;NYKŠTUKAI;9892201598;Ne;0;9;0;9
7547;Pipiras;NYKŠTUKAI;7371386368;Ne;0;3;0;3
7548;Pipiras;NYKŠTUKAI;1019753152;Ne;0;6;0;6
7549;Pipiras;NYKŠTUKAI;9499869533;Ne;0;2;0;2
7550;Pipiras;NYKŠTUKAI;5141447649;Ne;0;2;0;2
7551;Pipiras;NYKŠTUKAI;9248925267;Ne;0;6;0;6
7552;Pipiras;NYKŠTUKAI;9711147855;Ne;0;0;1;1
7553;Pipiras;NYKŠTUKAI;2120810457;Ne;0;22;0;22
7554;Pipiras;NYKŠTUKAI;7613592821;Ne;0;0;2;2
7555;Pipiras;PELĖDŽIUKAI;8985065850;Ne;3;3;4;10
7556;Pipiras;PELĖDŽIUKAI;3647356600;Ne;10;0;2;12
7557;Pipiras;PELĖDŽIUKAI;6465109403;Taip;3;2;2;7
7558;Pipiras;PELĖDŽIUKAI;6905506774;Ne;17;0;2;19
7559;Pipiras;PELĖDŽIUKAI;8040520887;Ne;0;4;0;4
7560;Pipiras;PELĖDŽIUKAI;7446225835;Ne;0;4;4;8
7561;Pipiras;PELĖDŽIUKAI;8800890503;Ne;0;4;0;4
7562;Pipiras;PELĖDŽIUKAI;6184943213;Ne;0;1;0;1
7563;Pipiras;PELĖDŽIUKAI;8028360748;Ne;0;2;3;5
7564;Pipiras;PELĖDŽIUKAI;1238280105;Ne;15;0;2;17
7565;Pipiras;PELĖDŽIUKAI;3299099535;Ne;0;2;0;2
7566;Pipiras;PELĖDŽIUKAI;5502186385;Ne;0;2;0;2
7567;Pipiras;PELĖDŽIUKAI;8707560610;Ne;2;0;3;5
7568;Pipiras;PELĖDŽIUKAI;4940053409;Ne;7;0;1;8
7569;Pipiras;PELĖDŽIUKAI;6666112357;Ne;0;2;0;2
7570;Pipiras;PELĖDŽIUKAI;9473056714;Ne;0;14;0;14
7571;Pipiras;DRUGELIAI;6018174577;Ne;0;2;0;2
7572;Pipiras;DRUGELIAI;1393570307;Ne;22;0;0;22
7573;Pipiras;DRUGELIAI;3216664984;Ne;0;22;0;22
7574;Pipiras;DRUGELIAI;9307622469;Ne;0;4;0;4
7575;Pipiras;DRUGELIAI;6925577945;Ne;0;2;0;2
7576;Pipiras;DRUGELIAI;9639609431;Ne;2;2;3;7
7577;Pipiras;DRUGELIAI;9422467047;Ne;0;0;4;4
7578;Pipiras;DRUGELIAI;4743474665;Ne;0;14;0;14
7579;Pipiras;DRUGELIAI;9552763906;Ne;1;2;3;6
7580;Pipiras;DRUGELIAI;2159315426;Ne;0;5;0;5
7581;Pipiras;DRUGELIAI;8404246568;Ne;0;2;5;7
7582;Pipiras;DRUGELIAI;3641496225;Ne;0;6;0;6
7583;Pipiras;DRUGELIAI;4991725638;Ne;0;0;4;4
7584;Pipiras;DRUGELIAI;7200147039;Ne;4;2;4;10
7585;Pipiras;DRUGELIAI;5035593032;Ne;0;0;2;2
7586;Pipiras;DRUGELIAI;1443705808;Ne;7;0;0;7
7587;Pipiras;GĖLYTĖS;9670710691;Ne;5;2;2;9
7588;Pipiras;GĖLYTĖS;8965139441;Ne;8;0;2;10
7589;Pipiras;GĖLYTĖS;2095794125;Ne;1;0;2;3
7590;Pipiras;GĖLYTĖS;8675473349;Ne;0;2;1;3
7591;Pipiras;GĖLYTĖS;4945164161;Ne;0;6;2;8
7592;Pipiras;GĖLYTĖS;7362002646;Ne;4;2;2;8
7593;Pipiras;GĖLYTĖS;5150723052;Taip;0;0;1;1
7594;Pipiras;GĖLYTĖS;3755824911;Ne;3;2;3;8
7595;Pipiras;GĖLYTĖS;6453274205;Ne;0;4;1;5
7596;Pipiras;GĖLYTĖS;4559954910;Ne;0;12;0;12
7597;Pipiras;GĖLYTĖS;7157187063;Ne;0;15;0;15
7598;Pipiras;GĖLYTĖS;4021613243;Ne;6;3;2;11
7599;Pipiras;GĖLYTĖS;4236597883;Ne;6;2;2;10
7600;Pipiras;GĖLYTĖS;2474548836;Ne;8;2;2;12
7601;Pipiras;GĖLYTĖS;8553422709;Ne;10;0;2;12
7602;Pipiras;GĖLYTĖS;5738334591;Ne;0;11;0;11
7603;Pipiras;GĖLYTĖS;6428525902;Ne;2;3;4;9
7604;Pipiras;GĖLYTĖS;8354158722;Ne;6;0;2;8
7605;Pipiras;BORUŽĖLĖS;4707794599;Ne;0;5;0;5
7606;Pipiras;BORUŽĖLĖS;8673271201;Ne;0;0;2;2
7607;Pipiras;BORUŽĖLĖS;5968015502;Ne;0;4;0;4
7608;Pipiras;BORUŽĖLĖS;4086728233;Ne;0;4;0;4
7609;Pipiras;BORUŽĖLĖS;8508292428;Ne;0;2;0;2
7610;Pipiras;BORUŽĖLĖS;1210940213;Ne;0;2;0;2
7611;Pipiras;BORUŽĖLĖS;8260680662;Ne;0;13;0;13
7612;Pipiras;BORUŽĖLĖS;9097987789;Taip;0;3;0;3
7613;Pipiras;BORUŽĖLĖS;6310054093;Ne;0;4;0;4
7614;Pipiras;BORUŽĖLĖS;8959946514;Ne;4;0;3;7
7615;Pipiras;BORUŽĖLĖS;9396979045;Ne;4;0;4;8
7616;Pipiras;BORUŽĖLĖS;1146369304;Ne;0;4;0;4
7617;Pipiras;BORUŽĖLĖS;9970587185;Ne;0;0;1;1
7618;Pipiras;BORUŽĖLĖS;6034298583;Ne;9;4;2;15
7619;Pipiras;BORUŽĖLĖS;6344932171;Ne;2;0;2;4
7620;Pipiras;BORUŽĖLĖS;1550959705;Ne;0;2;0;2
7621;Pipiras;BORUŽĖLĖS;9425682286;Ne;0;2;0;2
7622;Pipiras;SKRUZDĖLIUKAI;7969837759;Ne;0;3;0;3
7623;Pipiras;SKRUZDĖLIUKAI;2483867901;Ne;2;2;2;6
7624;Pipiras;SKRUZDĖLIUKAI;1315372873;Ne;0;3;0;3
7625;Pipiras;SKRUZDĖLIUKAI;9372109848;Ne;0;2;7;9
7626;Pipiras;SKRUZDĖLIUKAI;2296702730;Ne;3;0;2;5
7627;Pipiras;SKRUZDĖLIUKAI;3768825314;Ne;0;2;1;3
7628;Pipiras;SKRUZDĖLIUKAI;4309096743;Ne;3;0;2;5
7629;Pipiras;SKRUZDĖLIUKAI;8081343184;Ne;5;0;4;9
7630;Pipiras;SKRUZDĖLIUKAI;9852475056;Ne;10;0;2;12
7631;Pipiras;SKRUZDĖLIUKAI;6176818802;Ne;2;2;4;8
7632;Pipiras;SKRUZDĖLIUKAI;6570068615;Ne;3;1;2;6
7633;Pipiras;SKRUZDĖLIUKAI;9625933545;Ne;0;2;0;2
7634;Pipiras;SKRUZDĖLIUKAI;7211189491;Ne;0;4;0;4
7635;Pipiras;SKRUZDĖLIUKAI;6092576917;Taip;2;2;2;6
7636;Pipiras;SKRUZDĖLIUKAI;4321420201;Ne;0;10;0;10
7637;Pipiras;SKRUZDĖLIUKAI;5346249456;Ne;3;2;2;7
7638;Pipiras;ŽVIRBLIUKŲ;6342044341;Ne;0;4;2;6
7639;Pipiras;ŽVIRBLIUKŲ;5725956659;Ne;0;2;0;2
7640;Pipiras;ŽVIRBLIUKŲ;3852848863;Ne;0;2;0;2
7641;Pipiras;ŽVIRBLIUKŲ;3882437376;Ne;0;0;2;2
7642;Pipiras;ŽVIRBLIUKŲ;9157870634;Ne;1;4;0;5
7643;Pipiras;ŽVIRBLIUKŲ;5235868332;Ne;0;2;0;2
7644;Pipiras;ŽVIRBLIUKŲ;3554786173;Ne;0;0;1;1
7645;Pipiras;ŽVIRBLIUKŲ;1034182352;Ne;0;2;0;2
7646;Pipiras;ŽVIRBLIUKŲ;2075041950;Ne;0;5;0;5
7647;Pipiras;ŽVIRBLIUKŲ;6792777396;Ne;0;5;0;5
7648;Pipiras;ŽVIRBLIUKŲ;6780333972;Ne;0;7;0;7
7649;Pipiras;ŽVIRBLIUKŲ;5622119207;Ne;0;1;0;1
7650;Pipiras;ŽVIRBLIUKŲ;7934365114;Ne;0;1;0;1
7651;Pipiras;ŽVIRBLIUKŲ;9770780973;Ne;7;0;4;11
7652;Pipiras;ŽVIRBLIUKŲ;5845498558;Ne;3;8;0;11
7653;Pipiras;ŽVIRBLIUKŲ;9840040112;Ne;0;7;0;7
7654;Pipiras;ŽVIRBLIUKŲ;1784839485;Ne;2;4;2;8
7655;Pipiras;ŽVIRBLIUKŲ;3775916247;Ne;0;3;0;3
7656;Pipiras;ŽVIRBLIUKŲ;7350131214;Ne;0;8;0;8
7657;Pipiras;ZUIKUČIŲ;3299758617;Ne;0;11;0;11
7658;Pipiras;ZUIKUČIŲ;7202983046;Ne;22;0;0;22
7659;Pipiras;ZUIKUČIŲ;6392620549;Ne;3;2;2;7
7660;Pipiras;ZUIKUČIŲ;4017133866;Ne;0;6;0;6
7661;Pipiras;ZUIKUČIŲ;5273904507;Ne;22;0;0;22
7662;Pipiras;ZUIKUČIŲ;3779938901;Ne;4;0;0;4
7663;Pipiras;ZUIKUČIŲ;8364071068;Ne;22;0;0;22
7664;Pipiras;ZUIKUČIŲ;9206586291;Ne;8;0;4;12
7665;Pipiras;ZUIKUČIŲ;1326532597;Ne;8;0;2;10
7666;Pipiras;ZUIKUČIŲ;3759775049;Ne;2;2;4;8
7667;Pipiras;ZUIKUČIŲ;8716061709;Ne;0;2;0;2
7668;Pipiras;ZUIKUČIŲ;6700688846;Ne;0;22;0;22
7669;Pipiras;ZUIKUČIŲ;3390710493;Ne;4;0;3;7
7670;Pipiras;ZUIKUČIŲ;8415685989;Ne;0;2;0;2
7671;Pipiras;VARLIUKŲ;8952109131;Taip;7;0;2;9
7672;Pipiras;VARLIUKŲ;3553431200;Ne;3;2;4;9
7673;Pipiras;VARLIUKŲ;7262747212;Ne;3;0;2;5
7674;Pipiras;VARLIUKŲ;6221086316;Taip;0;1;0;1
7675;Pipiras;VARLIUKŲ;3219349754;Ne;0;16;0;16
7676;Pipiras;VARLIUKŲ;1254069142;Ne;0;3;0;3
7677;Pipiras;VARLIUKŲ;3548414064;Ne;3;2;4;9
7678;Pipiras;VARLIUKŲ;5735835403;Ne;2;0;0;2
7679;Pipiras;VARLIUKŲ;2248789873;Ne;11;0;2;13
7680;Pipiras;VARLIUKŲ;1995619760;Taip;22;0;0;22
7681;Pipiras;VARLIUKŲ;8128573827;Ne;7;8;0;15
7682;Pipiras;VARLIUKŲ;6349032299;Ne;13;3;2;18
7683;Pipiras;VARLIUKŲ;7209844964;Ne;2;1;2;5
7684;Pipiras;VARLIUKŲ;7689406983;Ne;0;2;0;2
7685;Pipiras;ŽIOGELIŲ;7510719254;Ne;17;0;2;19
7686;Pipiras;ŽIOGELIŲ;7802812858;Ne;0;5;0;5
7687;Pipiras;ŽIOGELIŲ;8697732892;Ne;2;0;5;7
7688;Pipiras;ŽIOGELIŲ;1466527534;Ne;2;0;3;5
7689;Pipiras;ŽIOGELIŲ;1172225661;Ne;0;6;0;6
7690;Pipiras;ŽIOGELIŲ;3825960148;Ne;8;2;4;14
7691;Pipiras;ŽIOGELIŲ;9747219629;Ne;0;2;1;3
7692;Pipiras;ŽIOGELIŲ;8445608419;Taip;0;0;2;2
7693;Pipiras;ŽIOGELIŲ;6602780166;Ne;2;0;2;4
7694;Pipiras;ŽIOGELIŲ;4229548366;Ne;9;0;3;12
7695;Pipiras;ŽIOGELIŲ;8666908143;Ne;11;0;10;21
7696;Pipiras;ŽIOGELIŲ;4083110785;Ne;0;10;0;10
7697;Pipiras;ŽIOGELIŲ;7011969610;Ne;0;0;4;4
7698;Pipiras;ŽIOGELIŲ;3701585967;Ne;8;2;4;14
7699;Pipiras;ŽIOGELIŲ;5274511724;Ne;2;0;0;2
7700;Pipiras;ŽIOGELIŲ;8852386906;Ne;0;0;3;3
7701;Pipiras;ŽIOGELIŲ;1417118390;Ne;9;2;3;14
7702;Pipiras;ŽIOGELIŲ;8364783015;Ne;9;0;10;19
7703;Pipiras;ŽIOGELIŲ;8351469544;Ne;0;8;0;8
7704;"Prie pasakų parko";ZUIKUČIAI;8493622886;Ne;4;0;2;6
7705;"Prie pasakų parko";ZUIKUČIAI;3998970024;Ne;2;0;0;2
7706;"Prie pasakų parko";ZUIKUČIAI;3907016976;Ne;10;0;2;12
7707;"Prie pasakų parko";ZUIKUČIAI;4904562817;Ne;2;0;1;3
7708;"Prie pasakų parko";ZUIKUČIAI;9659710840;Ne;0;3;0;3
7709;"Prie pasakų parko";ZUIKUČIAI;5394554484;Ne;2;0;0;2
7710;"Prie pasakų parko";ZUIKUČIAI;9707694441;Ne;6;0;2;8
7711;"Prie pasakų parko";ZUIKUČIAI;7220229641;Ne;13;1;3;17
7712;"Prie pasakų parko";ZUIKUČIAI;8616467675;Ne;8;0;2;10
7713;"Prie pasakų parko";ZUIKUČIAI;8215496569;Ne;0;0;2;2
7714;"Prie pasakų parko";ZUIKUČIAI;3038164555;Ne;2;0;0;2
7715;"Prie pasakų parko";ZUIKUČIAI;4183640714;Ne;22;0;0;22
7716;"Prie pasakų parko";ZUIKUČIAI;5326765354;Taip;10;0;2;12
7717;"Prie pasakų parko";PAUKŠČIUKŲ;7330033315;Ne;3;0;0;3
7718;"Prie pasakų parko";PAUKŠČIUKŲ;9061639276;Ne;2;0;1;3
7719;"Prie pasakų parko";PAUKŠČIUKŲ;1476515947;Ne;2;0;3;5
7720;"Prie pasakų parko";PAUKŠČIUKŲ;6601363351;Ne;0;2;1;3
7721;"Prie pasakų parko";PAUKŠČIUKŲ;7693728136;Taip;3;10;2;15
7722;"Prie pasakų parko";PAUKŠČIUKŲ;8882083855;Ne;2;0;3;5
7723;"Prie pasakų parko";PAUKŠČIUKŲ;8627379659;Ne;0;0;2;2
7724;"Prie pasakų parko";PAUKŠČIUKŲ;1644560882;Ne;3;0;3;6
7725;"Prie pasakų parko";PAUKŠČIUKŲ;4643624588;Ne;2;0;1;3
7726;"Prie pasakų parko";PAUKŠČIUKŲ;7349726598;Ne;9;0;3;12
7727;"Prie pasakų parko";PAUKŠČIUKŲ;9571177184;Ne;15;0;2;17
7728;"Prie pasakų parko";PAUKŠČIUKŲ;8949522672;Ne;2;4;0;6
7729;"Prie pasakų parko";PAUKŠČIUKŲ;1435069282;Ne;1;0;1;2
7730;"Prie pasakų parko";PAUKŠČIUKŲ;2088585478;Ne;0;0;2;2
7731;"Prie pasakų parko";PAUKŠČIUKŲ;6362378741;Taip;12;0;2;14
7732;"Prie pasakų parko";PAUKŠČIUKŲ;3525929286;Taip;2;0;3;5
7733;"Prie pasakų parko";"LINKSMOJI ŠEIMYNĖLĖ (SPEC)";2077861244;Ne;0;2;0;2
7734;"Prie pasakų parko";"LINKSMOJI ŠEIMYNĖLĖ (SPEC)";1112142035;Ne;0;0;1;1
7735;"Prie pasakų parko";"LINKSMOJI ŠEIMYNĖLĖ (SPEC)";4895744524;Ne;0;1;0;1
7736;"Prie pasakų parko";"LINKSMOJI ŠEIMYNĖLĖ (SPEC)";2760980480;Ne;0;0;2;2
7737;"Prie pasakų parko";"LINKSMOJI ŠEIMYNĖLĖ (SPEC)";2272661119;Ne;0;2;3;5
7738;"Prie pasakų parko";NYKŠTUKŲ;2287711014;Ne;2;0;1;3
7739;"Prie pasakų parko";NYKŠTUKŲ;6491435655;Ne;10;0;5;15
7740;"Prie pasakų parko";NYKŠTUKŲ;1743429440;Ne;0;17;0;17
7741;"Prie pasakų parko";NYKŠTUKŲ;7739970115;Ne;7;0;0;7
7742;"Prie pasakų parko";NYKŠTUKŲ;6700916147;Ne;1;0;2;3
7743;"Prie pasakų parko";NYKŠTUKŲ;6733793491;Ne;0;0;4;4
7744;"Prie pasakų parko";NYKŠTUKŲ;4674683653;Taip;3;0;2;5
7745;"Prie pasakų parko";NYKŠTUKŲ;2515928623;Ne;3;0;2;5
7746;"Prie pasakų parko";NYKŠTUKŲ;1316127369;Ne;4;0;3;7
7747;"Prie pasakų parko";NYKŠTUKŲ;2654978735;Ne;5;0;4;9
7748;"Prie pasakų parko";NYKŠTUKŲ;2661900328;Ne;0;2;0;2
7749;"Prie pasakų parko";NYKŠTUKŲ;3202292611;Ne;2;0;2;4
7750;"Prie pasakų parko";NYKŠTUKŲ;9225775914;Ne;0;1;1;2
7751;"Prie pasakų parko";NYKŠTUKŲ;4457827262;Ne;10;0;2;12
7752;"Prie pasakų parko";NYKŠTUKŲ;6171021539;Ne;4;0;10;14
7753;"Prie pasakų parko";NYKŠTUKŲ;4860316199;Ne;1;1;4;6
7754;"Prie pasakų parko";NYKŠTUKŲ;3907578461;Ne;2;0;2;4
7755;"Prie pasakų parko";NYKŠTUKŲ;9784398441;Ne;5;0;2;7
7756;"Prie pasakų parko";NYKŠTUKŲ;4891232161;Ne;0;3;1;4
7757;"Prie pasakų parko";NYKŠTUKŲ;9550985822;Ne;0;1;0;1
7758;"Prie pasakų parko";LAŠELIŲ;8574432191;Ne;0;1;0;1
7759;"Prie pasakų parko";LAŠELIŲ;4181676762;Ne;0;2;1;3
7760;"Prie pasakų parko";LAŠELIŲ;4548803933;Ne;0;2;0;2
7761;"Prie pasakų parko";LAŠELIŲ;6250610187;Ne;0;7;0;7
7762;"Prie pasakų parko";LAŠELIŲ;2216634402;Ne;8;2;3;13
7763;"Prie pasakų parko";LAŠELIŲ;2731544174;Ne;0;2;1;3
7764;"Prie pasakų parko";LAŠELIŲ;8339335908;Ne;0;2;0;2
7765;"Prie pasakų parko";LAŠELIŲ;2350325153;Ne;0;0;1;1
7766;"Prie pasakų parko";LAŠELIŲ;7390391804;Ne;2;0;4;6
7767;"Prie pasakų parko";LAŠELIŲ;6762267582;Ne;10;2;4;16
7768;"Prie pasakų parko";LAŠELIŲ;9072312203;Ne;0;2;0;2
7769;"Prie pasakų parko";LAŠELIŲ;2952868428;Ne;6;1;2;9
7770;"Prie pasakų parko";LAŠELIŲ;5159105661;Ne;0;2;1;3
7771;"Prie pasakų parko";LAŠELIŲ;6074218082;Ne;7;0;7;14
7772;"Prie pasakų parko";LAŠELIŲ;4351705573;Ne;10;0;3;13
7773;"Prie pasakų parko";"KAČIUKAI (SPEC)";2590693851;Ne;8;0;5;13
7774;"Prie pasakų parko";"KAČIUKAI (SPEC)";3949671257;Ne;4;0;2;6
7775;"Prie pasakų parko";"KAČIUKAI (SPEC)";2583331243;Ne;0;0;4;4
7776;"Prie pasakų parko";"KAČIUKAI (SPEC)";1370201372;Ne;0;0;6;6
7777;"Prie pasakų parko";"KAČIUKAI (SPEC)";5594531224;Ne;0;0;1;1
7778;"Prie pasakų parko";"KAČIUKAI (SPEC)";1618225282;Ne;0;1;1;2
7779;"Prie pasakų parko";"KAČIUKAI (SPEC)";2543765544;Ne;0;0;4;4
7780;"Prie pasakų parko";"ŽVAIGŽDUTĖS  (SPEC)";7216751216;Ne;1;1;2;4
7781;"Prie pasakų parko";"ŽVAIGŽDUTĖS  (SPEC)";5006152810;Ne;8;1;2;11
7782;"Prie pasakų parko";"ŽVAIGŽDUTĖS  (SPEC)";6989235061;Ne;6;0;7;13
7783;"Prie pasakų parko";"ŽVAIGŽDUTĖS  (SPEC)";5009168398;Ne;2;0;2;4
7784;"Prie pasakų parko";"ŽVAIGŽDUTĖS  (SPEC)";6585504578;Ne;9;0;3;12
7785;"Prie pasakų parko";"ŽVAIGŽDUTĖS  (SPEC)";1621710265;Ne;6;0;3;9
7786;"Prie pasakų parko";"ŽVAIGŽDUTĖS  (SPEC)";8203595449;Ne;9;1;4;14
7787;"Prie pasakų parko";"ŽVAIGŽDUTĖS  (SPEC)";7476984763;Ne;3;0;1;4
7788;"Prie pasakų parko";"ŽVAIGŽDUTĖS  (SPEC)";7449993309;Ne;13;0;3;16
7789;"Prie pasakų parko";"ANČIUKAI (SPEC)";6802898184;Ne;0;2;1;3
7790;"Prie pasakų parko";"ANČIUKAI (SPEC)";9529949992;Ne;7;1;4;12
7791;"Prie pasakų parko";"ANČIUKAI (SPEC)";4309482351;Ne;0;3;2;5
7792;"Prie pasakų parko";"ANČIUKAI (SPEC)";7200571639;Ne;1;0;4;5
7793;"Prie pasakų parko";"ANČIUKAI (SPEC)";2047018335;Ne;0;0;2;2
7794;"Prie pasakų parko";"ANČIUKAI (SPEC)";2731902356;Ne;0;2;0;2
7795;"Prie pasakų parko";"ANČIUKAI (SPEC)";5627477370;Ne;0;7;2;9
7796;"Prie pasakų parko";"ANČIUKAI (SPEC)";9999109437;Ne;2;7;2;11
7797;"Prie pasakų parko";"ANČIUKAI (SPEC)";9741985709;Ne;12;0;0;12
7798;"Prie pasakų parko";TIGRIUKAI;3918269702;Ne;6;2;4;12
7799;"Prie pasakų parko";TIGRIUKAI;6446562388;Ne;3;6;2;11
7800;"Prie pasakų parko";TIGRIUKAI;2168919559;Ne;0;9;0;9
7801;"Prie pasakų parko";TIGRIUKAI;9476448601;Ne;6;0;3;9
7802;"Prie pasakų parko";TIGRIUKAI;8029428034;Ne;0;1;0;1
7803;"Prie pasakų parko";TIGRIUKAI;8715851643;Ne;0;2;2;4
7804;"Prie pasakų parko";TIGRIUKAI;3617673265;Ne;3;0;5;8
7805;"Prie pasakų parko";TIGRIUKAI;1704679306;Ne;0;2;1;3
7806;"Prie pasakų parko";TIGRIUKAI;7776961789;Ne;0;2;3;5
7807;"Prie pasakų parko";TIGRIUKAI;3373275644;Ne;0;0;7;7
7808;"Prie pasakų parko";TIGRIUKAI;5518041213;Ne;0;0;4;4
7809;"Prie pasakų parko";TIGRIUKAI;8738488104;Ne;0;0;4;4
7810;"Prie pasakų parko";TIGRIUKAI;6606867989;Ne;3;0;2;5
7811;"Prie pasakų parko";TIGRIUKAI;2263419475;Ne;3;0;2;5
7812;"Prie pasakų parko";TIGRIUKAI;6784471792;Ne;3;0;6;9
7813;"Prie pasakų parko";TIGRIUKAI;6110226958;Ne;0;0;1;1
7814;"Prie pasakų parko";"EŽIUKŲ (SPEC)";9632354317;Ne;0;0;7;7
7815;"Prie pasakų parko";"EŽIUKŲ (SPEC)";5944113879;Ne;7;0;4;11
7816;"Prie pasakų parko";"EŽIUKŲ (SPEC)";4950143153;Ne;2;2;2;6
7817;"Prie pasakų parko";"EŽIUKŲ (SPEC)";5834070970;Ne;12;0;2;14
7818;"Prie pasakų parko";"EŽIUKŲ (SPEC)";3579773269;Ne;1;2;4;7
7819;"Prie pasakų parko";"EŽIUKŲ (SPEC)";7313963137;Ne;6;0;4;10
7820;"Prie pasakų parko";"EŽIUKŲ (SPEC)";8338549157;Ne;1;1;2;4
7821;"Prie pasakų parko";"BORUŽIUKŲ (SPEC)";9715586563;Ne;1;0;9;10
7822;"Prie pasakų parko";"BORUŽIUKŲ (SPEC)";2104412442;Ne;0;0;1;1
7823;"Prie pasakų parko";"BORUŽIUKŲ (SPEC)";4504147902;Ne;7;0;2;9
7824;"Prie pasakų parko";"BORUŽIUKŲ (SPEC)";6051760219;Ne;0;0;4;4
7825;"Prie pasakų parko";"BORUŽIUKŲ (SPEC)";5821107898;Ne;7;0;4;11
7826;"Prie pasakų parko";"BORUŽIUKŲ (SPEC)";6772736175;Ne;6;0;7;13
7827;"Prie pasakų parko";"BORUŽIUKŲ (SPEC)";5847625697;Ne;5;0;2;7
7828;"Prie pasakų parko";"BORUŽIUKŲ (SPEC)";8566236342;Ne;0;6;0;6
7829;"Prie pasakų parko";SAULYTĖS;4827245401;Ne;0;2;1;3
7830;"Prie pasakų parko";SAULYTĖS;7404885669;Ne;1;0;2;3
7831;"Prie pasakų parko";SAULYTĖS;3430128279;Ne;8;0;14;22
7832;"Prie pasakų parko";SAULYTĖS;5039094555;Ne;1;2;3;6
7833;"Prie pasakų parko";SAULYTĖS;4580377882;Ne;0;2;2;4
7834;"Prie pasakų parko";SAULYTĖS;5676549541;Ne;0;0;1;1
7835;"Prie pasakų parko";SAULYTĖS;3372896915;Ne;8;0;2;10
7836;"Prie pasakų parko";SAULYTĖS;9464727980;Ne;2;0;2;4
7837;"Prie pasakų parko";SAULYTĖS;4844984321;Ne;0;0;1;1
7838;"Prie pasakų parko";SAULYTĖS;6955061957;Ne;0;10;0;10
7839;"Pumpurėlis (Kalvarijų g. 186)";RAMUNĖLIŲ;7652642088;Taip;4;3;4;11
7840;"Pumpurėlis (Kalvarijų g. 186)";RAMUNĖLIŲ;9052267552;Ne;0;3;1;4
7841;"Pumpurėlis (Kalvarijų g. 186)";RAMUNĖLIŲ;2715059752;Ne;0;0;1;1
7842;"Pumpurėlis (Kalvarijų g. 186)";RAMUNĖLIŲ;4249039048;Ne;0;3;0;3
7843;"Pumpurėlis (Kalvarijų g. 186)";RAMUNĖLIŲ;6982600785;Ne;5;2;2;9
7844;"Pumpurėlis (Kalvarijų g. 186)";RAMUNĖLIŲ;1667602636;Ne;16;0;2;18
7845;"Pumpurėlis (Kalvarijų g. 186)";RAMUNĖLIŲ;8212403350;Ne;0;0;1;1
7846;"Pumpurėlis (Kalvarijų g. 186)";RAMUNĖLIŲ;1448399754;Ne;0;2;0;2
7847;"Pumpurėlis (Kalvarijų g. 186)";RAMUNĖLIŲ;6795405194;Ne;1;0;2;3
7848;"Pumpurėlis (Kalvarijų g. 186)";RAMUNĖLIŲ;7443152469;Ne;0;22;0;22
7849;"Pumpurėlis (Kalvarijų g. 186)";RAMUNĖLIŲ;9306426978;Ne;0;2;2;4
7850;"Pumpurėlis (Kalvarijų g. 186)";RAMUNĖLIŲ;8458676611;Taip;1;2;4;7
7851;"Pumpurėlis (Kalvarijų g. 186)";RAMUNĖLIŲ;6939412463;Ne;0;2;4;6
7852;"Pumpurėlis (Kalvarijų g. 186)";RAMUNĖLIŲ;1856558407;Ne;5;0;3;8
7853;"Pumpurėlis (Kalvarijų g. 186)";RAMUNĖLIŲ;7002569226;Ne;0;0;2;2
7854;"Pumpurėlis (Kalvarijų g. 186)";RAMUNĖLIŲ;8534897580;Taip;0;0;1;1
7855;"Pumpurėlis (Kalvarijų g. 186)";RAMUNĖLIŲ;5208799121;Ne;2;2;4;8
7856;"Pumpurėlis (Kalvarijų g. 186)";VARPELIŲ;5326000400;Ne;18;2;2;22
7857;"Pumpurėlis (Kalvarijų g. 186)";VARPELIŲ;7998027741;Ne;6;0;4;10
7858;"Pumpurėlis (Kalvarijų g. 186)";VARPELIŲ;9395698760;Ne;7;0;4;11
7859;"Pumpurėlis (Kalvarijų g. 186)";VARPELIŲ;9478685443;Ne;0;0;1;1
7860;"Pumpurėlis (Kalvarijų g. 186)";VARPELIŲ;9903981454;Ne;3;1;2;6
7861;"Pumpurėlis (Kalvarijų g. 186)";VARPELIŲ;6647331393;Ne;0;0;7;7
7862;"Pumpurėlis (Kalvarijų g. 186)";VARPELIŲ;3537534154;Ne;0;2;0;2
7863;"Pumpurėlis (Kalvarijų g. 186)";VARPELIŲ;9735493140;Ne;10;0;6;16
7864;"Pumpurėlis (Kalvarijų g. 186)";VARPELIŲ;3964441086;Ne;2;0;2;4
7865;"Pumpurėlis (Kalvarijų g. 186)";VARPELIŲ;8550119831;Ne;0;0;1;1
7866;"Pumpurėlis (Kalvarijų g. 186)";VARPELIŲ;6860128064;Ne;2;0;4;6
7867;"Pumpurėlis (Kalvarijų g. 186)";VARPELIŲ;2282966743;Ne;0;1;1;2
7868;"Pumpurėlis (Kalvarijų g. 186)";VARPELIŲ;5968577443;Ne;0;0;2;2
7869;"Pumpurėlis (Kalvarijų g. 186)";VARPELIŲ;8083674991;Ne;2;0;5;7
7870;"Pumpurėlis (Kalvarijų g. 186)";VARPELIŲ;6422203618;Ne;0;1;3;4
7871;"Pumpurėlis (Kalvarijų g. 186)";VARPELIŲ;1782842327;Ne;8;2;2;12
7872;"Pumpurėlis (Kalvarijų g. 186)";VARPELIŲ;9750242149;Ne;8;2;3;13
7873;"Pumpurėlis (Kalvarijų g. 186)";VARPELIŲ;5420222684;Ne;3;1;2;6
7874;"Pumpurėlis (Kalvarijų g. 186)";DRUGELIŲ;5928552565;Ne;0;0;6;6
7875;"Pumpurėlis (Kalvarijų g. 186)";DRUGELIŲ;5897036076;Ne;2;2;2;6
7876;"Pumpurėlis (Kalvarijų g. 186)";DRUGELIŲ;7055989095;Ne;0;18;0;18
7877;"Pumpurėlis (Kalvarijų g. 186)";DRUGELIŲ;7078621340;Ne;4;2;3;9
7878;"Pumpurėlis (Kalvarijų g. 186)";DRUGELIŲ;1538548768;Ne;2;0;4;6
7879;"Pumpurėlis (Kalvarijų g. 186)";DRUGELIŲ;2368226822;Ne;3;2;3;8
7880;"Pumpurėlis (Kalvarijų g. 186)";DRUGELIŲ;3088476130;Ne;3;0;4;7
7881;"Pumpurėlis (Kalvarijų g. 186)";DRUGELIŲ;9640790401;Taip;0;2;1;3
7882;"Pumpurėlis (Kalvarijų g. 186)";DRUGELIŲ;8320987208;Ne;5;0;2;7
7883;"Pumpurėlis (Kalvarijų g. 186)";DRUGELIŲ;7832408524;Ne;8;0;2;10
7884;"Pumpurėlis (Kalvarijų g. 186)";DRUGELIŲ;8644853849;Ne;0;2;1;3
7885;"Pumpurėlis (Kalvarijų g. 186)";DRUGELIŲ;9417688597;Ne;3;7;2;12
7886;"Pumpurėlis (Kalvarijų g. 186)";DRUGELIŲ;9032255874;Ne;0;2;5;7
7887;"Pumpurėlis (Kalvarijų g. 186)";DRUGELIŲ;9996789041;Ne;0;0;1;1
7888;"Pumpurėlis (Kalvarijų g. 186)";DRUGELIŲ;2684592319;Ne;0;0;1;1
7889;"Pumpurėlis (Kalvarijų g. 186)";DRUGELIŲ;5835115428;Ne;0;0;1;1
7890;"Pumpurėlis (Kalvarijų g. 186)";DRUGELIŲ;2132563531;Ne;0;0;1;1
7891;"Pumpurėlis (Kalvarijų g. 186)";DRUGELIŲ;4506063812;Ne;2;3;6;11
7892;"Pumpurėlis (Kalvarijų g. 186)";DRUGELIŲ;2165141865;Ne;0;2;1;3
7893;"Pumpurėlis (Kalvarijų g. 186)";DRUGELIŲ;8671697745;Ne;3;0;4;7
7894;"Pumpurėlis (Kalvarijų g. 186)";DRUGELIŲ;3187815703;Ne;14;0;5;19
7895;"Pumpurėlis (Kalvarijų g. 186)";KODĖLČIUKŲ;8214602054;Ne;5;0;2;7
7896;"Pumpurėlis (Kalvarijų g. 186)";KODĖLČIUKŲ;9654958302;Ne;0;0;2;2
7897;"Pumpurėlis (Kalvarijų g. 186)";KODĖLČIUKŲ;5564844211;Ne;5;0;7;12
7898;"Pumpurėlis (Kalvarijų g. 186)";KODĖLČIUKŲ;1215117598;Ne;3;6;2;11
7899;"Pumpurėlis (Kalvarijų g. 186)";KODĖLČIUKŲ;6978091765;Ne;5;0;3;8
7900;"Pumpurėlis (Kalvarijų g. 186)";KODĖLČIUKŲ;6433757421;Ne;0;0;1;1
7901;"Pumpurėlis (Kalvarijų g. 186)";KODĖLČIUKŲ;3328647987;Ne;0;2;0;2
7902;"Pumpurėlis (Kalvarijų g. 186)";KODĖLČIUKŲ;3748601124;Ne;0;0;3;3
7903;"Pumpurėlis (Kalvarijų g. 186)";KODĖLČIUKŲ;6004234378;Ne;3;2;2;7
7904;"Pumpurėlis (Kalvarijų g. 186)";KODĖLČIUKŲ;4196409137;Ne;3;1;3;7
7905;"Pumpurėlis (Kalvarijų g. 186)";KODĖLČIUKŲ;6117720533;Ne;0;2;0;2
7906;"Pumpurėlis (Kalvarijų g. 186)";KODĖLČIUKŲ;8070486897;Ne;14;0;4;18
7907;"Pumpurėlis (Kalvarijų g. 186)";KODĖLČIUKŲ;3534133061;Ne;4;0;2;6
7908;"Pumpurėlis (Kalvarijų g. 186)";KODĖLČIUKŲ;2611141763;Ne;0;0;2;2
7909;"Pumpurėlis (Kalvarijų g. 186)";KODĖLČIUKŲ;2307819108;Ne;0;2;1;3
7910;"Pumpurėlis (Kalvarijų g. 186)";KODĖLČIUKŲ;9650395309;Ne;0;0;2;2
7911;"Pumpurėlis (Kalvarijų g. 186)";KODĖLČIUKŲ;6702744879;Ne;0;0;6;6
7912;"Pumpurėlis (Kalvarijų g. 186)";KODĖLČIUKŲ;2890596967;Ne;2;0;2;4
7913;"Pumpurėlis (Kalvarijų g. 186)";KODĖLČIUKŲ;9839285886;Ne;16;0;2;18
7914;"Pumpurėlis (Kalvarijų g. 186)";LINELIS;6780042929;Ne;9;4;2;15
7915;"Pumpurėlis (Kalvarijų g. 186)";LINELIS;7610949816;Ne;0;4;0;4
7916;"Pumpurėlis (Kalvarijų g. 186)";LINELIS;8667762689;Ne;0;9;0;9
7917;"Pumpurėlis (Kalvarijų g. 186)";LINELIS;3953103488;Ne;0;13;0;13
7918;"Pumpurėlis (Kalvarijų g. 186)";LINELIS;6977710645;Ne;0;1;0;1
7919;"Pumpurėlis (Kalvarijų g. 186)";LINELIS;6511527480;Ne;3;2;2;7
7920;"Pumpurėlis (Kalvarijų g. 186)";LINELIS;9431295796;Ne;3;4;2;9
7921;"Pumpurėlis (Kalvarijų g. 186)";LINELIS;3838705973;Ne;0;4;0;4
7922;"Pumpurėlis (Kalvarijų g. 186)";LINELIS;1395380236;Ne;7;0;2;9
7923;"Pumpurėlis (Kalvarijų g. 186)";LINELIS;9424449290;Ne;0;10;0;10
7924;"Pumpurėlis (Kalvarijų g. 186)";LINELIS;6955168163;Ne;0;2;0;2
7925;"Pumpurėlis (Kalvarijų g. 186)";LINELIS;5171198109;Ne;0;12;0;12
7926;"Pumpurėlis (Kalvarijų g. 186)";LINELIS;2233224512;Ne;0;2;0;2
7927;"Pumpurėlis (Kalvarijų g. 186)";LINELIS;9726028397;Ne;1;1;2;4
7928;"Pumpurėlis (Kalvarijų g. 186)";LINELIS;7229289985;Ne;1;4;2;7
7929;"Pumpurėlis (Kalvarijų g. 186)";LINELIS;2969734731;Ne;0;1;2;3
7930;"Pumpurėlis (Kalvarijų g. 186)";LINELIS;7619709360;Ne;4;3;2;9
7931;"Pumpurėlis (Kalvarijų g. 186)";LINELIS;6726875853;Ne;2;3;2;7
7932;"Pumpurėlis (Kalvarijų g. 186)";LINELIS;7559071945;Ne;8;2;2;12
7933;"Pumpurėlis (Kalvarijų g. 186)";LINELIS;9117809080;Ne;0;1;0;1
7934;"Pumpurėlis (Kalvarijų g. 186)";SAULUTĖS;7182107790;Ne;0;2;3;5
7935;"Pumpurėlis (Kalvarijų g. 186)";SAULUTĖS;8525537588;Ne;0;0;3;3
7936;"Pumpurėlis (Kalvarijų g. 186)";SAULUTĖS;3101133244;Ne;0;5;0;5
7937;"Pumpurėlis (Kalvarijų g. 186)";SAULUTĖS;5023658988;Ne;0;7;0;7
7938;"Pumpurėlis (Kalvarijų g. 186)";SAULUTĖS;2668855786;Ne;0;6;2;8
7939;"Pumpurėlis (Kalvarijų g. 186)";SAULUTĖS;2103139845;Ne;0;2;0;2
7940;"Pumpurėlis (Kalvarijų g. 186)";SAULUTĖS;9612924972;Ne;0;4;0;4
7941;"Pumpurėlis (Kalvarijų g. 186)";SAULUTĖS;9884099545;Ne;7;2;2;11
7942;"Pumpurėlis (Kalvarijų g. 186)";SAULUTĖS;3733509497;Ne;0;2;0;2
7943;"Pumpurėlis (Kalvarijų g. 186)";SAULUTĖS;2247300456;Ne;0;0;1;1
7944;"Pumpurėlis (Kalvarijų g. 186)";SAULUTĖS;9224879966;Ne;3;2;2;7
7945;"Pumpurėlis (Kalvarijų g. 186)";SAULUTĖS;5564680653;Ne;0;2;1;3
7946;"Pumpurėlis (Kalvarijų g. 186)";SAULUTĖS;1411232443;Ne;0;5;0;5
7947;"Pumpurėlis (Kalvarijų g. 186)";SAULUTĖS;4508966729;Ne;3;1;2;6
7948;"Pumpurėlis (Kalvarijų g. 186)";SAULUTĖS;9552913910;Ne;0;2;4;6
7949;"Pumpurėlis (Kalvarijų g. 186)";SAULUTĖS;5196733185;Ne;0;2;2;4
7950;"Pumpurėlis (Kalvarijų g. 186)";SAULUTĖS;4629544683;Ne;0;3;0;3
7951;"Pumpurėlis (Kalvarijų g. 186)";SAULUTĖS;5583929465;Ne;0;2;0;2
7952;"Pumpurėlis (Kalvarijų g. 186)";BITUTĖS;4419940231;Ne;0;17;0;17
7953;"Pumpurėlis (Kalvarijų g. 186)";BITUTĖS;4985045047;Taip;10;2;3;15
7954;"Pumpurėlis (Kalvarijų g. 186)";BITUTĖS;2651037375;Ne;0;0;2;2
7955;"Pumpurėlis (Kalvarijų g. 186)";BITUTĖS;1768239820;Ne;0;0;2;2
7956;"Pumpurėlis (Kalvarijų g. 186)";BITUTĖS;2566557351;Ne;8;6;2;16
7957;"Pumpurėlis (Kalvarijų g. 186)";BITUTĖS;4426697956;Taip;4;0;3;7
7958;"Pumpurėlis (Kalvarijų g. 186)";BITUTĖS;7363814444;Ne;8;0;6;14
7959;"Pumpurėlis (Kalvarijų g. 186)";BITUTĖS;3405169131;Ne;7;2;2;11
7960;"Pumpurėlis (Kalvarijų g. 186)";BITUTĖS;3951445693;Ne;3;0;3;6
7961;"Pumpurėlis (Kalvarijų g. 186)";BITUTĖS;9612924316;Ne;8;9;2;19
7962;"Pumpurėlis (Kalvarijų g. 186)";BITUTĖS;1714440337;Ne;2;0;2;4
7963;"Pumpurėlis (Kalvarijų g. 186)";BITUTĖS;8655389224;Ne;3;0;3;6
7964;"Pumpurėlis (Kalvarijų g. 186)";BITUTĖS;1674341906;Taip;0;2;0;2
7965;"Pumpurėlis (Kalvarijų g. 186)";BITUTĖS;3842632260;Ne;0;2;0;2
7966;"Pumpurėlis (Kalvarijų g. 186)";BITUTĖS;1933502038;Ne;0;2;0;2
7967;"Pumpurėlis (Kalvarijų g. 186)";BITUTĖS;2230191718;Ne;0;2;0;2
7968;"Pumpurėlis (Kalvarijų g. 186)";BITUTĖS;7062090879;Ne;0;0;3;3
7969;"Pumpurėlis (Kalvarijų g. 186)";BITUTĖS;8470433743;Ne;8;0;9;17
7970;"Pumpurėlis (Kalvarijų g. 186)";BITUTĖS;6474918016;Ne;8;0;2;10
7971;"Pumpurėlis (Kalvarijų g. 186)";DOBILIUKAI;9179780392;Ne;4;0;2;6
7972;"Pumpurėlis (Kalvarijų g. 186)";DOBILIUKAI;1839505206;Ne;0;11;0;11
7973;"Pumpurėlis (Kalvarijų g. 186)";DOBILIUKAI;3970253545;Ne;2;0;7;9
7974;"Pumpurėlis (Kalvarijų g. 186)";DOBILIUKAI;6968264923;Ne;8;5;2;15
7975;"Pumpurėlis (Kalvarijų g. 186)";DOBILIUKAI;2700017433;Ne;8;2;2;12
7976;"Pumpurėlis (Kalvarijų g. 186)";DOBILIUKAI;7038597556;Ne;3;9;2;14
7977;"Pumpurėlis (Kalvarijų g. 186)";DOBILIUKAI;4130539703;Ne;0;2;0;2
7978;"Pumpurėlis (Kalvarijų g. 186)";DOBILIUKAI;6307988067;Ne;5;2;2;9
7979;"Pumpurėlis (Kalvarijų g. 186)";DOBILIUKAI;3374174445;Ne;8;2;2;12
7980;"Pumpurėlis (Kalvarijų g. 186)";DOBILIUKAI;3398517047;Ne;0;3;0;3
7981;"Pumpurėlis (Kalvarijų g. 186)";DOBILIUKAI;1961282282;Ne;8;2;3;13
7982;"Pumpurėlis (Kalvarijų g. 186)";DOBILIUKAI;7276322999;Ne;4;1;2;7
7983;"Pumpurėlis (Kalvarijų g. 186)";DOBILIUKAI;5587118874;Ne;5;0;2;7
7984;"Pumpurėlis (Kalvarijų g. 186)";DOBILIUKAI;9058493247;Ne;3;1;3;7
7985;"Pumpurėlis (Kalvarijų g. 186)";DOBILIUKAI;3214652626;Ne;8;0;4;12
7986;"Pumpurėlis (Kalvarijų g. 186)";DOBILIUKAI;2028068230;Ne;8;0;2;10
7987;"Pumpurėlis (Kalvarijų g. 186)";DOBILIUKAI;5444879430;Ne;17;0;1;18
7988;"Pumpurėlis (Kalvarijų g. 186)";DOBILIUKAI;7825190756;Ne;5;0;3;8
7989;"Pumpurėlis (Kalvarijų g. 186)";DOBILIUKAI;1438740562;Ne;6;1;2;9
7990;"Pumpurėlis (Kalvarijų g. 186)";DOBILIUKAI;9740660699;Ne;11;7;2;20
7991;"Pumpurėlis (Kalvarijų g. 186)";PUPYČIŲ;9317274035;Ne;0;0;1;1
7992;"Pumpurėlis (Kalvarijų g. 186)";PUPYČIŲ;1555441484;Ne;0;0;1;1
7993;"Pumpurėlis (Kalvarijų g. 186)";PUPYČIŲ;5238756058;Ne;0;22;0;22
7994;"Pumpurėlis (Kalvarijų g. 186)";PUPYČIŲ;1945615416;Ne;0;0;2;2
7995;"Pumpurėlis (Kalvarijų g. 186)";PUPYČIŲ;5384176825;Ne;8;0;4;12
7996;"Pumpurėlis (Kalvarijų g. 186)";PUPYČIŲ;9789187163;Ne;6;0;2;8
7997;"Pumpurėlis (Kalvarijų g. 186)";PUPYČIŲ;7114896633;Ne;9;0;2;11
7998;"Pumpurėlis (Kalvarijų g. 186)";PUPYČIŲ;4133819653;Ne;0;3;3;6
7999;"Pumpurėlis (Kalvarijų g. 186)";PUPYČIŲ;8215233820;Ne;8;0;6;14
8000;"Pumpurėlis (Kalvarijų g. 186)";PUPYČIŲ;1413673339;Ne;22;0;0;22
8001;"Pumpurėlis (Kalvarijų g. 186)";PUPYČIŲ;1084209625;Ne;0;0;2;2
8002;"Pumpurėlis (Kalvarijų g. 186)";PUPYČIŲ;9164586359;Ne;3;0;4;7
8003;"Pumpurėlis (Kalvarijų g. 186)";PUPYČIŲ;9316908064;Ne;3;0;4;7
8004;"Pumpurėlis (Kalvarijų g. 186)";PUPYČIŲ;1082943651;Ne;11;0;2;13
8005;"Pumpurėlis (Kalvarijų g. 186)";ŽIRNIUKŲ;4198532140;Ne;8;0;4;12
8006;"Pumpurėlis (Kalvarijų g. 186)";ŽIRNIUKŲ;6162279957;Ne;5;0;2;7
8007;"Pumpurėlis (Kalvarijų g. 186)";ŽIRNIUKŲ;6602860291;Ne;12;0;4;16
8008;"Pumpurėlis (Kalvarijų g. 186)";ŽIRNIUKŲ;6535225429;Ne;8;3;2;13
8009;"Pumpurėlis (Kalvarijų g. 186)";ŽIRNIUKŲ;6606861732;Ne;8;0;6;14
8010;"Pumpurėlis (Kalvarijų g. 186)";ŽIRNIUKŲ;8057222613;Ne;6;0;4;10
8011;"Pumpurėlis (Kalvarijų g. 186)";ŽIRNIUKŲ;9704396561;Ne;6;0;4;10
8012;"Pumpurėlis (Kalvarijų g. 186)";ŽIRNIUKŲ;9033360796;Ne;6;0;4;10
8013;"Pumpurėlis (Kalvarijų g. 186)";ŽIRNIUKŲ;3438212768;Ne;9;0;2;11
8014;"Pumpurėlis (Kalvarijų g. 186)";ŽIRNIUKŲ;4686840292;Ne;0;0;3;3
8015;"Pumpurėlis (Kalvarijų g. 186)";ŽIRNIUKŲ;4195060928;Ne;7;1;5;13
8016;"Pumpurėlis (Kalvarijų g. 186)";ŽIRNIUKŲ;3966128737;Ne;0;0;7;7
8017;"Pumpurėlis (Kalvarijų g. 186)";ŽIRNIUKŲ;4446088965;Ne;6;0;5;11
8018;"Pumpurėlis (Kalvarijų g. 186)";ŽIRNIUKŲ;7994376089;Ne;0;2;1;3
8019;"Pumpurėlis (Kalvarijų g. 186)";ŽIRNIUKŲ;5765942106;Ne;4;0;7;11
8020;"Pumpurėlis (Kalvarijų g. 186)";ŽIRNIUKŲ;8978637291;Ne;9;0;4;13
8021;"Pumpurėlis (Kalvarijų g. 186)";ŽIRNIUKŲ;1756751203;Ne;7;3;2;12
8022;"Pumpurėlis (Kalvarijų g. 186)";BORUŽĖLIŲ;2269864490;Ne;7;0;2;9
8023;"Pumpurėlis (Kalvarijų g. 186)";BORUŽĖLIŲ;6223338814;Ne;10;0;4;14
8024;"Pumpurėlis (Kalvarijų g. 186)";BORUŽĖLIŲ;5659508302;Ne;3;0;2;5
8025;"Pumpurėlis (Kalvarijų g. 186)";BORUŽĖLIŲ;5998858670;Ne;0;0;3;3
8026;"Pumpurėlis (Kalvarijų g. 186)";BORUŽĖLIŲ;7398363498;Ne;0;0;1;1
8027;"Pumpurėlis (Kalvarijų g. 186)";BORUŽĖLIŲ;5835545051;Ne;4;0;2;6
8028;"Pumpurėlis (Kalvarijų g. 186)";BORUŽĖLIŲ;4188020534;Ne;5;0;2;7
8029;"Pumpurėlis (Kalvarijų g. 186)";BORUŽĖLIŲ;6256781298;Ne;0;8;0;8
8030;"Pumpurėlis (Kalvarijų g. 186)";BORUŽĖLIŲ;9136771401;Ne;3;3;2;8
8031;"Pumpurėlis (Kalvarijų g. 186)";BORUŽĖLIŲ;7045349032;Ne;13;0;2;15
8032;"Pumpurėlis (Kalvarijų g. 186)";BORUŽĖLIŲ;1017838338;Ne;15;0;3;18
8033;"Pumpurėlis (Kalvarijų g. 186)";BORUŽĖLIŲ;1648249689;Ne;12;2;2;16
8034;"Pumpurėlis (Kalvarijų g. 186)";BORUŽĖLIŲ;7535098093;Ne;0;0;2;2
8035;"Pumpurėlis (Kalvarijų g. 186)";BORUŽĖLIŲ;7843280418;Ne;9;0;2;11
8036;"Pumpurėlis (Kalvarijų g. 186)";BORUŽĖLIŲ;3531862496;Ne;0;2;2;4
8037;"Pumpurėlis (Kalvarijų g. 186)";BORUŽĖLIŲ;1441993078;Ne;0;22;0;22
8038;"Pumpurėlis (Kalvarijų g. 186)";BORUŽĖLIŲ;3407251558;Ne;8;0;4;12
8039;"Pumpurėlis (Kalvarijų g. 186)";BORUŽĖLIŲ;4355867863;Ne;0;1;0;1
8040;"Pumpurėlis (Kalvarijų g. 186)";BORUŽĖLIŲ;6386699443;Ne;1;0;2;3
8041;"Pumpurėlis (Kalvarijų g. 186)";SMALSUČIŲ;6212212516;Ne;9;2;4;15
8042;"Pumpurėlis (Kalvarijų g. 186)";SMALSUČIŲ;6604801631;Ne;5;0;2;7
8043;"Pumpurėlis (Kalvarijų g. 186)";SMALSUČIŲ;6988369637;Ne;0;0;2;2
8044;"Pumpurėlis (Kalvarijų g. 186)";SMALSUČIŲ;9363610488;Ne;8;2;2;12
8045;"Pumpurėlis (Kalvarijų g. 186)";SMALSUČIŲ;8380689261;Ne;3;0;2;5
8046;"Pumpurėlis (Kalvarijų g. 186)";SMALSUČIŲ;6483338028;Ne;5;0;2;7
8047;"Pumpurėlis (Kalvarijų g. 186)";SMALSUČIŲ;3492977569;Ne;0;0;2;2
8048;"Pumpurėlis (Kalvarijų g. 186)";SMALSUČIŲ;6959214331;Ne;0;2;1;3
8049;"Pumpurėlis (Kalvarijų g. 186)";SMALSUČIŲ;2905797053;Ne;4;0;4;8
8050;"Pumpurėlis (Kalvarijų g. 186)";SMALSUČIŲ;2026021360;Ne;4;2;4;10
8051;"Pumpurėlis (Kalvarijų g. 186)";SMALSUČIŲ;3871151401;Ne;3;2;2;7
8052;"Pumpurėlis (Kalvarijų g. 186)";SMALSUČIŲ;6557857672;Ne;9;2;4;15
8053;"Pumpurėlis (Kalvarijų g. 186)";SMALSUČIŲ;5212827184;Ne;9;2;4;15
8054;"Pumpurėlis (Kalvarijų g. 186)";SMALSUČIŲ;6614797909;Ne;2;0;2;4
8055;"Pumpurėlis (Kalvarijų g. 186)";SMALSUČIŲ;7813696919;Ne;1;0;4;5
8056;"Pumpurėlis (Kalvarijų g. 186)";SMALSUČIŲ;5278250113;Ne;0;0;1;1
8057;"Pumpurėlis (Kalvarijų g. 186)";SMALSUČIŲ;5236515914;Ne;0;3;4;7
8058;"Pumpurėlis (Kalvarijų g. 186)";SMALSUČIŲ;5456922203;Ne;6;2;2;10
8059;"Pumpurėlis (Kalvarijų g. 186)";SMALSUČIŲ;8886730333;Ne;0;3;3;6
8060;Puriena;Ančiukų;6158842119;Ne;0;7;0;7
8061;Puriena;Ančiukų;3557013127;Ne;0;6;0;6
8062;Puriena;Ančiukų;4100466337;Ne;0;22;0;22
8063;Puriena;Ančiukų;9251058353;Ne;0;2;0;2
8064;Puriena;Ančiukų;3681811493;Ne;1;0;2;3
8065;Puriena;Ančiukų;4060087185;Ne;0;2;0;2
8066;Puriena;Ančiukų;6280465748;Ne;3;2;4;9
8067;Puriena;Ančiukų;3033562627;Ne;0;8;0;8
8068;Puriena;Ančiukų;5777076971;Ne;0;8;0;8
8069;Puriena;Ančiukų;8310231540;Ne;0;3;2;5
8070;Puriena;Ančiukų;4460575818;Ne;0;13;0;13
8071;Puriena;Ančiukų;8120597514;Ne;0;1;0;1
8072;Puriena;Ančiukų;7967288875;Ne;2;0;4;6
8073;Puriena;Ančiukų;5336923102;Ne;2;1;2;5
8074;Puriena;Ančiukų;1907429094;Ne;0;2;2;4
8075;Puriena;Ančiukų;4605662701;Ne;0;2;0;2
8076;Puriena;Ančiukų;1819876614;Ne;10;0;3;13
8077;Puriena;Ančiukų;4776745276;Ne;0;1;1;2
8078;Puriena;Ančiukų;7769252165;Ne;0;5;0;5
8079;Puriena;Ančiukų;2170025682;Ne;0;2;0;2
8080;Puriena;Ančiukų;3772941726;Ne;0;3;0;3
8081;Puriena;Ančiukų;1428098802;Ne;0;3;0;3
8082;Puriena;Drugeliai;7016498639;Ne;4;0;2;6
8083;Puriena;Drugeliai;4016228982;Ne;8;0;2;10
8084;Puriena;Drugeliai;9671916745;Ne;0;0;2;2
8085;Puriena;Drugeliai;8195902319;Ne;0;2;2;4
8086;Puriena;Drugeliai;5797970231;Ne;3;2;2;7
8087;Puriena;Drugeliai;3382737176;Ne;3;0;5;8
8088;Puriena;Drugeliai;4587892949;Ne;2;0;2;4
8089;Puriena;Drugeliai;3440488785;Ne;6;0;2;8
8090;Puriena;Drugeliai;6941251095;Ne;20;0;2;22
8091;Puriena;Drugeliai;3252190329;Ne;0;2;2;4
8092;Puriena;Drugeliai;5927216569;Ne;5;0;4;9
8093;Puriena;Drugeliai;8474426340;Ne;2;0;2;4
8094;Puriena;Drugeliai;6308393533;Ne;0;2;3;5
8095;Puriena;Drugeliai;9907972536;Taip;3;1;2;6
8096;Puriena;Drugeliai;8239919265;Taip;3;0;4;7
8097;Puriena;Drugeliai;7634536770;Ne;3;2;2;7
8098;Puriena;Drugeliai;9176303276;Ne;3;2;2;7
8099;Puriena;Drugeliai;3604094165;Ne;5;0;10;15
8100;Puriena;Drugeliai;8110665629;Ne;3;3;2;8
8101;Puriena;Pelėdžiukai;2013783668;Ne;0;2;0;2
8102;Puriena;Pelėdžiukai;8874823029;Ne;0;0;2;2
8103;Puriena;Pelėdžiukai;3149718901;Ne;0;2;2;4
8104;Puriena;Pelėdžiukai;9041388275;Ne;0;3;0;3
8105;Puriena;Pelėdžiukai;3175917649;Ne;0;0;2;2
8106;Puriena;Pelėdžiukai;2579402981;Ne;0;0;3;3
8107;Puriena;Pelėdžiukai;3671297035;Ne;0;7;0;7
8108;Puriena;Pelėdžiukai;2701942325;Ne;0;9;1;10
8109;Puriena;Pelėdžiukai;4858971990;Ne;0;1;0;1
8110;Puriena;Pelėdžiukai;1417566073;Ne;0;0;2;2
8111;Puriena;Pelėdžiukai;6463129806;Ne;0;2;0;2
8112;Puriena;Pelėdžiukai;4501239330;Ne;0;2;2;4
8113;Puriena;Pelėdžiukai;5341228269;Ne;9;6;0;15
8114;Puriena;Pelėdžiukai;6786694796;Ne;8;0;2;10
8115;Puriena;Pelėdžiukai;8952508230;Ne;7;0;3;10
8116;Puriena;Pelėdžiukai;5080805225;Ne;8;0;2;10
8117;Puriena;Pelėdžiukai;1158768017;Ne;0;4;0;4
8118;Puriena;Pelėdžiukai;1658720269;Ne;0;1;3;4
8119;Puriena;Voveriukai;8772936125;Ne;7;0;13;20
8120;Puriena;Voveriukai;6428413592;Ne;14;0;4;18
8121;Puriena;Voveriukai;8242140541;Ne;0;1;2;3
8122;Puriena;Voveriukai;7066959314;Ne;0;2;0;2
8123;Puriena;Voveriukai;1455237224;Ne;0;1;2;3
8124;Puriena;Voveriukai;3094722037;Ne;6;0;2;8
8125;Puriena;Voveriukai;4193710604;Ne;0;10;0;10
8126;Puriena;Voveriukai;6227990580;Ne;3;0;6;9
8127;Puriena;Voveriukai;4165800035;Ne;3;0;5;8
8128;Puriena;Voveriukai;7334787183;Ne;8;0;2;10
8129;Puriena;Voveriukai;8412041946;Ne;13;0;2;15
8130;Puriena;Voveriukai;3287725982;Ne;22;0;0;22
8131;Puriena;Voveriukai;6496077328;Ne;3;0;7;10
8132;Puriena;Voveriukai;8845361962;Ne;0;22;0;22
8133;Puriena;Voveriukai;9965834233;Ne;6;0;2;8
8134;Puriena;Voveriukai;5841409384;Ne;10;0;7;17
8135;Puriena;Voveriukai;9934831745;Ne;3;0;3;6
8136;Puriena;Voveriukai;8310464710;Ne;22;0;0;22
8137;Puriena;Voveriukai;1614993691;Ne;0;0;3;3
8138;Puriena;Voveriukai;2172109284;Ne;5;2;2;9
8139;Puriena;Bitučių;1621772702;Ne;3;3;2;8
8140;Puriena;Bitučių;9413672989;Ne;8;1;2;11
8141;Puriena;Bitučių;1175665781;Ne;0;0;4;4
8142;Puriena;Bitučių;6853706997;Ne;0;2;0;2
8143;Puriena;Bitučių;1339162214;Ne;0;4;2;6
8144;Puriena;Bitučių;9543884311;Ne;0;4;0;4
8145;Puriena;Bitučių;6656013805;Ne;0;2;1;3
8146;Puriena;Bitučių;8022809059;Ne;0;0;5;5
8147;Puriena;Bitučių;5395382717;Ne;0;2;3;5
8148;Puriena;Bitučių;8237149969;Ne;0;2;0;2
8149;Puriena;Bitučių;7481642656;Ne;0;22;0;22
8150;Puriena;Bitučių;8512814466;Ne;0;7;0;7
8151;Puriena;Bitučių;7622407056;Ne;0;0;2;2
8152;Puriena;Bitučių;4017644414;Ne;2;0;7;9
8153;Puriena;Bitučių;8416003733;Ne;0;4;2;6
8154;Puriena;Bitučių;8199607793;Ne;3;0;4;7
8155;Puriena;Bitučių;9854244405;Ne;0;3;0;3
8156;Puriena;Bitučių;6780164845;Ne;5;0;4;9
8157;Puriena;Bitučių;6413337915;Ne;0;2;6;8
8158;Puriena;Zylutės;2966464432;Ne;0;0;2;2
8159;Puriena;Zylutės;4760827000;Ne;0;3;1;4
8160;Puriena;Zylutės;1521955898;Ne;0;1;0;1
8161;Puriena;Zylutės;8881337164;Ne;0;1;0;1
8162;Puriena;Zylutės;6914613438;Ne;0;0;1;1
8163;Puriena;Zylutės;1121312813;Taip;0;1;0;1
8164;Puriena;Zylutės;2321753665;Ne;2;0;2;4
8165;Puriena;Zylutės;7021756459;Ne;0;1;0;1
8166;Puriena;Zylutės;1564155036;Ne;4;1;2;7
8167;Puriena;Zylutės;9098291788;Ne;0;4;0;4
8168;Puriena;Zylutės;6613654824;Ne;2;2;7;11
8169;Puriena;Zylutės;3738277048;Ne;0;0;3;3
8170;Puriena;Zylutės;7562458336;Ne;0;0;4;4
8171;Puriena;Zylutės;3579008577;Ne;0;10;0;10
8172;Puriena;Zylutės;7477278612;Ne;0;5;0;5
8173;Puriena;Zylutės;9847768390;Ne;0;3;0;3
8174;Puriena;Zylutės;9150157724;Ne;0;0;3;3
8175;Puriena;Meškučių;6234132927;Ne;12;2;4;18
8176;Puriena;Meškučių;4563681164;Ne;2;2;0;4
8177;Puriena;Meškučių;3153330970;Ne;0;2;0;2
8178;Puriena;Meškučių;9500729561;Ne;0;2;0;2
8179;Puriena;Meškučių;1238475246;Ne;0;2;2;4
8180;Puriena;Meškučių;5591189546;Ne;0;2;1;3
8181;Puriena;Meškučių;9748726934;Ne;7;0;5;12
8182;Puriena;Meškučių;7466163131;Ne;2;0;3;5
8183;Puriena;Meškučių;2466609635;Ne;0;0;5;5
8184;Puriena;Meškučių;3309219271;Ne;0;4;0;4
8185;Puriena;Meškučių;9509041179;Ne;0;0;2;2
8186;Puriena;Meškučių;5176663365;Ne;0;3;0;3
8187;Puriena;Meškučių;9961074983;Ne;2;0;0;2
8188;Puriena;Meškučių;3011629747;Ne;7;2;2;11
8189;Puriena;Meškučių;2029981617;Ne;2;4;3;9
8190;Puriena;Meškučių;6185080390;Ne;0;0;4;4
8191;Puriena;Meškučių;3526684967;Ne;1;2;4;7
8192;Puriena;Meškučių;1513909923;Ne;13;0;4;17
8193;Puriena;Meškučių;7556975480;Ne;8;0;5;13
8194;Puriena;Meškučių;2711642252;Ne;5;0;2;7
8195;Puriena;Meškučių;8093664167;Ne;6;0;2;8
8196;Puriena;Nykštukų;1053386081;Ne;5;1;3;9
8197;Puriena;Nykštukų;5469827031;Taip;9;0;4;13
8198;Puriena;Nykštukų;7649596096;Taip;9;0;5;14
8199;Puriena;Nykštukų;2762325241;Ne;7;11;4;22
8200;Puriena;Nykštukų;9907142348;Ne;9;0;4;13
8201;Puriena;Nykštukų;9369786639;Ne;2;0;1;3
8202;Puriena;Nykštukų;2344061847;Ne;0;3;0;3
8203;Puriena;Nykštukų;3630564604;Ne;7;6;2;15
8204;Puriena;Nykštukų;9438604106;Ne;3;0;4;7
8205;Puriena;Nykštukų;9379314578;Ne;13;0;2;15
8206;Puriena;Nykštukų;4211784186;Ne;11;0;4;15
8207;Puriena;Nykštukų;2146727759;Ne;6;2;2;10
8208;Puriena;Nykštukų;1988826809;Ne;0;1;0;1
8209;Puriena;Nykštukų;6605817147;Ne;3;0;4;7
8210;Puriena;Nykštukų;6271951373;Ne;11;1;2;14
8211;Puriena;Nykštukų;7869104640;Ne;0;7;0;7
8212;Puriena;Nykštukų;9931397038;Ne;7;1;4;12
8213;Puriena;Nykštukų;9497287421;Ne;8;1;2;11
8214;Puriena;Nykštukų;4006267650;Ne;8;5;2;15
8215;Puriena;Nykštukų;5277351784;Ne;0;2;0;2
8216;Puriena;Nykštukų;3215364967;Ne;1;3;4;8
8217;Puriena;Ežiukai;6451492815;Ne;1;2;3;6
8218;Puriena;Ežiukai;7913847170;Ne;10;1;2;13
8219;Puriena;Ežiukai;8089081251;Ne;8;12;2;22
8220;Puriena;Ežiukai;2830409862;Ne;0;11;0;11
8221;Puriena;Ežiukai;5550321808;Ne;5;2;2;9
8222;Puriena;Ežiukai;8038573068;Ne;2;3;4;9
8223;Puriena;Ežiukai;2624283930;Ne;0;7;0;7
8224;Puriena;Ežiukai;6001659356;Ne;6;2;2;10
8225;Puriena;Ežiukai;5539708916;Ne;8;0;2;10
8226;Puriena;Ežiukai;7335537384;Ne;4;0;4;8
8227;Puriena;Ežiukai;3204824116;Ne;9;0;2;11
8228;Puriena;Ežiukai;7720549981;Ne;15;0;2;17
8229;Puriena;Ežiukai;5555076926;Ne;15;0;3;18
8230;Puriena;Ežiukai;2312297583;Ne;6;0;4;10
8231;Puriena;Ežiukai;3232981406;Ne;17;0;0;17
8232;Puriena;Ežiukai;9228372078;Ne;10;5;7;22
8233;Puriena;Ežiukai;5374864513;Ne;10;0;4;14
8234;Puriena;Ežiukai;1737249860;Ne;0;8;0;8
8235;Puriena;Ežiukai;4608801156;Ne;0;4;0;4
8236;Puriena;Ežiukai;6991740430;Ne;0;1;1;2
8237;Puriena;"Boružiukų ";9600515308;Taip;10;1;2;13
8238;Puriena;"Boružiukų ";7985332838;Ne;0;22;0;22
8239;Puriena;"Boružiukų ";2818282875;Ne;3;3;2;8
8240;Puriena;"Boružiukų ";1796123753;Ne;9;0;2;11
8241;Puriena;"Boružiukų ";9489913940;Ne;8;5;4;17
8242;Puriena;"Boružiukų ";7350776605;Ne;0;8;2;10
8243;Puriena;"Boružiukų ";3521550682;Ne;4;0;0;4
8244;Puriena;"Boružiukų ";7554505121;Ne;13;0;4;17
8245;Puriena;"Boružiukų ";9728603155;Ne;3;1;4;8
8246;Puriena;"Boružiukų ";1453976004;Ne;3;2;2;7
8247;Puriena;"Boružiukų ";9402161115;Ne;8;4;2;14
8248;Puriena;"Boružiukų ";6966564224;Ne;12;0;4;16
8249;Puriena;"Boružiukų ";3888242345;Ne;13;0;4;17
8250;Puriena;"Boružiukų ";9085439508;Ne;8;0;4;12
8251;Puriena;"Boružiukų ";4139839679;Ne;1;0;4;5
8252;Puriena;"Zuikučių ";6549867740;Ne;3;2;2;7
8253;Puriena;"Zuikučių ";9102891844;Ne;8;0;3;11
8254;Puriena;"Zuikučių ";4946887007;Ne;0;22;0;22
8255;Puriena;"Zuikučių ";8607005504;Ne;0;0;1;1
8256;Puriena;"Zuikučių ";9553026735;Ne;8;0;3;11
8257;Puriena;"Zuikučių ";5257520238;Ne;7;0;4;11
8258;Puriena;"Zuikučių ";4549244705;Ne;5;0;2;7
8259;Puriena;"Zuikučių ";4102059769;Ne;0;22;0;22
8260;Puriena;"Zuikučių ";4257334383;Ne;0;1;0;1
8261;Puriena;"Zuikučių ";2736255661;Ne;1;0;2;3
8262;Puriena;"Zuikučių ";4363865643;Ne;3;0;2;5
8263;Puriena;"Zuikučių ";6084041374;Ne;5;1;2;8
8264;Puriena;"Zuikučių ";1877494111;Ne;6;0;2;8
8265;Puriena;"Zuikučių ";3510157302;Ne;0;22;0;22
8266;Puriena;Skruzdėliukai;9729644429;Ne;0;0;1;1
8267;Puriena;Skruzdėliukai;3826282438;Taip;4;2;4;10
8268;Puriena;Skruzdėliukai;4283608124;Ne;0;4;0;4
8269;Puriena;Skruzdėliukai;8144488922;Ne;0;2;4;6
8270;Puriena;Skruzdėliukai;8476986855;Ne;0;6;0;6
8271;Puriena;Skruzdėliukai;3627403517;Ne;0;9;0;9
8272;Puriena;Skruzdėliukai;8130975863;Ne;0;2;0;2
8273;Puriena;Skruzdėliukai;6140294839;Ne;22;0;0;22
8274;Puriena;Skruzdėliukai;2813562677;Ne;0;2;0;2
8275;Puriena;Skruzdėliukai;9453994213;Ne;0;2;0;2
8276;Puriena;Skruzdėliukai;7120683581;Ne;0;3;0;3
8277;Puriena;Skruzdėliukai;4653085762;Ne;5;9;2;16
8278;Puriena;Skruzdėliukai;3542374463;Ne;0;9;0;9
8279;Puriena;Skruzdėliukai;8497070167;Taip;14;2;2;18
8280;Puriena;Skruzdėliukai;4498919764;Ne;5;2;4;11
8281;Puriena;Skruzdėliukai;1933733714;Taip;0;3;0;3
8282;Puriena;Skruzdėliukai;4517020977;Ne;0;3;0;3
8283;Puriena;Skruzdėliukai;6150437624;Ne;0;4;0;4
8284;Puriena;Skruzdėliukai;3455291312;Ne;0;2;4;6
8285;Puriena;Skruzdėliukai;9911792407;Ne;8;1;4;13
8286;Puriena;Skruzdėliukai;6352605894;Ne;0;0;2;2
8287;Pušaitė;Kodėlčiukai;8702361596;Ne;0;1;0;1
8288;Pušaitė;Kodėlčiukai;3832434608;Ne;0;0;3;3
8289;Pušaitė;Kodėlčiukai;4838345510;Ne;0;0;1;1
8290;Pušaitė;Kodėlčiukai;7068451014;Ne;5;2;2;9
8291;Pušaitė;Kodėlčiukai;6275090953;Ne;0;3;1;4
8292;Pušaitė;Kodėlčiukai;8750774616;Ne;0;3;0;3
8293;Pušaitė;Kodėlčiukai;4198571222;Ne;0;5;1;6
8294;Pušaitė;Kodėlčiukai;4743105731;Ne;3;0;2;5
8295;Pušaitė;Kodėlčiukai;9391350218;Ne;0;6;0;6
8296;Pušaitė;Kodėlčiukai;9364887123;Ne;0;2;0;2
8297;Pušaitė;Kodėlčiukai;4326967247;Ne;3;0;2;5
8298;Pušaitė;Kodėlčiukai;5922053969;Ne;0;0;1;1
8299;Pušaitė;Kodėlčiukai;4473930703;Ne;0;3;1;4
8300;Pušaitė;Kodėlčiukai;4615270419;Ne;0;2;0;2
8301;Pušaitė;Kodėlčiukai;7117784038;Ne;3;3;3;9
8302;Pušaitė;Kodėlčiukai;8754286143;Ne;1;0;3;4
8303;Pušaitė;Kodėlčiukai;6186545163;Ne;2;4;2;8
8304;Pušaitė;Kodėlčiukai;3150144924;Ne;2;0;2;4
8305;Pušaitė;Kodėlčiukai;6189116357;Ne;20;0;2;22
8306;Pušaitė;Saulutės;5306237557;Ne;9;2;4;15
8307;Pušaitė;Saulutės;7480846917;Ne;0;22;0;22
8308;Pušaitė;Saulutės;8355083823;Ne;9;0;4;13
8309;Pušaitė;Saulutės;2543188867;Ne;7;0;2;9
8310;Pušaitė;Saulutės;8914668904;Ne;0;1;0;1
8311;Pušaitė;Saulutės;2396217546;Ne;0;4;2;6
8312;Pušaitė;Saulutės;3126709123;Ne;4;0;2;6
8313;Pušaitė;Saulutės;5469990058;Ne;5;0;8;13
8314;Pušaitė;Saulutės;1044902638;Ne;12;0;3;15
8315;Pušaitė;Saulutės;6784729764;Ne;0;22;0;22
8316;Pušaitė;Saulutės;6215522656;Ne;7;0;4;11
8317;Pušaitė;Saulutės;2675136958;Ne;6;1;2;9
8318;Pušaitė;Saulutės;6261355186;Ne;0;0;14;14
8319;Pušaitė;Saulutės;7888103890;Ne;0;0;14;14
8320;Pušaitė;Saulutės;6848340140;Ne;0;2;0;2
8321;Pušaitė;Zuikučiai;7291412329;Ne;7;0;4;11
8322;Pušaitė;Zuikučiai;8931688329;Ne;6;0;4;10
8323;Pušaitė;Zuikučiai;5981944481;Ne;10;0;2;12
8324;Pušaitė;Zuikučiai;4511258460;Ne;4;0;4;8
8325;Pušaitė;Zuikučiai;5422616450;Ne;0;1;0;1
8326;Pušaitė;Zuikučiai;5819186055;Ne;0;0;4;4
8327;Pušaitė;Zuikučiai;9577925438;Ne;8;2;2;12
8328;Pušaitė;Zuikučiai;4234318548;Ne;5;2;2;9
8329;Pušaitė;Zuikučiai;1384820994;Ne;12;0;4;16
8330;Pušaitė;Zuikučiai;7237345427;Ne;0;0;1;1
8331;Pušaitė;Zuikučiai;9180309936;Ne;8;0;2;10
8332;Pušaitė;Zuikučiai;4754791489;Ne;5;0;2;7
8333;Pušaitė;Zuikučiai;4082173648;Ne;0;5;4;9
8334;Pušaitė;Zuikučiai;2264047794;Ne;2;3;3;8
8335;Pušaitė;Zuikučiai;3052743933;Ne;0;22;0;22
8336;Pušaitė;Zuikučiai;4278699624;Ne;4;2;4;10
8337;Pušaitė;Zuikučiai;8244793037;Ne;3;1;7;11
8338;Pušaitė;Zuikučiai;5002710062;Taip;0;12;1;13
8339;Pušaitė;Zuikučiai;3508664946;Ne;6;1;2;9
8340;Pušaitė;Zuikučiai;2887576870;Ne;10;0;4;14
8341;Pušaitė;Zuikučiai;1180343204;Ne;0;13;3;16
8342;Pušaitė;Vėžliukai;8412276797;Ne;2;0;4;6
8343;Pušaitė;Vėžliukai;1326581025;Ne;3;10;2;15
8344;Pušaitė;Vėžliukai;8135552679;Ne;7;0;3;10
8345;Pušaitė;Vėžliukai;5161142520;Ne;0;0;1;1
8346;Pušaitė;Vėžliukai;3485234259;Ne;3;0;2;5
8347;Pušaitė;Vėžliukai;3014867515;Ne;1;4;2;7
8348;Pušaitė;Vėžliukai;9414554800;Ne;3;4;2;9
8349;Pušaitė;Vėžliukai;9470667227;Ne;0;4;2;6
8350;Pušaitė;Vėžliukai;6739253961;Ne;0;10;0;10
8351;Pušaitė;Vėžliukai;3014180020;Ne;1;0;2;3
8352;Pušaitė;Vėžliukai;7890577174;Ne;3;2;2;7
8353;Pušaitė;Vėžliukai;7652706756;Ne;0;2;0;2
8354;Pušaitė;Vėžliukai;5318602924;Ne;0;8;0;8
8355;Pušaitė;Vėžliukai;6794867560;Ne;0;7;0;7
8356;Pušaitė;Vėžliukai;5296435012;Ne;0;0;4;4
8357;Pušaitė;Vėžliukai;6833083982;Ne;0;0;1;1
8358;Pušaitė;Vėžliukai;5512786073;Ne;4;9;2;15
8359;Pušaitė;Vėžliukai;8399589954;Ne;3;6;2;11
8360;Pušaitė;Vėžliukai;4281125486;Ne;2;0;5;7
8361;Pušaitė;Vėžliukai;2777222076;Ne;3;4;2;9
8362;Pušaitė;"Linksmieji nykštukai";9265357004;Ne;0;6;0;6
8363;Pušaitė;"Linksmieji nykštukai";7520393710;Ne;0;1;0;1
8364;Pušaitė;"Linksmieji nykštukai";4517181474;Ne;0;2;0;2
8365;Pušaitė;"Linksmieji nykštukai";9033615485;Ne;3;6;2;11
8366;Pušaitė;"Linksmieji nykštukai";3130824742;Ne;0;4;0;4
8367;Pušaitė;"Linksmieji nykštukai";1024996364;Ne;0;2;2;4
8368;Pušaitė;"Linksmieji nykštukai";4662871524;Ne;0;2;0;2
8369;Pušaitė;"Linksmieji nykštukai";8438652029;Ne;0;1;2;3
8370;Pušaitė;"Linksmieji nykštukai";6578483902;Ne;10;2;4;16
8371;Pušaitė;"Linksmieji nykštukai";3350461304;Ne;3;4;2;9
8372;Pušaitė;"Linksmieji nykštukai";9327636862;Ne;0;3;0;3
8373;Pušaitė;"Linksmieji nykštukai";4175909754;Ne;7;2;6;15
8374;Pušaitė;"Linksmieji nykštukai";3788392895;Ne;7;4;2;13
8375;Pušaitė;"Linksmieji nykštukai";3195191374;Ne;0;1;0;1
8376;Pušaitė;"Linksmieji nykštukai";9127444013;Ne;0;3;0;3
8377;Pušaitė;"Linksmieji nykštukai";5422784898;Ne;0;4;1;5
8378;Pušaitė;"Linksmieji nykštukai";5104111840;Ne;9;0;2;11
8379;Pušaitė;"Linksmieji nykštukai";9866431097;Ne;0;4;2;6
8380;Pušaitė;"Linksmieji nykštukai";4374232593;Ne;3;4;4;11
8381;Pušaitė;"Linksmieji nykštukai";8378313810;Ne;2;2;2;6
8382;Pušaitė;"Kačiukų trobelė";3695016765;Ne;3;1;3;7
8383;Pušaitė;"Kačiukų trobelė";5415680731;Ne;3;2;2;7
8384;Pušaitė;"Kačiukų trobelė";7983115812;Ne;0;7;0;7
8385;Pušaitė;"Kačiukų trobelė";7614475216;Ne;0;5;0;5
8386;Pušaitė;"Kačiukų trobelė";1122112207;Ne;1;6;2;9
8387;Pušaitė;"Kačiukų trobelė";1635528919;Ne;0;2;1;3
8388;Pušaitė;"Kačiukų trobelė";2837439334;Ne;6;0;2;8
8389;Pušaitė;"Kačiukų trobelė";7014914682;Ne;0;3;0;3
8390;Pušaitė;"Kačiukų trobelė";8793102437;Ne;0;11;0;11
8391;Pušaitė;"Kačiukų trobelė";9056933586;Ne;11;2;2;15
8392;Pušaitė;"Kačiukų trobelė";7898355721;Ne;8;0;2;10
8393;Pušaitė;"Kačiukų trobelė";6323180798;Ne;2;0;2;4
8394;Pušaitė;"Kačiukų trobelė";1161519408;Ne;0;2;0;2
8395;Pušaitė;"Kačiukų trobelė";8822285103;Ne;0;2;0;2
8396;Pušaitė;"Kačiukų trobelė";9313564235;Ne;8;4;2;14
8397;Pušaitė;"Kačiukų trobelė";2430891944;Ne;4;0;2;6
8398;Pušaitė;"Kačiukų trobelė";1978339054;Ne;0;2;0;2
8399;Pušaitė;"Kačiukų trobelė";5461822909;Ne;6;4;2;12
8400;Pušaitė;Ežiukai;5013833636;Ne;0;1;0;1
8401;Pušaitė;Ežiukai;6742576615;Ne;0;0;1;1
8402;Pušaitė;Ežiukai;3732377309;Ne;1;0;2;3
8403;Pušaitė;Ežiukai;6511940816;Ne;0;0;7;7
8404;Pušaitė;Ežiukai;9546541248;Ne;0;0;1;1
8405;Pušaitė;Ežiukai;4769806128;Ne;0;1;1;2
8406;Pušaitė;Ežiukai;4529006786;Ne;4;0;2;6
8407;Pušaitė;Ežiukai;5270528758;Ne;0;0;1;1
8408;Pušaitė;Ežiukai;6767281906;Ne;0;1;0;1
8409;Pušaitė;Ežiukai;7210529114;Ne;0;2;0;2
8410;Pušaitė;Ežiukai;9164927041;Ne;0;22;0;22
8411;Pušaitė;Ežiukai;9867041220;Ne;5;5;2;12
8412;Pušaitė;Ežiukai;9031289300;Ne;0;0;3;3
8413;Pušaitė;Ežiukai;2758026755;Ne;0;1;0;1
8414;Pušaitė;Ežiukai;6059415475;Ne;0;0;7;7
8415;Pušaitė;Ežiukai;7737524017;Ne;3;0;2;5
8416;Pušaitė;Ežiukai;1069369636;Ne;0;8;0;8
8417;Pušaitė;Ežiukai;2454348536;Ne;1;0;8;9
8418;Pušaitė;Ežiukai;4883211957;Ne;1;0;2;3
8419;Pušaitė;"Gudručių šalis";8763667682;Ne;2;0;2;4
8420;Pušaitė;"Gudručių šalis";2321256048;Ne;1;2;3;6
8421;Pušaitė;"Gudručių šalis";5488507646;Ne;0;2;3;5
8422;Pušaitė;"Gudručių šalis";1305526154;Ne;1;2;2;5
8423;Pušaitė;"Gudručių šalis";6205900423;Ne;0;22;0;22
8424;Pušaitė;"Gudručių šalis";2078734161;Ne;0;0;2;2
8425;Pušaitė;"Gudručių šalis";8790959900;Ne;0;2;2;4
8426;Pušaitė;"Gudručių šalis";2397106198;Ne;0;2;0;2
8427;Pušaitė;"Gudručių šalis";3694667637;Ne;11;0;4;15
8428;Pušaitė;"Gudručių šalis";8343949011;Ne;1;0;3;4
8429;Pušaitė;"Gudručių šalis";4101285889;Ne;2;1;4;7
8430;Pušaitė;"Gudručių šalis";3959838346;Ne;7;0;4;11
8431;Pušaitė;"Gudručių šalis";5563772495;Ne;3;2;2;7
8432;Pušaitė;"Gudručių šalis";6356263503;Ne;2;0;4;6
8433;Pušaitė;"Gudručių šalis";4626055123;Taip;0;1;1;2
8434;Pušaitė;"Gudručių šalis";2333176054;Taip;3;0;3;6
8435;Pušaitė;"Gudručių šalis";7066207306;Ne;3;7;2;12
8436;Pušaitė;"Gudručių šalis";4918124423;Ne;0;1;4;5
8437;Pušaitė;"Gudručių šalis";6734504906;Ne;1;0;4;5
8438;Pušaitė;"Gudručių šalis";7992567219;Ne;0;0;2;2
8439;Pušaitė;"Lapučių mokyklėlė";9337726482;Ne;0;8;0;8
8440;Pušaitė;"Lapučių mokyklėlė";2666541612;Ne;0;4;0;4
8441;Pušaitė;"Lapučių mokyklėlė";8343225451;Ne;0;4;1;5
8442;Pušaitė;"Lapučių mokyklėlė";8218991320;Ne;0;1;0;1
8443;Pušaitė;"Lapučių mokyklėlė";1994898058;Ne;1;2;5;8
8444;Pušaitė;"Lapučių mokyklėlė";8551426938;Ne;6;1;2;9
8445;Pušaitė;"Lapučių mokyklėlė";4444972517;Ne;5;1;2;8
8446;Pušaitė;"Lapučių mokyklėlė";4138386134;Ne;1;3;4;8
8447;Pušaitė;"Lapučių mokyklėlė";4103149433;Ne;5;1;3;9
8448;Pušaitė;"Lapučių mokyklėlė";4747611989;Ne;0;1;1;2
8449;Pušaitė;"Lapučių mokyklėlė";3387165403;Ne;3;0;2;5
8450;Pušaitė;"Lapučių mokyklėlė";5339878948;Ne;0;9;0;9
8451;Pušaitė;"Lapučių mokyklėlė";3610256789;Ne;0;4;6;10
8452;Pušaitė;"Lapučių mokyklėlė";6576647982;Ne;8;1;4;13
8453;Pušaitė;"Lapučių mokyklėlė";1395577340;Ne;0;2;1;3
8454;Pušaitė;"Lapučių mokyklėlė";1534764228;Ne;0;2;0;2
8455;Pušaitė;"Lapučių mokyklėlė";5328083339;Ne;5;0;2;7
8456;Pušaitė;"Lapučių mokyklėlė";3200968850;Ne;0;10;0;10
8457;Pušaitė;"Lapučių mokyklėlė";5270684456;Ne;3;3;2;8
8458;Pušaitė;"VOVERIUKAI ";4420904389;Ne;0;22;0;22
8459;Pušaitė;"VOVERIUKAI ";1665030028;Ne;3;0;2;5
8460;Pušaitė;"VOVERIUKAI ";4818407739;Ne;0;0;1;1
8461;Pušaitė;"VOVERIUKAI ";8876092901;Ne;1;0;2;3
8462;Pušaitė;"VOVERIUKAI ";4767321724;Ne;16;0;2;18
8463;Pušaitė;"VOVERIUKAI ";1542239525;Ne;3;0;3;6
8464;Pušaitė;"VOVERIUKAI ";7971556404;Ne;1;1;4;6
8465;Pušaitė;"VOVERIUKAI ";6643741885;Ne;0;0;2;2
8466;Pušaitė;"VOVERIUKAI ";1439721280;Ne;5;0;3;8
8467;Pušaitė;"VOVERIUKAI ";8157849971;Ne;1;0;2;3
8468;Pušaitė;"VOVERIUKAI ";6891217457;Ne;8;0;4;12
8469;Pušaitė;"VOVERIUKAI ";6786313527;Ne;2;2;2;6
8470;Pušaitė;"VOVERIUKAI ";8967363762;Ne;0;22;0;22
8471;Pušaitė;"VOVERIUKAI ";2699657569;Ne;1;0;2;3
8472;Pušaitė;"VOVERIUKAI ";5191447724;Ne;6;0;4;10
8473;Pušaitė;MEŠKUČIAI;6754402783;Taip;4;3;2;9
8474;Pušaitė;MEŠKUČIAI;3239486674;Taip;0;0;1;1
8475;Pušaitė;MEŠKUČIAI;9339706754;Ne;3;1;2;6
8476;Pušaitė;MEŠKUČIAI;9418440677;Ne;0;1;0;1
8477;Pušaitė;MEŠKUČIAI;7426036114;Ne;5;0;6;11
8478;Pušaitė;MEŠKUČIAI;9887693476;Ne;3;4;2;9
8479;Pušaitė;MEŠKUČIAI;1034005054;Ne;9;0;9;18
8480;Pušaitė;MEŠKUČIAI;8720258818;Taip;0;2;0;2
8481;Pušaitė;MEŠKUČIAI;8916214448;Ne;0;2;2;4
8482;Pušaitė;MEŠKUČIAI;3238080908;Ne;7;2;2;11
8483;Pušaitė;MEŠKUČIAI;4331500545;Ne;8;1;2;11
8484;Pušaitė;MEŠKUČIAI;7278950473;Ne;0;2;0;2
8485;Pušaitė;MEŠKUČIAI;3994799424;Ne;1;0;15;16
8486;Pušaitė;MEŠKUČIAI;5686927118;Ne;0;22;0;22
8487;Pušaitė;PELIUKAI;9177861202;Ne;5;2;2;9
8488;Pušaitė;PELIUKAI;6645711171;Ne;11;4;0;15
8489;Pušaitė;PELIUKAI;2618038364;Ne;12;0;4;16
8490;Pušaitė;PELIUKAI;5112517007;Ne;1;3;2;6
8491;Pušaitė;PELIUKAI;9261546370;Ne;0;2;0;2
8492;Pušaitė;PELIUKAI;7285450755;Ne;0;0;2;2
8493;Pušaitė;PELIUKAI;7204853123;Ne;8;4;2;14
8494;Pušaitė;PELIUKAI;4802860079;Ne;10;1;4;15
8495;Pušaitė;PELIUKAI;2772351972;Ne;9;0;3;12
8496;Pušaitė;PELIUKAI;1450204608;Ne;0;22;0;22
8497;Pušaitė;PELIUKAI;7553389781;Ne;3;0;6;9
8498;Pušaitė;PELIUKAI;8273198870;Ne;8;2;2;12
8499;Pušaitė;PELIUKAI;3245931596;Ne;4;2;3;9
8500;"Pušynėlis (Miglos g. 53)";PUMPURĖLIAI;9465619945;Ne;5;2;2;9
8501;"Pušynėlis (Miglos g. 53)";PUMPURĖLIAI;4962270317;Ne;0;0;1;1
8502;"Pušynėlis (Miglos g. 53)";PUMPURĖLIAI;7689524787;Ne;4;0;5;9
8503;"Pušynėlis (Miglos g. 53)";PUMPURĖLIAI;1133655729;Ne;0;0;1;1
8504;"Pušynėlis (Miglos g. 53)";PUMPURĖLIAI;1517104634;Ne;5;0;2;7
8505;"Pušynėlis (Miglos g. 53)";PUMPURĖLIAI;1240222214;Ne;4;0;2;6
8506;"Pušynėlis (Miglos g. 53)";PUMPURĖLIAI;6414064067;Ne;0;4;0;4
8507;"Pušynėlis (Miglos g. 53)";PUMPURĖLIAI;8933840402;Ne;0;10;0;10
8508;"Pušynėlis (Miglos g. 53)";PUMPURĖLIAI;1439408620;Ne;18;2;2;22
8509;"Pušynėlis (Miglos g. 53)";PUMPURĖLIAI;7964828070;Ne;6;0;4;10
8510;"Pušynėlis (Miglos g. 53)";PUMPURĖLIAI;3682719098;Ne;0;0;4;4
8511;"Pušynėlis (Miglos g. 53)";PUMPURĖLIAI;4449613959;Ne;13;0;9;22
8512;"Pušynėlis (Miglos g. 53)";PUMPURĖLIAI;3125802067;Ne;5;2;7;14
8513;"Pušynėlis (Miglos g. 53)";PUMPURĖLIAI;1508282873;Ne;20;0;2;22
8514;"Pušynėlis (Miglos g. 53)";PUMPURĖLIAI;4603625624;Ne;0;2;2;4
8515;"Pušynėlis (Miglos g. 53)";PUMPURĖLIAI;5488832089;Taip;6;0;4;10
8516;"Pušynėlis (Miglos g. 53)";PUMPURĖLIAI;5670094788;Ne;8;2;3;13
8517;"Pušynėlis (Miglos g. 53)";PUMPURĖLIAI;5264481173;Ne;6;2;3;11
8518;"Pušynėlis (Miglos g. 53)";PUMPURĖLIAI;5038740377;Ne;0;2;0;2
8519;"Pušynėlis (Miglos g. 53)";PUMPURĖLIAI;6318952845;Ne;2;0;2;4
8520;"Pušynėlis (Miglos g. 53)";SAULUTĖS;5501281051;Ne;2;2;2;6
8521;"Pušynėlis (Miglos g. 53)";SAULUTĖS;2135996648;Ne;9;0;6;15
8522;"Pušynėlis (Miglos g. 53)";SAULUTĖS;9454407638;Ne;12;0;3;15
8523;"Pušynėlis (Miglos g. 53)";SAULUTĖS;5508064424;Ne;0;2;1;3
8524;"Pušynėlis (Miglos g. 53)";SAULUTĖS;5568838550;Ne;8;1;2;11
8525;"Pušynėlis (Miglos g. 53)";SAULUTĖS;2553444832;Ne;0;0;1;1
8526;"Pušynėlis (Miglos g. 53)";SAULUTĖS;2718421498;Ne;4;2;2;8
8527;"Pušynėlis (Miglos g. 53)";SAULUTĖS;2509111066;Ne;0;4;0;4
8528;"Pušynėlis (Miglos g. 53)";SAULUTĖS;8902047615;Ne;5;2;2;9
8529;"Pušynėlis (Miglos g. 53)";SAULUTĖS;3483639540;Ne;0;8;0;8
8530;"Pušynėlis (Miglos g. 53)";SAULUTĖS;2861000826;Ne;4;1;2;7
8531;"Pušynėlis (Miglos g. 53)";SAULUTĖS;3882064516;Ne;8;5;2;15
8532;"Pušynėlis (Miglos g. 53)";SAULUTĖS;9081582524;Ne;8;5;2;15
8533;"Pušynėlis (Miglos g. 53)";SAULUTĖS;9883505094;Ne;4;3;2;9
8534;"Pušynėlis (Miglos g. 53)";SAULUTĖS;4526807309;Ne;13;2;2;17
8535;"Pušynėlis (Miglos g. 53)";SAULUTĖS;7438923710;Ne;7;2;2;11
8536;"Pušynėlis (Miglos g. 53)";SAULUTĖS;6110878898;Ne;8;3;2;13
8537;"Pušynėlis (Miglos g. 53)";SAULUTĖS;8803766149;Ne;2;2;2;6
8538;"Pušynėlis (Miglos g. 53)";SAULUTĖS;8462742834;Ne;10;3;2;15
8539;"Pušynėlis (Miglos g. 53)";SAULUTĖS;6962705842;Ne;8;0;6;14
8540;"Pušynėlis (Miglos g. 53)";SAULUTĖS;2744665477;Ne;4;2;2;8
8541;"Pušynėlis (Miglos g. 53)";PRIEŠMOKYKLINĖ;4668634909;Ne;0;3;0;3
8542;"Pušynėlis (Miglos g. 53)";PRIEŠMOKYKLINĖ;4030500100;Ne;0;13;0;13
8543;"Pušynėlis (Miglos g. 53)";PRIEŠMOKYKLINĖ;8172450090;Ne;0;13;0;13
8544;"Pušynėlis (Miglos g. 53)";PRIEŠMOKYKLINĖ;3158789663;Ne;0;2;0;2
8545;"Pušynėlis (Miglos g. 53)";PRIEŠMOKYKLINĖ;9483417104;Ne;0;1;0;1
8546;"Pušynėlis (Miglos g. 53)";PRIEŠMOKYKLINĖ;1891728904;Ne;0;7;0;7
8547;"Pušynėlis (Miglos g. 53)";PRIEŠMOKYKLINĖ;1164201286;Ne;0;2;0;2
8548;"Pušynėlis (Miglos g. 53)";PRIEŠMOKYKLINĖ;2508640229;Ne;0;2;3;5
8549;"Pušynėlis (Miglos g. 53)";PRIEŠMOKYKLINĖ;1251787066;Ne;18;2;2;22
8550;"Pušynėlis (Miglos g. 53)";PRIEŠMOKYKLINĖ;5236219294;Ne;13;2;2;17
8551;"Pušynėlis (Miglos g. 53)";PRIEŠMOKYKLINĖ;6709692748;Ne;0;2;0;2
8552;"Pušynėlis (Miglos g. 53)";PRIEŠMOKYKLINĖ;8799095053;Ne;0;7;0;7
8553;"Pušynėlis (Miglos g. 53)";PRIEŠMOKYKLINĖ;5318223378;Ne;0;4;0;4
8554;"Pušynėlis (Miglos g. 53)";PRIEŠMOKYKLINĖ;4052132379;Ne;0;3;0;3
8555;"Pušynėlis (Miglos g. 53)";PRIEŠMOKYKLINĖ;3100230874;Ne;0;7;0;7
8556;"Pušynėlis (Miglos g. 53)";PRIEŠMOKYKLINĖ;7896617995;Ne;3;3;2;8
8557;"Pušynėlis (Miglos g. 53)";PRIEŠMOKYKLINĖ;5897839636;Ne;0;3;0;3
8558;"Pušynėlis (Miglos g. 53)";PRIEŠMOKYKLINĖ;1034336110;Ne;0;6;0;6
8559;"Pušynėlis (Miglos g. 53)";PRIEŠMOKYKLINĖ;3483007385;Ne;3;4;2;9
8560;"Pušynėlis (Miglos g. 53)";"TREPSIUKAI (2018.09)";4468698630;Ne;0;0;2;2
8561;"Pušynėlis (Miglos g. 53)";"TREPSIUKAI (2018.09)";7745507151;Ne;3;5;4;12
8562;"Pušynėlis (Miglos g. 53)";"TREPSIUKAI (2018.09)";8911046719;Ne;0;0;1;1
8563;"Pušynėlis (Miglos g. 53)";"TREPSIUKAI (2018.09)";8668256321;Ne;0;0;1;1
8564;"Pušynėlis (Miglos g. 53)";"TREPSIUKAI (2018.09)";4750005431;Ne;0;0;1;1
8565;"Pušynėlis (Miglos g. 53)";"TREPSIUKAI (2018.09)";5748126562;Ne;0;21;0;21
8566;"Pušynėlis (Miglos g. 53)";"TREPSIUKAI (2018.09)";7752614074;Ne;0;0;2;2
8567;"Pušynėlis (Miglos g. 53)";"TREPSIUKAI (2018.09)";1318218735;Ne;0;0;6;6
8568;"Pušynėlis (Miglos g. 53)";"TREPSIUKAI (2018.09)";5723212271;Ne;11;5;4;20
8569;"Pušynėlis (Miglos g. 53)";"TREPSIUKAI (2018.09)";5876903525;Ne;0;0;4;4
8570;Raktelis;LAŠIUKAI;4671391106;Ne;0;5;0;5
8571;Raktelis;LAŠIUKAI;9230053040;Ne;2;10;0;12
8572;Raktelis;LAŠIUKAI;9139322116;Ne;3;2;9;14
8573;Raktelis;LAŠIUKAI;6929358401;Ne;0;4;0;4
8574;Raktelis;LAŠIUKAI;4317705126;Ne;0;0;1;1
8575;Raktelis;LAŠIUKAI;2652125338;Ne;0;2;0;2
8576;Raktelis;LAŠIUKAI;5627179884;Ne;0;7;1;8
8577;Raktelis;LAŠIUKAI;4187804340;Taip;0;7;4;11
8578;Raktelis;LAŠIUKAI;9965855682;Ne;1;4;1;6
8579;Raktelis;LAŠIUKAI;7265543701;Ne;0;2;0;2
8580;Raktelis;LAŠIUKAI;4319176525;Ne;2;2;2;6
8581;Raktelis;LAŠIUKAI;5218387088;Ne;0;4;3;7
8582;Raktelis;LAŠIUKAI;5820028619;Ne;3;2;4;9
8583;Raktelis;LAŠIUKAI;5405322552;Ne;8;2;4;14
8584;Raktelis;LAŠIUKAI;3821849812;Ne;1;4;2;7
8585;Raktelis;LAŠIUKAI;4905982507;Ne;3;2;2;7
8586;Raktelis;LAŠIUKAI;7170546710;Ne;11;2;5;18
8587;Raktelis;LAŠIUKAI;9355380341;Ne;8;2;2;12
8588;Raktelis;LAŠIUKAI;9593639791;Ne;2;4;4;10
8589;Raktelis;LAŠIUKAI;1975411457;Ne;6;3;0;9
8590;Raktelis;LAŠIUKAI;6608224825;Ne;8;5;0;13
8591;Raktelis;LAŠIUKAI;6199212999;Ne;0;5;0;5
8592;Raktelis;LAŠIUKAI;1622504968;Ne;0;0;1;1
8593;Raktelis;LAŠIUKAI;9591285702;Ne;2;2;2;6
8594;Raktelis;BITUTĖS;3308623522;Ne;5;6;0;11
8595;Raktelis;BITUTĖS;4059286631;Ne;8;4;0;12
8596;Raktelis;BITUTĖS;5913060415;Ne;0;2;0;2
8597;Raktelis;BITUTĖS;6974263764;Ne;7;6;0;13
8598;Raktelis;BITUTĖS;6932820066;Ne;3;2;2;7
8599;Raktelis;BITUTĖS;2410682193;Ne;2;2;3;7
8600;Raktelis;BITUTĖS;5705825231;Ne;3;2;2;7
8601;Raktelis;BITUTĖS;4615337759;Ne;4;4;0;8
8602;Raktelis;BITUTĖS;4962251215;Ne;0;5;0;5
8603;Raktelis;BITUTĖS;8282429202;Ne;8;4;0;12
8604;Raktelis;BITUTĖS;7479542200;Ne;5;2;5;12
8605;Raktelis;BITUTĖS;6703168910;Ne;11;3;0;14
8606;Raktelis;BITUTĖS;1026592738;Ne;8;7;0;15
8607;Raktelis;BITUTĖS;7900644404;Ne;22;0;0;22
8608;Raktelis;BITUTĖS;6685891017;Ne;5;2;5;12
8609;Raktelis;BITUTĖS;3484991718;Ne;7;6;0;13
8610;Raktelis;BITUTĖS;6358227532;Ne;9;5;0;14
8611;Raktelis;BITUTĖS;9718355271;Ne;14;4;0;18
8612;Raktelis;BITUTĖS;8608093349;Ne;4;4;1;9
8613;Raktelis;BITUTĖS;6855863189;Ne;8;2;1;11
8614;Raktelis;BITUTĖS;7605822626;Ne;5;4;0;9
8615;Raktelis;BITUTĖS;9169797346;Ne;3;9;1;13
8616;Raktelis;BITUTĖS;2383174152;Ne;0;13;0;13
8617;Raktelis;BITUTĖS;7046291082;Ne;8;2;0;10
8618;Raktelis;BORUŽĖLĖS;7068061170;Ne;0;5;0;5
8619;Raktelis;BORUŽĖLĖS;2361477092;Ne;3;6;0;9
8620;Raktelis;BORUŽĖLĖS;4226277600;Ne;12;6;0;18
8621;Raktelis;BORUŽĖLĖS;2599670832;Ne;0;1;0;1
8622;Raktelis;BORUŽĖLĖS;1757601091;Ne;0;8;0;8
8623;Raktelis;BORUŽĖLĖS;5865484633;Ne;9;4;1;14
8624;Raktelis;BORUŽĖLĖS;4529213150;Ne;0;1;0;1
8625;Raktelis;BORUŽĖLĖS;4936637343;Ne;0;2;1;3
8626;Raktelis;BORUŽĖLĖS;4333191842;Ne;6;2;2;10
8627;Raktelis;BORUŽĖLĖS;9529797517;Ne;0;7;0;7
8628;Raktelis;BORUŽĖLĖS;4442395100;Ne;20;2;0;22
8629;Raktelis;BORUŽĖLĖS;5150954686;Ne;13;2;2;17
8630;Raktelis;BORUŽĖLĖS;3490428062;Ne;6;5;0;11
8631;Raktelis;BORUŽĖLĖS;5404673733;Ne;0;0;1;1
8632;Raktelis;BORUŽĖLĖS;1314972335;Ne;0;7;0;7
8633;Raktelis;BORUŽĖLĖS;3343352568;Ne;8;4;1;13
8634;Raktelis;BORUŽĖLĖS;2698820718;Ne;1;1;0;2
8635;Raktelis;BORUŽĖLĖS;7990626447;Ne;8;4;0;12
8636;Raktelis;BORUŽĖLĖS;7459272209;Ne;1;2;2;5
8637;Raktelis;BORUŽĖLĖS;5046450478;Taip;5;4;2;11
8638;Raktelis;BORUŽĖLĖS;1141447274;Ne;5;10;0;15
8639;Raktelis;BORUŽĖLĖS;5576511314;Ne;0;0;5;5
8640;Raktelis;BORUŽĖLĖS;9567582066;Ne;9;4;0;13
8641;Raktelis;BORUŽĖLĖS;3456093273;Ne;0;1;0;1
8642;Raktelis;BORUŽĖLĖS;8647112887;Ne;3;9;0;12
8643;Raktelis;KAČIUKAI;5270430511;Ne;11;3;0;14
8644;Raktelis;KAČIUKAI;4622683599;Ne;9;2;0;11
8645;Raktelis;KAČIUKAI;8600632097;Ne;0;3;0;3
8646;Raktelis;KAČIUKAI;7630501672;Ne;0;4;2;6
8647;Raktelis;KAČIUKAI;6007823584;Ne;5;2;1;8
8648;Raktelis;KAČIUKAI;3733786043;Ne;0;3;0;3
8649;Raktelis;KAČIUKAI;8456082594;Ne;0;2;0;2
8650;Raktelis;KAČIUKAI;4676213966;Taip;0;1;0;1
8651;Raktelis;KAČIUKAI;4631375439;Ne;0;8;0;8
8652;Raktelis;KAČIUKAI;6265489540;Ne;0;7;0;7
8653;Raktelis;KAČIUKAI;4160091258;Taip;10;4;1;15
8654;Raktelis;KAČIUKAI;3775306030;Ne;5;5;1;11
8655;Raktelis;KAČIUKAI;6550851582;Ne;0;1;0;1
8656;Raktelis;KAČIUKAI;4009105487;Ne;4;0;3;7
8657;Raktelis;KAČIUKAI;1843086151;Ne;8;4;2;14
8658;Raktelis;KAČIUKAI;2295251060;Ne;2;0;0;2
8659;Raktelis;KAČIUKAI;1983808547;Ne;5;0;2;7
8660;Raktelis;KAČIUKAI;5042538956;Ne;0;2;0;2
8661;Raktelis;KAČIUKAI;7260767942;Ne;8;0;2;10
8662;Raktelis;KAČIUKAI;1123693990;Ne;4;4;2;10
8663;Raktelis;KAČIUKAI;4979657165;Ne;0;3;0;3
8664;Raktelis;KAČIUKAI;2700148968;Ne;0;0;2;2
8665;Raktelis;KAČIUKAI;8767785444;Ne;0;3;0;3
8666;Raktelis;KIŠKUČIAI;1810732707;Ne;4;2;0;6
8667;Raktelis;KIŠKUČIAI;5293558630;Ne;5;0;3;8
8668;Raktelis;KIŠKUČIAI;6473692639;Ne;2;2;2;6
8669;Raktelis;KIŠKUČIAI;1668164327;Ne;2;2;2;6
8670;Raktelis;KIŠKUČIAI;1058482540;Ne;4;6;0;10
8671;Raktelis;KIŠKUČIAI;6222364306;Ne;9;0;0;9
8672;Raktelis;KIŠKUČIAI;6451056434;Ne;0;1;2;3
8673;Raktelis;KIŠKUČIAI;1129962966;Ne;0;1;0;1
8674;Raktelis;KIŠKUČIAI;5213015670;Ne;9;0;2;11
8675;Raktelis;KIŠKUČIAI;7931502610;Ne;0;4;3;7
8676;Raktelis;KIŠKUČIAI;2976675359;Ne;10;10;0;20
8677;Raktelis;KIŠKUČIAI;9203811388;Ne;15;0;0;15
8678;Raktelis;KIŠKUČIAI;1511932941;Ne;8;0;2;10
8679;Raktelis;KIŠKUČIAI;5053933317;Ne;8;0;4;12
8680;Raktelis;KIŠKUČIAI;1664533959;Taip;8;4;0;12
8681;Raktelis;NYKŠTUKAI;7865593006;Ne;0;0;1;1
8682;Raktelis;NYKŠTUKAI;4252867688;Ne;0;0;2;2
8683;Raktelis;NYKŠTUKAI;8817859592;Ne;6;0;4;10
8684;Raktelis;NYKŠTUKAI;4578445282;Ne;0;4;6;10
8685;Raktelis;NYKŠTUKAI;9164539135;Ne;5;4;5;14
8686;Raktelis;NYKŠTUKAI;4147382341;Ne;0;2;1;3
8687;Raktelis;NYKŠTUKAI;3968555691;Ne;0;3;0;3
8688;Raktelis;NYKŠTUKAI;8507551381;Ne;0;0;2;2
8689;Raktelis;NYKŠTUKAI;4764915486;Ne;0;0;2;2
8690;Raktelis;NYKŠTUKAI;2803146830;Ne;14;2;2;18
8691;Raktelis;NYKŠTUKAI;1002851704;Ne;5;2;0;7
8692;Raktelis;NYKŠTUKAI;7202523804;Ne;0;8;0;8
8693;Raktelis;NYKŠTUKAI;6718159439;Ne;5;7;0;12
8694;Raktelis;NYKŠTUKAI;7058612493;Ne;5;0;2;7
8695;Raktelis;NYKŠTUKAI;9390692206;Ne;16;2;0;18
8696;Raktelis;NYKŠTUKAI;8992797384;Ne;10;5;0;15
8697;Raktelis;NYKŠTUKAI;9803505110;Ne;4;4;1;9
8698;Raktelis;NYKŠTUKAI;6587878165;Ne;0;4;1;5
8699;Raktelis;NYKŠTUKAI;2262854947;Ne;10;2;0;12
8700;Raktelis;NYKŠTUKAI;2278227649;Ne;9;4;2;15
8701;Raktelis;NYKŠTUKAI;3493159224;Ne;13;0;4;17
8702;Raktelis;PELIUKAI;2044812301;Ne;0;5;0;5
8703;Raktelis;PELIUKAI;7389910330;Ne;3;2;0;5
8704;Raktelis;PELIUKAI;4834301832;Ne;3;2;0;5
8705;Raktelis;PELIUKAI;6346741475;Ne;0;9;0;9
8706;Raktelis;PELIUKAI;7117319827;Ne;0;4;1;5
8707;Raktelis;PELIUKAI;4100807708;Ne;5;2;0;7
8708;Raktelis;PELIUKAI;9778807678;Ne;6;6;0;12
8709;Raktelis;PELIUKAI;2928040174;Ne;12;2;2;16
8710;Raktelis;PELIUKAI;4139932945;Ne;14;2;2;18
8711;Raktelis;PELIUKAI;8581379659;Ne;5;2;2;9
8712;Raktelis;PELIUKAI;7892633426;Ne;0;0;1;1
8713;Raktelis;PELIUKAI;7847787737;Ne;3;1;3;7
8714;Raktelis;AGUONOS;9039234219;Ne;17;1;0;18
8715;Raktelis;AGUONOS;3811586185;Ne;0;4;0;4
8716;Raktelis;AGUONOS;1714731965;Taip;15;0;2;17
8717;Raktelis;AGUONOS;9666909207;Ne;0;2;0;2
8718;Raktelis;AGUONOS;9992920721;Taip;14;4;0;18
8719;Raktelis;AGUONOS;3373893685;Ne;0;1;0;1
8720;Raktelis;AGUONOS;6499798110;Ne;2;3;0;5
8721;Raktelis;AGUONOS;2949132578;Ne;0;1;0;1
8722;Raktelis;AGUONOS;4828942464;Ne;0;2;0;2
8723;Raktelis;AGUONOS;5686613002;Ne;2;4;2;8
8724;Raktelis;AGUONOS;5362472918;Ne;0;10;0;10
8725;Raktelis;AGUONOS;9205511475;Ne;7;0;6;13
8726;Raktelis;AGUONOS;1197236154;Ne;6;0;2;8
8727;Raktelis;AGUONOS;2666984428;Ne;3;2;1;6
8728;Raktelis;AGUONOS;6019423312;Ne;0;0;2;2
8729;Raktelis;AGUONOS;2550528342;Ne;0;0;3;3
8730;Raktelis;LAPIUKŲ;3517484891;Ne;4;8;0;12
8731;Raktelis;LAPIUKŲ;2731096860;Ne;5;0;2;7
8732;Raktelis;LAPIUKŲ;1263150004;Ne;7;4;0;11
8733;Raktelis;LAPIUKŲ;9497620710;Ne;2;0;0;2
8734;Raktelis;LAPIUKŲ;1120263625;Ne;12;2;1;15
8735;Raktelis;LAPIUKŲ;5688795147;Ne;2;4;0;6
8736;Raktelis;LAPIUKŲ;8035618134;Ne;4;2;2;8
8737;Raktelis;LAPIUKŲ;8146076115;Ne;4;2;2;8
8738;Raktelis;LAPIUKŲ;8700012974;Ne;4;0;3;7
8739;Raktelis;LAPIUKŲ;1445359221;Ne;8;2;0;10
8740;Raktelis;LAPIUKŲ;1604357851;Ne;8;2;0;10
8741;Raktelis;LAPIUKŲ;5758873229;Ne;6;4;0;10
8742;Raktelis;LAPIUKŲ;9599034285;Ne;5;4;0;9
8743;Raktelis;LAPIUKŲ;3311870918;Ne;1;5;0;6
8744;Raktelis;LAPIUKŲ;6826993779;Ne;1;4;0;5
8745;Raktelis;LAPIUKŲ;6393143566;Ne;0;9;0;9
8746;Raktelis;LAPIUKŲ;2141128125;Ne;10;0;2;12
8747;Raktelis;LAPIUKŲ;4502236264;Ne;9;2;2;13
8748;Raktelis;LAPIUKŲ;2301442262;Ne;5;0;1;6
8749;Raktelis;LAPIUKŲ;6853881405;Ne;2;9;0;11
8750;Raktelis;LAPIUKŲ;4513031164;Ne;6;0;6;12
8751;Raktelis;LAPIUKŲ;4014822452;Ne;11;2;0;13
8752;Raktelis;PELĖDŽIUKAI;4583377785;Ne;5;8;0;13
8753;Raktelis;PELĖDŽIUKAI;7962509432;Ne;0;5;0;5
8754;Raktelis;PELĖDŽIUKAI;9716191639;Ne;10;2;2;14
8755;Raktelis;PELĖDŽIUKAI;8869030487;Ne;4;0;4;8
8756;Raktelis;PELĖDŽIUKAI;1322912585;Ne;8;4;3;15
8757;Raktelis;PELĖDŽIUKAI;6877934219;Ne;2;4;1;7
8758;Raktelis;PELĖDŽIUKAI;9130613710;Ne;0;6;0;6
8759;Raktelis;PELĖDŽIUKAI;9151796053;Ne;3;1;3;7
8760;Raktelis;PELĖDŽIUKAI;8207675881;Ne;0;9;0;9
8761;Raktelis;PELĖDŽIUKAI;7869495911;Ne;7;2;0;9
8762;Raktelis;PELĖDŽIUKAI;5925441742;Ne;1;6;0;7
8763;Raktelis;PELĖDŽIUKAI;5082785025;Ne;5;8;0;13
8764;Raktelis;PELĖDŽIUKAI;7142823740;Ne;0;2;0;2
8765;Raktelis;PELĖDŽIUKAI;3395720463;Ne;0;12;0;12
8766;Raktelis;PELĖDŽIUKAI;2809458453;Ne;0;3;0;3
8767;Raktelis;PELĖDŽIUKAI;6894769625;Ne;13;3;1;17
8768;Raktelis;PELĖDŽIUKAI;5487606214;Ne;0;0;1;1
8769;Raktelis;PELĖDŽIUKAI;2967941870;Taip;0;5;0;5
8770;Raktelis;PELĖDŽIUKAI;7440866459;Ne;0;8;0;8
8771;Raktelis;PELĖDŽIUKAI;3884068578;Ne;0;2;0;2
8772;Raktelis;PELĖDŽIUKAI;4755892641;Ne;0;7;0;7
8773;Raktelis;MEŠKIUKAI;8851021346;Ne;10;2;0;12
8774;Raktelis;MEŠKIUKAI;4185763817;Ne;5;3;0;8
8775;Raktelis;MEŠKIUKAI;8341026400;Ne;0;2;1;3
8776;Raktelis;MEŠKIUKAI;2103900090;Ne;3;0;2;5
8777;Raktelis;MEŠKIUKAI;5718804414;Ne;7;0;2;9
8778;Raktelis;MEŠKIUKAI;6409457833;Ne;10;4;0;14
8779;Raktelis;MEŠKIUKAI;8515886073;Ne;0;0;4;4
8780;Raktelis;MEŠKIUKAI;1740426946;Ne;10;0;2;12
8781;Raktelis;MEŠKIUKAI;6992649778;Ne;5;5;0;10
8782;Raktelis;MEŠKIUKAI;1304479190;Ne;15;0;1;16
8783;Raktelis;MEŠKIUKAI;6391559356;Ne;0;2;0;2
8784;Raktelis;MEŠKIUKAI;5358970156;Ne;17;0;2;19
8785;Rasa;Nykštukai;5176175108;Ne;4;3;2;9
8786;Rasa;Nykštukai;3979273111;Ne;0;2;0;2
8787;Rasa;Nykštukai;4847544355;Ne;0;2;0;2
8788;Rasa;Nykštukai;9723040721;Ne;0;2;0;2
8789;Rasa;Nykštukai;1223962374;Ne;4;2;8;14
8790;Rasa;Nykštukai;3200377629;Ne;0;6;2;8
8791;Rasa;Nykštukai;1336291828;Ne;0;9;0;9
8792;Rasa;Nykštukai;5861229664;Ne;0;3;0;3
8793;Rasa;Nykštukai;1386880644;Ne;0;3;0;3
8794;Rasa;Nykštukai;7228037580;Ne;0;5;0;5
8795;Rasa;Nykštukai;2093263887;Ne;0;2;0;2
8796;Rasa;Nykštukai;2540124793;Ne;0;2;0;2
8797;Rasa;Nykštukai;5363748728;Ne;0;2;0;2
8798;Rasa;Nykštukai;2977737634;Ne;0;1;0;1
8799;Rasa;Nykštukai;7520665472;Ne;0;10;0;10
8800;Rasa;Nykštukai;7534306402;Ne;0;2;0;2
8801;Rasa;Nykštukai;3755794133;Ne;3;3;2;8
8802;Rasa;Nykštukai;8424049317;Ne;0;3;0;3
8803;Rasa;Nykštukai;2190948879;Ne;0;8;0;8
8804;Rasa;Nykštukai;4010262461;Ne;0;2;1;3
8805;Rasa;Nykštukai;8236464670;Ne;0;2;0;2
8806;Rasa;Nykštukai;6976298054;Ne;0;2;0;2
8807;Rasa;Nykštukai;2333938367;Ne;0;3;0;3
8808;Rasa;Meškiukai;8378755600;Ne;0;19;0;19
8809;Rasa;Meškiukai;3073804713;Ne;0;6;0;6
8810;Rasa;Meškiukai;8740659600;Ne;0;22;0;22
8811;Rasa;Meškiukai;4127921417;Ne;0;2;0;2
8812;Rasa;Meškiukai;7357915584;Ne;0;12;0;12
8813;Rasa;Meškiukai;8314522373;Ne;0;13;0;13
8814;Rasa;Meškiukai;3548008659;Ne;0;22;0;22
8815;Rasa;Meškiukai;3773600344;Ne;15;0;4;19
8816;Rasa;Meškiukai;2371282781;Ne;15;0;4;19
8817;Rasa;Meškiukai;2555108465;Ne;0;5;0;5
8818;Rasa;Meškiukai;1992726664;Taip;0;9;0;9
8819;Rasa;Meškiukai;7843789214;Ne;0;0;1;1
8820;Rasa;Meškiukai;5165588335;Ne;0;2;1;3
8821;Rasa;Meškiukai;7637404588;Ne;0;2;0;2
8822;Rasa;Meškiukai;7502435359;Ne;0;12;0;12
8823;Rasa;Meškiukai;6853285570;Ne;1;0;4;5
8824;Rasa;Meškiukai;8674133653;Ne;20;0;2;22
8825;Rasa;Meškiukai;2840437821;Ne;0;2;0;2
8826;Rasa;Sauliukai;3657956842;Ne;5;4;2;11
8827;Rasa;Sauliukai;6891623055;Ne;4;6;2;12
8828;Rasa;Sauliukai;9010812748;Ne;0;2;0;2
8829;Rasa;Sauliukai;7220007488;Ne;7;2;4;13
8830;Rasa;Sauliukai;4498966097;Ne;6;2;2;10
8831;Rasa;Sauliukai;4734775151;Ne;5;6;2;13
8832;Rasa;Sauliukai;8235869241;Ne;0;3;0;3
8833;Rasa;Sauliukai;3428261829;Ne;0;3;0;3
8834;Rasa;Sauliukai;5426981046;Ne;0;8;0;8
8835;Rasa;Sauliukai;9220749889;Ne;0;3;0;3
8836;Rasa;Sauliukai;5885520521;Ne;3;0;2;5
8837;Rasa;Sauliukai;3631124501;Ne;2;2;2;6
8838;Rasa;Sauliukai;2477057223;Ne;0;2;0;2
8839;Rasa;Sauliukai;4913483444;Ne;0;7;0;7
8840;Rasa;Sauliukai;9343039995;Ne;0;2;0;2
8841;Rasa;Sauliukai;4758138905;Ne;1;2;2;5
8842;Rasa;Sauliukai;6411372006;Ne;13;2;4;19
8843;Rasa;Sauliukai;9157136735;Ne;0;13;0;13
8844;Rasa;Smalsučiai;9288967646;Ne;15;0;4;19
8845;Rasa;Smalsučiai;8350239611;Ne;14;0;4;18
8846;Rasa;Smalsučiai;3867443155;Ne;8;0;4;12
8847;Rasa;Smalsučiai;2480847070;Ne;10;0;4;14
8848;Rasa;Smalsučiai;4828855802;Ne;11;6;2;19
8849;Rasa;Smalsučiai;7250512345;Ne;8;0;4;12
8850;Rasa;Smalsučiai;8204386619;Ne;8;0;4;12
8851;Rasa;Smalsučiai;8888344226;Ne;0;3;3;6
8852;Rasa;Smalsučiai;1683652129;Ne;9;0;4;13
8853;Rasa;Smalsučiai;2368671762;Ne;3;1;2;6
8854;Rasa;Smalsučiai;7335907373;Ne;10;0;4;14
8855;Rasa;Smalsučiai;2647048529;Ne;7;1;4;12
8856;Rasa;Smalsučiai;7901163117;Ne;11;0;6;17
8857;Rasa;Smalsučiai;7389262967;Ne;8;1;4;13
8858;Rasa;"Pelėdžiukai ";3387615841;Ne;0;5;0;5
8859;Rasa;"Pelėdžiukai ";8455168346;Ne;5;0;5;10
8860;Rasa;"Pelėdžiukai ";9056416308;Ne;4;2;2;8
8861;Rasa;"Pelėdžiukai ";5141906920;Ne;0;7;0;7
8862;Rasa;"Pelėdžiukai ";3381468321;Ne;5;0;3;8
8863;Rasa;"Pelėdžiukai ";1261868339;Ne;0;2;3;5
8864;Rasa;"Pelėdžiukai ";6553479199;Ne;1;2;4;7
8865;Rasa;"Pelėdžiukai ";4947382314;Ne;8;2;3;13
8866;Rasa;"Pelėdžiukai ";2968464121;Ne;3;2;4;9
8867;Rasa;"Pelėdžiukai ";5816940902;Taip;0;2;4;6
8868;Rasa;"Pelėdžiukai ";8403268732;Ne;1;2;3;6
8869;Rasa;"Pelėdžiukai ";4855210006;Ne;5;2;4;11
8870;Rasa;"Pelėdžiukai ";4661651050;Ne;4;1;4;9
8871;Rasa;"Pelėdžiukai ";4453855861;Ne;3;0;3;6
8872;Rasa;"Pelėdžiukai ";4234198467;Ne;10;0;4;14
8873;Rasa;"Pelėdžiukai ";6874601830;Ne;6;6;5;17
8874;Rasa;"Pelėdžiukai ";8841534992;Ne;0;1;0;1
8875;Rasa;Katinėliai;8622210603;Ne;0;6;0;6
8876;Rasa;Katinėliai;8574946856;Ne;3;3;2;8
8877;Rasa;Katinėliai;1477018184;Ne;0;1;6;7
8878;Rasa;Katinėliai;1521328997;Ne;0;2;1;3
8879;Rasa;Katinėliai;4018241056;Ne;6;2;3;11
8880;Rasa;Katinėliai;7568880413;Ne;0;0;2;2
8881;Rasa;Katinėliai;4762348187;Ne;0;0;2;2
8882;Rasa;Katinėliai;3884782148;Ne;0;2;0;2
8883;Rasa;Katinėliai;9230334839;Taip;1;0;2;3
8884;Rasa;Katinėliai;4979105526;Ne;3;2;2;7
8885;Rasa;Katinėliai;6755131948;Ne;0;1;1;2
8886;Rasa;Katinėliai;6442933249;Ne;0;2;1;3
8887;Rasa;Katinėliai;1736903037;Ne;0;2;7;9
8888;Rasa;Katinėliai;6656230158;Ne;5;0;5;10
8889;Rasa;Katinėliai;7029860782;Ne;0;1;4;5
8890;Rasa;Katinėliai;6640475278;Ne;0;0;4;4
8891;Rasa;Katinėliai;6856440701;Ne;0;22;0;22
8892;Rasa;Katinėliai;1263070686;Ne;0;4;2;6
8893;Rasa;Katinėliai;5370449148;Ne;0;0;1;1
8894;Rasa;Ančiukai;5260636074;Ne;8;0;2;10
8895;Rasa;Ančiukai;3898763654;Ne;8;0;12;20
8896;Rasa;Ančiukai;4427497247;Ne;12;0;6;18
8897;Rasa;Ančiukai;5128743872;Ne;6;0;6;12
8898;Rasa;Ančiukai;6044145252;Ne;0;3;0;3
8899;Rasa;Ančiukai;5407988663;Ne;12;0;3;15
8900;Rasa;Ančiukai;2683337738;Ne;0;0;3;3
8901;Rasa;Ančiukai;5580054434;Ne;7;0;15;22
8902;Rasa;Ančiukai;9392162542;Ne;13;2;4;19
8903;Rasa;Ančiukai;3559964630;Ne;0;17;0;17
8904;Rasa;Ančiukai;6403716333;Ne;3;3;2;8
8905;Rasa;Ančiukai;3569945230;Ne;0;2;12;14
8906;Rasa;Ančiukai;4872698495;Ne;1;0;2;3
8907;Rasa;Ančiukai;8159424999;Ne;1;0;2;3
8908;Rasa;"Vyturiukai ";7028605422;Ne;2;3;2;7
8909;Rasa;"Vyturiukai ";9599510902;Ne;0;1;0;1
8910;Rasa;"Vyturiukai ";5869253167;Ne;0;10;1;11
8911;Rasa;"Vyturiukai ";7037958994;Ne;3;2;2;7
8912;Rasa;"Vyturiukai ";8236785255;Ne;3;3;2;8
8913;Rasa;"Vyturiukai ";6887471189;Ne;0;1;0;1
8914;Rasa;"Vyturiukai ";2347639286;Ne;0;2;0;2
8915;Rasa;"Vyturiukai ";1206005039;Ne;0;2;0;2
8916;Rasa;"Vyturiukai ";9788282861;Ne;5;2;5;12
8917;Rasa;"Vyturiukai ";2711923397;Ne;1;1;2;4
8918;Rasa;"Vyturiukai ";2769096357;Ne;6;0;6;12
8919;Rasa;"Vyturiukai ";6883073764;Ne;0;2;2;4
8920;Rasa;"Vyturiukai ";9706428782;Ne;2;7;2;11
8921;Rasa;"Vyturiukai ";6575864256;Ne;6;0;4;10
8922;Rasa;"Vyturiukai ";8296425777;Ne;0;2;0;2
8923;Rasa;"Vyturiukai ";7284349651;Ne;1;0;5;6
8924;Rasa;"Vyturiukai ";7265752821;Ne;1;0;5;6
8925;Rasa;"Vyturiukai ";5686873929;Ne;0;1;6;7
8926;Rasa;Voveriukai;4111850024;Ne;7;2;4;13
8927;Rasa;Voveriukai;1978999728;Ne;0;0;2;2
8928;Rasa;Voveriukai;3546684695;Ne;0;4;0;4
8929;Rasa;Voveriukai;5977524939;Ne;0;1;5;6
8930;Rasa;Voveriukai;1592174114;Taip;2;2;3;7
8931;Rasa;Voveriukai;1564194649;Ne;0;0;2;2
8932;Rasa;Voveriukai;1764959761;Ne;8;1;5;14
8933;Rasa;Voveriukai;1765617605;Ne;0;3;0;3
8934;Rasa;Voveriukai;1733179752;Ne;0;3;0;3
8935;Rasa;Voveriukai;2895124729;Ne;3;4;4;11
8936;Rasa;Voveriukai;8469342353;Ne;0;1;0;1
8937;Rasa;Voveriukai;5622110823;Ne;0;3;0;3
8938;Rasa;Voveriukai;6221754830;Ne;0;2;0;2
8939;Rasa;Voveriukai;7218250981;Ne;4;4;2;10
8940;Rasa;Voveriukai;7152769140;Ne;0;2;3;5
8941;Rasa;Voveriukai;1167373091;Taip;0;3;0;3
8942;Rasa;Voveriukai;2699865274;Taip;0;3;0;3
8943;Rasa;"DRUGELIAI ";6621628020;Ne;3;1;4;8
8944;Rasa;"DRUGELIAI ";9959160342;Ne;3;1;4;8
8945;Rasa;"DRUGELIAI ";5761013588;Taip;0;8;1;9
8946;Rasa;"DRUGELIAI ";7220103314;Ne;0;1;2;3
8947;Rasa;"DRUGELIAI ";9506388242;Ne;0;12;2;14
8948;Rasa;"DRUGELIAI ";4188303400;Ne;1;0;5;6
8949;Rasa;"DRUGELIAI ";5483943978;Ne;0;3;0;3
8950;Rasa;"DRUGELIAI ";7251815682;Ne;8;0;4;12
8951;Rasa;"DRUGELIAI ";8702962863;Ne;0;1;0;1
8952;Rasa;"DRUGELIAI ";6291089659;Taip;0;6;0;6
8953;Rasa;"DRUGELIAI ";1575522555;Ne;12;1;4;17
8954;Rasa;"DRUGELIAI ";1610581364;Ne;7;0;4;11
8955;Rasa;"DRUGELIAI ";2881055956;Ne;7;7;2;16
8956;Rasa;"DRUGELIAI ";3113010641;Ne;0;0;7;7
8957;Rasa;"DRUGELIAI ";9938323938;Ne;0;0;1;1
8958;Rasa;Zuikučiai;8027532547;Ne;0;9;0;9
8959;Rasa;Zuikučiai;3470054190;Ne;8;0;5;13
8960;Rasa;Zuikučiai;8180141204;Ne;3;0;2;5
8961;Rasa;Zuikučiai;7253736220;Ne;0;4;1;5
8962;Rasa;Zuikučiai;4940758709;Ne;0;3;0;3
8963;Rasa;Zuikučiai;7091899236;Ne;12;2;2;16
8964;Rasa;Zuikučiai;6574998939;Ne;3;5;2;10
8965;Rasa;Zuikučiai;4212798846;Ne;0;7;0;7
8966;Rasa;Zuikučiai;6505001743;Ne;11;2;4;17
8967;Rasa;Zuikučiai;6780996150;Taip;1;0;4;5
8968;Rasa;Zuikučiai;8159411349;Ne;3;4;2;9
8969;Rasa;Zuikučiai;8992548689;Ne;0;4;0;4
8970;Rasa;Zuikučiai;1983112873;Ne;0;1;0;1
8971;Rasa;Zuikučiai;6650473677;Ne;4;0;3;7
8972;Rasa;Zuikučiai;4508356130;Ne;0;4;2;6
8973;Rasa;Zuikučiai;8503010505;Ne;6;1;4;11
8974;Rasa;Zuikučiai;1843058886;Ne;0;10;0;10
8975;Rasa;Zuikučiai;2935957834;Ne;0;9;0;9
8976;Rasa;Širdelė;3668598028;Ne;0;7;0;7
8977;Rasa;Širdelė;9560289781;Ne;0;1;0;1
8978;Rasa;Širdelė;5719253028;Ne;5;0;2;7
8979;Rasa;Širdelė;5710220699;Ne;0;1;0;1
8980;Rasa;Širdelė;4694382836;Ne;0;1;2;3
8981;Rasa;Širdelė;1796573723;Ne;1;1;2;4
8982;Rasa;Širdelė;3535655117;Ne;0;2;2;4
8983;Rasa;Širdelė;2830296197;Ne;3;2;2;7
8984;Rasa;Širdelė;4361959446;Ne;6;2;4;12
8985;Rasa;Širdelė;3215464914;Ne;0;2;0;2
8986;Rasa;Širdelė;6760723624;Ne;3;1;3;7
8987;Rasa;Širdelė;1447258806;Ne;0;0;3;3
8988;Rasa;Širdelė;1627996663;Ne;8;0;4;12
8989;Rasa;Širdelė;9884995175;Ne;0;0;4;4
8990;Rasa;Širdelė;3965976031;Ne;1;1;0;2
8991;Rasa;Širdelė;4982146852;Ne;1;1;2;4
8992;Rasa;Širdelė;4248042049;Ne;6;0;3;9
8993;Rasa;Širdelė;7604145882;Ne;0;1;2;3
8994;Rasa;Širdelė;9713743149;Ne;0;3;1;4
8995;Riešutėlis;Viščiukų;8413887888;Ne;4;1;3;8
8996;Riešutėlis;Viščiukų;7142412042;Ne;0;0;4;4
8997;Riešutėlis;Viščiukų;5659054276;Ne;0;4;0;4
8998;Riešutėlis;Viščiukų;7985174814;Ne;7;1;4;12
8999;Riešutėlis;Viščiukų;3508479107;Ne;3;6;2;11
9000;Riešutėlis;Viščiukų;6398881485;Ne;0;19;0;19
9001;Riešutėlis;Viščiukų;3040811647;Ne;0;3;0;3
9002;Riešutėlis;Viščiukų;3109659339;Ne;2;2;2;6
9003;Riešutėlis;Viščiukų;4554875389;Ne;8;3;2;13
9004;Riešutėlis;Viščiukų;4533005769;Ne;10;1;4;15
9005;Riešutėlis;Viščiukų;3883149010;Ne;3;0;2;5
9006;Riešutėlis;Viščiukų;9952450993;Ne;2;0;2;4
9007;Riešutėlis;Viščiukų;8049449033;Taip;3;1;4;8
9008;Riešutėlis;Viščiukų;1389302927;Ne;2;4;4;10
9009;Riešutėlis;Viščiukų;6105142818;Ne;1;1;2;4
9010;Riešutėlis;"Riešutėliai ";3800733442;Ne;3;0;2;5
9011;Riešutėlis;"Riešutėliai ";2117939721;Ne;6;6;4;16
9012;Riešutėlis;"Riešutėliai ";1343776985;Ne;4;0;2;6
9013;Riešutėlis;"Riešutėliai ";5915019363;Ne;6;4;2;12
9014;Riešutėlis;"Riešutėliai ";2207907790;Ne;0;2;2;4
9015;Riešutėlis;"Riešutėliai ";9699503472;Ne;2;0;7;9
9016;Riešutėlis;"Riešutėliai ";2098369052;Ne;8;0;3;11
9017;Riešutėlis;"Riešutėliai ";1426700414;Ne;5;0;4;9
9018;Riešutėlis;"Riešutėliai ";8539906445;Ne;0;1;0;1
9019;Riešutėlis;"Riešutėliai ";5873443383;Ne;6;0;4;10
9020;Riešutėlis;"Riešutėliai ";2301247729;Ne;0;5;0;5
9021;Riešutėlis;"Riešutėliai ";3602707130;Ne;0;3;0;3
9022;Riešutėlis;"Riešutėliai ";4293402095;Ne;6;2;4;12
9023;Riešutėlis;"Riešutėliai ";8917451081;Ne;11;0;2;13
9024;Riešutėlis;"Riešutėliai ";4698338374;Ne;3;3;2;8
9025;Riešutėlis;"Riešutėliai ";3345064565;Ne;10;0;4;14
9026;Riešutėlis;"Riešutėliai ";2560507294;Ne;0;0;2;2
9027;Riešutėlis;"Riešutėliai ";9078282526;Ne;5;1;2;8
9028;Riešutėlis;Ežiukai;5758442826;Ne;3;3;2;8
9029;Riešutėlis;Ežiukai;9888470246;Ne;3;3;2;8
9030;Riešutėlis;Ežiukai;6217500325;Ne;0;0;3;3
9031;Riešutėlis;Ežiukai;4042719626;Ne;6;0;4;10
9032;Riešutėlis;Ežiukai;1858791074;Ne;14;3;2;19
9033;Riešutėlis;Ežiukai;3759837057;Ne;12;1;0;13
9034;Riešutėlis;Ežiukai;3249196007;Ne;0;0;2;2
9035;Riešutėlis;Ežiukai;4740516426;Ne;3;0;2;5
9036;Riešutėlis;Ežiukai;5078051087;Ne;8;2;2;12
9037;Riešutėlis;Ežiukai;3150141050;Ne;2;2;2;6
9038;Riešutėlis;Ežiukai;6580050526;Ne;0;1;2;3
9039;Riešutėlis;Ežiukai;4810919435;Ne;0;1;3;4
9040;Riešutėlis;Ežiukai;2736824231;Ne;9;0;2;11
9041;Riešutėlis;Ežiukai;2378301886;Ne;9;1;2;12
9042;Riešutėlis;Ežiukai;2483793992;Ne;0;0;2;2
9043;Riešutėlis;Ežiukai;5262881964;Ne;0;0;6;6
9044;Riešutėlis;Ežiukai;4328166135;Ne;0;4;0;4
9045;Riešutėlis;Ežiukai;9052991215;Ne;0;4;0;4
9046;Riešutėlis;Ežiukai;6318150385;Ne;7;0;0;7
9047;Riešutėlis;Pelėdžiukai;1705599429;Ne;0;2;5;7
9048;Riešutėlis;Pelėdžiukai;4116506453;Ne;0;1;0;1
9049;Riešutėlis;Pelėdžiukai;2467739101;Ne;2;0;0;2
9050;Riešutėlis;Pelėdžiukai;2587460110;Ne;15;0;2;17
9051;Riešutėlis;Pelėdžiukai;6147780439;Ne;2;2;1;5
9052;Riešutėlis;Pelėdžiukai;3287685792;Ne;0;2;2;4
9053;Riešutėlis;Pelėdžiukai;1811701628;Ne;4;0;2;6
9054;Riešutėlis;Pelėdžiukai;5183264581;Ne;0;3;0;3
9055;Riešutėlis;Pelėdžiukai;6121386391;Ne;9;0;4;13
9056;Riešutėlis;Pelėdžiukai;3251066115;Ne;0;3;0;3
9057;Riešutėlis;Pelėdžiukai;4808684145;Ne;0;2;0;2
9058;Riešutėlis;Pelėdžiukai;4897581681;Ne;2;0;2;4
9059;Riešutėlis;Pelėdžiukai;7256075146;Ne;0;3;2;5
9060;Riešutėlis;Pelėdžiukai;5443448616;Ne;3;5;2;10
9061;Riešutėlis;Pelėdžiukai;9598824163;Ne;3;2;2;7
9062;Riešutėlis;Pelėdžiukai;8839482370;Ne;3;0;2;5
9063;Riešutėlis;Pelėdžiukai;4692384639;Ne;7;0;4;11
9064;Riešutėlis;Meškiukai;7030346495;Ne;0;9;0;9
9065;Riešutėlis;Meškiukai;9750713954;Ne;0;9;0;9
9066;Riešutėlis;Meškiukai;3577669231;Ne;9;4;3;16
9067;Riešutėlis;Meškiukai;8066712255;Ne;2;0;2;4
9068;Riešutėlis;Meškiukai;2837471235;Ne;0;2;8;10
9069;Riešutėlis;Meškiukai;2699984170;Ne;0;9;0;9
9070;Riešutėlis;Meškiukai;7601776182;Ne;3;4;4;11
9071;Riešutėlis;Meškiukai;7050440691;Ne;3;4;5;12
9072;Riešutėlis;Meškiukai;6259158270;Ne;0;2;3;5
9073;Riešutėlis;Meškiukai;7381623086;Ne;0;3;0;3
9074;Riešutėlis;Meškiukai;6284614328;Ne;0;22;0;22
9075;Riešutėlis;Meškiukai;9964688413;Ne;0;2;3;5
9076;Riešutėlis;Meškiukai;1548585448;Ne;0;2;0;2
9077;Riešutėlis;Meškiukai;5728858361;Ne;0;2;0;2
9078;Riešutėlis;Meškiukai;1818130297;Ne;0;2;0;2
9079;Riešutėlis;Meškiukai;8954127616;Ne;6;4;4;14
9080;Riešutėlis;Meškiukai;2092933906;Ne;0;9;0;9
9081;Riešutėlis;Meškiukai;6813024366;Ne;0;2;0;2
9082;Riešutėlis;Meškiukai;3460145784;Ne;0;1;0;1
9083;Riešutėlis;Meškiukai;8480059272;Ne;0;2;0;2
9084;Riešutėlis;Meškiukai;8751571852;Ne;4;1;5;10
9085;Riešutėlis;Kiškučiai;9297835044;Ne;1;0;2;3
9086;Riešutėlis;Kiškučiai;9086474785;Ne;5;0;4;9
9087;Riešutėlis;Kiškučiai;3363757821;Ne;3;3;2;8
9088;Riešutėlis;Kiškučiai;2581250615;Ne;3;0;2;5
9089;Riešutėlis;Kiškučiai;8445984114;Ne;13;0;4;17
9090;Riešutėlis;Kiškučiai;5266946070;Ne;2;0;2;4
9091;Riešutėlis;Kiškučiai;9357375649;Ne;5;3;2;10
9092;Riešutėlis;Kiškučiai;9500744921;Ne;8;0;4;12
9093;Riešutėlis;Kiškučiai;4851336076;Ne;3;0;2;5
9094;Riešutėlis;Kiškučiai;6705754238;Ne;9;2;3;14
9095;Riešutėlis;Kiškučiai;1111543507;Ne;3;2;3;8
9096;Riešutėlis;Kiškučiai;9964105252;Ne;3;0;2;5
9097;Riešutėlis;Kiškučiai;6693197006;Ne;13;0;4;17
9098;Riešutėlis;Kiškučiai;5846061115;Ne;1;0;0;1
9099;Riešutėlis;Kiškučiai;9995814717;Ne;7;0;4;11
9100;Riešutėlis;Kiškučiai;3165015754;Ne;4;0;7;11
9101;Riešutėlis;Kiškučiai;5738764214;Ne;1;0;0;1
9102;Riešutėlis;Kiškučiai;1494363200;Ne;13;0;3;16
9103;Riešutėlis;Voveriukų;9864636983;Ne;5;0;4;9
9104;Riešutėlis;Voveriukų;5662911204;Ne;1;2;2;5
9105;Riešutėlis;Voveriukų;7663823906;Ne;0;10;0;10
9106;Riešutėlis;Voveriukų;1282121190;Ne;5;3;2;10
9107;Riešutėlis;Voveriukų;5336618381;Ne;0;5;0;5
9108;Riešutėlis;Voveriukų;7327578507;Ne;4;0;2;6
9109;Riešutėlis;Voveriukų;6368610810;Ne;0;2;2;4
9110;Riešutėlis;Voveriukų;2875416610;Ne;8;2;2;12
9111;Riešutėlis;Voveriukų;7313602281;Ne;0;0;3;3
9112;Riešutėlis;Voveriukų;9296178632;Ne;0;2;1;3
9113;Riešutėlis;Voveriukų;6681930005;Ne;0;1;3;4
9114;Riešutėlis;Voveriukų;2352984379;Ne;3;0;2;5
9115;Riešutėlis;Voveriukų;3152100512;Ne;0;0;3;3
9116;Riešutėlis;Voveriukų;2238641969;Ne;1;0;2;3
9117;Riešutėlis;Voveriukų;1058206787;Ne;12;0;2;14
9118;Riešutėlis;Voveriukų;3340831522;Ne;22;0;0;22
9119;Riešutėlis;Saulutės;4004669930;Ne;3;2;3;8
9120;Riešutėlis;Saulutės;7177632315;Ne;0;1;0;1
9121;Riešutėlis;Saulutės;6721758785;Ne;4;4;2;10
9122;Riešutėlis;Saulutės;3694146893;Ne;0;2;0;2
9123;Riešutėlis;Saulutės;1748151109;Ne;6;5;2;13
9124;Riešutėlis;Saulutės;8504832383;Ne;2;0;2;4
9125;Riešutėlis;Saulutės;6292679662;Ne;2;0;2;4
9126;Riešutėlis;Saulutės;8738716660;Ne;0;4;4;8
9127;Riešutėlis;Saulutės;4828635362;Ne;0;1;0;1
9128;Riešutėlis;Saulutės;6635909614;Ne;0;2;0;2
9129;Riešutėlis;Saulutės;1196740726;Ne;18;2;2;22
9130;Riešutėlis;Saulutės;8415858895;Ne;0;1;4;5
9131;Riešutėlis;Saulutės;4498718519;Ne;0;1;0;1
9132;Riešutėlis;Saulutės;5753609922;Ne;6;3;5;14
9133;Riešutėlis;Saulutės;5013754772;Ne;11;0;4;15
9134;Riešutėlis;Saulutės;6468871352;Ne;2;1;0;3
9135;Riešutėlis;Saulutės;7154361660;Ne;0;7;3;10
9136;Riešutėlis;Saulutės;8677172126;Ne;1;0;3;4
9137;Riešutėlis;Saulutės;2572642260;Ne;1;0;0;1
9138;Riešutėlis;Saulutės;3544780386;Ne;5;0;2;7
9139;Riešutėlis;"Boruželės ";7666200219;Ne;0;9;0;9
9140;Riešutėlis;"Boruželės ";7071757771;Ne;0;0;1;1
9141;Riešutėlis;"Boruželės ";6626441225;Ne;0;0;3;3
9142;Riešutėlis;"Boruželės ";4426750525;Ne;0;0;2;2
9143;Riešutėlis;"Boruželės ";6906373822;Ne;2;1;2;5
9144;Riešutėlis;"Boruželės ";2734001106;Ne;0;0;2;2
9145;Riešutėlis;"Boruželės ";2493171003;Ne;4;0;6;10
9146;Riešutėlis;"Boruželės ";9341748384;Ne;0;0;1;1
9147;Riešutėlis;"Boruželės ";2235912189;Ne;0;0;2;2
9148;Riešutėlis;"Boruželės ";4429903561;Ne;2;0;0;2
9149;Riešutėlis;"Boruželės ";5317904812;Ne;0;3;0;3
9150;Riešutėlis;"Boruželės ";8235524536;Ne;0;1;1;2
9151;Riešutėlis;"Boruželės ";7795124495;Ne;0;0;3;3
9152;Riešutėlis;"Boruželės ";2832538856;Ne;0;5;2;7
9153;Riešutėlis;"Boruželės ";3730909181;Ne;0;11;0;11
9154;Riešutėlis;"Bitutės ";2498093110;Taip;0;2;0;2
9155;Riešutėlis;"Bitutės ";2459494071;Ne;0;0;1;1
9156;Riešutėlis;"Bitutės ";3931422170;Ne;0;4;8;12
9157;Riešutėlis;"Bitutės ";8265627960;Ne;0;2;0;2
9158;Riešutėlis;"Bitutės ";4591910912;Ne;6;2;2;10
9159;Riešutėlis;"Bitutės ";9285782325;Ne;0;1;0;1
9160;Riešutėlis;"Bitutės ";7473054556;Ne;0;1;0;1
9161;Riešutėlis;"Bitutės ";3592271009;Taip;3;1;4;8
9162;Riešutėlis;"Bitutės ";3348517050;Ne;0;4;0;4
9163;Riešutėlis;"Bitutės ";4358354602;Ne;3;3;7;13
9164;Riešutėlis;"Bitutės ";9903170301;Ne;0;12;4;16
9165;Riešutėlis;"Bitutės ";1842107341;Ne;7;7;4;18
9166;Riešutėlis;"Bitutės ";1033490929;Ne;0;2;0;2
9167;Riešutėlis;"Bitutės ";4211273525;Ne;0;0;2;2
9168;Riešutėlis;Drugelių;8266735624;Ne;0;2;0;2
9169;Riešutėlis;Drugelių;4776231497;Ne;0;2;0;2
9170;Riešutėlis;Drugelių;7769079730;Ne;0;3;0;3
9171;Riešutėlis;Drugelių;5811657782;Ne;0;0;1;1
9172;Riešutėlis;Drugelių;4221375847;Ne;0;2;0;2
9173;Riešutėlis;Drugelių;1075842434;Ne;0;3;0;3
9174;Riešutėlis;Drugelių;8845709386;Ne;0;4;2;6
9175;Riešutėlis;Drugelių;8352146446;Ne;5;2;2;9
9176;Riešutėlis;Drugelių;5412882446;Ne;0;2;2;4
9177;Riešutėlis;Drugelių;8020533200;Ne;0;2;2;4
9178;Riešutėlis;Drugelių;1164273595;Ne;7;2;4;13
9179;Riešutėlis;Drugelių;8918753084;Ne;0;2;0;2
9180;Riešutėlis;Drugelių;3836374000;Ne;0;1;0;1
9181;Riešutėlis;Drugelių;3071643137;Ne;0;4;0;4
9182;Riešutėlis;Drugelių;2599147931;Ne;1;3;2;6
9183;Riešutėlis;Drugelių;4845447863;Ne;4;0;2;6
9184;Riešutėlis;Drugelių;7225365172;Ne;4;4;2;10
9185;Riešutėlis;Nykštukų;3208422211;Ne;7;1;0;8
9186;Riešutėlis;Nykštukų;9445000826;Ne;0;0;1;1
9187;Riešutėlis;Nykštukų;2133207806;Ne;6;1;1;8
9188;Riešutėlis;Nykštukų;2965742701;Ne;0;1;0;1
9189;Riešutėlis;Nykštukų;8965323622;Ne;0;1;0;1
9190;Riešutėlis;Nykštukų;3304849985;Ne;0;0;2;2
9191;Riešutėlis;Nykštukų;4996921259;Ne;3;0;4;7
9192;Riešutėlis;Nykštukų;2380936705;Ne;1;1;3;5
9193;Riešutėlis;Nykštukų;1227857842;Ne;0;3;3;6
9194;Riešutėlis;Nykštukų;8857997445;Ne;5;15;2;22
9195;Riešutėlis;Nykštukų;5296617022;Ne;7;0;2;9
9196;Riešutėlis;Nykštukų;9445150366;Ne;0;2;0;2
9197;Riešutėlis;Nykštukų;9977733313;Ne;14;2;4;20
9198;Riešutėlis;Nykštukų;4746769566;Ne;4;0;2;6
9199;Riešutėlis;Nykštukų;9415334673;Ne;3;4;2;9
9200;Ramunėlė;SAULUTĖS;3852734401;Ne;0;1;0;1
9201;Ramunėlė;SAULUTĖS;1192743154;Ne;0;7;0;7
9202;Ramunėlė;SAULUTĖS;5714771643;Ne;3;4;2;9
9203;Ramunėlė;SAULUTĖS;1483391590;Ne;0;1;0;1
9204;Ramunėlė;SAULUTĖS;4209191105;Ne;0;4;0;4
9205;Ramunėlė;SAULUTĖS;9927068798;Ne;0;3;0;3
9206;Ramunėlė;SAULUTĖS;8929122197;Ne;2;0;2;4
9207;Ramunėlė;SAULUTĖS;7219400182;Ne;3;1;2;6
9208;Ramunėlė;SAULUTĖS;3779769727;Ne;0;5;0;5
9209;Ramunėlė;SAULUTĖS;5605444408;Ne;0;2;0;2
9210;Ramunėlė;SAULUTĖS;8912978935;Ne;0;3;0;3
9211;Ramunėlė;SAULUTĖS;9533155706;Ne;2;2;4;8
9212;Ramunėlė;SAULUTĖS;3109623760;Ne;2;2;5;9
9213;Ramunėlė;SAULUTĖS;6329943991;Ne;1;4;3;8
9214;Ramunėlė;SAULUTĖS;4677819736;Ne;9;0;8;17
9215;Ramunėlė;SAULUTĖS;6310921755;Ne;0;8;0;8
9216;Ramunėlė;SAULUTĖS;1568531299;Ne;4;2;2;8
9217;Ramunėlė;SAULUTĖS;4605161267;Ne;0;5;2;7
9218;Ramunėlė;SAULUTĖS;6931092874;Ne;6;0;2;8
9219;Ramunėlė;ŽIBUTĖ;4715809064;Ne;0;2;0;2
9220;Ramunėlė;ŽIBUTĖ;5315953299;Ne;2;0;2;4
9221;Ramunėlė;ŽIBUTĖ;2173425836;Ne;3;3;2;8
9222;Ramunėlė;ŽIBUTĖ;2686455030;Ne;3;3;2;8
9223;Ramunėlė;ŽIBUTĖ;5650659504;Ne;0;2;0;2
9224;Ramunėlė;ŽIBUTĖ;6627399830;Ne;2;2;3;7
9225;Ramunėlė;ŽIBUTĖ;8726443989;Ne;0;6;0;6
9226;Ramunėlė;ŽIBUTĖ;5801760033;Ne;0;1;0;1
9227;Ramunėlė;ŽIBUTĖ;6389008823;Ne;0;0;2;2
9228;Ramunėlė;ŽIBUTĖ;9136437288;Ne;3;2;3;8
9229;Ramunėlė;ŽIBUTĖ;6040461460;Ne;0;0;2;2
9230;Ramunėlė;ŽIBUTĖ;2605941371;Ne;0;3;0;3
9231;Ramunėlė;ŽIBUTĖ;7010828978;Ne;0;9;0;9
9232;Ramunėlė;ŽIBUTĖ;3879563193;Ne;0;10;0;10
9233;Ramunėlė;ŽIBUTĖ;2446375037;Ne;8;1;2;11
9234;Ramunėlė;ŽIBUTĖ;1671759939;Ne;0;2;0;2
9235;Ramunėlė;ŽIBUTĖ;6606802660;Ne;0;3;0;3
9236;Ramunėlė;ŽIBUTĖ;3525444906;Ne;0;6;0;6
9237;Ramunėlė;ŽIBUTĖ;8055844166;Ne;0;7;0;7
9238;Ramunėlė;ŽIRNIUKAI;7721421570;Ne;0;13;0;13
9239;Ramunėlė;ŽIRNIUKAI;8942483792;Ne;8;0;2;10
9240;Ramunėlė;ŽIRNIUKAI;6674467484;Ne;0;13;0;13
9241;Ramunėlė;ŽIRNIUKAI;7593855877;Ne;6;3;2;11
9242;Ramunėlė;ŽIRNIUKAI;2177200537;Ne;1;2;2;5
9243;Ramunėlė;ŽIRNIUKAI;7026935746;Ne;0;2;0;2
9244;Ramunėlė;ŽIRNIUKAI;5581693652;Ne;8;2;2;12
9245;Ramunėlė;ŽIRNIUKAI;4269170508;Ne;3;0;2;5
9246;Ramunėlė;ŽIRNIUKAI;7263195574;Ne;3;0;5;8
9247;Ramunėlė;ŽIRNIUKAI;4076525701;Ne;5;0;3;8
9248;Ramunėlė;ŽIRNIUKAI;4139935502;Ne;3;0;3;6
9249;Ramunėlė;ŽIRNIUKAI;1833069020;Ne;5;2;2;9
9250;Ramunėlė;ŽIRNIUKAI;4875011312;Ne;4;2;3;9
9251;Ramunėlė;ŽIRNIUKAI;4084046207;Ne;4;3;2;9
9252;Ramunėlė;ŽIRNIUKAI;2276657044;Ne;2;0;4;6
9253;Ramunėlė;ŽIRNIUKAI;5017020616;Ne;0;3;0;3
9254;Ramunėlė;ŽIRNIUKAI;6458458913;Ne;2;8;2;12
9255;Ramunėlė;ŽIRNIUKAI;6225605784;Ne;5;0;4;9
9256;Ramunėlė;ŽIRNIUKAI;4805808663;Ne;0;6;0;6
9257;Ramunėlė;ŽIRNIUKAI;7250951221;Ne;3;2;2;7
9258;Ramunėlė;BITUTĖS;5865482869;Taip;7;2;7;16
9259;Ramunėlė;BITUTĖS;7692958269;Ne;3;2;5;10
9260;Ramunėlė;BITUTĖS;1182350830;Ne;2;0;3;5
9261;Ramunėlė;BITUTĖS;6342801407;Ne;0;0;3;3
9262;Ramunėlė;BITUTĖS;4022818032;Ne;0;10;2;12
9263;Ramunėlė;BITUTĖS;1916520056;Taip;0;15;0;15
9264;Ramunėlė;BITUTĖS;6892481929;Ne;8;2;2;12
9265;Ramunėlė;BITUTĖS;6881228078;Taip;0;16;0;16
9266;Ramunėlė;BITUTĖS;9326288662;Ne;0;3;0;3
9267;Ramunėlė;BITUTĖS;3045477012;Ne;8;2;2;12
9268;Ramunėlė;BITUTĖS;8643188779;Ne;0;10;0;10
9269;Ramunėlė;BITUTĖS;3106987206;Ne;0;2;0;2
9270;Ramunėlė;BITUTĖS;1797997937;Ne;15;0;2;17
9271;Ramunėlė;BITUTĖS;2281370785;Ne;0;2;0;2
9272;Ramunėlė;BITUTĖS;4329292281;Ne;0;2;0;2
9273;Ramunėlė;BITUTĖS;9928703066;Ne;2;4;2;8
9274;Ramunėlė;BITUTĖS;4756689520;Ne;0;10;0;10
9275;Ramunėlė;BITUTĖS;3742982547;Ne;0;3;0;3
9276;Ramunėlė;DRUGELIAI;9984243153;Ne;2;3;2;7
9277;Ramunėlė;DRUGELIAI;4392309015;Ne;8;3;2;13
9278;Ramunėlė;DRUGELIAI;5049415445;Ne;8;2;2;12
9279;Ramunėlė;DRUGELIAI;8460527225;Ne;8;2;2;12
9280;Ramunėlė;DRUGELIAI;6809164145;Ne;3;2;2;7
9281;Ramunėlė;DRUGELIAI;6981729247;Ne;3;3;2;8
9282;Ramunėlė;DRUGELIAI;3683181174;Ne;6;0;2;8
9283;Ramunėlė;DRUGELIAI;7364976547;Ne;9;0;4;13
9284;Ramunėlė;DRUGELIAI;6156792400;Ne;0;7;0;7
9285;Ramunėlė;DRUGELIAI;2983986428;Ne;3;4;2;9
9286;Ramunėlė;DRUGELIAI;5548358138;Ne;3;1;2;6
9287;Ramunėlė;DRUGELIAI;2427399083;Ne;7;1;2;10
9288;Ramunėlė;DRUGELIAI;8623311748;Ne;0;9;0;9
9289;Ramunėlė;DRUGELIAI;6849205606;Ne;4;0;5;9
9290;Ramunėlė;DRUGELIAI;2422656007;Ne;2;7;3;12
9291;Ramunėlė;DRUGELIAI;7829765488;Ne;0;1;0;1
9292;Ramunėlė;DRUGELIAI;5153948802;Ne;8;2;2;12
9293;Ramunėlė;DRUGELIAI;4233978236;Ne;0;11;2;13
9294;Ramunėlė;DRUGELIAI;2558296296;Ne;7;2;4;13
9295;Ramunėlė;DRUGELIAI;4400154355;Ne;5;2;2;9
9296;Ramunėlė;NEUŽMIRŠTUOLĖS;2070729684;Ne;0;7;0;7
9297;Ramunėlė;NEUŽMIRŠTUOLĖS;6613469006;Ne;0;10;0;10
9298;Ramunėlė;NEUŽMIRŠTUOLĖS;9012749913;Ne;8;14;0;22
9299;Ramunėlė;NEUŽMIRŠTUOLĖS;1728034615;Ne;17;4;0;21
9300;Ramunėlė;NEUŽMIRŠTUOLĖS;1579527330;Ne;0;24;0;24
9301;Ramunėlė;NEUŽMIRŠTUOLĖS;7519551613;Ne;0;9;0;9
9302;Ramunėlė;NEUŽMIRŠTUOLĖS;2880352109;Ne;13;2;2;17
9303;Ramunėlė;NEUŽMIRŠTUOLĖS;3949246652;Ne;10;0;2;12
9304;Ramunėlė;NEUŽMIRŠTUOLĖS;5267145991;Ne;5;12;0;17
9305;Ramunėlė;NEUŽMIRŠTUOLĖS;1181787182;Ne;14;0;2;16
9306;Ramunėlė;NEUŽMIRŠTUOLĖS;9374972014;Ne;5;0;2;7
9307;Ramunėlė;NEUŽMIRŠTUOLĖS;9028383128;Ne;5;23;0;28
9308;Ramunėlė;NEUŽMIRŠTUOLĖS;6849227110;Ne;0;7;0;7
9309;Ramunėlė;NEUŽMIRŠTUOLĖS;3792795591;Ne;0;12;0;12
9310;Ramunėlė;NEUŽMIRŠTUOLĖS;4862989594;Ne;12;2;2;16
9311;Ramunėlė;NEUŽMIRŠTUOLĖS;9758688249;Ne;0;16;0;16
9312;Ramunėlė;NEUŽMIRŠTUOLĖS;9945561827;Ne;11;2;4;17
9313;Ramunėlė;OBUOLIUKAI;6604244856;Ne;0;4;1;5
9314;Ramunėlė;OBUOLIUKAI;8617271247;Ne;4;4;2;10
9315;Ramunėlė;OBUOLIUKAI;6413888803;Ne;2;1;4;7
9316;Ramunėlė;OBUOLIUKAI;5610672420;Ne;0;1;0;1
9317;Ramunėlė;OBUOLIUKAI;9861069932;Ne;9;3;2;14
9318;Ramunėlė;OBUOLIUKAI;9420613324;Ne;0;1;0;1
9319;Ramunėlė;OBUOLIUKAI;7639613472;Ne;2;4;2;8
9320;Ramunėlė;OBUOLIUKAI;4040520907;Ne;0;0;3;3
9321;Ramunėlė;OBUOLIUKAI;5573083546;Ne;2;0;2;4
9322;Ramunėlė;OBUOLIUKAI;1215510902;Ne;8;6;2;16
9323;Ramunėlė;OBUOLIUKAI;8218201930;Ne;8;5;2;15
9324;Ramunėlė;OBUOLIUKAI;2760710235;Ne;0;2;1;3
9325;Ramunėlė;OBUOLIUKAI;4788062781;Ne;0;3;0;3
9326;Ramunėlė;OBUOLIUKAI;3166386231;Ne;0;10;0;10
9327;Ramunėlė;OBUOLIUKAI;4642590173;Ne;0;4;0;4
9328;Ramunėlė;OBUOLIUKAI;9549605315;Ne;3;0;2;5
9329;Ramunėlė;OBUOLIUKAI;1277413234;Ne;0;1;0;1
9330;Ramunėlė;SAULĖGRĄŽA;7836959157;Ne;2;0;1;3
9331;Ramunėlė;SAULĖGRĄŽA;2458101652;Ne;5;0;0;5
9332;Ramunėlė;SAULĖGRĄŽA;9663304288;Ne;3;0;2;5
9333;Ramunėlė;SAULĖGRĄŽA;5398069413;Ne;14;0;2;16
9334;Ramunėlė;SAULĖGRĄŽA;3793779715;Ne;0;1;0;1
9335;Ramunėlė;SAULĖGRĄŽA;6775947111;Ne;14;7;3;24
9336;Ramunėlė;SAULĖGRĄŽA;1102946363;Ne;5;0;4;9
9337;Ramunėlė;SAULĖGRĄŽA;3801952385;Ne;0;9;0;9
9338;Ramunėlė;SAULĖGRĄŽA;9120142666;Taip;14;0;2;16
9339;Ramunėlė;SAULĖGRĄŽA;6942789511;Ne;3;0;1;4
9340;Ramunėlė;SAULĖGRĄŽA;2415377154;Ne;0;3;3;6
9341;Ramunėlė;SAULĖGRĄŽA;9076692864;Ne;10;2;4;16
9342;Ramunėlė;SAULĖGRĄŽA;3744140961;Ne;8;1;2;11
9343;Ramunėlė;SAULĖGRĄŽA;4177116924;Ne;9;0;2;11
9344;Ramunėlė;SAULĖGRĄŽA;1071166494;Ne;6;1;2;9
9345;Ramunėlė;SAULĖGRĄŽA;9656732273;Ne;10;0;6;16
9346;Ramunėlė;SAULĖGRĄŽA;6983139076;Taip;3;0;5;8
9347;Ramunėlė;SAULĖGRĄŽA;8045080504;Ne;16;7;4;27
9348;Ramunėlė;SAULĖGRĄŽA;9127154444;Ne;0;2;0;2
9349;Ramunėlė;BORUŽĖLĖS;1818513881;Ne;6;2;4;12
9350;Ramunėlė;BORUŽĖLĖS;4581826404;Ne;0;0;2;2
9351;Ramunėlė;BORUŽĖLĖS;8310875815;Ne;0;4;0;4
9352;Ramunėlė;BORUŽĖLĖS;1491688322;Ne;2;4;2;8
9353;Ramunėlė;BORUŽĖLĖS;6606966969;Ne;0;6;0;6
9354;Ramunėlė;BORUŽĖLĖS;5703289545;Ne;2;0;2;4
9355;Ramunėlė;BORUŽĖLĖS;9292235402;Ne;2;0;4;6
9356;Ramunėlė;BORUŽĖLĖS;3996453947;Ne;0;3;0;3
9357;Ramunėlė;BORUŽĖLĖS;3461269451;Ne;3;3;2;8
9358;Ramunėlė;BORUŽĖLĖS;3474578046;Ne;8;2;2;12
9359;Ramunėlė;BORUŽĖLĖS;7544671346;Ne;0;3;0;3
9360;Ramunėlė;BORUŽĖLĖS;5544992493;Ne;0;1;0;1
9361;Ramunėlė;BORUŽĖLĖS;6433856416;Ne;0;5;0;5
9362;Ramunėlė;BORUŽĖLĖS;3542912372;Ne;4;6;6;16
9363;Ramunėlė;BORUŽĖLĖS;1159457001;Ne;0;1;0;1
9364;Ramunėlė;BORUŽĖLĖS;3735308599;Ne;0;2;0;2
9365;Ramunėlė;BORUŽĖLĖS;3272747656;Ne;1;3;2;6
9366;Ramunėlė;BORUŽĖLĖS;6347893013;Ne;2;0;0;2
9367;Ramunėlė;BORUŽĖLĖS;1811931985;Ne;0;2;0;2
9368;Ramunėlė;NYKŠTUKAS;7542328641;Ne;4;1;2;7
9369;Ramunėlė;NYKŠTUKAS;1802650607;Ne;4;2;2;8
9370;Ramunėlė;NYKŠTUKAS;7715458376;Ne;2;4;4;10
9371;Ramunėlė;NYKŠTUKAS;2874729290;Taip;0;3;1;4
9372;Ramunėlė;NYKŠTUKAS;1212737814;Ne;0;2;1;3
9373;Ramunėlė;NYKŠTUKAS;9304631431;Ne;14;0;3;17
9374;Ramunėlė;NYKŠTUKAS;5011852981;Ne;13;2;4;19
9375;Ramunėlė;NYKŠTUKAS;7049941095;Taip;3;2;4;9
9376;Ramunėlė;NYKŠTUKAS;7958270513;Ne;1;2;2;5
9377;Ramunėlė;NYKŠTUKAS;9005050527;Ne;1;2;2;5
9378;Ramunėlė;NYKŠTUKAS;2521516332;Ne;2;2;5;9
9379;Ramunėlė;NYKŠTUKAS;7248072779;Ne;3;2;2;7
9380;Ramunėlė;NYKŠTUKAS;6326882817;Ne;4;2;4;10
9381;Ramunėlė;NYKŠTUKAS;5087404382;Ne;0;4;1;5
9382;Ramunėlė;NYKŠTUKAS;6385345287;Ne;7;0;2;9
9383;Ramunėlė;UOGELĖ;2361409931;Ne;3;2;2;7
9384;Ramunėlė;UOGELĖ;9765904825;Ne;10;0;2;12
9385;Ramunėlė;UOGELĖ;5934414699;Ne;0;4;2;6
9386;Ramunėlė;UOGELĖ;3097478921;Ne;5;5;3;13
9387;Ramunėlė;UOGELĖ;1962502699;Ne;0;2;2;4
9388;Ramunėlė;UOGELĖ;2652236809;Ne;0;2;0;2
9389;Ramunėlė;UOGELĖ;9603368652;Ne;0;1;0;1
9390;Ramunėlė;UOGELĖ;5468189903;Ne;0;6;1;7
9391;Ramunėlė;UOGELĖ;9834640538;Ne;4;0;2;6
9392;Ramunėlė;UOGELĖ;3838004754;Ne;0;8;0;8
9393;Ramunėlė;UOGELĖ;3037286125;Ne;0;2;1;3
9394;Ramunėlė;UOGELĖ;5196627958;Ne;0;11;0;11
9395;Ramunėlė;UOGELĖ;8538153845;Ne;13;5;4;22
9396;Ramunėlė;VARPELIAI;8023404173;Ne;0;5;0;5
9397;Ramunėlė;VARPELIAI;7005354909;Ne;0;8;0;8
9398;Ramunėlė;VARPELIAI;5665429647;Ne;8;4;4;16
9399;Ramunėlė;VARPELIAI;4946797276;Ne;0;7;0;7
9400;Ramunėlė;VARPELIAI;9180197156;Ne;5;2;0;7
9401;Ramunėlė;VARPELIAI;5108864184;Ne;2;4;0;6
9402;Ramunėlė;VARPELIAI;4321527067;Ne;19;1;6;26
9403;Ramunėlė;VARPELIAI;2202879286;Ne;0;3;0;3
9404;Ramunėlė;VARPELIAI;1666033483;Ne;5;2;0;7
9405;Ramunėlė;VARPELIAI;7896711579;Ne;0;10;2;12
9406;Ramunėlė;VARPELIAI;9994601365;Ne;8;7;2;17
9407;Ramunėlė;VARPELIAI;2620747378;Ne;16;0;5;21
9408;Ramunėlė;VARPELIAI;5726947811;Ne;0;7;0;7
9409;Ramunėlė;VARPELIAI;4171905362;Ne;5;11;0;16
9410;Ramunėlė;VARPELIAI;8764042799;Ne;6;2;0;8
9411;Ramunėlė;VARPELIAI;7926168752;Ne;13;0;3;16
9412;Ramunėlė;VARPELIAI;5498856861;Ne;7;0;4;11
9413;Ramunėlė;VARPELIAI;3024065664;Ne;10;5;2;17
9414;Ramunėlė;VARPELIAI;4397072823;Ne;20;0;4;24
9415;Ramunėlė;VARPELIAI;3793699824;Ne;3;6;2;11
9416;Rūta;SMALSUČIAI;2601011765;Ne;9;0;6;15
9417;Rūta;SMALSUČIAI;5902965224;Ne;5;2;2;9
9418;Rūta;SMALSUČIAI;5579794648;Ne;10;4;2;16
9419;Rūta;SMALSUČIAI;9471291067;Ne;8;5;2;15
9420;Rūta;SMALSUČIAI;4165080541;Ne;7;0;3;10
9421;Rūta;SMALSUČIAI;8012225409;Ne;8;0;4;12
9422;Rūta;SMALSUČIAI;3877807687;Taip;4;0;7;11
9423;Rūta;SMALSUČIAI;8483916287;Ne;5;2;2;9
9424;Rūta;SMALSUČIAI;1290867375;Ne;6;5;7;18
9425;Rūta;SMALSUČIAI;4780828296;Ne;1;0;4;5
9426;Rūta;SMALSUČIAI;2084935094;Ne;2;0;8;10
9427;Rūta;SMALSUČIAI;2830990163;Ne;0;0;3;3
9428;Rūta;SMALSUČIAI;7724451685;Ne;5;0;2;7
9429;Rūta;SMALSUČIAI;8320791295;Ne;6;2;5;13
9430;Rūta;SMALSUČIAI;2733932207;Taip;7;7;2;16
9431;Rūta;SMALSUČIAI;3498596516;Ne;8;0;4;12
9432;Rūta;KŪLVERSTUKAI;5002760763;Ne;2;0;4;6
9433;Rūta;KŪLVERSTUKAI;1059126758;Ne;0;7;1;8
9434;Rūta;KŪLVERSTUKAI;6417693659;Ne;2;2;3;7
9435;Rūta;KŪLVERSTUKAI;3352007694;Ne;2;0;4;6
9436;Rūta;KŪLVERSTUKAI;4466522924;Ne;5;2;5;12
9437;Rūta;KŪLVERSTUKAI;7905893575;Ne;2;2;3;7
9438;Rūta;KŪLVERSTUKAI;4776631890;Ne;3;0;3;6
9439;Rūta;KŪLVERSTUKAI;4436482805;Ne;0;1;0;1
9440;Rūta;KŪLVERSTUKAI;1260386759;Ne;0;3;0;3
9441;Rūta;KŪLVERSTUKAI;8935780480;Ne;2;0;2;4
9442;Rūta;KŪLVERSTUKAI;4208678278;Ne;5;2;4;11
9443;Rūta;KŪLVERSTUKAI;6044060646;Ne;0;4;0;4
9444;Rūta;KŪLVERSTUKAI;1671179652;Ne;3;2;2;7
9445;Rūta;KŪLVERSTUKAI;9012256437;Ne;0;0;1;1
9446;Rūta;KŪLVERSTUKAI;1152453609;Ne;1;1;5;7
9447;Rūta;KŪLVERSTUKAI;3081348981;Ne;0;0;1;1
9448;Rūta;KODĖLČIUKAI;5962981130;Ne;1;0;4;5
9449;Rūta;KODĖLČIUKAI;4347678781;Ne;3;0;2;5
9450;Rūta;KODĖLČIUKAI;3736279705;Ne;10;0;4;14
9451;Rūta;KODĖLČIUKAI;8668510009;Ne;0;0;3;3
9452;Rūta;KODĖLČIUKAI;2547849837;Ne;2;0;3;5
9453;Rūta;KODĖLČIUKAI;9501101073;Ne;10;0;5;15
9454;Rūta;KODĖLČIUKAI;8883578144;Ne;0;0;3;3
9455;Rūta;KODĖLČIUKAI;4546082355;Ne;0;4;0;4
9456;Rūta;KODĖLČIUKAI;1000645885;Ne;10;0;2;12
9457;Rūta;KODĖLČIUKAI;5766392854;Ne;1;3;2;6
9458;Rūta;KODĖLČIUKAI;4944413811;Ne;0;0;2;2
9459;Rūta;KODĖLČIUKAI;9916296056;Ne;2;0;0;2
9460;Rūta;KODĖLČIUKAI;1605412505;Ne;2;0;4;6
9461;Rūta;KODĖLČIUKAI;4533816630;Ne;3;5;2;10
9462;Rūta;KODĖLČIUKAI;8455941633;Ne;0;0;2;2
9463;Rūta;KODĖLČIUKAI;8120157087;Ne;2;0;6;8
9464;Rūta;BORUŽĖLĖS;7712500278;Ne;3;4;2;9
9465;Rūta;BORUŽĖLĖS;3898579878;Ne;8;0;2;10
9466;Rūta;BORUŽĖLĖS;8945868791;Ne;6;0;12;18
9467;Rūta;BORUŽĖLĖS;3348066709;Ne;2;2;2;6
9468;Rūta;BORUŽĖLĖS;5141290453;Ne;0;0;3;3
9469;Rūta;BORUŽĖLĖS;8303314520;Ne;3;0;2;5
9470;Rūta;BORUŽĖLĖS;3470052541;Ne;8;3;3;14
9471;Rūta;BORUŽĖLĖS;2625691851;Ne;12;0;2;14
9472;Rūta;BORUŽĖLĖS;1804222979;Ne;5;0;4;9
9473;Rūta;BORUŽĖLĖS;5624054621;Ne;3;0;2;5
9474;Rūta;BORUŽĖLĖS;2724625200;Ne;0;0;4;4
9475;Rūta;BORUŽĖLĖS;2118244290;Ne;5;1;2;8
9476;Rūta;BORUŽĖLĖS;2492891254;Ne;8;0;7;15
9477;Rūta;BORUŽĖLĖS;4204930257;Ne;0;1;2;3
9478;Rūta;VYTURĖLIAI;7680605199;Ne;0;3;0;3
9479;Rūta;VYTURĖLIAI;6075632046;Ne;2;1;2;5
9480;Rūta;VYTURĖLIAI;9386595365;Ne;0;2;0;2
9481;Rūta;VYTURĖLIAI;7649756034;Ne;7;2;4;13
9482;Rūta;VYTURĖLIAI;5899860543;Ne;6;2;2;10
9483;Rūta;VYTURĖLIAI;1346124133;Ne;3;2;2;7
9484;Rūta;VYTURĖLIAI;4728904136;Ne;1;2;2;5
9485;Rūta;VYTURĖLIAI;9791861646;Ne;3;3;2;8
9486;Rūta;VYTURĖLIAI;2928803089;Ne;0;2;4;6
9487;Rūta;VYTURĖLIAI;8378318357;Ne;0;2;0;2
9488;Rūta;VYTURĖLIAI;1951202550;Ne;0;1;1;2
9489;Rūta;VYTURĖLIAI;3875136625;Ne;2;1;2;5
9490;Rūta;VYTURĖLIAI;4962272621;Ne;0;0;1;1
9491;Rūta;VYTURĖLIAI;9911151238;Ne;0;2;3;5
9492;Rūta;VYTURĖLIAI;7434152435;Ne;0;1;0;1
9493;Rūta;VYTURĖLIAI;1035527190;Ne;3;2;2;7
9494;Rūta;VYTURĖLIAI;3843325181;Ne;2;2;3;7
9495;Rūta;VYTURĖLIAI;8182243701;Ne;0;2;1;3
9496;Rūta;VYTURĖLIAI;8763382361;Ne;9;2;7;18
9497;Rūta;"PABIRUČIAI (LOGOPEDINĖ)";5211104903;Ne;2;0;0;2
9498;Rūta;"PABIRUČIAI (LOGOPEDINĖ)";1734479058;Ne;0;0;4;4
9499;Rūta;"PABIRUČIAI (LOGOPEDINĖ)";4134411156;Ne;3;0;2;5
9500;Rūta;"PABIRUČIAI (LOGOPEDINĖ)";2164103114;Ne;6;0;5;11
9501;Rūta;"PABIRUČIAI (LOGOPEDINĖ)";4271185150;Ne;2;0;3;5
9502;Rūta;"PABIRUČIAI (LOGOPEDINĖ)";6088978998;Ne;0;0;3;3
9503;Rūta;"PABIRUČIAI (LOGOPEDINĖ)";6849928601;Ne;14;0;4;18
9504;Rūta;"PABIRUČIAI (LOGOPEDINĖ)";4151633786;Ne;3;0;6;9
9505;Rūta;GUDRUČIAI;4044349935;Ne;0;0;2;2
9506;Rūta;GUDRUČIAI;3998791775;Ne;0;2;0;2
9507;Rūta;GUDRUČIAI;3043164521;Ne;0;2;0;2
9508;Rūta;GUDRUČIAI;8548089843;Ne;0;2;1;3
9509;Rūta;GUDRUČIAI;4293920701;Ne;0;2;0;2
9510;Rūta;GUDRUČIAI;4473591998;Ne;0;5;0;5
9511;Rūta;GUDRUČIAI;9419809946;Ne;0;3;0;3
9512;Rūta;GUDRUČIAI;9589117921;Ne;0;1;0;1
9513;Rūta;GUDRUČIAI;3044976169;Ne;0;0;2;2
9514;Rūta;GUDRUČIAI;2546023973;Ne;0;0;2;2
9515;Rūta;GUDRUČIAI;8273644943;Ne;0;2;0;2
9516;Rūta;GUDRUČIAI;8963959004;Ne;0;4;4;8
9517;Rūta;GUDRUČIAI;3454881685;Ne;0;2;1;3
9518;Rūta;GUDRUČIAI;1811055786;Ne;0;1;5;6
9519;Rūta;GUDRUČIAI;1510268514;Ne;0;3;0;3
9520;Rūta;GUDRUČIAI;2702537976;Ne;0;4;0;4
9521;Rūta;GUDRUČIAI;2772130413;Ne;0;2;0;2
9522;Rūta;GUDRUČIAI;1623968580;Ne;0;1;0;1
9523;Rūta;GUDRUČIAI;8592528906;Ne;0;19;1;20
9524;Rūta;GUDRUČIAI;1182222976;Ne;0;0;2;2
9525;Rūta;SEKLYTĖLĖ;4423305209;Ne;5;2;2;9
9526;Rūta;SEKLYTĖLĖ;9245618776;Ne;3;3;2;8
9527;Rūta;SEKLYTĖLĖ;1216786487;Ne;4;3;2;9
9528;Rūta;SEKLYTĖLĖ;9736567509;Ne;1;3;2;6
9529;Rūta;SEKLYTĖLĖ;7222494215;Ne;3;2;2;7
9530;Rūta;SEKLYTĖLĖ;7519931138;Ne;0;2;0;2
9531;Rūta;SEKLYTĖLĖ;4880804625;Ne;3;0;2;5
9532;Rūta;SEKLYTĖLĖ;3055345528;Ne;4;0;3;7
9533;Rūta;SEKLYTĖLĖ;3499727608;Ne;7;2;2;11
9534;Rūta;SEKLYTĖLĖ;9765301038;Ne;7;2;2;11
9535;Rūta;SEKLYTĖLĖ;9638495757;Ne;4;1;2;7
9536;Rūta;SEKLYTĖLĖ;1962172243;Ne;3;0;2;5
9537;Rūta;SEKLYTĖLĖ;8605070655;Ne;3;3;2;8
9538;Rūta;SEKLYTĖLĖ;7553844890;Ne;11;4;2;17
9539;Rūta;SEKLYTĖLĖ;3964922552;Ne;5;2;2;9
9540;Rūta;SEKLYTĖLĖ;8395765508;Ne;2;10;2;14
9541;Rūta;SEKLYTĖLĖ;5109138407;Ne;4;2;4;10
9542;Rūta;SEKLYTĖLĖ;9400586178;Ne;3;6;2;11
9543;Rūta;SEKLYTĖLĖ;3956912957;Ne;0;1;0;1
9544;Rūta;SEKLYTĖLĖ;2890569107;Ne;2;3;2;7
9545;Rūta;SEKLYTĖLĖ;2474991135;Ne;6;1;2;9
9546;Rūta;"VARPELIAI (LOGOPEDINĖ)";4911219947;Ne;0;1;1;2
9547;Rūta;"VARPELIAI (LOGOPEDINĖ)";6221528830;Ne;6;0;0;6
9548;Rūta;"VARPELIAI (LOGOPEDINĖ)";5871960113;Ne;2;0;2;4
9549;Rūta;"VARPELIAI (LOGOPEDINĖ)";3814794448;Ne;5;1;4;10
9550;Rūta;"VARPELIAI (LOGOPEDINĖ)";6572172779;Ne;1;1;3;5
9551;Rūta;"VARPELIAI (LOGOPEDINĖ)";1590778538;Ne;0;4;0;4
9552;Rūta;"VARPELIAI (LOGOPEDINĖ)";7946139474;Ne;0;11;0;11
9553;Rūta;KIŠKUČIŲ;6587625933;Ne;3;0;3;6
9554;Rūta;KIŠKUČIŲ;9526121339;Ne;9;0;2;11
9555;Rūta;KIŠKUČIŲ;3805738277;Ne;0;0;2;2
9556;Rūta;KIŠKUČIŲ;8038977034;Ne;4;0;2;6
9557;Rūta;KIŠKUČIŲ;6019344201;Ne;8;0;2;10
9558;Rūta;KIŠKUČIŲ;4712457100;Ne;5;0;3;8
9559;Rūta;KIŠKUČIŲ;8370305271;Ne;5;5;2;12
9560;Rūta;KIŠKUČIŲ;4244665683;Ne;0;2;0;2
9561;Rūta;KIŠKUČIŲ;1504057906;Ne;6;1;4;11
9562;Rūta;KIŠKUČIŲ;9842173401;Ne;0;1;1;2
9563;Rūta;KIŠKUČIŲ;2895194578;Ne;7;0;2;9
9564;Rūta;KIŠKUČIŲ;1893871283;Ne;0;22;0;22
9565;Rūta;KIŠKUČIŲ;8711505500;Ne;8;2;2;12
9566;Rūta;KIŠKUČIŲ;7694633171;Ne;0;0;1;1
9567;Rūta;KIŠKUČIŲ;2534754132;Ne;0;20;0;20
9568;Rūta;ŽVIRBLIUKAI;6778088225;Ne;5;0;4;9
9569;Rūta;ŽVIRBLIUKAI;1397028236;Ne;2;0;2;4
9570;Rūta;ŽVIRBLIUKAI;6567603848;Ne;2;0;2;4
9571;Rūta;ŽVIRBLIUKAI;9803391980;Ne;1;2;3;6
9572;Rūta;ŽVIRBLIUKAI;4512761439;Ne;0;1;0;1
9573;Rūta;ŽVIRBLIUKAI;9695283747;Ne;5;0;3;8
9574;Rūta;ŽVIRBLIUKAI;1184265720;Ne;0;22;0;22
9575;Rūta;ŽVIRBLIUKAI;5868983105;Ne;0;1;2;3
9576;Rūta;ŽVIRBLIUKAI;5375565821;Ne;3;0;3;6
9577;Rūta;ŽVIRBLIUKAI;7072126499;Ne;0;14;0;14
9578;Rūta;SAULUTĖS;6869693434;Ne;0;0;3;3
9579;Rūta;SAULUTĖS;6585842434;Ne;0;0;3;3
9580;Rūta;SAULUTĖS;6620957022;Ne;3;0;2;5
9581;Rūta;SAULUTĖS;8806743371;Ne;0;5;2;7
9582;Rūta;SAULUTĖS;3765741047;Ne;0;0;1;1
9583;Rūta;SAULUTĖS;7762509383;Ne;0;1;0;1
9584;Rūta;SAULUTĖS;2685515977;Ne;7;0;2;9
9585;Rūta;SAULUTĖS;5512946296;Ne;0;5;0;5
9586;Rūta;SAULUTĖS;9308127402;Ne;0;0;2;2
9587;Rūta;SAULUTĖS;7422059414;Ne;6;7;2;15
9588;Rūta;SAULUTĖS;6186413364;Ne;0;22;0;22
9589;Rūta;SAULUTĖS;8479424939;Ne;6;0;2;8
9590;Rūta;SAULUTĖS;9014433476;Ne;0;3;0;3
9591;Rūta;SAULUTĖS;1207463357;Ne;0;3;1;4
9592;Rūta;SAULUTĖS;8715921452;Ne;0;8;7;15
9593;Rūta;SAULUTĖS;9243332756;Ne;0;1;0;1
9594;Sadutė;Kiškučiai;6645848193;Ne;0;1;3;4
9595;Sadutė;Kiškučiai;1589424708;Ne;3;2;2;7
9596;Sadutė;Kiškučiai;5992865266;Ne;5;0;4;9
9597;Sadutė;Kiškučiai;3568132830;Ne;8;0;5;13
9598;Sadutė;Kiškučiai;2087489114;Ne;8;0;2;10
9599;Sadutė;Kiškučiai;4360361866;Ne;0;2;0;2
9600;Sadutė;Kiškučiai;2139177648;Ne;0;2;0;2
9601;Sadutė;Kiškučiai;8397295024;Ne;3;2;2;7
9602;Sadutė;Kiškučiai;4075714061;Ne;0;2;0;2
9603;Sadutė;Kiškučiai;2845125335;Ne;0;1;0;1
9604;Sadutė;Kiškučiai;4135398332;Ne;10;0;4;14
9605;Sadutė;Kiškučiai;3954151590;Ne;0;0;1;1
9606;Sadutė;Kiškučiai;1860645542;Taip;0;10;0;10
9607;Sadutė;Kiškučiai;8841564884;Ne;0;1;3;4
9608;Sadutė;Kiškučiai;8350900604;Ne;0;18;0;18
9609;Sadutė;Kiškučiai;6784030565;Ne;0;0;2;2
9610;Sadutė;Kiškučiai;2807949826;Ne;5;0;8;13
9611;Sadutė;Boružėlės;9115304973;Ne;0;2;3;5
9612;Sadutė;Boružėlės;8442967732;Ne;0;1;0;1
9613;Sadutė;Boružėlės;1273355194;Ne;0;2;0;2
9614;Sadutė;Boružėlės;3119547420;Ne;0;2;0;2
9615;Sadutė;Boružėlės;8987528237;Ne;0;2;0;2
9616;Sadutė;Boružėlės;6994383907;Ne;0;0;2;2
9617;Sadutė;Boružėlės;8914509685;Ne;0;0;5;5
9618;Sadutė;Boružėlės;7242188081;Ne;0;6;0;6
9619;Sadutė;Boružėlės;3244211391;Ne;0;6;0;6
9620;Sadutė;Boružėlės;3875265137;Ne;0;2;3;5
9621;Sadutė;Boružėlės;5992119777;Ne;1;4;2;7
9622;Sadutė;Boružėlės;5682745869;Ne;0;0;1;1
9623;Sadutė;Boružėlės;5579040052;Ne;0;5;0;5
9624;Sadutė;Boružėlės;3362830536;Ne;3;2;12;17
9625;Sadutė;Boružėlės;5395676303;Ne;0;2;3;5
9626;Sadutė;Boružėlės;1923014145;Ne;0;2;6;8
9627;Sadutė;Boružėlės;5698462283;Ne;0;17;4;21
9628;Sadutė;Boružėlės;3845369333;Ne;7;0;4;11
9629;Sadutė;Boružėlės;8200891038;Ne;13;0;2;15
9630;Sadutė;Boružėlės;4696990344;Ne;0;2;0;2
9631;Sadutė;Boružėlės;7580736252;Ne;1;9;2;12
9632;Sadutė;Bitutės;1759479328;Ne;0;2;8;10
9633;Sadutė;Bitutės;1975767401;Ne;0;2;0;2
9634;Sadutė;Bitutės;4245873513;Ne;0;2;2;4
9635;Sadutė;Bitutės;1873928395;Ne;10;2;6;18
9636;Sadutė;Bitutės;5866461096;Ne;0;2;5;7
9637;Sadutė;Bitutės;4883934480;Ne;0;0;1;1
9638;Sadutė;Bitutės;7097653016;Ne;0;7;0;7
9639;Sadutė;Bitutės;4479315578;Ne;0;2;0;2
9640;Sadutė;Bitutės;2020766695;Ne;0;22;0;22
9641;Sadutė;Bitutės;5011320850;Ne;0;10;3;13
9642;Sadutė;Bitutės;4161502667;Ne;0;2;0;2
9643;Sadutė;Bitutės;5973513916;Ne;5;0;4;9
9644;Sadutė;Bitutės;3361904803;Ne;13;0;5;18
9645;Sadutė;Bitutės;1231048342;Ne;0;2;0;2
9646;Sadutė;Bitutės;8556086501;Ne;0;7;0;7
9647;Sadutė;Bitutės;6066145909;Ne;9;2;5;16
9648;Sadutė;Bitutės;5142566738;Ne;1;2;11;14
9649;Sadutė;Bitutės;8662375739;Ne;0;2;6;8
9650;Sadutė;Bitutės;9107727583;Ne;0;7;2;9
9651;Sadutė;Bitutės;6138604955;Ne;0;2;1;3
9652;Sadutė;Bitutės;3339522259;Ne;0;2;0;2
9653;Sadutė;Bitutės;9005989501;Ne;0;2;20;22
9654;Sadutė;Drugeliai;2965270548;Ne;8;2;2;12
9655;Sadutė;Drugeliai;7533550197;Ne;0;4;0;4
9656;Sadutė;Drugeliai;8308487263;Ne;0;2;0;2
9657;Sadutė;Drugeliai;5824843942;Ne;6;0;3;9
9658;Sadutė;Drugeliai;4753735028;Ne;0;22;0;22
9659;Sadutė;Drugeliai;6039555589;Ne;5;2;7;14
9660;Sadutė;Drugeliai;4132174495;Ne;0;3;0;3
9661;Sadutė;Drugeliai;4862514558;Ne;2;2;3;7
9662;Sadutė;Drugeliai;4866469773;Ne;0;22;0;22
9663;Sadutė;Drugeliai;4062325464;Ne;3;2;2;7
9664;Sadutė;Drugeliai;3450873020;Ne;3;0;2;5
9665;Sadutė;Drugeliai;5133144667;Ne;4;0;2;6
9666;Sadutė;Drugeliai;9224321056;Ne;5;0;2;7
9667;Sadutė;Drugeliai;3895799244;Ne;0;22;0;22
9668;Sadutė;Drugeliai;1907291315;Ne;13;0;2;15
9669;Sadutė;Drugeliai;3337178609;Ne;0;1;1;2
9670;Sadutė;Drugeliai;3540727678;Ne;18;2;2;22
9671;Sadutė;Pėledžiukai;9136727429;Ne;0;7;0;7
9672;Sadutė;Pėledžiukai;5616756293;Ne;6;2;4;12
9673;Sadutė;Pėledžiukai;2705458480;Ne;1;15;0;16
9674;Sadutė;Pėledžiukai;6314488650;Ne;0;0;2;2
9675;Sadutė;Pėledžiukai;6126235707;Ne;2;2;4;8
9676;Sadutė;Pėledžiukai;6716550703;Ne;2;0;2;4
9677;Sadutė;Pėledžiukai;7551299839;Ne;1;2;2;5
9678;Sadutė;Pėledžiukai;8914706717;Ne;3;0;3;6
9679;Sadutė;Pėledžiukai;6379705269;Ne;0;0;4;4
9680;Sadutė;Pėledžiukai;5385678913;Ne;10;0;6;16
9681;Sadutė;Pėledžiukai;2747256989;Ne;11;0;4;15
9682;Sadutė;Pėledžiukai;3277826759;Ne;5;0;4;9
9683;Sadutė;Pėledžiukai;4791750087;Ne;4;0;2;6
9684;Sadutė;Pėledžiukai;2003300961;Ne;0;3;0;3
9685;Sadutė;Pėledžiukai;5580870821;Ne;6;0;2;8
9686;Sadutė;Pėledžiukai;6430493524;Ne;4;0;4;8
9687;Sadutė;Pėledžiukai;1510498753;Ne;4;0;4;8
9688;Sadutė;Kačiukų;1903961488;Ne;3;2;2;7
9689;Sadutė;Kačiukų;2890916313;Ne;12;2;2;16
9690;Sadutė;Kačiukų;2733633163;Ne;0;1;0;1
9691;Sadutė;Kačiukų;3993181500;Ne;0;2;0;2
9692;Sadutė;Kačiukų;8835627470;Ne;0;2;2;4
9693;Sadutė;Kačiukų;2532626934;Ne;0;2;2;4
9694;Sadutė;Kačiukų;2466024649;Ne;0;2;0;2
9695;Sadutė;Kačiukų;6253351299;Ne;0;2;0;2
9696;Sadutė;Kačiukų;2426974464;Ne;0;2;1;3
9697;Sadutė;Kačiukų;5438448926;Ne;0;7;0;7
9698;Sadutė;Kačiukų;8974374101;Ne;0;2;4;6
9699;Sadutė;Kačiukų;4401870028;Ne;0;3;1;4
9700;Sadutė;Kačiukų;8714168144;Ne;0;2;1;3
9701;Sadutė;Kačiukų;3927044011;Ne;0;5;0;5
9702;Sadutė;Kačiukų;8974225608;Ne;0;0;1;1
9703;Sadutė;Kačiukų;8770727233;Ne;0;2;1;3
9704;Sadutė;Kačiukų;8556218971;Ne;0;2;0;2
9705;Sadutė;Kačiukų;5267093203;Ne;18;2;2;22
9706;Sadutė;Kačiukų;5614758320;Ne;0;18;0;18
9707;Sadutė;Kačiukų;2194387139;Ne;0;2;2;4
9708;Sakalėlis;GIRINUKŲ;6597274376;Ne;0;2;0;2
9709;Sakalėlis;GIRINUKŲ;5500248048;Ne;0;0;3;3
9710;Sakalėlis;GIRINUKŲ;8562164673;Ne;3;1;3;7
9711;Sakalėlis;GIRINUKŲ;1121818878;Ne;0;1;0;1
9712;Sakalėlis;GIRINUKŲ;2537030533;Ne;0;2;1;3
9713;Sakalėlis;GIRINUKŲ;3719351129;Ne;0;3;1;4
9714;Sakalėlis;GIRINUKŲ;3570413330;Ne;8;6;4;18
9715;Sakalėlis;GIRINUKŲ;7852255204;Ne;11;0;4;15
9716;Sakalėlis;GIRINUKŲ;9926328835;Ne;4;3;2;9
9717;Sakalėlis;GIRINUKŲ;8328069876;Ne;0;0;1;1
9718;Sakalėlis;GIRINUKŲ;2250828607;Ne;5;2;3;10
9719;Sakalėlis;GIRINUKŲ;2672429406;Ne;5;2;3;10
9720;Sakalėlis;GIRINUKŲ;2233966176;Ne;0;2;8;10
9721;Sakalėlis;GIRINUKŲ;7079300418;Ne;5;0;5;10
9722;Sakalėlis;GIRINUKŲ;6851247779;Ne;0;8;4;12
9723;Sakalėlis;GIRINUKŲ;8501785305;Ne;0;2;6;8
9724;Sakalėlis;GIRINUKŲ;2649804066;Ne;0;0;6;6
9725;Sakalėlis;GIRINUKŲ;6996901033;Ne;1;0;2;3
9726;Sakalėlis;VYTURIUKŲ;3927487265;Ne;0;2;2;4
9727;Sakalėlis;VYTURIUKŲ;2352118061;Ne;6;2;5;13
9728;Sakalėlis;VYTURIUKŲ;3680732318;Ne;6;1;3;10
9729;Sakalėlis;VYTURIUKŲ;4862004373;Ne;2;2;2;6
9730;Sakalėlis;VYTURIUKŲ;8422299669;Ne;6;2;5;13
9731;Sakalėlis;VYTURIUKŲ;6579827280;Ne;0;0;3;3
9732;Sakalėlis;VYTURIUKŲ;8381310908;Ne;0;1;1;2
9733;Sakalėlis;VYTURIUKŲ;6840368824;Ne;5;0;2;7
9734;Sakalėlis;VYTURIUKŲ;5795250727;Ne;0;5;0;5
9735;Sakalėlis;VYTURIUKŲ;2985239904;Ne;6;2;2;10
9736;Sakalėlis;VYTURIUKŲ;3351218789;Ne;0;2;7;9
9737;Sakalėlis;VYTURIUKŲ;9120873899;Ne;0;2;15;17
9738;Sakalėlis;VYTURIUKŲ;4136266629;Ne;0;2;7;9
9739;Sakalėlis;VYTURIUKŲ;5991029760;Ne;5;0;7;12
9740;Sakalėlis;VYTURIUKŲ;1736303381;Ne;0;2;3;5
9741;Sakalėlis;VYTURIUKŲ;1200252225;Ne;2;1;2;5
9742;Sakalėlis;VYTURIUKŲ;7280513854;Ne;0;2;1;3
9743;Sakalėlis;VYTURIUKŲ;1806698668;Ne;0;2;1;3
9744;Sakalėlis;DRUGELIŲ;8095359035;Ne;0;0;3;3
9745;Sakalėlis;DRUGELIŲ;6515519140;Ne;0;2;2;4
9746;Sakalėlis;DRUGELIŲ;7706606275;Ne;0;0;2;2
9747;Sakalėlis;DRUGELIŲ;5911341542;Ne;4;1;4;9
9748;Sakalėlis;DRUGELIŲ;9272347788;Ne;3;2;2;7
9749;Sakalėlis;DRUGELIŲ;8331612396;Ne;4;0;5;9
9750;Sakalėlis;DRUGELIŲ;2898006208;Ne;9;0;4;13
9751;Sakalėlis;DRUGELIŲ;7542322748;Ne;6;5;6;17
9752;Sakalėlis;DRUGELIŲ;4918228191;Ne;0;0;1;1
9753;Sakalėlis;DRUGELIŲ;1201086815;Ne;5;15;2;22
9754;Sakalėlis;DRUGELIŲ;3934295338;Ne;11;2;4;17
9755;Sakalėlis;DRUGELIŲ;1117800518;Ne;1;0;4;5
9756;Sakalėlis;DRUGELIŲ;2515169899;Ne;0;2;1;3
9757;Sakalėlis;DRUGELIŲ;8160589611;Ne;2;3;2;7
9758;Sakalėlis;DRUGELIŲ;9836193857;Ne;0;2;2;4
9759;Sakalėlis;DRUGELIŲ;4004006771;Ne;8;1;2;11
9760;Sakalėlis;DRUGELIŲ;1833573491;Ne;8;0;2;10
9761;Sakalėlis;DRUGELIŲ;8713298648;Ne;0;0;3;3
9762;Sakalėlis;DRUGELIŲ;2889638745;Ne;3;2;4;9
9763;Sakalėlis;DRUGELIŲ;7540098033;Ne;0;0;6;6
9764;Sakalėlis;GENIUKŲ;2505477059;Ne;8;0;3;11
9765;Sakalėlis;GENIUKŲ;1004062550;Ne;4;3;2;9
9766;Sakalėlis;GENIUKŲ;5865993835;Ne;3;0;4;7
9767;Sakalėlis;GENIUKŲ;6328924318;Ne;11;2;4;17
9768;Sakalėlis;GENIUKŲ;8228039819;Ne;14;0;4;18
9769;Sakalėlis;GENIUKŲ;7006304327;Ne;1;0;3;4
9770;Sakalėlis;GENIUKŲ;4611384179;Ne;3;1;2;6
9771;Sakalėlis;GENIUKŲ;4490632523;Ne;5;15;2;22
9772;Sakalėlis;GENIUKŲ;8868588637;Ne;8;2;3;13
9773;Sakalėlis;GENIUKŲ;8015985605;Ne;2;3;2;7
9774;Sakalėlis;GENIUKŲ;5052638078;Ne;11;0;5;16
9775;Sakalėlis;GENIUKŲ;5327382009;Ne;11;0;5;16
9776;Sakalėlis;GENIUKŲ;6897550418;Ne;10;0;2;12
9777;Sakalėlis;GENIUKŲ;9642519454;Ne;1;2;3;6
9778;Sakalėlis;GENIUKŲ;4295210323;Ne;2;0;2;4
9779;Sakalėlis;GENIUKŲ;6300266321;Ne;3;2;2;7
9780;Sakalėlis;GENIUKŲ;8796728627;Ne;0;7;0;7
9781;Sakalėlis;GENIUKŲ;8659925528;Ne;2;0;4;6
9782;Sakalėlis;VOVERIUKŲ;5172421763;Ne;1;0;5;6
9783;Sakalėlis;VOVERIUKŲ;5233697077;Ne;2;2;4;8
9784;Sakalėlis;VOVERIUKŲ;6414564366;Ne;5;0;6;11
9785;Sakalėlis;VOVERIUKŲ;4358313171;Ne;0;2;2;4
9786;Sakalėlis;VOVERIUKŲ;6806170544;Ne;0;0;1;1
9787;Sakalėlis;VOVERIUKŲ;2557089391;Ne;4;0;7;11
9788;Sakalėlis;VOVERIUKŲ;8133985842;Ne;5;0;4;9
9789;Sakalėlis;VOVERIUKŲ;3574956316;Ne;0;4;0;4
9790;Sakalėlis;VOVERIUKŲ;1403384561;Ne;3;0;6;9
9791;Sakalėlis;VOVERIUKŲ;3927363997;Ne;0;2;0;2
9792;Sakalėlis;VOVERIUKŲ;6293226507;Ne;10;0;3;13
9793;Sakalėlis;VOVERIUKŲ;2699844937;Taip;1;4;2;7
9794;Sakalėlis;VOVERIUKŲ;1669610397;Ne;0;0;12;12
9795;Sakalėlis;VOVERIUKŲ;6016854405;Ne;0;7;0;7
9796;Sakalėlis;VOVERIUKŲ;2531146677;Ne;11;2;4;17
9797;Sakalėlis;VOVERIUKŲ;2575873447;Ne;0;0;1;1
9798;Sakalėlis;VOVERIUKŲ;4968216193;Ne;2;0;4;6
9799;Sakalėlis;PĖLEDŽIUKŲ;5405669698;Ne;0;1;5;6
9800;Sakalėlis;PĖLEDŽIUKŲ;2474164013;Ne;3;2;2;7
9801;Sakalėlis;PĖLEDŽIUKŲ;9566176151;Ne;0;2;2;4
9802;Sakalėlis;PĖLEDŽIUKŲ;9493905856;Ne;9;1;4;14
9803;Sakalėlis;PĖLEDŽIUKŲ;9250470549;Ne;0;1;0;1
9804;Sakalėlis;PĖLEDŽIUKŲ;5496044442;Ne;0;2;2;4
9805;Sakalėlis;PĖLEDŽIUKŲ;3165387995;Ne;0;2;2;4
9806;Sakalėlis;PĖLEDŽIUKŲ;6603105354;Ne;0;2;1;3
9807;Sakalėlis;PĖLEDŽIUKŲ;3418702674;Ne;0;1;1;2
9808;Sakalėlis;PĖLEDŽIUKŲ;3748865437;Ne;4;1;2;7
9809;Sakalėlis;PĖLEDŽIUKŲ;3333037807;Ne;0;2;0;2
9810;Sakalėlis;PĖLEDŽIUKŲ;8606714134;Ne;0;2;0;2
9811;Sakalėlis;PĖLEDŽIUKŲ;4596727938;Ne;0;5;0;5
9812;Sakalėlis;PĖLEDŽIUKŲ;1347171934;Ne;0;7;0;7
9813;Sakalėlis;PĖLEDŽIUKŲ;8790189865;Ne;0;2;2;4
9814;Sakalėlis;PĖLEDŽIUKŲ;4458071075;Ne;4;1;2;7
9815;Sakalėlis;PĖLEDŽIUKŲ;4209146744;Ne;0;2;1;3
9816;Sakalėlis;PĖLEDŽIUKŲ;6217643065;Ne;0;2;2;4
9817;Sakalėlis;PĖLEDŽIUKŲ;9368758708;Ne;12;2;4;18
9818;Sakalėlis;PĖLEDŽIUKŲ;8326977226;Ne;1;2;2;5
9819;Sakalėlis;PĖLEDŽIUKŲ;4576495786;Ne;0;1;7;8
9820;Sakalėlis;"BITUČIŲ (LOGOPEDINĖ)";5376872141;Ne;0;0;2;2
9821;Sakalėlis;"BITUČIŲ (LOGOPEDINĖ)";3079900548;Taip;1;0;2;3
9822;Sakalėlis;"BITUČIŲ (LOGOPEDINĖ)";2669711574;Ne;1;0;2;3
9823;Sakalėlis;"BITUČIŲ (LOGOPEDINĖ)";8638720071;Ne;8;0;2;10
9824;Sakalėlis;"BITUČIŲ (LOGOPEDINĖ)";4442027941;Ne;6;0;9;15
9825;Sakalėlis;"BITUČIŲ (LOGOPEDINĖ)";2691761427;Ne;6;0;4;10
9826;Sakalėlis;"BITUČIŲ (LOGOPEDINĖ)";1208798798;Ne;7;4;2;13
9827;Sakalėlis;"BITUČIŲ (LOGOPEDINĖ)";2748400429;Taip;0;9;11;20
9828;Sakalėlis;"BITUČIŲ (LOGOPEDINĖ)";3992073331;Taip;0;0;3;3
9829;Sakalėlis;"BORUŽIUKŲ (LOGOPEDINĖ)";2124857941;Ne;8;2;2;12
9830;Sakalėlis;"BORUŽIUKŲ (LOGOPEDINĖ)";6250400609;Ne;5;0;2;7
9831;Sakalėlis;"BORUŽIUKŲ (LOGOPEDINĖ)";6222204020;Ne;0;1;0;1
9832;Sakalėlis;"BORUŽIUKŲ (LOGOPEDINĖ)";7602249339;Ne;0;2;0;2
9833;Sakalėlis;"BORUŽIUKŲ (LOGOPEDINĖ)";8263169658;Ne;0;2;1;3
9834;Sakalėlis;"BORUŽIUKŲ (LOGOPEDINĖ)";9776767584;Ne;4;0;2;6
9835;Sakalėlis;"BORUŽIUKŲ (LOGOPEDINĖ)";7620944079;Ne;0;2;0;2
9836;Sakalėlis;"BORUŽIUKŲ (LOGOPEDINĖ)";2732572235;Ne;2;2;5;9
9837;Sakalėlis;"BORUŽIUKŲ (LOGOPEDINĖ)";9337144831;Ne;4;0;2;6
9838;Sakalėlis;MEŠKUČIŲ;9546779717;Ne;5;2;2;9
9839;Sakalėlis;MEŠKUČIŲ;8535457018;Ne;0;6;4;10
9840;Sakalėlis;MEŠKUČIŲ;4813561523;Ne;0;0;3;3
9841;Sakalėlis;MEŠKUČIŲ;7154383856;Ne;5;0;6;11
9842;Sakalėlis;MEŠKUČIŲ;5082756444;Ne;0;0;4;4
9843;Sakalėlis;MEŠKUČIŲ;7839893402;Ne;0;0;2;2
9844;Sakalėlis;MEŠKUČIŲ;3092760315;Ne;3;2;2;7
9845;Sakalėlis;MEŠKUČIŲ;3524545708;Ne;0;5;0;5
9846;Sakalėlis;MEŠKUČIŲ;5961207419;Ne;8;0;4;12
9847;Sakalėlis;MEŠKUČIŲ;5961861760;Ne;1;0;3;4
9848;Sakalėlis;MEŠKUČIŲ;2389541483;Ne;0;9;0;9
9849;Sakalėlis;MEŠKUČIŲ;4063074948;Ne;0;0;3;3
9850;Sakalėlis;MEŠKUČIŲ;8108456923;Ne;0;0;2;2
9851;Sakalėlis;MEŠKUČIŲ;7285230768;Ne;0;10;2;12
9852;Sakalėlis;MEŠKUČIŲ;2090313887;Ne;0;7;4;11
9853;Sakalėlis;MEŠKUČIŲ;9794245922;Ne;0;2;7;9
9854;Sakalėlis;MEŠKUČIŲ;8106231242;Ne;8;0;5;13
9855;Sakalėlis;MEŠKUČIŲ;4520212128;Ne;0;11;2;13
9856;Sakalėlis;MEŠKUČIŲ;7228559861;Ne;0;7;3;10
9857;Sakalėlis;MEŠKUČIŲ;8000744698;Taip;8;0;2;10
9858;Sakalėlis;MEŠKUČIŲ;7664863335;Ne;0;1;0;1
9859;Sakalėlis;KIŠKUČIŲ;6029443196;Ne;0;1;1;2
9860;Sakalėlis;KIŠKUČIŲ;8036737782;Ne;11;5;6;22
9861;Sakalėlis;KIŠKUČIŲ;9621137382;Ne;11;0;5;16
9862;Sakalėlis;KIŠKUČIŲ;3941949117;Ne;0;0;1;1
9863;Sakalėlis;KIŠKUČIŲ;2117073621;Ne;0;1;0;1
9864;Sakalėlis;KIŠKUČIŲ;7796882816;Ne;10;0;4;14
9865;Sakalėlis;KIŠKUČIŲ;8788790889;Ne;0;0;3;3
9866;Sakalėlis;KIŠKUČIŲ;1270977572;Ne;15;0;4;19
9867;Sakalėlis;KIŠKUČIŲ;1213702668;Ne;4;0;2;6
9868;Sakalėlis;KIŠKUČIŲ;6682017840;Ne;3;0;3;6
9869;Sakalėlis;KIŠKUČIŲ;1913818905;Ne;3;0;4;7
9870;Sakalėlis;KIŠKUČIŲ;1969584481;Ne;17;0;4;21
9871;Sakalėlis;KIŠKUČIŲ;7764732694;Ne;0;3;0;3
9872;Sakalėlis;KIŠKUČIŲ;9172210601;Ne;0;7;0;7
9873;Sakalėlis;SVIRPLIUKŲ;1981444595;Ne;5;0;3;8
9874;Sakalėlis;SVIRPLIUKŲ;8562206323;Ne;5;0;2;7
9875;Sakalėlis;SVIRPLIUKŲ;5494452779;Ne;7;0;2;9
9876;Sakalėlis;SVIRPLIUKŲ;3294479203;Ne;8;0;2;10
9877;Sakalėlis;SVIRPLIUKŲ;9423279756;Ne;6;2;3;11
9878;Sakalėlis;SVIRPLIUKŲ;3205403024;Ne;2;0;6;8
9879;Sakalėlis;SVIRPLIUKŲ;3963251786;Ne;0;0;5;5
9880;Sakalėlis;SVIRPLIUKŲ;8386308690;Ne;16;1;5;22
9881;Sakalėlis;SVIRPLIUKŲ;9410185441;Ne;4;0;4;8
9882;Sakalėlis;SVIRPLIUKŲ;5649630720;Ne;2;0;2;4
9883;Sakalėlis;SVIRPLIUKŲ;5740175023;Ne;0;0;1;1
9884;Sakalėlis;SVIRPLIUKŲ;6476563646;Ne;4;0;4;8
9885;Sakalėlis;SVIRPLIUKŲ;8162876482;Ne;0;2;0;2
9886;Sakalėlis;GANDRIUKŲ;8502289806;Ne;0;9;2;11
9887;Sakalėlis;GANDRIUKŲ;7384400795;Ne;10;5;3;18
9888;Sakalėlis;GANDRIUKŲ;3644413861;Taip;0;2;0;2
9889;Sakalėlis;GANDRIUKŲ;4230762388;Ne;15;0;4;19
9890;Sakalėlis;GANDRIUKŲ;3228617971;Ne;0;0;3;3
9891;Sakalėlis;GANDRIUKŲ;5748438461;Taip;0;0;6;6
9892;Sakalėlis;GANDRIUKŲ;2734462553;Ne;0;0;1;1
9893;Sakalėlis;GANDRIUKŲ;2481285439;Ne;0;0;1;1
9894;Sakalėlis;GANDRIUKŲ;7345113972;Ne;0;1;1;2
9895;Sakalėlis;GANDRIUKŲ;6069544792;Ne;0;0;5;5
9896;Sakalėlis;GANDRIUKŲ;1560077883;Ne;0;0;6;6
9897;Sakalėlis;GANDRIUKŲ;5387119771;Ne;15;0;2;17
9898;Sakalėlis;GANDRIUKŲ;9599801230;Ne;5;1;3;9
9899;Sakalėlis;GANDRIUKŲ;7321913487;Ne;0;0;3;3
9900;Sakalėlis;GANDRIUKŲ;1820886350;Ne;5;0;6;11
9901;Sakalėlis;GANDRIUKŲ;4307106905;Ne;6;0;5;11
9902;Sakalėlis;GANDRIUKŲ;2889517278;Ne;10;0;2;12
9903;Salininkų;BORUŽIUKAI;1315946153;Ne;8;0;4;12
9904;Salininkų;BORUŽIUKAI;4251420816;Ne;3;7;2;12
9905;Salininkų;BORUŽIUKAI;4753007411;Ne;0;3;0;3
9906;Salininkų;BORUŽIUKAI;9802972916;Ne;5;1;2;8
9907;Salininkų;BORUŽIUKAI;1198469626;Ne;9;0;4;13
9908;Salininkų;BORUŽIUKAI;3168392325;Ne;3;2;6;11
9909;Salininkų;BORUŽIUKAI;6477136976;Ne;8;10;4;22
9910;Salininkų;BORUŽIUKAI;6903692351;Ne;0;0;3;3
9911;Salininkų;BORUŽIUKAI;1161889732;Ne;3;0;2;5
9912;Salininkų;BORUŽIUKAI;8049341629;Ne;0;1;2;3
9913;Salininkų;BORUŽIUKAI;7022231494;Ne;0;2;0;2
9914;Salininkų;BORUŽIUKAI;4726550395;Ne;5;1;2;8
9915;Salininkų;BORUŽIUKAI;4742529598;Ne;5;1;2;8
9916;Salininkų;BORUŽIUKAI;4866786238;Ne;10;2;2;14
9917;Salininkų;BORUŽIUKAI;3710734769;Ne;5;2;2;9
9918;Salininkų;BORUŽIUKAI;7491809175;Ne;10;0;4;14
9919;Salininkų;GĖLYTĖS;8718514114;Ne;4;2;4;10
9920;Salininkų;GĖLYTĖS;8329495685;Ne;5;0;4;9
9921;Salininkų;GĖLYTĖS;8930622266;Ne;0;11;0;11
9922;Salininkų;GĖLYTĖS;5447236646;Ne;0;4;2;6
9923;Salininkų;GĖLYTĖS;8911016037;Ne;0;11;0;11
9924;Salininkų;GĖLYTĖS;1647401700;Ne;13;0;5;18
9925;Salininkų;GĖLYTĖS;9817285587;Ne;6;0;4;10
9926;Salininkų;GĖLYTĖS;2146404021;Ne;0;6;0;6
9927;Salininkų;GĖLYTĖS;8823595510;Ne;0;11;0;11
9928;Salininkų;GĖLYTĖS;9416926474;Ne;10;1;2;13
9929;Salininkų;GĖLYTĖS;5671229613;Ne;10;0;2;12
9930;Salininkų;GĖLYTĖS;1005025619;Ne;0;14;0;14
9931;Salininkų;GĖLYTĖS;9855014750;Ne;0;0;2;2
9932;Salininkų;GĖLYTĖS;1254843449;Ne;0;10;0;10
9933;Salininkų;GĖLYTĖS;6315595048;Ne;0;12;0;12
9934;Salininkų;GĖLYTĖS;3231379271;Ne;0;10;0;10
9935;Salininkų;GĖLYTĖS;1346133493;Ne;0;1;0;1
9936;Salininkų;GĖLYTĖS;2273407270;Ne;0;1;0;1
9937;Salininkų;GĖLYTĖS;2056560837;Ne;8;0;4;12
9938;Salininkų;DRUGELIAI;2684868661;Ne;0;0;4;4
9939;Salininkų;DRUGELIAI;8063397588;Ne;0;0;1;1
9940;Salininkų;DRUGELIAI;4333027447;Ne;0;2;0;2
9941;Salininkų;DRUGELIAI;3115232507;Ne;0;6;0;6
9942;Salininkų;DRUGELIAI;2009246885;Ne;0;0;5;5
9943;Salininkų;DRUGELIAI;3420217477;Ne;10;0;2;12
9944;Salininkų;DRUGELIAI;3890914603;Ne;0;9;0;9
9945;Salininkų;DRUGELIAI;3181932118;Ne;9;1;5;15
9946;Salininkų;DRUGELIAI;5017068344;Ne;5;0;2;7
9947;Salininkų;DRUGELIAI;3761217912;Ne;0;2;0;2
9948;Salininkų;DRUGELIAI;2208607684;Ne;10;2;2;14
9949;Salininkų;DRUGELIAI;3963410827;Ne;0;2;2;4
9950;Salininkų;DRUGELIAI;5539560359;Ne;0;3;5;8
9951;Salininkų;DRUGELIAI;5587577036;Ne;0;0;2;2
9952;Salininkų;DRUGELIAI;5375668400;Ne;0;3;0;3
9953;Salininkų;DRUGELIAI;4529253958;Ne;11;0;4;15
9954;Salininkų;DRUGELIAI;5583804491;Ne;7;2;4;13
9955;Salininkų;DRUGELIAI;9018366347;Ne;1;7;3;11
9956;Salininkų;ŽIRNIUKAI;7643665643;Ne;5;2;2;9
9957;Salininkų;ŽIRNIUKAI;9198411540;Ne;12;3;4;19
9958;Salininkų;ŽIRNIUKAI;6885580632;Ne;5;2;2;9
9959;Salininkų;ŽIRNIUKAI;7409604480;Ne;0;2;0;2
9960;Salininkų;ŽIRNIUKAI;3677558828;Ne;0;4;0;4
9961;Salininkų;ŽIRNIUKAI;8095820690;Ne;0;1;2;3
9962;Salininkų;ŽIRNIUKAI;6482437251;Ne;0;2;0;2
9963;Salininkų;ŽIRNIUKAI;1380797788;Ne;0;3;0;3
9964;Salininkų;ŽIRNIUKAI;2495782496;Ne;3;4;2;9
9965;Salininkų;ŽIRNIUKAI;9896357816;Ne;5;3;2;10
9966;Salininkų;ŽIRNIUKAI;4568462071;Ne;4;0;6;10
9967;Salininkų;ŽIRNIUKAI;9137783249;Ne;0;4;0;4
9968;Salininkų;ŽIRNIUKAI;8524400656;Ne;0;4;0;4
9969;Salininkų;ŽIRNIUKAI;7463713798;Ne;0;7;0;7
9970;Salininkų;ŽIRNIUKAI;9617873735;Ne;3;0;2;5
9971;Salininkų;ŽIRNIUKAI;1111197633;Ne;0;1;0;1
9972;Salininkų;ŽIRNIUKAI;6143967744;Ne;11;0;4;15
9973;Salininkų;ŽIRNIUKAI;8552427446;Ne;20;0;2;22
9974;Salininkų;ŽIRNIUKAI;6586988786;Taip;0;2;2;4
9975;Salininkų;ŽIRNIUKAI;1587485662;Ne;0;2;2;4
9976;Salininkų;ŽIRNIUKAI;9611858211;Ne;3;2;4;9
9977;Salininkų;PAUKŠČIUKAI;2895782373;Ne;0;8;0;8
9978;Salininkų;PAUKŠČIUKAI;9893985732;Ne;0;13;0;13
9979;Salininkų;PAUKŠČIUKAI;1284909139;Ne;0;5;0;5
9980;Salininkų;PAUKŠČIUKAI;3686372180;Ne;1;0;3;4
9981;Salininkų;PAUKŠČIUKAI;9892443649;Ne;0;3;0;3
9982;Salininkų;PAUKŠČIUKAI;5164367382;Ne;13;0;4;17
9983;Salininkų;PAUKŠČIUKAI;3703729963;Ne;0;2;1;3
9984;Salininkų;PAUKŠČIUKAI;6506819265;Ne;0;7;0;7
9985;Salininkų;PAUKŠČIUKAI;6510096414;Ne;0;8;0;8
9986;Salininkų;PAUKŠČIUKAI;2491796874;Ne;0;5;0;5
9987;Salininkų;PAUKŠČIUKAI;3464228778;Ne;9;0;4;13
9988;Salininkų;PAUKŠČIUKAI;2440831687;Ne;0;11;0;11
9989;Salininkų;PAUKŠČIUKAI;8141168894;Ne;6;1;2;9
9990;Salininkų;PAUKŠČIUKAI;2798153926;Ne;0;5;0;5
9991;Salininkų;PAUKŠČIUKAI;8602489420;Ne;0;12;0;12
9992;Salininkų;BITUTĖS;6845471044;Ne;0;0;3;3
9993;Salininkų;BITUTĖS;2467926286;Ne;3;11;2;16
9994;Salininkų;BITUTĖS;9902751686;Ne;0;3;0;3
9995;Salininkų;BITUTĖS;6125152143;Ne;0;2;0;2
9996;Salininkų;BITUTĖS;2095952937;Ne;0;2;0;2
9997;Salininkų;BITUTĖS;6551489987;Taip;0;2;0;2
9998;Salininkų;BITUTĖS;1928897962;Taip;3;2;2;7
9999;Salininkų;BITUTĖS;3527495230;Ne;0;2;0;2
10000;Salininkų;BITUTĖS;5582091833;Ne;3;8;2;13
10001;Salininkų;BITUTĖS;2073939432;Taip;0;0;1;1
10002;Salininkų;BITUTĖS;9996809930;Taip;2;0;5;7
10003;Salininkų;BITUTĖS;8992580214;Taip;0;0;1;1
10004;Salininkų;BITUTĖS;3915336062;Ne;0;4;0;4
10005;Salininkų;BITUTĖS;7115888747;Ne;0;0;2;2
10006;Salininkų;BITUTĖS;7639362434;Ne;0;0;1;1
10007;Salininkų;BITUTĖS;2370778977;Ne;10;0;2;12
10008;Salininkų;BITUTĖS;1020073382;Ne;10;0;2;12
10009;Salininkų;BITUTĖS;4480303856;Ne;0;4;7;11
10010;Salininkų;BITUTĖS;7383557807;Ne;0;11;0;11
10011;Salininkų;BITUTĖS;6181876938;Taip;0;0;1;1
10012;Salvija;Daigelis(šatil);8337554678;Ne;0;0;3;3
10013;Salvija;Daigelis(šatil);6323383244;Ne;6;4;2;12
10014;Salvija;Daigelis(šatil);3857916185;Ne;0;0;10;10
10015;Salvija;Daigelis(šatil);1168900211;Ne;3;0;4;7
10016;Salvija;Daigelis(šatil);7410091250;Ne;0;0;2;2
10017;Salvija;Daigelis(šatil);5761622263;Ne;0;12;0;12
10018;Salvija;Daigelis(šatil);6797777730;Ne;0;0;1;1
10019;Salvija;Daigelis(šatil);1850688392;Ne;0;0;2;2
10020;Salvija;Daigelis(šatil);2959140033;Ne;0;5;0;5
10021;Salvija;Daigelis(šatil);9129939185;Ne;0;0;5;5
10022;Salvija;Daigelis(šatil);2161008233;Ne;0;0;3;3
10023;Salvija;Daigelis(šatil);1959861292;Ne;0;0;1;1
10024;Salvija;Daigelis(šatil);6260496597;Ne;20;0;2;22
10025;Salvija;"Pienė (savjon)";8981331532;Ne;0;0;9;9
10026;Salvija;"Pienė (savjon)";8013023311;Ne;0;1;1;2
10027;Salvija;"Pienė (savjon)";4325636377;Ne;2;0;3;5
10028;Salvija;"Pienė (savjon)";7477171133;Ne;0;12;0;12
10029;Salvija;"Pienė (savjon)";6706565915;Ne;0;0;1;1
10030;Salvija;"Pienė (savjon)";8853389268;Ne;0;4;0;4
10031;Salvija;"Pienė (savjon)";3856351749;Ne;9;2;4;15
10032;Salvija;"Pienė (savjon)";7862619996;Ne;0;0;4;4
10033;Salvija;"Pienė (savjon)";4373711097;Ne;0;0;2;2
10034;Salvija;"Pienė (savjon)";5816893736;Ne;8;0;3;11
10035;Salvija;"Pienė (savjon)";1975032693;Ne;0;2;0;2
10036;Salvija;"Pienė (savjon)";5327735648;Ne;13;0;4;17
10037;Salvija;"Pienė (savjon)";4665919836;Ne;8;0;4;12
10038;Salvija;"Pienė (savjon)";4577248630;Ne;6;5;2;13
10039;Salvija;"Pienė (savjon)";1509182157;Ne;2;0;3;5
10040;Salvija;"Pienė (savjon)";6509829735;Ne;0;0;2;2
10041;Salvija;"Pienė (savjon)";9978634888;Ne;2;7;2;11
10042;Salvija;"Pienė (savjon)";1676795179;Ne;9;0;3;12
10043;Saulėtekis;BERŽELIS;3493175211;Ne;0;8;0;8
10044;Saulėtekis;BERŽELIS;8086451893;Ne;8;1;4;13
10045;Saulėtekis;BERŽELIS;9351122147;Ne;8;0;2;10
10046;Saulėtekis;BERŽELIS;6667804855;Ne;0;2;0;2
10047;Saulėtekis;BERŽELIS;4704426104;Ne;5;0;4;9
10048;Saulėtekis;BERŽELIS;7407540257;Ne;3;0;2;5
10049;Saulėtekis;BERŽELIS;6920619390;Ne;2;0;0;2
10050;Saulėtekis;BERŽELIS;5194925689;Ne;6;2;4;12
10051;Saulėtekis;BERŽELIS;2672108464;Ne;1;2;2;5
10052;Saulėtekis;BERŽELIS;9579088485;Ne;0;2;0;2
10053;Saulėtekis;BERŽELIS;7436158953;Ne;9;2;4;15
10054;Saulėtekis;BERŽELIS;7165739418;Ne;0;0;2;2
10055;Saulėtekis;BERŽELIS;1917500190;Ne;4;2;2;8
10056;Saulėtekis;BERŽELIS;2935641362;Ne;9;0;6;15
10057;Saulėtekis;BERŽELIS;4676218435;Ne;0;0;1;1
10058;Saulėtekis;BERŽELIS;7598254324;Ne;5;0;5;10
10059;Saulėtekis;BERŽELIS;8468491266;Ne;0;2;0;2
10060;Saulėtekis;BERŽELIS;6181992249;Ne;5;0;6;11
10061;Saulėtekis;BERŽELIS;5824537129;Ne;10;6;6;22
10062;Saulėtekis;ŠYPSENA;8331205443;Ne;15;0;4;19
10063;Saulėtekis;ŠYPSENA;4975294724;Ne;1;0;7;8
10064;Saulėtekis;ŠYPSENA;7780877703;Ne;0;2;0;2
10065;Saulėtekis;ŠYPSENA;2282128335;Ne;4;0;2;6
10066;Saulėtekis;ŠYPSENA;7759917109;Ne;3;2;3;8
10067;Saulėtekis;ŠYPSENA;3306250980;Taip;0;0;3;3
10068;Saulėtekis;ŠYPSENA;4391887095;Ne;0;0;2;2
10069;Saulėtekis;ŠYPSENA;1278985938;Ne;0;0;2;2
10070;Saulėtekis;ŠYPSENA;4765756650;Ne;4;0;4;8
10071;Saulėtekis;ŠYPSENA;1237869114;Ne;3;0;2;5
10072;Saulėtekis;ŠYPSENA;1515580716;Ne;0;3;1;4
10073;Saulėtekis;ŠYPSENA;6831161042;Ne;0;3;1;4
10074;Saulėtekis;ŠYPSENA;4433821698;Ne;2;0;2;4
10075;Saulėtekis;NYKŠTUKAI;1896847801;Ne;2;0;0;2
10076;Saulėtekis;NYKŠTUKAI;7849181976;Ne;0;7;0;7
10077;Saulėtekis;NYKŠTUKAI;5748816813;Ne;2;0;4;6
10078;Saulėtekis;NYKŠTUKAI;7555273745;Ne;0;0;2;2
10079;Saulėtekis;NYKŠTUKAI;1416983683;Ne;3;4;2;9
10080;Saulėtekis;NYKŠTUKAI;4758423356;Ne;3;2;2;7
10081;Saulėtekis;NYKŠTUKAI;9270109327;Ne;2;2;2;6
10082;Saulėtekis;NYKŠTUKAI;5183297420;Ne;1;9;2;12
10083;Saulėtekis;NYKŠTUKAI;8007704080;Ne;3;2;2;7
10084;Saulėtekis;NYKŠTUKAI;8683571534;Ne;1;0;5;6
10085;Saulėtekis;NYKŠTUKAI;9481578412;Ne;4;2;4;10
10086;Saulėtekis;NYKŠTUKAI;8167740525;Ne;3;2;3;8
10087;Saulėtekis;NYKŠTUKAI;7273354670;Ne;0;0;2;2
10088;Saulėtekis;NYKŠTUKAI;3371045145;Ne;0;0;1;1
10089;Saulėtekis;NYKŠTUKAI;9818660340;Ne;0;2;4;6
10090;Saulėtekis;NYKŠTUKAI;3729811521;Ne;0;2;0;2
10091;Saulėtekis;NYKŠTUKAI;5888979911;Ne;0;10;0;10
10092;Saulėtekis;NYKŠTUKAI;8090571664;Ne;4;2;2;8
10093;Saulėtekis;NYKŠTUKAI;9104549419;Ne;0;1;0;1
10094;Saulėtekis;NYKŠTUKAI;3957655772;Ne;3;2;2;7
10095;Saulėtekis;NYKŠTUKAI;1331793286;Ne;6;4;2;12
10096;Saulėtekis;NYKŠTUKAI;8927598999;Ne;17;0;3;20
10097;Saulėtekis;PAGRANDUKAS;8098047919;Ne;0;9;0;9
10098;Saulėtekis;PAGRANDUKAS;8240764949;Ne;1;2;8;11
10099;Saulėtekis;PAGRANDUKAS;6763015593;Ne;6;5;4;15
10100;Saulėtekis;PAGRANDUKAS;5970957754;Ne;1;2;4;7
10101;Saulėtekis;PAGRANDUKAS;5252265065;Taip;15;0;2;17
10102;Saulėtekis;PAGRANDUKAS;3903728416;Ne;4;2;3;9
10103;Saulėtekis;PAGRANDUKAS;3096623181;Ne;2;0;1;3
10104;Saulėtekis;PAGRANDUKAS;6029401583;Ne;18;2;2;22
10105;Saulėtekis;PAGRANDUKAS;5321135231;Ne;3;0;6;9
10106;Saulėtekis;PAGRANDUKAS;6008705995;Ne;0;2;0;2
10107;Saulėtekis;PAGRANDUKAS;5173602064;Ne;2;2;2;6
10108;Saulėtekis;PAGRANDUKAS;3142594542;Ne;3;2;2;7
10109;Saulėtekis;PAGRANDUKAS;1734813803;Ne;3;0;3;6
10110;Saulėtekis;PAGRANDUKAS;6966791665;Ne;4;2;2;8
10111;Saulėtekis;PAGRANDUKAS;7293735126;Ne;1;2;2;5
10112;Saulėtekis;PAGRANDUKAS;4066394876;Ne;4;2;5;11
10113;Saulėtekis;PAGRANDUKAS;9575338070;Ne;16;0;4;20
10114;Saulėtekis;RAMUNĖLIŲ;8739919774;Ne;17;0;1;18
10115;Saulėtekis;RAMUNĖLIŲ;4681031693;Ne;5;5;2;12
10116;Saulėtekis;RAMUNĖLIŲ;2316817605;Ne;7;2;3;12
10117;Saulėtekis;RAMUNĖLIŲ;3987535802;Ne;4;1;4;9
10118;Saulėtekis;RAMUNĖLIŲ;5297650157;Ne;1;0;2;3
10119;Saulėtekis;RAMUNĖLIŲ;6979741482;Ne;0;2;1;3
10120;Saulėtekis;RAMUNĖLIŲ;8348456528;Ne;3;2;2;7
10121;Saulėtekis;RAMUNĖLIŲ;3430209353;Ne;2;0;1;3
10122;Saulėtekis;RAMUNĖLIŲ;5980690239;Ne;4;2;2;8
10123;Saulėtekis;RAMUNĖLIŲ;2786112846;Ne;3;2;2;7
10124;Saulėtekis;RAMUNĖLIŲ;8876580678;Ne;3;2;2;7
10125;Saulėtekis;RAMUNĖLIŲ;1427323748;Ne;4;0;3;7
10126;Saulėtekis;RAMUNĖLIŲ;3224110585;Ne;15;0;4;19
10127;Saulėtekis;RAMUNĖLIŲ;2002180753;Ne;0;2;5;7
10128;Saulėtekis;RAMUNĖLIŲ;5685176596;Ne;0;2;1;3
10129;Saulėtekis;RAMUNĖLIŲ;9668125862;Ne;5;2;3;10
10130;Saulėtekis;RAMUNĖLIŲ;4736430248;Ne;5;2;7;14
10131;Saulėtekis;RAMUNĖLIŲ;1108736588;Ne;3;0;4;7
10132;Saulėtekis;RAMUNĖLIŲ;3680199463;Ne;5;2;5;12
10133;Saulėtekis;RAMUNĖLIŲ;2383861394;Ne;5;2;2;9
10134;Saulėtekis;RAMUNĖLIŲ;2872732978;Ne;2;0;1;3
10135;Saulėtekis;RAMUNĖLIŲ;9732352141;Ne;0;2;3;5
10136;Saulėtekis;RAMUNĖLIŲ;7494641077;Ne;0;7;0;7
10137;Saulėtekis;RAMUNĖLIŲ;1577609727;Ne;0;7;0;7
10138;Saulėtekis;PASAKAITĖ;8033763960;Ne;0;3;2;5
10139;Saulėtekis;PASAKAITĖ;5086871001;Ne;0;2;2;4
10140;Saulėtekis;PASAKAITĖ;2446282019;Ne;0;1;0;1
10141;Saulėtekis;PASAKAITĖ;8572701238;Ne;0;1;0;1
10142;Saulėtekis;PASAKAITĖ;6063956790;Ne;0;2;0;2
10143;Saulėtekis;PASAKAITĖ;4437540996;Ne;4;3;2;9
10144;Saulėtekis;PASAKAITĖ;7407451018;Ne;0;2;0;2
10145;Saulėtekis;PASAKAITĖ;9226317303;Ne;0;5;0;5
10146;Saulėtekis;PASAKAITĖ;9267790598;Ne;4;2;4;10
10147;Saulėtekis;PASAKAITĖ;6720758829;Taip;3;0;2;5
10148;Saulėtekis;PASAKAITĖ;7966714585;Ne;0;2;0;2
10149;Saulėtekis;PASAKAITĖ;3224883243;Ne;2;2;3;7
10150;Saulėtekis;PASAKAITĖ;9382031144;Ne;1;7;2;10
10151;Saulėtekis;PASAKAITĖ;3371914339;Ne;0;7;0;7
10152;Saulėtekis;PASAKAITĖ;6214539956;Ne;5;4;2;11
10153;Saulėtekis;PASAKAITĖ;9584556476;Ne;0;7;0;7
10154;Saulėtekis;PASAKAITĖ;9799880235;Ne;0;8;0;8
10155;Saulėtekis;PASAKAITĖ;2469458604;Ne;0;1;0;1
10156;Saulėtekis;PASAKAITĖ;3499575148;Ne;3;2;2;7
10157;Saulėtekis;PASAKAITĖ;2206038658;Ne;5;2;2;9
10158;Saulėtekis;PASAKAITĖ;7826554599;Ne;0;3;2;5
10159;Saulėtekis;VARPELIAI;3303064486;Ne;4;0;4;8
10160;Saulėtekis;VARPELIAI;8195320453;Ne;5;0;3;8
10161;Saulėtekis;VARPELIAI;5997903066;Ne;2;0;1;3
10162;Saulėtekis;VARPELIAI;9383203972;Ne;3;0;2;5
10163;Saulėtekis;VARPELIAI;5870177112;Ne;1;2;3;6
10164;Saulėtekis;VARPELIAI;7171550857;Ne;2;0;3;5
10165;Saulėtekis;VARPELIAI;3157110037;Ne;2;2;4;8
10166;Saulėtekis;VARPELIAI;8331659142;Ne;3;0;4;7
10167;Saulėtekis;VARPELIAI;1479530265;Ne;2;2;2;6
10168;Saulėtekis;VARPELIAI;1164913351;Ne;0;2;5;7
10169;Saulėtekis;VARPELIAI;3499215193;Ne;0;0;1;1
10170;Saulėtekis;VARPELIAI;5165684803;Ne;8;0;2;10
10171;Saulėtekis;VARPELIAI;3780019474;Ne;7;0;2;9
10172;Saulėtekis;VARPELIAI;9615110873;Ne;2;0;1;3
10173;Saulėtekis;VARPELIAI;7423380888;Ne;8;0;3;11
10174;Saulėtekis;VARPELIAI;2621773226;Ne;6;0;2;8
10175;Saulėtekis;VARPELIAI;4592401190;Ne;2;0;3;5
10176;Saulėtekis;VARPELIAI;3832717108;Ne;6;1;2;9
10177;Saulėtekis;GRŪDELIS;1864236745;Ne;1;2;2;5
10178;Saulėtekis;GRŪDELIS;6535620172;Ne;12;0;3;15
10179;Saulėtekis;GRŪDELIS;8252953405;Taip;0;2;5;7
10180;Saulėtekis;GRŪDELIS;8219644557;Ne;0;2;3;5
10181;Saulėtekis;GRŪDELIS;9646060606;Ne;0;4;1;5
10182;Saulėtekis;GRŪDELIS;1934900185;Ne;8;0;6;14
10183;Saulėtekis;GRŪDELIS;9995919137;Ne;1;3;2;6
10184;Saulėtekis;GRŪDELIS;8138047893;Ne;0;2;4;6
10185;Saulėtekis;GRŪDELIS;3953501167;Ne;7;2;4;13
10186;Saulėtekis;GRŪDELIS;2646213073;Ne;4;0;2;6
10187;Saulėtekis;GRŪDELIS;6482182524;Ne;0;4;0;4
10188;Saulėtekis;GRŪDELIS;6779891385;Ne;1;2;2;5
10189;Saulėtekis;GRŪDELIS;9743690247;Ne;10;0;4;14
10190;Saulėtekis;GRŪDELIS;7666624373;Ne;4;0;4;8
10191;Saulėtekis;GRŪDELIS;8061477303;Ne;0;2;2;4
10192;Saulėtekis;GRŪDELIS;2568544418;Ne;0;0;4;4
10193;Saulėtekis;GRŪDELIS;9734188792;Ne;12;2;4;18
10194;Saulėtekis;GRŪDELIS;6983324115;Ne;0;2;2;4
10195;Saulėtekis;GRŪDELIS;9787534807;Ne;2;0;3;5
10196;Saulėtekis;JONVABALIS;8239855620;Ne;0;2;1;3
10197;Saulėtekis;JONVABALIS;8603952810;Ne;0;2;7;9
10198;Saulėtekis;JONVABALIS;8881524909;Ne;7;2;2;11
10199;Saulėtekis;JONVABALIS;7673965242;Ne;11;2;4;17
10200;Saulėtekis;JONVABALIS;7730889108;Ne;0;2;10;12
10201;Saulėtekis;JONVABALIS;2686041419;Ne;0;5;0;5
10202;Saulėtekis;JONVABALIS;3166959569;Ne;0;4;0;4
10203;Saulėtekis;JONVABALIS;9972687066;Ne;0;2;2;4
10204;Saulėtekis;JONVABALIS;9661075465;Ne;0;3;0;3
10205;Saulėtekis;JONVABALIS;7346852524;Ne;2;0;4;6
10206;Saulėtekis;JONVABALIS;5518726567;Ne;2;0;5;7
10207;Saulėtekis;JONVABALIS;6072030240;Ne;0;2;2;4
10208;Saulėtekis;JONVABALIS;7435424899;Ne;0;2;4;6
10209;Saulėtekis;JONVABALIS;2177470008;Ne;0;8;0;8
10210;Saulėtekis;JONVABALIS;7803735686;Ne;0;2;0;2
10211;Saulėtekis;JONVABALIS;7505040675;Ne;3;2;2;7
10212;Saulėtekis;JONVABALIS;8143793642;Ne;0;3;0;3
10213;Saulėtekis;JONVABALIS;1720125332;Ne;0;2;1;3
10214;Saulėtekis;JONVABALIS;9694119292;Ne;3;2;6;11
10215;Saulėtekis;JONVABALIS;9791926936;Ne;4;2;4;10
10216;Saulėtekis;JONVABALIS;6608831217;Ne;0;3;0;3
10217;Saulėtekis;JONVABALIS;8023603198;Ne;0;2;1;3
10218;Saulėtekis;SMALSUČIAI;9941731250;Ne;0;2;1;3
10219;Saulėtekis;SMALSUČIAI;8102360466;Ne;0;2;4;6
10220;Saulėtekis;SMALSUČIAI;2371396923;Ne;0;2;1;3
10221;Saulėtekis;SMALSUČIAI;1020209414;Ne;2;1;2;5
10222;Saulėtekis;SMALSUČIAI;8745921541;Ne;0;3;1;4
10223;Saulėtekis;SMALSUČIAI;2728836108;Ne;0;2;2;4
10224;Saulėtekis;SMALSUČIAI;7164579375;Ne;0;2;0;2
10225;Saulėtekis;SMALSUČIAI;4038684284;Ne;5;2;2;9
10226;Saulėtekis;SMALSUČIAI;8390615573;Ne;0;2;1;3
10227;Saulėtekis;SMALSUČIAI;8574702901;Ne;3;2;3;8
10228;Saulėtekis;SMALSUČIAI;7186085219;Ne;0;9;1;10
10229;Saulėtekis;SMALSUČIAI;2209156661;Ne;0;2;2;4
10230;Saulėtekis;SMALSUČIAI;5552614092;Ne;0;2;0;2
10231;Saulėtekis;SMALSUČIAI;3366064429;Ne;0;6;1;7
10232;Saulėtekis;SMALSUČIAI;9870595577;Ne;0;2;2;4
10233;Saulėtekis;SMALSUČIAI;7766084857;Ne;0;2;0;2
10234;Saulėtekis;SMALSUČIAI;2154590089;Ne;0;2;0;2
10235;Saulėtekis;SMALSUČIAI;3220993253;Ne;0;2;0;2
10236;Saulėtekis;SMALSUČIAI;2698535938;Ne;0;2;2;4
10237;Saulėtekis;SMALSUČIAI;8517049464;Ne;4;1;2;7
10238;Saulėtekis;SMALSUČIAI;8620689981;Ne;0;2;1;3
10239;Saulėtekis;BITUTĖS;4252302344;Ne;7;2;2;11
10240;Saulėtekis;BITUTĖS;9382796391;Ne;6;0;5;11
10241;Saulėtekis;BITUTĖS;2095103400;Ne;6;0;5;11
10242;Saulėtekis;BITUTĖS;7614555277;Ne;8;0;2;10
10243;Saulėtekis;BITUTĖS;7308749675;Ne;0;6;1;7
10244;Saulėtekis;BITUTĖS;3898675190;Ne;5;0;7;12
10245;Saulėtekis;BITUTĖS;4135680619;Ne;1;2;2;5
10246;Saulėtekis;BITUTĖS;3768954974;Ne;14;0;3;17
10247;Saulėtekis;BITUTĖS;2939151459;Ne;6;0;5;11
10248;Saulėtekis;BITUTĖS;8522059028;Ne;3;0;2;5
10249;Saulėtekis;BITUTĖS;2790163936;Ne;14;0;2;16
10250;Saulėtekis;BITUTĖS;9649078106;Taip;3;0;5;8
10251;Saulėtekis;BITUTĖS;9892315045;Ne;3;2;4;9
10252;Saulėtekis;BITUTĖS;8890060293;Ne;3;1;2;6
10253;Saulėtekis;BITUTĖS;3954368962;Ne;1;0;3;4
10254;Saulėtekis;BITUTĖS;3349025533;Ne;12;4;2;18
10255;Saulėtekis;BITUTĖS;6945891800;Ne;14;0;2;16
10256;Saulėtekis;BITUTĖS;6468360941;Ne;16;2;2;20
10257;Saulėtekis;RIEŠUTĖLIAI;8767786444;Ne;8;2;2;12
10258;Saulėtekis;RIEŠUTĖLIAI;2224626144;Ne;12;0;4;16
10259;Saulėtekis;RIEŠUTĖLIAI;9270231819;Ne;0;1;2;3
10260;Saulėtekis;RIEŠUTĖLIAI;5898051775;Ne;1;0;2;3
10261;Saulėtekis;RIEŠUTĖLIAI;7898928446;Ne;1;0;2;3
10262;Saulėtekis;RIEŠUTĖLIAI;3356705340;Ne;9;0;4;13
10263;Saulėtekis;RIEŠUTĖLIAI;7824492464;Ne;4;1;2;7
10264;Saulėtekis;RIEŠUTĖLIAI;3935935671;Ne;0;0;1;1
10265;Saulėtekis;RIEŠUTĖLIAI;7807096583;Ne;1;0;4;5
10266;Saulėtekis;RIEŠUTĖLIAI;2548612572;Ne;12;2;2;16
10267;Saulėtekis;RIEŠUTĖLIAI;2908714227;Ne;8;0;8;16
10268;Saulėtekis;RIEŠUTĖLIAI;7305619721;Ne;0;0;18;18
10269;Saulėtekis;RIEŠUTĖLIAI;9516841263;Ne;8;0;2;10
10270;Saulėtekis;RIEŠUTĖLIAI;6557482092;Ne;4;0;2;6
10271;Saulėtekis;RIEŠUTĖLIAI;1540848694;Ne;0;2;0;2
10272;Saulėtekis;RIEŠUTĖLIAI;3559882322;Ne;0;3;1;4
10273;Saulėtekis;RIEŠUTĖLIAI;4767842376;Ne;4;0;4;8
10274;Saulėtekis;RIEŠUTĖLIAI;9351147084;Ne;5;0;3;8
10275;Saulėtekis;RIEŠUTĖLIAI;9246555859;Ne;2;0;3;5
10276;Saulėtekis;RIEŠUTĖLIAI;7338301696;Ne;4;1;2;7
10277;Saulėtekis;RIEŠUTĖLIAI;3206247299;Ne;3;2;4;9
10278;Skroblinukas;SVIRPLIUKŲ;2195112297;Ne;1;0;8;9
10279;Skroblinukas;SVIRPLIUKŲ;4198512202;Ne;8;0;14;22
10280;Skroblinukas;SVIRPLIUKŲ;7750501815;Ne;0;0;12;12
10281;Skroblinukas;SVIRPLIUKŲ;1544598440;Ne;0;4;0;4
10282;Skroblinukas;SVIRPLIUKŲ;6574558658;Ne;3;0;3;6
10283;Skroblinukas;SVIRPLIUKŲ;4861971439;Ne;5;0;2;7
10284;Skroblinukas;SVIRPLIUKŲ;7817632987;Ne;0;3;1;4
10285;Skroblinukas;SVIRPLIUKŲ;7675772872;Ne;0;7;0;7
10286;Skroblinukas;SVIRPLIUKŲ;4266945644;Ne;9;0;6;15
10287;Skroblinukas;SVIRPLIUKŲ;7216760382;Ne;2;0;2;4
10288;Skroblinukas;SVIRPLIUKŲ;5154111867;Ne;3;9;2;14
10289;Skroblinukas;SVIRPLIUKŲ;8622930871;Ne;16;0;16;32
10290;Skroblinukas;SVIRPLIUKŲ;9661609284;Ne;3;0;2;5
10291;Skroblinukas;SVIRPLIUKŲ;3260267388;Ne;0;18;0;18
10292;Skroblinukas;SVIRPLIUKŲ;7761972818;Ne;0;9;0;9
10293;Skroblinukas;SVIRPLIUKŲ;9629502585;Ne;0;2;0;2
10294;Skroblinukas;SVIRPLIUKŲ;6461678336;Ne;2;0;0;2
10295;Skroblinukas;SVIRPLIUKŲ;8283516422;Ne;7;0;5;12
10296;Skroblinukas;GANDRIUKŲ;2197158518;Ne;0;1;2;3
10297;Skroblinukas;GANDRIUKŲ;2406619611;Ne;6;8;2;16
10298;Skroblinukas;GANDRIUKŲ;5646847921;Ne;0;10;0;10
10299;Skroblinukas;GANDRIUKŲ;1851920334;Ne;0;3;0;3
10300;Skroblinukas;GANDRIUKŲ;9377215921;Ne;0;14;0;14
10301;Skroblinukas;GANDRIUKŲ;6235844690;Ne;0;2;0;2
10302;Skroblinukas;GANDRIUKŲ;6489976163;Ne;6;2;2;10
10303;Skroblinukas;GANDRIUKŲ;1159546580;Ne;0;2;0;2
10304;Skroblinukas;GANDRIUKŲ;2630699296;Ne;0;2;0;2
10305;Skroblinukas;GANDRIUKŲ;2310750833;Ne;0;6;1;7
10306;Skroblinukas;GANDRIUKŲ;9888115079;Ne;0;7;0;7
10307;Skroblinukas;GANDRIUKŲ;9475514959;Ne;0;11;0;11
10308;Skroblinukas;GANDRIUKŲ;9031598603;Ne;2;2;1;5
10309;Skroblinukas;GANDRIUKŲ;5251903769;Ne;0;24;0;24
10310;Skroblinukas;GANDRIUKŲ;7385271438;Ne;0;7;5;12
10311;Skroblinukas;GANDRIUKŲ;7274368180;Ne;6;1;5;12
10312;Skroblinukas;GANDRIUKŲ;9541682085;Ne;0;2;0;2
10313;Skroblinukas;GANDRIUKŲ;1369962422;Ne;7;2;4;13
10314;Skroblinukas;VYTURIUKŲ;3954228349;Ne;0;0;2;2
10315;Skroblinukas;VYTURIUKŲ;4560580022;Ne;0;1;0;1
10316;Skroblinukas;VYTURIUKŲ;2330232287;Ne;1;0;3;4
10317;Skroblinukas;VYTURIUKŲ;3065235192;Taip;6;0;2;8
10318;Skroblinukas;VYTURIUKŲ;5902713448;Ne;0;7;0;7
10319;Skroblinukas;VYTURIUKŲ;3594000419;Ne;0;5;0;5
10320;Skroblinukas;VYTURIUKŲ;3512297435;Ne;0;5;0;5
10321;Skroblinukas;VYTURIUKŲ;2481980627;Ne;22;0;0;22
10322;Skroblinukas;VYTURIUKŲ;9725125130;Ne;1;2;2;5
10323;Skroblinukas;VYTURIUKŲ;2978284436;Ne;0;0;2;2
10324;Skroblinukas;VYTURIUKŲ;7068452970;Ne;10;0;2;12
10325;Skroblinukas;VYTURIUKŲ;3292517112;Ne;0;3;0;3
10326;Skroblinukas;VYTURIUKŲ;4129726208;Ne;0;0;3;3
10327;Skroblinukas;VYTURIUKŲ;5101136022;Ne;6;2;2;10
10328;Skroblinukas;VYTURIUKŲ;9828486832;Ne;0;1;2;3
10329;Skroblinukas;VYTURIUKŲ;2263955772;Ne;0;15;0;15
10330;Skroblinukas;VYTURIUKŲ;9731326488;Ne;9;2;3;14
10331;Skroblinukas;GENIUKŲ;6011466024;Ne;0;3;0;3
10332;Skroblinukas;GENIUKŲ;8629189405;Taip;8;1;2;11
10333;Skroblinukas;GENIUKŲ;9809817630;Ne;10;0;4;14
10334;Skroblinukas;GENIUKŲ;8544069746;Ne;0;5;0;5
10335;Skroblinukas;GENIUKŲ;6475609065;Ne;15;0;2;17
10336;Skroblinukas;GENIUKŲ;4091852305;Ne;0;4;0;4
10337;Skroblinukas;GENIUKŲ;1820748152;Ne;0;2;0;2
10338;Skroblinukas;GENIUKŲ;3705638869;Ne;8;0;2;10
10339;Skroblinukas;GENIUKŲ;2511496284;Ne;17;0;2;19
10340;Skroblinukas;GENIUKŲ;7153774246;Ne;0;2;1;3
10341;Skroblinukas;GENIUKŲ;7045587415;Ne;4;1;5;10
10342;Skroblinukas;GENIUKŲ;5946356374;Ne;12;0;5;17
10343;Skroblinukas;GENIUKŲ;5274898590;Ne;0;5;0;5
10344;Skroblinukas;GENIUKŲ;1167332689;Ne;0;1;0;1
10345;Skroblinukas;GENIUKŲ;4491947846;Ne;2;3;2;7
10346;Skroblinukas;GENIUKŲ;7955574061;Ne;4;0;2;6
10347;Skroblinukas;GENIUKŲ;9162582460;Ne;2;0;4;6
10348;Skroblinukas;GENIUKŲ;1014993354;Ne;6;1;3;10
10349;Skroblinukas;GENIUKŲ;1232121301;Ne;0;3;0;3
10350;Skroblinukas;GENIUKŲ;8680329175;Ne;3;2;3;8
10351;Skroblinukas;BITUČIŲ;4639384934;Ne;5;0;2;7
10352;Skroblinukas;BITUČIŲ;5206925237;Ne;0;0;2;2
10353;Skroblinukas;BITUČIŲ;7581372511;Ne;6;1;2;9
10354;Skroblinukas;BITUČIŲ;6717008836;Ne;11;4;2;17
10355;Skroblinukas;BITUČIŲ;8998236911;Ne;6;2;2;10
10356;Skroblinukas;BITUČIŲ;6791969485;Ne;3;3;2;8
10357;Skroblinukas;BITUČIŲ;2363368201;Ne;19;0;1;20
10358;Skroblinukas;BITUČIŲ;2885814517;Ne;0;1;0;1
10359;Skroblinukas;BITUČIŲ;5354832150;Ne;8;5;2;15
10360;Skroblinukas;BITUČIŲ;5841866621;Ne;4;1;2;7
10361;Skroblinukas;BITUČIŲ;4688496560;Ne;0;2;0;2
10362;Skroblinukas;BITUČIŲ;9341501143;Ne;7;0;4;11
10363;Skroblinukas;BITUČIŲ;3490684777;Ne;4;2;3;9
10364;Skroblinukas;BITUČIŲ;2717586232;Taip;4;0;2;6
10365;Skroblinukas;BITUČIŲ;4840767748;Ne;5;0;2;7
10366;Skroblinukas;BITUČIŲ;9513546028;Ne;6;0;2;8
10367;Skroblinukas;BITUČIŲ;8715188878;Ne;0;7;0;7
10368;Skroblinukas;BITUČIŲ;4631657273;Ne;4;0;3;7
10369;Skroblinukas;BITUČIŲ;7255510731;Ne;6;0;3;9
10370;Skroblinukas;BITUČIŲ;5694105568;Ne;5;0;2;7
10371;Skroblinukas;BORUŽĖLIŲ;2523742608;Ne;0;0;4;4
10372;Skroblinukas;BORUŽĖLIŲ;2311459579;Ne;3;0;4;7
10373;Skroblinukas;BORUŽĖLIŲ;7771969055;Ne;0;2;0;2
10374;Skroblinukas;BORUŽĖLIŲ;8711201474;Ne;4;2;4;10
10375;Skroblinukas;BORUŽĖLIŲ;8414376518;Ne;7;0;2;9
10376;Skroblinukas;BORUŽĖLIŲ;2166244766;Ne;6;7;2;15
10377;Skroblinukas;BORUŽĖLIŲ;7729612420;Ne;9;1;6;16
10378;Skroblinukas;BORUŽĖLIŲ;5082212661;Ne;6;0;2;8
10379;Skroblinukas;BORUŽĖLIŲ;4904084567;Ne;3;0;2;5
10380;Skroblinukas;BORUŽĖLIŲ;1357700154;Ne;9;0;4;13
10381;Skroblinukas;BORUŽĖLIŲ;2095608208;Ne;0;0;4;4
10382;Skroblinukas;BORUŽĖLIŲ;7446262781;Ne;5;0;4;9
10383;Skroblinukas;BORUŽĖLIŲ;6005897181;Ne;3;0;2;5
10384;Skroblinukas;BORUŽĖLIŲ;1547123058;Ne;9;0;2;11
10385;Skroblinukas;SKRUZDĖLIUKŲ;5688453546;Ne;0;4;2;6
10386;Skroblinukas;SKRUZDĖLIUKŲ;6445065388;Ne;0;5;0;5
10387;Skroblinukas;SKRUZDĖLIUKŲ;3006521657;Ne;0;1;0;1
10388;Skroblinukas;SKRUZDĖLIUKŲ;9448253468;Ne;0;2;0;2
10389;Skroblinukas;SKRUZDĖLIUKŲ;3771045336;Ne;0;7;0;7
10390;Skroblinukas;SKRUZDĖLIUKŲ;4424763028;Ne;0;4;0;4
10391;Skroblinukas;SKRUZDĖLIUKŲ;5252389111;Ne;0;1;0;1
10392;Skroblinukas;SKRUZDĖLIUKŲ;2883593274;Ne;0;2;0;2
10393;Skroblinukas;SKRUZDĖLIUKŲ;7493915017;Ne;1;0;3;4
10394;Skroblinukas;SKRUZDĖLIUKŲ;5157913924;Ne;2;7;2;11
10395;Skroblinukas;SKRUZDĖLIUKŲ;9368764758;Ne;0;7;0;7
10396;Skroblinukas;SKRUZDĖLIUKŲ;8576448571;Ne;0;4;0;4
10397;Skroblinukas;SKRUZDĖLIUKŲ;3290115134;Ne;0;10;0;10
10398;Skroblinukas;SKRUZDĖLIUKŲ;9813249677;Ne;0;2;0;2
10399;Skroblinukas;SKRUZDĖLIUKŲ;2101748012;Ne;0;0;1;1
10400;Skroblinukas;SKRUZDĖLIUKŲ;5915278745;Ne;0;2;0;2
10401;Skroblinukas;SKRUZDĖLIUKŲ;6640062847;Ne;0;3;0;3
10402;Skroblinukas;SKRUZDĖLIUKŲ;5433647187;Ne;4;2;2;8
10403;Skroblinukas;ŽVIRBLIUKŲ;3041669079;Ne;5;0;3;8
10404;Skroblinukas;ŽVIRBLIUKŲ;6068248705;Ne;7;0;7;14
10405;Skroblinukas;ŽVIRBLIUKŲ;3117532423;Ne;0;0;2;2
10406;Skroblinukas;ŽVIRBLIUKŲ;8124086303;Ne;5;1;4;10
10407;Skroblinukas;ŽVIRBLIUKŲ;7640540309;Ne;0;2;0;2
10408;Skroblinukas;ŽVIRBLIUKŲ;3858667425;Ne;4;0;7;11
10409;Skroblinukas;ŽVIRBLIUKŲ;1996484086;Ne;3;2;4;9
10410;Skroblinukas;ŽVIRBLIUKŲ;6135412007;Ne;4;0;6;10
10411;Skroblinukas;ŽVIRBLIUKŲ;2312400921;Ne;5;0;6;11
10412;Skroblinukas;ŽVIRBLIUKŲ;7804920443;Ne;11;0;4;15
10413;Skroblinukas;ŽVIRBLIUKŲ;4197050176;Ne;0;7;0;7
10414;Skroblinukas;ŽVIRBLIUKŲ;4390614970;Ne;13;0;8;21
10415;Skroblinukas;ŽIOGELIŲ;6279909049;Ne;9;0;2;11
10416;Skroblinukas;ŽIOGELIŲ;9737310101;Ne;0;0;1;1
10417;Skroblinukas;ŽIOGELIŲ;8118284793;Ne;4;0;3;7
10418;Skroblinukas;ŽIOGELIŲ;1844211217;Ne;7;0;3;10
10419;Skroblinukas;ŽIOGELIŲ;4266029484;Ne;0;1;0;1
10420;Skroblinukas;ŽIOGELIŲ;5983714050;Ne;0;11;0;11
10421;Skroblinukas;ŽIOGELIŲ;9191337531;Ne;29;0;2;31
10422;Skroblinukas;ŽIOGELIŲ;2941319404;Ne;9;0;6;15
10423;Skroblinukas;ŽIOGELIŲ;7912986106;Ne;3;0;19;22
10424;Skroblinukas;ŽIOGELIŲ;3909811358;Ne;3;1;2;6
10425;Skroblinukas;ŽIOGELIŲ;4718949638;Ne;0;2;0;2
10426;Skroblinukas;ŽIOGELIŲ;7650915045;Ne;5;0;3;8
10427;Skroblinukas;ŽIOGELIŲ;6444788760;Ne;0;3;0;3
10428;Skroblinukas;ŽIOGELIŲ;6070633607;Ne;0;0;1;1
10429;Skroblinukas;STRAZDELIŲ;8898971191;Ne;1;3;2;6
10430;Skroblinukas;STRAZDELIŲ;7480868540;Ne;6;0;4;10
10431;Skroblinukas;STRAZDELIŲ;1762416639;Ne;0;1;1;2
10432;Skroblinukas;STRAZDELIŲ;7483556761;Ne;4;0;2;6
10433;Skroblinukas;STRAZDELIŲ;1306489851;Ne;13;0;2;15
10434;Skroblinukas;STRAZDELIŲ;1846830752;Ne;0;0;7;7
10435;Skroblinukas;STRAZDELIŲ;4500841908;Ne;3;4;2;9
10436;Skroblinukas;STRAZDELIŲ;8734405028;Ne;1;6;2;9
10437;Skroblinukas;STRAZDELIŲ;2132271995;Ne;0;6;2;8
10438;Skroblinukas;STRAZDELIŲ;5781343695;Ne;2;2;6;10
10439;Skroblinukas;STRAZDELIŲ;9524875796;Ne;2;1;4;7
10440;Skroblinukas;STRAZDELIŲ;9753194124;Ne;9;0;6;15
10441;Skroblinukas;DRUGELIŲ;8305867345;Ne;0;0;1;1
10442;Skroblinukas;DRUGELIŲ;7400908711;Ne;0;19;0;19
10443;Skroblinukas;DRUGELIŲ;3889890374;Ne;0;7;0;7
10444;Skroblinukas;DRUGELIŲ;8864594520;Ne;0;2;0;2
10445;Skroblinukas;DRUGELIŲ;2772360168;Ne;0;2;0;2
10446;Skroblinukas;DRUGELIŲ;3624518310;Ne;0;1;0;1
10447;Skroblinukas;DRUGELIŲ;4831370981;Ne;0;1;0;1
10448;Skroblinukas;DRUGELIŲ;5957417413;Ne;0;1;0;1
10449;Skroblinukas;DRUGELIŲ;3226115050;Ne;0;1;0;1
10450;Skroblinukas;DRUGELIŲ;2887161771;Ne;0;1;0;1
10451;Skroblinukas;DRUGELIŲ;4737605061;Ne;0;2;0;2
10452;Skroblinukas;DRUGELIŲ;8390240445;Ne;0;0;1;1
10453;Skroblinukas;DRUGELIŲ;2948231687;Ne;0;0;2;2
10454;Skroblinukas;DRUGELIŲ;5912771080;Ne;3;2;2;7
10455;Skroblinukas;DRUGELIŲ;7528824951;Ne;6;0;2;8
10456;Skroblinukas;DRUGELIŲ;2987938909;Ne;0;8;2;10
10457;Skroblinukas;DRUGELIŲ;8064713969;Ne;0;2;2;4
10458;Skroblinukas;DRUGELIŲ;8286842648;Ne;0;0;1;1
10459;Skroblinukas;DRUGELIŲ;1453029732;Ne;4;6;4;14
10460;Skroblinukas;PELĖDŽIUKŲ;8953844650;Ne;0;0;2;2
10461;Skroblinukas;PELĖDŽIUKŲ;5813075721;Ne;6;0;2;8
10462;Skroblinukas;PELĖDŽIUKŲ;3646325903;Ne;0;3;0;3
10463;Skroblinukas;PELĖDŽIUKŲ;9292990596;Ne;0;1;0;1
10464;Skroblinukas;PELĖDŽIUKŲ;8202855376;Ne;0;0;22;22
10465;Skroblinukas;PELĖDŽIUKŲ;8312341293;Ne;0;3;0;3
10466;Skroblinukas;PELĖDŽIUKŲ;3658815079;Ne;3;0;2;5
10467;Skroblinukas;PELĖDŽIUKŲ;5418212729;Ne;2;0;0;2
10468;Skroblinukas;PELĖDŽIUKŲ;4168542339;Ne;4;5;4;13
10469;Skroblinukas;PELĖDŽIUKŲ;8958893525;Ne;3;5;0;8
10470;Skroblinukas;PELĖDŽIUKŲ;6675716937;Ne;2;0;0;2
10471;Skroblinukas;PELĖDŽIUKŲ;1009065470;Ne;4;5;2;11
10472;Skroblinukas;PELĖDŽIUKŲ;9553242594;Ne;0;2;0;2
10473;Skroblinukas;PELĖDŽIUKŲ;1758987652;Ne;0;0;1;1
10474;Skroblinukas;PELĖDŽIUKŲ;8465074037;Ne;0;1;0;1
10475;Skroblinukas;PELĖDŽIUKŲ;2071093890;Ne;0;2;1;3
10476;Skroblinukas;PELĖDŽIUKŲ;9523720873;Ne;3;9;2;14
10477;Skroblinukas;PELĖDŽIUKŲ;7920117036;Ne;0;2;2;4
10478;Skroblinukas;PELĖDŽIUKŲ;2215428081;Ne;0;0;2;2
10479;Smalsučiai;Žibuoklės;6535494814;Ne;8;0;3;11
10480;Smalsučiai;Žibuoklės;3309134310;Ne;8;4;2;14
10481;Smalsučiai;Žibuoklės;2326167599;Ne;0;1;1;2
10482;Smalsučiai;Žibuoklės;4094037708;Ne;2;0;1;3
10483;Smalsučiai;Žibuoklės;5893045664;Ne;0;2;0;2
10484;Smalsučiai;Žibuoklės;2742992400;Ne;4;0;5;9
10485;Smalsučiai;Žibuoklės;6299355505;Taip;0;2;0;2
10486;Smalsučiai;Žibuoklės;3877274360;Ne;8;3;3;14
10487;Smalsučiai;Žibuoklės;7726086066;Ne;0;1;0;1
10488;Smalsučiai;Žibuoklės;9988599126;Ne;4;0;4;8
10489;Smalsučiai;Žibuoklės;5489140006;Ne;0;2;3;5
10490;Smalsučiai;Žibuoklės;5900294530;Ne;0;0;3;3
10491;Smalsučiai;Žibuoklės;1380214235;Ne;0;0;2;2
10492;Smalsučiai;Žibuoklės;3071594259;Ne;3;0;2;5
10493;Smalsučiai;Žibuoklės;7107126092;Ne;3;0;2;5
10494;Smalsučiai;Žibuoklės;7070240693;Ne;0;1;2;3
10495;Smalsučiai;Žibuoklės;8259056296;Ne;0;0;11;11
10496;Smalsučiai;Žibuoklės;9637877396;Ne;0;2;5;7
10497;Smalsučiai;Aitvarų;3349726106;Ne;3;2;5;10
10498;Smalsučiai;Aitvarų;2219168902;Ne;0;7;1;8
10499;Smalsučiai;Aitvarų;9305837033;Ne;0;6;0;6
10500;Smalsučiai;Aitvarų;9305837033;Ne;0;6;0;6
10501;Smalsučiai;Aitvarų;9305837033;Ne;0;6;0;6
10502;Smalsučiai;Aitvarų;8877566394;Ne;0;2;2;4
10503;Smalsučiai;Aitvarų;3888093640;Ne;0;2;0;2
10504;Smalsučiai;Aitvarų;8284740122;Taip;12;0;0;12
10505;Smalsučiai;Aitvarų;1309254661;Ne;0;2;0;2
10506;Smalsučiai;Aitvarų;8985656809;Ne;3;0;3;6
10507;Smalsučiai;Aitvarų;6032887449;Ne;3;2;4;9
10508;Smalsučiai;Aitvarų;9821259659;Ne;0;1;0;1
10509;Smalsučiai;Aitvarų;4054278651;Ne;0;0;2;2
10510;Smalsučiai;Aitvarų;6232068532;Ne;0;5;0;5
10511;Smalsučiai;Aitvarų;3157534923;Ne;4;2;2;8
10512;Smalsučiai;Aitvarų;6825499095;Ne;2;0;3;5
10513;Smalsučiai;Aitvarų;4832292565;Ne;0;2;0;2
10514;Smalsučiai;Aitvarų;2835117069;Ne;0;3;0;3
10515;Smalsučiai;Aitvarų;2610753472;Ne;0;2;1;3
10516;Smalsučiai;Aitvarų;6090244401;Ne;6;1;2;9
10517;Smalsučiai;Aitvarų;2350539797;Ne;3;0;2;5
10518;Smalsučiai;Aitvarų;1126565862;Ne;5;8;2;15
10519;Smalsučiai;Aitvarų;1162035522;Ne;0;10;0;10
10520;Smalsučiai;Sraigiukų;7933302912;Ne;0;4;0;4
10521;Smalsučiai;Sraigiukų;1471941426;Ne;0;3;0;3
10522;Smalsučiai;Sraigiukų;1458544456;Ne;0;3;0;3
10523;Smalsučiai;Sraigiukų;5406430393;Ne;0;3;2;5
10524;Smalsučiai;Sraigiukų;9582225178;Ne;0;4;0;4
10525;Smalsučiai;Sraigiukų;9604182559;Ne;0;13;0;13
10526;Smalsučiai;Sraigiukų;6469604093;Ne;0;3;0;3
10527;Smalsučiai;Sraigiukų;4364810458;Ne;0;2;0;2
10528;Smalsučiai;Sraigiukų;4566816316;Ne;1;4;2;7
10529;Smalsučiai;Sraigiukų;5184903287;Ne;0;2;0;2
10530;Smalsučiai;Sraigiukų;7396172351;Ne;0;3;0;3
10531;Smalsučiai;Sraigiukų;6358800570;Ne;0;4;0;4
10532;Smalsučiai;Sraigiukų;2327930850;Ne;0;1;0;1
10533;Smalsučiai;Sraigiukų;3787937467;Ne;0;10;0;10
10534;Smalsučiai;Sraigiukų;3399798448;Ne;1;1;2;4
10535;Smalsučiai;Sraigiukų;1997966082;Ne;0;3;0;3
10536;Smalsučiai;Sraigiukų;9155011285;Ne;0;3;0;3
10537;Smalsučiai;Saulučių;1776385691;Ne;3;0;0;3
10538;Smalsučiai;Saulučių;2259361924;Ne;2;0;1;3
10539;Smalsučiai;Saulučių;1162964613;Taip;0;0;6;6
10540;Smalsučiai;Saulučių;9934952886;Ne;7;0;4;11
10541;Smalsučiai;Saulučių;9556433086;Ne;7;1;2;10
10542;Smalsučiai;Saulučių;1904973393;Ne;7;1;0;8
10543;Smalsučiai;Saulučių;3252901131;Ne;2;0;3;5
10544;Smalsučiai;Saulučių;2392217952;Ne;4;0;4;8
10545;Smalsučiai;Saulučių;1447512509;Ne;2;0;14;16
10546;Smalsučiai;Saulučių;2034284973;Ne;0;8;1;9
10547;Smalsučiai;Saulučių;7423419934;Ne;5;0;2;7
10548;Smalsučiai;Saulučių;7049101015;Ne;0;0;2;2
10549;Smalsučiai;Saulučių;9183519167;Taip;16;0;6;22
10550;Smalsučiai;Saulučių;5708986552;Ne;8;2;4;14
10551;Smalsučiai;Saulučių;4889923629;Ne;2;0;0;2
10552;Smalsučiai;Saulučių;8630411244;Ne;0;2;0;2
10553;Smalsučiai;Saulučių;5541908981;Ne;0;0;2;2
10554;Smalsučiai;Saulučių;6927421427;Ne;2;0;0;2
10555;Smalsučiai;Saulučių;7874635165;Ne;0;0;9;9
10556;Smalsučiai;Saulučių;5536697307;Ne;0;0;22;22
10557;Smalsučiai;Viščiukų;6827441564;Ne;12;0;0;12
10558;Smalsučiai;Viščiukų;4760366724;Ne;0;1;0;1
10559;Smalsučiai;Viščiukų;4847029162;Ne;1;3;0;4
10560;Smalsučiai;Viščiukų;9710944054;Ne;2;2;2;6
10561;Smalsučiai;Viščiukų;5213319192;Ne;6;0;6;12
10562;Smalsučiai;Viščiukų;8210141253;Ne;2;1;2;5
10563;Smalsučiai;Viščiukų;3782502443;Ne;0;3;0;3
10564;Smalsučiai;Viščiukų;6358968221;Ne;1;3;3;7
10565;Smalsučiai;Viščiukų;4030955447;Ne;3;3;2;8
10566;Smalsučiai;Viščiukų;6131743288;Ne;0;0;2;2
10567;Smalsučiai;Viščiukų;1331674807;Ne;7;1;2;10
10568;Smalsučiai;Viščiukų;9984878984;Ne;0;2;0;2
10569;Smalsučiai;Viščiukų;5535858303;Ne;0;0;2;2
10570;Smalsučiai;Viščiukų;2662588310;Ne;0;4;0;4
10571;Smalsučiai;Viščiukų;7318218997;Ne;7;0;4;11
10572;Smalsučiai;Viščiukų;2668720481;Ne;0;1;0;1
10573;Smalsučiai;Viščiukų;2369569130;Ne;0;3;2;5
10574;Smalsučiai;Boružėlių;8606216911;Ne;0;4;0;4
10575;Smalsučiai;Boružėlių;1023255628;Ne;0;1;1;2
10576;Smalsučiai;Boružėlių;9181601713;Taip;0;4;0;4
10577;Smalsučiai;Boružėlių;6642882883;Ne;0;0;2;2
10578;Smalsučiai;Boružėlių;7637630200;Ne;0;2;0;2
10579;Smalsučiai;Boružėlių;1247774684;Ne;0;2;0;2
10580;Smalsučiai;Boružėlių;2375360937;Ne;1;0;2;3
10581;Smalsučiai;Boružėlių;1224857159;Ne;0;3;0;3
10582;Smalsučiai;Boružėlių;2015172985;Ne;0;3;0;3
10583;Smalsučiai;Boružėlių;8893480054;Ne;0;2;3;5
10584;Smalsučiai;Boružėlių;3646740184;Ne;3;2;3;8
10585;Smalsučiai;Boružėlių;6996192450;Ne;0;2;5;7
10586;Smalsučiai;Boružėlių;9378696084;Ne;4;2;6;12
10587;Smalsučiai;Boružėlių;7143824796;Ne;1;0;2;3
10588;Smalsučiai;Boružėlių;7267389695;Ne;13;2;2;17
10589;Smalsučiai;Boružėlių;1344461213;Ne;0;0;2;2
10590;Smalsučiai;Boružėlių;4847212069;Ne;3;1;4;8
10591;Smalsučiai;Boružėlių;8690626891;Ne;0;2;0;2
10592;Smalsučiai;Zuikių;6006832443;Ne;0;1;0;1
10593;Smalsučiai;Zuikių;9864518144;Ne;0;3;2;5
10594;Smalsučiai;Zuikių;8128348060;Ne;6;0;2;8
10595;Smalsučiai;Zuikių;3757955200;Ne;6;2;2;10
10596;Smalsučiai;Zuikių;4847584492;Ne;3;2;3;8
10597;Smalsučiai;Zuikių;6415906523;Ne;0;2;0;2
10598;Smalsučiai;Zuikių;4425714802;Ne;1;2;2;5
10599;Smalsučiai;Zuikių;4379645417;Ne;0;9;0;9
10600;Smalsučiai;Zuikių;9732075162;Ne;3;2;2;7
10601;Smalsučiai;Zuikių;6090391818;Ne;2;2;5;9
10602;Smalsučiai;Zuikių;7023531176;Ne;2;0;2;4
10603;Smalsučiai;Zuikių;5098291946;Ne;0;0;20;20
10604;Smalsučiai;Zuikių;3582805599;Ne;0;1;0;1
10605;Smalsučiai;Zuikių;7137550663;Ne;0;9;0;9
10606;Smalsučiai;Zuikių;2958335372;Ne;0;0;1;1
10607;Smalsučiai;Zuikių;8578693978;Ne;0;4;0;4
10608;Smalsučiai;Zuikių;7713078413;Ne;0;5;0;5
10609;Smalsučiai;Zuikių;3627324317;Ne;0;2;0;2
10610;Smalsučiai;Zuikių;2034790691;Ne;0;0;2;2
10611;Smalsučiai;Zuikių;4506058735;Ne;0;2;3;5
10612;Smalsučiai;Nykštukų;3254574278;Ne;12;1;2;15
10613;Smalsučiai;Nykštukų;6279850475;Ne;3;2;2;7
10614;Smalsučiai;Nykštukų;6589139999;Ne;5;2;2;9
10615;Smalsučiai;Nykštukų;8461139523;Ne;0;2;0;2
10616;Smalsučiai;Nykštukų;3162567266;Ne;0;2;0;2
10617;Smalsučiai;Nykštukų;8405943289;Ne;0;6;3;9
10618;Smalsučiai;Nykštukų;7231947961;Ne;6;2;4;12
10619;Smalsučiai;Nykštukų;5205336476;Ne;5;1;4;10
10620;Smalsučiai;Nykštukų;5537437823;Ne;8;3;4;15
10621;Smalsučiai;Nykštukų;2271751532;Ne;0;5;0;5
10622;Smalsučiai;Nykštukų;7257857454;Ne;13;3;2;18
10623;Smalsučiai;Nykštukų;9299524862;Ne;11;3;2;16
10624;Smalsučiai;Nykštukų;6372742288;Ne;8;12;2;22
10625;Smalsučiai;Katinėlių;3636314894;Ne;6;0;4;10
10626;Smalsučiai;Katinėlių;8527953002;Ne;3;2;2;7
10627;Smalsučiai;Katinėlių;4306056807;Ne;0;4;0;4
10628;Smalsučiai;Katinėlių;7094624971;Ne;8;0;4;12
10629;Smalsučiai;Katinėlių;1956492436;Ne;1;0;2;3
10630;Smalsučiai;Katinėlių;2505732707;Ne;19;0;2;21
10631;Smalsučiai;Katinėlių;4517950062;Ne;8;0;4;12
10632;Smalsučiai;Katinėlių;7567134320;Ne;6;0;5;11
10633;Smalsučiai;Katinėlių;3325151724;Ne;4;1;2;7
10634;Smalsučiai;Katinėlių;5390381543;Ne;0;0;6;6
10635;Smalsučiai;Katinėlių;3104627678;Ne;0;7;1;8
10636;Smalsučiai;Katinėlių;4989144093;Ne;3;0;2;5
10637;Smalsučiai;Katinėlių;4275309820;Ne;4;4;4;12
10638;Smalsučiai;Katinėlių;9482651454;Ne;18;0;2;20
10639;Smalsučiai;Katinėlių;7123127278;Ne;13;2;3;18
10640;Smalsučiai;PELĖDŽIUKAI;9222858199;Ne;1;5;6;12
10641;Smalsučiai;PELĖDŽIUKAI;1909797307;Taip;4;0;4;8
10642;Smalsučiai;PELĖDŽIUKAI;7400990599;Ne;9;4;2;15
10643;Smalsučiai;PELĖDŽIUKAI;9771532192;Ne;6;7;2;15
10644;Smalsučiai;PELĖDŽIUKAI;8402519872;Ne;0;4;1;5
10645;Smalsučiai;PELĖDŽIUKAI;1305808180;Ne;0;2;0;2
10646;Smalsučiai;PELĖDŽIUKAI;6393203986;Ne;0;7;0;7
10647;Smalsučiai;PELĖDŽIUKAI;3746193901;Ne;3;3;2;8
10648;Smalsučiai;PELĖDŽIUKAI;3625628040;Ne;0;2;1;3
10649;Smalsučiai;PELĖDŽIUKAI;2305950301;Ne;0;0;1;1
10650;Smalsučiai;PELĖDŽIUKAI;6128134712;Ne;0;4;1;5
10651;Smalsučiai;PELĖDŽIUKAI;8615789381;Ne;1;3;2;6
10652;Smalsučiai;PELĖDŽIUKAI;5789420793;Ne;6;0;3;9
10653;Smalsučiai;PELĖDŽIUKAI;7973827402;Ne;10;0;1;11
10654;Smalsučiai;PELĖDŽIUKAI;5104153092;Ne;4;2;4;10
10655;Smalsučiai;PELĖDŽIUKAI;2377305079;Ne;0;0;1;1
10656;Smalsučiai;Pingvinukai;7731862348;Ne;11;0;2;13
10657;Smalsučiai;Pingvinukai;3064333387;Ne;2;0;2;4
10658;Smalsučiai;Pingvinukai;7266585367;Ne;3;0;4;7
10659;Smalsučiai;Pingvinukai;4557510634;Ne;7;0;3;10
10660;Smalsučiai;Pingvinukai;3340929454;Ne;9;0;2;11
10661;Smalsučiai;Pingvinukai;1381962216;Ne;22;0;0;22
10662;Smalsučiai;Pingvinukai;7065180174;Ne;0;5;0;5
10663;Smalsučiai;Pingvinukai;8493312040;Ne;5;1;2;8
10664;Smalsučiai;Pingvinukai;5081708388;Ne;13;0;2;15
10665;Smalsučiai;Pingvinukai;6430983316;Ne;11;0;4;15
10666;Smalsučiai;Pingvinukai;6380199558;Ne;4;0;3;7
10667;Smalsučiai;Pingvinukai;8524648874;Ne;11;0;5;16
10668;Smalsučiai;Pingvinukai;6996257151;Ne;8;0;2;10
10669;Smalsučiai;Pingvinukai;9953929955;Ne;6;0;2;8
10670;Smalsučiai;Voverikų;4811022648;Ne;0;3;0;3
10671;Smalsučiai;Voverikų;4973651632;Ne;0;7;0;7
10672;Smalsučiai;Voverikų;3509573985;Ne;7;1;4;12
10673;Smalsučiai;Voverikų;1485450504;Ne;0;2;0;2
10674;Smalsučiai;Voverikų;3042578767;Ne;0;5;0;5
10675;Smalsučiai;Voverikų;2070248478;Ne;0;7;2;9
10676;Smalsučiai;Voverikų;7205498813;Taip;4;2;2;8
10677;Smalsučiai;Voverikų;2612579099;Ne;0;14;0;14
10678;Smalsučiai;Voverikų;2885279828;Ne;0;1;2;3
10679;Smalsučiai;Voverikų;5964344820;Ne;0;1;0;1
10680;Smalsučiai;Voverikų;4105866680;Ne;10;1;4;15
10681;Smalsučiai;Voverikų;8493718326;Ne;2;0;2;4
10682;Smalsučiai;Voverikų;4611852575;Ne;0;15;0;15
10683;Smalsučiai;Voverikų;7988779202;Ne;0;14;0;14
10684;Smalsučiai;Voverikų;6984861531;Ne;3;3;5;11
10685;Smalsučiai;Voverikų;4233687544;Ne;0;5;5;10
10686;Smalsučiai;Voverikų;5710530457;Ne;0;1;0;1
10687;Spragtukas;NYKŠTUKAI;4527798635;Ne;2;2;2;6
10688;Spragtukas;NYKŠTUKAI;8551195766;Ne;0;0;4;4
10689;Spragtukas;NYKŠTUKAI;8297700739;Ne;0;2;0;2
10690;Spragtukas;NYKŠTUKAI;9595221494;Ne;0;3;0;3
10691;Spragtukas;NYKŠTUKAI;8715073512;Ne;0;0;2;2
10692;Spragtukas;NYKŠTUKAI;2076126173;Ne;0;10;0;10
10693;Spragtukas;NYKŠTUKAI;3012345413;Ne;3;2;2;7
10694;Spragtukas;NYKŠTUKAI;8698492694;Ne;5;0;7;12
10695;Spragtukas;NYKŠTUKAI;1150002524;Ne;0;5;0;5
10696;Spragtukas;NYKŠTUKAI;4493810276;Ne;0;1;0;1
10697;Spragtukas;NYKŠTUKAI;8288793522;Ne;0;9;0;9
10698;Spragtukas;NYKŠTUKAI;6986034864;Ne;0;4;0;4
10699;Spragtukas;NYKŠTUKAI;9665371858;Ne;0;3;0;3
10700;Spragtukas;NYKŠTUKAI;9308064461;Ne;0;4;0;4
10701;Spragtukas;SAULUTĖ;3337355440;Ne;2;2;2;6
10702;Spragtukas;SAULUTĖ;4669257062;Ne;0;2;0;2
10703;Spragtukas;SAULUTĖ;3692960591;Ne;0;3;0;3
10704;Spragtukas;SAULUTĖ;2305568596;Ne;0;2;0;2
10705;Spragtukas;SAULUTĖ;9191831532;Ne;0;2;0;2
10706;Spragtukas;SAULUTĖ;3948232692;Ne;0;4;2;6
10707;Spragtukas;SAULUTĖ;9149954373;Ne;0;9;0;9
10708;Spragtukas;SAULUTĖ;7511680722;Ne;0;2;0;2
10709;Spragtukas;SAULUTĖ;8235791891;Ne;8;1;2;11
10710;Spragtukas;SAULUTĖ;2987638580;Ne;0;4;2;6
10711;Spragtukas;SAULUTĖ;5687853390;Ne;9;3;4;16
10712;Spragtukas;SAULUTĖ;6679886985;Ne;8;6;2;16
10713;Spragtukas;SAULUTĖ;2879077913;Ne;0;3;0;3
10714;Spragtukas;SAULUTĖ;1998148708;Ne;0;4;0;4
10715;Spragtukas;SAULUTĖ;8227086854;Ne;0;11;0;11
10716;Spragtukas;SAULUTĖ;5697451914;Ne;0;6;0;6
10717;Spragtukas;SAULUTĖ;3086399458;Ne;3;1;2;6
10718;Spragtukas;SAULUTĖ;2879614195;Ne;0;13;0;13
10719;Spragtukas;SAULUTĖ;4929866385;Ne;0;2;0;2
10720;Spragtukas;SAULUTĖ;8912031554;Ne;20;0;2;22
10721;Spragtukas;SPINDULĖLIAI;4527531194;Ne;3;0;2;5
10722;Spragtukas;SPINDULĖLIAI;8083960192;Ne;3;2;2;7
10723;Spragtukas;SPINDULĖLIAI;6228634157;Ne;3;2;2;7
10724;Spragtukas;SPINDULĖLIAI;5902286196;Ne;3;2;2;7
10725;Spragtukas;SPINDULĖLIAI;4194552077;Ne;0;0;3;3
10726;Spragtukas;SPINDULĖLIAI;5998318402;Ne;4;0;6;10
10727;Spragtukas;SPINDULĖLIAI;9074266444;Ne;0;0;2;2
10728;Spragtukas;SPINDULĖLIAI;3323280861;Ne;1;0;3;4
10729;Spragtukas;SPINDULĖLIAI;8856554286;Ne;0;0;1;1
10730;Spragtukas;SPINDULĖLIAI;1928122722;Taip;0;2;0;2
10731;Spragtukas;SPINDULĖLIAI;3367731738;Ne;0;6;0;6
10732;Spragtukas;GINTARĖLIAI;1525489137;Ne;0;2;0;2
10733;Spragtukas;GINTARĖLIAI;5724874569;Ne;0;8;0;8
10734;Spragtukas;GINTARĖLIAI;1430632638;Ne;3;2;2;7
10735;Spragtukas;GINTARĖLIAI;8625143071;Ne;0;8;0;8
10736;Spragtukas;GINTARĖLIAI;2255007161;Ne;6;1;2;9
10737;Spragtukas;GINTARĖLIAI;9664130733;Ne;0;3;0;3
10738;Spragtukas;GINTARĖLIAI;2316071393;Ne;3;2;2;7
10739;Spragtukas;GINTARĖLIAI;8698469979;Ne;0;8;0;8
10740;Spragtukas;GINTARĖLIAI;1747417905;Ne;0;9;0;9
10741;Spragtukas;GINTARĖLIAI;6388163866;Ne;0;19;0;19
10742;Spragtukas;GINTARĖLIAI;8191270443;Ne;0;3;0;3
10743;Spragtukas;GINTARĖLIAI;3684183344;Ne;0;1;0;1
10744;Spragtukas;GINTARĖLIAI;7806145224;Ne;0;2;0;2
10745;Spragtukas;GINTARĖLIAI;2992201984;Ne;0;5;0;5
10746;Spragtukas;GINTARĖLIAI;2217627240;Taip;0;10;0;10
10747;Spragtukas;GINTARĖLIAI;1150727381;Ne;0;5;0;5
10748;Spragtukas;GINTARĖLIAI;2706473182;Ne;0;4;0;4
10749;Spragtukas;ČIPOLINO;9951226210;Ne;0;3;0;3
10750;Spragtukas;ČIPOLINO;7933945356;Ne;4;4;2;10
10751;Spragtukas;ČIPOLINO;8473814776;Ne;5;1;2;8
10752;Spragtukas;ČIPOLINO;4461217748;Ne;0;3;0;3
10753;Spragtukas;ČIPOLINO;2087416420;Ne;0;2;0;2
10754;Spragtukas;ČIPOLINO;9579825533;Ne;0;2;0;2
10755;Spragtukas;ČIPOLINO;9443091032;Ne;0;15;0;15
10756;Spragtukas;ČIPOLINO;7412489884;Ne;0;7;0;7
10757;Spragtukas;ČIPOLINO;9294770557;Ne;0;5;0;5
10758;Spragtukas;ČIPOLINO;8110631015;Ne;0;3;0;3
10759;Spragtukas;ČIPOLINO;2963449719;Ne;0;1;0;1
10760;Spragtukas;ČIPOLINO;8710910167;Ne;0;4;0;4
10761;Spragtukas;ČIPOLINO;7692148513;Ne;0;2;0;2
10762;Spragtukas;ČIPOLINO;2599579491;Ne;5;2;2;9
10763;Spragtukas;ČIPOLINO;7402797271;Ne;16;0;4;20
10764;Spragtukas;ČIPOLINO;8560471564;Ne;6;3;0;9
10765;Spragtukas;BORUŽĖLĖS;8614890958;Ne;0;7;0;7
10766;Spragtukas;BORUŽĖLĖS;2356476212;Ne;0;4;1;5
10767;Spragtukas;BORUŽĖLĖS;8287102733;Taip;18;2;2;22
10768;Spragtukas;BORUŽĖLĖS;6584145176;Taip;0;10;0;10
10769;Spragtukas;BORUŽĖLĖS;6824861247;Ne;0;2;0;2
10770;Spragtukas;BORUŽĖLĖS;7264683147;Ne;0;2;2;4
10771;Spragtukas;BORUŽĖLĖS;5556920140;Ne;7;2;2;11
10772;Spragtukas;BORUŽĖLĖS;7073092344;Ne;0;4;0;4
10773;Spragtukas;BORUŽĖLĖS;7042345781;Taip;0;2;0;2
10774;Spragtukas;BORUŽĖLĖS;1046613540;Ne;0;7;0;7
10775;Spragtukas;BORUŽĖLĖS;1180285187;Ne;3;2;2;7
10776;Spragtukas;BORUŽĖLĖS;2268649859;Ne;3;3;4;10
10777;Spragtukas;BORUŽĖLĖS;3225684296;Ne;0;2;2;4
10778;Spragtukas;BORUŽĖLĖS;5940679759;Ne;3;4;5;12
10779;Spragtukas;DRUGELIAI;7058848570;Ne;3;2;2;7
10780;Spragtukas;DRUGELIAI;7271482702;Ne;0;4;0;4
10781;Spragtukas;DRUGELIAI;9099921999;Ne;0;2;3;5
10782;Spragtukas;DRUGELIAI;4441290823;Ne;2;0;5;7
10783;Spragtukas;DRUGELIAI;5440632023;Ne;4;0;4;8
10784;Spragtukas;DRUGELIAI;9310818975;Ne;0;0;6;6
10785;Spragtukas;DRUGELIAI;1493711333;Ne;1;4;2;7
10786;Spragtukas;DRUGELIAI;8486415968;Ne;8;0;2;10
10787;Spragtukas;DRUGELIAI;4742132709;Ne;0;3;0;3
10788;Spragtukas;DRUGELIAI;3423699840;Ne;0;0;2;2
10789;Spragtukas;DRUGELIAI;7256772984;Ne;1;0;0;1
10790;Spragtukas;DRUGELIAI;2026249018;Ne;8;3;2;13
10791;Spragtukas;DRUGELIAI;1487259291;Ne;4;1;2;7
10792;Spragtukas;DRUGELIAI;5225669850;Ne;2;0;2;4
10793;Spragtukas;DRUGELIAI;8109894184;Ne;0;2;3;5
10794;Spragtukas;DRUGELIAI;8396134652;Ne;12;1;7;20
10795;Spragtukas;DRUGELIAI;1784758799;Ne;3;2;2;7
10796;Spragtukas;DRUGELIAI;8893500175;Ne;6;3;4;13
10797;Spragtukas;GAIDELIAI;2541126095;Ne;0;9;0;9
10798;Spragtukas;GAIDELIAI;4097458544;Ne;3;0;2;5
10799;Spragtukas;GAIDELIAI;8957903306;Ne;4;5;4;13
10800;Spragtukas;GAIDELIAI;1326714513;Ne;0;6;1;7
10801;Spragtukas;GAIDELIAI;7108640957;Ne;10;2;2;14
10802;Spragtukas;GAIDELIAI;6370760287;Ne;8;0;2;10
10803;Spragtukas;GAIDELIAI;7911124524;Ne;0;2;2;4
10804;Spragtukas;GAIDELIAI;9509296936;Ne;0;0;1;1
10805;Spragtukas;GAIDELIAI;3216796441;Ne;9;0;6;15
10806;Spragtukas;GAIDELIAI;8440836721;Ne;7;2;4;13
10807;Spragtukas;GAIDELIAI;4535021524;Ne;0;3;0;3
10808;Spragtukas;GAIDELIAI;2679834328;Ne;0;2;2;4
10809;Spragtukas;GAIDELIAI;7912840514;Ne;1;2;4;7
10810;Spragtukas;GAIDELIAI;1748358240;Ne;6;2;3;11
10811;Spragtukas;GAIDELIAI;7494879160;Taip;10;0;3;13
10812;Spragtukas;ŽUVELĖS;9078163633;Ne;5;2;2;9
10813;Spragtukas;ŽUVELĖS;8762832644;Ne;0;1;0;1
10814;Spragtukas;ŽUVELĖS;8652973900;Ne;0;3;0;3
10815;Spragtukas;ŽUVELĖS;3261213140;Ne;0;9;0;9
10816;Spragtukas;ŽUVELĖS;5689392663;Ne;3;3;2;8
10817;Spragtukas;ŽUVELĖS;9592271053;Ne;0;2;0;2
10818;Spragtukas;ŽUVELĖS;1272075883;Ne;0;4;0;4
10819;Spragtukas;ŽUVELĖS;6465991136;Ne;0;3;0;3
10820;Spragtukas;ŽUVELĖS;9282940430;Ne;0;2;0;2
10821;Spragtukas;ŽUVELĖS;6503842956;Ne;0;2;0;2
10822;Spragtukas;ŽUVELĖS;2578400770;Ne;0;2;0;2
10823;Spragtukas;ŽUVELĖS;3139748724;Ne;0;9;0;9
10824;Spragtukas;ŽUVELĖS;8640877497;Ne;1;2;2;5
10825;Spragtukas;ŽUVELĖS;2025314314;Ne;0;0;4;4
10826;Spragtukas;ŽUVELĖS;4848647219;Ne;3;8;2;13
10827;Spragtukas;ŽUVELĖS;3491418162;Ne;4;5;2;11
10828;Spragtukas;ŽUVELĖS;5836788916;Ne;0;3;0;3
10829;Spragtukas;ŽUVELĖS;5704941595;Ne;0;7;0;7
10830;Spragtukas;ŽUVELĖS;3286456855;Ne;0;2;0;2
10831;Spragtukas;ŽUVELĖS;9662188102;Ne;0;3;0;3
10832;Spragtukas;ŽUVELĖS;2539660577;Ne;0;2;0;2
10833;Spragtukas;ŽUVELĖS;6757604305;Ne;0;0;1;1
10834;Spragtukas;ŽUVELĖS;6800727630;Ne;0;2;0;2
10835;Spragtukas;ŽUVELĖS;1627243902;Ne;0;2;0;2
10836;Spragtukas;RIEŠUTĖLIAI;8684246143;Ne;0;4;2;6
10837;Spragtukas;RIEŠUTĖLIAI;1407611561;Ne;0;0;1;1
10838;Spragtukas;RIEŠUTĖLIAI;8773952377;Ne;0;4;0;4
10839;Spragtukas;RIEŠUTĖLIAI;1977526177;Ne;0;2;0;2
10840;Spragtukas;RIEŠUTĖLIAI;7615522850;Ne;1;0;2;3
10841;Spragtukas;RIEŠUTĖLIAI;6797841737;Ne;0;5;0;5
10842;Spragtukas;RIEŠUTĖLIAI;8342098575;Ne;3;1;2;6
10843;Spragtukas;RIEŠUTĖLIAI;1992850470;Ne;0;2;1;3
10844;Spragtukas;RIEŠUTĖLIAI;6158327941;Ne;0;2;0;2
10845;Spragtukas;RIEŠUTĖLIAI;4134127256;Ne;0;2;0;2
10846;Spragtukas;RIEŠUTĖLIAI;3009567338;Ne;0;2;1;3
10847;Spragtukas;RIEŠUTĖLIAI;2648358901;Ne;0;6;0;6
10848;Spragtukas;RIEŠUTĖLIAI;3822599790;Ne;0;15;0;15
10849;Spragtukas;RIEŠUTĖLIAI;7767940027;Ne;0;1;1;2
10850;Spragtukas;RIEŠUTĖLIAI;4625065223;Ne;3;0;2;5
10851;Spragtukas;RIEŠUTĖLIAI;6963190259;Ne;8;9;2;19
10852;Spragtukas;RIEŠUTĖLIAI;8732886749;Ne;2;2;2;6
10853;Spragtukas;RIEŠUTĖLIAI;1946493379;Ne;8;1;4;13
10854;Spragtukas;RIEŠUTĖLIAI;9975308171;Ne;3;8;2;13
10855;Spragtukas;VIŠČIUKAI;8291401010;Ne;20;0;2;22
10856;Spragtukas;VIŠČIUKAI;6219915771;Ne;0;0;3;3
10857;Spragtukas;VIŠČIUKAI;5497023448;Ne;3;0;2;5
10858;Spragtukas;VIŠČIUKAI;2359209112;Ne;6;0;6;12
10859;Spragtukas;VIŠČIUKAI;8371817233;Ne;0;8;0;8
10860;Spragtukas;VIŠČIUKAI;4489637427;Ne;1;2;2;5
10861;Spragtukas;VIŠČIUKAI;6804843816;Taip;8;0;5;13
10862;Spragtukas;VIŠČIUKAI;7883446348;Ne;0;1;1;2
10863;Spragtukas;VIŠČIUKAI;9617355214;Ne;5;0;4;9
10864;Spragtukas;VIŠČIUKAI;1878079499;Ne;11;0;4;15
10865;Spragtukas;VIŠČIUKAI;9198638303;Ne;5;0;2;7
10866;Spragtukas;VIŠČIUKAI;1572602399;Ne;5;0;2;7
10867;Spragtukas;MEŠKIUKAI;6477635199;Ne;10;0;4;14
10868;Spragtukas;MEŠKIUKAI;7730786172;Ne;0;2;0;2
10869;Spragtukas;MEŠKIUKAI;2422384041;Ne;3;0;3;6
10870;Spragtukas;MEŠKIUKAI;1411972930;Ne;9;3;3;15
10871;Spragtukas;MEŠKIUKAI;4654665538;Ne;0;3;0;3
10872;Spragtukas;MEŠKIUKAI;9313536781;Ne;2;0;2;4
10873;Spragtukas;MEŠKIUKAI;9616402367;Ne;9;1;2;12
10874;Spragtukas;MEŠKIUKAI;1869458751;Ne;4;2;2;8
10875;Spragtukas;MEŠKIUKAI;4332445650;Ne;5;0;2;7
10876;Spragtukas;MEŠKIUKAI;4900860607;Ne;0;5;0;5
10877;Spragtukas;MEŠKIUKAI;2172787507;Ne;0;4;0;4
10878;Spragtukas;MEŠKIUKAI;6073139322;Ne;2;1;0;3
10879;Strazdelis;Žiogelių;5346485534;Ne;4;3;2;9
10880;Strazdelis;Žiogelių;9933042249;Ne;12;2;4;18
10881;Strazdelis;Žiogelių;8581533423;Ne;5;0;2;7
10882;Strazdelis;Žiogelių;8209625399;Ne;15;1;2;18
10883;Strazdelis;Žiogelių;1141752802;Ne;7;2;2;11
10884;Strazdelis;Žiogelių;3596394112;Ne;3;5;2;10
10885;Strazdelis;Žiogelių;4563247013;Ne;13;0;4;17
10886;Strazdelis;Žiogelių;6437928004;Ne;0;3;0;3
10887;Strazdelis;Žiogelių;8971395173;Ne;3;4;2;9
10888;Strazdelis;Žiogelių;4955907851;Ne;2;0;2;4
10889;Strazdelis;Žiogelių;9567476872;Ne;3;2;2;7
10890;Strazdelis;Žiogelių;4516288199;Taip;3;2;2;7
10891;Strazdelis;Žiogelių;3028208428;Ne;6;1;3;10
10892;Strazdelis;Žiogelių;2753635198;Ne;4;4;4;12
10893;Strazdelis;Žiogelių;1194918926;Ne;6;1;5;12
10894;Strazdelis;Žiogelių;6651360492;Ne;8;3;2;13
10895;Strazdelis;Žiogelių;7913526787;Ne;3;3;2;8
10896;Strazdelis;Žiogelių;5742215922;Ne;4;1;2;7
10897;Strazdelis;Žiogelių;8035603341;Ne;0;5;0;5
10898;Strazdelis;Šeimynėlės;6570504154;Ne;0;2;0;2
10899;Strazdelis;Šeimynėlės;1683900907;Ne;7;0;4;11
10900;Strazdelis;Šeimynėlės;3897248010;Ne;0;2;3;5
10901;Strazdelis;Šeimynėlės;2990771887;Ne;0;8;0;8
10902;Strazdelis;Šeimynėlės;2185364583;Ne;5;0;3;8
10903;Strazdelis;Šeimynėlės;7905687363;Ne;4;0;2;6
10904;Strazdelis;Šeimynėlės;4501391298;Ne;7;6;2;15
10905;Strazdelis;Šeimynėlės;1277844969;Ne;2;0;0;2
10906;Strazdelis;Šeimynėlės;1012692326;Ne;2;0;0;2
10907;Strazdelis;Šeimynėlės;8899530711;Ne;2;0;0;2
10908;Strazdelis;Šeimynėlės;5784406335;Ne;0;2;0;2
10909;Strazdelis;Šeimynėlės;5296218650;Ne;7;0;3;10
10910;Strazdelis;Šeimynėlės;1754106518;Ne;3;0;2;5
10911;Strazdelis;Šeimynėlės;9806107189;Ne;0;4;0;4
10912;Strazdelis;Šeimynėlės;8295035233;Ne;0;0;1;1
10913;Strazdelis;Šeimynėlės;1553329770;Ne;2;0;0;2
10914;Strazdelis;Genelio;9586256979;Ne;1;2;2;5
10915;Strazdelis;Genelio;3084249678;Ne;0;6;1;7
10916;Strazdelis;Genelio;5499310072;Ne;0;8;2;10
10917;Strazdelis;Genelio;7083940713;Ne;0;0;2;2
10918;Strazdelis;Genelio;6480803618;Ne;0;0;1;1
10919;Strazdelis;Genelio;9490861272;Ne;0;7;0;7
10920;Strazdelis;Genelio;6071502600;Ne;0;2;2;4
10921;Strazdelis;Genelio;3713797440;Ne;0;2;2;4
10922;Strazdelis;Genelio;1034497200;Ne;0;0;2;2
10923;Strazdelis;Genelio;2459718449;Ne;0;3;0;3
10924;Strazdelis;Genelio;5714581201;Ne;0;2;0;2
10925;Strazdelis;Genelio;8956634754;Ne;4;0;2;6
10926;Strazdelis;Genelio;8762859576;Ne;0;0;1;1
10927;Strazdelis;Genelio;2306665561;Ne;0;5;0;5
10928;Strazdelis;Genelio;7680242840;Ne;0;2;0;2
10929;Strazdelis;Vikruolių;8287554571;Ne;0;2;0;2
10930;Strazdelis;Vikruolių;8637386316;Ne;0;4;1;5
10931;Strazdelis;Vikruolių;1704292727;Ne;0;3;0;3
10932;Strazdelis;Vikruolių;5892430004;Ne;0;10;0;10
10933;Strazdelis;Vikruolių;8371999002;Ne;5;2;2;9
10934;Strazdelis;Vikruolių;4562530311;Ne;0;2;2;4
10935;Strazdelis;Vikruolių;4004930488;Ne;3;2;0;5
10936;Strazdelis;Vikruolių;5768674837;Ne;13;0;4;17
10937;Strazdelis;Vikruolių;6046139859;Ne;0;0;2;2
10938;Strazdelis;Vikruolių;7349106795;Ne;0;2;0;2
10939;Strazdelis;Vikruolių;9761595867;Ne;5;0;2;7
10940;Strazdelis;Vikruolių;4448556404;Ne;0;2;0;2
10941;Strazdelis;Vikruolių;8854150040;Ne;0;2;0;2
10942;Strazdelis;Vikruolių;2655161322;Ne;0;5;0;5
10943;Strazdelis;Vyturėlių;2848984531;Ne;0;2;0;2
10944;Strazdelis;Vyturėlių;4159072583;Ne;3;2;2;7
10945;Strazdelis;Vyturėlių;2662549392;Ne;0;3;0;3
10946;Strazdelis;Vyturėlių;7469848482;Ne;0;3;0;3
10947;Strazdelis;Vyturėlių;2251157025;Ne;0;2;0;2
10948;Strazdelis;Vyturėlių;1841285441;Ne;0;2;0;2
10949;Strazdelis;Vyturėlių;5904388732;Ne;0;4;0;4
10950;Strazdelis;Vyturėlių;3460993302;Ne;0;2;3;5
10951;Strazdelis;Vyturėlių;7393083827;Ne;0;3;1;4
10952;Strazdelis;Vyturėlių;6555803164;Ne;2;1;2;5
10953;Strazdelis;Vyturėlių;1955166372;Ne;0;2;0;2
10954;Strazdelis;Vyturėlių;1706026100;Ne;0;5;0;5
10955;Strazdelis;Vyturėlių;4873707286;Ne;4;0;2;6
10956;Strazdelis;Vyturėlių;6527855940;Ne;0;1;0;1
10957;Strazdelis;Vyturėlių;2824416350;Ne;0;4;0;4
10958;Strazdelis;Vyturėlių;3610250359;Ne;1;2;4;7
10959;Strazdelis;Vyturėlių;2789987994;Ne;0;5;0;5
10960;Strazdelis;Vyturėlių;1173067724;Ne;3;1;2;6
10961;Strazdelis;Vyturėlių;2766970956;Ne;1;2;2;5
10962;Strazdelis;Varpelio;9502341478;Ne;0;10;0;10
10963;Strazdelis;Varpelio;5924324241;Ne;3;4;5;12
10964;Strazdelis;Varpelio;6954336739;Ne;0;3;2;5
10965;Strazdelis;Varpelio;3456287323;Ne;0;19;0;19
10966;Strazdelis;Varpelio;2438598773;Ne;1;8;2;11
10967;Strazdelis;Varpelio;8220751869;Ne;3;3;4;10
10968;Strazdelis;Varpelio;5425585036;Ne;7;3;4;14
10969;Strazdelis;Varpelio;1018598897;Ne;0;0;1;1
10970;Strazdelis;Varpelio;5314676261;Ne;0;2;0;2
10971;Strazdelis;Varpelio;2398220397;Ne;7;0;2;9
10972;Strazdelis;Varpelio;1787432390;Ne;0;4;0;4
10973;Strazdelis;Varpelio;3106135598;Ne;0;3;0;3
10974;Strazdelis;Varpelio;1455467186;Ne;5;2;4;11
10975;Strazdelis;Varpelio;9955443967;Ne;0;6;0;6
10976;Strazdelis;Varpelio;4908660203;Ne;0;2;7;9
10977;Strazdelis;Varpelio;6522639028;Ne;0;6;0;6
10978;Strazdelis;Pelėdžiukų;7087235151;Ne;3;17;2;22
10979;Strazdelis;Pelėdžiukų;1770338988;Ne;7;0;4;11
10980;Strazdelis;Pelėdžiukų;3030445367;Ne;7;0;2;9
10981;Strazdelis;Pelėdžiukų;4966668662;Ne;2;0;0;2
10982;Strazdelis;Pelėdžiukų;8484672456;Ne;0;4;0;4
10983;Strazdelis;Pelėdžiukų;6457478289;Ne;0;4;0;4
10984;Strazdelis;Pelėdžiukų;8953577585;Ne;0;1;0;1
10985;Strazdelis;Pelėdžiukų;3426039979;Ne;3;12;2;17
10986;Strazdelis;Pelėdžiukų;4715198107;Ne;1;2;3;6
10987;Strazdelis;Pelėdžiukų;4334385271;Ne;3;2;2;7
10988;Strazdelis;Pelėdžiukų;8677659019;Ne;0;2;1;3
10989;Strazdelis;Pelėdžiukų;4848650799;Ne;5;2;2;9
10990;Strazdelis;Pelėdžiukų;7716476995;Ne;2;2;2;6
10991;Strazdelis;Pelėdžiukų;8356680705;Ne;0;2;0;2
10992;Strazdelis;Pelėdžiukų;4174940099;Ne;0;9;2;11
10993;Strazdelis;Pelėdžiukų;8554043784;Ne;4;3;2;9
10994;Strazdelis;Pelėdžiukų;1952086370;Ne;4;3;2;9
10995;Strazdelis;Saulutės;5604313206;Ne;0;4;1;5
10996;Strazdelis;Saulutės;8877104963;Ne;0;3;0;3
10997;Strazdelis;Saulutės;4726043862;Ne;2;1;0;3
10998;Strazdelis;Saulutės;8686828982;Taip;0;8;0;8
10999;Strazdelis;Saulutės;1228651165;Ne;3;8;2;13
11000;Strazdelis;Saulutės;2852253325;Ne;0;3;0;3
11001;Strazdelis;Saulutės;3943914976;Ne;3;2;4;9
11002;Strazdelis;Saulutės;8938997208;Ne;1;0;3;4
11003;Strazdelis;Saulutės;2589303722;Ne;0;2;0;2
11004;Strazdelis;Saulutės;5232064496;Ne;0;3;0;3
11005;Strazdelis;Saulutės;2081538505;Ne;0;19;0;19
11006;Strazdelis;Saulutės;9776075027;Ne;4;2;3;9
11007;Strazdelis;Saulutės;6311710825;Ne;0;2;0;2
11008;Strazdelis;Saulutės;1021364759;Ne;0;2;0;2
11009;Strazdelis;Bitutės;8485509145;Ne;0;3;0;3
11010;Strazdelis;Bitutės;6508933324;Ne;4;3;2;9
11011;Strazdelis;Bitutės;4020547762;Ne;0;1;0;1
11012;Strazdelis;Bitutės;8753316532;Ne;3;1;2;6
11013;Strazdelis;Bitutės;9435593972;Ne;2;8;2;12
11014;Strazdelis;Bitutės;9555240419;Ne;0;1;2;3
11015;Strazdelis;Bitutės;3043580835;Ne;0;3;0;3
11016;Strazdelis;Bitutės;1539984888;Ne;0;3;0;3
11017;Strazdelis;Bitutės;4400849922;Ne;1;4;2;7
11018;Strazdelis;Bitutės;7890064837;Ne;8;1;2;11
11019;Strazdelis;Bitutės;1881071425;Taip;0;9;0;9
11020;Strazdelis;Bitutės;2908567982;Ne;0;3;0;3
11021;Strazdelis;Bitutės;9548465554;Ne;0;4;0;4
11022;Strazdelis;Bitutės;7466648222;Ne;5;0;2;7
11023;Strazdelis;Bitutės;4463378251;Ne;3;2;2;7
11024;Strazdelis;Bitutės;8443837176;Ne;1;0;2;3
11025;Strazdelis;Bitutės;2963535523;Ne;0;1;0;1
11026;Strazdelis;Bitutės;4369569609;Ne;0;5;2;7
11027;Strazdelis;Bitutės;3149930355;Ne;1;1;2;4
11028;Strazdelis;Mažylių;9357195019;Ne;0;0;1;1
11029;Strazdelis;Mažylių;5256750516;Ne;0;5;0;5
11030;Strazdelis;Mažylių;9383398775;Ne;6;0;2;8
11031;Strazdelis;Mažylių;2378910473;Ne;0;9;0;9
11032;Strazdelis;Mažylių;4699373769;Ne;8;3;2;13
11033;Strazdelis;Mažylių;3648883435;Ne;14;0;4;18
11034;Strazdelis;Mažylių;6788732053;Ne;0;1;0;1
11035;Strazdelis;Mažylių;2764495554;Ne;0;1;0;1
11036;Strazdelis;Mažylių;7039347901;Ne;4;1;3;8
11037;Strazdelis;Mažylių;3900225484;Ne;5;0;3;8
11038;Strazdelis;Mažylių;8734458997;Ne;2;2;2;6
11039;Strazdelis;Mažylių;3561551193;Ne;3;2;2;7
11040;Strazdelis;Mažylių;1932428439;Ne;0;2;0;2
11041;Strazdelis;Mažylių;2871841427;Ne;0;6;0;6
11042;Strazdelis;Pabiručių;1823053560;Ne;2;0;7;9
11043;Strazdelis;Pabiručių;7065489134;Ne;0;2;0;2
11044;Strazdelis;Pabiručių;4740153387;Ne;2;1;2;5
11045;Strazdelis;Pabiručių;5326864534;Ne;2;0;4;6
11046;Strazdelis;Pabiručių;9870463329;Ne;1;0;6;7
11047;Strazdelis;Pabiručių;2128546121;Ne;0;3;0;3
11048;Strazdelis;Pabiručių;3124550569;Ne;0;2;0;2
11049;Strazdelis;Pabiručių;4356218766;Ne;3;3;2;8
11050;Strazdelis;Pabiručių;9387670022;Ne;0;11;0;11
11051;Strazdelis;Žvirbliukai;9327438394;Ne;0;2;0;2
11052;Strazdelis;Žvirbliukai;4435530603;Ne;8;2;3;13
11053;Strazdelis;Žvirbliukai;3655476635;Ne;0;2;2;4
11054;Strazdelis;Žvirbliukai;4101114308;Ne;9;0;2;11
11055;Strazdelis;Žvirbliukai;6853311266;Ne;5;1;2;8
11056;Strazdelis;Žvirbliukai;5109807137;Ne;4;0;2;6
11057;Strazdelis;Žvirbliukai;8345990558;Ne;6;2;2;10
11058;Strazdelis;Žvirbliukai;7500217232;Ne;5;0;3;8
11059;Strazdelis;Žvirbliukai;2262189227;Ne;10;0;2;12
11060;Strazdelis;Žvirbliukai;5367260800;Ne;3;0;5;8
11061;Strazdelis;Žvirbliukai;2987873520;Ne;3;1;2;6
11062;Strazdelis;Žvirbliukai;6677510680;Ne;13;0;2;15
11063;Strazdelis;Smalsučiai;2400659346;Ne;2;0;5;7
11064;Strazdelis;Smalsučiai;7927494186;Ne;5;0;2;7
11065;Strazdelis;Smalsučiai;3363137855;Ne;3;1;2;6
11066;Strazdelis;Smalsučiai;2353001006;Ne;7;0;1;8
11067;Strazdelis;Smalsučiai;9394055331;Ne;0;0;5;5
11068;Strazdelis;Smalsučiai;3968872721;Ne;3;0;3;6
11069;Strazdelis;Smalsučiai;6306005935;Ne;3;0;2;5
11070;Strazdelis;Smalsučiai;3093434806;Ne;8;0;2;10
11071;Strazdelis;Smalsučiai;1607989470;Ne;3;0;3;6
11072;Strazdelis;Smalsučiai;4403950626;Ne;3;0;2;5
11073;Strazdelis;Smalsučiai;6617345241;Ne;10;0;2;12
11074;Strazdelis;Zuikučiai;5709610161;Ne;22;0;0;22
11075;Strazdelis;Zuikučiai;6746494698;Ne;20;0;2;22
11076;Strazdelis;Zuikučiai;3868845362;Ne;2;1;4;7
11077;Strazdelis;Zuikučiai;8426221586;Ne;7;0;4;11
11078;Strazdelis;Zuikučiai;3277336468;Ne;8;0;3;11
11079;Strazdelis;Zuikučiai;6370073120;Ne;0;0;3;3
11080;Strazdelis;Zuikučiai;8584413761;Ne;5;0;3;8
11081;Strazdelis;Zuikučiai;7879010008;Ne;3;0;2;5
11082;Strazdelis;Zuikučiai;7816174042;Ne;4;9;2;15
11083;Strazdelis;Zuikučiai;5842432403;Ne;3;0;2;5
11084;Strazdelis;Zuikučiai;2543809192;Taip;3;0;2;5
11085;Strazdelis;Boružiukai;7722063228;Ne;0;3;0;3
11086;Strazdelis;Boružiukai;1360433419;Ne;0;2;3;5
11087;Strazdelis;Boružiukai;3414489196;Ne;1;1;0;2
11088;Strazdelis;Boružiukai;6199087019;Ne;3;8;2;13
11089;Strazdelis;Boružiukai;4135433644;Ne;0;0;1;1
11090;Strazdelis;Boružiukai;8372033449;Ne;8;4;2;14
11091;Strazdelis;Boružiukai;4510204830;Ne;0;0;1;1
11092;Strazdelis;Boružiukai;5971903029;Ne;0;6;0;6
11093;Strazdelis;Boružiukai;6163722469;Ne;5;2;4;11
11094;Strazdelis;Boružiukai;4855667876;Ne;6;0;4;10
11095;Strazdelis;Boružiukai;4210678130;Ne;0;2;2;4
11096;Strazdelis;Boružiukai;9400396057;Ne;2;0;2;4
11097;Strazdelis;Boružiukai;8841518149;Ne;4;0;3;7
11098;Strazdelis;Gandriukai;1303481940;Ne;10;0;2;12
11099;Strazdelis;Gandriukai;5327428351;Ne;3;0;4;7
11100;Strazdelis;Gandriukai;2337958830;Ne;3;0;2;5
11101;Strazdelis;Gandriukai;1511882237;Ne;7;0;2;9
11102;Strazdelis;Gandriukai;9357344413;Ne;1;6;2;9
11103;Strazdelis;Gandriukai;6113204629;Ne;0;1;0;1
11104;Strazdelis;Gandriukai;9931075329;Ne;0;2;0;2
11105;Strazdelis;Gandriukai;2474988890;Ne;0;1;0;1
11106;Strazdelis;Gandriukai;9036931027;Ne;0;0;1;1
11107;Strazdelis;Gandriukai;4284112438;Ne;0;1;0;1
11108;Strazdelis;Gandriukai;4335313098;Ne;2;2;2;6
11109;Strazdelis;Gandriukai;1361102201;Ne;0;3;0;3
11110;Strazdelis;Gandriukai;7158003869;Ne;0;1;3;4
11111;Strazdelis;Gandriukai;7403074070;Ne;0;0;4;4
11112;Šermukšnėlė;MOLINUKAI;9746313951;Ne;8;0;3;11
11113;Šermukšnėlė;MOLINUKAI;4638109666;Ne;0;0;2;2
11114;Šermukšnėlė;MOLINUKAI;9329824053;Ne;0;0;3;3
11115;Šermukšnėlė;MOLINUKAI;2714018690;Ne;1;2;5;8
11116;Šermukšnėlė;MOLINUKAI;5262882873;Ne;0;2;1;3
11117;Šermukšnėlė;MOLINUKAI;2985284699;Ne;0;2;0;2
11118;Šermukšnėlė;MOLINUKAI;4983510683;Ne;0;2;0;2
11119;Šermukšnėlė;MOLINUKAI;7385114026;Ne;0;3;1;4
11120;Šermukšnėlė;MOLINUKAI;2784732759;Ne;9;0;4;13
11121;Šermukšnėlė;MOLINUKAI;3342919832;Taip;3;5;0;8
11122;Šermukšnėlė;MOLINUKAI;9337047371;Ne;0;2;0;2
11123;Šermukšnėlė;MOLINUKAI;2098090763;Ne;2;2;4;8
11124;Šermukšnėlė;MOLINUKAI;8000479161;Ne;1;2;4;7
11125;Šermukšnėlė;MOLINUKAI;4952285322;Ne;0;3;0;3
11126;Šermukšnėlė;MOLINUKAI;6608458145;Ne;2;8;0;10
11127;Šermukšnėlė;MOLINUKAI;8104182167;Ne;4;0;4;8
11128;Šermukšnėlė;MOLINUKAI;6988120570;Ne;6;8;0;14
11129;Šermukšnėlė;MOLINUKAI;8728441474;Ne;6;2;4;12
11130;Šermukšnėlė;MOLINUKAI;4075151928;Ne;0;0;1;1
11131;Šermukšnėlė;MOLINUKAI;9527382390;Ne;0;0;1;1
11132;Šermukšnėlė;MOLINUKAI;4968522498;Ne;8;6;0;14
11133;Šermukšnėlė;ŠIAUDINUKAI;7249568196;Ne;0;1;0;1
11134;Šermukšnėlė;ŠIAUDINUKAI;3451361097;Ne;0;0;1;1
11135;Šermukšnėlė;ŠIAUDINUKAI;7002917737;Ne;3;0;4;7
11136;Šermukšnėlė;ŠIAUDINUKAI;3637882900;Ne;0;7;0;7
11137;Šermukšnėlė;ŠIAUDINUKAI;1159472154;Ne;0;2;1;3
11138;Šermukšnėlė;ŠIAUDINUKAI;4956414941;Ne;6;2;4;12
11139;Šermukšnėlė;ŠIAUDINUKAI;3499394539;Ne;0;5;0;5
11140;Šermukšnėlė;ŠIAUDINUKAI;1157979179;Ne;0;7;0;7
11141;Šermukšnėlė;ŠIAUDINUKAI;8048598135;Ne;1;0;4;5
11142;Šermukšnėlė;ŠIAUDINUKAI;3082272196;Taip;0;2;1;3
11143;Šermukšnėlė;ŠIAUDINUKAI;9903310024;Ne;0;0;2;2
11144;Šermukšnėlė;ŠIAUDINUKAI;6993702887;Ne;2;0;2;4
11145;Šermukšnėlė;ŠIAUDINUKAI;9012757607;Ne;0;2;0;2
11146;Šermukšnėlė;ŠIAUDINUKAI;3550736579;Ne;5;0;6;11
11147;Šermukšnėlė;ŠIAUDINUKAI;5993599994;Ne;0;0;5;5
11148;Šermukšnėlė;ŠIAUDINUKAI;6077798297;Ne;0;2;0;2
11149;Šermukšnėlė;ŠIAUDINUKAI;2351386211;Ne;1;0;3;4
11150;Šermukšnėlė;ŠIAUDINUKAI;1437314920;Ne;0;2;0;2
11151;Šermukšnėlė;TOŠINUKAI;3994316729;Ne;1;2;2;5
11152;Šermukšnėlė;TOŠINUKAI;7229632099;Ne;0;2;2;4
11153;Šermukšnėlė;TOŠINUKAI;7038705221;Ne;0;1;2;3
11154;Šermukšnėlė;TOŠINUKAI;9035625467;Ne;0;2;0;2
11155;Šermukšnėlė;TOŠINUKAI;3081548524;Ne;0;2;0;2
11156;Šermukšnėlė;TOŠINUKAI;9442514813;Ne;3;2;2;7
11157;Šermukšnėlė;TOŠINUKAI;9585435700;Ne;2;0;1;3
11158;Šermukšnėlė;TOŠINUKAI;1131780941;Ne;0;2;0;2
11159;Šermukšnėlė;TOŠINUKAI;6286039101;Ne;3;2;2;7
11160;Šermukšnėlė;TOŠINUKAI;9584702487;Ne;0;0;1;1
11161;Šermukšnėlė;TOŠINUKAI;2534758615;Ne;9;5;0;14
11162;Šermukšnėlė;TOŠINUKAI;1622834854;Ne;1;2;2;5
11163;Šermukšnėlė;TOŠINUKAI;4945395564;Ne;5;0;2;7
11164;Šermukšnėlė;TOŠINUKAI;7106405983;Ne;0;4;1;5
11165;Šermukšnėlė;ODINUKAI;4422415026;Ne;0;10;0;10
11166;Šermukšnėlė;ODINUKAI;2176788727;Ne;0;0;2;2
11167;Šermukšnėlė;ODINUKAI;5575518612;Ne;0;0;1;1
11168;Šermukšnėlė;ODINUKAI;5733540837;Ne;0;2;3;5
11169;Šermukšnėlė;ODINUKAI;7262199284;Ne;0;2;1;3
11170;Šermukšnėlė;ODINUKAI;5159461963;Ne;0;2;0;2
11171;Šermukšnėlė;ODINUKAI;5354978646;Ne;0;1;2;3
11172;Šermukšnėlė;ODINUKAI;1882432812;Ne;0;1;2;3
11173;Šermukšnėlė;ODINUKAI;3949629658;Ne;0;5;0;5
11174;Šermukšnėlė;ODINUKAI;6105915822;Ne;2;2;5;9
11175;Šermukšnėlė;ODINUKAI;9742208172;Ne;0;2;2;4
11176;Šermukšnėlė;ODINUKAI;7667114310;Ne;0;7;2;9
11177;Šermukšnėlė;ODINUKAI;7245206247;Ne;0;2;1;3
11178;Šermukšnėlė;ODINUKAI;5397385093;Ne;0;2;1;3
11179;Šermukšnėlė;ODINUKAI;4331948700;Ne;0;1;1;2
11180;Šermukšnėlė;ODINUKAI;6718242890;Ne;0;2;0;2
11181;Šermukšnėlė;ODINUKAI;9664249364;Ne;0;1;4;5
11182;Šermukšnėlė;ODINUKAI;1064222922;Ne;3;2;3;8
11183;Šermukšnėlė;ODINUKAI;7770630580;Ne;0;2;1;3
11184;Šermukšnėlė;ODINUKAI;6194188831;Ne;0;2;2;4
11185;Šermukšnėlė;KRIAUKLELĖS;4256630681;Ne;0;0;3;3
11186;Šermukšnėlė;KRIAUKLELĖS;7458930634;Ne;0;2;0;2
11187;Šermukšnėlė;KRIAUKLELĖS;6342714998;Ne;1;0;2;3
11188;Šermukšnėlė;KRIAUKLELĖS;6946711443;Ne;4;0;2;6
11189;Šermukšnėlė;KRIAUKLELĖS;9074111563;Ne;0;2;0;2
11190;Šermukšnėlė;KRIAUKLELĖS;9908568127;Ne;0;0;1;1
11191;Šermukšnėlė;KRIAUKLELĖS;9783673534;Ne;1;0;3;4
11192;Šermukšnėlė;KRIAUKLELĖS;5408843906;Ne;0;3;0;3
11193;Šermukšnėlė;KRIAUKLELĖS;4810571143;Ne;0;2;0;2
11194;Šermukšnėlė;KRIAUKLELĖS;6797936390;Ne;3;2;2;7
11195;Šermukšnėlė;KRIAUKLELĖS;6286235756;Ne;6;1;2;9
11196;Šermukšnėlė;KRIAUKLELĖS;9080074486;Ne;3;1;1;5
11197;Šermukšnėlė;KRIAUKLELĖS;5456669766;Ne;0;2;0;2
11198;Šermukšnėlė;KRIAUKLELĖS;7098953763;Ne;0;8;0;8
11199;Šermukšnėlė;VYTINUKAI;2235123503;Ne;2;0;2;4
11200;Šermukšnėlė;VYTINUKAI;5605191023;Ne;1;0;3;4
11201;Šermukšnėlė;VYTINUKAI;8558117857;Ne;0;0;6;6
11202;Šermukšnėlė;VYTINUKAI;6531113007;Ne;0;2;0;2
11203;Šermukšnėlė;VYTINUKAI;8437052600;Ne;10;0;4;14
11204;Šermukšnėlė;VYTINUKAI;1318170904;Ne;0;4;0;4
11205;Šermukšnėlė;VYTINUKAI;8200175951;Ne;10;2;1;13
11206;Šermukšnėlė;VYTINUKAI;6149973884;Ne;7;0;3;10
11207;Šermukšnėlė;VYTINUKAI;5874725607;Ne;7;0;1;8
11208;Šermukšnėlė;VYTINUKAI;7532979465;Ne;4;0;3;7
11209;Šermukšnėlė;VYTINUKAI;7834844175;Ne;3;0;4;7
11210;Šermukšnėlė;VYTINUKAI;7211488009;Ne;0;2;0;2
11211;Šermukšnėlė;VYTINUKAI;7546040491;Ne;4;0;5;9
11212;Šermukšnėlė;VYTINUKAI;2698741674;Ne;0;3;0;3
11213;Šermukšnėlė;VYTINUKAI;3359398381;Ne;5;4;0;9
11214;Šermukšnėlė;VYTINUKAI;9872479998;Ne;0;0;2;2
11215;Šermukšnėlė;VYTINUKAI;1312471779;Ne;4;0;2;6
11216;Šermukšnėlė;VYTINUKAI;8802335133;Ne;0;1;0;1
11217;Šermukšnėlė;VYTINUKAI;8632561799;Ne;2;0;5;7
11218;Šermukšnėlė;GINTARĖLIAI;5069572637;Ne;0;2;0;2
11219;Šermukšnėlė;GINTARĖLIAI;8249749948;Ne;0;2;0;2
11220;Šermukšnėlė;GINTARĖLIAI;2989011150;Ne;0;2;0;2
11221;Šermukšnėlė;GINTARĖLIAI;3747531232;Ne;1;3;2;6
11222;Šermukšnėlė;GINTARĖLIAI;1996859146;Ne;0;2;1;3
11223;Šermukšnėlė;GINTARĖLIAI;4176986876;Ne;0;11;0;11
11224;Šermukšnėlė;GINTARĖLIAI;7036078780;Taip;13;4;0;17
11225;Šermukšnėlė;GINTARĖLIAI;1994737857;Ne;0;6;0;6
11226;Šermukšnėlė;GINTARĖLIAI;4619811264;Ne;0;6;0;6
11227;Šermukšnėlė;GINTARĖLIAI;5886893562;Ne;3;7;0;10
11228;Šermukšnėlė;GINTARĖLIAI;4783726095;Ne;0;2;0;2
11229;Šermukšnėlė;GINTARĖLIAI;9714566919;Ne;2;0;4;6
11230;Šermukšnėlė;GINTARĖLIAI;5172187141;Ne;0;5;0;5
11231;Šermukšnėlė;GINTARĖLIAI;3688946505;Ne;7;0;6;13
11232;Šermukšnėlė;GINTARĖLIAI;5905330617;Ne;0;2;2;4
11233;Šermukšnėlė;GINTARĖLIAI;1636944853;Ne;0;22;0;22
11234;Šermukšnėlė;GINTARĖLIAI;7053319091;Ne;1;2;3;6
11235;Šermukšnėlė;GINTARĖLIAI;6351841889;Taip;0;0;1;1
11236;Šermukšnėlė;GINTARĖLIAI;7305013368;Ne;0;2;0;2
11237;Šermukšnėlė;GINTARĖLIAI;6698650179;Ne;7;0;4;11
11238;Šermukšnėlė;GINTARĖLIAI;8639470631;Ne;3;0;2;5
11239;Šermukšnėlė;GINTARĖLIAI;8541743148;Ne;0;0;2;2
11240;Šermukšnėlė;AKMENUKAI;8407947566;Ne;0;2;4;6
11241;Šermukšnėlė;AKMENUKAI;8669676262;Ne;0;11;0;11
11242;Šermukšnėlė;AKMENUKAI;3148857617;Ne;0;16;0;16
11243;Šermukšnėlė;AKMENUKAI;4965640386;Ne;0;2;0;2
11244;Šermukšnėlė;AKMENUKAI;3639954786;Ne;16;2;4;22
11245;Šermukšnėlė;AKMENUKAI;7843128263;Ne;0;3;0;3
11246;Šermukšnėlė;AKMENUKAI;9805841777;Ne;0;11;0;11
11247;Šermukšnėlė;AKMENUKAI;3945291560;Ne;0;6;0;6
11248;Šermukšnėlė;AKMENUKAI;5660238634;Ne;0;5;0;5
11249;Šermukšnėlė;AKMENUKAI;6067298318;Ne;0;4;2;6
11250;Šermukšnėlė;AKMENUKAI;5678559268;Ne;0;2;2;4
11251;Šermukšnėlė;AKMENUKAI;8479230675;Ne;0;6;0;6
11252;Šermukšnėlė;AKMENUKAI;6162830167;Ne;0;0;2;2
11253;Šermukšnėlė;AKMENUKAI;2913363351;Ne;18;0;5;23
11254;Šermukšnėlė;AKMENUKAI;3613456202;Ne;0;4;4;8
11255;Šermukšnėlė;AKMENUKAI;2506945279;Ne;0;0;1;1
11256;Šermukšnėlė;AKMENUKAI;8709426669;Ne;0;18;0;18
11257;Šermukšnėlė;AKMENUKAI;6599779539;Ne;0;12;0;12
11258;Šermukšnėlė;AKMENUKAI;9876533442;Ne;0;10;3;13
11259;Šermukšnėlė;AKMENUKAI;3653792683;Ne;0;4;0;4
11260;Šermukšnėlė;SIŪLINUKAI;2967000352;Ne;0;2;0;2
11261;Šermukšnėlė;SIŪLINUKAI;4528448735;Ne;0;1;0;1
11262;Šermukšnėlė;SIŪLINUKAI;2740644605;Ne;6;2;2;10
11263;Šermukšnėlė;SIŪLINUKAI;8454298610;Ne;0;0;1;1
11264;Šermukšnėlė;SIŪLINUKAI;1819553019;Ne;7;0;1;8
11265;Šermukšnėlė;SIŪLINUKAI;7568969509;Ne;0;2;0;2
11266;Šermukšnėlė;SIŪLINUKAI;7758886713;Ne;0;1;0;1
11267;Šermukšnėlė;SIŪLINUKAI;5072021867;Ne;0;1;0;1
11268;Šermukšnėlė;SIŪLINUKAI;7934772640;Ne;0;5;0;5
11269;Šermukšnėlė;SIŪLINUKAI;3994075596;Ne;0;2;2;4
11270;Šermukšnėlė;SIŪLINUKAI;3098629992;Ne;0;2;0;2
11271;Šermukšnėlė;SIŪLINUKAI;6231057889;Ne;0;0;1;1
11272;Šermukšnėlė;SIŪLINUKAI;3106890807;Ne;2;0;3;5
11273;Šermukšnėlė;SIŪLINUKAI;3979766151;Ne;2;0;0;2
11274;Šermukšnėlė;SIŪLINUKAI;9534316724;Ne;0;2;2;4
11275;Šermukšnėlė;SIŪLINUKAI;2705569653;Ne;4;0;3;7
11276;Šermukšnėlė;SIŪLINUKAI;9703804879;Ne;0;1;0;1
11277;Šermukšnėlė;SIŪLINUKAI;1754181467;Ne;1;0;2;3
11278;Šermukšnėlė;MEDINUKAi;3819765572;Ne;2;0;3;5
11279;Šermukšnėlė;MEDINUKAi;2868258867;Ne;0;4;0;4
11280;Šermukšnėlė;MEDINUKAi;5483843510;Ne;6;1;3;10
11281;Šermukšnėlė;MEDINUKAi;7832178585;Ne;13;0;4;17
11282;Šermukšnėlė;MEDINUKAi;1931894084;Ne;5;1;2;8
11283;Šermukšnėlė;MEDINUKAi;3138507073;Ne;0;1;3;4
11284;Šermukšnėlė;MEDINUKAi;6778901855;Ne;0;1;0;1
11285;Šermukšnėlė;MEDINUKAi;1502704170;Ne;0;2;1;3
11286;Šermukšnėlė;MEDINUKAi;9247356229;Ne;0;10;0;10
11287;Šermukšnėlė;MEDINUKAi;3206222470;Ne;4;0;7;11
11288;Šermukšnėlė;MEDINUKAi;6524173015;Ne;0;5;0;5
11289;Šermukšnėlė;MEDINUKAi;5751303170;Ne;7;0;4;11
11290;Šermukšnėlė;MEDINUKAi;2810624440;Ne;3;2;4;9
11291;Šermukšnėlė;MEDINUKAi;3955219247;Ne;0;3;0;3
11292;Šermukšnėlė;MEDINUKAi;5564759354;Ne;4;0;2;6
11293;Šermukšnėlė;MEDINUKAi;5081685546;Taip;4;1;2;7
11294;Šermukšnėlė;SKUDURINUKAI;5162694179;Ne;6;5;0;11
11295;Šermukšnėlė;SKUDURINUKAI;4323596263;Ne;4;0;4;8
11296;Šermukšnėlė;SKUDURINUKAI;9005316719;Ne;0;9;0;9
11297;Šermukšnėlė;SKUDURINUKAI;7353340444;Ne;1;2;2;5
11298;Šermukšnėlė;SKUDURINUKAI;6618875999;Ne;3;0;5;8
11299;Šermukšnėlė;SKUDURINUKAI;9258544213;Ne;8;0;4;12
11300;Šermukšnėlė;SKUDURINUKAI;4839548718;Ne;3;1;2;6
11301;Šermukšnėlė;SKUDURINUKAI;2154197839;Ne;5;0;2;7
11302;Šermukšnėlė;SKUDURINUKAI;2156273039;Ne;4;0;2;6
11303;Šermukšnėlė;SKUDURINUKAI;9777470572;Ne;0;1;0;1
11304;Šermukšnėlė;SKUDURINUKAI;3024192802;Ne;1;0;2;3
11305;Šermukšnėlė;SKUDURINUKAI;1208356789;Ne;8;0;2;10
11306;Šermukšnėlė;SKUDURINUKAI;6437380493;Ne;3;0;3;6
11307;Šermukšnėlė;SKUDURINUKAI;8726532739;Ne;3;0;2;5
11308;Šermukšnėlė;PAGRANDUKAI;6185588116;Ne;3;0;7;10
11309;Šermukšnėlė;PAGRANDUKAI;1209135668;Ne;5;2;7;14
11310;Šermukšnėlė;PAGRANDUKAI;8641098720;Ne;0;4;0;4
11311;Šermukšnėlė;PAGRANDUKAI;8130815072;Ne;0;1;0;1
11312;Šermukšnėlė;PAGRANDUKAI;9246403711;Ne;9;0;4;13
11313;Šermukšnėlė;PAGRANDUKAI;3105388312;Ne;1;0;4;5
11314;Šermukšnėlė;PAGRANDUKAI;7570038521;Ne;9;2;4;15
11315;Šermukšnėlė;PAGRANDUKAI;4627034424;Ne;13;2;4;19
11316;Šermukšnėlė;PAGRANDUKAI;7777832161;Ne;1;0;3;4
11317;Šermukšnėlė;PAGRANDUKAI;4776535014;Ne;6;0;3;9
11318;Šermukšnėlė;PAGRANDUKAI;1761737605;Ne;11;0;4;15
11319;Šermukšnėlė;PAGRANDUKAI;5397987456;Ne;8;0;3;11
11320;Šermukšnėlė;PAGRANDUKAI;3705620362;Ne;5;0;2;7
11321;Šypsena;NYKŠTUKAI;3806651280;Ne;2;12;2;16
11322;Šypsena;NYKŠTUKAI;4330797734;Ne;0;1;0;1
11323;Šypsena;NYKŠTUKAI;7876871684;Ne;6;0;5;11
11324;Šypsena;NYKŠTUKAI;6055482561;Ne;11;4;6;21
11325;Šypsena;NYKŠTUKAI;6028006499;Ne;2;2;2;6
11326;Šypsena;NYKŠTUKAI;3724483762;Ne;0;2;0;2
11327;Šypsena;NYKŠTUKAI;7817486488;Ne;16;2;5;23
11328;Šypsena;NYKŠTUKAI;9862387726;Ne;0;1;0;1
11329;Šypsena;NYKŠTUKAI;8001187137;Ne;0;1;5;6
11330;Šypsena;NYKŠTUKAI;8094166916;Ne;0;2;1;3
11331;Šypsena;NYKŠTUKAI;5446516798;Ne;0;2;1;3
11332;Šypsena;NYKŠTUKAI;5094556499;Ne;0;2;3;5
11333;Šypsena;NYKŠTUKAI;4496704989;Ne;6;2;13;21
11334;Šypsena;NYKŠTUKAI;7471913547;Ne;0;2;0;2
11335;Šypsena;NYKŠTUKAI;7174068697;Ne;0;0;2;2
11336;Šypsena;NYKŠTUKAI;7905089772;Ne;0;2;3;5
11337;Šypsena;NYKŠTUKAI;7960872132;Ne;0;2;1;3
11338;Šypsena;NYKŠTUKAI;4260693029;Ne;0;11;0;11
11339;Šypsena;SPINDULIUKAI;8627994583;Ne;0;3;6;9
11340;Šypsena;SPINDULIUKAI;9363618080;Ne;0;2;0;2
11341;Šypsena;SPINDULIUKAI;8913058656;Ne;0;1;0;1
11342;Šypsena;SPINDULIUKAI;9702364620;Ne;7;6;2;15
11343;Šypsena;SPINDULIUKAI;3733757483;Ne;3;0;12;15
11344;Šypsena;SPINDULIUKAI;2179657619;Ne;0;3;0;3
11345;Šypsena;SPINDULIUKAI;2900195046;Ne;0;7;0;7
11346;Šypsena;SPINDULIUKAI;5818211923;Ne;0;2;0;2
11347;Šypsena;SPINDULIUKAI;8665786789;Ne;4;0;7;11
11348;Šypsena;SPINDULIUKAI;3003901966;Ne;15;2;2;19
11349;Šypsena;SPINDULIUKAI;2182189246;Ne;0;1;0;1
11350;Šypsena;SPINDULIUKAI;1431850136;Ne;0;2;4;6
11351;Šypsena;SPINDULIUKAI;1716274053;Ne;7;2;15;24
11352;Šypsena;SPINDULIUKAI;8439694239;Ne;7;2;5;14
11353;Šypsena;SPINDULIUKAI;6377979434;Ne;0;2;5;7
11354;Šypsena;SPINDULIUKAI;6724776618;Ne;3;2;11;16
11355;Šypsena;SPINDULIUKAI;2790906806;Ne;0;2;5;7
11356;Šypsena;SKRUZDELIUKAI;7898387398;Ne;0;1;0;1
11357;Šypsena;SKRUZDELIUKAI;1324902555;Ne;0;2;0;2
11358;Šypsena;SKRUZDELIUKAI;5222603743;Ne;1;2;2;5
11359;Šypsena;SKRUZDELIUKAI;7120597034;Ne;0;2;0;2
11360;Šypsena;SKRUZDELIUKAI;5879506651;Ne;0;2;2;4
11361;Šypsena;SKRUZDELIUKAI;3901424559;Ne;0;11;0;11
11362;Šypsena;SKRUZDELIUKAI;6713182218;Taip;0;2;0;2
11363;Šypsena;SKRUZDELIUKAI;8215278033;Ne;0;13;0;13
11364;Šypsena;SKRUZDELIUKAI;7537442618;Ne;0;7;0;7
11365;Šypsena;SKRUZDELIUKAI;2584574423;Ne;0;8;2;10
11366;Šypsena;SKRUZDELIUKAI;9704350208;Ne;0;4;0;4
11367;Šypsena;SKRUZDELIUKAI;5906001927;Ne;0;3;0;3
11368;Šypsena;SKRUZDELIUKAI;6951845385;Ne;0;3;2;5
11369;Šypsena;SKRUZDELIUKAI;7877396588;Ne;1;2;3;6
11370;Šypsena;SKRUZDELIUKAI;8765509994;Ne;0;1;0;1
11371;Šypsena;SKRUZDELIUKAI;4520148322;Ne;0;10;0;10
11372;Šypsena;Bitutės;1422418997;Ne;1;2;2;5
11373;Šypsena;Bitutės;3130841241;Ne;20;2;0;22
11374;Šypsena;Bitutės;3810433774;Ne;5;10;3;18
11375;Šypsena;Bitutės;9623451754;Ne;0;3;3;6
11376;Šypsena;Bitutės;1114341518;Ne;6;0;4;10
11377;Šypsena;Bitutės;1558614852;Ne;0;3;0;3
11378;Šypsena;Bitutės;1897176871;Ne;1;7;0;8
11379;Šypsena;Bitutės;1181590127;Ne;0;13;0;13
11380;Šypsena;Bitutės;4808041625;Ne;0;2;1;3
11381;Šypsena;Bitutės;5834057370;Ne;0;3;0;3
11382;Šypsena;Bitutės;3809171499;Ne;0;6;2;8
11383;Šypsena;Bitutės;5928432220;Ne;0;1;2;3
11384;Šypsena;Bitutės;5504570516;Ne;0;8;0;8
11385;Šypsena;Bitutės;1063834589;Ne;0;3;0;3
11386;Šypsena;Bitutės;5369445077;Ne;0;2;1;3
11387;Šypsena;Bitutės;2798819321;Ne;0;5;0;5
11388;Šypsena;Bitutės;4450146424;Ne;0;2;0;2
11389;Šypsena;MEŠKIUKAI;9696633725;Taip;3;3;2;8
11390;Šypsena;MEŠKIUKAI;4011596895;Ne;0;4;0;4
11391;Šypsena;MEŠKIUKAI;7234904026;Ne;5;4;2;11
11392;Šypsena;MEŠKIUKAI;3951000812;Ne;0;12;0;12
11393;Šypsena;MEŠKIUKAI;2177181171;Ne;18;2;2;22
11394;Šypsena;MEŠKIUKAI;1657019248;Ne;0;2;1;3
11395;Šypsena;MEŠKIUKAI;8756079118;Ne;0;2;0;2
11396;Šypsena;MEŠKIUKAI;4960714853;Ne;0;2;0;2
11397;Šypsena;MEŠKIUKAI;6224937025;Ne;0;2;0;2
11398;Šypsena;MEŠKIUKAI;1934857313;Ne;0;2;1;3
11399;Šypsena;MEŠKIUKAI;8109877136;Ne;0;2;2;4
11400;Šypsena;MEŠKIUKAI;9841955736;Ne;2;12;2;16
11401;Šypsena;MEŠKIUKAI;2692869989;Ne;0;3;0;3
11402;Šypsena;MEŠKIUKAI;3205854107;Ne;0;1;0;1
11403;Šypsena;BORUŽĖLĖS;3563748951;Ne;7;0;9;16
11404;Šypsena;BORUŽĖLĖS;1153036896;Ne;8;2;5;15
11405;Šypsena;BORUŽĖLĖS;3624678823;Ne;11;2;3;16
11406;Šypsena;BORUŽĖLĖS;9232229854;Ne;0;2;0;2
11407;Šypsena;BORUŽĖLĖS;1597728767;Ne;3;2;2;7
11408;Šypsena;BORUŽĖLĖS;3285293143;Ne;0;12;0;12
11409;Šypsena;BORUŽĖLĖS;6905376170;Ne;10;0;2;12
11410;Šypsena;BORUŽĖLĖS;3643736553;Ne;10;2;0;12
11411;Šypsena;BORUŽĖLĖS;4218879286;Ne;12;0;3;15
11412;Šnekutis;DRUGELIŲ;9543014297;Ne;8;3;3;14
11413;Šnekutis;DRUGELIŲ;3096125224;Ne;0;5;6;11
11414;Šnekutis;DRUGELIŲ;3386995244;Taip;4;0;4;8
11415;Šnekutis;DRUGELIŲ;8984597121;Ne;4;0;2;6
11416;Šnekutis;DRUGELIŲ;8810371475;Ne;1;0;2;3
11417;Šnekutis;DRUGELIŲ;7680962037;Ne;7;13;2;22
11418;Šnekutis;DRUGELIŲ;3611064172;Ne;2;4;4;10
11419;Šnekutis;DRUGELIŲ;8036600501;Ne;1;0;2;3
11420;Šnekutis;DRUGELIŲ;1556960616;Ne;5;2;4;11
11421;Šnekutis;DRUGELIŲ;4380966487;Ne;0;1;0;1
11422;Šnekutis;DRUGELIŲ;7954240439;Ne;0;18;0;18
11423;Šnekutis;DRUGELIŲ;6330033887;Ne;0;1;0;1
11424;Šnekutis;DRUGELIŲ;6071004512;Ne;0;4;1;5
11425;Šnekutis;DRUGELIŲ;1504945841;Ne;8;12;2;22
11426;Šnekutis;DRUGELIŲ;3177449195;Ne;0;2;0;2
11427;Šnekutis;DRUGELIŲ;1902486846;Ne;3;0;2;5
11428;Šnekutis;DRUGELIŲ;2131948397;Taip;0;1;0;1
11429;Šnekutis;Kačiukų;2914145045;Ne;9;1;3;13
11430;Šnekutis;Kačiukų;2656152037;Taip;0;6;0;6
11431;Šnekutis;Kačiukų;5521822696;Ne;0;1;1;2
11432;Šnekutis;Kačiukų;2144568225;Ne;3;0;0;3
11433;Šnekutis;Kačiukų;4624075875;Ne;0;0;5;5
11434;Šnekutis;Kačiukų;5828953086;Ne;12;0;0;12
11435;Šnekutis;Kačiukų;3635781445;Ne;6;0;6;12
11436;Šnekutis;Kačiukų;7109850241;Ne;6;7;2;15
11437;Šnekutis;Kačiukų;2386547087;Ne;2;0;1;3
11438;Šnekutis;Kačiukų;6072420827;Ne;22;0;0;22
11439;Šnekutis;Kačiukų;2626247219;Ne;1;0;3;4
11440;Šnekutis;Kačiukų;7707897830;Ne;2;0;3;5
11441;Šnekutis;Kačiukų;2312968654;Ne;3;0;2;5
11442;Šnekutis;Kačiukų;2852111627;Ne;0;2;5;7
11443;Šnekutis;Kačiukų;3214549246;Ne;6;0;3;9
11444;Šnekutis;Kačiukų;9574210410;Ne;0;2;4;6
11445;Šnekutis;Kačiukų;8417485561;Ne;0;0;1;1
11446;Šnekutis;Kačiukų;2042842873;Ne;4;0;2;6
11447;Šnekutis;Kačiukų;5727476284;Ne;0;0;6;6
11448;Šnekutis;Kačiukų;7391278306;Ne;6;0;3;9
11449;Šnekutis;Kačiukų;5590071706;Ne;2;0;5;7
11450;Šnekutis;Pėlėdžiukų;4835202527;Ne;3;0;2;5
11451;Šnekutis;Pėlėdžiukų;7089000987;Ne;0;2;0;2
11452;Šnekutis;Pėlėdžiukų;9326455786;Ne;3;0;2;5
11453;Šnekutis;Pėlėdžiukų;2843483435;Ne;3;2;2;7
11454;Šnekutis;Pėlėdžiukų;5906320006;Taip;0;0;2;2
11455;Šnekutis;Pėlėdžiukų;6405894763;Ne;0;13;0;13
11456;Šnekutis;Pėlėdžiukų;3889176018;Taip;2;7;2;11
11457;Šnekutis;Pėlėdžiukų;9054899440;Ne;3;0;3;6
11458;Šnekutis;Pėlėdžiukų;7307895397;Ne;0;0;5;5
11459;Šnekutis;Pėlėdžiukų;3371393656;Ne;3;0;4;7
11460;Šnekutis;Pėlėdžiukų;3344425033;Ne;0;0;5;5
11461;Šnekutis;Pėlėdžiukų;6544973632;Ne;6;0;11;17
11462;Šnekutis;Pėlėdžiukų;8219465079;Ne;0;4;0;4
11463;Šnekutis;Pėlėdžiukų;2779793970;Ne;3;3;2;8
11464;Šnekutis;Pėlėdžiukų;6146988521;Taip;0;12;2;14
11465;Šnekutis;Pėlėdžiukų;5519015388;Ne;0;2;1;3
11466;Šnekutis;Pėlėdžiukų;3628210526;Ne;0;2;0;2
11467;Šnekutis;Pėlėdžiukų;7344776758;Ne;0;0;5;5
11468;Šnekutis;Pėlėdžiukų;5970951526;Taip;0;0;2;2
11469;Šnekutis;Pėlėdžiukų;3937465849;Ne;0;2;0;2
11470;Šnekutis;Boružėlių;9887692849;Ne;0;0;4;4
11471;Šnekutis;Boružėlių;1833392181;Ne;7;0;4;11
11472;Šnekutis;Boružėlių;3115675798;Ne;4;0;4;8
11473;Šnekutis;Boružėlių;1805259980;Ne;2;0;2;4
11474;Šnekutis;Boružėlių;9790241725;Ne;3;0;4;7
11475;Šnekutis;Boružėlių;7006343288;Ne;10;1;2;13
11476;Šnekutis;Boružėlių;9322106995;Ne;0;0;4;4
11477;Šnekutis;Boružėlių;1248466603;Ne;3;0;2;5
11478;Šnekutis;Boružėlių;3842436406;Ne;0;3;0;3
11479;Šnekutis;Boružėlių;9772257715;Taip;0;12;2;14
11480;Šnekutis;Boružėlių;3593766968;Ne;5;0;5;10
11481;Šnekutis;Boružėlių;5919317274;Ne;0;0;2;2
11482;Šnekutis;Boružėlių;7200356364;Ne;3;0;4;7
11483;Šnekutis;Boružėlių;6306269165;Ne;0;1;0;1
11484;Šnekutis;Boružėlių;2761479685;Taip;0;1;0;1
11485;Šnekutis;Boružėlių;8456957469;Ne;0;1;0;1
11486;Šnekutis;Boružėlių;1475304511;Ne;3;0;4;7
11487;Šnekutis;Boružėlių;6669530657;Ne;4;0;5;9
11488;Šnekutis;Meškučių;1219175855;Ne;4;0;4;8
11489;Šnekutis;Meškučių;7980166125;Ne;2;0;2;4
11490;Šnekutis;Meškučių;6041045276;Ne;1;0;2;3
11491;Šnekutis;Meškučių;2134556666;Ne;18;0;2;20
11492;Šnekutis;Meškučių;7775818807;Ne;0;2;6;8
11493;Šnekutis;Meškučių;9752334636;Ne;3;0;2;5
11494;Šnekutis;Meškučių;8612528998;Ne;3;0;3;6
11495;Šnekutis;Meškučių;6915324469;Ne;1;3;2;6
11496;Šnekutis;Meškučių;5785972840;Ne;8;1;2;11
11497;Šnekutis;Meškučių;4963132460;Ne;0;2;2;4
11498;Šnekutis;Meškučių;5506037153;Ne;7;0;2;9
11499;Šnekutis;Meškučių;1772197145;Ne;4;0;5;9
11500;Šnekutis;Meškučių;4452941417;Ne;0;0;6;6
11501;Šnekutis;Meškučių;8332860563;Ne;0;1;0;1
11502;Šnekutis;Meškučių;3173995001;Ne;8;0;2;10
11503;Šnekutis;Meškučių;2615956847;Ne;22;0;0;22
11504;Šnekutis;Viščiukų;3588737003;Ne;2;7;3;12
11505;Šnekutis;Viščiukų;4848437026;Ne;5;0;2;7
11506;Šnekutis;Viščiukų;5059417996;Ne;5;0;2;7
11507;Šnekutis;Viščiukų;7914683654;Ne;8;1;3;12
11508;Šnekutis;Viščiukų;6849168221;Ne;10;0;2;12
11509;Šnekutis;Viščiukų;8061450452;Ne;2;0;2;4
11510;Šnekutis;Viščiukų;9238064074;Ne;15;0;2;17
11511;Šnekutis;Viščiukų;2258811969;Ne;8;7;2;17
11512;Šnekutis;Viščiukų;3852214850;Ne;9;0;2;11
11513;Šnekutis;Viščiukų;3869428583;Ne;5;0;2;7
11514;Šnekutis;Viščiukų;9433668798;Ne;1;0;2;3
11515;Šnekutis;Viščiukų;8241953257;Ne;4;0;3;7
11516;Šnekutis;Viščiukų;5185096482;Ne;2;2;3;7
11517;Šnekutis;Viščiukų;8900769157;Ne;2;0;2;4
11518;Šnekutis;Viščiukų;1811580823;Ne;7;3;2;12
11519;Šnekutis;Viščiukų;9385583890;Ne;0;9;13;22
11520;Užupiukas;VYTURĖLIŲ;9807212956;Ne;0;0;7;7
11521;Užupiukas;VYTURĖLIŲ;5182110542;Ne;7;0;4;11
11522;Užupiukas;VYTURĖLIŲ;3690562985;Ne;3;2;2;7
11523;Užupiukas;VYTURĖLIŲ;7034777770;Ne;0;0;5;5
11524;Užupiukas;VYTURĖLIŲ;4449466321;Ne;0;0;8;8
11525;Užupiukas;VYTURĖLIŲ;9872846882;Ne;4;0;6;10
11526;Užupiukas;VYTURĖLIŲ;5694960072;Ne;0;0;10;10
11527;Užupiukas;VYTURĖLIŲ;3879735445;Ne;0;15;1;16
11528;Užupiukas;VYTURĖLIŲ;2377079878;Ne;0;7;0;7
11529;Užupiukas;VYTURĖLIŲ;3474990673;Ne;6;0;5;11
11530;Užupiukas;VYTURĖLIŲ;1434083187;Ne;0;0;1;1
11531;Užupiukas;VYTURĖLIŲ;5851602817;Ne;4;7;2;13
11532;Užupiukas;VYTURĖLIŲ;8601594247;Ne;2;2;2;6
11533;Užupiukas;VYTURĖLIŲ;9556937880;Ne;13;2;2;17
11534;Užupiukas;VYTURĖLIŲ;4055044580;Ne;3;0;3;6
11535;Užupiukas;VYTURĖLIŲ;3654349639;Ne;0;2;0;2
11536;Užupiukas;VYTURĖLIŲ;3275112189;Ne;2;2;7;11
11537;Užupiukas;VYTURĖLIŲ;5280778870;Ne;7;2;2;11
11538;Užupiukas;VYTURĖLIŲ;7735497084;Ne;2;2;3;7
11539;Užupiukas;VYTURĖLIŲ;8931872728;Ne;5;5;4;14
11540;Užupiukas;KAČIUKŲ;3905448176;Ne;0;0;1;1
11541;Užupiukas;KAČIUKŲ;3567963511;Ne;0;2;0;2
11542;Užupiukas;KAČIUKŲ;9991552624;Ne;0;2;0;2
11543;Užupiukas;KAČIUKŲ;3048959458;Ne;4;2;4;10
11544;Užupiukas;KAČIUKŲ;1809036046;Ne;3;2;5;10
11545;Užupiukas;KAČIUKŲ;1102468034;Ne;0;2;2;4
11546;Užupiukas;KAČIUKŲ;1464016943;Ne;0;2;1;3
11547;Užupiukas;KAČIUKŲ;9386211193;Ne;0;2;0;2
11548;Užupiukas;KAČIUKŲ;1388346927;Ne;0;3;0;3
11549;Užupiukas;KAČIUKŲ;9333587467;Ne;3;2;2;7
11550;Užupiukas;KAČIUKŲ;7092857844;Ne;0;2;0;2
11551;Užupiukas;KAČIUKŲ;2606742144;Ne;0;2;0;2
11552;Užupiukas;KAČIUKŲ;3543913063;Ne;3;2;6;11
11553;Užupiukas;KAČIUKŲ;4920190785;Ne;0;6;0;6
11554;Užupiukas;KAČIUKŲ;1414888906;Ne;0;2;0;2
11555;Užupiukas;KAČIUKŲ;5436401811;Ne;4;2;4;10
11556;Užupiukas;KAČIUKŲ;3001874900;Ne;6;0;5;11
11557;Užupiukas;KAČIUKŲ;1930961813;Ne;0;2;0;2
11558;Užupiukas;KAČIUKŲ;3794021404;Ne;0;2;3;5
11559;Užupiukas;KAČIUKŲ;6685567970;Ne;0;2;0;2
11560;Užupiukas;DRUGELIŲ;8876174256;Ne;4;7;4;15
11561;Užupiukas;DRUGELIŲ;5239006321;Ne;0;12;1;13
11562;Užupiukas;DRUGELIŲ;7581152903;Ne;3;1;5;9
11563;Užupiukas;DRUGELIŲ;6698907535;Ne;8;2;3;13
11564;Užupiukas;DRUGELIŲ;4595291532;Ne;0;2;1;3
11565;Užupiukas;DRUGELIŲ;3383643388;Ne;0;1;3;4
11566;Užupiukas;DRUGELIŲ;3961733676;Ne;7;0;5;12
11567;Užupiukas;DRUGELIŲ;5006880916;Ne;6;0;6;12
11568;Užupiukas;DRUGELIŲ;9715624372;Ne;3;1;5;9
11569;Užupiukas;DRUGELIŲ;1108429907;Ne;8;0;6;14
11570;Užupiukas;DRUGELIŲ;9295230331;Ne;0;0;2;2
11571;Užupiukas;DRUGELIŲ;3575209839;Ne;0;6;1;7
11572;Užupiukas;DRUGELIŲ;5361599156;Ne;4;0;4;8
11573;Užupiukas;DRUGELIŲ;9577167600;Ne;2;1;4;7
11574;Užupiukas;DRUGELIŲ;3940029893;Ne;0;0;2;2
11575;Užupiukas;DRUGELIŲ;1156471313;Ne;0;0;2;2
11576;Užupiukas;DRUGELIŲ;4075611307;Ne;0;1;1;2
11577;Užupiukas;DRUGELIŲ;4680027403;Ne;0;0;2;2
11578;Užupiukas;EŽIUKŲ;8936209423;Ne;0;0;2;2
11579;Užupiukas;EŽIUKŲ;2522356285;Ne;4;0;4;8
11580;Užupiukas;EŽIUKŲ;5055376157;Ne;6;2;4;12
11581;Užupiukas;EŽIUKŲ;3235855849;Ne;5;0;4;9
11582;Užupiukas;EŽIUKŲ;4788900708;Ne;0;0;2;2
11583;Užupiukas;EŽIUKŲ;4670096314;Ne;0;22;0;22
11584;Užupiukas;EŽIUKŲ;7914295007;Ne;6;0;4;10
11585;Užupiukas;EŽIUKŲ;7671705684;Ne;8;0;4;12
11586;Užupiukas;EŽIUKŲ;6016947840;Ne;6;2;3;11
11587;Užupiukas;EŽIUKŲ;8443732431;Ne;5;0;4;9
11588;Užupiukas;EŽIUKŲ;4583779329;Ne;6;0;2;8
11589;Užupiukas;EŽIUKŲ;1757695746;Ne;6;0;2;8
11590;Užupiukas;EŽIUKŲ;4357253574;Ne;16;0;3;19
11591;Užupiukas;EŽIUKŲ;7299810108;Ne;8;0;5;13
11592;Užupiukas;EŽIUKŲ;5866437622;Ne;0;11;2;13
11593;Užupiukas;EŽIUKŲ;5784908270;Ne;0;0;8;8
11594;Užupiukas;EŽIUKŲ;9163947073;Ne;9;2;4;15
11595;Užupiukas;EŽIUKŲ;4034821342;Ne;0;0;2;2
11596;Užupiukas;EŽIUKŲ;7589905741;Ne;1;0;5;6
11597;Užupiukas;BORUŽĖLIŲ;8467502933;Ne;9;0;4;13
11598;Užupiukas;BORUŽĖLIŲ;4151757682;Ne;10;0;4;14
11599;Užupiukas;BORUŽĖLIŲ;3014087333;Ne;0;0;3;3
11600;Užupiukas;BORUŽĖLIŲ;3811750547;Ne;0;0;5;5
11601;Užupiukas;BORUŽĖLIŲ;2158976125;Ne;0;0;4;4
11602;Užupiukas;BORUŽĖLIŲ;1891855020;Ne;0;0;2;2
11603;Užupiukas;BORUŽĖLIŲ;1473606331;Ne;5;0;3;8
11604;Užupiukas;BORUŽĖLIŲ;9312234251;Ne;0;8;2;10
11605;Užupiukas;BORUŽĖLIŲ;4570457987;Ne;1;0;6;7
11606;Užupiukas;BORUŽĖLIŲ;6206118484;Ne;0;0;2;2
11607;Užupiukas;BORUŽĖLIŲ;4841475687;Ne;1;0;4;5
11608;Užupiukas;BORUŽĖLIŲ;9714322911;Ne;0;0;4;4
11609;Užupiukas;BORUŽĖLIŲ;7107441792;Ne;4;0;4;8
11610;Užupiukas;BORUŽĖLIŲ;7105857162;Ne;1;0;3;4
11611;Užupiukas;BORUŽĖLIŲ;8881187663;Ne;0;0;1;1
11612;Užupiukas;BORUŽĖLIŲ;7895825571;Ne;2;0;0;2
11613;Užupiukas;BORUŽĖLIŲ;7169272175;Ne;0;0;4;4
11614;Užupiukas;BORUŽĖLIŲ;7716893423;Ne;0;0;2;2
11615;Užupiukas;BORUŽĖLIŲ;6857321547;Ne;0;0;3;3
11616;Užupiukas;SPINDULIUKŲ;7443013255;Ne;0;2;0;2
11617;Užupiukas;SPINDULIUKŲ;3656400244;Ne;0;7;3;10
11618;Užupiukas;SPINDULIUKŲ;5718382826;Ne;2;2;4;8
11619;Užupiukas;SPINDULIUKŲ;2580733127;Ne;0;2;0;2
11620;Užupiukas;SPINDULIUKŲ;1791922219;Ne;0;2;2;4
11621;Užupiukas;SPINDULIUKŲ;1146968021;Ne;0;2;0;2
11622;Užupiukas;SPINDULIUKŲ;9212428150;Ne;2;1;4;7
11623;Užupiukas;SPINDULIUKŲ;8001099421;Ne;7;0;4;11
11624;Užupiukas;SPINDULIUKŲ;4401569800;Ne;0;2;0;2
11625;Užupiukas;SPINDULIUKŲ;1391826582;Ne;3;2;2;7
11626;Užupiukas;SPINDULIUKŲ;5021163099;Ne;0;7;0;7
11627;Užupiukas;SPINDULIUKŲ;8960813016;Ne;0;2;0;2
11628;Užupiukas;SPINDULIUKŲ;9132605734;Ne;6;0;4;10
11629;Užupiukas;SPINDULIUKŲ;8347350503;Ne;3;2;6;11
11630;Užupiukas;SPINDULIUKŲ;9209209113;Ne;4;2;2;8
11631;Užupiukas;SPINDULIUKŲ;5116564840;Ne;3;2;4;9
11632;Užupiukas;ŽVIRBLIUKŲ;5085660507;Ne;0;7;0;7
11633;Užupiukas;ŽVIRBLIUKŲ;2273766308;Ne;4;2;2;8
11634;Užupiukas;ŽVIRBLIUKŲ;9925592494;Ne;0;2;0;2
11635;Užupiukas;ŽVIRBLIUKŲ;7345579721;Ne;3;0;2;5
11636;Užupiukas;ŽVIRBLIUKŲ;4710910251;Ne;0;4;0;4
11637;Užupiukas;ŽVIRBLIUKŲ;9428884149;Ne;4;2;4;10
11638;Užupiukas;ŽVIRBLIUKŲ;2210437775;Ne;0;3;0;3
11639;Užupiukas;ŽVIRBLIUKŲ;1496541880;Ne;0;7;2;9
11640;Užupiukas;ŽVIRBLIUKŲ;1684901495;Ne;0;3;0;3
11641;Užupiukas;ŽVIRBLIUKŲ;2390955083;Ne;0;2;0;2
11642;Užupiukas;ŽVIRBLIUKŲ;6001766518;Ne;0;2;0;2
11643;Užupiukas;ŽVIRBLIUKŲ;4785494419;Ne;3;8;2;13
11644;Užupiukas;ŽVIRBLIUKŲ;8119142600;Ne;0;17;0;17
11645;Užupiukas;ŽVIRBLIUKŲ;2362568676;Ne;2;1;2;5
11646;Užupiukas;ŽVIRBLIUKŲ;7530856195;Ne;0;2;0;2
11647;Užupiukas;ŽVIRBLIUKŲ;4054724625;Ne;0;3;0;3
11648;Užupiukas;ŽVIRBLIUKŲ;1843171673;Ne;9;2;4;15
11649;Užupiukas;ŽVIRBLIUKŲ;9719845726;Ne;3;1;2;6
11650;Užupiukas;ŽVIRBLIUKŲ;1647271985;Ne;0;1;0;1
11651;Užupiukas;PELĖDŽIUKŲ;3398225200;Ne;0;2;0;2
11652;Užupiukas;PELĖDŽIUKŲ;6699322898;Ne;11;2;4;17
11653;Užupiukas;PELĖDŽIUKŲ;5204808398;Ne;0;2;0;2
11654;Užupiukas;PELĖDŽIUKŲ;9906475253;Ne;0;2;6;8
11655;Užupiukas;PELĖDŽIUKŲ;3171528288;Ne;0;2;2;4
11656;Užupiukas;PELĖDŽIUKŲ;7860601571;Ne;4;2;4;10
11657;Užupiukas;PELĖDŽIUKŲ;3611922301;Ne;0;2;0;2
11658;Užupiukas;PELĖDŽIUKŲ;8020138690;Ne;0;0;1;1
11659;Užupiukas;PELĖDŽIUKŲ;9774124589;Ne;0;2;2;4
11660;Užupiukas;PELĖDŽIUKŲ;2724216446;Ne;2;6;2;10
11661;Užupiukas;PELĖDŽIUKŲ;6823724962;Ne;0;2;0;2
11662;Užupiukas;PELĖDŽIUKŲ;9446562736;Ne;0;2;0;2
11663;Užupiukas;PELĖDŽIUKŲ;5072363435;Ne;0;2;0;2
11664;Užupiukas;PELĖDŽIUKŲ;1651249962;Ne;0;2;1;3
11665;Užupiukas;PELĖDŽIUKŲ;1526296386;Ne;0;4;3;7
11666;Užupiukas;PELĖDŽIUKŲ;8720638097;Ne;2;2;4;8
11667;Užupiukas;PELĖDŽIUKŲ;3057147440;Ne;0;2;2;4
11668;Užupiukas;PELĖDŽIUKŲ;6370918943;Ne;0;2;4;6
11669;Užupiukas;PELĖDŽIUKŲ;1100574872;Ne;6;3;3;12
11670;Užupiukas;PELĖDŽIUKŲ;9357101972;Ne;0;3;1;4
11671;Užupiukas;VARPELIŲ;7919242126;Ne;0;0;2;2
11672;Užupiukas;VARPELIŲ;9310238442;Ne;4;0;2;6
11673;Užupiukas;VARPELIŲ;5941280824;Ne;0;2;9;11
11674;Užupiukas;VARPELIŲ;2485426055;Ne;5;0;3;8
11675;Užupiukas;VARPELIŲ;7314085267;Ne;3;0;4;7
11676;Užupiukas;VARPELIŲ;2752139377;Ne;3;0;4;7
11677;Užupiukas;VARPELIŲ;4106614478;Ne;0;0;2;2
11678;Užupiukas;VARPELIŲ;1407429980;Ne;3;0;3;6
11679;Užupiukas;VARPELIŲ;4811619739;Ne;1;0;4;5
11680;Užupiukas;VARPELIŲ;2767523129;Ne;0;0;2;2
11681;Užupiukas;VARPELIŲ;9523512906;Ne;8;0;4;12
11682;Užupiukas;VARPELIŲ;5148672602;Ne;4;0;6;10
11683;Užupiukas;VARPELIŲ;2769924857;Ne;4;0;4;8
11684;Užupiukas;VARPELIŲ;7837545732;Ne;0;1;0;1
11685;Užupiukas;VARPELIŲ;4112143599;Ne;6;0;3;9
11686;Užupiukas;VARPELIŲ;7628420639;Ne;6;0;5;11
11687;Užupiukas;VARPELIŲ;6879206867;Ne;0;0;1;1
11688;Užupiukas;VARPELIŲ;4206519159;Ne;0;0;4;4
11689;Užupiukas;VARPELIŲ;9514298829;Ne;0;0;2;2
11690;Užupiukas;VARPELIŲ;3394103404;Ne;0;0;6;6
11691;Užupiukas;VARPELIŲ;4446988239;Ne;0;0;5;5
11692;Užupiukas;SAULUČIŲ;5704945892;Ne;0;2;6;8
11693;Užupiukas;SAULUČIŲ;2681679016;Ne;0;15;2;17
11694;Užupiukas;SAULUČIŲ;3684774901;Ne;0;2;0;2
11695;Užupiukas;SAULUČIŲ;8163092636;Ne;0;0;3;3
11696;Užupiukas;SAULUČIŲ;1976775494;Ne;3;0;3;6
11697;Užupiukas;SAULUČIŲ;5874450724;Ne;0;4;3;7
11698;Užupiukas;SAULUČIŲ;3341292382;Ne;1;0;7;8
11699;Užupiukas;SAULUČIŲ;2211595125;Ne;2;2;0;4
11700;Užupiukas;SAULUČIŲ;5570569874;Ne;0;0;3;3
11701;Užupiukas;SAULUČIŲ;7643286183;Ne;0;2;1;3
11702;Užupiukas;SAULUČIŲ;2814556305;Ne;0;0;5;5
11703;Užupiukas;SAULUČIŲ;9953994943;Ne;8;2;4;14
11704;Užupiukas;SAULUČIŲ;7956550754;Ne;3;0;4;7
11705;Užupiukas;SAULUČIŲ;5469735455;Ne;0;12;1;13
11706;Užupiukas;SAULUČIŲ;8489545569;Ne;3;0;3;6
11707;Užupiukas;SAULUČIŲ;4691413468;Ne;7;0;3;10
11708;Užupiukas;SAULUČIŲ;7423292334;Ne;3;4;2;9
11709;Užupiukas;SAULUČIŲ;9216626936;Ne;5;2;3;10
11710;Užupiukas;SAULUČIŲ;9962455415;Ne;0;0;2;2
11711;Užupiukas;SAULUČIŲ;9709440406;Ne;0;2;0;2
11712;Užupiukas;SAULUČIŲ;9434907771;Ne;0;0;5;5
11713;Užupiukas;LAPIUKŲ;9833934299;Ne;0;4;0;4
11714;Užupiukas;LAPIUKŲ;4963679583;Ne;1;0;2;3
11715;Užupiukas;LAPIUKŲ;2679915982;Ne;0;1;1;2
11716;Užupiukas;LAPIUKŲ;6004467875;Ne;0;8;0;8
11717;Užupiukas;LAPIUKŲ;1718048938;Ne;0;2;0;2
11718;Užupiukas;LAPIUKŲ;7986962850;Ne;0;3;0;3
11719;Užupiukas;LAPIUKŲ;2517606394;Ne;3;1;3;7
11720;Užupiukas;LAPIUKŲ;5965564175;Ne;2;0;2;4
11721;Užupiukas;LAPIUKŲ;5680350014;Ne;0;1;2;3
11722;Užupiukas;LAPIUKŲ;7161001771;Ne;0;22;0;22
11723;Užupiukas;LAPIUKŲ;1886792898;Ne;0;3;0;3
11724;Užupiukas;LAPIUKŲ;6967184410;Ne;3;2;3;8
11725;Užupiukas;LAPIUKŲ;1178152392;Ne;6;3;2;11
11726;Užupiukas;LAPIUKŲ;7029091978;Ne;0;1;2;3
11727;Užupiukas;LAPIUKŲ;3311694266;Ne;1;1;2;4
11728;Užupiukas;LAPIUKŲ;1041972540;Ne;0;2;0;2
11729;Užupiukas;LAPIUKŲ;4467470795;Ne;0;2;0;2
11730;Užupiukas;LAPIUKŲ;3333547785;Ne;0;2;2;4
11731;Užupiukas;LAPIUKŲ;8529259340;Ne;0;14;1;15
11732;Užupiukas;LAPIUKŲ;7487174943;Ne;0;2;0;2
11733;Užupiukas;LAPIUKŲ;8252575784;Ne;2;2;2;6
11734;Užupiukas;LAPIUKŲ;7559183263;Ne;0;1;0;1
11735;Užupiukas;LAPIUKŲ;4900699267;Ne;0;4;0;4
11736;Užupiukas;LAPIUKŲ;7247347675;Ne;0;2;0;2
11737;Užupiukas;NYKŠTUKŲ;1399112659;Ne;3;1;3;7
11738;Užupiukas;NYKŠTUKŲ;4379182756;Ne;7;0;4;11
11739;Užupiukas;NYKŠTUKŲ;9785674147;Ne;5;0;4;9
11740;Užupiukas;NYKŠTUKŲ;3094320206;Ne;6;0;4;10
11741;Užupiukas;NYKŠTUKŲ;9118614894;Ne;5;0;4;9
11742;Užupiukas;NYKŠTUKŲ;1358906847;Ne;5;0;6;11
11743;Užupiukas;NYKŠTUKŲ;3126900439;Ne;4;0;2;6
11744;Užupiukas;NYKŠTUKŲ;6628511386;Ne;4;0;4;8
11745;Užupiukas;NYKŠTUKŲ;8158567147;Ne;0;0;16;16
11746;Užupiukas;NYKŠTUKŲ;9580855533;Ne;0;0;15;15
11747;Užupiukas;NYKŠTUKŲ;9345093498;Ne;20;0;2;22
11748;Užupiukas;NYKŠTUKŲ;5343951688;Ne;12;0;4;16
11749;Užupiukas;NYKŠTUKŲ;5556719499;Ne;2;0;4;6
11750;Užupiukas;NYKŠTUKŲ;6716173079;Ne;4;1;4;9
11751;Užupiukas;NYKŠTUKŲ;4441941216;Ne;15;0;4;19
11752;Užupiukas;NYKŠTUKŲ;4489962171;Ne;3;1;5;9
11753;Užupiukas;NYKŠTUKŲ;1139748215;Ne;0;0;1;1
11754;Vaidilutė;Žiogelis;9568450630;Ne;7;0;2;9
11755;Vaidilutė;Žiogelis;8789527552;Ne;0;1;1;2
11756;Vaidilutė;Žiogelis;7319037375;Ne;0;5;0;5
11757;Vaidilutė;Žiogelis;4838951446;Ne;5;1;4;10
11758;Vaidilutė;Žiogelis;7494818866;Ne;0;2;2;4
11759;Vaidilutė;Žiogelis;5500950179;Ne;0;2;0;2
11760;Vaidilutė;Žiogelis;7306768961;Ne;3;2;5;10
11761;Vaidilutė;Žiogelis;7532115462;Ne;8;0;2;10
11762;Vaidilutė;Žiogelis;9437865610;Ne;0;2;2;4
11763;Vaidilutė;Žiogelis;1140011879;Ne;0;0;3;3
11764;Vaidilutė;Žiogelis;9563257771;Ne;0;0;3;3
11765;Vaidilutė;Žiogelis;3059654988;Ne;6;2;2;10
11766;Vaidilutė;Žiogelis;1341696594;Ne;0;2;0;2
11767;Vaidilutė;Žiogelis;1141947715;Ne;4;2;7;13
11768;Vaidilutė;Žiogelis;5482030284;Ne;0;2;0;2
11769;Vaidilutė;Žiogelis;8505156287;Ne;7;2;2;11
11770;Vaidilutė;Žiogelis;2189753894;Ne;0;2;3;5
11771;Vaidilutė;Žiogelis;2081959307;Ne;2;5;2;9
11772;Vaidilutė;Žiogelis;1171844031;Ne;0;2;6;8
11773;Vaidilutė;Rūtelė;6449710777;Ne;0;1;0;1
11774;Vaidilutė;Rūtelė;2444426554;Ne;0;2;0;2
11775;Vaidilutė;Rūtelė;4887753072;Ne;9;2;2;13
11776;Vaidilutė;Rūtelė;7726116370;Ne;0;0;2;2
11777;Vaidilutė;Rūtelė;2876157676;Ne;6;0;4;10
11778;Vaidilutė;Rūtelė;3557654689;Ne;3;0;4;7
11779;Vaidilutė;Rūtelė;8257746012;Ne;3;0;4;7
11780;Vaidilutė;Rūtelė;8444010416;Ne;0;0;6;6
11781;Vaidilutė;Rūtelė;4568108299;Ne;0;0;4;4
11782;Vaidilutė;Rūtelė;5026620305;Ne;0;0;2;2
11783;Vaidilutė;Rūtelė;3826303389;Ne;0;0;9;9
11784;Vaidilutė;Rūtelė;4469754560;Ne;2;0;2;4
11785;Vaidilutė;Rūtelė;8433116520;Ne;5;0;2;7
11786;Vaidilutė;Rūtelė;5918039529;Ne;1;0;5;6
11787;Vaidilutė;Rūtelė;7660273021;Ne;20;0;2;22
11788;Vaidilutė;Rūtelė;6795083491;Ne;0;22;0;22
11789;Vaidilutė;Rūtelė;6604575848;Ne;0;22;0;22
11790;Vaidilutė;Rūtelė;7649954695;Ne;0;0;2;2
11791;Vaidilutė;Rūtelė;5797505797;Ne;4;0;3;7
11792;Vaidilutė;Voveraitė;3248203941;Ne;2;0;9;11
11793;Vaidilutė;Voveraitė;1608646909;Ne;13;0;2;15
11794;Vaidilutė;Voveraitė;9429544108;Ne;8;0;2;10
11795;Vaidilutė;Voveraitė;5652381296;Ne;2;0;2;4
11796;Vaidilutė;Voveraitė;8377824920;Ne;3;10;2;15
11797;Vaidilutė;Voveraitė;5296146822;Ne;1;0;4;5
11798;Vaidilutė;Voveraitė;3299081380;Ne;0;0;5;5
11799;Vaidilutė;Voveraitė;3634285869;Ne;12;0;7;19
11800;Vaidilutė;Voveraitė;7703578508;Ne;9;0;4;13
11801;Vaidilutė;Voveraitė;3150642420;Ne;4;0;2;6
11802;Vaidilutė;Voveraitė;5855762068;Ne;0;4;4;8
11803;Vaidilutė;Voveraitė;8177787790;Ne;10;0;4;14
11804;Vaidilutė;Voveraitė;7327131165;Ne;8;7;2;17
11805;Vaidilutė;Voveraitė;2318578603;Ne;4;2;3;9
11806;Vaidilutė;Voveraitė;9372280434;Ne;0;4;1;5
11807;Vaidilutė;Voveraitė;1372767364;Ne;5;2;2;9
11808;Vaidilutė;Voveraitė;7478943531;Ne;8;0;4;12
11809;Vaidilutė;Voveraitė;4738318120;Ne;0;12;0;12
11810;Vaidilutė;Voveraitė;3319615121;Ne;4;2;4;10
11811;Vaidilutė;Voveraitė;6299324271;Ne;0;0;2;2
11812;Vaidilutė;Voveraitė;4186708502;Ne;9;0;2;11
11813;Vaidilutė;Voveraitė;2855672500;Ne;0;12;0;12
11814;Vaidilutė;Voveraitė;8053548602;Ne;10;0;2;12
11815;Vaidilutė;Saulutė;2164241264;Ne;5;0;2;7
11816;Vaidilutė;Saulutė;4648985217;Ne;2;1;2;5
11817;Vaidilutė;Saulutė;4805621473;Ne;2;2;2;6
11818;Vaidilutė;Saulutė;4348206726;Taip;6;2;2;10
11819;Vaidilutė;Saulutė;5008411199;Ne;0;0;2;2
11820;Vaidilutė;Saulutė;5405461987;Ne;3;1;2;6
11821;Vaidilutė;Saulutė;6928815317;Ne;4;0;5;9
11822;Vaidilutė;Saulutė;1283676263;Ne;11;0;5;16
11823;Vaidilutė;Saulutė;6239494382;Ne;3;1;2;6
11824;Vaidilutė;Saulutė;8629789128;Ne;11;0;3;14
11825;Vaidilutė;Saulutė;8413764934;Ne;0;0;4;4
11826;Vaidilutė;Saulutė;2315322608;Ne;15;0;2;17
11827;Vaidilutė;Saulutė;7019245743;Ne;8;2;2;12
11828;Vaidilutė;Saulutė;7075509397;Ne;7;0;2;9
11829;Vaidilutė;Saulutė;8012451263;Ne;0;1;2;3
11830;Vaidilutė;Saulutė;4760330697;Ne;0;0;2;2
11831;Vaidilutė;Saulutė;5205356977;Ne;2;0;2;4
11832;Vaidilutė;Saulutė;5095161432;Ne;7;0;4;11
11833;Vaidilutė;Saulutė;7572407329;Ne;5;3;2;10
11834;Vaidilutė;Saulutė;4963577351;Ne;5;2;2;9
11835;Vaidilutė;Saulutė;6527155865;Ne;7;1;5;13
11836;Vaidilutė;Žibutė;4085959509;Ne;0;0;2;2
11837;Vaidilutė;Žibutė;1001320466;Ne;0;0;4;4
11838;Vaidilutė;Žibutė;3051006765;Ne;0;0;6;6
11839;Vaidilutė;Žibutė;9189713003;Ne;0;0;1;1
11840;Vaidilutė;Žibutė;7903242996;Ne;13;0;6;19
11841;Vaidilutė;Žibutė;7400197367;Ne;6;1;4;11
11842;Vaidilutė;Žibutė;3980894528;Ne;10;2;4;16
11843;Vaidilutė;Žibutė;1362256314;Ne;8;3;4;15
11844;Vaidilutė;Žibutė;7940581813;Ne;3;2;2;7
11845;Vaidilutė;Žibutė;2767482145;Ne;6;0;6;12
11846;Vaidilutė;Žibutė;7765298370;Ne;0;0;4;4
11847;Vaidilutė;Žibutė;8769601956;Ne;0;0;2;2
11848;Vaidilutė;Žibutė;1726638921;Ne;3;2;4;9
11849;Vaidilutė;Žibutė;5415279154;Ne;0;2;0;2
11850;Vaidilutė;Žibutė;1377015807;Ne;1;0;2;3
11851;Vaidilutė;Žibutė;4124217264;Ne;0;2;5;7
11852;Vaidilutė;Žibutė;7429825620;Ne;0;5;0;5
11853;Vaidilutė;Žibutė;7690470762;Ne;2;3;2;7
11854;Vaidilutė;Žibutė;1606864068;Ne;10;0;4;14
11855;Vaidilutė;"Ąžuoliukas ";3463112472;Ne;0;0;5;5
11856;Vaidilutė;"Ąžuoliukas ";3730573432;Ne;7;2;2;11
11857;Vaidilutė;"Ąžuoliukas ";6586072228;Ne;0;0;1;1
11858;Vaidilutė;"Ąžuoliukas ";5988376676;Ne;6;0;2;8
11859;Vaidilutė;"Ąžuoliukas ";1305478052;Ne;0;7;0;7
11860;Vaidilutė;"Ąžuoliukas ";4954285515;Ne;0;4;1;5
11861;Vaidilutė;"Ąžuoliukas ";5556351358;Ne;0;2;0;2
11862;Vaidilutė;"Ąžuoliukas ";4761992071;Ne;1;0;4;5
11863;Vaidilutė;"Ąžuoliukas ";3381544575;Ne;0;2;2;4
11864;Vaidilutė;"Ąžuoliukas ";5307486959;Ne;0;3;0;3
11865;Vaidilutė;"Ąžuoliukas ";1653497170;Ne;0;7;0;7
11866;Vaidilutė;"Ąžuoliukas ";1440819171;Ne;0;4;0;4
11867;Vaidilutė;"Ąžuoliukas ";2668758195;Ne;0;4;2;6
11868;Vaidilutė;"Ąžuoliukas ";4901387311;Ne;3;0;2;5
11869;Vaidilutė;"Ąžuoliukas ";2997948252;Ne;4;4;2;10
11870;Vaidilutė;"Ąžuoliukas ";9723156071;Ne;4;5;4;13
11871;Vaidilutė;"Ąžuoliukas ";4193108560;Ne;1;0;4;5
11872;Vaidilutė;"Ąžuoliukas ";3782651091;Ne;5;1;2;8
11873;Vaidilutė;"Ąžuoliukas ";6637224510;Ne;0;2;8;10
11874;Vaidilutė;"Ąžuoliukas ";6067801976;Ne;2;0;5;7
11875;Vaidilutė;"Žemuogėlė ";2131127298;Ne;8;2;2;12
11876;Vaidilutė;"Žemuogėlė ";2014160468;Ne;3;2;2;7
11877;Vaidilutė;"Žemuogėlė ";4680645841;Ne;0;1;3;4
11878;Vaidilutė;"Žemuogėlė ";2662468804;Ne;3;3;2;8
11879;Vaidilutė;"Žemuogėlė ";5217609332;Ne;0;3;1;4
11880;Vaidilutė;"Žemuogėlė ";8492055287;Ne;0;2;2;4
11881;Vaidilutė;"Žemuogėlė ";5945744595;Ne;4;0;3;7
11882;Vaidilutė;"Žemuogėlė ";2864731541;Ne;13;2;2;17
11883;Vaidilutė;"Žemuogėlė ";1998872078;Ne;4;2;3;9
11884;Vaidilutė;"Žemuogėlė ";2468220275;Ne;0;2;6;8
11885;Vaidilutė;"Žemuogėlė ";6844372910;Ne;7;0;4;11
11886;Vaidilutė;"Žemuogėlė ";4972645715;Ne;18;2;2;22
11887;Vaidilutė;"Žemuogėlė ";1610262589;Ne;9;0;5;14
11888;Vaidilutė;"Žemuogėlė ";2356037175;Ne;0;3;1;4
11889;Vaidilutė;"Žemuogėlė ";5054640268;Ne;0;2;5;7
11890;Vaidilutė;"Žemuogėlė ";6885473308;Ne;0;0;1;1
11891;Vaidilutė;"Žemuogėlė ";1092821241;Ne;2;0;2;4
11892;Vaidilutė;"Žemuogėlė ";7826111890;Ne;2;1;2;5
11893;Vaidilutė;"Žemuogėlė ";1355005114;Ne;0;3;3;6
11894;Vaidilutė;"Žemuogėlė ";2294802783;Ne;3;4;4;11
11895;Vaidilutė;"Žemuogėlė ";2419903023;Ne;7;0;2;9
11896;Vaidilutė;"Vyturėlis ";3121914268;Ne;3;0;2;5
11897;Vaidilutė;"Vyturėlis ";5050251048;Ne;1;1;4;6
11898;Vaidilutė;"Vyturėlis ";7106410219;Ne;2;0;4;6
11899;Vaidilutė;"Vyturėlis ";9558983004;Ne;0;2;4;6
11900;Vaidilutė;"Vyturėlis ";5326935037;Ne;3;2;2;7
11901;Vaidilutė;"Vyturėlis ";9689388330;Ne;6;2;2;10
11902;Vaidilutė;"Vyturėlis ";1539700521;Ne;3;0;2;5
11903;Vaidilutė;"Vyturėlis ";4230076320;Ne;2;2;2;6
11904;Vaidilutė;"Vyturėlis ";8628545847;Ne;6;0;2;8
11905;Vaidilutė;"Vyturėlis ";4388069915;Ne;8;0;4;12
11906;Vaidilutė;"Vyturėlis ";1401180999;Ne;9;2;4;15
11907;Vaidilutė;"Vyturėlis ";1417828163;Ne;0;3;0;3
11908;Vaidilutė;"Vyturėlis ";5651628204;Ne;3;1;2;6
11909;Vaidilutė;"Vyturėlis ";2251608691;Ne;2;1;2;5
11910;Vaidilutė;"Vyturėlis ";7131561558;Ne;0;2;0;2
11911;Vaidilutė;"Vyturėlis ";2194984060;Ne;6;0;15;21
11912;Vaidilutė;"Vyturėlis ";3351968717;Ne;0;11;1;12
11913;Vaidilutė;"Vyturėlis ";1732848786;Ne;7;0;2;9
11914;Vaidilutė;"Varpelis ";6250831269;Ne;1;5;2;8
11915;Vaidilutė;"Varpelis ";2763266518;Ne;0;1;1;2
11916;Vaidilutė;"Varpelis ";6037349527;Ne;0;2;4;6
11917;Vaidilutė;"Varpelis ";5867501558;Ne;0;2;0;2
11918;Vaidilutė;"Varpelis ";3832349858;Ne;0;2;4;6
11919;Vaidilutė;"Varpelis ";9317774960;Ne;0;1;0;1
11920;Vaidilutė;"Varpelis ";5448014291;Ne;0;2;0;2
11921;Vaidilutė;"Varpelis ";3497795848;Ne;2;2;2;6
11922;Vaidilutė;"Varpelis ";4280822951;Ne;0;0;2;2
11923;Vaidilutė;"Varpelis ";6107554047;Ne;3;0;2;5
11924;Vaidilutė;"Varpelis ";3453045619;Ne;4;2;2;8
11925;Vaidilutė;"Varpelis ";6022130248;Ne;3;2;2;7
11926;Vaidilutė;"Varpelis ";5101104226;Ne;4;0;4;8
11927;Vaidilutė;"Varpelis ";5594121340;Ne;0;1;0;1
11928;Vaidilutė;"Varpelis ";1882829340;Ne;0;0;4;4
11929;Vaidilutė;"Varpelis ";3353827105;Ne;4;1;2;7
11930;Vaidilutė;"Varpelis ";4362797606;Ne;0;4;1;5
11931;Vaidilutė;"Varpelis ";6322986820;Ne;0;7;0;7
11932;Vaidilutė;"Varpelis ";2941550026;Ne;7;2;2;11
11933;Vaidilutė;"Varpelis ";2058071219;Ne;0;2;4;6
11934;Vaidilutė;"Boružėlių ";2401619665;Ne;5;1;2;8
11935;Vaidilutė;"Boružėlių ";7992756674;Taip;1;0;4;5
11936;Vaidilutė;"Boružėlių ";4202779406;Ne;4;2;2;8
11937;Vaidilutė;"Boružėlių ";9206804444;Ne;5;3;6;14
11938;Vaidilutė;"Boružėlių ";9323633666;Ne;4;0;6;10
11939;Vaidilutė;"Boružėlių ";4826719079;Ne;4;0;6;10
11940;Vaidilutė;"Boružėlių ";7163100596;Ne;1;0;3;4
11941;Vaidilutė;"Boružėlių ";1224632280;Ne;4;9;2;15
11942;Vaidilutė;"Boružėlių ";7605835683;Ne;1;0;2;3
11943;Vaidilutė;"Boružėlių ";2194687285;Ne;8;0;2;10
11944;Vaidilutė;"Malūnelis ";8212137096;Ne;6;0;4;10
11945;Vaidilutė;"Malūnelis ";7406210603;Ne;8;2;12;22
11946;Vaidilutė;"Malūnelis ";5166331829;Taip;6;0;2;8
11947;Vaidilutė;"Malūnelis ";3509892176;Ne;12;0;2;14
11948;Vaidilutė;"Malūnelis ";9183056003;Ne;2;0;4;6
11949;Vaidilutė;"Malūnelis ";1562042820;Ne;14;0;2;16
11950;Vaidilutė;"Malūnelis ";6001198563;Ne;1;5;5;11
11951;Vaidilutė;"Malūnelis ";7109743847;Ne;5;15;2;22
11952;Vaidilutė;"Malūnelis ";7036611507;Ne;12;2;2;16
11953;Vaidilutė;"Malūnelis ";9007565120;Ne;7;0;2;9
11954;Vaidilutė;"Malūnelis ";2393977201;Ne;3;0;2;5
11955;Vaidilutė;"Malūnelis ";8042617129;Ne;18;0;2;20
11956;Vaidilutė;"Malūnelis ";5415659432;Ne;5;0;3;8
11957;Vaidilutė;"Malūnelis ";6541442524;Ne;8;0;2;10
11958;Vaidilutė;"Riešutėlis ";1161455376;Ne;4;0;2;6
11959;Vaidilutė;"Riešutėlis ";4518002596;Ne;3;0;3;6
11960;Vaidilutė;"Riešutėlis ";4657952465;Ne;8;0;2;10
11961;Vaidilutė;"Riešutėlis ";8756807918;Ne;20;0;2;22
11962;Vaidilutė;"Riešutėlis ";9782176726;Ne;9;0;5;14
11963;Vaidilutė;"Riešutėlis ";1206696843;Ne;0;1;4;5
11964;Vaidilutė;"Riešutėlis ";9872915544;Ne;10;2;2;14
11965;Vaidilutė;"Riešutėlis ";2976615414;Ne;7;0;2;9
11966;Vaidilutė;"Riešutėlis ";2409760986;Ne;0;0;2;2
11967;Vaidilutė;"Riešutėlis ";4051575845;Ne;0;0;4;4
11968;Vaidilutė;"Riešutėlis ";9025469107;Ne;0;0;4;4
11969;Vaidilutė;"Riešutėlis ";3862444839;Ne;8;0;4;12
11970;Vaidilutė;"Riešutėlis ";3064988592;Ne;12;0;4;16
11971;Vaidilutė;"Riešutėlis ";7043895152;Ne;6;0;2;8
11972;Vaidilutė;"Riešutėlis ";8296567629;Ne;0;0;1;1
11973;Vaidilutė;"Riešutėlis ";7871629009;Ne;5;0;2;7
11974;Vandenis;ŽUVĖDRŲ;5362078687;Ne;7;5;2;14
11975;Vandenis;ŽUVĖDRŲ;6784010746;Ne;6;4;2;12
11976;Vandenis;ŽUVĖDRŲ;2238926097;Ne;0;2;0;2
11977;Vandenis;ŽUVĖDRŲ;9334958945;Ne;0;4;1;5
11978;Vandenis;ŽUVĖDRŲ;7447487403;Ne;0;1;0;1
11979;Vandenis;ŽUVĖDRŲ;7646133208;Ne;0;7;0;7
11980;Vandenis;ŽUVĖDRŲ;4303303483;Ne;9;4;2;15
11981;Vandenis;ŽUVĖDRŲ;2325465812;Ne;4;6;2;12
11982;Vandenis;ŽUVĖDRŲ;2649542586;Ne;0;4;0;4
11983;Vandenis;ŽUVĖDRŲ;1144490168;Ne;0;4;0;4
11984;Vandenis;ŽUVĖDRŲ;7948161881;Ne;4;2;2;8
11985;Vandenis;ŽUVĖDRŲ;7391206543;Ne;0;2;0;2
11986;Vandenis;ŽUVĖDRŲ;9335319713;Ne;8;2;2;12
11987;Vandenis;ŽUVĖDRŲ;6068154206;Taip;8;2;2;12
11988;Vandenis;ŽUVĖDRŲ;7296608892;Ne;3;6;2;11
11989;Vandenis;ŽUVĖDRŲ;4117091634;Ne;0;4;0;4
11990;Vandenis;ŽUVĖDRŲ;5408971428;Ne;0;2;0;2
11991;Vandenis;ŽUVĖDRŲ;2276497021;Ne;2;2;2;6
11992;Vandenis;ŽUVĖDRŲ;6063181697;Ne;0;2;0;2
11993;Vandenis;ŽUVĖDRŲ;6661117114;Ne;0;16;2;18
11994;Vandenis;ŽUVĖDRŲ;5112768778;Ne;5;7;2;14
11995;Vandenis;ŽUVĖDRŲ;6456557095;Ne;7;1;2;10
11996;Vandenis;RUONIUKŲ;9756270419;Ne;7;0;6;13
11997;Vandenis;RUONIUKŲ;5438770600;Ne;3;0;5;8
11998;Vandenis;RUONIUKŲ;6851036864;Ne;8;0;2;10
11999;Vandenis;RUONIUKŲ;1969144957;Ne;13;2;3;18
12000;Vandenis;RUONIUKŲ;4319584977;Ne;22;0;0;22
12001;Vandenis;RUONIUKŲ;7950837626;Ne;12;0;0;12
12002;Vandenis;RUONIUKŲ;8001157954;Ne;2;0;2;4
12003;Vandenis;RUONIUKŲ;6882874044;Ne;2;0;0;2
12004;Vandenis;RUONIUKŲ;9178978753;Ne;3;0;4;7
12005;Vandenis;RUONIUKŲ;9095152994;Ne;0;10;0;10
12006;Vandenis;RUONIUKŲ;9756750533;Ne;2;0;3;5
12007;Vandenis;RUONIUKŲ;4525906178;Ne;2;2;2;6
12008;Vandenis;RUONIUKŲ;9316297713;Ne;17;0;2;19
12009;Vandenis;RUONIUKŲ;3101289470;Ne;0;2;0;2
12010;Vandenis;RUONIUKŲ;6134775528;Ne;8;0;2;10
12011;Vandenis;RUONIUKŲ;9542360827;Ne;5;0;2;7
12012;Vandenis;RUONIUKŲ;8047806483;Ne;6;0;2;8
12013;Vandenis;RUONIUKŲ;5516720117;Ne;4;0;4;8
12014;Vandenis;RUONIUKŲ;6008552395;Ne;0;2;0;2
12015;Vandenis;ŽUVYČIŲ;7565308536;Ne;2;1;3;6
12016;Vandenis;ŽUVYČIŲ;1120907086;Ne;8;4;2;14
12017;Vandenis;ŽUVYČIŲ;1563710105;Ne;0;2;0;2
12018;Vandenis;ŽUVYČIŲ;6330187732;Ne;0;4;0;4
12019;Vandenis;ŽUVYČIŲ;9527253920;Ne;0;4;1;5
12020;Vandenis;ŽUVYČIŲ;6158299885;Ne;0;3;0;3
12021;Vandenis;ŽUVYČIŲ;5535901447;Ne;0;2;0;2
12022;Vandenis;ŽUVYČIŲ;8971291182;Ne;0;1;2;3
12023;Vandenis;ŽUVYČIŲ;9688954631;Ne;8;2;2;12
12024;Vandenis;ŽUVYČIŲ;3664560833;Ne;6;2;2;10
12025;Vandenis;ŽUVYČIŲ;6476051751;Ne;0;2;0;2
12026;Vandenis;ŽUVYČIŲ;9162936403;Ne;0;4;0;4
12027;Vandenis;ŽUVYČIŲ;1051281257;Ne;0;4;1;5
12028;Vandenis;ŽUVYČIŲ;2422642232;Ne;0;3;0;3
12029;Vandenis;ŽUVYČIŲ;6986724058;Ne;0;2;0;2
12030;Vandenis;ŽUVYČIŲ;4971165639;Ne;0;2;0;2
12031;Vandenis;ŽUVYČIŲ;7754158588;Ne;0;2;0;2
12032;Vandenis;PERLIUKŲ;8239664149;Ne;8;0;4;12
12033;Vandenis;PERLIUKŲ;2451901210;Ne;0;10;0;10
12034;Vandenis;PERLIUKŲ;1953052452;Ne;3;0;2;5
12035;Vandenis;PERLIUKŲ;6724626527;Ne;16;0;2;18
12036;Vandenis;PERLIUKŲ;6907717590;Ne;2;0;3;5
12037;Vandenis;PERLIUKŲ;1799139825;Ne;5;0;2;7
12038;Vandenis;PERLIUKŲ;1786146371;Ne;8;2;2;12
12039;Vandenis;PERLIUKŲ;6570331247;Ne;8;2;2;12
12040;Vandenis;PERLIUKŲ;3038533882;Ne;15;0;2;17
12041;Vandenis;PERLIUKŲ;3393306645;Ne;12;0;4;16
12042;Vandenis;PERLIUKŲ;2506411643;Ne;11;1;2;14
12043;Vandenis;PERLIUKŲ;8841954633;Ne;9;0;4;13
12044;Vandenis;PERLIUKŲ;7001613448;Ne;9;0;4;13
12045;Vandenis;PERLIUKŲ;2661339448;Ne;7;0;4;11
12046;Vandenis;PERLIUKŲ;5675840354;Ne;9;2;6;17
12047;Vandenis;PERLIUKŲ;9380306986;Ne;9;0;4;13
12048;Vandenis;PERLIUKŲ;1983972864;Ne;3;2;2;7
12049;Vandenis;PERLIUKŲ;3173213991;Ne;0;12;0;12
12050;Vandenis;PERLIUKŲ;6067408982;Ne;6;0;4;10
12051;Vandenis;PERLIUKŲ;7233484054;Ne;12;0;4;16
12052;Vandenis;ANČIUKŲ;4607196473;Ne;8;2;2;12
12053;Vandenis;ANČIUKŲ;9763300020;Ne;4;2;2;8
12054;Vandenis;ANČIUKŲ;9968877035;Ne;0;3;0;3
12055;Vandenis;ANČIUKŲ;3639160500;Ne;3;2;2;7
12056;Vandenis;ANČIUKŲ;1213743099;Ne;0;3;0;3
12057;Vandenis;ANČIUKŲ;4954121871;Ne;0;7;0;7
12058;Vandenis;ANČIUKŲ;4983424940;Ne;0;2;0;2
12059;Vandenis;ANČIUKŲ;4978712442;Ne;5;0;2;7
12060;Vandenis;ANČIUKŲ;7631982912;Ne;0;2;0;2
12061;Vandenis;ANČIUKŲ;7581114286;Ne;0;2;0;2
12062;Vandenis;ANČIUKŲ;9679010239;Ne;3;2;2;7
12063;Vandenis;ANČIUKŲ;1132534461;Ne;0;2;1;3
12064;Vandenis;ANČIUKŲ;5610800263;Ne;0;1;0;1
12065;Vandenis;ANČIUKŲ;3544764716;Ne;6;4;2;12
12066;Vandenis;ANČIUKŲ;4530824157;Ne;8;2;3;13
12067;Vandenis;ANČIUKŲ;4954787474;Ne;8;3;3;14
12068;Vandenis;ANČIUKŲ;8967191975;Ne;1;5;2;8
12069;Vandenis;ANČIUKŲ;9784116399;Ne;10;2;2;14
12070;Vandenis;ANČIUKŲ;4091633411;Ne;8;0;2;10
12071;Vandenis;VĖŽLIUKŲ;2309166304;Ne;4;2;2;8
12072;Vandenis;VĖŽLIUKŲ;2872343656;Ne;0;2;4;6
12073;Vandenis;VĖŽLIUKŲ;5454049563;Ne;0;2;3;5
12074;Vandenis;VĖŽLIUKŲ;9805578141;Ne;0;2;3;5
12075;Vandenis;VĖŽLIUKŲ;8921666108;Ne;10;2;2;14
12076;Vandenis;VĖŽLIUKŲ;7069369080;Ne;0;4;0;4
12077;Vandenis;VĖŽLIUKŲ;7924399684;Ne;0;7;0;7
12078;Vandenis;VĖŽLIUKŲ;1187395353;Ne;3;1;2;6
12079;Vandenis;VĖŽLIUKŲ;7091356848;Ne;0;8;0;8
12080;Vandenis;VĖŽLIUKŲ;5126732658;Ne;0;1;3;4
12081;Vandenis;VĖŽLIUKŲ;7059385610;Ne;0;3;0;3
12082;Vandenis;VĖŽLIUKŲ;1707354287;Ne;8;2;4;14
12083;Vandenis;VĖŽLIUKŲ;4413648496;Ne;2;0;6;8
12084;Vandenis;VĖŽLIUKŲ;4177166475;Ne;0;1;0;1
12085;Vandenis;VĖŽLIUKŲ;5218101579;Ne;1;2;2;5
12086;Vandenis;VĖŽLIUKŲ;8416839037;Ne;0;1;1;2
12087;Vandenis;VĖŽLIUKŲ;8879608849;Ne;0;7;6;13
12088;Vandenis;AŠTUNKOJŲ;3429495073;Ne;0;3;0;3
12089;Vandenis;AŠTUNKOJŲ;6896047075;Ne;0;2;1;3
12090;Vandenis;AŠTUNKOJŲ;9304912028;Ne;0;1;0;1
12091;Vandenis;AŠTUNKOJŲ;5844576485;Ne;0;2;0;2
12092;Vandenis;AŠTUNKOJŲ;6295009202;Ne;3;4;2;9
12093;Vandenis;AŠTUNKOJŲ;3239754791;Ne;0;9;0;9
12094;Vandenis;AŠTUNKOJŲ;5323428164;Ne;0;3;0;3
12095;Vandenis;AŠTUNKOJŲ;6073002418;Ne;0;9;0;9
12096;Vandenis;AŠTUNKOJŲ;2690536940;Ne;3;0;2;5
12097;Vandenis;AŠTUNKOJŲ;2576575249;Ne;8;2;2;12
12098;Vandenis;AŠTUNKOJŲ;7832674282;Ne;4;2;4;10
12099;Vandenis;AŠTUNKOJŲ;9798192239;Ne;0;3;0;3
12100;Vandenis;AŠTUNKOJŲ;5129492284;Ne;0;3;0;3
12101;Vandenis;AŠTUNKOJŲ;1975385430;Ne;0;3;0;3
12102;Vandenis;AŠTUNKOJŲ;3061606138;Ne;0;2;0;2
12103;Vandenis;AŠTUNKOJŲ;8117385209;Ne;3;2;2;7
12104;Vandenis;AŠTUNKOJŲ;5613067534;Ne;3;2;2;7
12105;Vandenis;AŠTUNKOJŲ;2321919298;Ne;2;4;2;8
12106;Vandenis;GANDRIUKŲ;4753416316;Ne;0;4;0;4
12107;Vandenis;GANDRIUKŲ;8264797886;Ne;10;0;2;12
12108;Vandenis;GANDRIUKŲ;9936940067;Ne;3;0;2;5
12109;Vandenis;GANDRIUKŲ;6153669587;Ne;3;0;0;3
12110;Vandenis;GANDRIUKŲ;6260893699;Ne;0;11;0;11
12111;Vandenis;GANDRIUKŲ;1919577714;Ne;1;2;4;7
12112;Vandenis;GANDRIUKŲ;7019646962;Ne;0;8;0;8
12113;Vandenis;GANDRIUKŲ;2078767085;Ne;8;4;2;14
12114;Vandenis;GANDRIUKŲ;2976505868;Ne;8;0;1;9
12115;Vandenis;GANDRIUKŲ;6558155968;Ne;0;3;0;3
12116;Vandenis;GANDRIUKŲ;6691874473;Ne;2;0;2;4
12117;Vandenis;GANDRIUKŲ;6483030616;Ne;0;2;1;3
12118;Vandenis;GANDRIUKŲ;8144830789;Ne;10;0;3;13
12119;Vandenis;GANDRIUKŲ;2381566229;Ne;3;0;1;4
12120;Vandenis;GANDRIUKŲ;5899846599;Ne;0;11;0;11
12121;Vandenis;GANDRIUKŲ;8127873607;Ne;2;0;2;4
12122;Vandenis;GANDRIUKŲ;1606103904;Ne;0;12;0;12
12123;Vandenis;GANDRIUKŲ;1753180703;Ne;0;2;0;2
12124;Vandenis;GANDRIUKŲ;7303512055;Ne;11;0;4;15
12125;Vandenis;GANDRIUKŲ;7311677107;Ne;0;2;1;3
12126;Vandenis;GANDRIUKŲ;6586215199;Ne;0;12;0;12
12127;Vandenis;ŽĄSIUKAI;8034690071;Ne;6;0;2;8
12128;Vandenis;ŽĄSIUKAI;9937317687;Ne;0;2;0;2
12129;Vandenis;ŽĄSIUKAI;2004158593;Ne;0;2;1;3
12130;Vandenis;ŽĄSIUKAI;4984723792;Ne;3;0;6;9
12131;Vandenis;ŽĄSIUKAI;8014569725;Ne;1;0;2;3
12132;Vandenis;ŽĄSIUKAI;1333381525;Ne;0;3;0;3
12133;Vandenis;ŽĄSIUKAI;7071349847;Ne;0;5;0;5
12134;Vandenis;ŽĄSIUKAI;7070234429;Ne;6;2;4;12
12135;Vandenis;ŽĄSIUKAI;4072405890;Ne;6;3;4;13
12136;Vandenis;ŽĄSIUKAI;7596199296;Ne;0;7;0;7
12137;Vandenis;ŽĄSIUKAI;6876019354;Ne;0;2;0;2
12138;Vandenis;ŽĄSIUKAI;5607412408;Ne;3;1;2;6
12139;Vandenis;ŽĄSIUKAI;5641929490;Ne;0;4;0;4
12140;Vandenis;ŽĄSIUKAI;1850352131;Ne;14;2;0;16
12141;Vandenis;ŽĄSIUKAI;2454959791;Ne;5;0;4;9
12142;Vandenis;ŽĄSIUKAI;9801593009;Ne;0;4;1;5
12143;Vandenis;ŽĄSIUKAI;9093048795;Ne;0;0;1;1
12144;Vandenis;PURIENŲ;6851178154;Ne;3;2;2;7
12145;Vandenis;PURIENŲ;5440027798;Ne;0;2;0;2
12146;Vandenis;PURIENŲ;4455886780;Ne;8;2;2;12
12147;Vandenis;PURIENŲ;1031451445;Ne;4;2;2;8
12148;Vandenis;PURIENŲ;4815210197;Ne;2;2;2;6
12149;Vandenis;PURIENŲ;3337286021;Ne;8;2;2;12
12150;Vandenis;PURIENŲ;7020534318;Ne;8;0;2;10
12151;Vandenis;PURIENŲ;6027680514;Ne;5;2;2;9
12152;Vandenis;PURIENŲ;2960005490;Ne;9;0;2;11
12153;Vandenis;PURIENŲ;1180322026;Ne;4;0;2;6
12154;Vandenis;PURIENŲ;3633805607;Ne;1;2;2;5
12155;Vandenis;PURIENŲ;6332179750;Ne;0;3;0;3
12156;Vandenis;PURIENŲ;2315167746;Ne;3;0;2;5
12157;Vandenis;PURIENŲ;2719678617;Ne;0;3;0;3
12158;Vandenis;PURIENŲ;7171302906;Ne;6;3;2;11
12159;Vandenis;PURIENŲ;8085633453;Ne;6;3;2;11
12160;Vandenis;PURIENŲ;2614561762;Ne;7;2;2;11
12161;Vandenis;PURIENŲ;5764809162;Ne;6;0;2;8
12162;Vandenis;PURIENŲ;1244502945;Ne;6;2;2;10
12163;Vandenis;PURIENŲ;9158541919;Ne;0;3;0;3
12164;Vandenis;PURIENŲ;5959181898;Ne;0;3;0;3
12165;Vandenis;VARLIUKAI;3851301038;Ne;0;2;1;3
12166;Vandenis;VARLIUKAI;1557924470;Ne;4;2;2;8
12167;Vandenis;VARLIUKAI;4467604017;Ne;3;2;1;6
12168;Vandenis;VARLIUKAI;1586318209;Ne;6;2;2;10
12169;Vandenis;VARLIUKAI;1713088739;Ne;8;2;0;10
12170;Vandenis;VARLIUKAI;6348714341;Ne;3;4;1;8
12171;Vandenis;VARLIUKAI;1926484881;Ne;6;0;4;10
12172;Vandenis;VARLIUKAI;8866969905;Ne;12;0;4;16
12173;Vandenis;VARLIUKAI;1587789226;Ne;7;4;0;11
12174;Vandenis;VARLIUKAI;6061476765;Ne;7;2;1;10
12175;Vandenis;VARLIUKAI;4220080362;Ne;8;0;4;12
12176;Vandenis;VARLIUKAI;8642524068;Ne;7;0;4;11
12177;Vandenis;VARLIUKAI;8184314532;Ne;7;2;2;11
12178;Vandenis;VARLIUKAI;6499309064;Ne;8;2;1;11
12179;Vandenis;VARLIUKAI;1321803758;Ne;8;0;2;10
12180;Vandenis;VARLIUKAI;5310917664;Ne;8;4;0;12
12181;Vandenis;VARLIUKAI;3048168468;Ne;12;0;2;14
12182;Vandenis;PINGVINAI;9856199548;Ne;3;1;0;4
12183;Vandenis;PINGVINAI;2209513000;Ne;0;0;2;2
12184;Vandenis;PINGVINAI;2665865704;Ne;8;1;2;11
12185;Vandenis;PINGVINAI;8755050997;Ne;14;0;2;16
12186;Vandenis;PINGVINAI;1780124964;Ne;0;3;2;5
12187;Vandenis;PINGVINAI;9609168578;Ne;0;8;0;8
12188;Vandenis;PINGVINAI;2156775779;Ne;0;3;0;3
12189;Vandenis;PINGVINAI;3360623444;Ne;2;0;2;4
12190;Vandenis;PINGVINAI;5191604973;Ne;2;0;4;6
12191;Vandenis;PINGVINAI;2757376962;Ne;0;6;0;6
12192;Vandenis;PINGVINAI;6992750701;Ne;8;2;2;12
12193;Vandenis;PINGVINAI;3933306911;Ne;9;0;4;13
12194;Vandenis;PINGVINAI;2534991705;Ne;0;3;0;3
12195;Vandenis;PINGVINAI;7267965471;Ne;4;0;2;6
12196;Vandenis;PINGVINAI;5632082019;Ne;0;3;0;3
12197;Vandenis;PINGVINAI;9717294497;Ne;0;2;0;2
12198;Vandenis;PINGVINAI;7770227772;Ne;14;2;2;18
12199;Vandenis;PINGVINAI;8560123112;Ne;0;8;0;8
12200;Vandenis;Debesėlių;3163423293;Ne;8;0;4;12
12201;Vandenis;Debesėlių;6555465114;Ne;13;0;2;15
12202;Vandenis;Debesėlių;4226028904;Taip;0;1;2;3
12203;Vandenis;Debesėlių;2844636823;Ne;2;0;4;6
12204;Vandenis;Debesėlių;2426003664;Ne;0;1;3;4
12205;Vandenis;Debesėlių;8299531021;Taip;4;2;5;11
12206;Vandenis;Debesėlių;9521927635;Ne;1;4;2;7
12207;Vandenis;Debesėlių;6494266251;Ne;11;2;2;15
12208;Vandenis;Debesėlių;3835819023;Ne;11;2;2;15
12209;Vandenis;Debesėlių;2953842982;Ne;6;1;2;9
12210;Vandenis;Debesėlių;2645775090;Ne;0;4;2;6
12211;Vandenis;Debesėlių;8678508812;Ne;0;4;0;4
12212;Vandenis;Debesėlių;5609737826;Ne;4;0;5;9
12213;Vandenis;Debesėlių;6327478049;Ne;0;0;22;22
12214;Vandenis;Debesėlių;3231434944;Ne;0;0;22;22
12215;Vandenis;Debesėlių;6003491409;Ne;4;2;2;8
12216;Vandenis;Debesėlių;5690075288;Ne;3;2;3;8
12217;Vandenis;Debesėlių;3701053997;Ne;1;4;2;7
12218;Vandenis;Debesėlių;1081283323;Ne;3;2;2;7
12219;Vandenis;Debesėlių;1081283323;Ne;3;2;2;7
12220;Vandenis;Debesėlių;1081283323;Ne;3;2;2;7
12221;Vandenis;Gintarėlių;1542662577;Ne;17;0;0;17
12222;Vandenis;Gintarėlių;5683829836;Ne;2;0;1;3
12223;Vandenis;Gintarėlių;5560529824;Ne;13;0;2;15
12224;Vandenis;Gintarėlių;5874429309;Ne;4;0;4;8
12225;Vandenis;Gintarėlių;7318344804;Ne;2;2;3;7
12226;Vandenis;Gintarėlių;7884422309;Ne;0;1;2;3
12227;Vandenis;Gintarėlių;8420609325;Ne;17;0;2;19
12228;Vandenis;Gintarėlių;5071489844;Ne;2;0;3;5
12229;Vandenis;Gintarėlių;5081501601;Ne;8;2;2;12
12230;Vandenis;Gintarėlių;9498231306;Ne;0;2;0;2
12231;Vandenis;Gintarėlių;3968719760;Ne;16;0;0;16
12232;Vandenis;Gintarėlių;4565893472;Ne;10;0;2;12
12233;Vandenis;Gintarėlių;3342147138;Ne;15;0;2;17
12234;Vandenis;Gintarėlių;7959438279;Ne;10;0;0;10
12235;Vandenis;Gintarėlių;1788652447;Ne;9;0;0;9
12236;Vandenis;Gintarėlių;5540306590;Ne;7;0;4;11
12237;Vandenis;Gintarėlių;4459177302;Ne;3;0;4;7
12238;Vandenis;Gintarėlių;3672852524;Ne;13;0;2;15
12239;Vandenis;Gintarėlių;4069657268;Ne;6;1;2;9
12240;Vandenis;Gintarėlių;9899621226;Ne;4;0;4;8
12241;Vandenis;Lašelių;1233236350;Ne;20;0;2;22
12242;Vandenis;Lašelių;5459023317;Ne;14;0;2;16
12243;Vandenis;Lašelių;2475761158;Ne;20;0;2;22
12244;Vandenis;Lašelių;6869501724;Ne;13;0;2;15
12245;Vandenis;Lašelių;4575455479;Ne;1;0;6;7
12246;Vandenis;Lašelių;8860667587;Ne;7;0;4;11
12247;Vandenis;Lašelių;8609549799;Ne;2;0;2;4
12248;Vandenis;Lašelių;5434744285;Ne;3;14;0;17
12249;Vandenis;Lašelių;5207600083;Ne;2;2;5;9
12250;Vandenis;Lašelių;2440317162;Ne;4;0;2;6
12251;Vandenis;Lašelių;7544597355;Ne;17;0;4;21
12252;Vandenis;Lašelių;7095534371;Ne;17;0;2;19
12253;Vandenis;Lašelių;1636387018;Ne;11;0;2;13
12254;Vandenis;Lašelių;5440102024;Ne;11;0;4;15
12255;Vandenis;Lašelių;6025496917;Ne;6;0;2;8
12256;Vandenis;Burbuliukų;5144953316;Ne;8;0;2;10
12257;Vandenis;Burbuliukų;3750162497;Ne;22;0;2;24
12258;Vandenis;Burbuliukų;6068144373;Ne;0;4;0;4
12259;Vandenis;Burbuliukų;2783738727;Ne;2;0;2;4
12260;Vandenis;Burbuliukų;2998970043;Ne;5;2;3;10
12261;Vandenis;Burbuliukų;7080129095;Ne;8;2;2;12
12262;Vandenis;Burbuliukų;7856148436;Ne;8;2;2;12
12263;Vandenis;Burbuliukų;1035549424;Ne;6;0;2;8
12264;Vandenis;Burbuliukų;7492804255;Ne;3;0;3;6
12265;Vandenis;Burbuliukų;4483401826;Ne;2;2;3;7
12266;Vandenis;Burbuliukų;9314410776;Ne;19;0;4;23
12267;Vandenis;Burbuliukų;2647966131;Ne;8;0;2;10
12268;Vandenis;Burbuliukų;4715198793;Ne;3;0;2;5
12269;Vandenis;Burbuliukų;5545019790;Ne;20;0;2;22
12270;Vandenis;Burbuliukų;9128547685;Ne;14;0;4;18
12271;Vandenis;Burbuliukų;6731336385;Ne;3;4;3;10
12272;Vandenis;Kriauklyčių;9130870495;Ne;2;2;3;7
12273;Vandenis;Kriauklyčių;2578294768;Ne;0;8;0;8
12274;Vandenis;Kriauklyčių;7736505435;Ne;5;0;4;9
12275;Vandenis;Kriauklyčių;5362018982;Ne;8;1;4;13
12276;Vandenis;Kriauklyčių;4219981694;Ne;14;0;3;17
12277;Vandenis;Kriauklyčių;8703465445;Ne;5;0;4;9
12278;Vandenis;Kriauklyčių;5983635986;Ne;8;0;6;14
12279;Vandenis;Kriauklyčių;4373688502;Ne;8;2;2;12
12280;Vandenis;Kriauklyčių;8921398489;Ne;23;2;2;27
12281;Vandenis;Kriauklyčių;6112591131;Ne;0;3;2;5
12282;Vandenis;Kriauklyčių;2528214535;Ne;0;11;0;11
12283;Vandenis;Kriauklyčių;6848032146;Ne;9;2;4;15
12284;Vandenis;Kriauklyčių;1836082819;Ne;0;0;2;2
12285;Vandenis;Kriauklyčių;2945086818;Ne;6;0;3;9
12286;Vandenis;Kriauklyčių;3262634002;Ne;11;0;2;13
12287;Vandenis;Kriauklyčių;3820448467;Ne;2;4;4;10
12288;Vandenis;Kriauklyčių;4168391832;Ne;0;10;0;10
12289;Vandenis;Kriauklyčių;2883058280;Ne;3;0;4;7
12290;Vandenis;Kriauklyčių;2997649372;Ne;13;0;6;19
12291;Vandenis;Kriauklyčių;9400150352;Ne;18;2;5;25
12292;Vėjelis;Pumpurėliai;2541077369;Ne;4;0;2;6
12293;Vėjelis;Pumpurėliai;3125815427;Ne;4;1;4;9
12294;Vėjelis;Pumpurėliai;5516672613;Ne;17;2;2;21
12295;Vėjelis;Pumpurėliai;5611813359;Ne;0;5;0;5
12296;Vėjelis;Pumpurėliai;1057586168;Ne;0;4;0;4
12297;Vėjelis;Pumpurėliai;9583495324;Ne;0;4;0;4
12298;Vėjelis;Pumpurėliai;7539681314;Ne;0;4;0;4
12299;Vėjelis;Pumpurėliai;3081923183;Ne;0;1;0;1
12300;Vėjelis;Pumpurėliai;9003601108;Ne;0;1;2;3
12301;Vėjelis;Pumpurėliai;6168648640;Ne;3;2;2;7
12302;Vėjelis;Pumpurėliai;6840643273;Ne;0;13;0;13
12303;Vėjelis;Pumpurėliai;9824130744;Ne;4;1;2;7
12304;Vėjelis;Pumpurėliai;1842552329;Ne;3;0;12;15
12305;Vėjelis;Pumpurėliai;8994680698;Ne;3;0;2;5
12306;Vėjelis;Pumpurėliai;2656895893;Ne;0;16;0;16
12307;Vėjelis;Pumpurėliai;2734891342;Taip;0;8;0;8
12308;Vėjelis;Pumpurėliai;7748975870;Ne;0;16;0;16
12309;Vėjelis;Drugeliai;1331334220;Ne;0;5;2;7
12310;Vėjelis;Drugeliai;2151737048;Ne;0;4;0;4
12311;Vėjelis;Drugeliai;4473677352;Ne;0;4;0;4
12312;Vėjelis;Drugeliai;4506243333;Ne;0;3;0;3
12313;Vėjelis;Drugeliai;3524350131;Ne;4;2;2;8
12314;Vėjelis;Drugeliai;6061966626;Ne;3;2;2;7
12315;Vėjelis;Drugeliai;6891260701;Ne;0;5;0;5
12316;Vėjelis;Drugeliai;9986867356;Ne;0;2;5;7
12317;Vėjelis;Drugeliai;1876663813;Ne;0;4;1;5
12318;Vėjelis;Drugeliai;8467887788;Ne;0;13;0;13
12319;Vėjelis;Drugeliai;5619026707;Ne;0;2;0;2
12320;Vėjelis;Drugeliai;1073818739;Ne;0;0;6;6
12321;Vėjelis;Drugeliai;6775556050;Ne;0;0;2;2
12322;Vėjelis;Drugeliai;1823215441;Ne;0;5;2;7
12323;Vėjelis;Drugeliai;5888429623;Ne;2;1;3;6
12324;Vėjelis;Drugeliai;9592852011;Ne;0;3;0;3
12325;Vėjelis;Drugeliai;7247057946;Ne;3;2;8;13
12326;Vėjelis;Drugeliai;8986581196;Ne;0;2;0;2
12327;Vėjelis;Drugeliai;4885237871;Ne;0;0;3;3
12328;Vėjelis;Malūnėlis;1994035417;Ne;0;7;0;7
12329;Vėjelis;Malūnėlis;1448699738;Ne;3;4;3;10
12330;Vėjelis;Malūnėlis;1882750621;Ne;0;22;0;22
12331;Vėjelis;Malūnėlis;5109441799;Ne;0;0;2;2
12332;Vėjelis;Malūnėlis;4171024976;Ne;2;6;2;10
12333;Vėjelis;Malūnėlis;1342200813;Ne;0;0;3;3
12334;Vėjelis;Malūnėlis;8221349174;Ne;0;3;0;3
12335;Vėjelis;Malūnėlis;6600504736;Ne;0;2;0;2
12336;Vėjelis;Malūnėlis;8063276082;Ne;0;1;0;1
12337;Vėjelis;Malūnėlis;6244227830;Ne;0;1;3;4
12338;Vėjelis;Malūnėlis;1417987860;Ne;0;6;3;9
12339;Vėjelis;Malūnėlis;9636946669;Ne;0;0;3;3
12340;Vėjelis;Malūnėlis;6823103188;Ne;0;7;0;7
12341;Vėjelis;Malūnėlis;2887703782;Ne;3;4;2;9
12342;Vėjelis;Malūnėlis;4063795811;Ne;0;4;0;4
12343;Vėjelis;Žvaigždutės;2522750651;Ne;3;0;2;5
12344;Vėjelis;Žvaigždutės;4868574574;Ne;3;0;2;5
12345;Vėjelis;Žvaigždutės;3495322620;Ne;6;2;0;8
12346;Vėjelis;Žvaigždutės;1956418258;Ne;0;7;0;7
12347;Vėjelis;Žvaigždutės;7203026860;Ne;0;2;0;2
12348;Vėjelis;Žvaigždutės;1075188861;Ne;11;2;4;17
12349;Vėjelis;Žvaigždutės;9451358807;Ne;2;2;4;8
12350;Vėjelis;Žvaigždutės;8995478684;Ne;0;2;0;2
12351;Vėjelis;Žvaigždutės;8281508498;Ne;3;6;2;11
12352;Vėjelis;Žvaigždutės;6909799367;Ne;0;7;0;7
12353;Vėjelis;Žvaigždutės;4884057836;Ne;7;0;0;7
12354;Vėjelis;Žvaigždutės;9546928491;Ne;7;0;0;7
12355;Vėjelis;Žvaigždutės;9675488924;Ne;0;2;0;2
12356;Vėjelis;Žvaigždutės;7101585528;Ne;0;2;0;2
12357;Vėjelis;Žvaigždutės;9202471939;Ne;0;8;0;8
12358;Vėjelis;Žvaigždutės;1615837863;Ne;0;8;0;8
12359;Vėjelis;Žvaigždutės;9403445317;Ne;0;5;3;8
12360;Vėjelis;Varpeliai;7507448059;Ne;11;4;2;17
12361;Vėjelis;Varpeliai;4853650350;Ne;0;2;0;2
12362;Vėjelis;Varpeliai;8748218387;Ne;0;1;0;1
12363;Vėjelis;Varpeliai;9492690970;Ne;0;3;0;3
12364;Vėjelis;Varpeliai;9557135813;Ne;0;4;0;4
12365;Vėjelis;Varpeliai;1436893015;Ne;3;0;2;5
12366;Vėjelis;Varpeliai;4353239658;Ne;0;2;0;2
12367;Vėjelis;Varpeliai;9135807341;Ne;4;6;4;14
12368;Vėjelis;Varpeliai;2117924725;Ne;0;2;0;2
12369;Vėjelis;Varpeliai;8866974952;Ne;0;4;0;4
12370;Vėjelis;Varpeliai;2132551615;Ne;9;4;4;17
12371;Vėjelis;Varpeliai;4101161670;Ne;0;8;0;8
12372;Vėjelis;Varpeliai;6386092350;Ne;9;6;2;17
12373;Vėjelis;Varpeliai;7046938604;Ne;0;4;0;4
12374;Vėjelis;Varpeliai;6777528441;Ne;0;6;0;6
12375;Vėjelis;Varpeliai;6844704326;Ne;0;2;1;3
12376;Vėjelis;Varpeliai;3315240387;Taip;0;16;0;16
12377;Vėjelis;Varpeliai;8300497094;Ne;0;4;1;5
12378;Vėjelis;Pelėdžiukų;3067215309;Ne;0;2;0;2
12379;Vėjelis;Pelėdžiukų;7211756910;Ne;0;7;0;7
12380;Vėjelis;Pelėdžiukų;4852532740;Ne;14;0;0;14
12381;Vėjelis;Pelėdžiukų;4450739919;Ne;0;1;0;1
12382;Vėjelis;Pelėdžiukų;9852892338;Ne;0;4;0;4
12383;Vėjelis;Pelėdžiukų;8433853523;Ne;0;8;1;9
12384;Vėjelis;Pelėdžiukų;4746355716;Ne;6;0;4;10
12385;Vėjelis;Pelėdžiukų;5507017221;Ne;5;3;2;10
12386;Vėjelis;Pelėdžiukų;1259743374;Ne;1;2;3;6
12387;Vėjelis;Pelėdžiukų;6226234271;Ne;6;1;4;11
12388;Vėjelis;Pelėdžiukų;7559733997;Ne;0;9;0;9
12389;Vėjelis;Pelėdžiukų;3764096742;Ne;0;0;4;4
12390;Vėjelis;Pelėdžiukų;8153021028;Ne;4;0;2;6
12391;Vėjelis;Pelėdžiukų;2283628712;Ne;2;2;6;10
12392;Vėjelis;Pelėdžiukų;9769871497;Ne;2;0;2;4
12393;Vėjelis;Pelėdžiukų;4318295503;Ne;0;0;4;4
12394;Vėjelis;Pelėdžiukų;9867392835;Ne;0;13;0;13
12395;Vėjelis;Pelėdžiukų;5662728912;Ne;0;1;1;2
12396;Vėjelis;Skruzdeliukų;3096861110;Ne;10;0;2;12
12397;Vėjelis;Skruzdeliukų;9964641007;Ne;3;1;3;7
12398;Vėjelis;Skruzdeliukų;7577991381;Ne;3;1;3;7
12399;Vėjelis;Skruzdeliukų;2928489724;Ne;0;22;0;22
12400;Vėjelis;Skruzdeliukų;2238139120;Ne;1;1;3;5
12401;Vėjelis;Skruzdeliukų;4531125902;Ne;2;0;0;2
12402;Vėjelis;Skruzdeliukų;9528142262;Ne;2;0;0;2
12403;Vėjelis;Skruzdeliukų;4758209854;Ne;7;0;2;9
12404;Vėjelis;Skruzdeliukų;2486741803;Ne;14;1;2;17
12405;Vėjelis;Skruzdeliukų;1793991609;Ne;9;1;2;12
12406;Vėjelis;Skruzdeliukų;2987292658;Ne;9;1;2;12
12407;Vėjelis;Skruzdeliukų;4605288262;Ne;6;0;2;8
12408;Vėjelis;Skruzdeliukų;8963364725;Ne;16;0;1;17
12409;Vėjelis;Skruzdeliukų;2888266675;Ne;0;0;17;17
12410;Vėjelis;Pieštukų;7854614677;Ne;3;4;0;7
12411;Vėjelis;Pieštukų;6453605110;Ne;11;1;2;14
12412;Vėjelis;Pieštukų;2720886612;Ne;0;4;0;4
12413;Vėjelis;Pieštukų;6520167840;Ne;16;0;2;18
12414;Vėjelis;Pieštukų;3691974508;Ne;5;5;0;10
12415;Vėjelis;Pieštukų;2912640999;Ne;0;0;2;2
12416;Vėjelis;Pieštukų;6839116451;Ne;13;0;4;17
12417;Vėjelis;Pieštukų;6938777118;Ne;3;1;4;8
12418;Vėjelis;Pieštukų;2553724469;Ne;0;22;0;22
12419;Vėjelis;Pieštukų;3012722334;Ne;13;0;2;15
12420;Vėjelis;Pieštukų;7889625599;Ne;0;8;0;8
12421;Vėjelis;Pieštukų;7763996061;Ne;0;7;0;7
12422;Vėjelis;Pieštukų;7553070848;Ne;0;4;3;7
12423;Vėjelis;Pieštukų;8310513436;Ne;2;4;4;10
12424;Vėjelis;Pieštukų;1291592424;Ne;7;0;0;7
12425;Vėjelis;Ramunėlių;5331895599;Ne;0;14;0;14
12426;Vėjelis;Ramunėlių;4450872985;Ne;5;0;2;7
12427;Vėjelis;Ramunėlių;1506416880;Ne;7;0;2;9
12428;Vėjelis;Ramunėlių;3756116835;Ne;0;7;3;10
12429;Vėjelis;Ramunėlių;6576149860;Ne;2;0;2;4
12430;Vėjelis;Ramunėlių;4843434827;Ne;0;6;0;6
12431;Vėjelis;Ramunėlių;1452685229;Ne;3;3;2;8
12432;Vėjelis;Ramunėlių;6573481399;Ne;2;1;2;5
12433;Vėjelis;Ramunėlių;2534737343;Ne;8;2;2;12
12434;Vėjelis;Ramunėlių;2195618699;Ne;0;13;0;13
12435;Vėjelis;Ramunėlių;8505186157;Ne;4;0;2;6
12436;Vėjelis;Ramunėlių;5452294829;Ne;6;0;2;8
12437;Vėjelis;Ramunėlių;4717248684;Ne;0;9;0;9
12438;Vėjelis;Ramunėlių;5291321394;Ne;5;0;2;7
12439;Vėjelis;Ramunėlių;9114597577;Ne;9;5;0;14
12440;Vėjelis;Nykštukai;6741600874;Ne;7;1;0;8
12441;Vėjelis;Nykštukai;9957614551;Ne;0;6;2;8
12442;Vėjelis;Nykštukai;7233448544;Ne;0;2;0;2
12443;Vėjelis;Nykštukai;5339200991;Ne;0;3;0;3
12444;Vėjelis;Nykštukai;6602964509;Ne;0;2;0;2
12445;Vėjelis;Nykštukai;2573683778;Ne;0;5;0;5
12446;Vėjelis;Nykštukai;3843601190;Ne;2;0;2;4
12447;Vėjelis;Nykštukai;4713754452;Ne;11;0;0;11
12448;Vėjelis;Nykštukai;3813509637;Ne;1;0;2;3
12449;Vėjelis;Nykštukai;8755889077;Ne;0;5;0;5
12450;Vėjelis;Nykštukai;9979979480;Ne;22;0;0;22
12451;Vėjelis;Nykštukai;6581265682;Ne;0;12;0;12
12452;Vėjelis;Nykštukai;8452132066;Ne;0;22;0;22
12453;Vėjelis;Nykštukai;7552365055;Ne;0;2;2;4
12454;Vėjelis;Nykštukai;6389449089;Ne;2;0;0;2
12455;Vėjelis;Nykštukai;9351658311;Ne;0;15;0;15
12456;Vėjelis;Nykštukai;1074246375;Ne;4;0;2;6
12457;Vėjelis;BITUTĖS;6824919005;Ne;0;4;0;4
12458;Vėjelis;BITUTĖS;4276237884;Taip;9;2;2;13
12459;Vėjelis;BITUTĖS;3772706363;Ne;2;3;2;7
12460;Vėjelis;BITUTĖS;1834203833;Ne;0;4;0;4
12461;Vėjelis;BITUTĖS;6283428333;Ne;5;0;2;7
12462;Vėjelis;BITUTĖS;6569848405;Ne;0;4;1;5
12463;Vėjelis;BITUTĖS;1457373815;Ne;6;5;2;13
12464;Vėjelis;BITUTĖS;8571757635;Ne;0;4;0;4
12465;Vėjelis;BITUTĖS;1022888418;Ne;19;0;2;21
12466;Vėjelis;BITUTĖS;1116238331;Ne;0;5;0;5
12467;Vėjelis;BITUTĖS;8286070405;Ne;1;8;2;11
12468;Vėjelis;BITUTĖS;1674810054;Ne;15;0;2;17
12469;Vėjelis;BITUTĖS;1070853175;Ne;3;0;2;5
12470;Vėjelis;BITUTĖS;4348246825;Taip;0;0;3;3
12471;Vėjelis;BITUTĖS;6660799519;Ne;5;2;2;9
12472;Vėjelis;BITUTĖS;6889825160;Taip;5;2;2;9
12473;Vėjelis;BITUTĖS;4745262277;Taip;0;4;0;4
12474;Vėjelis;BITUTĖS;3123360955;Ne;4;0;0;4
12475;Vėjelis;BITUTĖS;7790713917;Taip;5;2;2;9
12476;Vėjelis;BITUTĖS;1235788079;Taip;1;2;1;4
12477;Vėjelis;Boruželės;2199680661;Ne;6;2;2;10
12478;Vėjelis;Boruželės;1429496839;Ne;0;2;1;3
12479;Vėjelis;Boruželės;6108049183;Ne;0;6;0;6
12480;Vėjelis;Boruželės;1115802837;Ne;0;3;0;3
12481;Vėjelis;Boruželės;3276062426;Ne;0;2;1;3
12482;Vėjelis;Boruželės;4132824111;Ne;3;2;4;9
12483;Vėjelis;Boruželės;7752923796;Ne;0;2;6;8
12484;Vėjelis;Boruželės;8957653216;Ne;0;2;5;7
12485;Vėjelis;Boruželės;6431589805;Ne;0;4;3;7
12486;Vėjelis;Boruželės;4412135676;Ne;6;0;4;10
12487;Vėjelis;Boruželės;4746932126;Ne;0;2;0;2
12488;Vėjelis;Boruželės;1978952781;Ne;0;2;0;2
12489;Vėjelis;Boruželės;8353084814;Ne;0;4;3;7
12490;Vėjelis;Boruželės;2416832899;Ne;0;2;0;2
12491;Vėjelis;Boruželės;7594586198;Ne;0;4;0;4
12492;Vėjelis;Boruželės;7981032872;Ne;1;4;2;7
12493;Vėjelis;Boruželės;7697394469;Ne;0;4;1;5
12494;Vėjelis;Boruželės;4066956765;Ne;0;3;0;3
12495;Vėjelis;Boruželės;2788205363;Ne;0;4;0;4
12496;Vėtrungė;Debesėlių;3655025938;Ne;0;3;0;3
12497;Vėtrungė;Debesėlių;2825732654;Ne;0;1;2;3
12498;Vėtrungė;Debesėlių;7863176604;Ne;0;4;0;4
12499;Vėtrungė;Debesėlių;3179715496;Ne;0;4;0;4
12500;Vėtrungė;Debesėlių;6439014588;Ne;3;2;6;11
12501;Vėtrungė;Debesėlių;9423361592;Ne;0;4;0;4
12502;Vėtrungė;Debesėlių;4269488000;Ne;0;0;2;2
12503;Vėtrungė;Debesėlių;1191007983;Ne;2;4;4;10
12504;Vėtrungė;Debesėlių;3745680607;Ne;4;4;5;13
12505;Vėtrungė;Debesėlių;9359012317;Ne;19;0;4;23
12506;Vėtrungė;Debesėlių;1807742144;Ne;10;2;5;17
12507;Vėtrungė;Debesėlių;3433811829;Ne;0;0;5;5
12508;Vėtrungė;Debesėlių;2447851565;Ne;8;2;8;18
12509;Vėtrungė;Debesėlių;5246813735;Ne;0;0;1;1
12510;Vėtrungė;Debesėlių;8957071345;Ne;2;2;2;6
12511;Vėtrungė;Debesėlių;5545581078;Ne;5;2;2;9
12512;Vėtrungė;Debesėlių;7185104341;Ne;0;1;4;5
12513;Vėtrungė;Debesėlių;5939537473;Taip;5;5;2;12
12514;Vėtrungė;Debesėlių;1871358961;Ne;2;0;10;12
12515;Vėtrungė;Debesėlių;1480035015;Ne;3;0;2;5
12516;Vėtrungė;Debesėlių;7632969321;Ne;6;2;9;17
12517;Vėtrungė;Debesėlių;9642541034;Ne;0;2;4;6
12518;Vėtrungė;Debesėlių;6115556675;Ne;12;0;4;16
12519;Vėtrungė;Zuikių;9332362038;Ne;3;0;3;6
12520;Vėtrungė;Zuikių;9407558097;Ne;6;10;2;18
12521;Vėtrungė;Zuikių;2985829593;Ne;0;2;1;3
12522;Vėtrungė;Zuikių;4121886031;Ne;0;1;0;1
12523;Vėtrungė;Zuikių;7573021445;Ne;0;11;0;11
12524;Vėtrungė;Zuikių;3335047815;Ne;0;5;3;8
12525;Vėtrungė;Zuikių;8157356569;Ne;0;5;0;5
12526;Vėtrungė;Zuikių;9742099165;Ne;0;2;0;2
12527;Vėtrungė;Zuikių;1215953192;Ne;13;0;6;19
12528;Vėtrungė;Zuikių;3908259010;Ne;1;0;0;1
12529;Vėtrungė;Zuikių;1729819557;Ne;1;1;3;5
12530;Vėtrungė;Zuikių;4916692634;Ne;0;6;0;6
12531;Vėtrungė;Zuikių;4197321604;Ne;7;0;4;11
12532;Vėtrungė;Zuikių;1007578933;Ne;13;0;4;17
12533;Vėtrungė;Zuikių;7558548846;Ne;15;0;4;19
12534;Vėtrungė;Zuikių;8742161467;Taip;4;3;3;10
12535;Vėtrungė;Zuikių;2537221101;Ne;10;4;2;16
12536;Vėtrungė;Zuikių;7342250921;Taip;0;13;0;13
12537;Vėtrungė;Zuikių;9248113268;Ne;7;0;3;10
12538;Vėtrungė;Zuikių;7435005821;Ne;1;4;2;7
12539;Vėtrungė;Zuikių;1280823326;Ne;0;5;0;5
12540;Vėtrungė;Zuikių;4508176017;Ne;0;5;2;7
12541;Vėtrungė;Zuikių;8958748086;Ne;3;2;2;7
12542;Vėtrungė;Drugelių;5622109033;Ne;3;2;2;7
12543;Vėtrungė;Drugelių;6457369177;Ne;3;0;2;5
12544;Vėtrungė;Drugelių;8744050633;Ne;3;0;2;5
12545;Vėtrungė;Drugelių;7943682529;Ne;8;0;2;10
12546;Vėtrungė;Drugelių;9090873546;Ne;8;0;6;14
12547;Vėtrungė;Drugelių;2124476787;Ne;5;2;2;9
12548;Vėtrungė;Drugelių;2970067995;Ne;12;1;2;15
12549;Vėtrungė;Drugelių;8729505032;Ne;8;0;2;10
12550;Vėtrungė;Drugelių;5251308945;Taip;5;12;0;17
12551;Vėtrungė;Drugelių;9812496068;Ne;0;1;0;1
12552;Vėtrungė;Drugelių;8753387108;Ne;4;2;4;10
12553;Vėtrungė;Drugelių;3634995652;Ne;4;2;2;8
12554;Vėtrungė;Drugelių;2123410772;Ne;7;0;3;10
12555;Vėtrungė;Drugelių;3744377479;Ne;3;6;5;14
12556;Vėtrungė;Drugelių;8905533826;Ne;2;1;0;3
12557;Vėtrungė;Drugelių;7186353024;Ne;5;9;2;16
12558;Vėtrungė;Drugelių;2933312366;Taip;15;8;2;25
12559;Vėtrungė;Drugelių;2508501223;Ne;0;11;0;11
12560;Vėtrungė;Drugelių;6538402680;Ne;0;1;0;1
12561;Vėtrungė;Drugelių;5887245282;Ne;0;10;0;10
12562;Vėtrungė;Drugelių;3306549764;Ne;0;1;0;1
12563;Vėtrungė;Drugelių;7974212517;Ne;8;0;3;11
12564;Vėtrungė;Drugelių;9423979719;Ne;8;0;3;11
12565;Vėtrungė;Drugelių;1611114179;Ne;12;0;2;14
12566;Vėtrungė;Do-re-mi;7752842285;Ne;19;0;6;25
12567;Vėtrungė;Do-re-mi;1408629891;Ne;16;2;4;22
12568;Vėtrungė;Do-re-mi;7411180918;Ne;3;6;2;11
12569;Vėtrungė;Do-re-mi;2832753464;Ne;4;0;2;6
12570;Vėtrungė;Do-re-mi;2643851525;Ne;16;0;4;20
12571;Vėtrungė;Do-re-mi;6782673546;Ne;6;3;4;13
12572;Vėtrungė;Do-re-mi;3885409650;Ne;12;1;4;17
12573;Vėtrungė;Do-re-mi;4944115709;Ne;5;2;4;11
12574;Vėtrungė;Do-re-mi;7175547800;Ne;9;3;2;14
12575;Vėtrungė;Do-re-mi;1024958500;Ne;6;4;3;13
12576;Vėtrungė;Do-re-mi;5272077870;Ne;4;4;2;10
12577;Vėtrungė;Do-re-mi;1185643576;Ne;1;2;2;5
12578;Vėtrungė;Do-re-mi;9158760410;Ne;3;0;29;32
12579;Vėtrungė;Do-re-mi;3000030998;Ne;7;5;2;14
12580;Vėtrungė;Do-re-mi;4602351198;Ne;14;0;4;18
12581;Vėtrungė;Smalsučių;1020095914;Ne;2;2;3;7
12582;Vėtrungė;Smalsučių;7270370939;Ne;0;2;1;3
12583;Vėtrungė;Smalsučių;9543456295;Ne;1;1;2;4
12584;Vėtrungė;Smalsučių;2510763357;Ne;3;2;2;7
12585;Vėtrungė;Smalsučių;4713420194;Ne;3;2;2;7
12586;Vėtrungė;Smalsučių;9313438768;Ne;0;6;0;6
12587;Vėtrungė;Smalsučių;9685389270;Ne;0;1;2;3
12588;Vėtrungė;Smalsučių;9207846866;Ne;6;2;4;12
12589;Vėtrungė;Smalsučių;2226654309;Ne;5;3;2;10
12590;Vėtrungė;Smalsučių;1766599777;Ne;0;3;5;8
12591;Vėtrungė;Smalsučių;3328447991;Ne;0;1;0;1
12592;Vėtrungė;Smalsučių;4624264759;Ne;7;0;2;9
12593;Vėtrungė;Smalsučių;5832298824;Ne;0;1;0;1
12594;Vėtrungė;Smalsučių;2136966687;Ne;1;10;2;13
12595;Vėtrungė;Smalsučių;9070732925;Ne;2;3;5;10
12596;Vėtrungė;Smalsučių;2207041148;Ne;0;11;0;11
12597;Vėtrungė;Smalsučių;5836190044;Ne;7;3;2;12
12598;Vėtrungė;Smalsučių;6374739740;Taip;0;9;0;9
12599;Vėtrungė;Gudručių;9994445948;Ne;0;1;0;1
12600;Vėtrungė;Gudručių;6595858698;Ne;0;1;0;1
12601;Vėtrungė;Gudručių;6449124019;Ne;0;1;3;4
12602;Vėtrungė;Gudručių;9079483362;Ne;5;2;3;10
12603;Vėtrungė;Gudručių;8956375453;Ne;0;3;0;3
12604;Vėtrungė;Gudručių;7807708310;Ne;2;2;6;10
12605;Vėtrungė;Gudručių;9271869305;Ne;3;2;4;9
12606;Vėtrungė;Gudručių;2883254822;Ne;1;3;5;9
12607;Vėtrungė;Gudručių;7895027909;Ne;1;2;4;7
12608;Vėtrungė;Gudručių;5452337780;Ne;1;2;2;5
12609;Vėtrungė;Gudručių;3200251047;Ne;5;2;4;11
12610;Vėtrungė;Gudručių;5430818470;Ne;0;2;2;4
12611;Vėtrungė;Gudručių;9324733839;Ne;0;2;1;3
12612;Vėtrungė;Gudručių;4709068324;Ne;5;2;2;9
12613;Vėtrungė;Gudručių;9865628172;Ne;0;2;7;9
12614;Vėtrungė;Kodėlčių;9172488122;Ne;0;3;2;5
12615;Vėtrungė;Kodėlčių;2739382736;Ne;5;4;6;15
12616;Vėtrungė;Kodėlčių;3903604247;Ne;3;0;5;8
12617;Vėtrungė;Kodėlčių;3500551575;Ne;0;3;2;5
12618;Vėtrungė;Kodėlčių;7872043253;Ne;0;8;1;9
12619;Vėtrungė;Kodėlčių;9852609222;Ne;1;3;2;6
12620;Vėtrungė;Kodėlčių;8465132902;Ne;0;4;0;4
12621;Vėtrungė;Kodėlčių;8859592174;Ne;3;6;2;11
12622;Vėtrungė;Kodėlčių;7862615352;Ne;2;4;2;8
12623;Vėtrungė;Kodėlčių;5385880910;Ne;0;2;2;4
12624;Vėtrungė;Kodėlčių;9211406129;Ne;3;6;4;13
12625;Vėtrungė;Kodėlčių;1032730549;Ne;1;2;0;3
12626;Vėtrungė;Kodėlčių;7511121411;Ne;3;2;3;8
12627;Vėtrungė;Kodėlčių;9127735773;Ne;1;1;2;4
12628;Vėtrungė;Kodėlčių;5830221727;Ne;2;1;2;5
12629;Vėtrungė;Kodėlčių;4756863295;Ne;1;5;2;8
12630;Vėtrungė;Kodėlčių;8985054558;Ne;1;2;2;5
12631;Vėtrungė;Kodėlčių;3922749661;Ne;3;0;4;7
12632;Vėtrungė;Kodėlčių;8013249618;Taip;0;5;1;6
12633;Vėtrungė;Kodėlčių;3887230224;Ne;1;3;2;6
12634;Vėtrungė;Kodėlčių;7740260264;Ne;5;0;6;11
12635;Vėtrungė;Kodėlčių;6807838878;Ne;9;2;4;15
12636;Vėtrungė;Kodėlčių;3638303693;Ne;0;3;4;7
12637;Vėtrungė;Paukštelių;6983172988;Ne;4;3;2;9
12638;Vėtrungė;Paukštelių;3957148270;Ne;4;4;1;9
12639;Vėtrungė;Paukštelių;3466149991;Ne;6;8;2;16
12640;Vėtrungė;Paukštelių;7258995031;Ne;0;3;1;4
12641;Vėtrungė;Paukštelių;5338424871;Ne;4;4;2;10
12642;Vėtrungė;Paukštelių;4805836717;Ne;0;4;0;4
12643;Vėtrungė;Paukštelių;6812588777;Ne;4;3;1;8
12644;Vėtrungė;Paukštelių;2798915063;Ne;0;9;0;9
12645;Vėtrungė;Paukštelių;2981610749;Ne;13;0;11;24
12646;Vėtrungė;Paukštelių;6146327857;Ne;1;0;0;1
12647;Vėtrungė;Paukštelių;8149563485;Ne;2;0;6;8
12648;Vėtrungė;Paukštelių;2786721399;Ne;7;0;2;9
12649;Vėtrungė;Paukštelių;1397916572;Ne;8;1;2;11
12650;Vėtrungė;Paukštelių;9461365083;Ne;6;5;4;15
12651;Vėtrungė;Paukštelių;9822462988;Ne;0;5;1;6
12652;Vėtrungė;Paukštelių;2741119142;Ne;4;4;1;9
12653;Vėtrungė;Viščiukų;2725607774;Ne;2;6;2;10
12654;Vėtrungė;Viščiukų;5808423634;Ne;2;0;2;4
12655;Vėtrungė;Viščiukų;6190900822;Ne;5;2;2;9
12656;Vėtrungė;Viščiukų;4597361099;Ne;11;0;9;20
12657;Vėtrungė;Viščiukų;2490075899;Ne;7;2;4;13
12658;Vėtrungė;Viščiukų;8761701511;Ne;17;0;6;23
12659;Vėtrungė;Viščiukų;3527585648;Ne;8;4;2;14
12660;Vėtrungė;Viščiukų;4145172377;Ne;4;0;12;16
12661;Vėtrungė;Viščiukų;3859501564;Ne;7;8;4;19
12662;Vėtrungė;Viščiukų;3917214308;Ne;30;0;2;32
12663;Vėtrungė;Viščiukų;9862408289;Ne;13;0;8;21
12664;Vėtrungė;Viščiukų;7065114742;Ne;5;0;7;12
12665;Vėtrungė;Viščiukų;2558088727;Ne;0;20;0;20
12666;Vėtrungė;Viščiukų;6495674830;Ne;8;1;4;13
12667;Vėtrungė;Viščiukų;4782989673;Ne;6;2;4;12
12668;Vėtrungė;Viščiukų;8276160906;Ne;0;0;32;32
12669;Vėtrungė;Viščiukų;4516633703;Ne;11;0;4;15
12670;Vėtrungė;Viščiukų;6279761125;Ne;7;0;2;9
12671;Vėtrungė;Nykštukų;9696984346;Ne;2;3;2;7
12672;Vėtrungė;Nykštukų;7819147751;Ne;2;2;2;6
12673;Vėtrungė;Nykštukų;6990506209;Ne;15;1;2;18
12674;Vėtrungė;Nykštukų;2348557463;Ne;0;15;0;15
12675;Vėtrungė;Nykštukų;8059553343;Ne;0;1;0;1
12676;Vėtrungė;Nykštukų;4020987532;Ne;0;1;0;1
12677;Vėtrungė;Nykštukų;9569555731;Ne;9;3;2;14
12678;Vėtrungė;Nykštukų;9773838651;Ne;0;1;0;1
12679;Vėtrungė;Nykštukų;3869546285;Ne;0;2;1;3
12680;Vėtrungė;Nykštukų;6783756347;Ne;0;2;6;8
12681;Vėtrungė;Nykštukų;4289435509;Ne;3;5;2;10
12682;Vėtrungė;Nykštukų;5132419026;Ne;11;0;6;17
12683;Vėtrungė;Nykštukų;7647363322;Ne;11;0;6;17
12684;Vėtrungė;Nykštukų;3046782145;Ne;13;4;2;19
12685;Vėtrungė;Nykštukų;7037942782;Ne;10;9;2;21
12686;Vėtrungė;Nykštukų;2205455847;Ne;3;8;4;15
12687;Vėtrungė;Ąžuoliukų;8775969909;Ne;8;0;4;12
12688;Vėtrungė;Ąžuoliukų;1034537691;Ne;2;0;2;4
12689;Vėtrungė;Ąžuoliukų;6363761237;Ne;2;3;3;8
12690;Vėtrungė;Ąžuoliukų;8913748584;Ne;0;2;4;6
12691;Vėtrungė;Ąžuoliukų;3073965379;Ne;2;2;5;9
12692;Vėtrungė;Ąžuoliukų;3938684888;Ne;10;0;4;14
12693;Vėtrungė;Ąžuoliukų;6073563461;Ne;5;3;5;13
12694;Vėtrungė;Ąžuoliukų;2977116563;Ne;3;0;2;5
12695;Vėtrungė;Ąžuoliukų;4925843510;Ne;9;0;6;15
12696;Vėtrungė;Ąžuoliukų;8867794275;Ne;1;2;3;6
12697;Vėtrungė;Ąžuoliukų;7096106273;Ne;11;0;15;26
12698;Vėtrungė;Ąžuoliukų;8026065367;Ne;0;4;2;6
12699;Vėtrungė;Ąžuoliukų;6476717645;Ne;13;3;2;18
12700;Vėtrungė;Ąžuoliukų;5167580818;Ne;2;0;3;5
12701;Vėtrungė;Ąžuoliukų;1169648551;Ne;0;0;7;7
12702;Vėtrungė;Ąžuoliukų;4489937085;Ne;3;10;2;15
12703;Vėtrungė;Ąžuoliukų;4740985408;Ne;11;0;6;17
12704;Vėtrungė;Ąžuoliukų;9684184905;Ne;4;0;9;13
12705;Vėtrungė;Ąžuoliukų;5021830780;Ne;14;1;4;19
12706;Vėtrungė;Ąžuoliukų;1568598938;Ne;0;2;0;2
12707;Vėtrungė;Ąžuoliukų;9459062715;Ne;4;0;4;8
12708;Vėtrungė;"&quot;MEŠKIUKŲ&quot;";9667227707;Taip;7;0;4;11
12709;Vėtrungė;"&quot;MEŠKIUKŲ&quot;";4529215724;Taip;7;0;4;11
12710;Vėtrungė;"&quot;MEŠKIUKŲ&quot;";7900887923;Ne;12;3;6;21
12711;Vėtrungė;"&quot;MEŠKIUKŲ&quot;";2150341689;Ne;0;2;2;4
12712;Vėtrungė;"&quot;MEŠKIUKŲ&quot;";7323779310;Ne;5;0;4;9
12713;Vėtrungė;"&quot;MEŠKIUKŲ&quot;";6791587580;Ne;1;1;3;5
12714;Vėtrungė;"&quot;MEŠKIUKŲ&quot;";4550285483;Ne;0;0;2;2
12715;Vėtrungė;"&quot;MEŠKIUKŲ&quot;";3019474140;Ne;8;1;4;13
12716;Vėtrungė;"&quot;MEŠKIUKŲ&quot;";6529918013;Ne;5;0;4;9
12717;Vėtrungė;"&quot;MEŠKIUKŲ&quot;";2711203550;Ne;17;4;4;25
12718;Vėtrungė;"&quot;MEŠKIUKŲ&quot;";8632209474;Ne;1;2;2;5
12719;Vėtrungė;"&quot;MEŠKIUKŲ&quot;";1981425811;Ne;4;0;5;9
12720;Vilnelė;Lakštutė;8843094480;Ne;5;4;2;11
12721;Vilnelė;Lakštutė;5786086401;Ne;0;1;0;1
12722;Vilnelė;Lakštutė;6249731759;Ne;7;8;2;17
12723;Vilnelė;Lakštutė;6837850601;Ne;0;3;0;3
12724;Vilnelė;Lakštutė;5554451335;Ne;11;2;4;17
12725;Vilnelė;Lakštutė;1762024490;Ne;0;2;0;2
12726;Vilnelė;Lakštutė;8201829887;Ne;0;2;0;2
12727;Vilnelė;Lakštutė;7702217893;Ne;0;0;2;2
12728;Vilnelė;Lakštutė;4427383755;Ne;0;6;2;8
12729;Vilnelė;Lakštutė;1547117566;Ne;0;6;2;8
12730;Vilnelė;Lakštutė;3231387543;Ne;4;2;2;8
12731;Vilnelė;Lakštutė;1734277231;Ne;0;6;0;6
12732;Vilnelė;Lakštutė;3900484348;Ne;0;2;0;2
12733;Vilnelė;Lakštutė;5498574366;Ne;3;7;2;12
12734;Vilnelė;Lakštutė;6686896190;Ne;0;4;1;5
12735;Vilnelė;Lakštutė;3032273912;Ne;0;7;0;7
12736;Vilnelė;Lakštutė;4017436910;Ne;0;0;2;2
12737;Vilnelė;Lakštutė;6156838553;Ne;3;2;5;10
12738;Vilnelė;Lakštutė;9843449060;Ne;0;0;1;1
12739;Vilnelė;Lakštutė;2803880424;Ne;0;3;0;3
12740;Vilnelė;Lakštutė;2418216191;Ne;0;0;2;2
12741;Vilnelė;Lakštutė;5913967803;Ne;0;0;2;2
12742;Vilnelė;Vyturėlis;7536603663;Ne;8;3;2;13
12743;Vilnelė;Vyturėlis;3503461211;Ne;0;3;0;3
12744;Vilnelė;Vyturėlis;2788449626;Ne;0;0;2;2
12745;Vilnelė;Vyturėlis;1574809879;Ne;11;3;4;18
12746;Vilnelė;Vyturėlis;3558073399;Ne;8;0;4;12
12747;Vilnelė;Vyturėlis;6083082959;Ne;0;3;0;3
12748;Vilnelė;Vyturėlis;3993826389;Ne;0;7;1;8
12749;Vilnelė;Vyturėlis;7388336851;Ne;5;2;3;10
12750;Vilnelė;Vyturėlis;2923012145;Ne;2;1;5;8
12751;Vilnelė;Vyturėlis;8667403338;Ne;3;3;3;9
12752;Vilnelė;Vyturėlis;4166351390;Ne;8;2;2;12
12753;Vilnelė;Vyturėlis;1351798589;Ne;0;2;0;2
12754;Vilnelė;Vyturėlis;2841315531;Ne;2;0;3;5
12755;Vilnelė;Vyturėlis;9162681538;Ne;1;3;0;4
12756;Vilnelė;Vyturėlis;3075681823;Ne;2;3;0;5
12757;Vilnelė;Vyturėlis;9804772168;Ne;3;2;2;7
12758;Vilnelė;Vyturėlis;1596625263;Ne;0;5;3;8
12759;Vilnelė;Vyturėlis;7338573817;Ne;0;2;2;4
12760;Vilnelė;Vyturėlis;8121075430;Ne;0;19;0;19
12761;Vilnelė;Vyturėlis;6342242777;Ne;0;0;3;3
12762;Vilnelė;Vyturėlis;3843064564;Ne;0;2;1;3
12763;Vilnelė;Vyturėlis;9674145631;Ne;8;2;2;12
12764;Vilnelė;Pagrandukas;5508759323;Ne;0;2;1;3
12765;Vilnelė;Pagrandukas;2144925171;Ne;5;3;2;10
12766;Vilnelė;Pagrandukas;4295816753;Ne;0;10;0;10
12767;Vilnelė;Pagrandukas;3844066232;Ne;0;11;0;11
12768;Vilnelė;Pagrandukas;6659537454;Ne;0;2;0;2
12769;Vilnelė;Pagrandukas;4448413194;Ne;3;0;5;8
12770;Vilnelė;Pagrandukas;6830433856;Ne;3;2;4;9
12771;Vilnelė;Pagrandukas;4664946923;Ne;0;1;0;1
12772;Vilnelė;Pagrandukas;6982847450;Ne;0;4;0;4
12773;Vilnelė;Pagrandukas;7560124407;Ne;1;4;3;8
12774;Vilnelė;Pagrandukas;3685294539;Taip;2;0;2;4
12775;Vilnelė;Pagrandukas;4931943297;Ne;0;0;3;3
12776;Vilnelė;Pagrandukas;7882756938;Ne;0;2;0;2
12777;Vilnelė;Pagrandukas;7348404699;Ne;0;20;0;20
12778;Vilnelė;Pagrandukas;3323738649;Ne;0;2;0;2
12779;Vilnelė;Pagrandukas;8116613831;Ne;0;2;0;2
12780;Vilnelė;Pagrandukas;9489760844;Ne;0;5;0;5
12781;Vilnelė;Pagrandukas;6466321228;Ne;0;10;0;10
12782;Vilnelė;Pagrandukas;4478847902;Ne;0;6;0;6
12783;Vilnelė;Pagrandukas;9635159885;Ne;4;2;4;10
12784;Vilnelė;Pagrandukas;6448119003;Ne;0;1;0;1
12785;Vilnelė;Pagrandukas;2165389724;Ne;0;4;1;5
12786;Vilnelė;Bitutė;4718994967;Ne;0;15;0;15
12787;Vilnelė;Bitutė;3529718234;Ne;0;8;0;8
12788;Vilnelė;Bitutė;1880318663;Ne;0;11;0;11
12789;Vilnelė;Bitutė;9589410276;Ne;0;11;0;11
12790;Vilnelė;Bitutė;9879688569;Ne;0;6;0;6
12791;Vilnelė;Bitutė;5473379559;Ne;2;4;2;8
12792;Vilnelė;Bitutė;3781595939;Ne;0;7;0;7
12793;Vilnelė;Bitutė;3791258264;Ne;0;2;0;2
12794;Vilnelė;Bitutė;6132739519;Ne;0;7;0;7
12795;Vilnelė;Bitutė;1730149127;Ne;0;13;0;13
12796;Vilnelė;Bitutė;9884955712;Ne;0;6;0;6
12797;Vilnelė;Bitutė;5778176840;Ne;6;2;2;10
12798;Vilnelė;Bitutė;8162191913;Ne;3;3;2;8
12799;Vilnelė;Bitutė;6355912551;Ne;0;5;0;5
12800;Vilnelė;Bitutė;3945921490;Ne;0;19;0;19
12801;Vilnelė;Bitutė;7976798775;Ne;0;13;0;13
12802;Vilnelė;Bitutė;1975954784;Ne;0;4;0;4
12803;Vilnelė;Bitutė;8092642447;Ne;0;3;0;3
12804;Vilnelė;Bitutė;7199490431;Ne;0;2;0;2
12805;Vilnelė;Bitutė;3811289758;Ne;0;15;0;15
12806;Vilnelė;Bitutė;3856917286;Ne;0;13;0;13
12807;Vilnelė;Bitutė;7883724600;Ne;9;3;2;14
12808;Vilnelė;Šaltinėlis;5487729159;Taip;0;8;0;8
12809;Vilnelė;Šaltinėlis;1108529953;Ne;10;0;2;12
12810;Vilnelė;Šaltinėlis;8118746185;Ne;3;0;4;7
12811;Vilnelė;Šaltinėlis;7949990857;Ne;0;1;0;1
12812;Vilnelė;Šaltinėlis;3579253910;Ne;0;1;0;1
12813;Vilnelė;Šaltinėlis;4973214588;Ne;0;22;0;22
12814;Vilnelė;Šaltinėlis;6858955752;Ne;5;1;2;8
12815;Vilnelė;Šaltinėlis;9578062060;Taip;10;0;2;12
12816;Vilnelė;Šaltinėlis;5341996342;Ne;3;2;4;9
12817;Vilnelė;Šaltinėlis;5625236416;Ne;12;0;2;14
12818;Vilnelė;Šaltinėlis;9774791340;Ne;1;0;3;4
12819;Vilnelė;Šaltinėlis;1893356606;Taip;0;10;0;10
12820;Vilnelė;Šaltinėlis;2835124257;Ne;8;0;2;10
12821;Vilnelė;Šaltinėlis;7924367229;Ne;6;0;3;9
12822;Vilnelė;Riešutėllis;1027463000;Ne;4;2;2;8
12823;Vilnelė;Riešutėllis;7020707723;Ne;2;9;0;11
12824;Vilnelė;Riešutėllis;1960860528;Ne;6;0;2;8
12825;Vilnelė;Riešutėllis;4203549404;Ne;3;0;3;6
12826;Vilnelė;Riešutėllis;3290952017;Ne;17;0;2;19
12827;Vilnelė;Riešutėllis;8588430578;Ne;0;14;0;14
12828;Vilnelė;Riešutėllis;7957695470;Ne;8;2;2;12
12829;Vilnelė;Riešutėllis;8750705826;Ne;8;0;2;10
12830;Vilnelė;Riešutėllis;4780827432;Ne;1;4;2;7
12831;Vilnelė;Riešutėllis;4455099179;Ne;17;1;0;18
12832;Vilnelė;Riešutėllis;2367127222;Ne;0;10;0;10
12833;Vilnelė;Riešutėllis;5306723959;Ne;2;0;0;2
12834;Vilnelė;Riešutėllis;3670613082;Ne;0;5;4;9
12835;Vilnelė;Riešutėllis;3211657057;Ne;0;4;0;4
12836;Vilnelė;Riešutėllis;9016866597;Ne;0;15;0;15
12837;Vilnelė;Riešutėllis;7087798406;Ne;0;3;0;3
12838;Vilnelė;Riešutėllis;4254744025;Ne;2;11;0;13
12839;Vilnelė;Riešutėllis;3730997665;Ne;1;2;3;6
12840;Vilnelė;Riešutėllis;2706699572;Ne;0;7;0;7
12841;Vilnelė;Riešutėllis;8774842903;Ne;6;2;2;10
12842;Vilnelė;Nykštukas;4210511566;Taip;3;0;5;8
12843;Vilnelė;Nykštukas;2891787022;Ne;0;2;0;2
12844;Vilnelė;Nykštukas;4734511521;Ne;6;3;2;11
12845;Vilnelė;Nykštukas;6344134620;Ne;0;2;0;2
12846;Vilnelė;Nykštukas;4295630317;Ne;20;0;2;22
12847;Vilnelė;Nykštukas;1554473199;Ne;17;0;2;19
12848;Vilnelė;Nykštukas;1819154122;Ne;3;0;2;5
12849;Vilnelė;Nykštukas;4060927733;Ne;8;4;2;14
12850;Vilnelė;Nykštukas;2299381653;Ne;0;10;0;10
12851;Vilnelė;Nykštukas;5041031750;Ne;9;2;2;13
12852;Vilnelė;Nykštukas;2157793186;Ne;0;9;0;9
12853;Vilnelė;Nykštukas;4516818999;Ne;0;18;0;18
12854;Vilnelė;Nykštukas;8579294202;Ne;0;18;0;18
12855;Vilnelė;Nykštukas;7161529969;Ne;0;8;1;9
12856;Vilnelė;Nykštukas;3720979747;Ne;0;3;0;3
12857;Vilnelė;Nykštukas;8493390146;Ne;0;1;0;1
12858;Vilnelė;Nykštukas;6048991617;Taip;1;0;0;1
12859;Vilnelė;Nykštukas;6054488692;Ne;3;11;2;16
12860;Vilnelė;Nykštukas;8630048961;Ne;0;7;0;7
12861;Vilnelė;Nykštukas;1500899512;Ne;0;0;1;1
12862;Vilnelė;Nykštukas;7592040226;Ne;0;11;0;11
12863;Vilnelė;Nykštukas;1515873552;Ne;3;7;2;12
12864;Vilnelė;Nykštukas;5629086127;Ne;0;3;0;3
12865;Vilnelė;Pieštukas;9882766915;Ne;0;11;0;11
12866;Vilnelė;Pieštukas;5444967820;Ne;2;0;2;4
12867;Vilnelė;Pieštukas;3828623778;Ne;8;2;2;12
12868;Vilnelė;Pieštukas;7698638698;Ne;3;0;2;5
12869;Vilnelė;Pieštukas;3064118212;Ne;4;4;2;10
12870;Vilnelė;Pieštukas;7231998656;Ne;17;0;0;17
12871;Vilnelė;Pieštukas;5813090771;Ne;3;0;2;5
12872;Vilnelė;Pieštukas;4670933970;Ne;0;1;0;1
12873;Vilnelė;Pieštukas;9317041585;Ne;2;0;1;3
12874;Vilnelė;Pieštukas;2683662906;Ne;22;0;0;22
12875;Vilnelė;Pieštukas;4982137749;Taip;0;1;0;1
12876;Vilnelė;Pieštukas;2700153185;Ne;0;0;3;3
12877;Vilnelė;Pieštukas;4817502971;Ne;5;0;2;7
12878;Vilnelė;Pieštukas;3712463891;Ne;0;5;0;5
12879;Vilnelė;Pieštukas;2576381995;Ne;3;0;2;5
12880;Vilnelė;Pieštukas;9476510950;Ne;7;2;2;11
12881;Vilnelė;Pieštukas;8848138564;Taip;0;5;0;5
12882;Vilnelė;Pieštukas;7752502124;Ne;5;0;2;7
12883;Vilnelė;Voverytė;1414168531;Ne;0;0;1;1
12884;Vilnelė;Voverytė;2918624119;Ne;5;0;4;9
12885;Vilnelė;Voverytė;3432602015;Ne;0;1;1;2
12886;Vilnelė;Voverytė;9660305163;Ne;9;2;3;14
12887;Vilnelė;Voverytė;9950598582;Taip;6;0;4;10
12888;Vilnelė;Voverytė;7968029402;Ne;3;2;0;5
12889;Vilnelė;Voverytė;7221712624;Ne;1;2;2;5
12890;Vilnelė;Voverytė;2964672357;Ne;7;2;3;12
12891;Vilnelė;Voverytė;5273665901;Ne;1;0;2;3
12892;Vilnelė;Voverytė;1566734465;Ne;0;0;1;1
12893;Vilnelė;Voverytė;1371066506;Ne;5;0;2;7
12894;Vilnelė;Voverytė;3654833067;Ne;1;1;3;5
12895;Vilnelė;Voverytė;4322462166;Ne;1;1;3;5
12896;Vilnelė;Voverytė;5649725693;Ne;0;4;1;5
12897;Vilnelė;Voverytė;3234028667;Ne;4;4;4;12
12898;Vilnelė;Voverytė;7870509810;Taip;5;0;2;7
12899;Vilnelė;Voverytė;6569980514;Ne;11;0;4;15
12900;Vilnelė;Voverytė;4758117005;Taip;9;2;4;15
12901;Vilnelė;Voverytė;6634526716;Ne;0;9;0;9
12902;Vilnelė;Voverytė;1598555488;Ne;2;1;2;5
12903;Vilnelė;Voverytė;5960725916;Ne;7;7;2;16
12904;Vilnelė;Voverytė;7568755715;Ne;3;2;3;8
12905;Vilnelė;Kodėlčiukas;4642378600;Ne;3;2;2;7
12906;Vilnelė;Kodėlčiukas;6618109352;Ne;0;19;0;19
12907;Vilnelė;Kodėlčiukas;6715997340;Ne;7;4;0;11
12908;Vilnelė;Kodėlčiukas;9482133396;Ne;9;0;2;11
12909;Vilnelė;Kodėlčiukas;8620789304;Ne;4;2;2;8
12910;Vilnelė;Kodėlčiukas;8439505238;Ne;15;2;2;19
12911;Vilnelė;Kodėlčiukas;1580287517;Ne;0;5;0;5
12912;Vilnelė;Kodėlčiukas;5558378376;Taip;0;1;0;1
12913;Vilnelė;Kodėlčiukas;4328263940;Ne;0;4;0;4
12914;Vilnelė;Kodėlčiukas;3056845279;Ne;0;17;0;17
12915;Vilnelė;Kodėlčiukas;9537740492;Ne;1;0;2;3
12916;Vilnelė;Kodėlčiukas;9640330864;Ne;7;3;0;10
12917;Vilnelė;Kodėlčiukas;3848720970;Ne;0;0;2;2
12918;Vilnelė;Kodėlčiukas;7833531435;Ne;5;2;0;7
12919;Vilnelė;Kodėlčiukas;5961910077;Ne;5;2;2;9
12920;Vilnelė;Kodėlčiukas;3115242919;Ne;1;2;1;4
12921;Vilnelė;Kodėlčiukas;8543995029;Taip;5;10;0;15
12922;Vilnelė;Kodėlčiukas;1933660272;Ne;0;0;2;2
12923;Vilnelė;Kodėlčiukas;4986079102;Ne;2;4;0;6
12924;Vilnelė;Kodėlčiukas;5398303580;Ne;3;3;0;6
12925;Vilnelė;Kodėlčiukas;9418661965;Ne;7;2;2;11
12926;Vilnelė;Kodėlčiukas;5180951251;Ne;6;2;3;11
12927;Vilnelė;Žirniukas;9817054571;Ne;3;2;2;7
12928;Vilnelė;Žirniukas;5147406277;Ne;11;2;2;15
12929;Vilnelė;Žirniukas;9476348226;Ne;0;2;0;2
12930;Vilnelė;Žirniukas;9253975757;Ne;3;2;2;7
12931;Vilnelė;Žirniukas;9432188739;Ne;0;6;0;6
12932;Vilnelė;Žirniukas;8216383228;Ne;4;2;2;8
12933;Vilnelė;Žirniukas;2358167792;Ne;8;0;4;12
12934;Vilnelė;Žirniukas;2146981715;Ne;5;0;5;10
12935;Vilnelė;Žirniukas;1465849135;Ne;0;2;0;2
12936;Vilnelė;Žirniukas;9578715472;Ne;7;2;4;13
12937;Vilnelė;Žirniukas;2188575653;Ne;8;2;3;13
12938;Vilnelė;Žirniukas;2234709212;Ne;0;2;0;2
12939;Vilnelė;Žirniukas;1912897383;Ne;8;0;2;10
12940;Vilnelė;Žirniukas;4789175532;Ne;6;0;3;9
12941;Vilnelė;Pipiras;1977362135;Ne;3;0;4;7
12942;Vilnelė;Pipiras;6883775268;Ne;7;0;4;11
12943;Vilnelė;Pipiras;1336126156;Ne;0;2;0;2
12944;Vilnelė;Pipiras;5855361002;Ne;7;0;4;11
12945;Vilnelė;Pipiras;1631249610;Ne;2;2;2;6
12946;Vilnelė;Pipiras;4692537934;Ne;10;1;2;13
12947;Vilnelė;Pipiras;9300237246;Ne;10;0;3;13
12948;Vilnelė;Pipiras;7090044022;Ne;0;0;1;1
12949;Vilnelė;Pipiras;8602843000;Ne;4;4;2;10
12950;Vilnelė;Pipiras;6707024855;Ne;0;9;0;9
12951;Vilnelė;Pipiras;9016135318;Ne;0;2;0;2
12952;Vilnelė;Pipiras;8015908754;Ne;0;14;0;14
12953;Vilnelė;Pipiras;4445721874;Ne;2;4;4;10
12954;Vilnelė;Pipiras;1003518211;Ne;2;4;4;10
12955;Vilnelė;Pipiras;3980908303;Ne;0;10;0;10
12956;Vėrinėlis;GAIDELIAI;6162461750;Ne;5;0;2;7
12957;Vėrinėlis;GAIDELIAI;1944358526;Ne;30;0;2;32
12958;Vėrinėlis;GAIDELIAI;3500287869;Ne;17;3;4;24
12959;Vėrinėlis;GAIDELIAI;6500266853;Ne;12;0;4;16
12960;Vėrinėlis;GAIDELIAI;5891690000;Ne;2;3;4;9
12961;Vėrinėlis;GAIDELIAI;4401001009;Ne;21;2;4;27
12962;Vėrinėlis;GAIDELIAI;1685329004;Ne;5;0;2;7
12963;Vėrinėlis;GAIDELIAI;4498096701;Ne;14;1;4;19
12964;Vėrinėlis;GAIDELIAI;9144004655;Ne;8;1;4;13
12965;Vėrinėlis;GAIDELIAI;8272531606;Ne;7;1;4;12
12966;Vėrinėlis;GAIDELIAI;2114637828;Ne;9;0;2;11
12967;Vėrinėlis;GAIDELIAI;1844862699;Ne;9;0;2;11
12968;Vėrinėlis;GAIDELIAI;7455948332;Ne;5;4;0;9
12969;Vėrinėlis;GAIDELIAI;4965735537;Ne;8;0;3;11
12970;Vėrinėlis;GAIDELIAI;1014076118;Ne;9;0;3;12
12971;Vėrinėlis;GAIDELIAI;8817186115;Ne;5;6;2;13
12972;Vėrinėlis;GAIDELIAI;6211953526;Ne;10;3;2;15
12973;Vėrinėlis;GAIDELIAI;9522506115;Ne;9;3;2;14
12974;Vėrinėlis;GAIDELIAI;6159725406;Ne;8;2;2;12
12975;Vėrinėlis;SAULUTĖ;7224418233;Ne;5;0;4;9
12976;Vėrinėlis;SAULUTĖ;7471147288;Taip;0;2;0;2
12977;Vėrinėlis;SAULUTĖ;8238013636;Taip;4;6;3;13
12978;Vėrinėlis;SAULUTĖ;7273090217;Taip;0;2;1;3
12979;Vėrinėlis;SAULUTĖ;2337883071;Taip;6;0;8;14
12980;Vėrinėlis;SAULUTĖ;6913001318;Ne;0;5;0;5
12981;Vėrinėlis;SAULUTĖ;7440020169;Ne;4;3;2;9
12982;Vėrinėlis;SAULUTĖ;7913975075;Ne;0;10;0;10
12983;Vėrinėlis;SAULUTĖ;9009344779;Taip;0;10;0;10
12984;Vėrinėlis;SAULUTĖ;4059906525;Ne;5;0;3;8
12985;Vėrinėlis;SAULUTĖ;3832662507;Taip;2;0;1;3
12986;Vėrinėlis;SAULUTĖ;3291922401;Ne;4;2;2;8
12987;Vėrinėlis;SAULUTĖ;1007705906;Ne;0;11;0;11
12988;Vėrinėlis;SAULUTĖ;9289003583;Ne;0;5;0;5
12989;Vėrinėlis;SAULUTĖ;1684203955;Ne;0;5;0;5
12990;Vėrinėlis;SAULUTĖ;5942475043;Taip;0;7;0;7
12991;Vėrinėlis;SAULUTĖ;9310629340;Ne;2;0;0;2
12992;Vėrinėlis;SAULUTĖ;2369434537;Ne;0;2;0;2
12993;Vėrinėlis;SAULUTĖ;4728119881;Ne;0;2;0;2
12994;Vėrinėlis;SAULUTĖ;1515803985;Ne;0;9;0;9
12995;Vėrinėlis;SAULUTĖ;1303022448;Taip;1;0;3;4
12996;Vėrinėlis;NYKŠTUKAI;5488087105;Ne;0;6;0;6
12997;Vėrinėlis;NYKŠTUKAI;4423562494;Ne;3;0;3;6
12998;Vėrinėlis;NYKŠTUKAI;5167825818;Taip;0;0;19;19
12999;Vėrinėlis;NYKŠTUKAI;2646575761;Ne;1;2;3;6
13000;Vėrinėlis;NYKŠTUKAI;8397635057;Ne;6;1;2;9
13001;Vėrinėlis;NYKŠTUKAI;8423611087;Ne;2;0;1;3
13002;Vėrinėlis;NYKŠTUKAI;8294753714;Ne;15;0;2;17
13003;Vėrinėlis;NYKŠTUKAI;4841000338;Ne;3;0;4;7
13004;Vėrinėlis;NYKŠTUKAI;2403376619;Ne;0;1;0;1
13005;Vėrinėlis;NYKŠTUKAI;2384172198;Ne;0;2;2;4
13006;Vėrinėlis;BURATINAS;7093959212;Ne;0;5;0;5
13007;Vėrinėlis;BURATINAS;8100283579;Ne;0;5;0;5
13008;Vėrinėlis;BURATINAS;2774618380;Ne;0;4;0;4
13009;Vėrinėlis;BURATINAS;5429955166;Ne;0;3;0;3
13010;Vėrinėlis;BURATINAS;5429372946;Ne;8;0;4;12
13011;Vėrinėlis;BURATINAS;2467700639;Ne;4;7;0;11
13012;Vėrinėlis;BURATINAS;6136232912;Ne;0;6;0;6
13013;Vėrinėlis;BURATINAS;7092421890;Ne;0;2;0;2
13014;Vėrinėlis;BURATINAS;6058712578;Ne;3;7;0;10
13015;Vėrinėlis;BURATINAS;6413701823;Ne;2;0;0;2
13016;Vėrinėlis;BURATINAS;2364117224;Ne;3;4;2;9
13017;Vėrinėlis;BURATINAS;7287634205;Ne;0;4;0;4
13018;Vėrinėlis;BURATINAS;3898060925;Ne;3;8;2;13
13019;Vėrinėlis;BURATINAS;4676052255;Ne;0;1;0;1
13020;Vėrinėlis;BURATINAS;3882915774;Ne;0;9;0;9
13021;Vėrinėlis;BURATINAS;7167034587;Ne;0;6;0;6
13022;Vėrinėlis;BURATINAS;1919350623;Ne;9;0;4;13
13023;Vėrinėlis;BURATINAS;9612956692;Ne;0;10;0;10
13024;Vėrinėlis;BURATINAS;6310807762;Ne;2;0;2;4
13025;Vėrinėlis;BURATINAS;5514167627;Ne;6;0;5;11
13026;Vėrinėlis;GINTARĖLIAI;8372084728;Ne;6;5;2;13
13027;Vėrinėlis;GINTARĖLIAI;6054398276;Ne;1;0;2;3
13028;Vėrinėlis;GINTARĖLIAI;7432965615;Ne;3;0;2;5
13029;Vėrinėlis;GINTARĖLIAI;3457199716;Ne;0;4;2;6
13030;Vėrinėlis;GINTARĖLIAI;7743951577;Ne;0;0;2;2
13031;Vėrinėlis;GINTARĖLIAI;2006432327;Ne;0;1;0;1
13032;Vėrinėlis;GINTARĖLIAI;6785519869;Ne;0;1;2;3
13033;Vėrinėlis;GINTARĖLIAI;3363388500;Ne;0;14;0;14
13034;Vėrinėlis;GINTARĖLIAI;9171173116;Ne;0;1;0;1
13035;Vėrinėlis;GINTARĖLIAI;3192625484;Ne;3;0;2;5
13036;Vėrinėlis;GINTARĖLIAI;8343196405;Ne;10;3;2;15
13037;Vėrinėlis;GINTARĖLIAI;5644772729;Ne;0;2;0;2
13038;Vėrinėlis;GINTARĖLIAI;4034106321;Ne;0;1;0;1
13039;Vėrinėlis;GINTARĖLIAI;5654269153;Ne;0;0;1;1
13040;Vėrinėlis;GINTARĖLIAI;6226329879;Ne;3;0;2;5
13041;Vėrinėlis;GINTARĖLIAI;7069247393;Ne;0;2;1;3
13042;Vėrinėlis;GINTARĖLIAI;9370715798;Taip;4;0;3;7
13043;Vėrinėlis;GINTARĖLIAI;6055921178;Ne;0;4;0;4
13044;Vėrinėlis;RAMUNĖLĖS;2911674984;Ne;6;2;4;12
13045;Vėrinėlis;RAMUNĖLĖS;4123553749;Ne;19;0;4;23
13046;Vėrinėlis;RAMUNĖLĖS;9234123596;Ne;9;0;3;12
13047;Vėrinėlis;RAMUNĖLĖS;5051742311;Ne;3;1;2;6
13048;Vėrinėlis;RAMUNĖLĖS;9257045102;Ne;1;0;3;4
13049;Vėrinėlis;RAMUNĖLĖS;5501075800;Ne;4;0;6;10
13050;Vėrinėlis;RAMUNĖLĖS;1699912818;Ne;5;0;2;7
13051;Vėrinėlis;RAMUNĖLĖS;7294499755;Ne;24;2;2;28
13052;Vėrinėlis;RAMUNĖLĖS;7544881486;Ne;0;2;0;2
13053;Vėrinėlis;RAMUNĖLĖS;1403519604;Ne;7;0;6;13
13054;Vėrinėlis;RAMUNĖLĖS;6240649255;Ne;7;0;6;13
13055;Vėrinėlis;RAMUNĖLĖS;2763569936;Ne;0;9;0;9
13056;Vėrinėlis;RAMUNĖLĖS;7349463495;Ne;5;5;2;12
13057;Vėrinėlis;RAMUNĖLĖS;9935098198;Ne;11;0;2;13
13058;Vėrinėlis;KODELČIUKŲ;8722816580;Ne;4;0;4;8
13059;Vėrinėlis;KODELČIUKŲ;5342916562;Ne;0;0;3;3
13060;Vėrinėlis;KODELČIUKŲ;9650883071;Ne;2;0;3;5
13061;Vėrinėlis;KODELČIUKŲ;9349874701;Ne;3;0;3;6
13062;Vėrinėlis;KODELČIUKŲ;9179544549;Ne;13;0;4;17
13063;Vėrinėlis;KODELČIUKŲ;3830101723;Ne;10;0;2;12
13064;Vėrinėlis;KODELČIUKŲ;4818860992;Ne;0;2;2;4
13065;Vėrinėlis;KODELČIUKŲ;2908247336;Ne;3;0;1;4
13066;Vėrinėlis;KODELČIUKŲ;8389805682;Taip;4;2;3;9
13067;Vėrinėlis;KODELČIUKŲ;3563156582;Ne;2;0;4;6
13068;Vėrinėlis;KODELČIUKŲ;1119458722;Ne;10;0;2;12
13069;Vėrinėlis;KODELČIUKŲ;8029977991;Ne;1;0;2;3
13070;Vėrinėlis;KODELČIUKŲ;4065241921;Ne;9;1;4;14
13071;Vėrinėlis;KODELČIUKŲ;8977670959;Ne;9;0;3;12
13072;Vėrinėlis;KODELČIUKŲ;7382201231;Ne;10;0;4;14
13073;Vėrinėlis;ŽIRNIUKAI;1769852084;Ne;0;3;3;6
13074;Vėrinėlis;ŽIRNIUKAI;4718732261;Taip;0;2;0;2
13075;Vėrinėlis;ŽIRNIUKAI;4981127515;Ne;0;2;0;2
13076;Vėrinėlis;ŽIRNIUKAI;8329989952;Ne;2;0;4;6
13077;Vėrinėlis;ŽIRNIUKAI;3202518504;Taip;2;3;3;8
13078;Vėrinėlis;ŽIRNIUKAI;4752902173;Ne;0;6;0;6
13079;Vėrinėlis;ŽIRNIUKAI;7237945125;Ne;0;2;2;4
13080;Vėrinėlis;ŽIRNIUKAI;5600815908;Taip;0;9;0;9
13081;Vėrinėlis;ŽIRNIUKAI;2687583764;Ne;7;0;2;9
13082;Vėrinėlis;ŽIRNIUKAI;2633143128;Ne;7;2;4;13
13083;Vėrinėlis;ŽIRNIUKAI;7817387800;Ne;0;0;2;2
13084;Vėrinėlis;ŽIRNIUKAI;6377447141;Ne;9;0;4;13
13085;Vėrinėlis;ŽIRNIUKAI;7371908331;Ne;2;5;2;9
13086;Vėrinėlis;ŽIRNIUKAI;2087129236;Ne;0;3;1;4
13087;Vėrinėlis;ŽIRNIUKAI;6392625405;Ne;0;4;0;4
13088;Vėrinėlis;ŽIRNIUKAI;1896980533;Ne;4;1;4;9
13089;Vėrinėlis;ŽIRNIUKAI;8483525051;Ne;0;3;0;3
13090;Vėrinėlis;ŽIRNIUKAI;8397025332;Ne;5;1;4;10
13091;Vėrinėlis;ŽIRNIUKAI;6576726481;Ne;5;1;4;10
13092;Vėrinėlis;ŽIRNIUKAI;6220653152;Ne;2;2;2;6
13093;Vėrinėlis;VARPELIAI;7416041207;Ne;0;5;0;5
13094;Vėrinėlis;VARPELIAI;8655158155;Ne;6;2;2;10
13095;Vėrinėlis;VARPELIAI;3829146401;Taip;3;2;2;7
13096;Vėrinėlis;VARPELIAI;6362125404;Ne;8;4;2;14
13097;Vėrinėlis;VARPELIAI;9599724421;Ne;0;12;0;12
13098;Vėrinėlis;VARPELIAI;7216867683;Ne;0;6;0;6
13099;Vėrinėlis;VARPELIAI;2731207996;Ne;0;0;3;3
13100;Vėrinėlis;VARPELIAI;2625930005;Ne;8;0;5;13
13101;Vėrinėlis;VARPELIAI;1026312967;Ne;0;3;0;3
13102;Vėrinėlis;VARPELIAI;2561255096;Ne;0;2;1;3
13103;Vėrinėlis;VARPELIAI;3392458614;Ne;0;2;0;2
13104;Vėrinėlis;VARPELIAI;5837383907;Ne;0;1;0;1
13105;Vėrinėlis;VARPELIAI;3953496894;Ne;2;2;2;6
13106;Vėrinėlis;VARPELIAI;3663446767;Ne;5;2;2;9
13107;Vėrinėlis;VARPELIAI;4086695239;Ne;2;0;5;7
13108;Vėrinėlis;BORUŽĖLĖS;8759487574;Ne;0;8;0;8
13109;Vėrinėlis;BORUŽĖLĖS;4819016753;Ne;0;0;2;2
13110;Vėrinėlis;BORUŽĖLĖS;1910385020;Ne;5;1;2;8
13111;Vėrinėlis;BORUŽĖLĖS;2078857084;Ne;2;2;0;4
13112;Vėrinėlis;BORUŽĖLĖS;3934652683;Ne;20;0;0;20
13113;Vėrinėlis;BORUŽĖLĖS;6904733283;Ne;8;0;7;15
13114;Vėrinėlis;BORUŽĖLĖS;4446546335;Ne;0;3;0;3
13115;Vėrinėlis;BORUŽĖLĖS;3718510933;Ne;4;1;1;6
13116;Vėrinėlis;BORUŽĖLĖS;2501287529;Ne;0;3;0;3
13117;Vėrinėlis;BORUŽĖLĖS;8904833339;Ne;12;3;0;15
13118;Vėrinėlis;BORUŽĖLĖS;3312501759;Ne;12;3;0;15
13119;Vėrinėlis;BORUŽĖLĖS;9217188911;Ne;8;9;2;19
13120;Vėrinėlis;BORUŽĖLĖS;7414937335;Taip;4;4;0;8
13121;Vėrinėlis;BORUŽĖLĖS;2574507205;Ne;3;2;2;7
13122;Vėrinėlis;BORUŽĖLĖS;6671382987;Ne;1;0;0;1
13123;Vėrinėlis;BORUŽĖLĖS;4852563692;Ne;1;3;3;7
13124;Vėrinėlis;BORUŽĖLĖS;5865529907;Ne;14;0;3;17
13125;Vėrinėlis;BORUŽĖLĖS;9613642664;Ne;0;8;0;8
13126;Vėrinėlis;BORUŽĖLĖS;2467242845;Ne;0;7;0;7
13127;Vėrinėlis;BORUŽĖLĖS;4037594669;Ne;0;1;0;1
13128;Vėrinėlis;SVEIKUOLIAI;6176308531;Ne;8;4;2;14
13129;Vėrinėlis;SVEIKUOLIAI;3070965434;Ne;0;1;0;1
13130;Vėrinėlis;SVEIKUOLIAI;3563114419;Ne;7;0;2;9
13131;Vėrinėlis;SVEIKUOLIAI;3973272659;Ne;2;3;2;7
13132;Vėrinėlis;SVEIKUOLIAI;8032396191;Ne;0;0;2;2
13133;Vėrinėlis;SVEIKUOLIAI;6504377326;Ne;0;2;0;2
13134;Vėrinėlis;SVEIKUOLIAI;8716965452;Ne;14;3;2;19
13135;Vėrinėlis;SVEIKUOLIAI;7584124339;Ne;8;0;3;11
13136;Vėrinėlis;SVEIKUOLIAI;9352630743;Ne;0;3;3;6
13137;Vėrinėlis;SVEIKUOLIAI;4859330774;Ne;2;5;0;7
13138;Vėrinėlis;SVEIKUOLIAI;8543081245;Ne;0;2;0;2
13139;Vėrinėlis;SVEIKUOLIAI;1800434426;Ne;4;4;2;10
13140;Vėrinėlis;SVEIKUOLIAI;3958551159;Ne;6;0;2;8
13141;Vėrinėlis;SVEIKUOLIAI;5614185158;Ne;6;1;3;10
13142;Vėrinėlis;SVEIKUOLIAI;2516474825;Ne;3;2;2;7
13143;Vėrinėlis;SVEIKUOLIAI;9058127692;Ne;0;2;2;4
13144;Vėrinėlis;SVEIKUOLIAI;1278914183;Ne;5;0;2;7
13145;Vėrinėlis;SVEIKUOLIAI;7573209012;Ne;0;2;0;2
13146;Vėrinėlis;SVEIKUOLIAI;3084117432;Ne;2;2;2;6
13147;Vėrinėlis;SVEIKUOLIAI;2015928440;Ne;2;0;0;2
13148;Vėrinėlis;ŠIRDELĖS;7734163541;Ne;0;2;0;2
13149;Vėrinėlis;ŠIRDELĖS;7811024382;Ne;0;0;2;2
13150;Vėrinėlis;ŠIRDELĖS;4378592116;Ne;7;6;2;15
13151;Vėrinėlis;ŠIRDELĖS;7517113022;Ne;0;0;2;2
13152;Vėrinėlis;ŠIRDELĖS;1841277321;Ne;8;3;2;13
13153;Vėrinėlis;ŠIRDELĖS;5588658517;Ne;7;0;2;9
13154;Vėrinėlis;ŠIRDELĖS;5653635907;Ne;0;6;0;6
13155;Vėrinėlis;ŠIRDELĖS;1152010178;Ne;11;2;4;17
13156;Vėrinėlis;ŠIRDELĖS;2038169885;Ne;5;11;2;18
13157;Vėrinėlis;ŠIRDELĖS;9375922889;Taip;6;1;2;9
13158;Vėrinėlis;ŠIRDELĖS;5813009126;Ne;5;5;2;12
13159;Vėrinėlis;ŠIRDELĖS;3511809411;Ne;0;3;2;5
13160;Vėrinėlis;ŠIRDELĖS;9217815657;Ne;0;4;0;4
13161;Vėrinėlis;ŠIRDELĖS;4403875733;Ne;3;0;2;5
13162;Vėrinėlis;ŠIRDELĖS;4700093328;Ne;1;0;5;6
13163;Vėrinėlis;ŠIRDELĖS;1339847370;Ne;6;0;4;10
13164;Vėrinėlis;ŠIRDELĖS;1939318286;Ne;0;1;0;1
13165;Vėrinėlis;ŠIRDELĖS;3687250255;Ne;0;6;0;6
13166;Vėrinėlis;ŠIRDELĖS;2847839917;Taip;6;4;4;14
13167;Vėrinėlis;ŠIRDELĖS;7311740859;Ne;0;5;0;5
13168;Vėrinėlis;ŠIRDELĖS;6905591549;Ne;4;6;2;12
13169;Viltenė;Drugeliai;3625763429;Ne;2;2;0;4
13170;Viltenė;Drugeliai;2392304909;Ne;0;2;0;2
13171;Viltenė;Drugeliai;5781655552;Ne;9;2;0;11
13172;Viltenė;Drugeliai;8679787688;Ne;5;0;0;5
13173;Viltenė;Drugeliai;4616047113;Ne;0;9;0;9
13174;Viltenė;Drugeliai;6810811656;Ne;0;3;0;3
13175;Viltenė;Drugeliai;3905014810;Ne;0;11;0;11
13176;Viltenė;Drugeliai;4121448859;Ne;4;3;0;7
13177;Viltenė;Drugeliai;9157616307;Ne;0;6;0;6
13178;Viltenė;Drugeliai;9476132305;Ne;7;3;0;10
13179;Viltenė;Drugeliai;7401460248;Ne;0;1;0;1
13180;Viltenė;Drugeliai;9820462941;Ne;0;0;2;2
13181;Viltenė;Drugeliai;7928894276;Ne;8;9;0;17
13182;Viltenė;Drugeliai;1081603034;Ne;0;13;0;13
13183;Viltenė;Drugeliai;7500965165;Ne;0;2;0;2
13184;Viltenė;Bitučių;4001205912;Ne;13;3;0;16
13185;Viltenė;Bitučių;5077874991;Ne;0;6;0;6
13186;Viltenė;Bitučių;7266522399;Ne;4;1;2;7
13187;Viltenė;Bitučių;5241075224;Ne;0;1;0;1
13188;Viltenė;Bitučių;1374979411;Ne;0;2;0;2
13189;Viltenė;Bitučių;1765335359;Ne;6;9;0;15
13190;Viltenė;Bitučių;8681961430;Ne;6;0;8;14
13191;Viltenė;Bitučių;9438542101;Ne;4;1;6;11
13192;Viltenė;Bitučių;8608269197;Ne;0;2;0;2
13193;Viltenė;Bitučių;9805422851;Ne;0;2;0;2
13194;Viltenė;Bitučių;1042857771;Ne;1;0;2;3
13195;Viltenė;Bitučių;2460019568;Ne;0;9;0;9
13196;Viltenė;Boružėlių;6642790962;Ne;4;2;4;10
13197;Viltenė;Boružėlių;9572407405;Ne;7;2;2;11
13198;Viltenė;Boružėlių;3738838707;Ne;0;2;0;2
13199;Viltenė;Boružėlių;8473588098;Ne;3;7;0;10
13200;Viltenė;Boružėlių;1399653129;Ne;0;2;0;2
13201;Viltenė;Boružėlių;7526555727;Ne;0;13;0;13
13202;Viltenė;Boružėlių;1936628249;Ne;0;1;1;2
13203;Viltenė;Boružėlių;7912396297;Ne;0;8;0;8
13204;Viltenė;Boružėlių;4036109404;Ne;4;2;4;10
13205;Viltenė;Boružėlių;4604298036;Ne;0;7;0;7
13206;Viltenė;Boružėlių;9197007374;Ne;0;2;0;2
13207;Viltenė;Boružėlių;9242034622;Ne;0;3;0;3
13208;Viltenė;Boružėlių;6621273812;Ne;0;3;0;3
13209;Viltenė;Boružėlių;1496943250;Ne;3;0;2;5
13210;Viltenė;Boružėlių;7010024061;Ne;3;6;0;9
13211;Viltenė;Boružėlių;8527270437;Ne;0;3;0;3
13212;Viltenė;Boružėlių;3052677157;Ne;0;3;0;3
13213;Viltenė;Boružėlių;6293879765;Ne;2;0;2;4
13214;Viltenė;Boružėlių;5077189153;Ne;0;2;0;2
13215;Viltenė;Gandriukų;6481491422;Ne;4;1;5;10
13216;Viltenė;Gandriukų;2452782594;Ne;0;2;0;2
13217;Viltenė;Gandriukų;1126409020;Ne;0;1;0;1
13218;Viltenė;Gandriukų;2884698447;Ne;0;3;1;4
13219;Viltenė;Gandriukų;6060648988;Ne;5;2;2;9
13220;Viltenė;Gandriukų;1840626621;Ne;3;3;0;6
13221;Viltenė;Gandriukų;8549631247;Ne;0;3;0;3
13222;Viltenė;Gandriukų;7796422726;Ne;3;2;2;7
13223;Viltenė;Gandriukų;2815105107;Ne;2;0;2;4
13224;Viltenė;Gandriukų;6511850468;Ne;2;3;2;7
13225;Viltenė;Gandriukų;4945108189;Ne;0;10;0;10
13226;Viltenė;Gandriukų;5850652322;Ne;5;2;2;9
13227;Viltenė;Gandriukų;8110413064;Ne;0;4;0;4
13228;Viltenė;Gandriukų;1243595112;Ne;0;4;0;4
13229;Viltenė;Gandriukų;3073228245;Ne;12;2;4;18
13230;Viltenė;Gandriukų;4468743044;Ne;0;1;2;3
13231;Viltenė;Gandriukų;6355857716;Ne;9;2;5;16
13232;Viltenė;Gandriukų;6473925760;Ne;3;1;2;6
13233;Viltenė;Gandriukų;8458769051;Ne;0;4;0;4
13234;Viltenė;Aitvariukai;2137929911;Ne;0;9;0;9
13235;Viltenė;Aitvariukai;9185054066;Ne;4;3;2;9
13236;Viltenė;Aitvariukai;2036902795;Ne;0;3;0;3
13237;Viltenė;Aitvariukai;5599943846;Ne;0;2;0;2
13238;Viltenė;Aitvariukai;6721689684;Ne;0;10;0;10
13239;Viltenė;Aitvariukai;6296509460;Ne;0;5;0;5
13240;Viltenė;Aitvariukai;9101795131;Ne;0;2;0;2
13241;Viltenė;Aitvariukai;3908574248;Ne;2;1;2;5
13242;Viltenė;Aitvariukai;8439859449;Ne;0;2;0;2
13243;Viltenė;Aitvariukai;2976705872;Ne;0;2;0;2
13244;Viltenė;Aitvariukai;2192086488;Ne;0;5;0;5
13245;Viltenė;Aitvariukai;2026654467;Ne;1;7;0;8
13246;Viltenė;Aitvariukai;4641365031;Ne;0;6;0;6
13247;Viltenė;Aitvariukai;7277455268;Ne;0;8;0;8
13248;Viltenė;Aitvariukai;3245284852;Ne;2;0;2;4
13249;Viltenė;Aitvariukai;2786572522;Ne;0;7;0;7
13250;Viltenė;Aitvariukai;1267187553;Ne;3;0;2;5
13251;Viltenė;Geniukų;3157417614;Ne;5;2;2;9
13252;Viltenė;Geniukų;2903596382;Ne;3;7;0;10
13253;Viltenė;Geniukų;7145240197;Ne;3;0;2;5
13254;Viltenė;Geniukų;7058586628;Ne;8;8;0;16
13255;Viltenė;Geniukų;7005219570;Ne;5;2;3;10
13256;Viltenė;Geniukų;4552355700;Ne;0;2;0;2
13257;Viltenė;Geniukų;8278572246;Ne;1;2;2;5
13258;Viltenė;Geniukų;1587868835;Ne;1;2;4;7
13259;Viltenė;Geniukų;2850146424;Ne;0;0;3;3
13260;Viltenė;Geniukų;3306285115;Ne;3;0;2;5
13261;Viltenė;Geniukų;9288406881;Ne;1;2;2;5
13262;Viltenė;Geniukų;6992120038;Ne;0;5;0;5
13263;Viltenė;Geniukų;4981225829;Ne;0;8;0;8
13264;Viltenė;Geniukų;3853518656;Ne;3;1;2;6
13265;Viltenė;Geniukų;5707049797;Ne;6;0;4;10
13266;Viltenė;Geniukų;2036857372;Ne;1;0;2;3
13267;Viltenė;Geniukų;9424773418;Ne;0;2;0;2
13268;Viltenė;Saulutės;8091905944;Ne;1;3;0;4
13269;Viltenė;Saulutės;5974408492;Ne;6;4;2;12
13270;Viltenė;Saulutės;1641406030;Taip;0;1;0;1
13271;Viltenė;Saulutės;4615393852;Ne;0;3;0;3
13272;Viltenė;Saulutės;9760364123;Ne;0;1;0;1
13273;Viltenė;Saulutės;9578037239;Ne;4;2;2;8
13274;Viltenė;Saulutės;1760899500;Ne;1;0;2;3
13275;Viltenė;Saulutės;3347380524;Ne;0;1;0;1
13276;Viltenė;Saulutės;2846574130;Ne;0;2;0;2
13277;Viltenė;Saulutės;2656363650;Ne;0;1;0;1
13278;Viltenė;Saulutės;4724382069;Ne;0;1;0;1
13279;Viltenė;Saulutės;2841144656;Ne;0;2;0;2
13280;Viltenė;Saulutės;8141954391;Ne;1;0;2;3
13281;Viltenė;Saulutės;4379784712;Ne;0;0;2;2
13282;Viltenė;Saulutės;7810374329;Ne;0;5;0;5
13283;Viltenė;Saulutės;9095458948;Ne;6;0;2;8
13284;Viltenė;Saulutės;4661430937;Ne;8;3;0;11
13285;Viltenė;Saulutės;8588903828;Ne;0;1;0;1
13286;Viltenė;Saulutės;6595715908;Ne;3;0;2;5
13287;Viltenė;Lapiukų;2034259692;Ne;6;5;0;11
13288;Viltenė;Lapiukų;3473533533;Ne;0;4;0;4
13289;Viltenė;Lapiukų;8696698257;Ne;3;2;2;7
13290;Viltenė;Lapiukų;8248514570;Ne;2;5;0;7
13291;Viltenė;Lapiukų;2878124826;Taip;1;2;2;5
13292;Viltenė;Lapiukų;2660622296;Ne;4;2;2;8
13293;Viltenė;Lapiukų;8122878153;Ne;3;2;2;7
13294;Viltenė;Lapiukų;9573891616;Ne;0;5;0;5
13295;Viltenė;Lapiukų;4243501722;Ne;2;2;2;6
13296;Viltenė;Lapiukų;6429905246;Ne;1;2;2;5
13297;Viltenė;Lapiukų;6070264006;Ne;0;4;0;4
13298;Viltenė;Lapiukų;8187712849;Ne;0;1;0;1
13299;Viltenė;Lapiukų;3679704404;Ne;0;1;0;1
13300;Viltenė;Lapiukų;1507287948;Taip;0;1;0;1
13301;Viltenė;Lapiukų;9846205631;Ne;0;3;0;3
13302;Viltenė;Lapiukų;9063994291;Ne;0;1;0;1
13303;Viltenė;Lapiukų;1964849653;Ne;11;2;5;18
13304;Viltenė;Voveriukai;6888346135;Ne;7;8;0;15
13305;Viltenė;Voveriukai;2936670828;Ne;0;1;1;2
13306;Viltenė;Voveriukai;5816623708;Ne;0;21;0;21
13307;Viltenė;Voveriukai;5611839058;Ne;0;3;0;3
13308;Viltenė;Voveriukai;4414192600;Ne;11;3;4;18
13309;Viltenė;Voveriukai;2483760198;Ne;0;3;0;3
13310;Viltenė;Voveriukai;8341211836;Ne;0;2;0;2
13311;Viltenė;Voveriukai;6954065006;Ne;0;2;0;2
13312;Viltenė;Voveriukai;6741521720;Ne;6;7;0;13
13313;Viltenė;Voveriukai;2642080849;Ne;0;2;0;2
13314;Viltenė;Voveriukai;6040634853;Ne;0;2;0;2
13315;Viltenė;Voveriukai;7322841332;Ne;4;3;3;10
13316;Viltenė;Voveriukai;1888167096;Ne;0;3;1;4
13317;Viltenė;Voveriukai;3291926243;Ne;3;10;0;13
13318;Viltenė;Voveriukai;2013415571;Ne;0;8;0;8
13319;Viltenė;Voveriukai;2894570917;Taip;0;6;0;6
13320;Viltenė;Voveriukai;1890096287;Ne;1;2;4;7
13321;Viltenė;Kiškučiai;7314937470;Ne;3;5;0;8
13322;Viltenė;Kiškučiai;8150583354;Ne;2;0;6;8
13323;Viltenė;Kiškučiai;9862698928;Ne;5;0;4;9
13324;Viltenė;Kiškučiai;3996210451;Ne;0;1;0;1
13325;Viltenė;Kiškučiai;7273826810;Ne;13;0;2;15
13326;Viltenė;Kiškučiai;1512772072;Ne;5;0;2;7
13327;Viltenė;Kiškučiai;4970273010;Ne;5;0;5;10
13328;Viltenė;Kiškučiai;6971198297;Ne;7;2;4;13
13329;Viltenė;Kiškučiai;3719039209;Ne;0;2;0;2
13330;Viltenė;Kiškučiai;5633115904;Ne;6;2;2;10
13331;Viltenė;Kiškučiai;2413392645;Ne;0;0;2;2
13332;Viltenė;Kiškučiai;7948249597;Ne;3;0;5;8
13333;Viltenė;Kiškučiai;3501209955;Ne;1;2;3;6
13334;Viltenė;Kiškučiai;1828982237;Ne;5;2;2;9
13335;Viltenė;Kiškučiai;5575163907;Ne;10;0;4;14
13336;Viltenė;Nykštukų;9263941853;Ne;4;7;0;11
13337;Viltenė;Nykštukų;9308502487;Ne;15;0;2;17
13338;Viltenė;Nykštukų;3331402933;Ne;4;0;4;8
13339;Viltenė;Nykštukų;6715408809;Ne;11;0;5;16
13340;Viltenė;Nykštukų;7957033437;Ne;0;6;0;6
13341;Viltenė;Nykštukų;8423445808;Ne;7;0;3;10
13342;Viltenė;Nykštukų;4692894136;Ne;10;0;4;14
13343;Viltenė;Nykštukų;2675172000;Ne;3;1;2;6
13344;Viltenė;Nykštukų;7950534618;Ne;8;3;0;11
13345;Viltenė;Nykštukų;7281994705;Taip;2;0;2;4
13346;Viltenė;Nykštukų;9962055404;Ne;2;0;2;4
13347;Viltenė;Nykštukų;9803655268;Ne;0;0;1;1
13348;Viltenė;Nykštukų;6805422614;Ne;7;0;4;11
13349;Viltenė;Nykštukų;2549050819;Ne;1;1;5;7
13350;Viltenė;Triušiukai;1788524515;Ne;0;8;0;8
13351;Viltenė;Triušiukai;5741994085;Ne;0;2;0;2
13352;Viltenė;Triušiukai;2720563160;Ne;0;6;0;6
13353;Viltenė;Triušiukai;9211978362;Ne;1;2;3;6
13354;Viltenė;Triušiukai;3007260551;Ne;3;1;2;6
13355;Viltenė;Triušiukai;1324341385;Ne;4;0;2;6
13356;Viltenė;Triušiukai;5083086443;Ne;1;0;2;3
13357;Viltenė;Triušiukai;9643964097;Taip;0;1;0;1
13358;Viltenė;Triušiukai;9163535422;Ne;0;1;3;4
13359;Viltenė;Triušiukai;1280744308;Ne;0;3;0;3
13360;Viltenė;Triušiukai;8517635316;Ne;0;1;3;4
13361;Viltenė;Triušiukai;2077492267;Ne;2;0;5;7
13362;Voveraitė;ŽVIRBLIUKŲ;6684234832;Ne;0;2;4;6
13363;Voveraitė;ŽVIRBLIUKŲ;8119493388;Ne;0;3;5;8
13364;Voveraitė;ŽVIRBLIUKŲ;9715405072;Ne;0;2;0;2
13365;Voveraitė;ŽVIRBLIUKŲ;5804351872;Ne;0;2;2;4
13366;Voveraitė;ŽVIRBLIUKŲ;8925151080;Ne;0;2;0;2
13367;Voveraitė;ŽVIRBLIUKŲ;5510544648;Ne;0;1;6;7
13368;Voveraitė;ŽVIRBLIUKŲ;6959751328;Ne;0;1;1;2
13369;Voveraitė;ŽVIRBLIUKŲ;8803052781;Ne;0;7;0;7
13370;Voveraitė;ŽVIRBLIUKŲ;8257748589;Ne;0;2;2;4
13371;Voveraitė;ŽVIRBLIUKŲ;1522307865;Ne;0;2;2;4
13372;Voveraitė;ŽVIRBLIUKŲ;3811230983;Ne;0;2;12;14
13373;Voveraitė;ŽVIRBLIUKŲ;2142507659;Ne;3;1;4;8
13374;Voveraitė;ŽVIRBLIUKŲ;3247101840;Ne;0;2;10;12
13375;Voveraitė;ŽVIRBLIUKŲ;6643600680;Ne;0;2;1;3
13376;Voveraitė;ŽVIRBLIUKŲ;4460047281;Ne;0;0;1;1
13377;Voveraitė;ŽVIRBLIUKŲ;3877673172;Ne;3;0;4;7
13378;Voveraitė;ŽVIRBLIUKŲ;7008576999;Ne;0;2;5;7
13379;Voveraitė;ŽVIRBLIUKŲ;2716400502;Ne;0;2;5;7
13380;Voveraitė;ŽVIRBLIUKŲ;6994680282;Ne;0;2;1;3
13381;Voveraitė;ŽVIRBLIUKŲ;5605614222;Ne;0;1;2;3
13382;Voveraitė;ŽVIRBLIUKŲ;7248705010;Ne;0;2;16;18
13383;Voveraitė;VOVERIUKŲ;5104290434;Ne;3;2;4;9
13384;Voveraitė;VOVERIUKŲ;3883413387;Ne;10;0;2;12
13385;Voveraitė;VOVERIUKŲ;6762558038;Ne;5;0;4;9
13386;Voveraitė;VOVERIUKŲ;2317744694;Ne;6;0;3;9
13387;Voveraitė;VOVERIUKŲ;5484809515;Ne;0;2;0;2
13388;Voveraitė;VOVERIUKŲ;7047943041;Ne;9;1;4;14
13389;Voveraitė;VOVERIUKŲ;9350363241;Ne;5;0;3;8
13390;Voveraitė;VOVERIUKŲ;1177010991;Ne;0;0;2;2
13391;Voveraitė;VOVERIUKŲ;1003244190;Ne;1;7;2;10
13392;Voveraitė;VOVERIUKŲ;1805322222;Ne;7;0;4;11
13393;Voveraitė;VOVERIUKŲ;6179702518;Ne;9;0;4;13
13394;Voveraitė;VOVERIUKŲ;6177162728;Ne;8;0;2;10
13395;Voveraitė;VOVERIUKŲ;2035456422;Ne;7;0;2;9
13396;Voveraitė;VOVERIUKŲ;8936261148;Ne;8;0;3;11
13397;Voveraitė;KIŠKUČIŲ;9537862791;Ne;5;5;2;12
13398;Voveraitė;KIŠKUČIŲ;4478984171;Ne;0;2;0;2
13399;Voveraitė;KIŠKUČIŲ;3736638759;Ne;3;2;2;7
13400;Voveraitė;KIŠKUČIŲ;9011096222;Ne;0;2;0;2
13401;Voveraitė;KIŠKUČIŲ;3058377539;Ne;1;2;2;5
13402;Voveraitė;KIŠKUČIŲ;8084986328;Ne;2;0;2;4
13403;Voveraitė;KIŠKUČIŲ;6261152304;Ne;0;4;0;4
13404;Voveraitė;KIŠKUČIŲ;8220437514;Ne;0;3;0;3
13405;Voveraitė;KIŠKUČIŲ;4060906360;Ne;0;3;0;3
13406;Voveraitė;KIŠKUČIŲ;5069929376;Ne;3;1;2;6
13407;Voveraitė;KIŠKUČIŲ;7379045686;Ne;0;2;2;4
13408;Voveraitė;KIŠKUČIŲ;1961699588;Ne;9;2;2;13
13409;Voveraitė;KIŠKUČIŲ;1979839656;Ne;0;2;0;2
13410;Voveraitė;KIŠKUČIŲ;8121423914;Ne;0;2;0;2
13411;Voveraitė;KIŠKUČIŲ;1322927329;Ne;0;0;2;2
13412;Voveraitė;KIŠKUČIŲ;8528435385;Ne;2;2;4;8
13413;Voveraitė;KIŠKUČIŲ;8937070276;Ne;2;1;0;3
13414;Voveraitė;KIŠKUČIŲ;3859125174;Ne;5;0;2;7
13415;Voveraitė;KIŠKUČIŲ;4234600509;Ne;5;3;2;10
13416;Voveraitė;KODĖLČIUKŲ;7868415893;Ne;1;0;2;3
13417;Voveraitė;KODĖLČIUKŲ;3274422598;Ne;3;8;0;11
13418;Voveraitė;KODĖLČIUKŲ;8438808999;Ne;2;2;3;7
13419;Voveraitė;KODĖLČIUKŲ;8818603905;Ne;0;22;0;22
13420;Voveraitė;KODĖLČIUKŲ;9397887760;Ne;1;2;2;5
13421;Voveraitė;KODĖLČIUKŲ;4151144278;Ne;6;1;2;9
13422;Voveraitė;KODĖLČIUKŲ;1482908802;Ne;4;0;3;7
13423;Voveraitė;KODĖLČIUKŲ;9887747925;Ne;8;2;2;12
13424;Voveraitė;KODĖLČIUKŲ;7605427741;Ne;4;5;2;11
13425;Voveraitė;KODĖLČIUKŲ;3432886020;Ne;0;4;0;4
13426;Voveraitė;KODĖLČIUKŲ;8154347030;Ne;1;3;2;6
13427;Voveraitė;KODĖLČIUKŲ;2482908027;Ne;2;8;2;12
13428;Voveraitė;KODĖLČIUKŲ;8692155848;Ne;0;0;2;2
13429;Voveraitė;KODĖLČIUKŲ;1040007977;Ne;4;1;2;7
13430;Voveraitė;KODĖLČIUKŲ;3881039538;Ne;3;0;2;5
13431;Voveraitė;KODĖLČIUKŲ;7281753415;Ne;3;0;2;5
13432;Voveraitė;KODĖLČIUKŲ;8021563060;Ne;3;4;2;9
13433;Voveraitė;KODĖLČIUKŲ;9816971493;Ne;0;4;0;4
13434;Voveraitė;MEŠKIUKŲ;7253112849;Ne;3;7;2;12
13435;Voveraitė;MEŠKIUKŲ;7499150201;Ne;0;9;0;9
13436;Voveraitė;MEŠKIUKŲ;3217609712;Ne;0;5;0;5
13437;Voveraitė;MEŠKIUKŲ;3088866739;Ne;3;2;2;7
13438;Voveraitė;MEŠKIUKŲ;4207949414;Ne;0;4;0;4
13439;Voveraitė;MEŠKIUKŲ;7474214701;Ne;0;3;0;3
13440;Voveraitė;MEŠKIUKŲ;9729735431;Ne;2;0;0;2
13441;Voveraitė;MEŠKIUKŲ;6853358062;Ne;2;0;0;2
13442;Voveraitė;MEŠKIUKŲ;3539069705;Ne;4;0;2;6
13443;Voveraitė;MEŠKIUKŲ;6609235703;Taip;3;7;2;12
13444;Voveraitė;MEŠKIUKŲ;1528968162;Taip;15;0;2;17
13445;Voveraitė;MEŠKIUKŲ;3159659638;Ne;2;1;0;3
13446;Voveraitė;MEŠKIUKŲ;3532178114;Ne;2;1;0;3
13447;Voveraitė;MEŠKIUKŲ;8534405352;Ne;1;0;2;3
13448;Voveraitė;MEŠKIUKŲ;5018335921;Ne;22;0;0;22
13449;Voveraitė;MEŠKIUKŲ;6579193196;Ne;0;2;1;3
13450;Voveraitė;MEŠKIUKŲ;8940421826;Ne;6;0;2;8
13451;Voveraitė;MEŠKIUKŲ;9332936763;Ne;7;1;2;10
13452;Voveraitė;MEŠKIUKŲ;6206817227;Ne;3;0;2;5
13453;Voveraitė;BORUŽĖLIŲ;7969862374;Ne;1;1;2;4
13454;Voveraitė;BORUŽĖLIŲ;4233627593;Ne;12;0;2;14
13455;Voveraitė;BORUŽĖLIŲ;2446269570;Ne;1;0;2;3
13456;Voveraitė;BORUŽĖLIŲ;1542869765;Ne;0;13;0;13
13457;Voveraitė;BORUŽĖLIŲ;3408126903;Ne;5;1;2;8
13458;Voveraitė;BORUŽĖLIŲ;8675606844;Ne;2;1;2;5
13459;Voveraitė;BORUŽĖLIŲ;8627692360;Ne;11;0;2;13
13460;Voveraitė;BORUŽĖLIŲ;3168493145;Ne;3;0;4;7
13461;Voveraitė;BORUŽĖLIŲ;7776716092;Ne;8;1;3;12
13462;Voveraitė;BORUŽĖLIŲ;8693704363;Ne;15;0;2;17
13463;Voveraitė;BORUŽĖLIŲ;7718303218;Ne;2;0;0;2
13464;Voveraitė;BORUŽĖLIŲ;9218074631;Taip;4;0;4;8
13465;Voveraitė;BORUŽĖLIŲ;6443288864;Ne;0;4;0;4
13466;Voveraitė;BORUŽĖLIŲ;2552772063;Ne;0;2;2;4
13467;Voveraitė;BORUŽĖLIŲ;1921260351;Ne;1;0;2;3
13468;Voveraitė;BORUŽĖLIŲ;8695525951;Ne;5;0;2;7
13469;Voveraitė;BORUŽĖLIŲ;6650343917;Ne;0;5;0;5
13470;Voveraitė;BORUŽĖLIŲ;3452040361;Ne;7;0;2;9
13471;Voveraitė;BORUŽĖLIŲ;8451803815;Ne;8;2;2;12
13472;Voveraitė;BORUŽĖLIŲ;8382950248;Ne;2;0;4;6
13473;Voveraitė;PELĖDŽIUKŲ;7984755636;Ne;7;0;2;9
13474;Voveraitė;PELĖDŽIUKŲ;8705616608;Ne;6;0;2;8
13475;Voveraitė;PELĖDŽIUKŲ;2028714618;Ne;9;0;4;13
13476;Voveraitė;PELĖDŽIUKŲ;5415791380;Ne;2;0;2;4
13477;Voveraitė;PELĖDŽIUKŲ;2915226148;Ne;3;8;2;13
13478;Voveraitė;PELĖDŽIUKŲ;1971097565;Ne;3;0;2;5
13479;Voveraitė;PELĖDŽIUKŲ;2724402352;Ne;10;0;4;14
13480;Voveraitė;PELĖDŽIUKŲ;1063298119;Ne;8;2;3;13
13481;Voveraitė;PELĖDŽIUKŲ;1877131292;Ne;4;0;2;6
13482;Voveraitė;PELĖDŽIUKŲ;6666893294;Ne;11;0;3;14
13483;Voveraitė;PELĖDŽIUKŲ;5918809105;Ne;3;0;3;6
13484;Voveraitė;PELĖDŽIUKŲ;9130691819;Ne;11;2;4;17
13485;Voveraitė;PELĖDŽIUKŲ;3729924233;Ne;4;0;2;6
13486;Voveraitė;PELĖDŽIUKŲ;8126894347;Ne;12;0;4;16
13487;Voveraitė;PELĖDŽIUKŲ;3279671808;Ne;2;0;2;4
13488;Voveraitė;PELĖDŽIUKŲ;2761041681;Ne;17;0;2;19
13489;Voveraitė;DRUGELIŲ;1441921029;Ne;0;2;0;2
13490;Voveraitė;DRUGELIŲ;7531020548;Ne;3;3;2;8
13491;Voveraitė;DRUGELIŲ;4300235743;Ne;7;0;2;9
13492;Voveraitė;DRUGELIŲ;3388547792;Ne;0;2;0;2
13493;Voveraitė;DRUGELIŲ;8719547570;Ne;0;0;1;1
13494;Voveraitė;DRUGELIŲ;3475601049;Ne;0;7;0;7
13495;Voveraitė;DRUGELIŲ;4017408873;Ne;12;0;0;12
13496;Voveraitė;DRUGELIŲ;1550830434;Ne;0;5;1;6
13497;Voveraitė;DRUGELIŲ;5114768009;Ne;1;0;2;3
13498;Voveraitė;DRUGELIŲ;1045204378;Ne;2;0;0;2
13499;Voveraitė;DRUGELIŲ;4605007814;Ne;4;0;4;8
13500;Voveraitė;DRUGELIŲ;4911291891;Ne;8;3;4;15
13501;Voveraitė;DRUGELIŲ;4782336282;Ne;0;3;0;3
13502;Voveraitė;DRUGELIŲ;6415024059;Taip;2;1;0;3
13503;Voveraitė;DRUGELIŲ;4350450125;Ne;0;4;9;13
13504;Voveraitė;DRUGELIŲ;8913940646;Ne;0;2;3;5
13505;Voveraitė;DRUGELIŲ;1201270622;Ne;3;0;2;5
13506;Voveraitė;DRUGELIŲ;7238482039;Ne;7;0;2;9
13507;Voveraitė;DRUGELIŲ;4961315260;Ne;2;4;3;9
13508;Voveraitė;DRUGELIŲ;8939638368;Ne;2;4;3;9
13509;Voveraitė;NYKŠTUKŲ;8206634977;Ne;4;2;4;10
13510;Voveraitė;NYKŠTUKŲ;3068683904;Ne;4;1;3;8
13511;Voveraitė;NYKŠTUKŲ;1294012085;Ne;0;6;0;6
13512;Voveraitė;NYKŠTUKŲ;9363490578;Ne;3;2;2;7
13513;Voveraitė;NYKŠTUKŲ;8217771158;Ne;0;4;0;4
13514;Voveraitė;NYKŠTUKŲ;3409709168;Ne;0;2;3;5
13515;Voveraitė;NYKŠTUKŲ;1045121363;Ne;0;7;0;7
13516;Voveraitė;NYKŠTUKŲ;4319786615;Ne;0;4;0;4
13517;Voveraitė;NYKŠTUKŲ;1384430452;Ne;0;0;8;8
13518;Voveraitė;NYKŠTUKŲ;6648733729;Ne;6;3;4;13
13519;Voveraitė;NYKŠTUKŲ;2801245150;Ne;2;0;4;6
13520;Voveraitė;NYKŠTUKŲ;2839442228;Ne;0;0;4;4
13521;Voveraitė;NYKŠTUKŲ;5887384991;Ne;1;0;5;6
13522;Voveraitė;NYKŠTUKŲ;1647496426;Ne;0;0;1;1
13523;Voveraitė;NYKŠTUKŲ;3627796093;Ne;2;6;4;12
13524;Voveraitė;NYKŠTUKŲ;4329107736;Ne;2;0;2;4
13525;Voveraitė;GENIUKŲ;8697761112;Ne;2;2;2;6
13526;Voveraitė;GENIUKŲ;6007396459;Ne;3;2;2;7
13527;Voveraitė;GENIUKŲ;9514425475;Ne;0;5;0;5
13528;Voveraitė;GENIUKŲ;1663784931;Ne;0;8;0;8
13529;Voveraitė;GENIUKŲ;8373093305;Ne;0;2;1;3
13530;Voveraitė;GENIUKŲ;4054841724;Ne;7;3;4;14
13531;Voveraitė;GENIUKŲ;4563198733;Ne;0;4;2;6
13532;Voveraitė;GENIUKŲ;1141304286;Ne;0;2;0;2
13533;Voveraitė;GENIUKŲ;3276295199;Ne;0;5;0;5
13534;Voveraitė;GENIUKŲ;6891841301;Ne;0;2;0;2
13535;Voveraitė;GENIUKŲ;6017698476;Ne;0;2;0;2
13536;Voveraitė;GENIUKŲ;8344323109;Ne;0;1;0;1
13537;Voveraitė;GENIUKŲ;2594535017;Ne;0;2;0;2
13538;Voveraitė;GENIUKŲ;5956830012;Ne;3;2;2;7
13539;Voveraitė;GENIUKŲ;1960385335;Ne;3;3;2;8
13540;Voveraitė;GENIUKŲ;9912862474;Ne;0;4;2;6
13541;Voveraitė;GENIUKŲ;1340379090;Ne;3;2;2;7
13542;Voveraitė;GENIUKŲ;5935777154;Ne;0;0;2;2
13543;Voveraitė;GENIUKŲ;5138855000;Ne;0;2;1;3
13544;Voveraitė;GENIUKŲ;6113913885;Ne;0;4;1;5
13545;Voveraitė;GENIUKŲ;9195700962;Ne;8;9;2;19
13546;Voveraitė;GENIUKŲ;1515087924;Ne;1;2;2;5
13547;Voveraitė;LAPIUKŲ;8405238812;Ne;1;2;2;5
13548;Voveraitė;LAPIUKŲ;8152541593;Ne;7;0;3;10
13549;Voveraitė;LAPIUKŲ;9327593792;Ne;8;2;2;12
13550;Voveraitė;LAPIUKŲ;4139239328;Ne;8;2;2;12
13551;Voveraitė;LAPIUKŲ;2587660082;Ne;3;6;3;12
13552;Voveraitė;LAPIUKŲ;4689191326;Ne;12;0;0;12
13553;Voveraitė;LAPIUKŲ;7131189895;Ne;6;0;2;8
13554;Voveraitė;LAPIUKŲ;6766131083;Ne;8;7;7;22
13555;Voveraitė;LAPIUKŲ;4760054428;Ne;8;0;4;12
13556;Voveraitė;LAPIUKŲ;4848321265;Ne;22;0;0;22
13557;Voveraitė;LAPIUKŲ;3419973673;Ne;7;0;2;9
13558;Voveraitė;LAPIUKŲ;4402971359;Ne;3;0;2;5
13559;Voveraitė;LAPIUKŲ;3955549715;Ne;5;0;4;9
13560;Voveraitė;LAPIUKŲ;9219176927;Ne;0;1;4;5
13561;Voveraitė;LAPIUKŲ;8382465808;Ne;6;0;3;9
13562;Voveraitė;EŽIUKŲ;5420123208;Ne;13;2;2;17
13563;Voveraitė;EŽIUKŲ;1692829228;Ne;3;14;2;19
13564;Voveraitė;EŽIUKŲ;8074808131;Ne;2;0;1;3
13565;Voveraitė;EŽIUKŲ;8229145014;Ne;4;0;5;9
13566;Voveraitė;EŽIUKŲ;2755043670;Ne;0;8;0;8
13567;Voveraitė;EŽIUKŲ;6481289149;Ne;0;2;0;2
13568;Voveraitė;EŽIUKŲ;6917511246;Ne;8;0;3;11
13569;Voveraitė;EŽIUKŲ;7227349394;Ne;8;0;4;12
13570;Voveraitė;EŽIUKŲ;9624353633;Ne;0;2;3;5
13571;Voveraitė;EŽIUKŲ;8663564002;Ne;10;0;4;14
13572;Voveraitė;EŽIUKŲ;3598956934;Ne;0;17;0;17
13573;Voveraitė;EŽIUKŲ;8465757758;Ne;1;0;4;5
13574;Voveraitė;EŽIUKŲ;5439761018;Ne;0;0;2;2
13575;Voveraitė;EŽIUKŲ;2064720751;Ne;0;5;0;5
13576;Voveraitė;EŽIUKŲ;4913232575;Ne;10;4;2;16
13577;Voveraitė;EŽIUKŲ;9859868228;Ne;0;7;0;7
13578;"Trakų Vokė";Voveriukų;1252962923;Ne;10;2;2;14
13579;"Trakų Vokė";Voveriukų;2163756512;Ne;3;1;2;6
13580;"Trakų Vokė";Voveriukų;2318712376;Ne;5;4;2;11
13581;"Trakų Vokė";Voveriukų;9140597911;Ne;5;0;7;12
13582;"Trakų Vokė";Voveriukų;5741852704;Ne;18;0;2;20
13583;"Trakų Vokė";Voveriukų;8636196544;Ne;3;2;2;7
13584;"Trakų Vokė";Voveriukų;4516714702;Ne;11;2;3;16
13585;"Trakų Vokė";Voveriukų;3445611475;Ne;7;1;4;12
13586;"Trakų Vokė";Voveriukų;3422308444;Ne;6;4;2;12
13587;"Trakų Vokė";Voveriukų;6076083379;Ne;3;1;2;6
13588;"Trakų Vokė";Voveriukų;5626732539;Ne;2;10;2;14
13589;"Trakų Vokė";Voveriukų;7706665420;Ne;3;1;2;6
13590;"Trakų Vokė";Voveriukų;7656305410;Ne;0;9;0;9
13591;"Trakų Vokė";Voveriukų;7346128036;Ne;1;1;2;4
13592;"Trakų Vokė";Voveriukų;2812442474;Ne;6;0;2;8
13593;"Trakų Vokė";Voveriukų;7671121106;Ne;6;11;2;19
13594;"Trakų Vokė";Voveriukų;7797516793;Ne;12;2;2;16
13595;"Trakų Vokė";Voveriukų;2077669020;Ne;14;2;2;18
13596;"Trakų Vokė";Voveriukų;8938061997;Ne;2;0;1;3
13597;"Trakų Vokė";Voveriukų;1946140073;Ne;8;0;6;14
13598;"Trakų Vokė";Voveriukų;6494156059;Ne;6;6;2;14
13599;"Trakų Vokė";Voveriukų;6247495021;Ne;9;6;4;19
13600;"Trakų Vokė";Voveriukų;3471649998;Ne;20;0;2;22
13601;"Trakų Vokė";Boružėlių;6550998156;Ne;5;0;4;9
13602;"Trakų Vokė";Boružėlių;7705116536;Ne;5;0;2;7
13603;"Trakų Vokė";Boružėlių;4300812649;Ne;4;1;4;9
13604;"Trakų Vokė";Boružėlių;6495211591;Ne;12;2;4;18
13605;"Trakų Vokė";Boružėlių;2141759752;Ne;0;0;3;3
13606;"Trakų Vokė";Boružėlių;4621824988;Ne;15;0;2;17
13607;"Trakų Vokė";Boružėlių;7122970239;Ne;6;0;4;10
13608;"Trakų Vokė";Boružėlių;2287132096;Ne;0;2;3;5
13609;"Trakų Vokė";Boružėlių;1798327247;Ne;7;0;2;9
13610;"Trakų Vokė";Boružėlių;6004005405;Ne;8;4;2;14
13611;"Trakų Vokė";Boružėlių;3930137078;Ne;0;1;0;1
13612;"Trakų Vokė";Boružėlių;1515075178;Ne;5;0;5;10
13613;"Trakų Vokė";Boružėlių;4377392002;Ne;0;4;0;4
13614;"Trakų Vokė";Boružėlių;3733223248;Ne;3;0;3;6
13615;"Trakų Vokė";Boružėlių;7778039165;Ne;7;1;3;11
13616;"Trakų Vokė";Boružėlių;9334999599;Ne;3;2;2;7
13617;"Trakų Vokė";Boružėlių;7933901042;Ne;2;0;3;5
13618;"Trakų Vokė";Boružėlių;7042434004;Ne;6;0;6;12
13619;"Trakų Vokė";KIŠKUČIŲ;2348524235;Ne;11;0;4;15
13620;"Trakų Vokė";KIŠKUČIŲ;6916284436;Taip;6;2;4;12
13621;"Trakų Vokė";KIŠKUČIŲ;2027461389;Ne;6;0;3;9
13622;"Trakų Vokė";KIŠKUČIŲ;8148859043;Ne;14;0;4;18
13623;"Trakų Vokė";KIŠKUČIŲ;9375730686;Ne;2;0;4;6
13624;"Trakų Vokė";KIŠKUČIŲ;2327739950;Ne;3;4;6;13
13625;"Trakų Vokė";KIŠKUČIŲ;1436135794;Ne;8;0;2;10
13626;"Trakų Vokė";KIŠKUČIŲ;3233117814;Ne;0;2;0;2
13627;"Trakų Vokė";KIŠKUČIŲ;6450573461;Ne;0;0;2;2
13628;"Trakų Vokė";KIŠKUČIŲ;3146611814;Ne;0;2;0;2
13629;"Trakų Vokė";KIŠKUČIŲ;8601290001;Ne;16;0;2;18
13630;"Trakų Vokė";KIŠKUČIŲ;1941250346;Ne;3;3;2;8
13631;"Trakų Vokė";KIŠKUČIŲ;4832898751;Ne;0;2;0;2
13632;"Trakų Vokė";KIŠKUČIŲ;8861279937;Ne;2;0;2;4
13633;"Trakų Vokė";KIŠKUČIŲ;7799307934;Ne;3;0;2;5
13634;"Trakų Vokė";BITUČIŲ;7632198751;Ne;0;2;1;3
13635;"Trakų Vokė";BITUČIŲ;3686108421;Ne;6;0;4;10
13636;"Trakų Vokė";BITUČIŲ;5031669549;Ne;7;2;4;13
13637;"Trakų Vokė";BITUČIŲ;8703806519;Ne;13;1;3;17
13638;"Trakų Vokė";BITUČIŲ;4531294784;Ne;0;1;1;2
13639;"Trakų Vokė";BITUČIŲ;5720994041;Ne;1;1;3;5
13640;"Trakų Vokė";BITUČIŲ;7459132887;Ne;0;1;2;3
13641;"Trakų Vokė";BITUČIŲ;6402002961;Ne;3;2;4;9
13642;"Trakų Vokė";BITUČIŲ;3536227018;Ne;8;1;5;14
13643;"Trakų Vokė";BITUČIŲ;6787506848;Ne;5;6;0;11
13644;"Trakų Vokė";BITUČIŲ;3372734352;Ne;0;1;1;2
13645;"Trakų Vokė";BITUČIŲ;1359519176;Ne;13;1;2;16
13646;"Trakų Vokė";BITUČIŲ;1039317931;Ne;4;0;14;18
13647;"Trakų Vokė";BITUČIŲ;3333979364;Ne;0;1;0;1
13648;"Trakų Vokė";BITUČIŲ;5810595458;Ne;4;1;2;7
13649;"Trakų Vokė";BITUČIŲ;4212617288;Ne;2;2;3;7
13650;"Trakų Vokė";BITUČIŲ;3023545645;Ne;0;3;0;3
13651;"Trakų Vokė";BITUČIŲ;1000323267;Ne;3;2;2;7
13652;"Trakų Vokė";BITUČIŲ;8496627262;Ne;0;0;22;22
13653;"Trakų Vokė";BITUČIŲ;1389577176;Ne;2;0;3;5
13654;Zylutė;Katerok;8749296671;Ne;0;2;2;4
13655;Zylutė;Katerok;4592825972;Ne;2;2;2;6
13656;Zylutė;Katerok;8747721198;Ne;7;7;2;16
13657;Zylutė;Katerok;8212030518;Ne;0;6;0;6
13658;Zylutė;Katerok;7706833089;Ne;3;5;2;10
13659;Zylutė;Katerok;3115223229;Ne;3;0;2;5
13660;Zylutė;Katerok;5687201052;Ne;9;2;4;15
13661;Zylutė;Katerok;3055559237;Ne;0;2;2;4
13662;Zylutė;Katerok;2792217953;Ne;0;2;0;2
13663;Zylutė;Katerok;5948147748;Ne;2;2;2;6
13664;Zylutė;Katerok;7851423851;Ne;1;3;2;6
13665;Zylutė;Katerok;1164530815;Taip;0;2;1;3
13666;Zylutė;Katerok;1423890598;Ne;4;2;2;8
13667;Zylutė;Katerok;2558354198;Ne;0;6;0;6
13668;Zylutė;Katerok;8268700439;Ne;0;3;4;7
13669;Zylutė;Katerok;4494567155;Ne;0;7;0;7
13670;Zylutė;Katerok;8618778936;Ne;0;1;0;1
13671;Zylutė;"Vesole misiaki";9162232979;Ne;4;2;2;8
13672;Zylutė;"Vesole misiaki";9737308076;Taip;0;7;0;7
13673;Zylutė;"Vesole misiaki";5589330186;Ne;3;12;4;19
13674;Zylutė;"Vesole misiaki";3848401615;Ne;6;2;2;10
13675;Zylutė;"Vesole misiaki";2913504349;Ne;0;6;0;6
13676;Zylutė;"Vesole misiaki";2501761963;Ne;0;2;0;2
13677;Zylutė;"Vesole misiaki";3976277394;Ne;0;7;0;7
13678;Zylutė;"Vesole misiaki";2489898107;Ne;0;7;0;7
13679;Zylutė;"Vesole misiaki";2313423907;Ne;5;6;2;13
13680;Zylutė;"Vesole misiaki";8121814945;Ne;1;2;2;5
13681;Zylutė;"Vesole misiaki";9159342804;Ne;2;2;5;9
13682;Zylutė;"Vesole misiaki";2201317313;Ne;11;0;4;15
13683;Zylutė;"Vesole misiaki";9018673580;Ne;0;1;2;3
13684;Zylutė;"Vesole misiaki";5369354390;Taip;2;2;4;8
13685;Zylutė;"Vesole misiaki";8023418946;Ne;0;2;1;3
13686;Zylutė;"Vesole misiaki";9507157625;Taip;0;1;4;5
13687;Zylutė;"Vesole misiaki";8101232865;Ne;0;2;0;2
13688;Zylutė;"Vesole misiaki";2484025931;Ne;0;8;0;8
13689;Zylutė;NYKŠTUKAI;1169490002;Ne;13;7;2;22
13690;Zylutė;NYKŠTUKAI;3994691080;Ne;8;0;2;10
13691;Zylutė;NYKŠTUKAI;4894611078;Ne;7;0;0;7
13692;Zylutė;NYKŠTUKAI;7648922403;Ne;10;0;2;12
13693;Zylutė;NYKŠTUKAI;2113594059;Ne;22;0;0;22
13694;Zylutė;NYKŠTUKAI;9615779237;Ne;0;3;1;4
13695;Zylutė;NYKŠTUKAI;2604844156;Taip;12;0;3;15
13696;Zylutė;NYKŠTUKAI;2511658462;Ne;8;0;4;12
13697;Zylutė;NYKŠTUKAI;3035745273;Ne;5;1;0;6
13698;Zylutė;NYKŠTUKAI;2620903587;Ne;17;0;5;22
13699;Zylutė;NYKŠTUKAI;4706933533;Ne;7;0;0;7
13700;Zylutė;NYKŠTUKAI;4491529018;Taip;12;0;0;12
13701;Zylutė;NYKŠTUKAI;2745905798;Ne;22;0;0;22
13702;Zylutė;NYKŠTUKAI;5975875502;Ne;4;3;2;9
13703;Zylutė;NYKŠTUKAI;4840138765;Ne;10;0;2;12
13704;Zylutė;NYKŠTUKAI;9221414691;Taip;14;0;0;14
13705;Zylutė;NYKŠTUKAI;7433615959;Ne;7;0;4;11
13706;Zylutė;NYKŠTUKAI;2520744071;Ne;5;0;3;8
13707;Zylutė;NYKŠTUKAI;8033573972;Ne;4;0;3;7
13708;Zylutė;Ručijok;5096881585;Ne;2;5;3;10
13709;Zylutė;Ručijok;9904758615;Ne;3;0;2;5
13710;Zylutė;Ručijok;4874246039;Ne;8;0;2;10
13711;Zylutė;Ručijok;3274885318;Ne;0;0;4;4
13712;Zylutė;Ručijok;6607670962;Ne;0;0;4;4
13713;Zylutė;Ručijok;2769424439;Ne;0;7;0;7
13714;Zylutė;Ručijok;1145229045;Ne;0;3;8;11
13715;Zylutė;Ručijok;3058040516;Ne;0;14;0;14
13716;Zylutė;Ručijok;5038936878;Ne;11;0;2;13
13717;Zylutė;Ručijok;2491905840;Ne;3;0;2;5
13718;Zylutė;Ručijok;5956114459;Ne;0;0;3;3
13719;Zylutė;Ručijok;6276017610;Ne;3;3;2;8
13720;Zylutė;Ručijok;3128535871;Ne;4;2;5;11
13721;Zylutė;Ručijok;6281989117;Ne;0;5;0;5
13722;Zylutė;Ručijok;2505224609;Ne;0;4;9;13
13723;Zylutė;Ručijok;7519900933;Ne;0;0;4;4
13724;Zylutė;Ručijok;3573761619;Ne;9;2;2;13
13725;Zylutė;Ručijok;7742044835;Taip;0;3;0;3
13726;Zylutė;Ručijok;3153857567;Ne;0;0;5;5
13727;Zylutė;Raduga;5573851165;Ne;5;0;4;9
13728;Zylutė;Raduga;2916622808;Ne;16;0;2;18
13729;Zylutė;Raduga;2527003662;Taip;22;0;0;22
13730;Zylutė;Raduga;3977730349;Ne;6;1;3;10
13731;Zylutė;Raduga;7911418657;Ne;6;0;5;11
13732;Zylutė;Raduga;5650984730;Ne;7;0;1;8
13733;Zylutė;Raduga;6422018564;Ne;19;0;2;21
13734;Zylutė;Raduga;5019654510;Ne;19;0;2;21
13735;Zylutė;Raduga;2826889413;Ne;21;0;0;21
13736;Zylutė;Raduga;1935817272;Ne;4;3;0;7
13737;Zylutė;Raduga;9584717697;Ne;11;1;4;16
13738;Zylutė;Raduga;1108316842;Ne;5;0;2;7
13739;Zylutė;Raduga;4801678066;Ne;16;0;2;18
13740;Zylutė;"Miki Maus";7762245887;Taip;8;2;2;12
13741;Zylutė;"Miki Maus";9213491152;Ne;5;0;2;7
13742;Zylutė;"Miki Maus";3928932787;Ne;11;5;2;18
13743;Zylutė;"Miki Maus";4057419108;Ne;2;0;4;6
13744;Zylutė;"Miki Maus";3668160578;Ne;0;12;0;12
13745;Zylutė;"Miki Maus";9093777086;Ne;0;10;0;10
13746;Zylutė;"Miki Maus";7123399601;Ne;3;3;2;8
13747;Zylutė;"Miki Maus";9951774752;Ne;3;2;2;7
13748;Zylutė;"Miki Maus";7625237309;Ne;4;0;2;6
13749;Zylutė;"Miki Maus";8291414891;Ne;4;0;4;8
13750;Zylutė;"Miki Maus";7880958850;Ne;14;0;2;16
13751;Zylutė;"Miki Maus";8230673446;Ne;4;2;2;8
13752;Zylutė;"Miki Maus";6876326785;Ne;4;2;2;8
13753;Zylutė;"Miki Maus";6389666593;Ne;11;0;4;15
13754;Zylutė;"Miki Maus";4798370162;Ne;8;2;2;12
13755;Zylutė;Solnyško;8379932761;Ne;8;1;2;11
13756;Zylutė;Solnyško;5556769710;Ne;6;0;2;8
13757;Zylutė;Solnyško;2088316489;Ne;4;6;4;14
13758;Zylutė;Solnyško;1076803315;Ne;0;1;3;4
13759;Zylutė;Solnyško;7616444695;Ne;5;0;2;7
13760;Zylutė;Solnyško;5234846079;Ne;4;1;2;7
13761;Zylutė;Solnyško;5939522435;Ne;1;6;2;9
13762;Zylutė;Solnyško;3111739911;Ne;1;0;2;3
13763;Zylutė;Solnyško;5826813410;Ne;0;7;0;7
13764;Zylutė;Solnyško;7447067072;Ne;8;2;3;13
13765;Zylutė;Solnyško;1386683435;Ne;3;0;3;6
13766;Zylutė;Solnyško;4669449744;Ne;3;0;2;5
13767;Zylutė;Solnyško;1969578486;Ne;8;0;2;10
13768;Zylutė;Solnyško;6573541087;Ne;8;1;2;11
13769;Zylutė;Solnyško;3656587423;Ne;2;0;2;4
13770;Zylutė;Solnyško;5011947014;Ne;0;3;1;4
13771;Zylutė;Solnyško;4474338590;Ne;3;0;3;6
13772;Zylutė;Solnyško;4474338590;Ne;3;0;3;6
13773;Zylutė;Solnyško;9107676840;Ne;16;2;2;20
13774;Zylutė;Motyliok;7241045507;Ne;6;0;4;10
13775;Zylutė;Motyliok;9913001904;Ne;0;5;0;5
13776;Zylutė;Motyliok;6112586092;Ne;0;13;0;13
13777;Zylutė;Motyliok;8178488164;Ne;10;0;2;12
13778;Zylutė;Motyliok;5045652581;Ne;11;7;2;20
13779;Zylutė;Motyliok;9586800176;Ne;2;0;0;2
13780;Zylutė;Motyliok;4497904128;Ne;0;10;0;10
13781;Zylutė;Motyliok;3355159275;Ne;0;4;0;4
13782;Zylutė;Motyliok;9995791665;Ne;2;0;2;4
13783;Zylutė;Motyliok;1455822427;Ne;3;0;2;5
13784;Zylutė;Motyliok;3455374127;Ne;9;4;2;15
13785;Zylutė;Motyliok;1632490481;Ne;10;5;2;17
13786;Zylutė;Motyliok;1726060015;Ne;7;0;2;9
13787;Zylutė;Motyliok;3084870481;Ne;0;2;0;2
13788;Zylutė;Motyliok;6051657134;Ne;0;4;0;4
13789;Zylutė;Motyliok;3271366684;Ne;0;2;0;2
13790;Zylutė;Motyliok;3633983359;Ne;8;7;2;17
13791;Zylutė;Motyliok;9155513221;Ne;5;0;3;8
13792;Zylutė;Motyliok;8262929231;Ne;5;0;2;7
13793;Zylutė;Motyliok;6601967273;Ne;4;0;2;6
13794;Zylutė;Motyliok;6778361006;Ne;0;0;1;1
13795;Zylutė;ŽVIRBLIUKAI;1319040747;Ne;0;2;7;9
13796;Zylutė;ŽVIRBLIUKAI;8326987895;Ne;4;5;2;11
13797;Zylutė;ŽVIRBLIUKAI;9330583784;Ne;0;2;3;5
13798;Zylutė;ŽVIRBLIUKAI;1220439948;Ne;8;6;2;16
13799;Zylutė;ŽVIRBLIUKAI;4646273830;Ne;2;0;3;5
13800;Zylutė;ŽVIRBLIUKAI;9580188426;Ne;1;0;4;5
13801;Zylutė;ŽVIRBLIUKAI;1797701777;Ne;0;2;0;2
13802;Zylutė;ŽVIRBLIUKAI;2966482773;Ne;6;2;2;10
13803;Zylutė;ŽVIRBLIUKAI;1452384017;Ne;0;2;7;9
13804;Zylutė;ŽVIRBLIUKAI;8152140523;Ne;0;2;3;5
13805;Zylutė;ŽVIRBLIUKAI;8346794629;Ne;0;7;0;7
13806;Zylutė;ŽVIRBLIUKAI;2061747513;Ne;3;4;2;9
13807;Zylutė;ŽVIRBLIUKAI;4611555689;Ne;0;10;0;10
13808;Zylutė;ŽVIRBLIUKAI;3894885445;Ne;0;6;0;6
13809;Zylutė;ŽVIRBLIUKAI;7137348151;Ne;3;3;0;6
13810;Zylutė;ŽVIRBLIUKAI;5942010679;Ne;0;0;7;7
13811;Zylutė;ŽVIRBLIUKAI;5722697679;Ne;3;3;2;8
13812;Zylutė;"DRUŽNYJE REBIATA";5332039406;Ne;0;12;0;12
13813;Zylutė;"DRUŽNYJE REBIATA";9039665233;Ne;7;1;2;10
13814;Zylutė;"DRUŽNYJE REBIATA";6075614020;Ne;3;7;2;12
13815;Zylutė;"DRUŽNYJE REBIATA";9518714240;Ne;3;4;2;9
13816;Zylutė;"DRUŽNYJE REBIATA";2693961315;Taip;3;2;2;7
13817;Zylutė;"DRUŽNYJE REBIATA";3372639449;Ne;0;2;0;2
13818;Zylutė;"DRUŽNYJE REBIATA";4916625058;Ne;7;5;2;14
13819;Zylutė;"DRUŽNYJE REBIATA";3447644735;Ne;0;5;0;5
13820;Zylutė;"DRUŽNYJE REBIATA";3174042441;Ne;0;5;0;5
13821;Zylutė;"DRUŽNYJE REBIATA";6848387941;Ne;8;7;2;17
13822;Zylutė;"DRUŽNYJE REBIATA";1404949829;Ne;1;5;2;8
13823;Zylutė;"DRUŽNYJE REBIATA";4548205666;Ne;0;9;2;11
13824;Zylutė;"DRUŽNYJE REBIATA";6962852787;Ne;0;9;2;11
13825;Zylutė;"DRUŽNYJE REBIATA";9220918504;Ne;0;9;2;11
13826;Zylutė;"DRUŽNYJE REBIATA";9193349264;Ne;8;2;2;12
13827;Zylutė;"DRUŽNYJE REBIATA";8204885376;Ne;0;5;2;7
13828;Zylutė;"DRUŽNYJE REBIATA";9769201088;Ne;3;12;2;17
13829;Zylutė;"DRUŽNYJE REBIATA";5233163416;Ne;0;5;0;5
13830;Zylutė;"DRUŽNYJE REBIATA";5126282685;Ne;4;5;2;11
13831;Zylutė;"DRUŽNYJE REBIATA";8820121776;Ne;0;0;1;1
13832;Zylutė;VIEVERSĖLIAI;9748604675;Ne;2;0;2;4
13833;Zylutė;VIEVERSĖLIAI;9372402025;Taip;3;0;3;6
13834;Zylutė;VIEVERSĖLIAI;6540140502;Ne;2;0;2;4
13835;Zylutė;VIEVERSĖLIAI;5058082347;Ne;3;0;2;5
13836;Zylutė;VIEVERSĖLIAI;6311805184;Ne;6;0;5;11
13837;Zylutė;VIEVERSĖLIAI;7072947464;Ne;2;0;2;4
13838;Zylutė;VIEVERSĖLIAI;3449678598;Ne;2;0;2;4
13839;Zylutė;VIEVERSĖLIAI;1271913393;Ne;4;0;0;4
13840;Zylutė;VIEVERSĖLIAI;4135186333;Ne;0;0;1;1
13841;Zylutė;VIEVERSĖLIAI;1501573278;Ne;11;1;2;14
13842;Zylutė;VIEVERSĖLIAI;3787829836;Ne;1;0;2;3
13843;Zylutė;VIEVERSĖLIAI;5125900173;Ne;3;5;5;13
13844;Zylutė;VIEVERSĖLIAI;7173499688;Ne;8;0;3;11
13845;Zylutė;VIEVERSĖLIAI;5444138006;Ne;5;0;2;7
13846;Zylutė;VIEVERSĖLIAI;4437827048;Ne;6;0;2;8
13847;Želmenėliai;Bitučių;3268310531;Ne;8;3;2;13
13848;Želmenėliai;Bitučių;6799702725;Ne;0;3;2;5
13849;Želmenėliai;Bitučių;8358780570;Ne;0;3;0;3
13850;Želmenėliai;Bitučių;9006406225;Ne;0;5;0;5
13851;Želmenėliai;Bitučių;2102401372;Ne;0;2;0;2
13852;Želmenėliai;Bitučių;4931835807;Ne;0;2;0;2
13853;Želmenėliai;Bitučių;5147895081;Ne;0;2;0;2
13854;Želmenėliai;Bitučių;9611741258;Ne;0;2;0;2
13855;Želmenėliai;Bitučių;1619143702;Ne;9;0;4;13
13856;Želmenėliai;Bitučių;9825545754;Ne;0;4;0;4
13857;Želmenėliai;Bitučių;5314438217;Ne;0;6;0;6
13858;Želmenėliai;Bitučių;4927030144;Ne;8;5;2;15
13859;Želmenėliai;Bitučių;2853659708;Ne;7;4;2;13
13860;Želmenėliai;Bitučių;9207984505;Ne;0;16;0;16
13861;Želmenėliai;Bitučių;8946365627;Ne;2;2;3;7
13862;Želmenėliai;Kačiukų;1292462938;Ne;3;0;2;5
13863;Želmenėliai;Kačiukų;2350936740;Ne;9;1;4;14
13864;Želmenėliai;Kačiukų;3063417708;Ne;0;12;0;12
13865;Želmenėliai;Kačiukų;2570248893;Taip;4;1;4;9
13866;Želmenėliai;Kačiukų;2577850672;Ne;0;7;0;7
13867;Želmenėliai;Kačiukų;7197717698;Ne;2;0;2;4
13868;Želmenėliai;Kačiukų;7849682820;Ne;0;12;0;12
13869;Želmenėliai;Kačiukų;2111008869;Ne;0;2;1;3
13870;Želmenėliai;Kačiukų;4589396143;Ne;3;2;2;7
13871;Želmenėliai;Kačiukų;4198085732;Ne;6;0;2;8
13872;Želmenėliai;Kačiukų;6509783586;Ne;0;2;0;2
13873;Želmenėliai;Kačiukų;4126499046;Ne;0;6;0;6
13874;Želmenėliai;Kačiukų;4758240577;Ne;3;1;2;6
13875;Želmenėliai;Kačiukų;7094853897;Taip;9;1;4;14
13876;Želmenėliai;Kačiukų;9493581034;Ne;0;4;12;16
13877;Želmenėliai;Kačiukų;4931664953;Ne;0;3;0;3
13878;Želmenėliai;Kačiukų;4376978921;Ne;4;13;2;19
13879;Želmenėliai;Kačiukų;9313666706;Taip;2;2;2;6
13880;Želmenėliai;Kačiukų;8590129703;Ne;3;0;9;12
13881;Želmenėliai;Kačiukų;3959066963;Ne;0;5;0;5
13882;Želmenėliai;Voveriukų;8418427863;Ne;0;1;2;3
13883;Želmenėliai;Voveriukų;5360157217;Ne;0;11;0;11
13884;Želmenėliai;Voveriukų;4968328834;Ne;1;2;2;5
13885;Želmenėliai;Voveriukų;2025424742;Ne;0;0;1;1
13886;Želmenėliai;Voveriukų;2924134152;Ne;10;0;3;13
13887;Želmenėliai;Voveriukų;5975166975;Ne;3;14;2;19
13888;Želmenėliai;Voveriukų;6857922902;Ne;5;0;2;7
13889;Želmenėliai;Voveriukų;9811131936;Ne;12;0;5;17
13890;Želmenėliai;Voveriukų;8968533318;Ne;8;4;2;14
13891;Želmenėliai;Voveriukų;8952421941;Ne;0;5;0;5
13892;Želmenėliai;Voveriukų;7345540758;Ne;0;1;0;1
13893;Želmenėliai;Voveriukų;9709599805;Ne;8;2;2;12
13894;Želmenėliai;Voveriukų;4248374729;Ne;0;3;0;3
13895;Želmenėliai;Voveriukų;7263162876;Ne;8;1;4;13
13896;Želmenėliai;Voveriukų;1199920167;Ne;7;1;2;10
13897;Želmenėliai;Voveriukų;5247889693;Ne;5;1;5;11
13898;Želmenėliai;Voveriukų;5767158743;Ne;3;1;5;9
13899;Želmenėliai;Ežiukų;1652131150;Ne;4;3;4;11
13900;Želmenėliai;Ežiukų;5795735579;Ne;0;4;0;4
13901;Želmenėliai;Ežiukų;3572462731;Ne;0;1;0;1
13902;Želmenėliai;Ežiukų;3353793939;Ne;0;0;2;2
13903;Želmenėliai;Ežiukų;7495157523;Ne;0;1;0;1
13904;Želmenėliai;Ežiukų;3972980949;Ne;0;1;0;1
13905;Želmenėliai;Ežiukų;6779746783;Ne;5;0;2;7
13906;Želmenėliai;Ežiukų;6876147546;Ne;0;13;0;13
13907;Želmenėliai;Ežiukų;9126715074;Taip;0;2;2;4
13908;Želmenėliai;Ežiukų;1260607572;Ne;1;2;2;5
13909;Želmenėliai;Ežiukų;5638248652;Ne;0;1;0;1
13910;Želmenėliai;Ežiukų;8154713582;Ne;13;7;2;22
13911;Želmenėliai;Ežiukų;2296870749;Ne;0;0;1;1
13912;Želmenėliai;Ežiukų;6180553648;Ne;0;1;0;1
13913;Želmenėliai;Ežiukų;7294722095;Ne;0;8;0;8
13914;Želmenėliai;Ežiukų;4120125150;Ne;13;0;4;17
13915;Želmenėliai;Ežiukų;5281861477;Ne;0;2;0;2
13916;Želmenėliai;Ežiukų;8987377791;Ne;0;2;0;2
13917;Želmenėliai;Ežiukų;7373892344;Ne;8;7;2;17
13918;Želmenėliai;Ežiukų;6481952132;Ne;0;2;0;2
13919;Želmenėliai;Peledžiukų;8491797555;Ne;5;15;2;22
13920;Želmenėliai;Peledžiukų;7058759730;Ne;0;11;0;11
13921;Želmenėliai;Peledžiukų;4485249321;Ne;4;2;2;8
13922;Želmenėliai;Peledžiukų;3869372021;Ne;2;0;2;4
13923;Želmenėliai;Peledžiukų;4374898642;Ne;3;2;2;7
13924;Želmenėliai;Peledžiukų;7751609462;Ne;0;3;0;3
13925;Želmenėliai;Peledžiukų;5929410363;Ne;6;2;2;10
13926;Želmenėliai;Peledžiukų;5205425589;Ne;4;4;2;10
13927;Želmenėliai;Peledžiukų;5362390260;Ne;0;1;0;1
13928;Želmenėliai;Peledžiukų;1580370689;Ne;4;2;2;8
13929;Želmenėliai;Peledžiukų;1983575576;Ne;2;0;2;4
13930;Želmenėliai;Peledžiukų;7672980212;Ne;8;4;2;14
13931;Želmenėliai;Peledžiukų;6260153299;Ne;3;3;2;8
13932;Želmenėliai;Peledžiukų;6187661667;Ne;0;3;0;3
13933;Želmenėliai;Peledžiukų;6109546917;Ne;6;4;2;12
13934;Želmenėliai;Peledžiukų;8118696261;Ne;8;1;4;13
13935;Želmenėliai;Peledžiukų;4746898209;Ne;12;3;4;19
13936;Želmenėliai;Peledžiukų;9929149682;Taip;9;3;4;16
13937;Želmenėliai;Peledžiukų;3723155757;Ne;8;4;2;14
13938;Želmenėliai;Peledžiukų;6662439747;Ne;8;3;2;13
13939;Želmenėliai;Drugelių;7123290599;Ne;1;0;4;5
13940;Želmenėliai;Drugelių;4526936339;Ne;8;0;2;10
13941;Želmenėliai;Drugelių;2878494111;Ne;0;8;0;8
13942;Želmenėliai;Drugelių;5169813205;Ne;6;0;3;9
13943;Želmenėliai;Drugelių;7341132501;Ne;6;2;6;14
13944;Želmenėliai;Drugelių;9661692350;Ne;0;8;0;8
13945;Želmenėliai;Drugelių;6230010537;Ne;0;2;0;2
13946;Želmenėliai;Drugelių;1025894534;Ne;0;12;0;12
13947;Želmenėliai;Drugelių;1606079948;Ne;0;2;0;2
13948;Želmenėliai;Drugelių;9250666159;Ne;10;0;2;12
13949;Želmenėliai;Drugelių;5569699398;Ne;10;0;2;12
13950;Želmenėliai;Drugelių;4207070475;Ne;0;2;0;2
13951;Želmenėliai;Drugelių;8409831053;Ne;2;3;3;8
13952;Želmenėliai;Drugelių;8060048377;Ne;4;2;2;8
13953;Želmenėliai;Drugelių;3608041516;Ne;0;4;0;4
13954;Želmenėliai;Drugelių;2578675950;Ne;7;0;0;7
13955;Želmenėliai;Drugelių;5454656514;Ne;0;3;0;3
13956;Želmenėliai;Drugelių;7792850272;Ne;0;2;0;2
13957;Želmenėliai;Voriukų;4264751761;Ne;0;3;0;3
13958;Želmenėliai;Voriukų;7563461821;Ne;0;6;0;6
13959;Želmenėliai;Voriukų;4075533071;Ne;0;7;0;7
13960;Želmenėliai;Voriukų;4545012342;Ne;0;3;0;3
13961;Želmenėliai;Voriukų;7505996978;Ne;0;10;0;10
13962;Želmenėliai;Voriukų;2722619508;Ne;3;3;2;8
13963;Želmenėliai;Voriukų;5025345647;Ne;3;3;2;8
13964;Želmenėliai;Voriukų;8892137326;Ne;0;4;0;4
13965;Želmenėliai;Voriukų;7700521261;Ne;0;6;0;6
13966;Želmenėliai;Voriukų;5794346039;Ne;0;1;0;1
13967;Želmenėliai;Voriukų;8273301992;Ne;3;4;2;9
13968;Želmenėliai;Voriukų;9427388681;Ne;0;1;0;1
13969;Želmenėliai;Voriukų;9977585033;Ne;0;2;0;2
13970;Želmenėliai;Voriukų;6343814445;Ne;1;2;2;5
13971;Želmenėliai;Voriukų;5171736943;Ne;0;4;0;4
13972;Želmenėliai;Voriukų;7833143421;Ne;2;2;2;6
13973;Želmenėliai;Voriukų;7423900312;Ne;0;5;0;5
13974;Želmenėliai;Boružėlių;1764468979;Ne;0;2;0;2
13975;Želmenėliai;Boružėlių;5161934903;Ne;0;4;0;4
13976;Želmenėliai;Boružėlių;8722573513;Ne;0;7;0;7
13977;Želmenėliai;Boružėlių;3516695805;Ne;0;9;0;9
13978;Želmenėliai;Boružėlių;5949535657;Ne;1;2;4;7
13979;Želmenėliai;Boružėlių;2262009049;Ne;0;1;0;1
13980;Želmenėliai;Boružėlių;7077832687;Ne;1;3;2;6
13981;Želmenėliai;Boružėlių;3896171121;Ne;0;7;0;7
13982;Želmenėliai;Boružėlių;2951719129;Ne;5;3;2;10
13983;Želmenėliai;Boružėlių;2066439950;Ne;1;2;4;7
13984;Želmenėliai;Boružėlių;5207899503;Ne;7;11;2;20
13985;Želmenėliai;Boružėlių;2111705047;Ne;0;3;0;3
13986;Želmenėliai;Boružėlių;2179165096;Ne;0;4;1;5
13987;Želmenėliai;Boružėlių;6831569546;Ne;0;2;5;7
13988;Želmenėliai;Boružėlių;9042786857;Ne;5;4;2;11
13989;Želmenėliai;Boružėlių;5913022147;Ne;3;3;2;8
13990;Želmenėliai;Pūkuotukų;3558547171;Ne;0;1;0;1
13991;Želmenėliai;Pūkuotukų;3979635800;Ne;0;2;0;2
13992;Želmenėliai;Pūkuotukų;4485851428;Ne;0;4;2;6
13993;Želmenėliai;Pūkuotukų;2501163903;Ne;0;7;0;7
13994;Želmenėliai;Pūkuotukų;1426080041;Ne;0;4;0;4
13995;Želmenėliai;Pūkuotukų;9076874685;Ne;0;2;0;2
13996;Želmenėliai;Pūkuotukų;3346680108;Ne;0;22;0;22
13997;Želmenėliai;Pūkuotukų;8654298177;Ne;0;0;1;1
13998;Želmenėliai;Pūkuotukų;9182208354;Ne;0;2;0;2
13999;Želmenėliai;Pūkuotukų;4679930998;Ne;0;2;0;2
14000;Želmenėliai;Pūkuotukų;3344426717;Ne;0;2;1;3
14001;Želmenėliai;Pūkuotukų;4930868989;Ne;0;5;0;5
14002;Želmenėliai;Pūkuotukų;4451798870;Ne;0;1;0;1
14003;Želmenėliai;Pūkuotukų;8104790589;Ne;11;2;4;17
14004;Želmenėliai;Pūkuotukų;4722890143;Ne;0;4;0;4
14005;Želmenėliai;Pūkuotukų;9901320882;Ne;0;3;0;3
14006;Želmenėliai;Pūkuotukų;3232996198;Ne;8;3;2;13
14007;Želmenėliai;Pūkuotukų;6764567873;Ne;10;4;4;18
14008;Želmenėliai;Pūkuotukų;3926238501;Ne;0;12;0;12
14009;Želmenėliai;Pūkuotukų;2095477479;Ne;0;4;1;5
14010;Želmenėliai;Ančiukų;9377359390;Ne;7;2;7;16
14011;Želmenėliai;Ančiukų;8165683014;Ne;22;6;4;32
14012;Želmenėliai;Ančiukų;3172645969;Ne;16;0;6;22
14013;Želmenėliai;Ančiukų;7128213908;Ne;0;2;0;2
14014;Želmenėliai;Ančiukų;6723870371;Ne;7;0;4;11
14015;Želmenėliai;Ančiukų;5872145297;Ne;5;4;3;12
14016;Želmenėliai;Ančiukų;4824276300;Ne;0;2;0;2
14017;Želmenėliai;Ančiukų;9558387704;Ne;10;0;4;14
14018;Želmenėliai;Ančiukų;7550865762;Ne;10;0;5;15
14019;Želmenėliai;Ančiukų;4841250486;Taip;5;0;0;5
14020;Želmenėliai;Ančiukų;3057181122;Ne;12;2;0;14
14021;Želmenėliai;Ančiukų;1359184372;Ne;2;25;0;27
14022;Želmenėliai;Ančiukų;9945526672;Ne;32;0;0;32
14023;Želmenėliai;Nykštukų;8276857357;Ne;3;3;2;8
14024;Želmenėliai;Nykštukų;3003922213;Ne;8;2;4;14
14025;Želmenėliai;Nykštukų;3539019330;Ne;4;0;4;8
14026;Želmenėliai;Nykštukų;3313780575;Ne;8;0;7;15
14027;Želmenėliai;Nykštukų;5560792581;Ne;0;0;1;1
14028;Želmenėliai;Nykštukų;8191484604;Ne;25;0;2;27
14029;Želmenėliai;Nykštukų;2028226797;Ne;0;13;0;13
14030;Želmenėliai;Nykštukų;2369379191;Taip;4;0;2;6
14031;Želmenėliai;Nykštukų;6172599827;Ne;5;0;4;9
14032;Želmenėliai;Nykštukų;2678902898;Ne;11;0;2;13
14033;Želmenėliai;Nykštukų;7537198352;Ne;13;0;6;19
14034;Želmenėliai;Nykštukų;2896053108;Ne;7;6;2;15
14035;Želmenėliai;Nykštukų;4165912796;Ne;3;10;2;15
14036;Želmenėliai;Nykštukų;1613626023;Ne;0;5;5;10
14037;Želmenėliai;Nykštukų;2105799163;Ne;12;2;2;16
14038;Želmenėliai;Lašelių;9483665065;Ne;3;6;2;11
14039;Želmenėliai;Lašelių;5494517342;Ne;0;1;0;1
14040;Želmenėliai;Lašelių;9774587149;Ne;18;2;2;22
14041;Želmenėliai;Lašelių;2143421412;Ne;2;1;2;5
14042;Želmenėliai;Lašelių;9608259121;Ne;0;8;0;8
14043;Želmenėliai;Lašelių;7403060823;Ne;0;7;0;7
14044;Želmenėliai;Lašelių;9178657126;Ne;0;0;1;1
14045;Želmenėliai;Lašelių;6863082839;Ne;3;2;2;7
14046;Želmenėliai;Lašelių;6605391184;Ne;0;2;0;2
14047;Želmenėliai;Lašelių;4197691574;Ne;9;1;2;12
14048;Želmenėliai;Lašelių;3788587862;Taip;3;2;4;9
14049;Želmenėliai;Lašelių;7067545362;Ne;4;8;2;14
14050;Želmenėliai;Lašelių;4354709866;Ne;10;5;2;17
14051;Žemyna;Čiauškučiai;9985529041;Ne;8;0;2;10
14052;Žemyna;Čiauškučiai;9570187081;Ne;2;0;2;4
14053;Žemyna;Čiauškučiai;2547436771;Ne;4;0;5;9
14054;Žemyna;Čiauškučiai;6346173832;Ne;0;0;4;4
14055;Žemyna;Čiauškučiai;3074391266;Ne;0;0;5;5
14056;Žemyna;Čiauškučiai;1365045512;Ne;2;5;0;7
14057;Žemyna;Čiauškučiai;7620179886;Ne;0;0;7;7
14058;Žemyna;Čiauškučiai;2792702536;Ne;0;2;0;2
14059;Žemyna;Čiauškučiai;7376806308;Ne;0;2;0;2
14060;Žemyna;Čiauškučiai;7277970673;Ne;8;0;2;10
14061;Žemyna;Čiauškučiai;5069437469;Ne;3;2;2;7
14062;Žemyna;Čiauškučiai;7427119736;Ne;0;2;1;3
14063;Žemyna;Čiauškučiai;4642600915;Ne;0;2;0;2
14064;Žemyna;Čiauškučiai;2354265632;Ne;0;0;2;2
14065;Žemyna;Čiauškučiai;2887459684;Ne;3;2;3;8
14066;Žemyna;Čiauškučiai;1654157342;Ne;8;2;2;12
14067;Žemyna;Čiauškučiai;7352868453;Ne;0;2;0;2
14068;Žemyna;Čiauškučiai;4501408683;Ne;0;2;1;3
14069;Žemyna;Čiauškučiai;4613946229;Ne;0;4;0;4
14070;Žemyna;Čiauškučiai;7675699775;Ne;1;2;2;5
14071;Žemyna;Čiauškučiai;6254811026;Ne;2;0;4;6
14072;Žemyna;Nykštukai;5124024813;Ne;0;0;1;1
14073;Žemyna;Nykštukai;8965957442;Ne;8;0;5;13
14074;Žemyna;Nykštukai;6965700024;Ne;1;2;7;10
14075;Žemyna;Nykštukai;3413550977;Ne;0;0;1;1
14076;Žemyna;Nykštukai;1158238868;Ne;2;0;2;4
14077;Žemyna;Nykštukai;8234617396;Ne;4;6;0;10
14078;Žemyna;Nykštukai;2105658990;Ne;0;2;1;3
14079;Žemyna;Nykštukai;1241953155;Ne;15;0;2;17
14080;Žemyna;Nykštukai;5274759824;Ne;5;0;3;8
14081;Žemyna;Nykštukai;9457156368;Taip;8;0;2;10
14082;Žemyna;Nykštukai;1581399038;Ne;2;5;0;7
14083;Žemyna;Nykštukai;4238528111;Taip;0;1;0;1
14084;Žemyna;Nykštukai;3741459808;Taip;0;1;0;1
14085;Žemyna;Nykštukai;3870917221;Ne;8;0;4;12
14086;Žemyna;Nykštukai;6632827240;Ne;0;2;0;2
14087;Žemyna;Nykštukai;3935318882;Ne;3;2;2;7
14088;Žemyna;Nykštukai;2010676445;Ne;3;2;2;7
14089;Žemyna;Nykštukai;9788890112;Ne;2;0;0;2
14090;Žemyna;Nykštukai;8157281885;Ne;5;0;2;7
14091;Žemyna;Voveriukai;6912605631;Ne;0;3;2;5
14092;Žemyna;Voveriukai;4549562657;Ne;0;4;0;4
14093;Žemyna;Voveriukai;8882641275;Ne;8;5;2;15
14094;Žemyna;Voveriukai;7121061078;Ne;0;2;2;4
14095;Žemyna;Voveriukai;4900914346;Ne;3;3;2;8
14096;Žemyna;Voveriukai;8241038433;Ne;3;2;2;7
14097;Žemyna;Voveriukai;3500358886;Ne;1;1;6;8
14098;Žemyna;Voveriukai;6592356004;Ne;2;0;0;2
14099;Žemyna;Voveriukai;7705964355;Ne;0;2;1;3
14100;Žemyna;Voveriukai;5486645485;Ne;3;1;6;10
14101;Žemyna;Voveriukai;5828590779;Ne;6;1;4;11
14102;Žemyna;Voveriukai;8601806926;Ne;12;2;4;18
14103;Žemyna;Kiškučiai;9912869400;Ne;10;2;4;16
14104;Žemyna;Kiškučiai;2006173745;Ne;0;3;0;3
14105;Žemyna;Kiškučiai;6116581655;Ne;0;0;1;1
14106;Žemyna;Kiškučiai;6728229865;Ne;0;7;0;7
14107;Žemyna;Kiškučiai;7280740926;Ne;3;3;2;8
14108;Žemyna;Kiškučiai;4872348199;Ne;0;2;1;3
14109;Žemyna;Kiškučiai;6419974691;Ne;1;2;5;8
14110;Žemyna;Kiškučiai;9818711030;Ne;3;1;2;6
14111;Žemyna;Kiškučiai;6735720135;Ne;0;2;0;2
14112;Žemyna;Kiškučiai;6878669773;Ne;0;2;0;2
14113;Žemyna;Kiškučiai;7764615445;Ne;0;2;2;4
14114;Žemyna;Kiškučiai;4502958166;Ne;0;4;0;4
14115;Žemyna;Kiškučiai;5868208651;Ne;8;2;2;12
14116;Žemyna;Kiškučiai;3982766622;Ne;0;2;0;2
14117;Žemyna;Kiškučiai;3992383447;Ne;5;0;4;9
14118;Žemyna;Kiškučiai;9568886284;Ne;4;1;7;12
14119;Žemyna;Kiškučiai;9668975591;Ne;0;2;0;2
14120;Žemyna;Kiškučiai;6856737270;Ne;0;1;0;1
14121;Žemyna;Kiškučiai;4612112289;Ne;0;3;1;4
14122;Žemyna;Kiškučiai;5188496664;Ne;0;2;0;2
14123;Žemyna;Vyturiukai;2526949655;Ne;1;2;2;5
14124;Žemyna;Vyturiukai;1417007895;Ne;0;6;0;6
14125;Žemyna;Vyturiukai;5355845891;Ne;0;1;0;1
14126;Žemyna;Vyturiukai;1481273689;Ne;4;2;4;10
14127;Žemyna;Vyturiukai;7781332622;Ne;1;6;0;7
14128;Žemyna;Vyturiukai;9366133892;Ne;1;2;2;5
14129;Žemyna;Vyturiukai;1031171460;Ne;4;0;3;7
14130;Žemyna;Vyturiukai;5204349188;Ne;6;2;2;10
14131;Žemyna;Vyturiukai;1345704379;Ne;2;0;2;4
14132;Žemyna;Vyturiukai;6097681172;Ne;2;1;2;5
14133;Žemyna;Vyturiukai;5133115712;Ne;1;1;2;4
14134;Žemyna;Vyturiukai;5416338054;Ne;1;1;2;4
14135;Žemyna;Vyturiukai;3446774478;Ne;4;5;2;11
14136;Žemyna;Vyturiukai;6271057561;Ne;0;4;0;4
14137;Žemyna;Vyturiukai;2304633263;Ne;0;0;7;7
14138;Žemyna;Vyturiukai;7300819771;Ne;0;1;0;1
14139;Žemyna;Vyturiukai;3679990879;Ne;4;0;6;10
14140;Žemyna;Vyturiukai;8681308720;Ne;0;4;0;4
14141;Žemyna;Vyturiukai;9646494715;Ne;0;3;0;3
14142;Žemyna;Vyturiukai;4863350801;Ne;2;0;0;2
14143;Žemyna;Vyturiukai;5655302107;Ne;0;3;0;3
14144;Žemyna;Pelėdžiukai;8525229514;Ne;0;0;4;4
14145;Žemyna;Pelėdžiukai;1846287760;Ne;0;2;7;9
14146;Žemyna;Pelėdžiukai;8775518984;Ne;0;2;3;5
14147;Žemyna;Pelėdžiukai;5337086029;Ne;10;0;2;12
14148;Žemyna;Pelėdžiukai;8926045231;Ne;3;2;4;9
14149;Žemyna;Pelėdžiukai;3860791215;Ne;0;2;5;7
14150;Žemyna;Pelėdžiukai;9855080887;Ne;0;2;0;2
14151;Žemyna;Pelėdžiukai;8185243991;Ne;0;2;1;3
14152;Žemyna;Pelėdžiukai;9471382383;Ne;0;4;0;4
14153;Žemyna;Pelėdžiukai;7942276632;Ne;2;4;2;8
14154;Žemyna;Pelėdžiukai;2422672832;Ne;2;0;2;4
14155;Žemyna;Pelėdžiukai;8408275231;Ne;8;2;5;15
14156;Žemyna;Pelėdžiukai;7417179112;Ne;0;2;0;2
14157;Žemyna;Pelėdžiukai;5387026410;Ne;0;2;0;2
14158;Žemyna;Pelėdžiukai;9831054554;Ne;0;1;0;1
14159;Žemyna;Pelėdžiukai;9194899557;Ne;0;2;1;3
14160;Žemyna;Pelėdžiukai;6175213274;Ne;0;2;0;2
14161;Žemyna;Pelėdžiukai;7311046586;Ne;0;2;1;3
14162;Žemyna;Pelėdžiukai;5124507416;Ne;0;2;1;3
14163;Žemyna;Pelėdžiukai;1713559750;Ne;0;1;0;1
14164;Žemyna;Vijurkai;4524929331;Ne;7;2;2;11
14165;Žemyna;Vijurkai;5114094924;Ne;1;4;4;9
14166;Žemyna;Vijurkai;3643594001;Ne;0;4;2;6
14167;Žemyna;Vijurkai;9182709647;Ne;0;6;0;6
14168;Žemyna;Vijurkai;4257096808;Ne;3;2;2;7
14169;Žemyna;Vijurkai;3874855308;Ne;2;2;2;6
14170;Žemyna;Vijurkai;7121742098;Ne;0;8;0;8
14171;Žemyna;Vijurkai;2461700030;Ne;5;5;0;10
14172;Žemyna;Vijurkai;3519840747;Ne;0;2;0;2
14173;Žemyna;Vijurkai;7508491119;Ne;3;3;2;8
14174;Žemyna;Vijurkai;1725771976;Ne;0;1;0;1
14175;Žemyna;Vijurkai;9653530823;Ne;0;3;0;3
14176;Žemyna;Vijurkai;2860210906;Ne;3;4;2;9
14177;Žemyna;Vijurkai;7832066079;Ne;0;7;0;7
14178;Žemyna;Vijurkai;1468040559;Ne;3;2;4;9
14179;Žemyna;Vijurkai;4322192775;Ne;3;2;2;7
14180;Žemyna;Vijurkai;4444870782;Ne;3;2;2;7
14181;Žemyna;Vijurkai;4265606762;Ne;4;2;4;10
14182;Žemyna;Vijurkai;7781924111;Ne;0;2;0;2
14183;Žemyna;Vijurkai;2928125522;Ne;0;2;0;2
14184;Žemyna;Vijurkai;4759403487;Ne;0;11;0;11
14185;Žemyna;Vijurkai;5222774764;Ne;0;22;0;22
14186;Žemyna;Šnekučiai;4540472310;Ne;0;6;0;6
14187;Žemyna;Šnekučiai;9647706055;Ne;5;0;2;7
14188;Žemyna;Šnekučiai;7537145330;Ne;1;0;2;3
14189;Žemyna;Šnekučiai;3899901920;Ne;1;2;2;5
14190;Žemyna;Šnekučiai;7831778620;Ne;0;4;0;4
14191;Žemyna;Šnekučiai;9692952139;Ne;1;2;2;5
14192;Žemyna;Šnekučiai;1795919515;Ne;0;3;1;4
14193;Žemyna;Šnekučiai;8319442149;Ne;9;0;0;9
14194;Žemyna;Šnekučiai;1999410395;Ne;9;0;5;14
14195;Žemyna;Šnekučiai;6872208929;Ne;2;0;13;15
14196;Žemyna;Šnekučiai;4373063041;Ne;0;0;2;2
14197;Žemyna;Šnekučiai;9813765590;Ne;0;9;0;9
14198;Žemyna;Šnekučiai;4779461598;Ne;0;0;7;7
14199;Žemyna;Šnekučiai;3976010927;Ne;0;17;0;17
14200;Žemyna;Šnekučiai;4963338410;Ne;5;0;6;11
14201;Žemyna;Šnekučiai;1078809628;Ne;1;2;9;12
14202;Žemyna;Šnekučiai;9535234845;Ne;0;0;3;3
14203;Žemyna;Šnekučiai;3996577758;Ne;0;3;0;3
14204;Žemyna;Pabiručiai;9827401825;Ne;0;5;0;5
14205;Žemyna;Pabiručiai;5743535463;Ne;0;7;0;7
14206;Žemyna;Pabiručiai;6958537154;Ne;0;6;0;6
14207;Žemyna;Pabiručiai;7005045961;Ne;3;12;2;17
14208;Žemyna;Pabiručiai;1745197274;Ne;0;4;0;4
14209;Žemyna;Pabiručiai;6041223291;Ne;4;2;2;8
14210;Žemyna;Pabiručiai;8248443265;Ne;0;0;1;1
14211;Žemyna;Pabiručiai;7122276019;Ne;7;3;2;12
14212;Žemyna;Pabiručiai;9094718595;Ne;0;0;3;3
14213;Žemyna;Pabiručiai;6208953341;Ne;0;14;0;14
14214;Žemyna;Pabiručiai;5127174926;Ne;0;5;0;5
14215;Žemyna;Pabiručiai;8559870965;Ne;3;3;2;8
14216;Žemyna;Pabiručiai;1850100203;Ne;0;2;0;2
14217;Žemyna;Pabiručiai;6450681255;Ne;0;3;0;3
14218;Žemyna;Pabiručiai;2860232791;Ne;0;0;1;1
14219;Žemyna;Pabiručiai;4237778022;Ne;3;0;2;5
14220;Žemyna;Pabiručiai;2414400761;Ne;0;7;0;7
14221;Žemyna;Pabiručiai;9511935264;Ne;0;2;0;2
14222;Žemyna;Pabiručiai;4176386795;Ne;0;2;0;2
14223;Žemyna;Pabiručiai;3393414493;Ne;3;0;2;5
14224;Žemyna;Pabiručiai;2495616844;Ne;0;6;0;6
14225;Žemyna;Pabiručiai;6329592260;Ne;0;4;11;15
14226;Žemyna;Drugeliai;7564693757;Ne;1;0;3;4
14227;Žemyna;Drugeliai;8302345911;Ne;0;2;0;2
14228;Žemyna;Drugeliai;3505551915;Ne;5;0;5;10
14229;Žemyna;Drugeliai;2231967652;Ne;0;0;9;9
14230;Žemyna;Drugeliai;3755964840;Ne;2;2;2;6
14231;Žemyna;Drugeliai;9171823612;Ne;0;0;22;22
14232;Žemyna;Drugeliai;5518125715;Ne;0;0;13;13
14233;Žemyna;Drugeliai;9589582451;Ne;0;0;6;6
14234;Žemyna;Drugeliai;3872427931;Ne;0;0;3;3
14235;Žemyna;Drugeliai;1279981170;Ne;0;0;1;1
14236;Žemyna;Drugeliai;2102920661;Ne;0;0;4;4
14237;Žemyna;Drugeliai;6575272457;Ne;4;0;4;8
14238;Žemyna;Drugeliai;6164541167;Ne;8;2;3;13
14239;Žemyna;Drugeliai;7461187735;Ne;2;0;4;6
14240;Žemyna;Drugeliai;3390442637;Ne;0;2;0;2
14241;Žemyna;Drugeliai;2371069183;Ne;3;0;5;8
14242;Žemyna;Drugeliai;2139103576;Ne;0;4;0;4
14243;Žemyna;Drugeliai;7920398415;Ne;0;7;0;7
14244;Žemyna;Drugeliai;1695063377;Ne;15;0;0;15
14245;Žemyna;Drugeliai;7745383607;Ne;3;2;4;9
14246;Žemyna;Drugeliai;7661182825;Ne;0;0;3;3
14247;Žemyna;Drugeliai;4861799571;Ne;0;0;3;3
14248;Žemyna;Drugeliai;8709792653;Ne;7;0;3;10
14249;Žemyna;Drugeliai;7969518430;Ne;8;0;6;14
14250;Žemyna;"ŽIRNIUKAI ";8638419172;Ne;4;0;4;8
14251;Žemyna;"ŽIRNIUKAI ";5262196604;Ne;5;0;2;7
14252;Žemyna;"ŽIRNIUKAI ";6783675344;Ne;12;0;2;14
14253;Žemyna;"ŽIRNIUKAI ";9082375371;Ne;3;0;0;3
14254;Žemyna;"ŽIRNIUKAI ";3172071074;Ne;0;0;22;22
14255;Žemyna;"ŽIRNIUKAI ";8574497593;Ne;0;2;13;15
14256;Žemyna;"ŽIRNIUKAI ";3951546627;Ne;10;0;2;12
14257;Žemyna;"ŽIRNIUKAI ";2333634521;Ne;0;1;0;1
14258;Žemyna;"ŽIRNIUKAI ";8915491841;Ne;0;0;3;3
14259;Žemyna;"ŽIRNIUKAI ";1667692063;Ne;0;2;10;12
14260;Žemyna;"ŽIRNIUKAI ";1898736492;Ne;0;1;1;2
14261;Žemyna;"ŽIRNIUKAI ";8371442452;Ne;0;2;0;2
14262;Žemyna;"ŽIRNIUKAI ";2302222659;Ne;6;2;4;12
14263;Žemyna;"ŽIRNIUKAI ";1014787654;Ne;6;2;4;12
14264;Žemyna;"ŽIOGELIAI ";2039344248;Ne;8;0;4;12
14265;Žemyna;"ŽIOGELIAI ";5193466394;Ne;11;1;2;14
14266;Žemyna;"ŽIOGELIAI ";3164469202;Ne;4;0;2;6
14267;Žemyna;"ŽIOGELIAI ";8365200813;Ne;0;2;0;2
14268;Žemyna;"ŽIOGELIAI ";3234902380;Ne;3;0;2;5
14269;Žemyna;"ŽIOGELIAI ";8939113856;Ne;0;3;0;3
14270;Žemyna;"ŽIOGELIAI ";8205404725;Ne;0;1;0;1
14271;Žemyna;"ŽIOGELIAI ";6638712995;Ne;7;0;2;9
14272;Žemyna;"ŽIOGELIAI ";3768231563;Ne;6;0;5;11
14273;Žemyna;"ŽIOGELIAI ";7580529381;Ne;10;0;4;14
14274;Žemyna;"ŽIOGELIAI ";5593285877;Ne;11;0;4;15
14275;Žemyna;"ŽIOGELIAI ";3397833166;Ne;0;1;1;2
14276;Žemyna;"ŽIOGELIAI ";2255662379;Ne;6;0;3;9
14277;Žemyna;"ŽIOGELIAI ";8017209353;Ne;6;0;3;9
14278;Žemyna;"ŽIOGELIAI ";8036600474;Ne;2;2;2;6
14279;Žemyna;"ŽIOGELIAI ";6317657622;Ne;10;2;4;16
14280;Žemyna;"ŽIOGELIAI ";9992027222;Ne;14;0;2;16
14281;Žemuogėlė;Boružiukai;1350671777;Ne;7;0;4;11
14282;Žemuogėlė;Boružiukai;9344628661;Ne;1;0;3;4
14283;Žemuogėlė;Boružiukai;2158359435;Ne;0;0;2;2
14284;Žemuogėlė;Boružiukai;1639634300;Ne;10;3;3;16
14285;Žemuogėlė;Boružiukai;5521993938;Ne;6;0;3;9
14286;Žemuogėlė;Boružiukai;1267222057;Ne;6;2;3;11
14287;Žemuogėlė;Boružiukai;9562512849;Ne;8;4;4;16
14288;Žemuogėlė;Boružiukai;8661864424;Ne;0;0;2;2
14289;Žemuogėlė;Boružiukai;1150466286;Ne;6;1;2;9
14290;Žemuogėlė;Boružiukai;8040255583;Ne;5;3;2;10
14291;Žemuogėlė;Boružiukai;2190458676;Ne;8;0;4;12
14292;Žemuogėlė;Boružiukai;7328566035;Ne;2;0;2;4
14293;Žemuogėlė;Boružiukai;8557325116;Ne;3;1;2;6
14294;Žemuogėlė;Boružiukai;1350383125;Ne;3;2;2;7
14295;Žemuogėlė;Boružiukai;3413805578;Ne;5;0;4;9
14296;Žemuogėlė;Boružiukai;1187953952;Ne;2;0;2;4
14297;Žemuogėlė;Boružiukai;3677459716;Ne;0;1;2;3
14298;Žemuogėlė;Boružiukai;8426601160;Ne;8;0;3;11
14299;Žemuogėlė;Boružiukai;5911215640;Ne;4;1;14;19
14300;Žemuogėlė;Šviesuliukai;9599829363;Ne;0;10;0;10
14301;Žemuogėlė;Šviesuliukai;4663181188;Ne;0;0;1;1
14302;Žemuogėlė;Šviesuliukai;1341637008;Ne;3;0;2;5
14303;Žemuogėlė;Šviesuliukai;7288060676;Ne;15;4;2;21
14304;Žemuogėlė;Šviesuliukai;5447960062;Ne;0;0;3;3
14305;Žemuogėlė;Šviesuliukai;4654060157;Ne;5;0;1;6
14306;Žemuogėlė;Šviesuliukai;2652630375;Ne;7;6;5;18
14307;Žemuogėlė;Šviesuliukai;1250186598;Ne;7;4;4;15
14308;Žemuogėlė;Šviesuliukai;3287415964;Ne;0;9;0;9
14309;Žemuogėlė;Šviesuliukai;5094867109;Ne;5;0;8;13
14310;Žemuogėlė;Šviesuliukai;4974793430;Ne;9;0;6;15
14311;Žemuogėlė;Šviesuliukai;5125826172;Ne;0;9;0;9
14312;Žemuogėlė;Šviesuliukai;8262862183;Ne;5;3;6;14
14313;Žemuogėlė;Šviesuliukai;8798113318;Ne;1;0;2;3
14314;Žemuogėlė;Šviesuliukai;1280794094;Ne;0;5;2;7
14315;Žemuogėlė;Šviesuliukai;2251142510;Ne;4;3;4;11
14316;Žemuogėlė;Šviesuliukai;1417355297;Ne;1;0;2;3
14317;Žemuogėlė;Šviesuliukai;6659616731;Ne;0;5;0;5
14318;Žemuogėlė;Šviesuliukai;3467743802;Ne;7;2;4;13
14319;Žemuogėlė;Šviesuliukai;3842157786;Ne;6;4;5;15
14320;Žemuogėlė;Lašiukai;3190523750;Ne;5;0;4;9
14321;Žemuogėlė;Lašiukai;1251497003;Ne;0;1;0;1
14322;Žemuogėlė;Lašiukai;3706531223;Ne;8;2;2;12
14323;Žemuogėlė;Lašiukai;8029484123;Ne;10;0;4;14
14324;Žemuogėlė;Lašiukai;3753156044;Ne;0;4;0;4
14325;Žemuogėlė;Lašiukai;7592566602;Ne;4;2;4;10
14326;Žemuogėlė;Lašiukai;1555899448;Ne;0;2;1;3
14327;Žemuogėlė;Lašiukai;8644564820;Ne;0;1;0;1
14328;Žemuogėlė;Lašiukai;3546429231;Ne;4;4;2;10
14329;Žemuogėlė;Lašiukai;3073956225;Ne;18;0;2;20
14330;Žemuogėlė;Lašiukai;9693814425;Ne;2;1;2;5
14331;Žemuogėlė;Lašiukai;2115883173;Ne;4;0;4;8
14332;Žemuogėlė;Lašiukai;9848385521;Ne;2;0;1;3
14333;Žemuogėlė;Lašiukai;5602718614;Ne;1;2;12;15
14334;Žemuogėlė;Skambaliukai;7804015060;Ne;0;3;0;3
14335;Žemuogėlė;Skambaliukai;3765022476;Ne;0;4;2;6
14336;Žemuogėlė;Skambaliukai;9476688736;Ne;0;2;0;2
14337;Žemuogėlė;Skambaliukai;2001471529;Ne;0;5;0;5
14338;Žemuogėlė;Skambaliukai;9519563708;Ne;0;4;2;6
14339;Žemuogėlė;Skambaliukai;5266493632;Ne;0;1;0;1
14340;Žemuogėlė;Skambaliukai;2841634296;Ne;0;6;2;8
14341;Žemuogėlė;Skambaliukai;3237083654;Taip;0;10;0;10
14342;Žemuogėlė;Skambaliukai;2259779058;Ne;3;2;3;8
14343;Žemuogėlė;Skambaliukai;9693894254;Ne;0;4;0;4
14344;Žemuogėlė;Skambaliukai;9378432383;Ne;0;6;0;6
14345;Žemuogėlė;Skambaliukai;6913038845;Ne;3;2;2;7
14346;Žemuogėlė;Skambaliukai;6581889641;Ne;0;3;0;3
14347;Žemuogėlė;Skambaliukai;2555902309;Ne;0;8;0;8
14348;Žemuogėlė;Skambaliukai;2132549536;Ne;3;4;4;11
14349;Žemuogėlė;Skambaliukai;5532053268;Ne;5;2;4;11
14350;Žemuogėlė;Skambaliukai;8496353410;Ne;0;3;2;5
14351;Žemuogėlė;Skambaliukai;1733808230;Ne;4;2;2;8
14352;Žemuogėlė;Skambaliukai;9579921777;Ne;5;2;2;9
14353;Žemuogėlė;Spinduliukai;5971652934;Ne;0;3;0;3
14354;Žemuogėlė;Spinduliukai;4578291476;Ne;3;11;0;14
14355;Žemuogėlė;Spinduliukai;6707522989;Ne;6;5;0;11
14356;Žemuogėlė;Spinduliukai;7669457695;Ne;0;9;0;9
14357;Žemuogėlė;Spinduliukai;3041461125;Ne;4;0;0;4
14358;Žemuogėlė;Spinduliukai;4933948491;Ne;12;0;2;14
14359;Žemuogėlė;Spinduliukai;7342985744;Ne;15;2;4;21
14360;Žemuogėlė;Spinduliukai;8492878852;Ne;0;2;0;2
14361;Žemuogėlė;Spinduliukai;7551522580;Ne;3;6;2;11
14362;Žemuogėlė;Spinduliukai;5499401648;Ne;2;0;2;4
14363;Žemuogėlė;Spinduliukai;7603740057;Ne;5;2;2;9
14364;Žemuogėlė;Spinduliukai;3746045950;Ne;10;6;2;18
14365;Žemuogėlė;Spinduliukai;4506847669;Ne;3;1;0;4
14366;Žemuogėlė;Spinduliukai;7189855370;Ne;14;5;2;21
14367;Žemuogėlė;Spinduliukai;3801534195;Ne;4;0;4;8
14368;Žemuogėlė;Perliukai;1002937953;Ne;0;1;0;1
14369;Žemuogėlė;Perliukai;6504659145;Ne;0;2;1;3
14370;Žemuogėlė;Perliukai;3505090532;Ne;7;0;5;12
14371;Žemuogėlė;Perliukai;1790341419;Ne;0;3;5;8
14372;Žemuogėlė;Perliukai;4998981337;Ne;0;1;0;1
14373;Žemuogėlė;Perliukai;6045257180;Ne;0;0;2;2
14374;Žemuogėlė;Perliukai;2496321184;Taip;0;9;0;9
14375;Žemuogėlė;Perliukai;8490643028;Ne;8;0;4;12
14376;Žemuogėlė;Perliukai;5208043522;Ne;2;0;0;2
14377;Žemuogėlė;Perliukai;2139102266;Ne;6;0;3;9
14378;Žemuogėlė;Perliukai;3740127955;Taip;1;14;2;17
14379;Žemuogėlė;Perliukai;5614510812;Ne;8;0;2;10
14380;Žemuogėlė;Perliukai;9735379466;Ne;2;4;2;8
14381;Žemuogėlė;Perliukai;4089939292;Ne;1;0;2;3
14382;Žemuogėlė;Perliukai;9584172565;Ne;2;1;0;3
14383;Žemuogėlė;Perliukai;8706379207;Ne;4;0;4;8
14384;Žemuogėlė;Perliukai;1457860763;Ne;5;0;3;8
14385;Žemuogėlė;Drugeliai;2745609317;Ne;3;4;4;11
14386;Žemuogėlė;Drugeliai;9694133286;Ne;4;3;1;8
14387;Žemuogėlė;Drugeliai;5557409350;Ne;4;4;4;12
14388;Žemuogėlė;Drugeliai;7148244029;Ne;0;2;0;2
14389;Žemuogėlė;Drugeliai;1901423257;Ne;0;1;0;1
14390;Žemuogėlė;Drugeliai;4862145385;Ne;4;7;2;13
14391;Žemuogėlė;Drugeliai;4368183799;Ne;8;7;2;17
14392;Žemuogėlė;Drugeliai;9902953729;Ne;11;7;4;22
14393;Žemuogėlė;Drugeliai;9537297860;Ne;4;1;5;10
14394;Žemuogėlė;Drugeliai;5170205929;Ne;0;10;0;10
14395;Žemuogėlė;Drugeliai;2428043195;Ne;0;9;0;9
14396;Žemuogėlė;Drugeliai;1716114524;Ne;3;5;2;10
14397;Žemuogėlė;Drugeliai;8137567729;Ne;2;7;2;11
14398;Žemuogėlė;Drugeliai;7974688217;Ne;11;4;0;15
14399;Žemuogėlė;Drugeliai;9273896998;Ne;6;1;4;11
14400;Žemuogėlė;Drugeliai;9801151322;Ne;1;13;2;16
14401;Žemuogėlė;Drugeliai;5142411841;Ne;1;4;2;7
14402;Žemuogėlė;Drugeliai;9872387354;Ne;6;1;4;11
14403;Žemuogėlė;Drugeliai;5300388726;Ne;6;1;2;9
14404;Žemuogėlė;"VIEVERSIUKAI ";6520776378;Ne;9;0;4;13
14405;Žemuogėlė;"VIEVERSIUKAI ";8048818368;Ne;0;0;5;5
14406;Žemuogėlė;"VIEVERSIUKAI ";6577040746;Ne;10;0;5;15
14407;Žemuogėlė;"VIEVERSIUKAI ";2674188340;Ne;14;0;4;18
14408;Žemuogėlė;"VIEVERSIUKAI ";7823828526;Ne;5;0;2;7
14409;Žemuogėlė;"VIEVERSIUKAI ";4172356209;Ne;32;0;0;32
14410;Žemuogėlė;"VIEVERSIUKAI ";6379837644;Ne;0;2;2;4
14411;Žemuogėlė;"VIEVERSIUKAI ";3104276726;Ne;3;0;7;10
14412;Žemuogėlė;"VIEVERSIUKAI ";3419907292;Ne;8;0;4;12
14413;Žemuogėlė;"VIEVERSIUKAI ";2800160529;Ne;9;1;2;12
14414;Žemuogėlė;"VIEVERSIUKAI ";8934779062;Ne;12;0;0;12
14415;Žemuogėlė;"VIEVERSIUKAI ";3090630899;Ne;4;0;2;6
14416;Žemuogėlė;"VIEVERSIUKAI ";8091000121;Ne;4;0;4;8
14417;Žemuogėlė;"VIEVERSIUKAI ";2110963483;Ne;10;13;2;25
14418;Žemuogėlė;"VIEVERSIUKAI ";2574719380;Ne;9;2;5;16
14419;Žemuogėlė;"NYKŠTUKAI ";9205221446;Ne;5;0;2;7
14420;Žemuogėlė;"NYKŠTUKAI ";2655733505;Ne;5;2;2;9
14421;Žemuogėlė;"NYKŠTUKAI ";1911605637;Ne;1;3;2;6
14422;Žemuogėlė;"NYKŠTUKAI ";9798128294;Ne;12;2;4;18
14423;Žemuogėlė;"NYKŠTUKAI ";1916826391;Ne;11;2;2;15
14424;Žemuogėlė;"NYKŠTUKAI ";5948873766;Ne;1;3;2;6
14425;Žemuogėlė;"NYKŠTUKAI ";3010585170;Ne;7;4;4;15
14426;Žemuogėlė;"NYKŠTUKAI ";1769751604;Ne;5;0;4;9
14427;Žemuogėlė;"NYKŠTUKAI ";3462564692;Ne;20;0;12;32
14428;Žemuogėlė;"NYKŠTUKAI ";8706639942;Ne;2;0;5;7
14429;Žemuogėlė;"NYKŠTUKAI ";4180815331;Ne;5;2;2;9
14430;Žemuogėlė;"NYKŠTUKAI ";9290074229;Ne;0;0;2;2
14431;Žemuogėlė;"NYKŠTUKAI ";1601617523;Ne;0;6;0;6
14432;Žemuogėlė;KIŠKUČIAI;8584425313;Ne;8;2;2;12
14433;Žemuogėlė;KIŠKUČIAI;7423719480;Ne;4;5;3;12
14434;Žemuogėlė;KIŠKUČIAI;9889748260;Ne;3;3;2;8
14435;Žemuogėlė;KIŠKUČIAI;3385450072;Ne;0;8;0;8
14436;Žemuogėlė;KIŠKUČIAI;7190053438;Ne;1;2;6;9
14437;Žemuogėlė;KIŠKUČIAI;3726995259;Ne;1;2;7;10
14438;Žemuogėlė;KIŠKUČIAI;6557523361;Ne;0;2;4;6
14439;Žemuogėlė;KIŠKUČIAI;9153455673;Ne;12;0;4;16
14440;Žemuogėlė;KIŠKUČIAI;2091617436;Ne;20;0;4;24
14441;Žemuogėlė;KIŠKUČIAI;9501717210;Ne;20;0;4;24
14442;Žemuogėlė;KIŠKUČIAI;6901260056;Ne;4;0;3;7
14443;Žemuogėlė;KIŠKUČIAI;7263992351;Ne;7;3;0;10
14444;Žemuogėlė;KIŠKUČIAI;7508582586;Ne;1;2;2;5
14445;Žemuogėlė;KIŠKUČIAI;8048133131;Ne;14;0;4;18
14446;Žemuogėlė;KIŠKUČIAI;1090827680;Ne;4;0;2;6
14447;Žemuogėlė;Žiniukai;1306065826;Ne;3;2;2;7
14448;Žemuogėlė;Žiniukai;8106709288;Ne;0;4;0;4
14449;Žemuogėlė;Žiniukai;2664267604;Ne;8;0;2;10
14450;Žemuogėlė;Žiniukai;1060986850;Ne;0;1;0;1
14451;Žemuogėlė;Žiniukai;9150335499;Ne;8;0;3;11
14452;Žemuogėlė;Žiniukai;7794377881;Ne;5;5;2;12
14453;Žemuogėlė;Žiniukai;1658954821;Ne;7;0;0;7
14454;Žemuogėlė;Žiniukai;4698671798;Ne;3;0;2;5
14455;Žemuogėlė;Žiniukai;1079114347;Ne;8;0;2;10
14456;Žemuogėlė;Žiniukai;5902241163;Ne;3;10;2;15
14457;Žemuogėlė;Žiniukai;7879519193;Ne;3;5;2;10
14458;Žemuogėlė;Žiniukai;2922827304;Ne;0;3;4;7
14459;Žemuogėlė;Žiniukai;2109195565;Ne;0;2;3;5
14460;Žemuogėlė;Žiniukai;7415364637;Ne;1;3;3;7
14461;Žemuogėlė;Žiniukai;3710681463;Ne;12;2;2;16
14462;Žemuogėlė;Žiniukai;1796489729;Ne;0;4;0;4
14463;Žemuogėlė;Žiniukai;8215763877;Ne;0;3;2;5
14464;Žemuogėlė;Žiniukai;2934225120;Ne;13;0;2;15
14465;Žemuogėlė;Žiniukai;3426685084;Ne;0;5;1;6
14466;Žibutė;PELĖDŽIUKAI;3777544301;Ne;0;2;3;5
14467;Žibutė;PELĖDŽIUKAI;1362419302;Ne;0;3;0;3
14468;Žibutė;PELĖDŽIUKAI;5677389434;Ne;0;3;1;4
14469;Žibutė;PELĖDŽIUKAI;5416015554;Ne;0;2;3;5
14470;Žibutė;PELĖDŽIUKAI;1366469428;Ne;0;2;2;4
14471;Žibutė;PELĖDŽIUKAI;4825064521;Ne;0;0;5;5
14472;Žibutė;PELĖDŽIUKAI;5826523148;Ne;0;3;0;3
14473;Žibutė;PELĖDŽIUKAI;7531027545;Ne;0;3;1;4
14474;Žibutė;PELĖDŽIUKAI;3957898269;Ne;0;4;0;4
14475;Žibutė;PELĖDŽIUKAI;3645481894;Ne;0;2;0;2
14476;Žibutė;PELĖDŽIUKAI;6074488747;Ne;0;1;1;2
14477;Žibutė;PELĖDŽIUKAI;8880329060;Ne;0;0;2;2
14478;Žibutė;PELĖDŽIUKAI;5591698130;Ne;0;0;1;1
14479;Žibutė;PELĖDŽIUKAI;9868621666;Ne;0;2;0;2
14480;Žibutė;PELĖDŽIUKAI;5009495840;Ne;1;1;0;2
14481;Žibutė;PELĖDŽIUKAI;7136145033;Ne;3;0;2;5
14482;Žibutė;PELĖDŽIUKAI;6978977383;Ne;0;2;1;3
14483;Žibutė;PELĖDŽIUKAI;1004098038;Ne;0;11;1;12
14484;Žibutė;PELĖDŽIUKAI;2880593326;Ne;1;0;2;3
14485;Žibutė;PELĖDŽIUKAI;7479437931;Ne;0;2;0;2
14486;Žibutė;PELĖDŽIUKAI;9498011134;Ne;0;1;2;3
14487;Žibutė;KREGŽDUTĖS;7036454359;Ne;8;0;2;10
14488;Žibutė;KREGŽDUTĖS;3555071718;Ne;6;2;2;10
14489;Žibutė;KREGŽDUTĖS;5412917352;Ne;0;0;1;1
14490;Žibutė;KREGŽDUTĖS;5190377896;Ne;4;2;2;8
14491;Žibutė;KREGŽDUTĖS;6013340521;Ne;0;8;0;8
14492;Žibutė;KREGŽDUTĖS;3574946816;Ne;0;0;2;2
14493;Žibutė;KREGŽDUTĖS;9923687090;Ne;9;17;4;30
14494;Žibutė;KREGŽDUTĖS;4847295068;Ne;3;0;6;9
14495;Žibutė;KREGŽDUTĖS;9700866512;Ne;0;3;0;3
14496;Žibutė;KREGŽDUTĖS;7774532200;Ne;0;13;0;13
14497;Žibutė;KREGŽDUTĖS;2607509585;Ne;0;3;0;3
14498;Žibutė;KREGŽDUTĖS;8944042589;Ne;0;0;1;1
14499;Žibutė;KREGŽDUTĖS;2438980348;Ne;0;1;5;6
14500;Žibutė;KREGŽDUTĖS;9918283923;Ne;0;2;1;3
14501;Žibutė;KREGŽDUTĖS;5126232169;Ne;8;2;2;12
14502;Žibutė;KREGŽDUTĖS;8792292819;Taip;28;0;4;32
14503;Žibutė;KREGŽDUTĖS;7668484415;Ne;0;16;1;17
14504;Žibutė;KREGŽDUTĖS;2516448580;Ne;0;13;0;13
14505;Žibutė;KREGŽDUTĖS;8708083787;Ne;0;2;13;15
14506;Žibutė;BORUŽĖLĖS;5430856044;Ne;2;0;1;3
14507;Žibutė;BORUŽĖLĖS;8303166103;Ne;1;6;2;9
14508;Žibutė;BORUŽĖLĖS;4708691611;Ne;7;0;2;9
14509;Žibutė;BORUŽĖLĖS;9116859942;Ne;0;3;0;3
14510;Žibutė;BORUŽĖLĖS;1730975120;Ne;10;2;2;14
14511;Žibutė;BORUŽĖLĖS;9547812966;Ne;6;0;2;8
14512;Žibutė;BORUŽĖLĖS;9563567679;Ne;9;0;6;15
14513;Žibutė;BORUŽĖLĖS;7738606888;Ne;2;0;2;4
14514;Žibutė;BORUŽĖLĖS;6072605005;Ne;3;4;0;7
14515;Žibutė;BORUŽĖLĖS;8423264689;Ne;16;0;2;18
14516;Žibutė;BORUŽĖLĖS;7683703528;Ne;9;2;4;15
14517;Žibutė;BORUŽĖLĖS;5462787553;Ne;6;0;2;8
14518;Žibutė;BORUŽĖLĖS;3258258046;Ne;7;0;4;11
14519;Žibutė;BORUŽĖLĖS;9127784681;Ne;2;0;1;3
14520;Žibutė;BORUŽĖLĖS;6209156111;Ne;3;3;2;8
14521;Žibutė;BITUTĖS;7023683517;Ne;1;2;0;3
14522;Žibutė;BITUTĖS;7853531467;Ne;0;1;0;1
14523;Žibutė;BITUTĖS;3687123871;Ne;7;0;4;11
14524;Žibutė;BITUTĖS;2312717334;Ne;0;2;5;7
14525;Žibutė;BITUTĖS;6361543454;Ne;0;3;0;3
14526;Žibutė;BITUTĖS;1297347740;Ne;1;2;2;5
14527;Žibutė;BITUTĖS;6934760468;Ne;16;0;0;16
14528;Žibutė;BITUTĖS;4455757640;Ne;3;1;2;6
14529;Žibutė;BITUTĖS;8797870379;Ne;0;3;0;3
14530;Žibutė;BITUTĖS;7792267540;Ne;4;2;2;8
14531;Žibutė;BITUTĖS;9221523836;Ne;0;3;0;3
14532;Žibutė;BITUTĖS;3632745935;Ne;3;2;2;7
14533;Žibutė;BITUTĖS;7611641692;Ne;0;12;0;12
14534;Žibutė;BITUTĖS;5112512917;Ne;2;6;2;10
14535;Žibutė;BITUTĖS;8276724226;Ne;8;0;4;12
14536;Žibutė;BITUTĖS;4685356158;Ne;0;0;2;2
14537;Žibutė;BITUTĖS;1515636796;Ne;0;2;0;2
14538;Žibutė;BITUTĖS;7872636200;Ne;3;0;2;5
14539;Žibutė;BITUTĖS;6833179680;Ne;6;0;6;12
14540;Žibutė;BITUTĖS;1614551884;Ne;1;0;4;5
14541;Žibutė;KAČIUKAI;9611892163;Ne;5;2;4;11
14542;Žibutė;KAČIUKAI;1786332689;Ne;0;2;0;2
14543;Žibutė;KAČIUKAI;3618347199;Ne;0;3;1;4
14544;Žibutė;KAČIUKAI;5591970907;Ne;2;0;2;4
14545;Žibutė;KAČIUKAI;8879347884;Ne;11;2;5;18
14546;Žibutė;KAČIUKAI;7608622330;Ne;2;0;2;4
14547;Žibutė;KAČIUKAI;5186839413;Taip;0;3;0;3
14548;Žibutė;KAČIUKAI;4278832423;Ne;0;2;0;2
14549;Žibutė;KAČIUKAI;1381488132;Ne;6;0;4;10
14550;Žibutė;KAČIUKAI;4622674814;Ne;0;4;0;4
14551;Žibutė;KAČIUKAI;5632520305;Ne;0;0;3;3
14552;Žibutė;KAČIUKAI;7805758264;Ne;0;7;0;7
14553;Žibutė;KAČIUKAI;6672033757;Ne;0;2;1;3
14554;Žibutė;KAČIUKAI;3066580779;Ne;5;0;2;7
14555;Žibutė;KAČIUKAI;7481695788;Ne;0;0;2;2
14556;Žibutė;KAČIUKAI;8640664660;Ne;0;7;0;7
14557;Žibutė;KAČIUKAI;8155327668;Ne;0;4;0;4
14558;Žibutė;KAČIUKAI;2374119662;Ne;0;3;0;3
14559;Žibutė;ZUIKIAI;5326761360;Ne;0;3;0;3
14560;Žibutė;ZUIKIAI;4741505387;Ne;0;2;0;2
14561;Žibutė;ZUIKIAI;2787326978;Ne;10;0;2;12
14562;Žibutė;ZUIKIAI;4787010953;Ne;0;3;0;3
14563;Žibutė;ZUIKIAI;9645026432;Ne;9;4;2;15
14564;Žibutė;ZUIKIAI;3875455223;Ne;0;12;0;12
14565;Žibutė;ZUIKIAI;3449188614;Ne;0;4;0;4
14566;Žibutė;ZUIKIAI;4434623264;Ne;0;11;0;11
14567;Žibutė;ZUIKIAI;9769180056;Ne;0;6;2;8
14568;Žibutė;ZUIKIAI;2013724729;Ne;0;11;1;12
14569;Žibutė;ZUIKIAI;9379539151;Ne;0;9;0;9
14570;Žibutė;ZUIKIAI;6234135622;Ne;4;4;2;10
14571;Žibutė;ZUIKIAI;8585964720;Ne;13;1;2;16
14572;Žibutė;ZUIKIAI;9793570682;Ne;0;5;0;5
14573;Žibutė;ZUIKIAI;6618315401;Ne;6;0;6;12
14574;Žibutė;ZUIKIAI;6290821274;Ne;10;3;2;15
14575;Žibutė;ZUIKIAI;5045628452;Ne;0;9;0;9
14576;Žiedas;Bitutės;8208331527;Ne;1;0;2;3
14577;Žiedas;Bitutės;9140396365;Ne;0;0;1;1
14578;Žiedas;Bitutės;8148831014;Ne;0;2;6;8
14579;Žiedas;Bitutės;3230107921;Ne;0;3;0;3
14580;Žiedas;Bitutės;3178778438;Ne;1;9;2;12
14581;Žiedas;Bitutės;9602083568;Ne;10;2;2;14
14582;Žiedas;Bitutės;5061575884;Ne;3;3;2;8
14583;Žiedas;Bitutės;5628720422;Ne;0;6;0;6
14584;Žiedas;Bitutės;1582961378;Ne;0;1;0;1
14585;Žiedas;Bitutės;9020540780;Ne;0;2;0;2
14586;Žiedas;Bitutės;1878050384;Ne;0;1;1;2
14587;Žiedas;Bitutės;5578227349;Ne;0;3;0;3
14588;Žiedas;Bitutės;6515510381;Ne;0;1;0;1
14589;Žiedas;Bitutės;3842589827;Ne;3;2;4;9
14590;Žiedas;Bitutės;1043230748;Ne;1;11;0;12
14591;Žiedas;Bitutės;5835309107;Ne;5;2;2;9
14592;Žiedas;Bitutės;3387263016;Ne;0;2;0;2
14593;Žiedas;Bitutės;3178580610;Ne;0;3;0;3
14594;Žiedas;Varpeliai;2320543511;Ne;0;2;0;2
14595;Žiedas;Varpeliai;4699833757;Ne;2;4;2;8
14596;Žiedas;Varpeliai;8861734370;Taip;3;7;2;12
14597;Žiedas;Varpeliai;7780469974;Ne;9;2;2;13
14598;Žiedas;Varpeliai;4360175072;Ne;2;2;3;7
14599;Žiedas;Varpeliai;2149342412;Ne;0;2;0;2
14600;Žiedas;Varpeliai;1086714229;Ne;10;3;6;19
14601;Žiedas;Varpeliai;3051211643;Ne;0;2;0;2
14602;Žiedas;Varpeliai;8558784843;Ne;2;0;2;4
14603;Žiedas;Varpeliai;7445583512;Ne;0;3;2;5
14604;Žiedas;Varpeliai;1910079515;Ne;5;2;2;9
14605;Žiedas;Varpeliai;2714272604;Ne;3;3;2;8
14606;Žiedas;Varpeliai;8539301771;Ne;5;2;2;9
14607;Žiedas;Varpeliai;5108873389;Ne;4;6;5;15
14608;Žiedas;Varpeliai;2321239854;Ne;0;10;0;10
14609;Žiedas;Varpeliai;2680021778;Ne;0;2;0;2
14610;Žiedas;Varpeliai;9012779767;Ne;0;2;2;4
14611;Žiedas;Varpeliai;9400503719;Ne;1;3;2;6
14612;Žiedas;Varpeliai;2684888407;Ne;8;2;5;15
14613;Žiedas;Varpeliai;2884725931;Ne;4;3;2;9
14614;Žiedas;Ramunėlės;3055218791;Taip;0;2;0;2
14615;Žiedas;Ramunėlės;1333555044;Ne;3;2;2;7
14616;Žiedas;Ramunėlės;5789261620;Taip;4;2;5;11
14617;Žiedas;Ramunėlės;5577339739;Ne;2;2;4;8
14618;Žiedas;Ramunėlės;6884933845;Taip;0;6;0;6
14619;Žiedas;Ramunėlės;1659873036;Taip;5;2;2;9
14620;Žiedas;Ramunėlės;1243169901;Taip;0;11;0;11
14621;Žiedas;Ramunėlės;1580781723;Ne;0;2;0;2
14622;Žiedas;Ramunėlės;5920211041;Taip;0;2;1;3
14623;Žiedas;Ramunėlės;4933650089;Taip;0;2;0;2
14624;Žiedas;Ramunėlės;4044156905;Taip;2;6;2;10
14625;Žiedas;Ramunėlės;4844442247;Ne;0;7;0;7
14626;Žiedas;Ramunėlės;7294671324;Taip;0;2;1;3
14627;Žiedas;Ramunėlės;8415686253;Ne;14;2;4;20
14628;Žiedas;Ramunėlės;1309242930;Ne;4;2;2;8
14629;Žiedas;Ramunėlės;8797245208;Ne;7;1;2;10
14630;Žiedas;Ramunėlės;5635958124;Ne;5;2;2;9
14631;Žiedas;Ramunėlės;9337317396;Ne;0;3;0;3
14632;Žiedas;Ramunėlės;2320411618;Ne;9;3;4;16
14633;Žiedas;Ramunėlės;1184578906;Ne;0;1;10;11
14634;Žiedas;Pakalnutės;7798930533;Ne;3;7;4;14
14635;Žiedas;Pakalnutės;1094506858;Ne;0;2;2;4
14636;Žiedas;Pakalnutės;9375048835;Ne;5;2;4;11
14637;Žiedas;Pakalnutės;5266048033;Ne;0;6;0;6
14638;Žiedas;Pakalnutės;5804334198;Ne;0;2;0;2
14639;Žiedas;Pakalnutės;1721956438;Ne;0;3;0;3
14640;Žiedas;Pakalnutės;4808020243;Ne;0;2;0;2
14641;Žiedas;Pakalnutės;3742949697;Ne;2;4;2;8
14642;Žiedas;Pakalnutės;6343634478;Ne;0;2;2;4
14643;Žiedas;Pakalnutės;8857150598;Ne;0;4;1;5
14644;Žiedas;Pakalnutės;2416234016;Ne;0;4;0;4
14645;Žiedas;Pakalnutės;9054709268;Ne;0;6;0;6
14646;Žiedas;Pakalnutės;9964883646;Ne;0;5;0;5
14647;Žiedas;Pakalnutės;4917324037;Ne;0;2;0;2
14648;Žiedas;Pakalnutės;4021189767;Ne;0;1;0;1
14649;Žiedas;Pakalnutės;1346658299;Ne;0;3;0;3
14650;Žiedas;Pakalnutės;4663390744;Ne;2;0;2;4
14651;Žiedas;Pakalnutės;4697477761;Ne;0;1;0;1
14652;Žiedas;Pakalnutės;7678333395;Ne;0;4;1;5
14653;Žiedas;Pakalnutės;9207945616;Ne;0;3;0;3
14654;Žiedas;Pakalnutės;7221702677;Ne;0;2;0;2
14655;Žiedas;Pakalnutės;2393112381;Ne;0;4;0;4
14656;Žiedas;Rožytės;8846443535;Taip;0;3;0;3
14657;Žiedas;Rožytės;7799489700;Ne;0;15;0;15
14658;Žiedas;Rožytės;8927034492;Ne;0;22;0;22
14659;Žiedas;Rožytės;1777501190;Ne;0;2;0;2
14660;Žiedas;Rožytės;1844621525;Ne;0;2;0;2
14661;Žiedas;Rožytės;6459679214;Ne;0;17;0;17
14662;Žiedas;Rožytės;5987689515;Ne;0;4;0;4
14663;Žiedas;Rožytės;1035854293;Ne;0;2;1;3
14664;Žiedas;Rožytės;7584712202;Ne;0;2;0;2
14665;Žiedas;Rožytės;2642760082;Ne;0;4;0;4
14666;Žiedas;Rožytės;1917085385;Ne;0;5;0;5
14667;Žiedas;Rožytės;3099608553;Ne;0;5;0;5
14668;Žiedas;Rožytės;7228139235;Ne;0;1;0;1
14669;Žiedas;Rožytės;1975718197;Ne;0;0;3;3
14670;Žiedas;Rožytės;2312361963;Ne;4;4;6;14
14671;Žiedas;Rožytės;6859410675;Ne;0;3;2;5
14672;Žiedas;Rožytės;1390431397;Ne;0;1;0;1
14673;Žiedas;Rožytės;3490370918;Ne;0;8;0;8
14674;Žiedas;Rožytės;9183582003;Ne;0;8;0;8
14675;Žiedas;Pumpurėliai;1631534238;Ne;4;2;4;10
14676;Žiedas;Pumpurėliai;3994387532;Taip;0;22;0;22
14677;Žiedas;Pumpurėliai;5773778930;Ne;3;1;2;6
14678;Žiedas;Pumpurėliai;5862164657;Ne;3;4;4;11
14679;Žiedas;Pumpurėliai;9143843408;Ne;13;2;2;17
14680;Žiedas;Pumpurėliai;9833875402;Ne;0;7;0;7
14681;Žiedas;Pumpurėliai;8336518449;Ne;5;0;4;9
14682;Žiedas;Pumpurėliai;8592046023;Ne;1;3;2;6
14683;Žiedas;Pumpurėliai;9537901302;Ne;3;3;2;8
14684;Žiedas;Pumpurėliai;1980594198;Ne;10;7;2;19
14685;Žiedas;Pumpurėliai;5814371567;Ne;11;0;2;13
14686;Žiedas;Pumpurėliai;4854055565;Ne;6;2;4;12
14687;Žiedas;Pumpurėliai;7314459335;Taip;2;2;4;8
14688;Žiedas;Pumpurėliai;3075660919;Ne;5;1;2;8
14689;Žiedas;Pumpurėliai;7801566777;Ne;8;2;2;12
14690;Žiedas;Pumpurėliai;6543036900;Ne;1;3;2;6
14691;Žiedas;Pumpurėliai;8819758750;Ne;6;0;2;8
14692;Žiedas;Pumpurėliai;8297772326;Ne;1;1;2;4
14693;Žiedas;Pumpurėliai;3682750815;Ne;15;2;2;19
14694;Žiedas;Pumpurėliai;2013485224;Ne;0;0;2;2
14695;Žiedas;"Dobiliukai ";6066566242;Ne;9;2;4;15
14696;Žiedas;"Dobiliukai ";8436592169;Ne;0;4;0;4
14697;Žiedas;"Dobiliukai ";3654878543;Ne;0;3;6;9
14698;Žiedas;"Dobiliukai ";8794003030;Ne;0;3;0;3
14699;Žiedas;"Dobiliukai ";8444690698;Ne;0;2;6;8
14700;Žiedas;"Dobiliukai ";2715554681;Taip;1;4;2;7
14701;Žiedas;"Dobiliukai ";2132564079;Ne;14;2;4;20
14702;Žiedas;"Dobiliukai ";9586578606;Taip;0;7;0;7
14703;Žiedas;"Dobiliukai ";3940002957;Taip;0;3;0;3
14704;Žiedas;"Dobiliukai ";5353507617;Ne;18;2;2;22
14705;Žiedas;"Dobiliukai ";1610219365;Ne;0;5;0;5
14706;Žiedas;"Dobiliukai ";2794691006;Ne;0;4;0;4
14707;Žiedas;"Dobiliukai ";6665199013;Ne;0;8;0;8
14708;Žiedas;"Dobiliukai ";1852347789;Ne;0;2;1;3
14709;Žiedas;"Dobiliukai ";3284907486;Ne;2;1;2;5
14710;Žiedas;"Dobiliukai ";2633676360;Ne;1;2;5;8
14711;Žiedas;"Dobiliukai ";7677595571;Taip;0;4;3;7
14712;Žiedas;"Dobiliukai ";5106427067;Taip;0;5;2;7
14713;Žiedas;"Dobiliukai ";2182340305;Taip;0;2;0;2
14714;Žiedas;"Dobiliukai ";2402512731;Ne;9;2;7;18
14715;Žiedas;RŪTELĖS;1885623466;Ne;0;3;0;3
14716;Žiedas;RŪTELĖS;9464217926;Ne;0;4;0;4
14717;Žiedas;RŪTELĖS;9543860953;Ne;0;2;0;2
14718;Žiedas;RŪTELĖS;3247328978;Ne;3;3;2;8
14719;Žiedas;RŪTELĖS;4250009129;Ne;3;4;2;9
14720;Žiedas;RŪTELĖS;7399937598;Ne;7;4;2;13
14721;Žiedas;RŪTELĖS;1325715061;Ne;0;2;0;2
14722;Žiedas;RŪTELĖS;9111149805;Ne;0;2;2;4
14723;Žiedas;RŪTELĖS;4695900874;Ne;0;2;2;4
14724;Žiedas;RŪTELĖS;3258241663;Ne;5;2;2;9
14725;Žiedas;RŪTELĖS;6700593422;Ne;13;1;4;18
14726;Žiedas;RŪTELĖS;6245366671;Ne;0;1;0;1
14727;Žiedas;RŪTELĖS;3835714894;Ne;3;1;2;6
14728;Žiedas;RŪTELĖS;7535993061;Ne;0;1;0;1
14729;Žiedas;RŪTELĖS;1956219718;Ne;0;1;0;1
14730;Žiedas;RŪTELĖS;4809093267;Ne;5;2;4;11
14731;Žiedas;RŪTELĖS;6856477482;Ne;0;3;0;3
14732;Žiedas;RŪTELĖS;1874460511;Ne;0;10;0;10
14733;Žiedas;RŪTELĖS;7150427502;Ne;1;3;2;6
14734;Žiedas;RŪTELĖS;1562699898;Ne;0;3;0;3
14735;Žiedas;RŪTELĖS;1669599543;Taip;4;2;3;9
14736;Žiedas;SAULĖGRĄŽOS;1011602827;Ne;0;8;0;8
14737;Žiedas;SAULĖGRĄŽOS;8887021328;Ne;6;1;2;9
14738;Žiedas;SAULĖGRĄŽOS;2932857132;Ne;1;2;6;9
14739;Žiedas;SAULĖGRĄŽOS;5552786845;Ne;7;2;2;11
14740;Žiedas;SAULĖGRĄŽOS;8833895006;Ne;5;6;2;13
14741;Žiedas;SAULĖGRĄŽOS;5658235821;Ne;3;2;2;7
14742;Žiedas;SAULĖGRĄŽOS;4992446383;Ne;5;0;4;9
14743;Žiedas;SAULĖGRĄŽOS;9057761408;Ne;0;2;1;3
14744;Žiedas;SAULĖGRĄŽOS;1645402434;Ne;0;2;0;2
14745;Žiedas;SAULĖGRĄŽOS;2026540724;Ne;0;3;0;3
14746;Žiedas;SAULĖGRĄŽOS;4564268323;Ne;0;5;0;5
14747;Žiedas;SAULĖGRĄŽOS;8801900486;Ne;0;2;0;2
14748;Žiedas;SAULĖGRĄŽOS;1609487830;Ne;0;6;0;6
14749;Žiedas;SAULĖGRĄŽOS;3437651010;Ne;11;2;4;17
14750;Žiedas;SAULĖGRĄŽOS;3422053505;Ne;0;4;0;4
14751;Žiedas;SAULĖGRĄŽOS;5274845525;Ne;3;4;4;11
14752;Žiedas;SAULĖGRĄŽOS;6053010050;Ne;0;1;2;3
14753;Žiedas;SAULĖGRĄŽOS;7057747531;Ne;0;3;0;3
14754;Žiedas;SAULĖGRĄŽOS;8819018248;Ne;0;9;0;9
14755;Žiedas;SAULĖGRĄŽOS;7604200899;Ne;3;2;2;7
14756;Žiedas;SAULĖGRĄŽOS;3303581707;Ne;0;2;0;2
14757;Žiedas;SAULĖGRĄŽOS;2134466899;Ne;0;2;0;2
14758;Žiedas;SAULĖGRĄŽOS;6822887260;Ne;0;2;0;2
14759;Žiedas;SAULĖGRĄŽOS;1253833615;Ne;0;1;0;1
14760;Žiedas;RUGIAGĖLĖS;1826599535;Ne;3;5;4;12
14761;Žiedas;RUGIAGĖLĖS;3477341028;Ne;1;6;2;9
14762;Žiedas;RUGIAGĖLĖS;2124086277;Ne;6;3;2;11
14763;Žiedas;RUGIAGĖLĖS;7381658912;Ne;7;4;4;15
14764;Žiedas;RUGIAGĖLĖS;2148027253;Ne;5;2;2;9
14765;Žiedas;RUGIAGĖLĖS;1758868055;Ne;3;2;2;7
14766;Žiedas;RUGIAGĖLĖS;9393499257;Ne;2;4;2;8
14767;Žiedas;RUGIAGĖLĖS;8276022676;Taip;7;2;3;12
14768;Žiedas;RUGIAGĖLĖS;7418985667;Ne;0;2;0;2
14769;Žiedas;RUGIAGĖLĖS;6766710113;Ne;10;3;4;17
14770;Žiedas;RUGIAGĖLĖS;1835893385;Ne;0;3;4;7
14771;Žiedas;RUGIAGĖLĖS;3654749109;Ne;0;6;1;7
14772;Žiedas;RUGIAGĖLĖS;2913328259;Ne;8;2;4;14
14773;Žiedas;RUGIAGĖLĖS;4568189195;Ne;2;0;4;6
14774;Žiedas;RUGIAGĖLĖS;7114207461;Ne;4;2;2;8
14775;Žiedas;RUGIAGĖLĖS;3407247493;Ne;8;2;4;14
14776;Žiedas;RUGIAGĖLĖS;6923562927;Ne;3;4;3;10
14777;Žiedas;RUGIAGĖLĖS;1509140770;Ne;0;2;0;2
14778;Žiedas;RUGIAGĖLĖS;7498211984;Ne;3;2;2;7
14779;Žiedas;RUGIAGĖLĖS;3948942801;Ne;3;0;2;5
14780;Žiedas;RUGIAGĖLĖS;7441475685;Ne;1;2;2;5
14781;Žiedas;Boružėlės;9685152753;Ne;3;0;2;5
14782;Žiedas;Boružėlės;9218388800;Ne;2;4;2;8
14783;Žiedas;Boružėlės;9352485926;Ne;0;22;0;22
14784;Žiedas;Boružėlės;5914428064;Ne;0;5;0;5
14785;Žiedas;Boružėlės;3857121753;Taip;0;4;2;6
14786;Žiedas;Boružėlės;6443633568;Ne;8;3;2;13
14787;Žiedas;Boružėlės;7491134119;Ne;5;1;2;8
14788;Žiedas;Boružėlės;5959899914;Ne;0;6;0;6
14789;Žiedas;Boružėlės;7333813704;Ne;0;2;0;2
14790;Žiedas;Boružėlės;5928377774;Ne;4;2;5;11
14791;Žiedas;Boružėlės;5126173608;Ne;0;4;1;5
14792;Žiedas;Boružėlės;7072578987;Ne;0;2;1;3
14793;Žiedas;Boružėlės;5647232875;Ne;0;1;0;1
14794;Žiedas;Boružėlės;4497634040;Ne;0;0;2;2
14795;Žiedas;Boružėlės;1738121071;Ne;0;2;0;2
14796;Žiedas;AGUONĖLĖS;5518670127;Ne;8;2;4;14
14797;Žiedas;AGUONĖLĖS;2846835865;Ne;3;2;2;7
14798;Žiedas;AGUONĖLĖS;6162306565;Ne;0;2;0;2
14799;Žiedas;AGUONĖLĖS;5211681615;Ne;2;2;3;7
14800;Žiedas;AGUONĖLĖS;5947851166;Ne;2;4;2;8
14801;Žiedas;AGUONĖLĖS;8978215481;Ne;4;3;4;11
14802;Žiedas;AGUONĖLĖS;7159730702;Ne;1;1;7;9
14803;Žiedas;AGUONĖLĖS;8485801027;Ne;0;2;2;4
14804;Žiedas;AGUONĖLĖS;3634949279;Ne;0;3;0;3
14805;Žiedas;AGUONĖLĖS;1147121060;Ne;5;2;2;9
14806;Žiedas;AGUONĖLĖS;5789381608;Ne;0;4;0;4
14807;Žiedas;AGUONĖLĖS;6635256945;Ne;3;2;3;8
14808;Žiedas;AGUONĖLĖS;1642330461;Ne;2;2;2;6
14809;Žiedas;AGUONĖLĖS;5177625346;Ne;13;2;4;19
14810;Žiedas;AGUONĖLĖS;4914111970;Taip;3;3;5;11
14811;Žiedas;AGUONĖLĖS;6813477102;Ne;2;9;2;13
14812;Žiedas;ŽIBUTĖS;8638720939;Ne;6;2;2;10
14813;Žiedas;ŽIBUTĖS;4039958043;Ne;4;7;4;15
14814;Žiedas;ŽIBUTĖS;9269909624;Ne;8;2;2;12
14815;Žiedas;ŽIBUTĖS;8084555994;Ne;3;6;2;11
14816;Žiedas;ŽIBUTĖS;2935037966;Ne;8;2;4;14
14817;Žiedas;ŽIBUTĖS;6340071454;Ne;4;3;4;11
14818;Žiedas;ŽIBUTĖS;3271812706;Ne;0;0;4;4
14819;Žiedas;ŽIBUTĖS;6248399763;Ne;3;2;3;8
14820;Žiedas;ŽIBUTĖS;8163426046;Ne;5;1;2;8
14821;Žiedas;ŽIBUTĖS;4530564746;Ne;6;2;4;12
14822;Žiedas;ŽIBUTĖS;1546447912;Ne;3;0;4;7
14823;Žiedas;ŽIBUTĖS;9202969623;Ne;8;4;2;14
14824;Žiedas;ŽIBUTĖS;2065370602;Ne;0;17;0;17
14825;Žiedas;ŽIBUTĖS;3488618084;Ne;8;2;2;12
14826;Žiedas;ŽIBUTĖS;8162441626;Ne;3;3;2;8
14827;Žiedas;ŽIBUTĖS;8651843785;Ne;4;4;3;11
14828;Žiedas;ŽIBUTĖS;2853498452;Ne;3;3;2;8
14829;Žiedas;ŽIBUTĖS;9834096834;Ne;6;2;6;14
14830;Žiedas;DRUGELIAI;9763704573;Ne;0;4;0;4
14831;Žiedas;DRUGELIAI;5028265234;Ne;0;15;0;15
14832;Žiedas;DRUGELIAI;6852487760;Ne;13;2;2;17
14833;Žiedas;DRUGELIAI;8645771800;Ne;1;4;2;7
14834;Žiedas;DRUGELIAI;6041919197;Ne;3;4;6;13
14835;Žiedas;DRUGELIAI;8163645535;Ne;0;5;3;8
14836;Žiedas;DRUGELIAI;2182381160;Ne;1;2;2;5
14837;Žiedas;DRUGELIAI;8822472312;Ne;0;7;0;7
14838;Žiedas;DRUGELIAI;9021286246;Ne;0;3;0;3
14839;Žiedas;DRUGELIAI;6261847845;Ne;1;0;2;3
14840;Žiedas;DRUGELIAI;5020148822;Ne;0;2;0;2
14841;Žiedas;DRUGELIAI;1219634640;Ne;0;2;0;2
14842;Žiedas;DRUGELIAI;2170318597;Ne;0;4;0;4
14843;Žiedas;DRUGELIAI;1333233100;Ne;3;2;2;7
14844;Žiogelis;SKRUZDELYTĖS;2959983278;Ne;0;3;0;3
14845;Žiogelis;SKRUZDELYTĖS;4677024422;Ne;0;4;1;5
14846;Žiogelis;SKRUZDELYTĖS;6165380986;Ne;0;5;0;5
14847;Žiogelis;SKRUZDELYTĖS;5281321968;Ne;0;7;3;10
14848;Žiogelis;SKRUZDELYTĖS;8410428124;Ne;1;0;2;3
14849;Žiogelis;SKRUZDELYTĖS;3214640817;Ne;0;13;0;13
14850;Žiogelis;SKRUZDELYTĖS;1937740173;Ne;0;5;0;5
14851;Žiogelis;SKRUZDELYTĖS;4115425880;Ne;0;1;0;1
14852;Žiogelis;SKRUZDELYTĖS;5737326104;Ne;7;2;3;12
14853;Žiogelis;SKRUZDELYTĖS;2614574694;Ne;0;5;0;5
14854;Žiogelis;SKRUZDELYTĖS;7107814348;Ne;3;7;2;12
14855;Žiogelis;SKRUZDELYTĖS;9243862028;Ne;0;4;0;4
14856;Žiogelis;SKRUZDELYTĖS;7395901559;Ne;0;8;0;8
14857;Žiogelis;SKRUZDELYTĖS;9819352425;Ne;3;2;3;8
14858;Žiogelis;SKRUZDELYTĖS;8780773039;Ne;7;7;2;16
14859;Žiogelis;SKRUZDELYTĖS;7881734492;Ne;3;1;2;6
14860;Žiogelis;SKRUZDELYTĖS;9120836406;Ne;0;2;0;2
14861;Žiogelis;SKRUZDELYTĖS;6742462116;Ne;10;1;2;13
14862;Žiogelis;SKRUZDELYTĖS;6608146625;Ne;5;0;4;9
14863;Žiogelis;SKRUZDELYTĖS;9035254979;Ne;9;0;6;15
14864;Žiogelis;SKRUZDELYTĖS;8682279246;Ne;2;2;2;6
14865;Žiogelis;ŽIRNIUKAI;1106149118;Ne;0;3;0;3
14866;Žiogelis;ŽIRNIUKAI;9737574835;Ne;0;2;0;2
14867;Žiogelis;ŽIRNIUKAI;6284764694;Ne;3;3;2;8
14868;Žiogelis;ŽIRNIUKAI;9842311161;Ne;0;5;0;5
14869;Žiogelis;ŽIRNIUKAI;2036243422;Ne;3;2;2;7
14870;Žiogelis;ŽIRNIUKAI;6491130711;Ne;0;8;0;8
14871;Žiogelis;ŽIRNIUKAI;9378236361;Ne;6;0;2;8
14872;Žiogelis;ŽIRNIUKAI;5445409452;Ne;6;0;2;8
14873;Žiogelis;ŽIRNIUKAI;4623532521;Ne;0;1;0;1
14874;Žiogelis;ŽIRNIUKAI;6988180082;Ne;0;3;0;3
14875;Žiogelis;ŽIRNIUKAI;4677227753;Ne;0;3;0;3
14876;Žiogelis;ŽIRNIUKAI;5996045442;Ne;0;6;0;6
14877;Žiogelis;ŽIRNIUKAI;5527793395;Ne;0;8;0;8
14878;Žiogelis;ŽIRNIUKAI;4974459437;Ne;0;11;0;11
14879;Žiogelis;ŽIRNIUKAI;8664568879;Ne;0;2;0;2
14880;Žiogelis;ŽIRNIUKAI;9941105459;Ne;3;3;2;8
14881;Žiogelis;ŽIRNIUKAI;3199884855;Ne;0;0;5;5
14882;Žiogelis;ŽIRNIUKAI;5245672298;Ne;8;0;4;12
14883;Žiogelis;ŽIRNIUKAI;7804701635;Ne;3;0;5;8
14884;Žiogelis;DOBILĖLIAI;8485067381;Ne;0;15;0;15
14885;Žiogelis;DOBILĖLIAI;1618384759;Ne;0;1;0;1
14886;Žiogelis;DOBILĖLIAI;5054228916;Ne;0;2;0;2
14887;Žiogelis;DOBILĖLIAI;8712788346;Ne;0;3;0;3
14888;Žiogelis;DOBILĖLIAI;7535167450;Ne;0;0;1;1
14889;Žiogelis;DOBILĖLIAI;3361421852;Ne;2;1;2;5
14890;Žiogelis;DOBILĖLIAI;1268908081;Ne;0;4;3;7
14891;Žiogelis;DOBILĖLIAI;3856321373;Ne;0;2;3;5
14892;Žiogelis;DOBILĖLIAI;6378295945;Ne;0;2;1;3
14893;Žiogelis;DOBILĖLIAI;8959934210;Ne;0;0;1;1
14894;Žiogelis;DOBILĖLIAI;8591680136;Ne;0;2;0;2
14895;Žiogelis;DOBILĖLIAI;6980853713;Ne;5;0;3;8
14896;Žiogelis;DOBILĖLIAI;7340918175;Ne;0;2;3;5
14897;Žiogelis;DOBILĖLIAI;5487213418;Ne;0;2;0;2
14898;Žiogelis;DOBILĖLIAI;8058231095;Ne;0;2;0;2
14899;Žiogelis;DOBILĖLIAI;7702173581;Ne;0;1;0;1
14900;Žiogelis;DOBILĖLIAI;1650284820;Ne;0;1;0;1
14901;Žiogelis;DOBILĖLIAI;6515890056;Ne;0;4;2;6
14902;Žiogelis;DOBILĖLIAI;7310459638;Ne;1;2;3;6
14903;Žiogelis;DOBILĖLIAI;1763603533;Ne;11;0;3;14
14904;Žiogelis;DOBILĖLIAI;9813150014;Ne;0;3;0;3
14905;Žiogelis;BORUŽĖLĖS;8683148826;Ne;8;6;2;16
14906;Žiogelis;BORUŽĖLĖS;6532218580;Ne;1;0;5;6
14907;Žiogelis;BORUŽĖLĖS;1763070523;Ne;0;3;0;3
14908;Žiogelis;BORUŽĖLĖS;3308563362;Ne;0;3;0;3
14909;Žiogelis;BORUŽĖLĖS;2117192553;Ne;0;4;1;5
14910;Žiogelis;BORUŽĖLĖS;3427704550;Ne;0;2;0;2
14911;Žiogelis;BORUŽĖLĖS;5911231906;Ne;0;2;0;2
14912;Žiogelis;BORUŽĖLĖS;1190395481;Ne;0;2;0;2
14913;Žiogelis;BORUŽĖLĖS;6115834138;Ne;3;2;2;7
14914;Žiogelis;BORUŽĖLĖS;1465027680;Ne;3;0;3;6
14915;Žiogelis;BORUŽĖLĖS;3392582853;Ne;0;2;0;2
14916;Žiogelis;BORUŽĖLĖS;5557800297;Ne;0;2;0;2
14917;Žiogelis;BORUŽĖLĖS;6495456608;Ne;0;2;0;2
14918;Žiogelis;BORUŽĖLĖS;5364996984;Ne;0;7;0;7
14919;Žiogelis;BORUŽĖLĖS;9568208184;Ne;0;7;0;7
14920;Žiogelis;BORUŽĖLĖS;7065052244;Ne;2;1;2;5
14921;Žiogelis;BORUŽĖLĖS;6340620973;Ne;0;2;4;6
14922;Žiogelis;BORUŽĖLĖS;3887222613;Ne;0;2;1;3
14923;Žiogelis;BORUŽĖLĖS;9610249055;Ne;0;3;0;3
14924;Žiogelis;BORUŽĖLĖS;3686409773;Ne;0;3;0;3
14925;Žiogelis;BORUŽĖLĖS;2122392982;Ne;0;4;1;5
14926;Žiogelis;DRUGELIAI;2797078863;Taip;17;0;3;20
14927;Žiogelis;DRUGELIAI;3813592739;Ne;0;0;2;2
14928;Žiogelis;DRUGELIAI;3820406417;Ne;7;9;2;18
14929;Žiogelis;DRUGELIAI;9533670829;Ne;0;0;2;2
14930;Žiogelis;DRUGELIAI;1673279182;Ne;0;11;0;11
14931;Žiogelis;DRUGELIAI;9964121573;Ne;0;2;8;10
14932;Žiogelis;DRUGELIAI;5104952346;Ne;0;2;0;2
14933;Žiogelis;DRUGELIAI;9717527407;Ne;0;0;2;2
14934;Žiogelis;DRUGELIAI;2622354022;Ne;3;2;2;7
14935;Žiogelis;DRUGELIAI;7462316396;Ne;0;4;0;4
14936;Žiogelis;DRUGELIAI;2243541285;Ne;6;2;6;14
14937;Žiogelis;DRUGELIAI;2326799191;Ne;3;0;6;9
14938;Žiogelis;DRUGELIAI;1833992163;Ne;5;1;2;8
14939;Žiogelis;DRUGELIAI;4946802677;Ne;4;0;4;8
14940;Žiogelis;DRUGELIAI;8763533677;Ne;1;0;4;5
14941;Žiogelis;DRUGELIAI;4994053705;Ne;6;2;6;14
14942;Žiogelis;DRUGELIAI;2655049586;Ne;5;1;3;9
14943;Žiogelis;DRUGELIAI;4120627587;Ne;3;0;4;7
14944;Žiogelis;DRUGELIAI;7944882353;Ne;1;1;2;4
14945;Žiogelis;PELĖDŽIUKAI;7128248940;Ne;0;1;0;1
14946;Žiogelis;PELĖDŽIUKAI;6709029770;Ne;0;3;0;3
14947;Žiogelis;PELĖDŽIUKAI;7502572217;Ne;0;10;0;10
14948;Žiogelis;PELĖDŽIUKAI;5876904663;Ne;0;2;0;2
14949;Žiogelis;PELĖDŽIUKAI;8217782981;Ne;0;3;0;3
14950;Žiogelis;PELĖDŽIUKAI;7120126547;Ne;0;3;0;3
14951;Žiogelis;PELĖDŽIUKAI;9387048672;Ne;0;9;0;9
14952;Žiogelis;PELĖDŽIUKAI;3937261260;Ne;0;3;0;3
14953;Žiogelis;PELĖDŽIUKAI;8873231715;Ne;0;1;0;1
14954;Žiogelis;PELĖDŽIUKAI;8894068297;Ne;0;3;0;3
14955;Žiogelis;PELĖDŽIUKAI;2160862681;Ne;5;2;4;11
14956;Žiogelis;PELĖDŽIUKAI;7725494899;Ne;0;1;0;1
14957;Žiogelis;PELĖDŽIUKAI;8689074067;Ne;11;2;4;17
14958;Žiogelis;PELĖDŽIUKAI;4565342104;Ne;0;3;0;3
14959;Žiogelis;PELĖDŽIUKAI;1223396469;Ne;6;2;2;10
14960;Žiogelis;PELĖDŽIUKAI;3500076229;Ne;0;22;0;22
14961;Žiogelis;PELĖDŽIUKAI;8715501524;Ne;12;1;4;17
14962;Žiogelis;PELĖDŽIUKAI;6347738933;Ne;4;4;4;12
14963;Žiogelis;PELĖDŽIUKAI;3520393042;Ne;0;2;2;4
14964;Žiogelis;PELĖDŽIUKAI;1513562249;Ne;5;1;4;10
14965;Žiogelis;VARPELIAI;8983731310;Ne;0;14;0;14
14966;Žiogelis;VARPELIAI;1954544417;Ne;0;8;0;8
14967;Žiogelis;VARPELIAI;9385596579;Ne;0;5;0;5
14968;Žiogelis;VARPELIAI;1447349850;Ne;0;13;0;13
14969;Žiogelis;VARPELIAI;3752358694;Ne;0;8;0;8
14970;Žiogelis;VARPELIAI;6402784913;Ne;0;5;0;5
14971;Žiogelis;VARPELIAI;4462189852;Ne;0;10;0;10
14972;Žiogelis;VARPELIAI;9470241656;Ne;0;2;0;2
14973;Žiogelis;VARPELIAI;8133583992;Ne;0;1;0;1
14974;Žiogelis;VARPELIAI;2346231162;Ne;0;10;0;10
14975;Žiogelis;VARPELIAI;6658457517;Ne;0;9;0;9
14976;Žiogelis;VARPELIAI;6650891980;Ne;20;2;0;22
14977;Žiogelis;VARPELIAI;5076511003;Ne;2;0;2;4
14978;Žiogelis;VARPELIAI;1139259000;Ne;0;5;0;5
14979;Žiogelis;VARPELIAI;7992701275;Ne;12;1;4;17
14980;Žiogelis;VARPELIAI;2238709964;Ne;13;0;4;17
14981;Žiogelis;VARPELIAI;5288197445;Ne;0;9;0;9
14982;Žiogelis;VARPELIAI;5336455992;Ne;6;0;4;10
14983;Žiogelis;VARPELIAI;3606236367;Ne;0;5;0;5
14984;Žiogelis;VARPELIAI;5115094299;Ne;0;7;0;7
14985;Žiogelis;VARPELIAI;6942174644;Ne;2;2;2;6
14986;Žiogelis;VARPELIAI;1647252870;Ne;20;0;2;22
14987;Žiogelis;KREGŽDUTĖS;5042341085;Ne;5;0;2;7
14988;Žiogelis;KREGŽDUTĖS;9766966628;Ne;0;2;0;2
14989;Žiogelis;KREGŽDUTĖS;8835394030;Ne;0;3;0;3
14990;Žiogelis;KREGŽDUTĖS;3752355139;Ne;2;8;2;12
14991;Žiogelis;KREGŽDUTĖS;9627583831;Ne;1;5;2;8
14992;Žiogelis;KREGŽDUTĖS;3296450902;Ne;0;2;0;2
14993;Žiogelis;KREGŽDUTĖS;4814936645;Ne;3;0;2;5
14994;Žiogelis;KREGŽDUTĖS;3792114246;Ne;6;4;2;12
14995;Žiogelis;KREGŽDUTĖS;4645245689;Ne;0;3;0;3
14996;Žiogelis;KREGŽDUTĖS;9981130790;Ne;0;4;0;4
14997;Žiogelis;KREGŽDUTĖS;3820534331;Ne;0;2;0;2
14998;Žiogelis;KREGŽDUTĖS;5139645108;Ne;0;2;3;5
14999;Žiogelis;KREGŽDUTĖS;4630381709;Ne;0;2;0;2
15000;Žiogelis;KREGŽDUTĖS;9790463889;Ne;0;4;0;4
15001;Žiogelis;KREGŽDUTĖS;9874412804;Ne;7;2;2;11
15002;Žiogelis;KREGŽDUTĖS;6024752960;Ne;0;3;0;3
15003;Žiogelis;KREGŽDUTĖS;8853905367;Ne;0;3;0;3
15004;Žiogelis;KREGŽDUTĖS;1397686161;Ne;7;5;4;16
15005;Žiogelis;KREGŽDUTĖS;2171351454;Ne;3;1;2;6
15006;Žiogelis;KREGŽDUTĖS;2173494736;Ne;3;2;2;7
15007;Žiogelis;KREGŽDUTĖS;1134384178;Ne;0;2;0;2
15008;Žiogelis;KREGŽDUTĖS;4609861306;Ne;0;0;1;1
15009;Žiogelis;KREGŽDUTĖS;2759766559;Ne;5;1;5;11
15010;Žiogelis;ŽVIRBLIUKAI;6718866954;Ne;4;1;2;7
15011;Žiogelis;ŽVIRBLIUKAI;9756601090;Ne;20;0;2;22
15012;Žiogelis;ŽVIRBLIUKAI;4708377318;Ne;10;1;2;13
15013;Žiogelis;ŽVIRBLIUKAI;8601929848;Ne;0;1;0;1
15014;Žiogelis;ŽVIRBLIUKAI;2028344962;Ne;4;2;2;8
15015;Žiogelis;ŽVIRBLIUKAI;1900846262;Ne;0;13;0;13
15016;Žiogelis;ŽVIRBLIUKAI;6925485778;Ne;10;2;5;17
15017;Žiogelis;ŽVIRBLIUKAI;7539495906;Ne;3;2;2;7
15018;Žiogelis;ŽVIRBLIUKAI;2753323641;Ne;12;0;2;14
15019;Žiogelis;ŽVIRBLIUKAI;8067244838;Ne;12;0;2;14
15020;Žiogelis;ŽVIRBLIUKAI;2925961701;Ne;9;0;4;13
15021;Žiogelis;ŽVIRBLIUKAI;3407223108;Ne;3;3;1;7
15022;Žiogelis;ŽVIRBLIUKAI;4924536259;Ne;3;3;1;7
15023;Žiogelis;ŽVIRBLIUKAI;1093662117;Ne;4;0;2;6
15024;Žiogelis;ŽVIRBLIUKAI;2540274386;Ne;4;0;2;6
15025;Žiogelis;ŽVIRBLIUKAI;4602474688;Ne;2;0;2;4
15026;Žiogelis;BITUTĖS;5337641310;Ne;0;0;2;2
15027;Žiogelis;BITUTĖS;2771911603;Ne;0;6;0;6
15028;Žiogelis;BITUTĖS;4561384361;Ne;3;0;3;6
15029;Žiogelis;BITUTĖS;6617995346;Ne;1;0;2;3
15030;Žiogelis;BITUTĖS;4755709634;Ne;0;4;0;4
15031;Žiogelis;BITUTĖS;7936785905;Taip;0;3;0;3
15032;Žiogelis;BITUTĖS;2348525913;Ne;6;0;4;10
15033;Žiogelis;BITUTĖS;3628571567;Ne;0;3;0;3
15034;Žiogelis;BITUTĖS;9142952548;Ne;0;2;0;2
15035;Žiogelis;BITUTĖS;4450344120;Ne;0;2;2;4
15036;Žiogelis;BITUTĖS;5223426277;Ne;0;2;0;2
15037;Žiogelis;BITUTĖS;8998694866;Ne;3;2;2;7
15038;Žiogelis;BITUTĖS;3472310047;Ne;0;3;0;3
15039;Žiogelis;BITUTĖS;8018943297;Ne;0;1;0;1
15040;Žiogelis;BITUTĖS;3516143432;Ne;4;3;2;9
15041;Žiogelis;BITUTĖS;2833768296;Ne;0;1;6;7
15042;Žiogelis;BITUTĖS;9918493914;Ne;20;0;2;22
15043;Žiogelis;BITUTĖS;8038242532;Ne;5;0;0;5
15044;Žiogelis;BITUTĖS;2463360858;Ne;0;4;0;4
15045;Žiogelis;BITUTĖS;6857937795;Ne;8;0;6;14
15046;Žiogelis;BITUTĖS;1067136657;Ne;0;2;1;3
15047;Žiogelis;BITUTĖS;9672307977;Ne;3;1;3;7
15048;Žiogelis;BITUTĖS;2799966199;Ne;0;0;3;3
15049;Žiogelis;RIEŠUTĖLIAI;8634114085;Ne;3;1;2;6
15050;Žiogelis;RIEŠUTĖLIAI;6035707604;Ne;0;7;0;7
15051;Žiogelis;RIEŠUTĖLIAI;8743725024;Ne;3;3;2;8
15052;Žiogelis;RIEŠUTĖLIAI;9869864499;Ne;2;0;2;4
15053;Žiogelis;RIEŠUTĖLIAI;8547003106;Ne;0;3;0;3
15054;Žiogelis;RIEŠUTĖLIAI;8652050979;Ne;1;2;2;5
15055;Žiogelis;RIEŠUTĖLIAI;7428779654;Ne;3;2;5;10
15056;Žiogelis;RIEŠUTĖLIAI;3037415668;Ne;3;2;4;9
15057;Žiogelis;RIEŠUTĖLIAI;6470463492;Ne;0;7;1;8
15058;Žiogelis;RIEŠUTĖLIAI;6313053720;Ne;0;11;0;11
15059;Žiogelis;RIEŠUTĖLIAI;5146366874;Ne;0;11;0;11
15060;Žiogelis;RIEŠUTĖLIAI;8135592447;Ne;0;2;0;2
15061;Žiogelis;RIEŠUTĖLIAI;2454569485;Ne;5;1;2;8
15062;Žiogelis;RIEŠUTĖLIAI;2033139643;Ne;15;0;2;17
15063;Žiogelis;RIEŠUTĖLIAI;1578732378;Ne;0;2;0;2
15064;Žiogelis;RIEŠUTĖLIAI;3242570582;Ne;0;3;0;3
15065;Žiogelis;RIEŠUTĖLIAI;9783948483;Ne;0;2;0;2
15066;Žiogelis;PAKALNUTĖS;9863503924;Ne;0;6;0;6
15067;Žiogelis;PAKALNUTĖS;9144282935;Ne;1;0;4;5
15068;Žiogelis;PAKALNUTĖS;5741157573;Ne;0;1;0;1
15069;Žiogelis;PAKALNUTĖS;8485973974;Ne;10;0;3;13
15070;Žiogelis;PAKALNUTĖS;6039409252;Ne;0;0;2;2
15071;Žiogelis;PAKALNUTĖS;2275123126;Ne;3;0;3;6
15072;Žiogelis;PAKALNUTĖS;4587838884;Ne;0;22;0;22
15073;Žiogelis;PAKALNUTĖS;6048534817;Ne;1;0;9;10
15074;Žiogelis;PAKALNUTĖS;8303283893;Ne;0;3;2;5
15075;Žiogelis;PAKALNUTĖS;4147132498;Ne;0;2;0;2
15076;Žiogelis;PAKALNUTĖS;2724389716;Ne;5;0;3;8
15077;Žiogelis;PAKALNUTĖS;7763941077;Ne;0;6;0;6
15078;Žiogelis;PAKALNUTĖS;7008807839;Ne;5;0;3;8
15079;Žiogelis;PAKALNUTĖS;2518015116;Ne;0;0;1;1
15080;Žiogelis;PAKALNUTĖS;5475797764;Ne;4;0;4;8
15081;Žiogelis;PAKALNUTĖS;2177479618;Ne;0;0;1;1
15082;Žiogelis;PAKALNUTĖS;6213118462;Ne;0;1;0;1
15083;Žolynėlis;Spanguolėlė;8810441600;Ne;0;3;0;3
15084;Žolynėlis;Spanguolėlė;6440991320;Ne;12;3;2;17
15085;Žolynėlis;Spanguolėlė;3631138915;Ne;0;3;1;4
15086;Žolynėlis;Spanguolėlė;5218448120;Ne;2;3;2;7
15087;Žolynėlis;Spanguolėlė;4494255525;Ne;0;2;0;2
15088;Žolynėlis;Spanguolėlė;2493633505;Ne;6;0;7;13
15089;Žolynėlis;Spanguolėlė;5438607463;Ne;5;1;4;10
15090;Žolynėlis;Spanguolėlė;5208585298;Ne;0;2;2;4
15091;Žolynėlis;Spanguolėlė;9498369210;Ne;5;0;2;7
15092;Žolynėlis;Spanguolėlė;7260397656;Ne;2;0;5;7
15093;Žolynėlis;Spanguolėlė;2315947380;Ne;6;0;4;10
15094;Žolynėlis;Spanguolėlė;5074658392;Ne;6;0;4;10
15095;Žolynėlis;Spanguolėlė;6288526291;Ne;5;2;3;10
15096;Žolynėlis;Spanguolėlė;7234022613;Ne;0;2;1;3
15097;Žolynėlis;Spanguolėlė;8404728242;Ne;0;0;3;3
15098;Žolynėlis;"SAULUTĖ (spec)";9675783636;Ne;0;2;0;2
15099;Žolynėlis;"SAULUTĖ (spec)";7962304738;Ne;0;2;1;3
15100;Žolynėlis;"SAULUTĖ (spec)";3934182673;Ne;6;2;2;10
15101;Žolynėlis;"SAULUTĖ (spec)";8588753136;Ne;7;2;3;12
15102;Žolynėlis;"SAULUTĖ (spec)";9507509872;Ne;2;6;2;10
15103;Žolynėlis;"LINELIS (spec)";6510930436;Ne;0;1;2;3
15104;Žolynėlis;"LINELIS (spec)";6619551947;Ne;5;1;2;8
15105;Žolynėlis;"LINELIS (spec)";4000928238;Ne;0;3;0;3
15106;Žolynėlis;"LINELIS (spec)";1540454207;Ne;0;1;0;1
15107;Žolynėlis;"LINELIS (spec)";5610113641;Ne;4;1;2;7
15108;Žolynėlis;"LINELIS (spec)";6678697536;Ne;20;0;2;22
15109;Žolynėlis;"LINELIS (spec)";3043560150;Ne;11;2;4;17
15110;Žolynėlis;"RASAKILA (spec)";4971887781;Ne;0;1;0;1
15111;Žolynėlis;"RASAKILA (spec)";8839037219;Ne;0;1;0;1
15112;Žolynėlis;"RASAKILA (spec)";4481343085;Ne;5;2;2;9
15113;Žolynėlis;"RASAKILA (spec)";8577197481;Ne;6;4;4;14
15114;Žolynėlis;"RASAKILA (spec)";1412336878;Ne;0;3;2;5
15115;Žolynėlis;"RASAKILA (spec)";2327996393;Ne;5;3;4;12
15116;Žolynėlis;"RAMUNĖLĖS (spec)";4559404699;Ne;1;2;5;8
15117;Žolynėlis;"RAMUNĖLĖS (spec)";1703785525;Ne;4;4;5;13
15118;Žolynėlis;"RAMUNĖLĖS (spec)";2072569949;Ne;0;4;7;11
15119;Žolynėlis;"RAMUNĖLĖS (spec)";5729519418;Ne;0;0;2;2
15120;Žolynėlis;"RAMUNĖLĖS (spec)";7266224868;Ne;4;0;4;8
15121;Žolynėlis;"RAMUNĖLĖS (spec)";7085655808;Ne;2;1;2;5
15122;Žolynėlis;"RAMUNĖLĖS (spec)";3748657353;Ne;3;4;4;11
15123;Žolynėlis;Dobiliukai;2005661306;Ne;2;3;2;7
15124;Žolynėlis;Dobiliukai;2820649587;Ne;0;5;1;6
15125;Žolynėlis;Dobiliukai;7581436340;Ne;20;0;2;22
15126;Žolynėlis;Dobiliukai;3385748516;Ne;3;3;4;10
15127;Žolynėlis;Dobiliukai;5456771327;Ne;3;0;2;5
15128;Žolynėlis;Dobiliukai;5634886191;Ne;13;3;4;20
15129;Žolynėlis;Dobiliukai;3350246193;Ne;2;1;2;5
15130;Žolynėlis;Dobiliukai;5269388947;Ne;0;2;0;2
15131;Žolynėlis;Dobiliukai;1206144208;Ne;2;2;2;6
15132;Žolynėlis;Dobiliukai;1213384150;Ne;0;5;0;5
15133;Žolynėlis;Dobiliukai;7485033527;Ne;0;3;0;3
15134;Žolynėlis;Dobiliukai;4462289757;Ne;2;3;2;7
15135;Žolynėlis;Dobiliukai;6124252688;Ne;0;7;0;7
15136;Žolynėlis;Dobiliukai;4229530366;Ne;12;4;4;20
15137;Žolynėlis;Aguonėlė;3071570864;Ne;3;2;3;8
15138;Žolynėlis;Aguonėlė;1440666914;Ne;0;1;0;1
15139;Žolynėlis;Aguonėlė;1365534272;Ne;3;1;2;6
15140;Žolynėlis;Aguonėlė;2628636018;Ne;1;2;2;5
15141;Žolynėlis;Aguonėlė;6740105842;Ne;0;7;0;7
15142;Žolynėlis;Aguonėlė;3952731134;Ne;0;4;0;4
15143;Žolynėlis;Aguonėlė;5243624422;Ne;2;2;2;6
15144;Žolynėlis;Aguonėlė;1748987196;Ne;0;9;0;9
15145;Žolynėlis;Aguonėlė;4094173207;Ne;4;0;2;6
15146;Žolynėlis;Aguonėlė;6034854963;Ne;0;17;0;17
15147;Žolynėlis;Pienė;3520272555;Ne;0;2;0;2
15148;Žolynėlis;Pienė;1163753820;Ne;0;2;0;2
15149;Žolynėlis;Pienė;9238832484;Ne;0;3;0;3
15150;Žolynėlis;Pienė;3877168024;Ne;5;2;2;9
15151;Žolynėlis;Pienė;4618251201;Ne;0;5;0;5
15152;Žolynėlis;Pienė;1264022895;Ne;5;3;2;10
15153;Žolynėlis;Pienė;8697184617;Ne;0;2;0;2
15154;Žolynėlis;Pienė;8713225753;Ne;0;1;0;1
15155;Žolynėlis;Pienė;5332349177;Ne;0;5;0;5
15156;Žolynėlis;Pienė;3091749692;Ne;0;2;0;2
15157;Žolynėlis;Pienė;2263679711;Ne;5;5;2;12
15158;Žolynėlis;Pienė;5149512625;Ne;0;2;0;2
15159;Žolynėlis;Pienė;5973298389;Ne;4;4;2;10
15160;Žolynėlis;Pienė;4048788625;Ne;0;5;0;5
15161;Žolynėlis;Pienė;8552635547;Ne;0;0;2;2
15162;Žolynėlis;Pienė;2256262371;Ne;0;7;0;7
15163;Žolynėlis;Čiobreliai;8215427354;Ne;0;7;1;8
15164;Žolynėlis;Čiobreliai;7339496409;Ne;0;1;1;2
15165;Žolynėlis;Čiobreliai;2565770471;Ne;5;1;2;8
15166;Žolynėlis;Čiobreliai;6829144389;Ne;0;2;0;2
15167;Žolynėlis;Čiobreliai;7256502393;Ne;0;4;0;4
15168;Žolynėlis;Čiobreliai;2108221942;Ne;0;5;0;5
15169;Žolynėlis;Čiobreliai;2881461471;Ne;0;3;0;3
15170;Žolynėlis;Čiobreliai;7339110559;Ne;0;2;0;2
15171;Žolynėlis;Čiobreliai;2460982987;Ne;0;1;0;1
15172;Žolynėlis;Čiobreliai;7980206574;Ne;5;0;2;7
15173;Žolynėlis;Čiobreliai;3088932720;Ne;2;6;2;10
15174;Žolynėlis;Čiobreliai;4758738231;Ne;0;3;1;4
15175;Žolynėlis;Čiobreliai;6024288147;Ne;0;3;0;3
15176;Žolynėlis;Čiobreliai;1485195267;Ne;0;2;0;2
15177;Žolynėlis;Čiobreliai;6763515483;Ne;2;1;2;5
15178;Žolynėlis;Čiobreliai;5432464074;Ne;0;2;0;2
15179;Žolynėlis;Čiobreliai;6416217971;Ne;5;7;2;14
15180;Žolynėlis;Čiobreliai;1879046798;Ne;0;1;0;1
15181;Žolynėlis;Čiobreliai;2934361190;Ne;0;2;0;2
15182;Žolynėlis;Čiobreliai;8510764089;Ne;0;3;0;3
15183;Žolynėlis;Avietėlė;4277871671;Ne;0;2;0;2
15184;Žolynėlis;Avietėlė;9404844632;Ne;0;2;0;2
15185;Žolynėlis;Avietėlė;5873931225;Ne;1;2;2;5
15186;Žolynėlis;Avietėlė;1266614631;Ne;3;0;2;5
15187;Žolynėlis;Avietėlė;7855260478;Ne;0;2;0;2
15188;Žolynėlis;Avietėlė;2718255075;Ne;0;10;0;10
15189;Žolynėlis;Avietėlė;6417150398;Taip;2;0;2;4
15190;Žolynėlis;Avietėlė;7517815798;Ne;3;0;5;8
15191;Žolynėlis;Avietėlė;1108820859;Ne;3;7;2;12
15192;Žolynėlis;Avietėlė;9905727117;Ne;2;2;4;8
15193;Žolynėlis;Avietėlė;4221470753;Ne;4;2;2;8
15194;Žolynėlis;Avietėlė;5234937076;Ne;0;0;4;4
15195;Žolynėlis;RŪTELĖ;3293250169;Ne;2;0;4;6
15196;Žolynėlis;RŪTELĖ;9993230229;Ne;0;4;0;4
15197;Žolynėlis;RŪTELĖ;2727273826;Ne;2;0;4;6
15198;Žolynėlis;RŪTELĖ;7264446456;Ne;0;2;1;3
15199;Žolynėlis;RŪTELĖ;3857544079;Ne;10;0;4;14
15200;Žolynėlis;RŪTELĖ;1130456335;Ne;0;0;4;4
15201;Žolynėlis;RŪTELĖ;3401352504;Ne;0;2;2;4
15202;Žolynėlis;RŪTELĖ;5175997689;Ne;6;0;2;8
15203;Žolynėlis;RŪTELĖ;8534977952;Ne;0;2;2;4
15204;Žolynėlis;RŪTELĖ;4780520358;Ne;5;0;3;8
15205;Žolynėlis;RŪTELĖ;3804251134;Ne;0;2;3;5
15206;Žolynėlis;RŪTELĖ;2181156327;Ne;2;4;3;9
15207;Žolynėlis;RŪTELĖ;5184931936;Ne;7;0;5;12
15208;Žolynėlis;RŪTELĖ;5666650566;Ne;11;0;5;16
15209;Žolynėlis;RŪTELĖ;5769654742;Ne;13;3;4;20
15210;Žolynėlis;RŪTELĖ;6808975784;Ne;0;0;2;2
15211;Žuvėdra;"JŪROS ŽVAIGŽDUTĖS";1200084485;Ne;0;5;0;5
15212;Žuvėdra;"JŪROS ŽVAIGŽDUTĖS";4177319374;Ne;0;2;0;2
15213;Žuvėdra;"JŪROS ŽVAIGŽDUTĖS";7121154799;Ne;0;20;0;20
15214;Žuvėdra;"JŪROS ŽVAIGŽDUTĖS";8162649794;Ne;1;0;2;3
15215;Žuvėdra;"JŪROS ŽVAIGŽDUTĖS";7710853637;Ne;0;8;0;8
15216;Žuvėdra;"JŪROS ŽVAIGŽDUTĖS";2858729034;Ne;11;3;3;17
15217;Žuvėdra;"JŪROS ŽVAIGŽDUTĖS";7958768355;Ne;0;1;0;1
15218;Žuvėdra;"JŪROS ŽVAIGŽDUTĖS";6672289932;Ne;3;2;2;7
15219;Žuvėdra;"JŪROS ŽVAIGŽDUTĖS";5571732399;Ne;0;2;17;19
15220;Žuvėdra;"JŪROS ŽVAIGŽDUTĖS";3620753237;Ne;0;0;3;3
15221;Žuvėdra;"JŪROS ŽVAIGŽDUTĖS";6651984898;Ne;2;1;2;5
15222;Žuvėdra;"JŪROS ŽVAIGŽDUTĖS";1974766090;Ne;7;5;4;16
15223;Žuvėdra;"JŪROS ŽVAIGŽDUTĖS";8869169590;Taip;8;5;2;15
15224;Žuvėdra;"JŪROS ŽVAIGŽDUTĖS";5436158437;Ne;5;1;0;6
15225;Žuvėdra;"JŪROS ŽVAIGŽDUTĖS";2082128566;Ne;0;18;0;18
15226;Žuvėdra;"JŪROS ŽVAIGŽDUTĖS";2582404760;Ne;3;3;2;8
15227;Žuvėdra;"JŪROS ŽVAIGŽDUTĖS";6952843736;Ne;0;7;0;7
15228;Žuvėdra;"JŪROS ŽVAIGŽDUTĖS";3616821462;Ne;0;3;0;3
15229;Žuvėdra;DELFINUKAI;7235005234;Ne;8;0;2;10
15230;Žuvėdra;DELFINUKAI;5876618912;Ne;8;7;2;17
15231;Žuvėdra;DELFINUKAI;6989906913;Ne;0;6;0;6
15232;Žuvėdra;DELFINUKAI;4702627979;Ne;13;1;2;16
15233;Žuvėdra;DELFINUKAI;6327915228;Ne;4;0;2;6
15234;Žuvėdra;DELFINUKAI;7803397430;Ne;4;0;3;7
15235;Žuvėdra;DELFINUKAI;7705946236;Taip;16;0;3;19
15236;Žuvėdra;DELFINUKAI;3069506904;Ne;6;0;6;12
15237;Žuvėdra;DELFINUKAI;5913580058;Ne;8;0;5;13
15238;Žuvėdra;DELFINUKAI;9651268462;Ne;3;0;6;9
15239;Žuvėdra;DELFINUKAI;3423051494;Ne;9;1;3;13
15240;Žuvėdra;DELFINUKAI;8111760611;Ne;5;0;2;7
15241;Žuvėdra;DELFINUKAI;1993897043;Ne;6;7;2;15
15242;Žuvėdra;DELFINUKAI;9200342856;Taip;9;0;2;11
15243;Žuvėdra;DELFINUKAI;1604010000;Ne;0;11;0;11
15244;Žuvėdra;DELFINUKAI;2844920302;Ne;0;0;3;3
15245;Žuvėdra;DELFINUKAI;2323431685;Ne;5;2;2;9
15246;Žuvėdra;OSMINOŽKI;5273726957;Ne;0;3;0;3
15247;Žuvėdra;OSMINOŽKI;5674529681;Ne;3;3;2;8
15248;Žuvėdra;OSMINOŽKI;7368183516;Ne;0;5;0;5
15249;Žuvėdra;OSMINOŽKI;3853045274;Ne;0;16;0;16
15250;Žuvėdra;OSMINOŽKI;3185158741;Ne;3;4;2;9
15251;Žuvėdra;OSMINOŽKI;5198825127;Ne;4;2;4;10
15252;Žuvėdra;OSMINOŽKI;5561903903;Ne;3;4;4;11
15253;Žuvėdra;OSMINOŽKI;4907571967;Ne;0;0;2;2
15254;Žuvėdra;OSMINOŽKI;3613045982;Ne;6;3;2;11
15255;Žuvėdra;OSMINOŽKI;7467154866;Ne;0;22;0;22
15256;Žuvėdra;OSMINOŽKI;5151984122;Ne;0;5;0;5
15257;Žuvėdra;OSMINOŽKI;8670342549;Ne;0;1;0;1
15258;Žuvėdra;OSMINOŽKI;6715416675;Ne;1;0;4;5
15259;Žuvėdra;OSMINOŽKI;3349158713;Ne;6;2;4;12
15260;Žuvėdra;OSMINOŽKI;8942228415;Ne;0;2;0;2
15261;Žuvėdra;OSMINOŽKI;4715123063;Ne;0;4;0;4
15262;Žuvėdra;RUSALAČKA;1707519901;Ne;12;1;0;13
15263;Žuvėdra;RUSALAČKA;1810114962;Ne;0;2;0;2
15264;Žuvėdra;RUSALAČKA;1960306957;Ne;0;14;0;14
15265;Žuvėdra;RUSALAČKA;2640238143;Ne;0;0;4;4
15266;Žuvėdra;RUSALAČKA;2577280901;Ne;13;0;4;17
15267;Žuvėdra;RUSALAČKA;5481785360;Ne;8;0;2;10
15268;Žuvėdra;RUSALAČKA;9011276878;Ne;4;3;2;9
15269;Žuvėdra;RUSALAČKA;7387863175;Ne;0;13;0;13
15270;Žuvėdra;RUSALAČKA;3058300342;Ne;0;2;0;2
15271;Žuvėdra;RUSALAČKA;7227722516;Ne;5;1;4;10
15272;Žuvėdra;RUSALAČKA;1219808187;Ne;3;3;2;8
15273;Žuvėdra;RUSALAČKA;7908898376;Ne;0;0;3;3
15274;Žuvėdra;RUSALAČKA;2197976174;Ne;2;2;2;6
15275;Žuvėdra;RUSALAČKA;3781157324;Ne;2;1;2;5
15276;Žuvėdra;RUSALAČKA;1039661177;Ne;4;1;2;7
15277;Žuvėdra;JANTARIKI;1929548863;Ne;8;3;3;14
15278;Žuvėdra;JANTARIKI;2789379055;Ne;6;0;6;12
15279;Žuvėdra;JANTARIKI;9610223932;Ne;8;0;2;10
15280;Žuvėdra;JANTARIKI;9410938471;Ne;12;3;0;15
15281;Žuvėdra;JANTARIKI;1526878181;Ne;15;0;4;19
15282;Žuvėdra;JANTARIKI;5272918949;Ne;5;11;2;18
15283;Žuvėdra;JANTARIKI;1352508839;Ne;0;8;0;8
15284;Žuvėdra;JANTARIKI;8224363978;Ne;7;0;0;7
15285;Žuvėdra;JANTARIKI;1224866951;Ne;2;0;2;4
15286;Žuvėdra;JANTARIKI;3190173500;Ne;2;1;1;4
15287;Žuvėdra;"AUKSINĖ ŽUVELĖ";6287034023;Ne;0;1;0;1
15288;Žuvėdra;"AUKSINĖ ŽUVELĖ";9460887312;Ne;6;2;2;10
15289;Žuvėdra;"AUKSINĖ ŽUVELĖ";5009153711;Ne;4;1;2;7
15290;Žuvėdra;"AUKSINĖ ŽUVELĖ";4739865462;Ne;6;0;5;11
15291;Žuvėdra;"AUKSINĖ ŽUVELĖ";7135848009;Taip;0;1;1;2
15292;Žuvėdra;"AUKSINĖ ŽUVELĖ";9215777054;Taip;3;1;2;6
15293;Žuvėdra;"AUKSINĖ ŽUVELĖ";4217169024;Ne;10;0;2;12
15294;Žuvėdra;"AUKSINĖ ŽUVELĖ";6451721553;Ne;11;2;4;17
15295;Žuvėdra;"AUKSINĖ ŽUVELĖ";4447517071;Ne;4;0;4;8
15296;Žuvėdra;"AUKSINĖ ŽUVELĖ";2118573300;Ne;10;0;2;12
15297;Žuvėdra;"AUKSINĖ ŽUVELĖ";7083794325;Ne;4;0;4;8
15298;Žuvėdra;"AUKSINĖ ŽUVELĖ";4207664070;Ne;4;0;2;6
15299;Žvangutis;PELIUKŲ;7616874368;Ne;1;1;2;4
15300;Žvangutis;PELIUKŲ;3906808900;Ne;0;1;0;1
15301;Žvangutis;PELIUKŲ;7722153982;Ne;0;2;0;2
15302;Žvangutis;PELIUKŲ;4295016449;Ne;0;8;0;8
15303;Žvangutis;PELIUKŲ;9958554027;Ne;0;2;0;2
15304;Žvangutis;PELIUKŲ;8592522675;Ne;0;3;0;3
15305;Žvangutis;PELIUKŲ;3957064486;Ne;2;0;2;4
15306;Žvangutis;PELIUKŲ;5817402847;Ne;12;5;0;17
15307;Žvangutis;PELIUKŲ;4407484687;Ne;0;3;2;5
15308;Žvangutis;PELIUKŲ;5638068914;Ne;10;11;1;22
15309;Žvangutis;PELIUKŲ;4337928288;Ne;2;3;2;7
15310;Žvangutis;PELIUKŲ;8062689240;Ne;0;2;0;2
15311;Žvangutis;PELIUKŲ;3875906173;Ne;0;3;0;3
15312;Žvangutis;PELIUKŲ;1328464199;Ne;6;7;2;15
15313;Žvangutis;PELIUKŲ;3546672690;Ne;0;2;0;2
15314;Žvangutis;PELIUKŲ;4992231141;Ne;0;2;1;3
15315;Žvangutis;PELIUKŲ;3408933802;Ne;1;1;2;4
15316;Žvangutis;PELIUKŲ;8481666202;Ne;2;6;2;10
15317;Žvangutis;PELIUKŲ;4705131089;Ne;2;0;0;2
15318;Žvangutis;PELIUKŲ;7844987649;Ne;0;2;1;3
15319;Žvangutis;ANČIUKŲ;5539992579;Ne;0;4;0;4
15320;Žvangutis;ANČIUKŲ;2411307963;Ne;3;2;2;7
15321;Žvangutis;ANČIUKŲ;8295525284;Ne;0;1;0;1
15322;Žvangutis;ANČIUKŲ;6068428687;Ne;0;2;0;2
15323;Žvangutis;ANČIUKŲ;9468660351;Ne;0;2;0;2
15324;Žvangutis;ANČIUKŲ;9149037184;Ne;0;5;0;5
15325;Žvangutis;ANČIUKŲ;1404378308;Ne;0;7;0;7
15326;Žvangutis;ANČIUKŲ;1185135525;Ne;5;3;1;9
15327;Žvangutis;ANČIUKŲ;5012996199;Ne;1;2;2;5
15328;Žvangutis;ANČIUKŲ;2623107843;Ne;0;2;0;2
15329;Žvangutis;ANČIUKŲ;3276065009;Ne;1;1;2;4
15330;Žvangutis;ANČIUKŲ;1282567366;Ne;0;1;0;1
15331;Žvangutis;ANČIUKŲ;2570379643;Ne;2;2;2;6
15332;Žvangutis;ANČIUKŲ;9036869235;Ne;0;4;0;4
15333;Žvangutis;ANČIUKŲ;2922083476;Ne;0;2;0;2
15334;Žvangutis;ANČIUKŲ;6207989105;Ne;0;2;0;2
15335;Žvangutis;ANČIUKŲ;2755838558;Ne;0;1;0;1
15336;Žvangutis;ANČIUKŲ;6040986672;Ne;6;7;2;15
15337;Žvangutis;ANČIUKŲ;2716216474;Ne;0;2;0;2
15338;Žvangutis;PELĖDŽIUKŲ;7599491698;Ne;8;2;2;12
15339;Žvangutis;PELĖDŽIUKŲ;6094686500;Taip;0;0;1;1
15340;Žvangutis;PELĖDŽIUKŲ;2049990751;Ne;0;0;2;2
15341;Žvangutis;PELĖDŽIUKŲ;9711017196;Ne;5;1;3;9
15342;Žvangutis;PELĖDŽIUKŲ;8906823569;Ne;8;3;2;13
15343;Žvangutis;PELĖDŽIUKŲ;8753815074;Taip;6;0;3;9
15344;Žvangutis;PELĖDŽIUKŲ;3781959962;Ne;8;1;2;11
15345;Žvangutis;PELĖDŽIUKŲ;8506809320;Ne;5;3;1;9
15346;Žvangutis;PELĖDŽIUKŲ;8376022173;Ne;3;2;2;7
15347;Žvangutis;PELĖDŽIUKŲ;6825952779;Ne;6;2;2;10
15348;Žvangutis;PELĖDŽIUKŲ;4920234186;Ne;0;8;0;8
15349;Žvangutis;PELĖDŽIUKŲ;8598396569;Ne;7;2;2;11
15350;Žvangutis;PELĖDŽIUKŲ;1590704985;Ne;1;0;2;3
15351;Žvangutis;PELĖDŽIUKŲ;9306755042;Ne;5;0;2;7
15352;Žvangutis;PELĖDŽIUKŲ;1352736819;Taip;0;2;1;3
15353;Žvangutis;PELĖDŽIUKŲ;2298103025;Ne;0;5;0;5
15354;Žvangutis;PELĖDŽIUKŲ;9523189658;Ne;8;0;2;10
15355;Žvangutis;PELĖDŽIUKŲ;5126809299;Ne;8;0;2;10
15356;Žvangutis;PELĖDŽIUKŲ;9883337991;Taip;17;0;2;19
15357;Žvangutis;KAČIUKŲ;7213349517;Ne;0;4;0;4
15358;Žvangutis;KAČIUKŲ;7581320158;Ne;0;0;2;2
15359;Žvangutis;KAČIUKŲ;2296360416;Ne;2;4;2;8
15360;Žvangutis;KAČIUKŲ;7721746116;Ne;0;3;0;3
15361;Žvangutis;KAČIUKŲ;2598842770;Ne;0;3;0;3
15362;Žvangutis;KAČIUKŲ;1142315595;Ne;0;3;0;3
15363;Žvangutis;KAČIUKŲ;9239279639;Ne;0;2;0;2
15364;Žvangutis;KAČIUKŲ;4696437804;Ne;0;2;2;4
15365;Žvangutis;KAČIUKŲ;8492637734;Ne;0;3;0;3
15366;Žvangutis;KAČIUKŲ;2503355659;Ne;0;0;2;2
15367;Žvangutis;KAČIUKŲ;8863909185;Ne;0;11;0;11
15368;Žvangutis;KAČIUKŲ;3498584864;Ne;0;4;0;4
15369;Žvangutis;KAČIUKŲ;4408086513;Ne;0;11;0;11
15370;Žvangutis;KAČIUKŲ;1256264382;Ne;0;9;0;9
15371;Žvangutis;KAČIUKŲ;8030520477;Ne;0;2;0;2
15372;Žvangutis;KAČIUKŲ;5166614226;Ne;2;0;0;2
15373;Žvangutis;KAČIUKŲ;8810739982;Ne;2;0;1;3
15374;Žvangutis;KAČIUKŲ;2740875969;Ne;3;0;1;4
15375;Žvangutis;KAČIUKŲ;8269992031;Ne;2;1;7;10
15376;Žvangutis;KAČIUKŲ;1224292338;Ne;2;0;1;3
15377;Žvangutis;MEŠKUČIŲ;5714127995;Ne;3;2;1;6
15378;Žvangutis;MEŠKUČIŲ;8515349879;Ne;4;0;2;6
15379;Žvangutis;MEŠKUČIŲ;8841791656;Ne;0;1;0;1
15380;Žvangutis;MEŠKUČIŲ;7007117864;Ne;0;1;0;1
15381;Žvangutis;MEŠKUČIŲ;5162865213;Ne;5;0;3;8
15382;Žvangutis;MEŠKUČIŲ;8081046191;Ne;0;2;0;2
15383;Žvangutis;MEŠKUČIŲ;2671205721;Ne;0;22;0;22
15384;Žvangutis;MEŠKUČIŲ;2148237530;Ne;1;5;0;6
15385;Žvangutis;MEŠKUČIŲ;6424312740;Ne;0;2;0;2
15386;Žvangutis;MEŠKUČIŲ;8324813274;Ne;7;1;4;12
15387;Žvangutis;MEŠKUČIŲ;7098816023;Taip;6;0;4;10
15388;Žvangutis;MEŠKUČIŲ;3734153710;Ne;5;0;2;7
15389;Žvangutis;MEŠKUČIŲ;5780339899;Ne;4;4;4;12
15390;Žvangutis;MEŠKUČIŲ;6189100246;Ne;0;2;0;2
15391;Žvangutis;MEŠKUČIŲ;6329268519;Ne;7;0;4;11
15392;Žvangutis;MEŠKUČIŲ;5579521166;Ne;6;0;4;10
15393;Žvangutis;MEŠKUČIŲ;9671139568;Ne;2;0;0;2
15394;Žvangutis;KIŠKUČIŲ;3940893168;Ne;1;2;2;5
15395;Žvangutis;KIŠKUČIŲ;1592158260;Ne;6;1;2;9
15396;Žvangutis;KIŠKUČIŲ;5022657156;Ne;0;0;4;4
15397;Žvangutis;KIŠKUČIŲ;7645908955;Ne;10;0;3;13
15398;Žvangutis;KIŠKUČIŲ;6741623841;Ne;4;1;2;7
15399;Žvangutis;KIŠKUČIŲ;3029382724;Ne;3;2;6;11
15400;Žvangutis;KIŠKUČIŲ;4128856598;Ne;9;0;3;12
15401;Žvangutis;KIŠKUČIŲ;4968365511;Taip;16;0;2;18
15402;Žvangutis;KIŠKUČIŲ;1706200292;Ne;8;0;3;11
15403;Žvangutis;KIŠKUČIŲ;5328547183;Ne;2;0;2;4
15404;Žvangutis;KIŠKUČIŲ;6511539983;Ne;5;0;2;7
15405;Žvangutis;KIŠKUČIŲ;4471191112;Ne;0;16;0;16
15406;Žvangutis;KIŠKUČIŲ;6768957624;Ne;3;2;2;7
15407;Žvangutis;KIŠKUČIŲ;8514691010;Ne;0;0;17;17
15408;Žvangutis;KIŠKUČIŲ;8233392333;Ne;7;2;4;13
15409;Žvangutis;KIŠKUČIŲ;2284700283;Ne;1;0;2;3
15410;Žvangutis;KIŠKUČIŲ;9292902597;Taip;6;0;4;10
15411;Žirniukas;Boružiukų;5311746004;Ne;0;2;15;17
15412;Žirniukas;Boružiukų;2476906136;Ne;0;2;1;3
15413;Žirniukas;Boružiukų;2528905738;Ne;3;4;5;12
15414;Žirniukas;Boružiukų;6268788036;Ne;0;3;0;3
15415;Žirniukas;Boružiukų;6363169823;Ne;0;17;0;17
15416;Žirniukas;Boružiukų;2636634198;Ne;0;4;1;5
15417;Žirniukas;Boružiukų;8148254025;Ne;4;2;3;9
15418;Žirniukas;Boružiukų;6531175340;Ne;0;4;1;5
15419;Žirniukas;Boružiukų;9647374339;Ne;0;4;0;4
15420;Žirniukas;Boružiukų;3022672028;Ne;6;12;2;20
15421;Žirniukas;Boružiukų;8180092480;Ne;0;0;2;2
15422;Žirniukas;Boružiukų;7397202752;Ne;0;4;7;11
15423;Žirniukas;Boružiukų;4233026576;Ne;0;6;0;6
15424;Žirniukas;Boružiukų;6598851580;Ne;0;2;9;11
15425;Žirniukas;Boružiukų;7965050711;Ne;0;2;2;4
15426;Žirniukas;Boružiukų;9986289837;Ne;0;2;4;6
15427;Žirniukas;Boružiukų;7872611724;Ne;2;3;2;7
15428;Žirniukas;Boružiukų;3189741449;Ne;0;2;0;2
15429;Žirniukas;Boružiukų;2140863010;Ne;0;0;22;22
15430;Žirniukas;Smalsučiai;5819443551;Ne;0;2;0;2
15431;Žirniukas;Smalsučiai;6096664609;Ne;0;2;0;2
15432;Žirniukas;Smalsučiai;1074945082;Ne;3;0;5;8
15433;Žirniukas;Smalsučiai;4433579937;Ne;0;2;0;2
15434;Žirniukas;Smalsučiai;1594735501;Ne;1;2;2;5
15435;Žirniukas;Smalsučiai;4229687519;Ne;3;0;2;5
15436;Žirniukas;Smalsučiai;2733313392;Ne;11;2;2;15
15437;Žirniukas;Smalsučiai;9707776533;Taip;0;3;2;5
15438;Žirniukas;Smalsučiai;7278153529;Taip;0;3;2;5
15439;Žirniukas;Smalsučiai;8151071354;Ne;0;3;0;3
15440;Žirniukas;Smalsučiai;7927815250;Ne;0;5;0;5
15441;Žirniukas;Smalsučiai;2325139043;Ne;4;2;2;8
15442;Žirniukas;Smalsučiai;4527367786;Ne;0;2;0;2
15443;Žirniukas;Smalsučiai;8599313527;Ne;1;6;2;9
15444;Žirniukas;Smalsučiai;4320686646;Ne;0;7;2;9
15445;Žirniukas;Smalsučiai;3610402086;Ne;0;2;0;2
15446;Žirniukas;Smalsučiai;9961947583;Ne;1;2;2;5
15447;Žirniukas;Smalsučiai;4045432303;Ne;3;2;2;7
15448;Žirniukas;Gėlyčių;2982628594;Ne;0;1;0;1
15449;Žirniukas;Gėlyčių;6121388208;Ne;11;3;2;16
15450;Žirniukas;Gėlyčių;6201949014;Ne;0;0;3;3
15451;Žirniukas;Gėlyčių;9497414375;Ne;0;2;6;8
15452;Žirniukas;Gėlyčių;6147030672;Ne;8;0;4;12
15453;Žirniukas;Gėlyčių;2423974973;Ne;8;0;2;10
15454;Žirniukas;Gėlyčių;2789026451;Ne;0;0;6;6
15455;Žirniukas;Gėlyčių;9507651487;Ne;4;0;5;9
15456;Žirniukas;Gėlyčių;1368553187;Ne;12;0;4;16
15457;Žirniukas;Gėlyčių;2221770310;Ne;12;2;4;18
15458;Žirniukas;Gėlyčių;5925420191;Ne;5;0;6;11
15459;Žirniukas;Gėlyčių;5554441466;Ne;14;0;2;16
15460;Žirniukas;Gėlyčių;6788087742;Ne;8;0;2;10
15461;Žirniukas;Gėlyčių;5317756167;Ne;2;2;2;6
15462;Žirniukas;Nykštukų;2489070480;Ne;0;0;1;1
15463;Žirniukas;Nykštukų;5734197350;Ne;0;0;2;2
15464;Žirniukas;Nykštukų;2746074694;Ne;0;2;0;2
15465;Žirniukas;Nykštukų;4282344625;Ne;0;2;0;2
15466;Žirniukas;Nykštukų;3874713264;Ne;0;4;0;4
15467;Žirniukas;Nykštukų;1532129054;Ne;0;2;0;2
15468;Žirniukas;Nykštukų;7368124402;Ne;7;2;6;15
15469;Žirniukas;Nykštukų;1635353228;Ne;5;1;4;10
15470;Žirniukas;Nykštukų;2526769571;Ne;2;0;4;6
15471;Žirniukas;Nykštukų;2027344763;Ne;0;1;2;3
15472;Žirniukas;Nykštukų;4732089209;Ne;6;3;2;11
15473;Žirniukas;Nykštukų;9988669252;Ne;0;1;2;3
15474;Žirniukas;Nykštukų;8242086461;Ne;5;0;2;7
15475;Žirniukas;Nykštukų;8242086461;Ne;5;0;2;7
15476;Žirniukas;Nykštukų;8242086461;Ne;5;0;2;7
15477;Žirniukas;Nykštukų;6511802399;Ne;5;0;2;7
15478;Žirniukas;Nykštukų;6511802399;Ne;5;0;2;7
15479;Žirniukas;Nykštukų;6511802399;Ne;5;0;2;7
15480;Žirniukas;Nykštukų;6349641015;Ne;2;1;2;5
15481;Žirniukas;Nykštukų;2635969699;Ne;2;2;7;11
15482;Žirniukas;Nykštukų;5422282267;Ne;10;0;6;16
15483;Žirniukas;Nykštukų;5103440019;Ne;0;0;4;4
15484;Žirniukas;Saulytės;5613818351;Ne;0;3;0;3
15485;Žirniukas;Saulytės;1345594362;Ne;0;3;0;3
15486;Žirniukas;Saulytės;9847840127;Ne;0;5;0;5
15487;Žirniukas;Saulytės;5212289551;Ne;0;0;1;1
15488;Žirniukas;Saulytės;1005139737;Ne;1;0;2;3
15489;Žirniukas;Saulytės;7968189099;Ne;3;1;4;8
15490;Žirniukas;Saulytės;7081683726;Ne;0;4;2;6
15491;Žirniukas;Saulytės;7021496832;Ne;1;0;2;3
15492;Žirniukas;Saulytės;7269948694;Ne;0;2;0;2
15493;Žirniukas;Saulytės;6594686128;Ne;0;2;0;2
15494;Žirniukas;Saulytės;1679864330;Ne;0;0;1;1
15495;Žirniukas;Saulytės;3438394768;Ne;0;2;0;2
15496;Žirniukas;Saulytės;9569187800;Ne;5;0;2;7
15497;Žirniukas;Saulytės;2302878611;Ne;6;0;2;8
15498;Žirniukas;Saulytės;2115471433;Ne;0;2;0;2
15499;Žirniukas;Saulytės;3603956795;Ne;8;1;2;11
15500;Žirniukas;Saulytės;4902056654;Ne;5;0;2;7
15501;Žirniukas;Saulytės;7563892184;Ne;5;0;2;7
15502;Žirniukas;Saulytės;5194729029;Ne;0;4;0;4
15503;Žirniukas;Drugelių;6271194358;Ne;4;1;2;7
15504;Žirniukas;Drugelių;9232828844;Ne;0;2;0;2
15505;Žirniukas;Drugelių;5269074776;Ne;0;0;10;10
15506;Žirniukas;Drugelių;3509857181;Ne;5;2;2;9
15507;Žirniukas;Drugelių;2517524802;Ne;6;1;2;9
15508;Žirniukas;Drugelių;9901196251;Ne;0;2;1;3
15509;Žirniukas;Drugelių;2555959199;Ne;5;7;0;12
15510;Žirniukas;Drugelių;4762596462;Ne;0;0;1;1
15511;Žirniukas;Drugelių;5046469974;Ne;2;0;4;6
15512;Žirniukas;Drugelių;4536071547;Ne;3;3;3;9
15513;Žirniukas;Drugelių;3996393849;Ne;14;0;4;18
15514;Žirniukas;Drugelių;7240364379;Ne;1;1;2;4
15515;Žirniukas;Drugelių;6300372863;Ne;0;4;5;9
15516;Žirniukas;Drugelių;5670489807;Ne;0;0;1;1
15517;Žirniukas;Drugelių;9794535841;Ne;1;0;2;3
15518;Žirniukas;Drugelių;1031316325;Ne;2;0;2;4
15519;Žirniukas;Drugelių;1018506580;Ne;13;4;2;19
15520;Žirniukas;Drugelių;6993784924;Ne;0;4;0;4
15521;Žirniukas;Drugelių;9384464752;Ne;2;2;2;6
15522;Žirniukas;Pelėdžiukai;7889803840;Ne;0;2;0;2
15523;Žirniukas;Pelėdžiukai;2895924102;Ne;7;2;2;11
15524;Žirniukas;Pelėdžiukai;4347695841;Ne;4;0;3;7
15525;Žirniukas;Pelėdžiukai;9381704756;Ne;4;0;2;6
15526;Žirniukas;Pelėdžiukai;4847093256;Ne;0;0;2;2
15527;Žirniukas;Pelėdžiukai;7356213150;Ne;0;11;0;11
15528;Žirniukas;Pelėdžiukai;7545458622;Ne;20;0;2;22
15529;Žirniukas;Pelėdžiukai;8354728917;Ne;0;1;0;1
15530;Žirniukas;Pelėdžiukai;5376080603;Ne;0;0;4;4
15531;Žirniukas;Pelėdžiukai;9511974432;Ne;2;2;2;6
15532;Žirniukas;Pelėdžiukai;7755938379;Ne;4;2;2;8
15533;Žirniukas;Pelėdžiukai;5470692657;Taip;15;0;4;19
15534;Žirniukas;Pelėdžiukai;8690042163;Ne;5;0;2;7
15535;Žirniukas;Pelėdžiukai;2332260494;Ne;3;2;2;7
15536;Žirniukas;Pelėdžiukai;6941160450;Ne;4;0;3;7
15537;Žirniukas;Pelėdžiukai;4464151713;Ne;0;0;2;2
15538;Žirniukas;Pelėdžiukai;4069128550;Ne;0;0;2;2
15539;Žirniukas;Pelėdžiukai;2489163786;Ne;5;0;0;5
15540;Žirniukas;Pelėdžiukai;7767762079;Ne;0;5;2;7
15541;Žirniukas;ZUIKUČIAI;4860680720;Ne;4;2;2;8
15542;Žirniukas;ZUIKUČIAI;9993119353;Ne;0;2;1;3
15543;Žirniukas;ZUIKUČIAI;2315136490;Ne;0;1;0;1
15544;Žirniukas;ZUIKUČIAI;4519996144;Ne;0;2;0;2
15545;Žirniukas;ZUIKUČIAI;2081378583;Ne;0;2;0;2
15546;Žirniukas;ZUIKUČIAI;8511341812;Ne;0;0;2;2
15547;Žirniukas;ZUIKUČIAI;7530076269;Ne;0;22;0;22
15548;Žirniukas;ZUIKUČIAI;1255561862;Ne;14;0;4;18
15549;Žirniukas;ZUIKUČIAI;6780809984;Ne;3;0;5;8
15550;Žirniukas;ZUIKUČIAI;5580500746;Ne;0;1;0;1
15551;Žirniukas;ZUIKUČIAI;2161897682;Ne;1;2;2;5
15552;Žirniukas;ZUIKUČIAI;6042654423;Taip;9;0;4;13
15553;Žirniukas;ZUIKUČIAI;6223594794;Ne;0;14;0;14
15554;Žirniukas;ZUIKUČIAI;7868678721;Ne;0;6;1;7
15555;Aušra;Kodėlčiukai;4540040693;Ne;8;2;2;12
15556;Aušra;Kodėlčiukai;5013135853;Ne;0;2;5;7
15557;Aušra;Kodėlčiukai;7765504789;Ne;0;4;1;5
15558;Aušra;Kodėlčiukai;4824773027;Ne;1;1;2;4
15559;Aušra;Kodėlčiukai;6139706771;Ne;5;0;4;9
15560;Aušra;Kodėlčiukai;5929538617;Ne;1;0;2;3
15561;Aušra;Kodėlčiukai;4720749995;Ne;0;1;2;3
15562;Aušra;Kodėlčiukai;8108663467;Ne;4;2;4;10
15563;Aušra;Kodėlčiukai;5046439805;Ne;0;1;0;1
15564;Aušra;Kodėlčiukai;3420851059;Ne;2;1;2;5
15565;Aušra;Kodėlčiukai;7314273812;Ne;1;5;2;8
15566;Aušra;Kodėlčiukai;1423840991;Ne;0;8;0;8
15567;Aušra;Kodėlčiukai;7469266085;Ne;9;2;8;19
15568;Aušra;Kodėlčiukai;1010721404;Ne;0;2;0;2
15569;Aušra;Kodėlčiukai;2611563172;Ne;6;2;3;11
15570;Aušra;Kodėlčiukai;1883185016;Ne;0;3;0;3
15571;Aušra;Kodėlčiukai;9437530221;Ne;0;22;0;22
15572;Aušra;Kodėlčiukai;3627487971;Ne;1;2;3;6
15573;Aušra;Kodėlčiukai;7367602247;Ne;0;2;0;2
15574;Aušra;Smalsučiai;4010347313;Ne;0;3;0;3
15575;Aušra;Smalsučiai;5993984086;Ne;1;2;2;5
15576;Aušra;Smalsučiai;1630814772;Ne;3;3;2;8
15577;Aušra;Smalsučiai;2768220823;Ne;1;2;4;7
15578;Aušra;Smalsučiai;4000881716;Ne;9;1;2;12
15579;Aušra;Smalsučiai;7710131755;Ne;6;1;2;9
15580;Aušra;Smalsučiai;8884580599;Ne;3;1;2;6
15581;Aušra;Smalsučiai;3468946868;Ne;16;1;4;21
15582;Aušra;Smalsučiai;8021547491;Ne;1;1;2;4
15583;Aušra;Smalsučiai;5925213006;Ne;7;2;2;11
15584;Aušra;Smalsučiai;2495610772;Ne;0;10;0;10
15585;Aušra;Smalsučiai;3526010606;Ne;3;1;3;7
15586;Aušra;Smalsučiai;4339450816;Ne;0;2;0;2
15587;Aušra;Smalsučiai;4163605313;Ne;0;11;0;11
15588;Aušra;Smalsučiai;6614027605;Ne;0;8;0;8
15589;Aušra;Smalsučiai;3860755808;Ne;4;4;2;10
15590;Aušra;Smalsučiai;2039920706;Ne;0;12;0;12
15591;Aušra;Smalsučiai;9333701196;Ne;0;11;0;11
15592;Aušra;Smalsučiai;8584355573;Ne;0;13;0;13
15593;Aušra;Smalsučiai;6965081051;Ne;0;7;0;7
15594;Aušra;Smalsučiai;8489362814;Ne;8;2;2;12
15595;Aušra;Smalsučiai;3675175233;Ne;8;0;2;10
15596;Aušra;"1A klasė";5524681006;Ne;0;2;0;2
15597;Aušra;"1A klasė";4404047456;Ne;3;2;0;5
15598;Aušra;"1A klasė";3680329197;Ne;10;2;0;12
15599;Aušra;"1A klasė";1575761029;Ne;2;2;0;4
15600;Aušra;"1A klasė";97102749430;Ne;2;2;0;4
15601;Aušra;"1A klasė";5777939563;Ne;1;2;0;3
15602;Aušra;"1A klasė";8740755922;Ne;0;2;0;2
15603;Aušra;"1A klasė";8500642069;Ne;0;2;0;2
15604;Aušra;"1A klasė";1450251779;Ne;1;2;0;3
15605;Aušra;"1A klasė";8176840834;Ne;16;2;0;18
15606;Aušra;"1A klasė";4922560649;Ne;6;2;0;8
15607;Aušra;"1A klasė";4946988585;Ne;0;2;0;2
15608;Aušra;"1A klasė";3767301684;Ne;8;2;0;10
15609;Aušra;"1A klasė";8755231814;Ne;0;2;0;2
15610;Aušra;"1A klasė";1625009666;Ne;3;2;0;5
15611;Aušra;"1A klasė";9058688663;Ne;1;2;0;3
15612;Aušra;"1A klasė";4468214107;Ne;0;2;0;2
15613;Aušra;"1A klasė";7708360056;Ne;2;2;0;4
15614;Aušra;"1A klasė";8096035110;Ne;0;2;0;2
15615;Aušra;"1A klasė";1687206394;Ne;0;2;0;2
15616;Aušra;"1A klasė";1557503831;Ne;2;2;0;4
15617;Aušra;"1A klasė";1636794584;Ne;1;2;0;3
15618;Aušra;"1A klasė";5258444578;Ne;6;2;0;8
15619;Aušra;"1A klasė";1612662076;Ne;6;2;0;8
15620;Aušra;"1A klasė";4013275108;Ne;0;2;0;2
15621;Aušra;"1B klasė";5409157554;Ne;1;2;0;3
15622;Aušra;"1B klasė";8709340592;Ne;0;2;0;2
15623;Aušra;"1B klasė";1940882109;Ne;0;2;0;2
15624;Aušra;"1B klasė";6384243597;Ne;0;2;0;2
15625;Aušra;"1B klasė";3898178166;Ne;2;2;0;4
15626;Aušra;"1B klasė";1343532870;Ne;1;2;0;3
15627;Aušra;"1B klasė";9614562473;Ne;0;2;0;2
15628;Aušra;"1B klasė";7921251819;Ne;14;2;0;16
15629;Aušra;"1B klasė";2523842161;Ne;5;2;0;7
15630;Aušra;"1B klasė";1465584524;Ne;1;2;0;3
15631;Aušra;"1B klasė";8036572198;Ne;0;2;0;2
15632;Aušra;"1B klasė";8525869648;Ne;0;2;0;2
15633;Aušra;"1B klasė";9589692031;Ne;5;2;0;7
15634;Aušra;"1B klasė";9972967198;Ne;11;2;0;13
15635;Aušra;"1B klasė";5522008237;Ne;1;2;0;3
15636;Aušra;"1B klasė";5269927048;Ne;0;2;0;2
15637;Aušra;"1B klasė";6084096300;Ne;0;2;0;2
15638;Aušra;"1B klasė";10796114623;Ne;0;2;0;2
15639;Aušra;"1B klasė";2052892422;Ne;0;2;0;2
15640;Aušra;"1B klasė";9197020006;Ne;0;2;0;2
15641;Aušra;"1B klasė";7178676049;Ne;0;2;0;2
15642;Aušra;"1B klasė";1298724775;Ne;0;2;0;2
15643;Aušra;"1B klasė";7918281270;Ne;6;2;0;8
15644;Aušra;"1B klasė";43123279348;Ne;0;2;0;2
15645;Aušra;"2A klasė";3001784066;Ne;0;2;0;2
15646;Aušra;"2A klasė";84116863778;Ne;9;2;0;11
15647;Aušra;"2A klasė";2227238810;Ne;0;2;0;2
15648;Aušra;"2A klasė";59837942520;Ne;0;2;0;2
15649;Aušra;"2A klasė";11053850075;Ne;0;2;0;2
15650;Aušra;"2A klasė";23609052737;Ne;0;2;0;2
15651;Aušra;"2A klasė";41017803426;Ne;0;2;0;2
15652;Aušra;"2A klasė";21544489661;Ne;3;2;0;5
15653;Aušra;"2A klasė";24625925423;Ne;0;2;0;2
15654;Aušra;"2A klasė";62186117615;Ne;0;2;0;2
15655;Aušra;"2A klasė";3526237179;Ne;12;2;0;14
15656;Aušra;"2A klasė";1893586984;Ne;0;22;0;22
15657;Aušra;"2A klasė";8686777160;Ne;0;2;0;2
15658;Aušra;"2A klasė";15657824495;Ne;2;2;0;4
15659;Aušra;"2A klasė";5988529284;Ne;1;2;0;3
15660;Aušra;"2A klasė";79051821501;Ne;10;2;0;12
15661;Aušra;"2A klasė";2062470430;Ne;2;2;0;4
15662;Aušra;"2A klasė";5815377310;Ne;1;2;0;3
15663;Aušra;"2A klasė";58254707316;Ne;0;2;0;2
15664;Aušra;"2A klasė";1385844067;Ne;0;2;0;2
15665;Aušra;"2A klasė";2121418946;Ne;1;2;0;3
15666;Aušra;"2A klasė";1219257874;Ne;0;22;0;22
15667;Aušra;"2A klasė";4325224130;Ne;0;2;0;2
15668;Aušra;"2A klasė";59267104215;Ne;0;2;0;2
15669;Aušra;"2A klasė";3732655408;Ne;0;2;0;2
15670;Aušra;"3A klasė";1049364899;Ne;3;2;0;5
15671;Aušra;"3A klasė";1473962346;Ne;5;2;0;7
15672;Aušra;"3A klasė";1427235223;Ne;1;2;0;3
15673;Aušra;"3A klasė";42344686036;Ne;0;2;0;2
15674;Aušra;"3A klasė";95586246863;Ne;0;2;0;2
15675;Aušra;"3A klasė";1167565535;Ne;4;2;0;6
15676;Aušra;"3A klasė";5468993286;Ne;0;2;0;2
15677;Aušra;"3A klasė";75047415039;Ne;0;2;0;2
15678;Aušra;"3A klasė";85826303673;Ne;1;2;0;3
15679;Aušra;"3A klasė";1145863002;Ne;0;22;0;22
15680;Aušra;"3A klasė";77966124767;Ne;0;2;0;2
15681;Aušra;"3A klasė";97312326369;Ne;1;2;0;3
15682;Aušra;"3A klasė";48817619537;Ne;4;2;0;6
15683;Aušra;"3A klasė";55937499558;Ne;4;2;0;6
15684;Aušra;"3A klasė";35779814505;Ne;0;2;0;2
15685;Aušra;"3A klasė";76280361479;Ne;0;2;0;2
15686;Aušra;"3A klasė";2131349938;Ne;0;2;0;2
15687;Aušra;"3A klasė";1455625997;Ne;0;22;0;22
15688;Aušra;"3A klasė";36447115547;Ne;0;22;0;22
15689;Aušra;"3A klasė";1393006122;Ne;4;2;0;6
15690;Aušra;"3A klasė";7998332115;Ne;0;2;0;2
15691;Aušra;"3A klasė";2647629246;Ne;0;2;0;2
15692;Aušra;"3A klasė";14611425618;Ne;0;2;0;2
15693;Aušra;"3A klasė";31458685084;Ne;0;2;0;2
15694;Aušra;"3A klasė";1315930711;Ne;3;2;0;5
15695;Aušra;"3A klasė";4110537888;Ne;2;2;0;4
15696;Aušra;"3A klasė";9603569117;Ne;2;2;0;4
15697;Aušra;"3A klasė";2019480768;Ne;0;2;0;2
15698;Aušra;"4A klasė";40499781883;Ne;3;2;0;5
15699;Aušra;"4A klasė";73509864636;Ne;0;2;0;2
15700;Aušra;"4A klasė";8510995681;Ne;0;2;0;2
15701;Aušra;"4A klasė";13157844661;Ne;1;2;0;3
15702;Aušra;"4A klasė";70233681803;Ne;0;22;0;22
15703;Aušra;"4A klasė";68160889669;Ne;1;2;0;3
15704;Aušra;"4A klasė";97781409787;Ne;2;2;0;4
15705;Aušra;"4A klasė";9605206310;Ne;2;2;0;4
15706;Aušra;"4A klasė";88655846176;Ne;0;2;0;2
15707;Aušra;"4A klasė";3284383302;Ne;0;2;0;2
15708;Aušra;"4A klasė";1437126272;Ne;0;2;0;2
15709;Aušra;"4A klasė";39537089288;Ne;0;2;0;2
15710;Aušra;"4A klasė";3965445196;Ne;0;2;0;2
15711;Aušra;"4A klasė";85578471272;Ne;0;22;0;22
15712;Aušra;"4A klasė";27958163601;Ne;0;2;0;2
15713;Aušra;"4A klasė";68031503463;Ne;0;22;0;22
15714;Aušra;"4A klasė";81633973264;Ne;0;22;0;22
15715;Aušra;"4A klasė";52985512945;Ne;0;22;0;22
15716;Aušra;"4A klasė";51185323645;Ne;12;2;0;14
15717;Aušra;"4A klasė";1437385365;Ne;0;22;0;22
15718;Aušra;"4A klasė";15330844181;Ne;0;22;0;22
15719;Aušra;"4A klasė";2062775070;Ne;0;22;0;22
15720;Aušra;"4A klasė";14157070764;Ne;2;2;0;4
15721;Aušra;"4A klasė";99073448709;Ne;0;2;0;2
15722;Aušra;"4A klasė";40714551025;Ne;3;2;0;5
15723;Aušra;"4A klasė";58699109274;Ne;0;2;0;2
15724;Aušra;"2B klasė";1988459596;Ne;0;2;0;2
15725;Aušra;"2B klasė";4930807661;Ne;0;2;0;2
15726;Aušra;"2B klasė";86128256406;Ne;0;2;0;2
15727;Aušra;"2B klasė";50687988382;Ne;0;2;0;2
15728;Aušra;"2B klasė";1021183555;Ne;1;2;0;3
15729;Aušra;"2B klasė";41268510292;Ne;1;2;0;3
15730;Aušra;"2B klasė";8428069167;Ne;1;2;0;3
15731;Aušra;"2B klasė";3910688753;Ne;0;2;0;2
15732;Aušra;"2B klasė";4024898537;Ne;4;2;0;6
15733;Aušra;"2B klasė";1238171728;Ne;1;2;0;3
15734;Aušra;"2B klasė";4103951942;Ne;2;2;0;4
15735;Aušra;"2B klasė";46481555688;Ne;1;2;0;3
15736;Aušra;"2B klasė";1063755068;Ne;9;2;0;11
15737;Aušra;"2B klasė";70844824182;Ne;2;2;0;4
15738;Aušra;"2B klasė";17098859260;Ne;0;2;0;2
15739;Aušra;"2B klasė";9940683245;Ne;1;2;0;3
15740;Aušra;"2B klasė";2841526614;Ne;0;2;0;2
15741;Aušra;"2B klasė";8813044848;Ne;7;2;0;9
15742;Aušra;"2B klasė";58741201573;Ne;2;2;0;4
15743;Aušra;"2B klasė";2003368811;Ne;0;2;0;2
15744;Aušra;"2B klasė";65840410497;Ne;1;2;0;3
15745;Aušra;"2B klasė";1640356242;Ne;0;2;0;2
15746;Aušra;"2B klasė";90604001837;Ne;2;2;0;4
15747;Aušra;"2B klasė";7794899167;Ne;10;2;0;12
15748;Aušra;Pabiručiai;8769357172;Ne;0;2;0;2
15749;Aušra;Pabiručiai;8462418277;Ne;0;3;0;3
15750;Aušra;Pabiručiai;6555345047;Ne;4;2;2;8
15751;Aušra;Pabiručiai;1306616759;Ne;0;3;0;3
15752;Aušra;Pabiručiai;7476662446;Ne;0;0;1;1
15753;Aušra;Pabiručiai;7199483890;Ne;0;4;4;8
15754;Aušra;Pabiručiai;9466807067;Ne;3;2;4;9
15755;Aušra;Pabiručiai;3008573040;Ne;6;2;4;12
15756;Aušra;Pabiručiai;7926621700;Ne;8;3;2;13
15757;Aušra;Pabiručiai;2904303784;Ne;0;0;2;2
15758;Aušra;Pabiručiai;7888891808;Ne;1;0;3;4
15759;Aušra;Pabiručiai;7944904281;Ne;0;3;0;3
15760;Aušra;Pabiručiai;4646215025;Ne;7;0;5;12
15761;Aušra;Pabiručiai;6056923592;Ne;7;1;5;13
15762;Aušra;Pabiručiai;8665364744;Ne;13;2;2;17
15763;Aušra;Pabiručiai;3553620602;Ne;7;0;0;7
15764;Aušra;Pabiručiai;4071233786;Ne;8;0;3;11
15765;Aušra;Pabiručiai;3953653896;Ne;0;7;0;7
15766;Aušra;Pabiručiai;6508435821;Ne;8;0;2;10
15767;Aušra;Pabiručiai;5797692122;Ne;1;2;2;5
15768;Aušra;Pabiručiai;7159809546;Ne;0;4;0;4
15769;Aušra;Pabiručiai;7542690501;Ne;0;22;0;22
15770;Aušra;Pabiručiai;3759593393;Ne;0;2;0;2
15771;Aušra;Pabiručiai;2273160688;Ne;7;2;3;12
15772;Aušra;Gudručiai;1933801749;Ne;3;2;2;7
15773;Aušra;Gudručiai;6658178519;Ne;0;1;0;1
15774;Aušra;Gudručiai;5854637278;Ne;0;2;0;2
15775;Aušra;Gudručiai;2243689816;Ne;0;12;0;12
15776;Aušra;Gudručiai;2271582954;Ne;4;2;3;9
15777;Aušra;Gudručiai;9628651723;Ne;0;5;0;5
15778;Aušra;Gudručiai;1337138547;Ne;3;2;2;7
15779;Aušra;Gudručiai;3343235857;Ne;0;5;0;5
15780;Aušra;Gudručiai;8715912139;Ne;0;4;2;6
15781;Aušra;Gudručiai;7783006852;Ne;4;0;3;7
15782;Aušra;Gudručiai;1429548355;Ne;0;22;0;22
15783;Aušra;Gudručiai;1693711284;Ne;3;2;2;7
15784;Aušra;Gudručiai;6935310711;Ne;3;3;2;8
15785;Aušra;Gudručiai;3698868934;Ne;7;2;3;12
15786;Aušra;Gudručiai;9079804366;Ne;0;2;0;2
15787;Aušra;Gudručiai;3498143162;Ne;0;2;0;2
15788;Aušra;Gudručiai;5053808615;Ne;0;1;0;1
15789;Aušra;Gudručiai;2093165104;Ne;0;3;0;3
15790;Aušra;Naminukai;5596076175;Ne;16;2;2;20
15791;Aušra;Naminukai;5029468798;Ne;0;4;0;4
15792;Aušra;Naminukai;3889084120;Ne;0;2;3;5
15793;Aušra;Naminukai;9817943569;Ne;3;0;2;5
15794;Aušra;Naminukai;9783616691;Ne;3;4;2;9
15795;Aušra;Naminukai;7432671713;Ne;2;2;2;6
15796;Aušra;Naminukai;3600378899;Ne;7;1;3;11
15797;Aušra;Naminukai;2372043385;Ne;0;0;3;3
15798;Aušra;Naminukai;8872977307;Taip;16;2;2;20
15799;Aušra;Naminukai;5943702240;Ne;3;1;2;6
15800;Aušra;Naminukai;7833475076;Ne;0;2;1;3
15801;Aušra;Naminukai;4856488024;Ne;10;0;2;12
15802;Aušra;Naminukai;1415288593;Ne;3;2;2;7
15803;Aušra;Naminukai;2831726456;Ne;0;4;0;4
15804;Aušra;Naminukai;5245988936;Ne;0;2;4;6
15805;Aušra;Naminukai;2109806524;Ne;4;2;3;9
15806;Aušra;Naminukai;4300801436;Ne;2;0;1;3
15807;Aušra;Naminukai;4824331856;Ne;0;2;5;7
15808;Aušra;Naminukai;5270770998;Ne;0;2;0;2
15809;Aušra;"2 C klasė";1426802917;Ne;2;2;0;4
15810;Aušra;"2 C klasė";26010333641;Ne;2;2;0;4
15811;Aušra;"2 C klasė";3133031845;Ne;2;2;0;4
15812;Aušra;"2 C klasė";11130172902;Ne;0;2;0;2
15813;Aušra;"2 C klasė";43737170074;Ne;0;2;0;2
15814;Aušra;"2 C klasė";1370336984;Ne;0;2;0;2
15815;Aušra;"2 C klasė";6483078840;Ne;0;2;0;2
15816;Aušra;"2 C klasė";1684481833;Ne;0;2;0;2
15817;Aušra;"2 C klasė";1198248619;Ne;0;2;0;2
15818;Aušra;"2 C klasė";4765125810;Ne;2;2;0;4
15819;Aušra;"2 C klasė";5704281727;Ne;0;2;0;2
15820;Aušra;"2 C klasė";1479311429;Ne;15;2;0;17
15821;Aušra;"2 C klasė";1542575012;Ne;3;2;0;5
15822;Aušra;"2 C klasė";1291782232;Ne;0;2;0;2
15823;Aušra;"2 C klasė";90520726029;Ne;0;2;0;2
15824;Aušra;"2 C klasė";1844632980;Ne;12;2;0;14
15825;Aušra;"2 C klasė";94478599707;Ne;5;2;0;7
15826;Aušra;"2 C klasė";78489473446;Ne;2;2;0;4
15827;Aušra;"2 C klasė";29328876924;Ne;5;2;0;7
15828;Aušra;"2 C klasė";7649832094;Ne;0;2;0;2
15829;Aušra;"2 C klasė";8225188274;Ne;4;2;0;6
15830;Aušra;"2 C klasė";1371282149;Ne;0;2;0;2
15831;Aušra;"2 C klasė";57559227292;Ne;6;2;0;8
15832;Berželis;PČIOLKI;3613459846;Ne;0;1;1;2
15833;Berželis;PČIOLKI;7781031211;Ne;7;2;5;14
15834;Berželis;PČIOLKI;4546285993;Ne;0;22;0;22
15835;Berželis;PČIOLKI;7940591009;Ne;4;0;3;7
15836;Berželis;PČIOLKI;6352635742;Ne;0;4;0;4
15837;Berželis;PČIOLKI;2030770943;Ne;4;1;2;7
15838;Berželis;PČIOLKI;6942559693;Ne;0;2;2;4
15839;Berželis;PČIOLKI;5688897783;Ne;0;2;6;8
15840;Berželis;PČIOLKI;2016194182;Ne;0;2;1;3
15841;Berželis;PČIOLKI;5069322062;Ne;2;2;5;9
15842;Berželis;PČIOLKI;6577232093;Ne;14;0;2;16
15843;Berželis;PČIOLKI;9585609150;Ne;0;12;0;12
15844;Berželis;PČIOLKI;9091691636;Ne;3;2;4;9
15845;Berželis;PČIOLKI;2667957070;Ne;0;2;2;4
15846;Berželis;PČIOLKI;9245706377;Ne;1;1;2;4
15847;Berželis;PČIOLKI;8448872491;Ne;4;0;5;9
15848;Berželis;PČIOLKI;6387242787;Ne;0;22;0;22
15849;Berželis;PČIOLKI;2954451168;Ne;6;3;2;11
15850;Berželis;"BOŽJI KOROVKI";3162044236;Ne;0;1;0;1
15851;Berželis;"BOŽJI KOROVKI";7421059780;Ne;2;2;2;6
15852;Berželis;"BOŽJI KOROVKI";4100740863;Ne;11;3;4;18
15853;Berželis;"BOŽJI KOROVKI";5953387226;Ne;5;4;2;11
15854;Berželis;"BOŽJI KOROVKI";3070917065;Ne;7;1;2;10
15855;Berželis;"BOŽJI KOROVKI";8118040960;Ne;2;2;2;6
15856;Berželis;"BOŽJI KOROVKI";2005082089;Ne;0;2;1;3
15857;Berželis;"BOŽJI KOROVKI";9848723402;Ne;3;1;2;6
15858;Berželis;"BOŽJI KOROVKI";5551459997;Ne;2;4;4;10
15859;Berželis;"BOŽJI KOROVKI";6651007152;Ne;4;2;4;10
15860;Berželis;"BOŽJI KOROVKI";8451877584;Ne;5;0;6;11
15861;Berželis;"BOŽJI KOROVKI";7080168105;Ne;11;1;2;14
15862;Berželis;"BOŽJI KOROVKI";9438498834;Ne;0;2;3;5
15863;Berželis;"BOŽJI KOROVKI";1132252592;Ne;4;2;4;10
15864;Berželis;"BOŽJI KOROVKI";5550598069;Ne;4;5;2;11
15865;Berželis;"BOŽJI KOROVKI";1852964349;Ne;0;4;0;4
15866;Berželis;"BOŽJI KOROVKI";8871199713;Ne;4;0;4;8
15867;Berželis;"BOŽJI KOROVKI";1722262813;Ne;0;6;0;6
15868;Berželis;"BOŽJI KOROVKI";9466461910;Ne;13;0;4;17
15869;Berželis;"BOŽJI KOROVKI";2182268389;Ne;2;2;2;6
15870;Berželis;"BOŽJI KOROVKI";2901168499;Ne;0;3;0;3
15871;Berželis;"BOŽJI KOROVKI";1498165322;Ne;1;0;7;8
15872;Berželis;SOLNYŠKO;7411282628;Ne;0;0;2;2
15873;Berželis;SOLNYŠKO;1167103292;Ne;7;0;3;10
15874;Berželis;SOLNYŠKO;5408368340;Ne;8;0;5;13
15875;Berželis;SOLNYŠKO;1070751052;Ne;5;3;2;10
15876;Berželis;SOLNYŠKO;5464385395;Ne;0;4;0;4
15877;Berželis;SOLNYŠKO;6422037185;Ne;1;0;2;3
15878;Berželis;SOLNYŠKO;1424868444;Ne;2;5;0;7
15879;Berželis;SOLNYŠKO;1146976812;Ne;0;4;1;5
15880;Berželis;SOLNYŠKO;6774460279;Ne;0;22;0;22
15881;Berželis;SOLNYŠKO;5866092980;Taip;5;0;3;8
15882;Berželis;SOLNYŠKO;9750863775;Ne;6;4;2;12
15883;Berželis;SOLNYŠKO;2146432569;Ne;7;0;2;9
15884;Berželis;SOLNYŠKO;4125566288;Ne;3;0;2;5
15885;Berželis;SOLNYŠKO;1503116062;Ne;2;0;3;5
15886;Berželis;SOLNYŠKO;8353172510;Ne;0;7;5;12
15887;Berželis;SOLNYŠKO;6281925938;Ne;0;11;1;12
15888;Berželis;SOLNYŠKO;5739847580;Ne;0;7;4;11
15889;Berželis;SOLNYŠKO;5194480946;Ne;2;1;4;7
15890;Berželis;BABOČKI;7535016799;Ne;0;0;2;2
15891;Berželis;BABOČKI;3118835709;Ne;0;0;2;2
15892;Berželis;BABOČKI;4511595124;Ne;2;0;2;4
15893;Berželis;BABOČKI;3171522992;Ne;0;22;0;22
15894;Berželis;BABOČKI;9233307928;Ne;0;22;0;22
15895;Berželis;BABOČKI;6476593246;Ne;3;0;3;6
15896;Berželis;BABOČKI;5460675556;Ne;6;0;2;8
15897;Berželis;BABOČKI;6465432599;Ne;7;0;2;9
15898;Berželis;BABOČKI;5357039865;Ne;1;0;4;5
15899;Berželis;BABOČKI;9300262294;Ne;2;2;2;6
15900;Berželis;SOVUŠKI;8185887403;Ne;6;0;2;8
15901;Berželis;SOVUŠKI;1289333809;Ne;11;1;2;14
15902;Berželis;SOVUŠKI;9273819928;Ne;0;2;0;2
15903;Berželis;SOVUŠKI;1769470120;Ne;1;5;0;6
15904;Berželis;SOVUŠKI;3885474466;Ne;0;1;0;1
15905;Berželis;SOVUŠKI;1825910306;Ne;2;0;2;4
15906;Berželis;SOVUŠKI;6706273205;Ne;2;0;0;2
15907;Berželis;SOVUŠKI;1464998584;Ne;8;0;2;10
15908;Berželis;SOVUŠKI;3835273594;Ne;2;0;2;4
15909;Berželis;SOVUŠKI;2632535013;Ne;20;0;2;22
15910;Berželis;SOVUŠKI;6698849108;Ne;2;0;5;7
15911;Berželis;SOVUŠKI;1583268041;Ne;0;1;1;2
15912;Berželis;SOVUŠKI;5925726854;Ne;2;0;4;6
15913;Berželis;SOVUŠKI;1044720859;Ne;0;3;0;3
15914;Berželis;SOVUŠKI;2615832804;Ne;3;5;2;10
15915;Berželis;PODSOLNUŠKI;3157906472;Ne;22;0;0;22
15916;Berželis;PODSOLNUŠKI;9945124824;Ne;1;2;2;5
15917;Berželis;PODSOLNUŠKI;8168498937;Ne;3;1;2;6
15918;Berželis;PODSOLNUŠKI;9072126286;Ne;5;0;2;7
15919;Berželis;PODSOLNUŠKI;8633724383;Ne;4;1;3;8
15920;Berželis;PODSOLNUŠKI;2259367998;Ne;3;2;3;8
15921;Berželis;PODSOLNUŠKI;3033042487;Ne;0;14;0;14
15922;Berželis;PODSOLNUŠKI;2136455625;Ne;0;2;4;6
15923;Berželis;PODSOLNUŠKI;1964320071;Ne;8;4;2;14
15924;Berželis;PODSOLNUŠKI;9133988149;Ne;3;5;2;10
15925;Berželis;PODSOLNUŠKI;5795151632;Ne;3;2;2;7
15926;Berželis;PODSOLNUŠKI;6686248053;Ne;3;0;2;5
15927;Berželis;PODSOLNUŠKI;5963915092;Ne;6;0;4;10
15928;Berželis;PODSOLNUŠKI;3378237475;Ne;5;0;2;7
15929;Berželis;PODSOLNUŠKI;4681334359;Ne;0;0;4;4
15930;Berželis;LAPIUKAI;3813964138;Ne;0;1;0;1
15931;Berželis;LAPIUKAI;9658062645;Ne;0;0;1;1
15932;Berželis;LAPIUKAI;9681310544;Ne;0;0;4;4
15933;Berželis;LAPIUKAI;9543499205;Ne;0;1;0;1
15934;Berželis;LAPIUKAI;9749516260;Ne;5;0;4;9
15935;Berželis;LAPIUKAI;4243086262;Ne;7;0;2;9
15936;Berželis;LAPIUKAI;8994102218;Ne;0;3;0;3
15937;Berželis;LAPIUKAI;4854931959;Ne;1;0;5;6
15938;Berželis;LAPIUKAI;9234691627;Ne;0;0;3;3
15939;Berželis;LAPIUKAI;4437437529;Ne;0;2;0;2
15940;Berželis;LAPIUKAI;9562165121;Ne;8;0;2;10
15941;Berželis;LAPIUKAI;7848240865;Ne;2;0;3;5
15942;Berželis;LAPIUKAI;7545277683;Ne;0;7;3;10
15943;Berželis;LAPIUKAI;7807553847;Ne;4;0;4;8
15944;Berželis;LAPIUKAI;1456066646;Ne;4;0;4;8
15945;Berželis;LAPIUKAI;9459031158;Ne;0;2;0;2
15946;Berželis;LAPIUKAI;6186408090;Ne;0;0;2;2
15947;Berželis;LAPIUKAI;1673524685;Ne;3;0;4;7
15948;Berželis;LAPIUKAI;7902774064;Taip;0;0;8;8
15949;Berželis;MEŠKIUKAI;2062794406;Taip;2;0;0;2
15950;Berželis;MEŠKIUKAI;9178527605;Taip;0;0;2;2
15951;Berželis;MEŠKIUKAI;1235617054;Ne;9;1;2;12
15952;Berželis;MEŠKIUKAI;5100214127;Ne;2;0;2;4
15953;Berželis;MEŠKIUKAI;3535856504;Taip;10;0;4;14
15954;Berželis;MEŠKIUKAI;8560266611;Ne;10;0;12;22
15955;Berželis;MEŠKIUKAI;3936106342;Ne;3;0;0;3
15956;Berželis;MEŠKIUKAI;6689893827;Ne;5;0;2;7
15957;Berželis;MEŠKIUKAI;8251510865;Ne;4;2;3;9
15958;Berželis;MEŠKIUKAI;9182053246;Ne;1;0;3;4
15959;Berželis;MEŠKIUKAI;7374231804;Ne;0;0;2;2
15960;Berželis;MEŠKIUKAI;6394357191;Ne;0;0;2;2
15961;Berželis;MEŠKIUKAI;8552923414;Ne;10;0;2;12
15962;Berželis;MEŠKIUKAI;3528575340;Ne;0;0;3;3
15963;Berželis;ŽIEDELIAI;3786609012;Ne;6;0;2;8
15964;Berželis;ŽIEDELIAI;9805181733;Ne;6;0;4;10
15965;Berželis;ŽIEDELIAI;1165300871;Ne;4;0;2;6
15966;Berželis;ŽIEDELIAI;2016827207;Ne;1;0;9;10
15967;Berželis;ŽIEDELIAI;9979442772;Ne;6;0;11;17
15968;Berželis;ŽIEDELIAI;9881246268;Ne;8;0;4;12
15969;Berželis;ŽIEDELIAI;7042967329;Ne;4;0;5;9
15970;Berželis;ŽIEDELIAI;9925865228;Ne;6;0;2;8
15971;Berželis;ŽIEDELIAI;1402975280;Ne;4;8;2;14
15972;Berželis;ŽIEDELIAI;2030492491;Ne;8;0;2;10
15973;Berželis;ŽIEDELIAI;3351114197;Ne;0;0;4;4
15974;Berželis;ŽIEDELIAI;5248880873;Ne;15;0;2;17
15975;Berželis;ŽIEDELIAI;2262911854;Ne;5;0;2;7
15976;Berželis;ŽIEDELIAI;2508532190;Ne;15;0;2;17
15977;Berželis;ŽIEDELIAI;2947072348;Ne;7;1;2;10
15978;Berželis;ŽIEDELIAI;7947225506;Ne;0;0;4;4
15979;Berželis;ŽIEDELIAI;1834920753;Taip;9;0;4;13
15980;Berželis;ŽIEDELIAI;6384939601;Ne;9;0;2;11
15981;Berželis;ŽIEDELIAI;2410514408;Ne;3;2;7;12
15982;Berželis;ŽIEDELIAI;2794074071;Taip;3;0;3;6
15983;Berželis;NYKŠTUKAI;8148104183;Ne;4;2;5;11
15984;Berželis;NYKŠTUKAI;7935684899;Ne;7;0;10;17
15985;Berželis;NYKŠTUKAI;1403664386;Ne;0;6;2;8
15986;Berželis;NYKŠTUKAI;5637168259;Ne;0;0;1;1
15987;Berželis;NYKŠTUKAI;9666648116;Ne;0;2;11;13
15988;Berželis;NYKŠTUKAI;3559065542;Ne;0;2;14;16
15989;Berželis;NYKŠTUKAI;3556594755;Ne;0;0;4;4
15990;Berželis;NYKŠTUKAI;2933069798;Ne;0;0;2;2
15991;Berželis;NYKŠTUKAI;8430372047;Ne;0;2;2;4
15992;Berželis;NYKŠTUKAI;5099275362;Ne;0;0;3;3
15993;Berželis;NYKŠTUKAI;7676141462;Ne;0;4;0;4
15994;Berželis;NYKŠTUKAI;3852021563;Ne;0;0;3;3
15995;Berželis;NYKŠTUKAI;3379227410;Ne;3;0;4;7
15996;Berželis;NYKŠTUKAI;4032178538;Taip;0;2;0;2
15997;Berželis;NYKŠTUKAI;5839964720;Ne;0;2;2;4
15998;Berželis;NYKŠTUKAI;5012540410;Ne;0;2;0;2
15999;Berželis;NYKŠTUKAI;9925281959;Ne;9;1;2;12
16000;Berželis;NYKŠTUKAI;5326178821;Ne;2;2;7;11
16001;Berželis;UOGELĖS;8735934456;Ne;0;2;2;4
16002;Berželis;UOGELĖS;6136155301;Ne;10;0;5;15
16003;Berželis;UOGELĖS;9950641759;Ne;3;0;10;13
16004;Berželis;UOGELĖS;9034464618;Ne;2;1;3;6
16005;Berželis;UOGELĖS;2321608974;Ne;6;0;2;8
16006;Berželis;UOGELĖS;3229996417;Ne;0;2;11;13
16007;Berželis;UOGELĖS;7750905743;Taip;10;0;2;12
16008;Berželis;UOGELĖS;4607486516;Ne;6;0;3;9
16009;Berželis;UOGELĖS;5197350105;Ne;8;0;4;12
16010;Berželis;UOGELĖS;1847117067;Taip;10;0;5;15
16011;Berželis;UOGELĖS;4672663741;Ne;4;0;8;12
16012;Berželis;UOGELĖS;1252310465;Ne;10;0;2;12
16013;Berželis;UOGELĖS;1307377636;Ne;11;2;2;15
16014;Berželis;UOGELĖS;3248854903;Ne;6;0;2;8
16015;Berželis;KODĖLČIUKAI;5786052354;Ne;0;0;6;6
16016;Berželis;KODĖLČIUKAI;5134372871;Ne;2;0;2;4
16017;Berželis;KODĖLČIUKAI;7852089381;Taip;0;0;2;2
16018;Berželis;KODĖLČIUKAI;5751995154;Ne;5;0;3;8
16019;Berželis;KODĖLČIUKAI;3951962738;Taip;3;5;5;13
16020;Berželis;KODĖLČIUKAI;2193392844;Taip;2;0;1;3
16021;Berželis;KODĖLČIUKAI;9696962207;Ne;8;0;3;11
16022;Berželis;KODĖLČIUKAI;8286301258;Ne;9;1;2;12
16023;Berželis;KODĖLČIUKAI;6500588668;Ne;2;0;4;6
16024;Berželis;KODĖLČIUKAI;3327751482;Ne;0;0;3;3
16025;Berželis;KODĖLČIUKAI;6060490387;Ne;3;0;3;6
16026;Berželis;KODĖLČIUKAI;9418230816;Ne;8;2;5;15
16027;Berželis;KODĖLČIUKAI;4254592648;Ne;20;0;2;22
16028;Berželis;KODĖLČIUKAI;2144796691;Ne;13;0;4;17
16029;Berželis;KODĖLČIUKAI;8737788279;Ne;9;0;8;17
16030;Berželis;KODĖLČIUKAI;8957312159;Ne;0;0;5;5
16031;Berželis;KODĖLČIUKAI;9538082931;Ne;5;0;2;7
16032;Saulutė;Drugeliai;5943795519;Ne;1;0;4;5
16033;Saulutė;Drugeliai;4067009709;Ne;0;2;4;6
16034;Saulutė;Drugeliai;3991128892;Ne;3;0;3;6
16035;Saulutė;Drugeliai;7689842018;Ne;3;0;3;6
16036;Saulutė;Drugeliai;4288298305;Ne;0;2;2;4
16037;Saulutė;Drugeliai;9133269796;Ne;5;0;4;9
16038;Saulutė;Drugeliai;6057938367;Ne;0;2;1;3
16039;Saulutė;Drugeliai;1268204445;Ne;0;14;0;14
16040;Saulutė;Drugeliai;1585403702;Ne;0;0;2;2
16041;Saulutė;Drugeliai;8003855875;Ne;0;0;2;2
16042;Saulutė;Drugeliai;2301903550;Ne;0;19;0;19
16043;Saulutė;Drugeliai;2337702344;Ne;0;0;3;3
16044;Saulutė;Drugeliai;3662919521;Ne;0;2;1;3
16045;Saulutė;Drugeliai;6455593653;Ne;0;8;0;8
16046;Saulutė;Drugeliai;9410517602;Ne;0;0;2;2
16047;Saulutė;Drugeliai;1088813143;Ne;0;0;3;3
16048;Saulutė;Drugeliai;6304028361;Ne;0;0;5;5
16049;Saulutė;Drugeliai;7139492238;Ne;0;0;3;3
16050;Saulutė;Drugeliai;2750955550;Ne;10;3;2;15
16051;Saulutė;Drugeliai;5931269521;Ne;0;7;0;7
16052;Saulutė;Drugeliai;3730442890;Ne;0;11;0;11
16053;Saulutė;Drugeliai;8409958782;Ne;0;3;1;4
16054;Saulutė;"Saulės zuikučiai";5448950324;Ne;0;9;0;9
16055;Saulutė;"Saulės zuikučiai";3948540247;Ne;0;4;0;4
16056;Saulutė;"Saulės zuikučiai";4130972647;Ne;3;2;2;7
16057;Saulutė;"Saulės zuikučiai";3242810449;Ne;0;4;0;4
16058;Saulutė;"Saulės zuikučiai";9110162513;Ne;0;22;0;22
16059;Saulutė;"Saulės zuikučiai";1648978545;Ne;0;3;0;3
16060;Saulutė;"Saulės zuikučiai";6927834443;Ne;0;9;0;9
16061;Saulutė;"Saulės zuikučiai";8714520840;Ne;3;17;2;22
16062;Saulutė;"Saulės zuikučiai";9726675673;Ne;13;2;2;17
16063;Saulutė;"Saulės zuikučiai";8520474896;Ne;13;2;2;17
16064;Saulutė;"Saulės zuikučiai";6189637986;Ne;0;2;0;2
16065;Saulutė;"Saulės zuikučiai";7132125341;Ne;0;14;0;14
16066;Saulutė;"Saulės zuikučiai";3215349379;Ne;0;14;0;14
16067;Saulutė;"Saulės zuikučiai";3259790911;Ne;0;9;0;9
16068;Saulutė;"Saulės zuikučiai";7311594119;Ne;0;17;0;17
16069;Saulutė;"Saulės zuikučiai";9567511354;Ne;0;5;0;5
16070;Saulutė;"Saulės zuikučiai";6579874077;Ne;0;10;0;10
16071;Saulutė;"Saulės zuikučiai";6178908581;Ne;3;1;2;6
16072;Saulutė;"Saulės zuikučiai";8472510151;Ne;0;2;0;2
16073;Saulutė;"Saulės zuikučiai";7478215328;Ne;0;4;0;4
16074;Saulutė;"Saulės zuikučiai";9727366891;Ne;0;6;0;6
16075;Saulutė;"Saulės zuikučiai";4222649372;Ne;0;1;0;1
16076;Saulutė;Boružėlės;3295289082;Ne;0;3;1;4
16077;Saulutė;Boružėlės;1587328722;Ne;0;3;0;3
16078;Saulutė;Boružėlės;8390767549;Ne;0;2;0;2
16079;Saulutė;Boružėlės;7576532632;Ne;0;3;1;4
16080;Saulutė;Boružėlės;9314889468;Ne;0;2;0;2
16081;Saulutė;Boružėlės;7764493159;Ne;0;2;0;2
16082;Saulutė;Boružėlės;5565832676;Ne;0;2;0;2
16083;Saulutė;Boružėlės;5811810714;Ne;0;2;0;2
16084;Saulutė;Boružėlės;8643975544;Ne;0;3;1;4
16085;Saulutė;Boružėlės;7081700501;Ne;0;2;0;2
16086;Saulutė;Boružėlės;7474989619;Ne;0;12;0;12
16087;Saulutė;Boružėlės;1803710557;Ne;0;3;1;4
16088;Saulutė;Boružėlės;9173336078;Ne;0;2;0;2
16089;Saulutė;Boružėlės;9098663596;Ne;0;2;0;2
16090;Saulutė;Boružėlės;1265174091;Ne;0;2;0;2
16091;Saulutė;Boružėlės;2988010963;Ne;0;17;0;17
16092;Saulutė;Boružėlės;3852862834;Ne;0;7;0;7
16093;Saulutė;Boružėlės;1275552038;Ne;3;3;2;8
16094;Saulutė;Boružėlės;3363212754;Ne;0;6;0;6
16095;Saulutė;Boružėlės;8086759121;Ne;0;3;2;5
16096;Saulutė;Boružėlės;4840187188;Ne;3;3;3;9
16097;Saulutė;Nykštukai;2601822200;Ne;3;0;3;6
16098;Saulutė;Nykštukai;5607937410;Ne;0;2;0;2
16099;Saulutė;Nykštukai;3571751974;Ne;0;0;2;2
16100;Saulutė;Nykštukai;3221612665;Ne;3;0;4;7
16101;Saulutė;Nykštukai;2140277182;Ne;15;2;4;21
16102;Saulutė;Nykštukai;4800144085;Ne;20;0;2;22
16103;Saulutė;Nykštukai;8257363228;Ne;0;2;2;4
16104;Saulutė;Nykštukai;9337687977;Ne;3;0;5;8
16105;Saulutė;Nykštukai;9664809396;Ne;0;2;2;4
16106;Saulutė;Nykštukai;8984040932;Ne;0;7;0;7
16107;Saulutė;Nykštukai;3463428772;Ne;0;0;2;2
16108;Saulutė;Nykštukai;9930330487;Ne;0;4;0;4
16109;Saulutė;Nykštukai;1229624643;Ne;0;3;0;3
16110;Saulutė;Nykštukai;9572394489;Ne;0;8;6;14
16111;Saulutė;Nykštukai;5509365461;Ne;0;8;0;8
16112;Saulutė;Nykštukai;3408369823;Ne;0;0;6;6
16113;Saulutė;Nykštukai;5264813819;Ne;0;0;2;2
16114;Saulutė;Nykštukai;3265401334;Ne;3;0;3;6
16115;Saulutė;Nykštukai;9497439410;Ne;0;6;0;6
16116;Saulutė;Nykštukai;5335820652;Ne;0;1;2;3
16117;Saulutė;Nykštukai;4510990261;Ne;0;2;1;3
16118;Saulutė;Nykštukai;7555183487;Ne;4;1;3;8
16119;Saulutė;Meškiukai;5219429911;Ne;0;10;0;10
16120;Saulutė;Meškiukai;8787977881;Ne;0;8;0;8
16121;Saulutė;Meškiukai;8147755754;Ne;3;0;8;11
16122;Saulutė;Meškiukai;1562476697;Ne;15;0;4;19
16123;Saulutė;Meškiukai;1776176097;Ne;4;0;4;8
16124;Saulutė;Meškiukai;1408451926;Ne;13;7;2;22
16125;Saulutė;Meškiukai;9175541045;Ne;0;0;1;1
16126;Saulutė;Meškiukai;6978306762;Ne;0;0;3;3
16127;Saulutė;Meškiukai;7757420187;Ne;8;0;4;12
16128;Saulutė;Meškiukai;1415128133;Ne;0;0;2;2
16129;Saulutė;Meškiukai;9919098322;Ne;0;0;11;11
16130;Saulutė;Meškiukai;1848147862;Ne;0;0;8;8
16131;Saulutė;Meškiukai;3883395634;Ne;4;0;4;8
16132;Saulutė;Meškiukai;2929345460;Ne;0;8;4;12
16133;Saulutė;Meškiukai;9825396096;Ne;20;0;2;22
16134;Saulutė;Meškiukai;1175393220;Ne;0;0;8;8
16135;Saulutė;Meškiukai;8844784669;Ne;6;0;4;10
16136;Saulutė;Ežiukai;2813274509;Ne;7;0;4;11
16137;Saulutė;Ežiukai;2315812734;Ne;1;0;5;6
16138;Saulutė;Ežiukai;8736917541;Taip;0;1;2;3
16139;Saulutė;Ežiukai;4363210987;Taip;0;2;1;3
16140;Saulutė;Ežiukai;5972503001;Ne;10;0;3;13
16141;Saulutė;Ežiukai;6884472677;Taip;5;0;3;8
16142;Saulutė;Ežiukai;4194586403;Ne;5;0;6;11
16143;Saulutė;Ežiukai;1853984777;Ne;5;0;5;10
16144;Saulutė;Ežiukai;1666301750;Ne;0;2;7;9
16145;Saulutė;Ežiukai;3133714991;Ne;0;0;4;4
16146;Saulutė;Ežiukai;7967532537;Ne;0;0;3;3
16147;Saulutė;Ežiukai;2728669975;Ne;0;5;2;7
16148;Saulutė;Ežiukai;9398356470;Ne;20;0;2;22
16149;Saulutė;Ežiukai;6126870829;Ne;4;2;2;8
16150;Saulutė;Ežiukai;3565818383;Ne;0;0;2;2
16151;Saulutė;Ežiukai;9101950978;Ne;5;0;6;11
16152;Saulutė;Ežiukai;6982979199;Ne;0;0;1;1
16153;Saulutė;Ežiukai;8919457259;Ne;0;0;1;1
16154;Saulutė;Ežiukai;3125186472;Ne;5;0;3;8
16155;Saulutė;Ežiukai;7941601480;Ne;0;5;0;5
16156;Saulutė;Ežiukai;8961335897;Ne;7;0;4;11
16157;Saulutė;Ežiukai;4039065925;Ne;6;0;4;10
16158;Saulutė;Bitutės;5897526863;Ne;3;0;4;7
16159;Saulutė;Bitutės;6531388817;Ne;0;0;3;3
16160;Saulutė;Bitutės;1640977737;Ne;3;0;3;6
16161;Saulutė;Bitutės;2251663689;Ne;0;12;10;22
16162;Saulutė;Bitutės;8428335721;Ne;0;0;4;4
16163;Saulutė;Bitutės;5623547412;Ne;15;0;2;17
16164;Saulutė;Bitutės;1931298484;Ne;0;4;0;4
16165;Saulutė;Bitutės;5308928580;Ne;10;0;4;14
16166;Saulutė;Bitutės;9741004996;Ne;0;0;8;8
16167;Saulutė;Bitutės;3883903645;Ne;0;0;2;2
16168;Saulutė;Bitutės;2402895955;Ne;0;0;4;4
16169;Saulutė;Bitutės;4055603288;Ne;0;2;1;3
16170;Saulutė;Bitutės;8551251470;Ne;0;15;2;17
16171;Saulutė;Bitutės;2849357495;Ne;0;7;2;9
16172;Saulutė;Bitutės;1763631244;Ne;0;0;13;13
16173;Saulutė;Bitutės;7123687661;Ne;20;0;2;22
16174;Saulutė;Pelėdžiukai;8512137633;Ne;2;6;2;10
16175;Saulutė;Pelėdžiukai;4211866191;Ne;0;0;2;2
16176;Saulutė;Pelėdžiukai;2373409300;Ne;0;0;11;11
16177;Saulutė;Pelėdžiukai;8405262902;Ne;0;0;6;6
16178;Saulutė;Pelėdžiukai;1745754752;Ne;0;0;6;6
16179;Saulutė;Pelėdžiukai;1056158093;Ne;0;0;2;2
16180;Saulutė;Pelėdžiukai;8371366346;Ne;0;6;0;6
16181;Saulutė;Pelėdžiukai;6842585310;Ne;0;0;11;11
16182;Saulutė;Pelėdžiukai;1776164273;Ne;0;0;5;5
16183;Saulutė;Pelėdžiukai;5850783789;Ne;0;4;0;4
16184;Saulutė;Pelėdžiukai;7243072252;Ne;0;2;0;2
16185;Saulutė;Pelėdžiukai;9903380188;Ne;2;0;5;7
16186;Saulutė;Pelėdžiukai;2450554594;Ne;0;2;0;2
16187;Saulutė;Pelėdžiukai;7620841597;Ne;0;0;3;3
16188;Saulutė;Pelėdžiukai;7640441297;Ne;0;1;0;1
16189;Saulutė;Pelėdžiukai;6046611248;Taip;0;10;0;10
16190;Saulutė;Pelėdžiukai;4301516165;Ne;4;15;2;21
16191;Saulutė;Pelėdžiukai;7258180835;Ne;0;0;1;1
16192;Saulutė;Pelėdžiukai;2566263680;Ne;0;17;2;19
16193;Saulutė;Pelėdžiukai;9106119465;Ne;0;0;9;9
16194;Saulutė;Pelėdžiukai;4179271978;Ne;3;0;11;14
16195;Saulutė;Zylutės;3228226715;Ne;0;2;2;4
16196;Saulutė;Zylutės;8040751073;Ne;0;1;2;3
16197;Saulutė;Zylutės;2074473832;Ne;0;0;1;1
16198;Saulutė;Zylutės;6109527712;Ne;3;0;5;8
16199;Saulutė;Zylutės;4686825392;Ne;0;2;0;2
16200;Saulutė;Zylutės;7446423510;Ne;0;8;0;8
16201;Saulutė;Zylutės;8717210130;Ne;7;8;2;17
16202;Saulutė;Zylutės;8211523302;Ne;6;2;2;10
16203;Saulutė;Zylutės;3272296969;Ne;0;2;0;2
16204;Saulutė;Zylutės;7032417938;Taip;0;1;0;1
16205;Saulutė;Zylutės;1784093413;Ne;3;0;6;9
16206;Saulutė;Zylutės;8722717930;Ne;0;0;22;22
16207;Saulutė;Zylutės;5442075474;Ne;13;0;4;17
16208;Saulutė;Zylutės;4136425904;Ne;10;4;2;16
16209;Saulutė;Zylutės;4390098560;Ne;0;2;0;2
16210;Saulutė;Zylutės;4663795223;Ne;0;17;0;17
16211;Saulutė;Zylutės;7839168221;Ne;0;2;0;2
16212;Saulutė;Zylutės;2527027536;Ne;0;12;3;15
16213;Saulutė;Zylutės;2725491887;Ne;20;0;2;22
16214;Saulutė;Zylutės;1712365476;Ne;13;2;4;19
16215;Saulutė;Zylutės;4516130694;Ne;5;15;2;22
16216;Saulutė;Zylutės;5460773696;Ne;0;0;14;14
16217;Saulutė;"1 klasė";7844396402;Ne;0;2;0;2
16218;Saulutė;"1 klasė";8379304869;Ne;0;4;0;4
16219;Saulutė;"1 klasė";9947607411;Ne;0;2;0;2
16220;Saulutė;"1 klasė";7351477901;Ne;0;2;0;2
16221;Saulutė;"1 klasė";1324799653;Ne;0;2;0;2
16222;Saulutė;"1 klasė";95439358242;Ne;0;2;0;2
16223;Saulutė;"1 klasė";3691381351;Ne;0;2;0;2
16224;Saulutė;"1 klasė";8242602551;Ne;0;4;0;4
16225;Saulutė;"1 klasė";2397257894;Ne;0;2;0;2
16226;Saulutė;"1 klasė";5326279083;Ne;0;2;0;2
16227;Saulutė;"1 klasė";8946107286;Ne;0;2;0;2
16228;Saulutė;"1 klasė";7888435573;Ne;0;5;0;5
16229;Saulutė;"1 klasė";2781003892;Ne;0;2;0;2
16230;Saulutė;"1 klasė";2816806902;Ne;0;2;0;2
16231;Saulutė;"1 klasė";5247769309;Ne;0;2;0;2
16232;Saulutė;"1 klasė";9521155670;Ne;0;2;0;2
16233;Saulutė;"1 klasė";3620722907;Ne;0;2;0;2
16234;Saulutė;"1 klasė";3749374270;Ne;0;2;0;2
16235;Saulutė;"1 klasė";5148542811;Ne;0;2;0;2
16236;Saulutė;"1 klasė";1562393383;Ne;0;2;0;2
16237;Saulutė;"1 klasė";5641148690;Ne;0;2;0;2
16238;Saulutė;"1 klasė";4818911910;Ne;0;2;0;2
16239;Saulutė;"1 klasė";1833001939;Ne;0;2;0;2
16240;Saulutė;"1 klasė";8092104136;Ne;0;2;0;2
16241;Saulutė;"1 klasė";1625197280;Ne;0;2;0;2
16242;Saulutė;"1 klasė";4971244488;Ne;0;3;0;3
16243;Saulutė;"2 klasė";61073095949;Ne;0;7;0;7
16244;Saulutė;"2 klasė";1717909005;Ne;0;3;0;3
16245;Saulutė;"2 klasė";1513449225;Ne;0;3;0;3
16246;Saulutė;"2 klasė";87814849917;Ne;0;3;0;3
16247;Saulutė;"2 klasė";84919478493;Ne;0;3;0;3
16248;Saulutė;"2 klasė";1320018338;Ne;0;4;0;4
16249;Saulutė;"2 klasė";8599199376;Ne;0;2;0;2
16250;Saulutė;"2 klasė";8944601874;Ne;0;2;0;2
16251;Saulutė;"2 klasė";3064199909;Ne;0;4;0;4
16252;Saulutė;"2 klasė";1556270046;Ne;0;2;0;2
16253;Saulutė;"2 klasė";1911318708;Ne;0;2;0;2
16254;Saulutė;"2 klasė";4272320685;Ne;0;5;0;5
16255;Saulutė;"2 klasė";8952155496;Ne;0;2;0;2
16256;Saulutė;"2 klasė";28772515317;Ne;0;4;0;4
16257;Saulutė;"2 klasė";1291318940;Ne;0;3;0;3
16258;Saulutė;"2 klasė";2677995903;Ne;0;3;0;3
16259;Saulutė;"2 klasė";1391904744;Ne;0;2;0;2
16260;Saulutė;"2 klasė";1786491396;Ne;0;8;0;8
16261;Saulutė;"2 klasė";1386800520;Ne;0;9;0;9
16262;Saulutė;"2 klasė";6096297366;Ne;0;2;0;2
16263;Saulutė;"2 klasė";1332002470;Ne;0;2;0;2
16264;Saulutė;"2 klasė";1609952589;Ne;0;2;0;2
16265;Saulutė;"3 klasė";45306237230;Ne;0;6;0;6
16266;Saulutė;"3 klasė";79438946697;Ne;0;4;0;4
16267;Saulutė;"3 klasė";79919438191;Ne;0;9;0;9
16268;Saulutė;"3 klasė";29074930927;Ne;0;4;0;4
16269;Saulutė;"3 klasė";8369703027;Ne;0;4;0;4
16270;Saulutė;"3 klasė";21605684303;Ne;0;3;0;3
16271;Saulutė;"3 klasė";31705050946;Ne;0;3;0;3
16272;Saulutė;"3 klasė";37315117916;Ne;0;3;0;3
16273;Saulutė;"3 klasė";3445723020;Ne;0;2;0;2
16274;Saulutė;"3 klasė";2098990667;Ne;0;6;0;6
16275;Saulutė;"3 klasė";27386434894;Ne;0;2;0;2
16276;Saulutė;"3 klasė";77923802656;Ne;0;2;0;2
16277;Saulutė;"3 klasė";46280382280;Ne;0;3;0;3
16278;Saulutė;"3 klasė";1935503629;Ne;0;4;0;4
16279;Saulutė;"3 klasė";75405796772;Ne;0;22;0;22
16280;Saulutė;"3 klasė";1277263391;Ne;0;2;0;2
16281;Saulutė;"3 klasė";97145959022;Ne;0;18;0;18
16282;Saulutė;"3 klasė";64418469679;Ne;0;2;0;2
16283;Saulutė;"3 klasė";77170708225;Ne;0;4;0;4
16284;Saulutė;"3 klasė";4640909915;Ne;0;4;0;4
16285;Saulutė;"3 klasė";65492344097;Ne;0;2;0;2
16286;Saulutė;"3 klasė";1704733670;Ne;0;2;0;2
16287;Saulutė;"3 klasė";1534183935;Ne;0;2;0;2
16288;Saulutė;"3 klasė";5574049005;Ne;0;4;0;4
16289;Saulutė;"3 klasė";1510434265;Ne;0;2;0;2
16290;Saulutė;"3 klasė";1422040758;Ne;0;5;0;5
16291;Saulutė;"3 klasė";77951768319;Ne;0;2;0;2
16292;Saulutė;"4 klasė";1005459768;Ne;0;8;0;8
16293;Saulutė;"4 klasė";1804521229;Ne;0;4;0;4
16294;Saulutė;"4 klasė";76108591835;Ne;0;2;0;2
16295;Saulutė;"4 klasė";1475031090;Ne;0;4;0;4
16296;Saulutė;"4 klasė";3156830821;Ne;0;5;0;5
16297;Saulutė;"4 klasė";5741276602;Ne;0;2;0;2
16298;Saulutė;"4 klasė";3246485288;Ne;0;6;0;6
16299;Saulutė;"4 klasė";44452051978;Ne;0;12;0;12
16300;Saulutė;"4 klasė";78967475616;Ne;0;2;0;2
16301;Saulutė;"4 klasė";89710141573;Ne;0;2;0;2
16302;Saulutė;"4 klasė";25124975646;Ne;0;3;0;3
16303;Saulutė;"4 klasė";3450668814;Ne;0;3;0;3
16304;Saulutė;"4 klasė";8168961080;Ne;0;22;0;22
16305;Saulutė;"4 klasė";57283533169;Ne;0;2;0;2
16306;Saulutė;"4 klasė";76744652185;Ne;0;10;0;10
16307;Saulutė;"4 klasė";97296161595;Ne;0;2;0;2
16308;Saulutė;"4 klasė";1205642335;Ne;0;2;0;2
16309;Saulutė;"4 klasė";2426509692;Ne;0;11;0;11
16310;Saulutė;"4 klasė";36414547943;Ne;0;2;0;2
16311;Saulutė;"4 klasė";99841176399;Ne;0;2;0;2
16312;Saulutė;"4 klasė";21703177024;Ne;0;3;0;3
16313;Saulutė;"4 klasė";1337654926;Ne;0;2;0;2
16314;Saulutė;"4 klasė";54950572289;Ne;0;2;0;2
16315;Saulutė;"4 klasė";2787531476;Ne;0;3;0;3
16316;Saulutė;"4 klasė";13147367113;Ne;0;4;0;4
16317;Saulutė;"4 klasė";2216383015;Ne;0;14;0;14
16318;Saulutė;"4 klasė";1644704074;Ne;0;2;0;2
16319;Saulutė;"4 klasė";96497471950;Ne;0;9;0;9
16320;Saulutė;"4 klasė";6557918941;Ne;0;2;0;2
16321;Svaja;SAULĖGRĄŽA;9811110367;Ne;2;0;4;6
16322;Svaja;SAULĖGRĄŽA;1579441289;Ne;2;0;4;6
16323;Svaja;SAULĖGRĄŽA;3792660330;Ne;0;2;0;2
16324;Svaja;SAULĖGRĄŽA;7575922215;Ne;0;2;3;5
16325;Svaja;SAULĖGRĄŽA;4510147045;Ne;0;8;0;8
16326;Svaja;SAULĖGRĄŽA;9680766688;Ne;2;2;6;10
16327;Svaja;SAULĖGRĄŽA;3912426942;Ne;1;2;3;6
16328;Svaja;SAULĖGRĄŽA;3809817617;Ne;0;2;2;4
16329;Svaja;SAULĖGRĄŽA;3501620040;Ne;0;10;0;10
16330;Svaja;SAULĖGRĄŽA;4333001830;Ne;0;0;3;3
16331;Svaja;SAULĖGRĄŽA;6928763381;Ne;7;0;3;10
16332;Svaja;SAULĖGRĄŽA;7408966637;Ne;1;1;6;8
16333;Svaja;SAULĖGRĄŽA;7089640807;Ne;0;7;1;8
16334;Svaja;SAULĖGRĄŽA;3461282516;Ne;0;2;0;2
16335;Svaja;SAULĖGRĄŽA;4253831334;Ne;2;0;7;9
16336;Svaja;SAULĖGRĄŽA;6963684639;Ne;0;2;0;2
16337;Svaja;SAULĖGRĄŽA;4189290919;Ne;0;22;0;22
16338;Svaja;SAULĖGRĄŽA;7747251736;Ne;0;2;0;2
16339;Svaja;SAULĖGRĄŽA;8875703109;Ne;0;2;0;2
16340;Svaja;SAULĖGRĄŽA;1496216379;Ne;0;0;2;2
16341;Svaja;"STEBUKLINGAS ŽIBINTAS";1558093905;Ne;0;2;0;2
16342;Svaja;"STEBUKLINGAS ŽIBINTAS";1050291871;Ne;0;2;0;2
16343;Svaja;"STEBUKLINGAS ŽIBINTAS";2200408537;Ne;0;2;4;6
16344;Svaja;"STEBUKLINGAS ŽIBINTAS";9814969596;Ne;3;4;2;9
16345;Svaja;"STEBUKLINGAS ŽIBINTAS";4290716676;Ne;5;2;2;9
16346;Svaja;"STEBUKLINGAS ŽIBINTAS";9545690301;Ne;7;2;6;15
16347;Svaja;"STEBUKLINGAS ŽIBINTAS";6128350581;Ne;0;2;1;3
16348;Svaja;"STEBUKLINGAS ŽIBINTAS";9843726794;Ne;3;2;4;9
16349;Svaja;"STEBUKLINGAS ŽIBINTAS";2658828200;Ne;0;2;0;2
16350;Svaja;"STEBUKLINGAS ŽIBINTAS";3940123543;Ne;0;2;0;2
16351;Svaja;"STEBUKLINGAS ŽIBINTAS";1860076171;Ne;2;0;1;3
16352;Svaja;"STEBUKLINGAS ŽIBINTAS";9259478140;Ne;5;0;2;7
16353;Svaja;"STEBUKLINGAS ŽIBINTAS";4237592104;Ne;0;22;0;22
16354;Svaja;"STEBUKLINGAS ŽIBINTAS";8363418532;Ne;0;0;4;4
16355;Svaja;"STEBUKLINGAS ŽIBINTAS";7277217069;Ne;1;2;6;9
16356;Svaja;"STEBUKLINGAS ŽIBINTAS";8172396846;Ne;2;2;5;9
16357;Svaja;"STEBUKLINGAS ŽIBINTAS";2188430052;Ne;4;2;6;12
16358;Svaja;"STEBUKLINGAS ŽIBINTAS";4004383843;Ne;0;5;0;5
16359;Svaja;"STEBUKLINGAS ŽIBINTAS";8353427144;Ne;0;3;0;3
16360;Svaja;"STEBUKLINGAS ŽIBINTAS";9102872020;Ne;2;0;1;3
16361;Svaja;"STEBUKLINGAS ŽIBINTAS";1150040935;Ne;0;2;1;3
16362;Svaja;"STEBUKLINGAS ŽIBINTAS";4565097904;Ne;0;2;2;4
16363;Svaja;SAULUTĖ;8890454460;Ne;7;0;2;9
16364;Svaja;SAULUTĖ;5440231053;Ne;0;2;0;2
16365;Svaja;SAULUTĖ;3382252131;Ne;22;0;0;22
16366;Svaja;SAULUTĖ;4250501744;Ne;0;2;0;2
16367;Svaja;SAULUTĖ;3684781373;Ne;2;3;2;7
16368;Svaja;SAULUTĖ;1013124074;Ne;2;2;5;9
16369;Svaja;SAULUTĖ;8632400763;Ne;7;2;4;13
16370;Svaja;SAULUTĖ;5051491859;Ne;3;0;2;5
16371;Svaja;SAULUTĖ;1312040427;Ne;3;2;8;13
16372;Svaja;SAULUTĖ;9004673086;Ne;0;1;0;1
16373;Svaja;SAULUTĖ;5455078232;Ne;4;2;5;11
16374;Svaja;SAULUTĖ;7087302180;Ne;7;2;3;12
16375;Svaja;SAULUTĖ;6335409702;Ne;0;2;7;9
16376;Svaja;SAULUTĖ;6027456849;Ne;10;0;2;12
16377;Svaja;SAULUTĖ;8609098948;Ne;0;2;0;2
16378;Svaja;SAULUTĖ;1344097741;Ne;4;2;2;8
16379;Svaja;SAULUTĖ;7520701357;Ne;8;0;3;11
16380;Svaja;SAULUTĖ;6765463228;Ne;0;2;0;2
16381;Svaja;SAULUTĖ;4577061794;Ne;0;0;5;5
16382;Svaja;SAULUTĖ;2599692546;Ne;4;10;2;16
16383;Svaja;SAULUTĖ;4415517674;Ne;0;2;4;6
16384;Svaja;SAULUTĖ;6837946814;Ne;2;0;0;2
16385;Svaja;SAULUTĖ;6354364944;Ne;4;12;2;18
16386;Svaja;SAULUTĖ;5186248897;Ne;2;0;0;2
16387;Svaja;"AUKSINĖ ŽUVELĖ";1914129062;Ne;8;2;9;19
16388;Svaja;"AUKSINĖ ŽUVELĖ";9826552657;Ne;0;2;5;7
16389;Svaja;"AUKSINĖ ŽUVELĖ";2427918378;Ne;0;2;0;2
16390;Svaja;"AUKSINĖ ŽUVELĖ";3377044908;Ne;3;2;6;11
16391;Svaja;"AUKSINĖ ŽUVELĖ";3567924341;Ne;5;0;7;12
16392;Svaja;"AUKSINĖ ŽUVELĖ";5033214011;Ne;2;2;2;6
16393;Svaja;"AUKSINĖ ŽUVELĖ";5013548619;Ne;6;0;6;12
16394;Svaja;"AUKSINĖ ŽUVELĖ";9091970902;Ne;1;0;3;4
16395;Svaja;"AUKSINĖ ŽUVELĖ";6028471687;Ne;5;0;2;7
16396;Svaja;"AUKSINĖ ŽUVELĖ";1877749103;Ne;0;2;1;3
16397;Svaja;"AUKSINĖ ŽUVELĖ";7605002899;Ne;0;2;5;7
16398;Svaja;"AUKSINĖ ŽUVELĖ";5230444195;Ne;0;4;0;4
16399;Svaja;"AUKSINĖ ŽUVELĖ";5224855138;Ne;2;2;2;6
16400;Svaja;"AUKSINĖ ŽUVELĖ";5908440171;Ne;0;0;3;3
16401;Svaja;"AUKSINĖ ŽUVELĖ";7562678317;Ne;8;2;9;19
16402;Svaja;"AUKSINĖ ŽUVELĖ";5198482539;Ne;0;1;0;1
16403;Svaja;"AUKSINĖ ŽUVELĖ";7434898745;Ne;0;20;2;22
16404;Svaja;"AUKSINĖ ŽUVELĖ";2641473764;Ne;0;0;2;2
16405;Svaja;"AUKSINĖ ŽUVELĖ";6086270618;Ne;3;1;2;6
16406;Svaja;"AUKSINĖ ŽUVELĖ";1932506236;Ne;6;2;9;17
16407;Svaja;"AUKSINĖ ŽUVELĖ";3708286263;Ne;0;2;4;6
16408;Svaja;"PRIE ĮLANKOS";9240037050;Ne;4;2;2;8
16409;Svaja;"PRIE ĮLANKOS";6980866050;Ne;0;1;0;1
16410;Svaja;"PRIE ĮLANKOS";3459060550;Ne;8;2;5;15
16411;Svaja;"PRIE ĮLANKOS";6361228838;Ne;5;2;2;9
16412;Svaja;"PRIE ĮLANKOS";7853479591;Ne;0;2;2;4
16413;Svaja;"PRIE ĮLANKOS";2770477678;Ne;2;5;2;9
16414;Svaja;"PRIE ĮLANKOS";5127370193;Ne;0;0;1;1
16415;Svaja;"PRIE ĮLANKOS";9689082202;Ne;5;0;3;8
16416;Svaja;"PRIE ĮLANKOS";3612833383;Ne;0;2;0;2
16417;Svaja;"PRIE ĮLANKOS";2993145079;Ne;3;2;2;7
16418;Svaja;"PRIE ĮLANKOS";6385127914;Ne;8;2;3;13
16419;Svaja;"PRIE ĮLANKOS";6102907953;Ne;3;3;8;14
16420;Svaja;"PRIE ĮLANKOS";2070084064;Ne;0;0;3;3
16421;Svaja;"PRIE ĮLANKOS";4256222944;Ne;7;2;4;13
16422;Svaja;"PRIE ĮLANKOS";4376033711;Ne;0;10;0;10
16423;Svaja;"PRIE ĮLANKOS";1953538445;Ne;2;0;2;4
16424;Svaja;"PRIE ĮLANKOS";5126348190;Ne;0;6;0;6
16425;Svaja;"PRIE ĮLANKOS";3823958567;Ne;0;2;0;2
16426;Svaja;"PRIE ĮLANKOS";6059069293;Ne;0;2;6;8
16427;Svaja;"PRIE ĮLANKOS";8622800666;Ne;3;2;7;12
16428;Svaja;"PRIE ĮLANKOS";5668878259;Ne;2;0;2;4
16429;Svaja;"1 B klasė";20473739993;Ne;5;17;0;22
16430;Svaja;"1 B klasė";50207734108;Ne;0;2;0;2
16431;Svaja;"1 B klasė";8689706130;Ne;0;2;0;2
16432;Svaja;"1 B klasė";1045300185;Ne;0;2;0;2
16433;Svaja;"1 B klasė";6665752307;Ne;1;2;0;3
16434;Svaja;"1 B klasė";5479482244;Ne;3;2;0;5
16435;Svaja;"1 B klasė";7020342969;Ne;0;2;0;2
16436;Svaja;"1 B klasė";2166382346;Ne;1;2;0;3
16437;Svaja;"1 B klasė";8503177793;Ne;1;2;0;3
16438;Svaja;"1 B klasė";1633236289;Ne;5;2;0;7
16439;Svaja;"1 B klasė";8656417794;Ne;0;2;0;2
16440;Svaja;"1 B klasė";4014493868;Ne;1;2;0;3
16441;Svaja;"1 B klasė";6388514464;Ne;0;2;0;2
16442;Svaja;"1 B klasė";1044733634;Ne;4;2;0;6
16443;Svaja;"1 B klasė";1392455608;Ne;0;2;0;2
16444;Svaja;"1 B klasė";9864664937;Ne;0;2;0;2
16445;Svaja;"1 B klasė";1617844709;Ne;3;2;0;5
16446;Svaja;"1 B klasė";5862570666;Ne;0;2;0;2
16447;Svaja;"1 B klasė";3102257512;Ne;0;2;0;2
16448;Svaja;"1 B klasė";4284157599;Ne;0;2;0;2
16449;Svaja;"1 B klasė";9950569499;Ne;0;2;0;2
16450;Svaja;"1 B klasė";3458374439;Ne;3;2;0;5
16451;Svaja;"1 B klasė";4541391191;Ne;6;2;0;8
16452;Svaja;"1 B klasė";7205437280;Ne;0;2;0;2
16453;Svaja;"1 B klasė";6638804854;Ne;2;2;0;4
16454;Svaja;"1 B klasė";67304194087;Ne;0;2;0;2
16455;Svaja;"1 B klasė";3000676765;Ne;2;2;0;4
16456;Svaja;"1 B klasė";2627089275;Ne;3;2;0;5
16457;Svaja;"1 A klasė";9112198914;Ne;0;2;0;2
16458;Svaja;"1 A klasė";6807834176;Ne;0;2;0;2
16459;Svaja;"1 A klasė";7936765752;Ne;0;2;0;2
16460;Svaja;"1 A klasė";3049808328;Ne;1;2;0;3
16461;Svaja;"1 A klasė";3802996573;Ne;5;2;0;7
16462;Svaja;"1 A klasė";5443682744;Ne;0;2;0;2
16463;Svaja;"1 A klasė";9475971731;Ne;7;2;0;9
16464;Svaja;"1 A klasė";4968201186;Ne;4;2;0;6
16465;Svaja;"1 A klasė";7473493846;Ne;7;2;0;9
16466;Svaja;"1 A klasė";30719991872;Ne;0;2;0;2
16467;Svaja;"1 A klasė";3633996231;Ne;3;2;0;5
16468;Svaja;"1 A klasė";2750615517;Ne;1;2;0;3
16469;Svaja;"1 A klasė";9311520300;Ne;3;2;0;5
16470;Svaja;"1 A klasė";5595087767;Ne;0;2;0;2
16471;Svaja;"1 A klasė";6676145522;Ne;0;2;0;2
16472;Svaja;"1 A klasė";2018689468;Ne;2;2;0;4
16473;Svaja;"1 A klasė";1671495181;Ne;3;2;0;5
16474;Svaja;"1 A klasė";7514587933;Ne;9;2;0;11
16475;Svaja;"1 A klasė";4393041946;Ne;1;2;0;3
16476;Svaja;"1 A klasė";3868254757;Ne;0;2;0;2
16477;Svaja;"1 A klasė";1377813636;Ne;0;2;0;2
16478;Svaja;"1 A klasė";3630922360;Ne;0;2;0;2
16479;Svaja;"1 A klasė";6995285377;Ne;0;2;0;2
16480;Svaja;"1 A klasė";2436416327;Ne;0;2;0;2
16481;Svaja;"1 A klasė";8357287467;Ne;0;2;0;2
16482;Svaja;"1 A klasė";3636826798;Ne;0;2;0;2
16483;Svaja;"1 A klasė";1114477688;Ne;2;2;0;4
16484;Svaja;"1 A klasė";5356005675;Ne;6;2;0;8
16485;Svaja;"2 A klasė";43307670660;Ne;2;2;0;4
16486;Svaja;"2 A klasė";58102699652;Ne;0;2;0;2
16487;Svaja;"2 A klasė";5335776957;Ne;0;22;0;22
16488;Svaja;"2 A klasė";22702341083;Ne;7;2;0;9
16489;Svaja;"2 A klasė";2076060840;Ne;5;2;0;7
16490;Svaja;"2 A klasė";27445299450;Ne;6;2;0;8
16491;Svaja;"2 A klasė";1576498450;Ne;4;2;0;6
16492;Svaja;"2 A klasė";1714711904;Ne;0;22;0;22
16493;Svaja;"2 A klasė";1046879533;Ne;10;2;0;12
16494;Svaja;"2 A klasė";65917456866;Ne;0;2;0;2
16495;Svaja;"2 A klasė";4846025153;Ne;0;2;0;2
16496;Svaja;"2 A klasė";47457128214;Ne;2;2;0;4
16497;Svaja;"2 A klasė";2147266053;Ne;1;2;0;3
16498;Svaja;"2 A klasė";1197826066;Ne;0;2;0;2
16499;Svaja;"2 A klasė";5337604370;Ne;0;22;0;22
16500;Svaja;"2 A klasė";73679997517;Ne;0;2;0;2
16501;Svaja;"2 A klasė";56117509354;Ne;6;2;0;8
16502;Svaja;"2 A klasė";7669562010;Ne;5;2;0;7
16503;Svaja;"2 A klasė";4900757614;Ne;3;2;0;5
16504;Svaja;"2 A klasė";1061894314;Ne;3;2;0;5
16505;Svaja;"2 A klasė";8697355813;Ne;6;2;0;8
16506;Svaja;"2 A klasė";193181908;Ne;0;2;0;2
16507;Svaja;"2 A klasė";193181908;Ne;0;2;0;2
16508;Svaja;"2 B klasė";25194696146;Ne;3;2;0;5
16509;Svaja;"2 B klasė";55925058866;Ne;1;21;0;22
16510;Svaja;"2 B klasė";1704075006;Ne;0;2;0;2
16511;Svaja;"2 B klasė";8875237023;Ne;0;2;0;2
16512;Svaja;"2 B klasė";8279605005;Ne;3;19;0;22
16513;Svaja;"2 B klasė";1437557657;Ne;7;2;0;9
16514;Svaja;"2 B klasė";36505115395;Ne;12;10;0;22
16515;Svaja;"2 B klasė";6593047776;Ne;0;2;0;2
16516;Svaja;"2 B klasė";7911488445;Ne;0;2;0;2
16517;Svaja;"2 B klasė";64196174690;Ne;0;22;0;22
16518;Svaja;"2 B klasė";7753488216;Ne;1;2;0;3
16519;Svaja;"2 B klasė";21871530266;Ne;1;2;0;3
16520;Svaja;"2 B klasė";9110985103;Ne;0;2;0;2
16521;Svaja;"2 B klasė";2985196852;Ne;3;2;0;5
16522;Svaja;"2 B klasė";3562817807;Ne;2;20;0;22
16523;Svaja;"2 B klasė";2069150261;Ne;3;2;0;5
16524;Svaja;"2 B klasė";1191494598;Ne;8;2;0;10
16525;Svaja;"2 B klasė";24863928147;Ne;3;2;0;5
16526;Svaja;"2 B klasė";15159708127;Ne;0;2;0;2
16527;Svaja;"2 B klasė";8491275729;Ne;11;2;0;13
16528;Svaja;"2 B klasė";11671380984;Ne;2;2;0;4
16529;Svaja;"2 B klasė";99183628764;Ne;7;2;0;9
16530;Svaja;"2 B klasė";1369637618;Ne;0;2;0;2
16531;Svaja;"2 B klasė";3660152224;Ne;0;2;0;2
16532;Svaja;"2 B klasė";1865658456;Ne;3;2;0;5
16533;Svaja;"3 A klasė";9628146488;Ne;0;2;0;2
16534;Svaja;"3 A klasė";1017471747;Ne;1;2;0;3
16535;Svaja;"3 A klasė";1304775332;Ne;3;2;0;5
16536;Svaja;"3 A klasė";26902749194;Ne;0;2;0;2
16537;Svaja;"3 A klasė";1297727288;Ne;0;2;0;2
16538;Svaja;"3 A klasė";30027404222;Ne;0;2;0;2
16539;Svaja;"3 A klasė";1352488176;Ne;0;2;0;2
16540;Svaja;"3 A klasė";1943166503;Ne;2;2;0;4
16541;Svaja;"3 A klasė";8198614500;Ne;2;2;0;4
16542;Svaja;"3 A klasė";5522433229;Ne;2;2;0;4
16543;Svaja;"3 A klasė";40856210635;Ne;9;2;0;11
16544;Svaja;"3 A klasė";67462299886;Ne;3;2;0;5
16545;Svaja;"3 A klasė";18733824395;Ne;1;2;0;3
16546;Svaja;"3 A klasė";26500981786;Ne;2;2;0;4
16547;Svaja;"3 A klasė";89042677798;Ne;0;2;0;2
16548;Svaja;"3 A klasė";3022690832;Ne;10;2;0;12
16549;Svaja;"3 A klasė";23112873505;Ne;0;2;0;2
16550;Svaja;"3 A klasė";15246943974;Ne;0;2;0;2
16551;Svaja;"3 A klasė";1562041360;Ne;0;2;0;2
16552;Svaja;"3 A klasė";2058827699;Ne;6;2;0;8
16553;Svaja;"3 A klasė";84508228457;Ne;0;2;0;2
16554;Svaja;"3 A klasė";1048576329;Ne;3;2;0;5
16555;Svaja;"3 B klasė";69028070656;Ne;6;2;0;8
16556;Svaja;"3 B klasė";30360097999;Ne;0;22;0;22
16557;Svaja;"3 B klasė";19887874988;Ne;3;2;0;5
16558;Svaja;"3 B klasė";1967394949;Ne;0;2;0;2
16559;Svaja;"3 B klasė";7719185632;Ne;0;2;0;2
16560;Svaja;"3 B klasė";57216954289;Ne;3;2;0;5
16561;Svaja;"3 B klasė";44989143252;Ne;4;2;0;6
16562;Svaja;"3 B klasė";87432529423;Ne;1;2;0;3
16563;Svaja;"3 B klasė";3077814152;Ne;2;2;0;4
16564;Svaja;"3 B klasė";6056157113;Ne;2;2;0;4
16565;Svaja;"3 B klasė";21608020858;Ne;4;2;0;6
16566;Svaja;"3 B klasė";1655551042;Ne;3;2;0;5
16567;Svaja;"3 B klasė";1601648171;Ne;5;2;0;7
16568;Svaja;"3 B klasė";1509272327;Ne;3;2;0;5
16569;Svaja;"3 B klasė";4804779327;Ne;2;20;0;22
16570;Svaja;"3 B klasė";40814723278;Ne;3;2;0;5
16571;Svaja;"3 B klasė";69413101571;Ne;1;2;0;3
16572;Svaja;"3 B klasė";54745410330;Ne;6;2;0;8
16573;Svaja;"3 B klasė";4881476441;Ne;1;2;0;3
16574;Svaja;"3 B klasė";78293798850;Ne;2;2;0;4
16575;Svaja;"3 B klasė";30036722764;Ne;0;2;0;2
16576;Svaja;"3 B klasė";89316574266;Ne;7;15;0;22
16577;Svaja;"3 B klasė";809734624;Ne;2;2;0;4
16578;Svaja;"3 B klasė";76618850202;Ne;1;2;0;3
16579;Svaja;"3 B klasė";1378219785;Ne;0;2;0;2
16580;Svaja;"4 A klasė";6057524892;Ne;0;22;0;22
16581;Svaja;"4 A klasė";63346231562;Ne;3;2;0;5
16582;Svaja;"4 A klasė";25578518444;Ne;0;2;0;2
16583;Svaja;"4 A klasė";64487515384;Ne;0;22;0;22
16584;Svaja;"4 A klasė";15252353189;Ne;1;2;0;3
16585;Svaja;"4 A klasė";4617061890;Ne;1;2;0;3
16586;Svaja;"4 A klasė";8828911320;Ne;0;22;0;22
16587;Svaja;"4 A klasė";75104768118;Ne;0;2;0;2
16588;Svaja;"4 A klasė";3604946305;Ne;0;22;0;22
16589;Svaja;"4 A klasė";34216516886;Ne;0;2;0;2
16590;Svaja;"4 A klasė";3474439050;Ne;4;2;0;6
16591;Svaja;"4 A klasė";72752022712;Ne;2;2;0;4
16592;Svaja;"4 A klasė";30754812113;Ne;0;2;0;2
16593;Svaja;"4 A klasė";75296600945;Ne;2;2;0;4
16594;Svaja;"4 A klasė";2321739150;Ne;6;2;0;8
16595;Svaja;"4 A klasė";1168637823;Ne;3;2;0;5
16596;Svaja;"4 A klasė";4906784415;Ne;2;2;0;4
16597;Svaja;"4 A klasė";60448774566;Ne;0;6;0;6
16598;Svaja;"4 A klasė";1649920341;Ne;1;2;0;3
16599;Svaja;"4 B klasė";70506691027;Ne;3;19;0;22
16600;Svaja;"4 B klasė";73391331150;Ne;4;18;0;22
16601;Svaja;"4 B klasė";70507326327;Ne;9;13;0;22
16602;Svaja;"4 B klasė";1470843400;Ne;3;2;0;5
16603;Svaja;"4 B klasė";8011137572;Ne;0;2;0;2
16604;Svaja;"4 B klasė";4416877973;Ne;0;2;0;2
16605;Svaja;"4 B klasė";54328462992;Ne;3;19;0;22
16606;Svaja;"4 B klasė";44418402260;Ne;2;2;0;4
16607;Svaja;"4 B klasė";1367687415;Ne;0;2;0;2
16608;Svaja;"4 B klasė";92044111261;Ne;3;2;0;5
16609;Svaja;"4 B klasė";1847775266;Ne;7;2;0;9
16610;Svaja;"4 B klasė";71708072632;Ne;3;2;0;5
16611;Svaja;"4 B klasė";56506642672;Ne;5;2;0;7
16612;Svaja;"4 B klasė";17947580061;Ne;5;2;0;7
16613;Svaja;"4 B klasė";3526873547;Ne;1;2;0;3
16614;Svaja;"4 B klasė";62971657427;Ne;0;2;0;2
16615;Svaja;"4 B klasė";50649509868;Ne;7;15;0;22
16616;Svaja;"4 B klasė";80772711351;Ne;7;2;0;9
16617;Svaja;"4 B klasė";11937575740;Ne;0;2;0;2
16618;Svaja;"4 B klasė";6969692916;Ne;0;2;0;2
16619;Svaja;"4 B klasė";4282243865;Ne;8;14;0;22
16620;Svaja;"4 B klasė";6905550313;Ne;0;2;0;2
16621;Svaja;"4 C klasė";93651139102;Ne;3;2;0;5
16622;Svaja;"4 C klasė";25934507261;Ne;6;2;0;8
16623;Svaja;"4 C klasė";89047123808;Ne;1;2;0;3
16624;Svaja;"4 C klasė";41183537732;Ne;4;2;0;6
16625;Svaja;"4 C klasė";50510924690;Ne;0;2;0;2
16626;Svaja;"4 C klasė";54462393937;Ne;1;2;0;3
16627;Svaja;"4 C klasė";74904581010;Ne;0;2;0;2
16628;Svaja;"4 C klasė";1795682827;Ne;0;2;0;2
16629;Svaja;"4 C klasė";2165716699;Ne;7;15;0;22
16630;Svaja;"4 C klasė";94449039022;Ne;1;19;0;20
16631;Svaja;"4 C klasė";85150525696;Ne;0;2;0;2
16632;Svaja;"4 C klasė";36001411632;Ne;2;2;0;4
16633;Svaja;"4 C klasė";34995551069;Ne;1;2;0;3
16634;Svaja;"4 C klasė";1742951527;Ne;5;2;0;7
16635;Svaja;"4 C klasė";1848422504;Ne;5;2;0;7
16636;Svaja;"4 C klasė";3743948734;Ne;3;2;0;5
16637;Svaja;"4 C klasė";70714898590;Ne;0;2;0;2
16638;Svaja;"4 C klasė";54852358913;Ne;1;2;0;3
16639;Svaja;"4 C klasė";57253216255;Ne;9;2;0;11
16640;Svaja;"4 C klasė";91855230473;Ne;4;2;0;6
16641;Svaja;"4 C klasė";1855559693;Ne;4;18;0;22
16642;Svaja;"4 C klasė";31216445971;Ne;2;20;0;22
16643;Svaja;"4 C klasė";20342193231;Ne;0;2;0;2
16644;Svaja;"4 C klasė";91088224294;Ne;7;11;0;18
16645;Šilelis;PAUKŠTELIAI;6128379060;Ne;3;4;4;11
16646;Šilelis;PAUKŠTELIAI;9653439873;Ne;0;10;0;10
16647;Šilelis;PAUKŠTELIAI;2823486581;Ne;0;1;0;1
16648;Šilelis;PAUKŠTELIAI;6369443270;Ne;0;1;0;1
16649;Šilelis;PAUKŠTELIAI;7595774842;Ne;6;0;6;12
16650;Šilelis;PAUKŠTELIAI;6614686867;Ne;9;0;3;12
16651;Šilelis;PAUKŠTELIAI;3053443777;Ne;0;0;1;1
16652;Šilelis;PAUKŠTELIAI;4960501068;Ne;3;4;2;9
16653;Šilelis;PAUKŠTELIAI;7072057348;Taip;0;4;0;4
16654;Šilelis;PAUKŠTELIAI;5974537364;Ne;0;5;0;5
16655;Šilelis;PAUKŠTELIAI;8166061969;Ne;3;0;1;4
16656;Šilelis;PAUKŠTELIAI;1124854378;Ne;2;1;2;5
16657;Šilelis;PAUKŠTELIAI;8184170908;Ne;8;0;4;12
16658;Šilelis;PAUKŠTELIAI;4432542988;Ne;3;0;4;7
16659;Šilelis;PAUKŠTELIAI;9799198904;Ne;4;0;2;6
16660;Šilelis;PAUKŠTELIAI;5493811298;Ne;1;2;3;6
16661;Šilelis;PAUKŠTELIAI;4032841142;Ne;3;0;2;5
16662;Šilelis;PAUKŠTELIAI;7652950762;Ne;5;0;5;10
16663;Šilelis;SKRUZDELIUKAI;6359318134;Ne;3;3;2;8
16664;Šilelis;SKRUZDELIUKAI;5598152793;Ne;5;3;2;10
16665;Šilelis;SKRUZDELIUKAI;8090773379;Ne;0;9;0;9
16666;Šilelis;SKRUZDELIUKAI;1200024379;Ne;7;0;0;7
16667;Šilelis;SKRUZDELIUKAI;7299084520;Ne;0;5;0;5
16668;Šilelis;SKRUZDELIUKAI;8578620603;Ne;0;0;2;2
16669;Šilelis;SKRUZDELIUKAI;9589138527;Ne;3;7;2;12
16670;Šilelis;SKRUZDELIUKAI;3967932407;Ne;0;5;0;5
16671;Šilelis;SKRUZDELIUKAI;2972202874;Taip;0;0;1;1
16672;Šilelis;SKRUZDELIUKAI;9461117894;Taip;0;5;4;9
16673;Šilelis;SKRUZDELIUKAI;5817818596;Ne;0;2;9;11
16674;Šilelis;SKRUZDELIUKAI;6827855685;Ne;14;0;3;17
16675;Šilelis;SKRUZDELIUKAI;5091571136;Ne;0;6;0;6
16676;Šilelis;SKRUZDELIUKAI;8297975308;Ne;15;5;2;22
16677;Šilelis;SKRUZDELIUKAI;3381053227;Ne;0;7;0;7
16678;Šilelis;SKRUZDELIUKAI;9276607554;Ne;0;7;0;7
16679;Šilelis;SKRUZDELIUKAI;6139976105;Ne;4;3;2;9
16680;Šilelis;SMERFY;3247333567;Ne;0;2;0;2
16681;Šilelis;SMERFY;9886134621;Ne;0;1;0;1
16682;Šilelis;SMERFY;3089270468;Ne;0;10;0;10
16683;Šilelis;SMERFY;4504627601;Ne;0;0;1;1
16684;Šilelis;SMERFY;7534468539;Ne;1;2;2;5
16685;Šilelis;SMERFY;6390855924;Ne;10;0;2;12
16686;Šilelis;SMERFY;1821827154;Ne;0;7;1;8
16687;Šilelis;SMERFY;4196893379;Ne;0;2;0;2
16688;Šilelis;SMERFY;5025956218;Ne;2;1;2;5
16689;Šilelis;SMERFY;8909345826;Ne;4;1;2;7
16690;Šilelis;SMERFY;9502563865;Ne;20;0;2;22
16691;Šilelis;SMERFY;3452984649;Ne;7;4;0;11
16692;Šilelis;SMERFY;8659845107;Ne;2;7;2;11
16693;Šilelis;SMERFY;1906712332;Ne;0;0;1;1
16694;Šilelis;EŽIUKAI;7074963804;Ne;0;1;0;1
16695;Šilelis;EŽIUKAI;4702068672;Ne;0;7;0;7
16696;Šilelis;EŽIUKAI;2295849333;Ne;3;6;2;11
16697;Šilelis;EŽIUKAI;1883483049;Ne;0;5;0;5
16698;Šilelis;EŽIUKAI;6854997486;Ne;0;0;2;2
16699;Šilelis;EŽIUKAI;6386996498;Ne;0;2;1;3
16700;Šilelis;EŽIUKAI;2681063256;Ne;3;0;2;5
16701;Šilelis;EŽIUKAI;6233673622;Ne;6;2;3;11
16702;Šilelis;EŽIUKAI;3312235148;Ne;1;2;2;5
16703;Šilelis;EŽIUKAI;5314433515;Ne;0;2;2;4
16704;Šilelis;EŽIUKAI;1980323777;Ne;0;2;2;4
16705;Šilelis;EŽIUKAI;9203888742;Ne;5;7;2;14
16706;Šilelis;EŽIUKAI;2289616655;Ne;0;2;3;5
16707;Šilelis;EŽIUKAI;5167084901;Ne;8;2;3;13
16708;Šilelis;EŽIUKAI;3669647107;Ne;0;2;0;2
16709;Šilelis;EŽIUKAI;2151250706;Ne;0;2;3;5
16710;Šilelis;EŽIUKAI;7891369140;Ne;1;2;2;5
16711;Šilelis;EŽIUKAI;4751611934;Ne;0;2;0;2
16712;Šilelis;NYKŠTUKAI;3046954717;Ne;2;0;4;6
16713;Šilelis;NYKŠTUKAI;3158708835;Ne;10;0;2;12
16714;Šilelis;NYKŠTUKAI;6107771932;Ne;4;1;6;11
16715;Šilelis;NYKŠTUKAI;4323998445;Ne;0;1;1;2
16716;Šilelis;NYKŠTUKAI;2095572561;Ne;3;1;4;8
16717;Šilelis;NYKŠTUKAI;2161973782;Ne;0;1;0;1
16718;Šilelis;NYKŠTUKAI;4459114205;Ne;5;2;4;11
16719;Šilelis;NYKŠTUKAI;3728633100;Ne;0;2;0;2
16720;Šilelis;NYKŠTUKAI;3999426414;Ne;3;10;2;15
16721;Šilelis;NYKŠTUKAI;5745874033;Ne;0;8;0;8
16722;Šilelis;NYKŠTUKAI;9769483899;Ne;3;4;2;9
16723;Šilelis;NYKŠTUKAI;8944490184;Ne;1;1;4;6
16724;Šilelis;NYKŠTUKAI;2908840424;Ne;0;9;0;9
16725;Šilelis;NYKŠTUKAI;6980045156;Ne;0;3;0;3
16726;Šilelis;NYKŠTUKAI;4868465692;Ne;0;6;0;6
16727;Šilelis;NYKŠTUKAI;4754544277;Ne;1;3;2;6
16728;Šilelis;NYKŠTUKAI;1222028604;Ne;7;0;7;14
16729;Šilelis;NYKŠTUKAI;7480611069;Ne;0;2;0;2
16730;Šilelis;NYKŠTUKAI;9360553910;Ne;0;8;0;8
16731;Šilelis;NYKŠTUKAI;6852463814;Ne;2;7;2;11
16732;Šilelis;NYKŠTUKAI;9715544798;Ne;0;4;0;4
16733;Šilelis;ANČIUKAI;1726944289;Ne;1;0;2;3
16734;Šilelis;ANČIUKAI;4336942500;Ne;3;0;2;5
16735;Šilelis;ANČIUKAI;9661578871;Ne;2;0;6;8
16736;Šilelis;ANČIUKAI;6616262730;Ne;0;3;1;4
16737;Šilelis;ANČIUKAI;4323750313;Ne;11;2;2;15
16738;Šilelis;ANČIUKAI;3221398692;Ne;6;0;2;8
16739;Šilelis;ANČIUKAI;6364741317;Ne;7;2;4;13
16740;Šilelis;ANČIUKAI;1325857464;Taip;0;7;0;7
16741;Šilelis;ANČIUKAI;9407916190;Ne;0;7;0;7
16742;Šilelis;ANČIUKAI;8188160849;Ne;0;0;2;2
16743;Šilelis;ANČIUKAI;7128670936;Ne;10;0;4;14
16744;Šilelis;ANČIUKAI;8613748314;Ne;0;1;1;2
16745;Šilelis;ANČIUKAI;5381213051;Ne;5;6;2;13
16746;Šilelis;ANČIUKAI;8807755852;Ne;0;6;0;6
16747;Šilelis;ANČIUKAI;4135383684;Ne;0;7;0;7
16748;Šilelis;ANČIUKAI;5926624138;Taip;0;9;0;9
16749;Šilelis;ANČIUKAI;8603589758;Ne;0;3;0;3
16750;Šilelis;ANČIUKAI;4996192593;Ne;3;2;4;9
16751;Šilelis;ANČIUKAI;6485433036;Ne;9;0;7;16
16752;Šilelis;ANČIUKAI;7968869585;Ne;7;0;4;11
16753;Šilelis;ANČIUKAI;3182336761;Ne;2;0;8;10
16754;Šilelis;ANČIUKAI;9767000842;Ne;0;3;0;3
16755;Šilelis;KAČIUKAI;3216168797;Ne;8;2;4;14
16756;Šilelis;KAČIUKAI;9848760151;Ne;0;2;2;4
16757;Šilelis;KAČIUKAI;4743459915;Ne;0;7;0;7
16758;Šilelis;KAČIUKAI;8387022157;Ne;8;5;2;15
16759;Šilelis;KAČIUKAI;3393466953;Ne;2;7;2;11
16760;Šilelis;KAČIUKAI;2111979474;Ne;0;0;2;2
16761;Šilelis;KAČIUKAI;8064905796;Ne;0;4;0;4
16762;Šilelis;KAČIUKAI;7123048946;Ne;0;2;1;3
16763;Šilelis;KAČIUKAI;2906501601;Ne;0;4;0;4
16764;Šilelis;KAČIUKAI;6510813364;Ne;0;2;2;4
16765;Šilelis;KAČIUKAI;8319185507;Ne;0;1;0;1
16766;Šilelis;KAČIUKAI;8504187981;Ne;0;5;0;5
16767;Šilelis;KAČIUKAI;6470073008;Ne;0;4;0;4
16768;Šilelis;KAČIUKAI;3419284228;Taip;8;0;4;12
16769;Šilelis;KAČIUKAI;3712001932;Ne;0;8;0;8
16770;Šilelis;KAČIUKAI;9106999969;Ne;1;2;2;5
16771;Šilelis;KAČIUKAI;6894466509;Ne;4;0;3;7
16772;Šilelis;KAČIUKAI;5026203678;Ne;0;6;0;6
16773;Šilelis;KAČIUKAI;1395257200;Ne;0;5;0;5
16774;Šilelis;KAČIUKAI;6561145380;Ne;0;5;0;5
16775;Šilelis;KAČIUKAI;5138192616;Ne;3;2;3;8
16776;Šilelis;KIŠKUČIAI;9480895465;Ne;0;2;1;3
16777;Šilelis;KIŠKUČIAI;8759694551;Ne;0;0;2;2
16778;Šilelis;KIŠKUČIAI;2209552706;Ne;6;2;4;12
16779;Šilelis;KIŠKUČIAI;3296197220;Ne;5;1;2;8
16780;Šilelis;KIŠKUČIAI;4386065478;Ne;0;5;0;5
16781;Šilelis;KIŠKUČIAI;7043644521;Ne;8;2;3;13
16782;Šilelis;KIŠKUČIAI;8096868221;Ne;0;2;2;4
16783;Šilelis;KIŠKUČIAI;9746722034;Ne;0;2;3;5
16784;Šilelis;KIŠKUČIAI;2551747888;Ne;0;0;1;1
16785;Šilelis;KIŠKUČIAI;5815768693;Ne;2;2;2;6
16786;Šilelis;KIŠKUČIAI;8598321310;Ne;1;2;6;9
16787;Šilelis;KIŠKUČIAI;4965573774;Ne;8;2;2;12
16788;Šilelis;KIŠKUČIAI;9992207035;Ne;10;0;4;14
16789;Šilelis;KIŠKUČIAI;5431978292;Ne;6;0;2;8
16790;Šilelis;KIŠKUČIAI;6415777619;Ne;1;0;6;7
16791;Šilelis;KIŠKUČIAI;7630784355;Ne;7;2;5;14
16792;Šilelis;KIŠKUČIAI;7822646258;Ne;1;1;2;4
16793;Šilelis;KIŠKUČIAI;4910899296;Ne;2;2;4;8
16794;Šilelis;KIŠKUČIAI;1070067484;Ne;0;0;2;2
16795;Šilelis;KREGŽDUTĖS;1025643459;Ne;4;0;2;6
16796;Šilelis;KREGŽDUTĖS;8453070684;Ne;7;1;4;12
16797;Šilelis;KREGŽDUTĖS;1286082219;Ne;0;2;1;3
16798;Šilelis;KREGŽDUTĖS;3068950702;Ne;3;0;4;7
16799;Šilelis;KREGŽDUTĖS;8665357907;Ne;6;3;4;13
16800;Šilelis;KREGŽDUTĖS;1152159735;Ne;11;0;4;15
16801;Šilelis;KREGŽDUTĖS;6630114847;Taip;4;0;2;6
16802;Šilelis;KREGŽDUTĖS;3953114161;Taip;7;0;1;8
16803;Šilelis;KREGŽDUTĖS;2499322761;Ne;5;7;2;14
16804;Šilelis;KREGŽDUTĖS;5868594049;Ne;4;0;4;8
16805;Šilelis;KREGŽDUTĖS;8855625488;Ne;2;0;2;4
16806;Šilelis;KREGŽDUTĖS;5223262925;Ne;0;1;2;3
16807;Šilelis;KREGŽDUTĖS;1279361795;Ne;11;2;2;15
16808;Šilelis;KREGŽDUTĖS;9292761872;Ne;16;0;2;18
16809;Šilelis;KREGŽDUTĖS;6987557382;Ne;2;1;6;9
16810;Šilelis;KREGŽDUTĖS;9991765829;Ne;3;0;2;5
16811;Šilelis;KREGŽDUTĖS;4696129999;Ne;1;0;2;3
16812;Šilelis;KREGŽDUTĖS;1805615293;Ne;0;3;0;3
16813;Šilelis;KREGŽDUTĖS;5192604763;Ne;2;0;5;7
16814;Šilelis;KREGŽDUTĖS;6065839221;Ne;4;0;3;7
16815;Šilelis;PAGRANDUKAI;8632645047;Ne;3;0;2;5
16816;Šilelis;PAGRANDUKAI;8616798722;Ne;3;1;2;6
16817;Šilelis;PAGRANDUKAI;6598481106;Ne;20;0;0;20
16818;Šilelis;PAGRANDUKAI;8654600612;Ne;0;22;0;22
16819;Šilelis;PAGRANDUKAI;7900611929;Ne;1;1;2;4
16820;Šilelis;PAGRANDUKAI;1325551883;Ne;11;0;4;15
16821;Šilelis;PAGRANDUKAI;3627435667;Ne;3;2;2;7
16822;Šilelis;PAGRANDUKAI;5090120850;Ne;10;0;2;12
16823;Šilelis;PAGRANDUKAI;7890456241;Ne;10;1;4;15
16824;Šilelis;PAGRANDUKAI;3147394614;Ne;3;2;2;7
16825;Šilelis;PAGRANDUKAI;2693883266;Ne;10;0;2;12
16826;Šilelis;PAGRANDUKAI;2702371841;Ne;4;1;2;7
16827;Šilelis;PAGRANDUKAI;2378919393;Ne;9;0;2;11
16828;Šilelis;PAGRANDUKAI;6484740846;Ne;7;2;2;11
16829;Šilelis;PAGRANDUKAI;7849601686;Ne;7;3;4;14
16830;Šilelis;BITUTĖS;7512731255;Ne;0;1;0;1
16831;Šilelis;BITUTĖS;1268335563;Ne;0;2;0;2
16832;Šilelis;BITUTĖS;7814807923;Ne;0;10;0;10
16833;Šilelis;BITUTĖS;9071963194;Ne;3;0;6;9
16834;Šilelis;BITUTĖS;5843337891;Ne;3;1;2;6
16835;Šilelis;BITUTĖS;1960952604;Ne;9;2;2;13
16836;Šilelis;BITUTĖS;3062557053;Ne;0;1;0;1
16837;Šilelis;BITUTĖS;1390916076;Ne;3;2;2;7
16838;Šilelis;BITUTĖS;2023309512;Ne;0;5;0;5
16839;Šilelis;BITUTĖS;5375413045;Ne;0;15;0;15
16840;Šilelis;BITUTĖS;6830200578;Ne;0;4;0;4
16841;Šilelis;BITUTĖS;6479728064;Ne;0;10;0;10
16842;Šilelis;BITUTĖS;3686287802;Ne;0;2;0;2
16843;Šilelis;BITUTĖS;9602317911;Ne;0;2;0;2
16844;Šilelis;BITUTĖS;8304500877;Ne;0;2;0;2
16845;Šilelis;BITUTĖS;8741597642;Ne;0;0;3;3
16846;Šilelis;BITUTĖS;7061399035;Ne;0;3;0;3
16847;Šilelis;BITUTĖS;4272205822;Taip;3;2;2;7
16848;Šilelis;BITUTĖS;5484196739;Ne;15;0;4;19
16849;Šilelis;DRUGELIAI;6800679760;Ne;0;1;4;5
16850;Šilelis;DRUGELIAI;3100416582;Ne;4;2;3;9
16851;Šilelis;DRUGELIAI;8563843417;Ne;4;0;1;5
16852;Šilelis;DRUGELIAI;3134882364;Ne;0;0;3;3
16853;Šilelis;DRUGELIAI;5131513427;Ne;3;3;2;8
16854;Šilelis;DRUGELIAI;2575292661;Ne;0;8;0;8
16855;Šilelis;DRUGELIAI;4762848901;Ne;0;5;0;5
16856;Šilelis;DRUGELIAI;8579501639;Ne;9;2;2;13
16857;Šilelis;DRUGELIAI;2073341570;Ne;2;0;1;3
16858;Šilelis;DRUGELIAI;3940956024;Ne;5;0;5;10
16859;Šilelis;DRUGELIAI;3551123110;Ne;12;0;2;14
16860;Šilelis;DRUGELIAI;9047094780;Ne;0;1;0;1
16861;Šilelis;DRUGELIAI;4513916744;Taip;0;0;1;1
16862;Šilelis;DRUGELIAI;1244496708;Ne;3;0;2;5
16863;Šilelis;DRUGELIAI;9593306122;Ne;0;0;2;2
16864;Šilelis;DRUGELIAI;5845704184;Ne;6;2;3;11
16865;Šilelis;DRUGELIAI;5899112658;Ne;7;0;4;11
16866;Šilelis;DRUGELIAI;3080593571;Ne;0;6;0;6
16867;Vaduvos;PAGRANDUKAI;6611531526;Ne;0;11;0;11
16868;Vaduvos;PAGRANDUKAI;4576510280;Ne;12;1;2;15
16869;Vaduvos;PAGRANDUKAI;3060409258;Ne;0;2;0;2
16870;Vaduvos;PAGRANDUKAI;8070494719;Ne;3;2;3;8
16871;Vaduvos;PAGRANDUKAI;3206096414;Ne;10;1;2;13
16872;Vaduvos;PAGRANDUKAI;9232960362;Ne;5;2;2;9
16873;Vaduvos;PAGRANDUKAI;7425991335;Ne;2;0;0;2
16874;Vaduvos;PAGRANDUKAI;7592658267;Ne;5;1;0;6
16875;Vaduvos;PAGRANDUKAI;8533315132;Ne;0;3;0;3
16876;Vaduvos;PAGRANDUKAI;2508650990;Ne;0;7;0;7
16877;Vaduvos;PAGRANDUKAI;1466282653;Ne;7;2;3;12
16878;Vaduvos;PAGRANDUKAI;8055108164;Ne;7;0;3;10
16879;Vaduvos;PAGRANDUKAI;6943057114;Ne;11;2;2;15
16880;Vaduvos;PAGRANDUKAI;8669267296;Ne;0;12;0;12
16881;Vaduvos;PAGRANDUKAI;1736248725;Ne;0;15;0;15
16882;Vaduvos;PAGRANDUKAI;2369774637;Ne;8;2;3;13
16883;Vaduvos;PAGRANDUKAI;9385879695;Ne;3;4;0;7
16884;Vaduvos;PAGRANDUKAI;1414575326;Ne;0;2;1;3
16885;Vaduvos;PAGRANDUKAI;3710830036;Ne;7;2;2;11
16886;Vaduvos;PAGRANDUKAI;7205880191;Ne;4;8;0;12
16887;Vaduvos;PAGRANDUKAI;3695552176;Ne;0;1;0;1
16888;Vaduvos;KODĖLČIUKAI;3010510262;Ne;0;3;0;3
16889;Vaduvos;KODĖLČIUKAI;9429028460;Ne;0;2;0;2
16890;Vaduvos;KODĖLČIUKAI;6210729584;Ne;8;2;3;13
16891;Vaduvos;KODĖLČIUKAI;9606193112;Ne;0;2;0;2
16892;Vaduvos;KODĖLČIUKAI;4177935331;Ne;0;8;0;8
16893;Vaduvos;KODĖLČIUKAI;9983148737;Ne;0;2;0;2
16894;Vaduvos;KODĖLČIUKAI;6810198013;Ne;0;3;0;3
16895;Vaduvos;KODĖLČIUKAI;4270137614;Ne;0;4;0;4
16896;Vaduvos;KODĖLČIUKAI;3682708061;Ne;0;7;0;7
16897;Vaduvos;KODĖLČIUKAI;5262165284;Ne;3;0;3;6
16898;Vaduvos;KODĖLČIUKAI;8603418399;Ne;0;1;0;1
16899;Vaduvos;KODĖLČIUKAI;3096104197;Ne;7;6;0;13
16900;Vaduvos;KODĖLČIUKAI;5761137540;Ne;0;3;0;3
16901;Vaduvos;KODĖLČIUKAI;9597857664;Ne;5;2;0;7
16902;Vaduvos;KODĖLČIUKAI;1054097622;Ne;9;2;0;11
16903;Vaduvos;KODĖLČIUKAI;6013737546;Ne;0;2;9;11
16904;Vaduvos;KODĖLČIUKAI;4789480822;Ne;0;7;0;7
16905;Vaduvos;KODĖLČIUKAI;7904713344;Ne;7;1;0;8
16906;Vaduvos;KODĖLČIUKAI;8324927031;Ne;0;10;0;10
16907;Vaduvos;SMALSUČIAI;2184711783;Ne;0;2;0;2
16908;Vaduvos;SMALSUČIAI;3091707832;Ne;0;7;0;7
16909;Vaduvos;SMALSUČIAI;7181151562;Ne;4;2;2;8
16910;Vaduvos;SMALSUČIAI;6462126837;Ne;0;3;0;3
16911;Vaduvos;SMALSUČIAI;1265287458;Ne;8;2;0;10
16912;Vaduvos;SMALSUČIAI;3948025914;Ne;6;5;0;11
16913;Vaduvos;SMALSUČIAI;6253552951;Ne;0;5;0;5
16914;Vaduvos;SMALSUČIAI;7508333714;Ne;0;7;0;7
16915;Vaduvos;SMALSUČIAI;7789888994;Ne;12;2;0;14
16916;Vaduvos;SMALSUČIAI;6593271671;Ne;0;3;0;3
16917;Vaduvos;SMALSUČIAI;6379952023;Ne;0;7;0;7
16918;Vaduvos;SMALSUČIAI;4550915388;Ne;3;7;0;10
16919;Vaduvos;SMALSUČIAI;3680758366;Ne;3;1;0;4
16920;Vaduvos;SMALSUČIAI;9896249776;Ne;0;6;0;6
16921;Vaduvos;SMALSUČIAI;2643410976;Ne;0;8;0;8
16922;Vaduvos;GILIUKAI;1277811729;Ne;3;8;0;11
16923;Vaduvos;GILIUKAI;1969325922;Taip;0;3;0;3
16924;Vaduvos;GILIUKAI;5376707663;Ne;0;2;0;2
16925;Vaduvos;GILIUKAI;6409466338;Ne;7;2;2;11
16926;Vaduvos;GILIUKAI;2835635250;Ne;0;2;0;2
16927;Vaduvos;GILIUKAI;2939561403;Ne;2;0;0;2
16928;Vaduvos;GILIUKAI;8188374113;Ne;1;0;3;4
16929;Vaduvos;GILIUKAI;6514406042;Ne;2;2;2;6
16930;Vaduvos;GILIUKAI;3057729267;Ne;11;2;0;13
16931;Vaduvos;GILIUKAI;6346625714;Ne;2;2;2;6
16932;Vaduvos;GILIUKAI;8580834401;Ne;0;0;2;2
16933;Vaduvos;GILIUKAI;9167796462;Ne;3;6;0;9
16934;Vaduvos;GILIUKAI;6276149710;Ne;3;3;0;6
16935;Vaduvos;GILIUKAI;6572776966;Ne;1;3;0;4
16936;Vaduvos;GILIUKAI;6676167440;Ne;3;2;0;5
16937;Vaduvos;GILIUKAI;2957685586;Ne;3;2;0;5
16938;Vaduvos;GILIUKAI;3540548094;Ne;0;2;0;2
16939;Vaduvos;GILIUKAI;8964194121;Ne;4;4;0;8
16940;Vaduvos;GILIUKAI;5297217576;Ne;0;4;0;4
16941;Vaduvos;GILIUKAI;5010914832;Ne;5;0;2;7
16942;Vaduvos;GILIUKAI;4030891958;Ne;2;2;0;4
16943;Vaduvos;GILIUKAI;7730737705;Ne;10;0;4;14
16944;Vaduvos;GILIUKAI;2011976336;Ne;7;0;2;9
16945;Vaduvos;GILIUKAI;5510687497;Ne;1;10;0;11
16946;Vaduvos;BORUŽĖLĖS;2277525837;Ne;0;2;0;2
16947;Vaduvos;BORUŽĖLĖS;6439773886;Ne;0;11;0;11
16948;Vaduvos;BORUŽĖLĖS;5634252033;Ne;0;5;0;5
16949;Vaduvos;BORUŽĖLĖS;6593754016;Ne;0;10;0;10
16950;Vaduvos;BORUŽĖLĖS;7521846747;Ne;0;3;0;3
16951;Vaduvos;BORUŽĖLĖS;1422507884;Ne;4;7;0;11
16952;Vaduvos;BORUŽĖLĖS;3461756429;Ne;0;2;0;2
16953;Vaduvos;BORUŽĖLĖS;2417613291;Ne;2;0;0;2
16954;Vaduvos;BORUŽĖLĖS;5717064754;Ne;0;3;0;3
16955;Vaduvos;BORUŽĖLĖS;8064111922;Ne;3;7;0;10
16956;Vaduvos;BORUŽĖLĖS;2923920649;Ne;0;4;0;4
16957;Vaduvos;BORUŽĖLĖS;6552763746;Ne;0;16;0;16
16958;Vaduvos;BORUŽĖLĖS;3255011809;Ne;0;10;0;10
16959;Vaduvos;BORUŽĖLĖS;7169054113;Ne;0;6;0;6
16960;Vaduvos;BORUŽĖLĖS;2366843609;Ne;2;2;0;4
16961;Vaduvos;BORUŽĖLĖS;1924714755;Ne;0;3;0;3
16962;Vaduvos;BORUŽĖLĖS;6991960029;Taip;0;16;0;16
16963;Vaduvos;BORUŽĖLĖS;3833382641;Ne;3;1;2;6
16964;Vaduvos;DRUGELIAI;4936598927;Ne;9;4;0;13
16965;Vaduvos;DRUGELIAI;2341467486;Ne;0;1;0;1
16966;Vaduvos;DRUGELIAI;9824469881;Ne;5;0;2;7
16967;Vaduvos;DRUGELIAI;5915272436;Ne;12;1;0;13
16968;Vaduvos;DRUGELIAI;4238942070;Ne;8;6;0;14
16969;Vaduvos;DRUGELIAI;1539465611;Taip;1;1;4;6
16970;Vaduvos;DRUGELIAI;8384302877;Ne;6;2;2;10
16971;Vaduvos;DRUGELIAI;6770559352;Ne;8;5;0;13
16972;Vaduvos;DRUGELIAI;4856601924;Ne;6;1;2;9
16973;Vaduvos;DRUGELIAI;3477273224;Ne;0;3;0;3
16974;Vaduvos;DRUGELIAI;2452309232;Taip;3;7;0;10
16975;Vaduvos;DRUGELIAI;6776150749;Ne;5;2;0;7
16976;Vaduvos;DRUGELIAI;4587836073;Ne;0;5;0;5
16977;Vaduvos;DRUGELIAI;9333495119;Ne;6;5;0;11
16978;Vaduvos;DRUGELIAI;2789503381;Ne;0;2;0;2
16979;Vaduvos;DRUGELIAI;1987969267;Ne;11;2;0;13
16980;Vaduvos;DRUGELIAI;8990472878;Ne;10;2;0;12
16981;Vaduvos;DRUGELIAI;2717887489;Ne;9;3;0;12
16982;Vaduvos;DRUGELIAI;5881009426;Ne;0;1;0;1
16983;Vaduvos;DRUGELIAI;1434871968;Ne;14;0;0;14
16984;Vaduvos;RIEŠUTĖLIAI;3855900628;Ne;10;0;0;10
16985;Vaduvos;RIEŠUTĖLIAI;8709781176;Ne;17;0;0;17
16986;Vaduvos;RIEŠUTĖLIAI;3690176756;Ne;9;4;0;13
16987;Vaduvos;RIEŠUTĖLIAI;5457850068;Ne;11;0;0;11
16988;Vaduvos;RIEŠUTĖLIAI;9420758132;Ne;3;4;0;7
16989;Vaduvos;RIEŠUTĖLIAI;5217573680;Ne;15;2;0;17
16990;Vaduvos;RIEŠUTĖLIAI;2838261867;Ne;0;10;0;10
16991;Vaduvos;RIEŠUTĖLIAI;3775261278;Ne;5;2;3;10
16992;Vaduvos;RIEŠUTĖLIAI;6824763956;Ne;0;11;0;11
16993;Vaduvos;RIEŠUTĖLIAI;6228969089;Ne;3;4;0;7
16994;Vaduvos;RIEŠUTĖLIAI;6163392340;Ne;10;2;0;12
16995;Vaduvos;RIEŠUTĖLIAI;1247907161;Ne;4;3;0;7
16996;Vaduvos;RIEŠUTĖLIAI;5012931485;Ne;9;0;2;11
16997;Vaduvos;RIEŠUTĖLIAI;2767613126;Ne;10;0;4;14
16998;Vaduvos;RIEŠUTĖLIAI;7914513191;Ne;3;5;0;8
16999;Vaduvos;"1 klasė";4805607216;Ne;0;2;0;2
17000;Vaduvos;"1 klasė";4805607216;Ne;0;2;0;2
17001;Vaduvos;"1 klasė";1696303051;Ne;0;2;0;2
17002;Vaduvos;"1 klasė";1431863758;Ne;0;4;0;4
17003;Vaduvos;"1 klasė";72724196791;Ne;0;11;0;11
17004;Vaduvos;"1 klasė";9371067563;Ne;0;2;0;2
17005;Vaduvos;"1 klasė";2897226343;Ne;0;7;0;7
17006;Vaduvos;"1 klasė";68848152670;Ne;0;2;0;2
17007;Vaduvos;"1 klasė";6425640531;Ne;0;2;0;2
17008;Vaduvos;"1 klasė";4029586203;Ne;0;2;0;2
17009;Vaduvos;"1 klasė";4105978403;Ne;0;2;0;2
17010;Vaduvos;"1 klasė";9540008495;Ne;0;2;0;2
17011;Vaduvos;"1 klasė";8299189235;Ne;0;3;0;3
17012;Vaduvos;"1 klasė";73800920781;Ne;0;3;0;3
17013;Vaduvos;"1 klasė";5428067167;Ne;0;4;0;4
17014;Vaduvos;"1 klasė";5954492368;Ne;0;6;0;6
17015;Vaduvos;"1 klasė";3699578284;Ne;0;3;0;3
17016;Vaduvos;"1 klasė";7397068779;Ne;0;3;0;3
17017;Vaduvos;"1 klasė";8875709110;Ne;0;2;0;2
17018;Vaduvos;"1 klasė";7305111076;Ne;0;2;0;2
17019;Vaduvos;"1 klasė";7163839896;Ne;0;3;0;3
17020;Vaduvos;"1 klasė";7493037613;Ne;0;3;0;3
17021;Vaduvos;"1 klasė";1423148023;Ne;0;2;0;2
17022;Vaduvos;"1 klasė";5573145836;Ne;0;6;0;6
17023;Vaduvos;"1 klasė";7337663549;Ne;0;2;0;2
17024;Vaduvos;"1 klasė";87008942241;Ne;0;3;0;3
17025;Vaduvos;"2 klasė";4365590843;Ne;0;2;0;2
17026;Vaduvos;"2 klasė";3174998523;Ne;0;2;0;2
17027;Vaduvos;"2 klasė";9112649520;Ne;0;3;0;3
17028;Vaduvos;"2 klasė";93702732546;Ne;0;2;0;2
17029;Vaduvos;"2 klasė";15757662594;Ne;0;2;0;2
17030;Vaduvos;"2 klasė";1599595256;Ne;0;2;0;2
17031;Vaduvos;"2 klasė";1825188497;Ne;0;2;0;2
17032;Vaduvos;"2 klasė";4513707989;Ne;0;8;0;8
17033;Vaduvos;"2 klasė";68937983441;Ne;0;3;0;3
17034;Vaduvos;"2 klasė";3722349868;Ne;0;2;0;2
17035;Vaduvos;"2 klasė";13888236429;Ne;0;4;0;4
17036;Vaduvos;"2 klasė";59616893535;Ne;0;4;0;4
17037;Vaduvos;"2 klasė";22641388717;Ne;0;8;0;8
17038;Vaduvos;"2 klasė";21499108813;Ne;0;6;0;6
17039;Vaduvos;"2 klasė";79437154441;Ne;0;2;0;2
17040;Vaduvos;"2 klasė";46608435244;Ne;0;2;0;2
17041;Vaduvos;"2 klasė";5307128703;Ne;0;2;0;2
17042;Vaduvos;"2 klasė";5435336235;Ne;0;4;0;4
17043;Vaduvos;"2 klasė";61046090149;Ne;0;2;0;2
17044;Vaduvos;"2 klasė";56280470781;Ne;0;2;0;2
17045;Vaduvos;"2 klasė";6128582180;Ne;0;3;0;3
17046;Vaduvos;"2 klasė";11202010413;Ne;0;22;0;22
17047;Vaduvos;"2 klasė";1681367373;Ne;0;9;0;9
17048;Vaduvos;"2 klasė";1370696345;Ne;0;5;0;5
17049;Vaduvos;"2 klasė";62183976729;Ne;0;6;0;6
17050;Vaduvos;"2 klasė";4342471835;Ne;0;3;0;3
17051;Vaduvos;"4 klasė";97423576166;Ne;0;2;0;2
17052;Vaduvos;"4 klasė";38504924027;Ne;0;5;0;5
17053;Vaduvos;"4 klasė";96148085691;Ne;0;22;0;22
17054;Vaduvos;"4 klasė";12330772986;Ne;0;7;0;7
17055;Vaduvos;"4 klasė";33277362439;Ne;0;4;0;4
17056;Vaduvos;"4 klasė";41272273463;Ne;0;2;0;2
17057;Vaduvos;"4 klasė";32138087379;Ne;0;22;0;22
17058;Vaduvos;"4 klasė";67324784528;Ne;0;2;0;2
17059;Vaduvos;"4 klasė";4807104855;Ne;0;2;0;2
17060;Vaduvos;"4 klasė";2181614424;Ne;0;3;0;3
17061;Vaduvos;"4 klasė";2019573643;Ne;0;3;0;3
17062;Vaduvos;"4 klasė";27419094487;Ne;0;2;0;2
17063;Vaduvos;"4 klasė";89793734700;Ne;0;2;0;2
17064;Vaduvos;"4 klasė";17473821556;Ne;0;22;0;22
17065;Vaduvos;"4 klasė";53866301875;Ne;0;22;0;22
17066;Vaduvos;"4 klasė";7786986697;Ne;0;2;0;2
17067;Vaduvos;"4 klasė";9147332638;Ne;0;2;0;2
17068;Vaduvos;"4 klasė";1532675814;Ne;0;2;0;2
17069;Vaduvos;"4 klasė";98259624669;Ne;0;22;0;22
17070;Vaduvos;"4 klasė";36931517006;Ne;0;2;0;2
17071;Vaduvos;"4 klasė";61243424057;Ne;0;2;0;2
17072;Vaduvos;"4 klasė";30979103892;Ne;0;7;0;7
17073;Vaduvos;"4 klasė";78245732319;Ne;0;3;0;3
17074;Vaduvos;"4 klasė";48433447683;Ne;0;3;0;3
17075;Vaduvos;"4 klasė";85090873161;Ne;0;22;0;22
17076;Vaduvos;3A;6279678482;Ne;0;2;0;2
17077;Vaduvos;3A;96892752634;Ne;0;3;0;3
17078;Vaduvos;3A;61243200177;Ne;0;2;0;2
17079;Vaduvos;3A;62703428759;Ne;0;2;0;2
17080;Vaduvos;3A;68420568339;Ne;0;4;0;4
17081;Vaduvos;3A;49738318631;Ne;0;3;0;3
17082;Vaduvos;3A;65647119496;Ne;0;2;0;2
17083;Vaduvos;3A;19390879176;Ne;0;3;0;3
17084;Vaduvos;3A;6155494370;Ne;0;2;0;2
17085;Vaduvos;3A;1139509471;Ne;0;22;0;22
17086;Vaduvos;3A;70693742936;Ne;0;3;0;3
17087;Vaduvos;3A;1010061503;Ne;0;2;0;2
17088;Vaduvos;3A;1107557891;Ne;0;22;0;22
17089;Vaduvos;3A;8802765960;Ne;0;2;0;2
17090;Vaduvos;3A;3172047211;Ne;0;2;0;2
17091;Vaduvos;3B;95104294893;Ne;0;6;0;6
17092;Vaduvos;3B;40872193458;Ne;0;2;0;2
17093;Vaduvos;3B;6500567162;Ne;0;3;0;3
17094;Vaduvos;3B;78931952732;Ne;0;2;0;2
17095;Vaduvos;3B;1241148402;Ne;0;3;0;3
17096;Vaduvos;3B;66359913774;Ne;0;3;0;3
17097;Vaduvos;3B;24887196729;Ne;0;2;0;2
17098;Vaduvos;3B;39687066893;Ne;0;2;0;2
17099;Vaduvos;3B;64074141491;Ne;0;2;0;2
17100;Vaduvos;3B;93924290247;Ne;0;8;0;8
17101;Vaduvos;3B;47465933557;Ne;0;2;0;2
17102;Vaduvos;3B;62521006557;Ne;0;2;0;2
17103;Vaduvos;3B;16882774330;Ne;0;2;0;2
17104;Vaduvos;3B;3259114583;Ne;0;2;0;2
17105;Vaduvos;3B;8782782031;Ne;0;2;0;2
17106;Vaduvos;3B;87671358423;Ne;0;22;0;22
17107;Vaduvos;3B;55138588393;Ne;0;2;0;2
17108;Vilkpėdės;PASAKORIŲ;3129307975;Ne;12;0;3;15
17109;Vilkpėdės;PASAKORIŲ;1268568294;Ne;5;0;2;7
17110;Vilkpėdės;PASAKORIŲ;7918728030;Ne;10;0;3;13
17111;Vilkpėdės;PASAKORIŲ;8819707366;Ne;15;0;2;17
17112;Vilkpėdės;PASAKORIŲ;8261543050;Ne;2;0;0;2
17113;Vilkpėdės;PASAKORIŲ;2102814426;Ne;6;0;4;10
17114;Vilkpėdės;PASAKORIŲ;6877083798;Ne;9;0;3;12
17115;Vilkpėdės;PASAKORIŲ;7780157972;Ne;1;1;3;5
17116;Vilkpėdės;PASAKORIŲ;9892981462;Ne;7;0;3;10
17117;Vilkpėdės;PASAKORIŲ;7937515587;Ne;3;0;2;5
17118;Vilkpėdės;PASAKORIŲ;4625117662;Ne;2;0;4;6
17119;Vilkpėdės;PASAKORIŲ;3548680401;Ne;2;0;7;9
17120;Vilkpėdės;PASAKORIŲ;4282952336;Ne;2;0;7;9
17121;Vilkpėdės;PASAKORIŲ;3646631186;Ne;5;2;2;9
17122;Vilkpėdės;PASAKORIŲ;9350127172;Ne;7;0;2;9
17123;Vilkpėdės;MĮSLIUKŲ;7705509136;Ne;15;2;4;21
17124;Vilkpėdės;MĮSLIUKŲ;7370710652;Ne;15;2;4;21
17125;Vilkpėdės;MĮSLIUKŲ;4314657343;Ne;5;0;3;8
17126;Vilkpėdės;MĮSLIUKŲ;7184242648;Ne;3;7;2;12
17127;Vilkpėdės;MĮSLIUKŲ;4904820034;Ne;9;0;7;16
17128;Vilkpėdės;MĮSLIUKŲ;3863312205;Ne;13;0;2;15
17129;Vilkpėdės;MĮSLIUKŲ;3379294145;Ne;0;2;0;2
17130;Vilkpėdės;MĮSLIUKŲ;2505859673;Ne;5;1;4;10
17131;Vilkpėdės;MĮSLIUKŲ;8907004805;Ne;9;0;4;13
17132;Vilkpėdės;MĮSLIUKŲ;8348012645;Ne;8;0;2;10
17133;Vilkpėdės;MĮSLIUKŲ;9537458943;Ne;11;0;2;13
17134;Vilkpėdės;MĮSLIUKŲ;7334892130;Ne;11;0;2;13
17135;Vilkpėdės;MĮSLIUKŲ;7900956212;Ne;10;0;4;14
17136;Vilkpėdės;MĮSLIUKŲ;5110059560;Ne;12;2;2;16
17137;Vilkpėdės;ŽINIUKŲ;4270461575;Ne;10;0;4;14
17138;Vilkpėdės;ŽINIUKŲ;4998396593;Ne;0;0;2;2
17139;Vilkpėdės;ŽINIUKŲ;6819447340;Ne;8;3;2;13
17140;Vilkpėdės;ŽINIUKŲ;1278300322;Ne;0;1;0;1
17141;Vilkpėdės;ŽINIUKŲ;9797550851;Ne;0;0;3;3
17142;Vilkpėdės;ŽINIUKŲ;1040357501;Ne;3;2;2;7
17143;Vilkpėdės;ŽINIUKŲ;6876470245;Ne;3;2;2;7
17144;Vilkpėdės;ŽINIUKŲ;8431620518;Ne;3;0;2;5
17145;Vilkpėdės;ŽINIUKŲ;1655396296;Ne;6;0;3;9
17146;Vilkpėdės;ŽINIUKŲ;2358685682;Ne;15;0;4;19
17147;Vilkpėdės;ŽINIUKŲ;5076206526;Ne;0;1;0;1
17148;Vilkpėdės;ŽINIUKŲ;3611416887;Ne;0;1;0;1
17149;Vilkpėdės;ŽINIUKŲ;9501254301;Ne;0;1;0;1
17150;Vilkpėdės;IŠMINČIŲ;8002436634;Taip;3;2;2;7
17151;Vilkpėdės;IŠMINČIŲ;4052026470;Ne;4;1;12;17
17152;Vilkpėdės;IŠMINČIŲ;7992484314;Ne;2;2;7;11
17153;Vilkpėdės;IŠMINČIŲ;5050493757;Ne;0;13;0;13
17154;Vilkpėdės;IŠMINČIŲ;8217972925;Ne;0;8;2;10
17155;Vilkpėdės;IŠMINČIŲ;5677284428;Ne;2;3;2;7
17156;Vilkpėdės;IŠMINČIŲ;2232913117;Taip;0;2;15;17
17157;Vilkpėdės;IŠMINČIŲ;3994451071;Ne;0;0;4;4
17158;Vilkpėdės;IŠMINČIŲ;4726171678;Ne;5;0;4;9
17159;Vilkpėdės;IŠMINČIŲ;2529188623;Ne;1;2;3;6
17160;Vilkpėdės;IŠMINČIŲ;7519472444;Ne;2;4;0;6
17161;Vilkpėdės;IŠMINČIŲ;5569182344;Ne;5;0;2;7
17162;Vilkpėdės;IŠMINČIŲ;3991785883;Ne;0;1;0;1
17163;Vilkpėdės;IŠMINČIŲ;9334610111;Ne;4;2;5;11
17164;Vilkpėdės;IŠMINČIŲ;6268525635;Ne;20;0;2;22
17165;Vilkpėdės;IŠMINČIŲ;3521289746;Ne;0;0;3;3
17166;Vilkpėdės;IŠMINČIŲ;4277073629;Ne;3;17;2;22
17167;Vilkpėdės;TYRINĖTOJŲ;6418829930;Ne;0;8;0;8
17168;Vilkpėdės;TYRINĖTOJŲ;1633942236;Ne;0;9;0;9
17169;Vilkpėdės;TYRINĖTOJŲ;7829343719;Ne;0;22;0;22
17170;Vilkpėdės;TYRINĖTOJŲ;8484873068;Ne;0;2;0;2
17171;Vilkpėdės;TYRINĖTOJŲ;2503128176;Ne;0;9;0;9
17172;Vilkpėdės;TYRINĖTOJŲ;9570469277;Taip;2;0;3;5
17173;Vilkpėdės;TYRINĖTOJŲ;5274855225;Ne;15;0;4;19
17174;Vilkpėdės;TYRINĖTOJŲ;8860791478;Ne;0;2;0;2
17175;Vilkpėdės;TYRINĖTOJŲ;5420512675;Ne;1;0;3;4
17176;Vilkpėdės;TYRINĖTOJŲ;8613778606;Ne;0;5;0;5
17177;Vilkpėdės;TYRINĖTOJŲ;7991758361;Ne;0;2;0;2
17178;Vilkpėdės;TYRINĖTOJŲ;2736318576;Ne;3;0;2;5
17179;Vilkpėdės;TYRINĖTOJŲ;6064336759;Ne;0;5;0;5
17180;Vilkpėdės;TYRINĖTOJŲ;8930504912;Ne;0;0;1;1
17181;Vilkpėdės;TYRINĖTOJŲ;3303872633;Ne;0;4;0;4
17182;Vilkpėdės;TYRINĖTOJŲ;5972405023;Ne;6;2;4;12
17183;Vilkpėdės;TYRINĖTOJŲ;4485811377;Ne;5;5;2;12
17184;Vilkpėdės;TYRINĖTOJŲ;9841831811;Ne;0;0;21;21
17185;Vilkpėdės;GUDRUOLIŲ;2525399410;Ne;8;0;2;10
17186;Vilkpėdės;GUDRUOLIŲ;1985540746;Ne;11;0;4;15
17187;Vilkpėdės;GUDRUOLIŲ;6198736925;Ne;5;2;6;13
17188;Vilkpėdės;GUDRUOLIŲ;2703704892;Ne;6;1;2;9
17189;Vilkpėdės;GUDRUOLIŲ;5812430367;Ne;2;0;2;4
17190;Vilkpėdės;GUDRUOLIŲ;1478022307;Ne;7;2;2;11
17191;Vilkpėdės;GUDRUOLIŲ;2205143759;Ne;0;0;5;5
17192;Vilkpėdės;GUDRUOLIŲ;7661268641;Ne;0;2;0;2
17193;Vilkpėdės;GUDRUOLIŲ;4018140154;Ne;5;0;2;7
17194;Vilkpėdės;GUDRUOLIŲ;8804335248;Ne;2;2;2;6
17195;Vilkpėdės;GUDRUOLIŲ;1838974989;Ne;0;0;2;2
17196;Vilkpėdės;GUDRUOLIŲ;6598572049;Ne;1;0;4;5
17197;Vilkpėdės;GUDRUOLIŲ;2419661008;Ne;7;2;2;11
17198;Vilkpėdės;GUDRUOLIŲ;7931496783;Ne;0;2;2;4
17199;Vilkpėdės;GUDRUOLIŲ;2418313731;Ne;2;3;5;10
17200;Vilkpėdės;GUDRUOLIŲ;8385974099;Ne;4;0;3;7
17201;Vilkpėdės;GUDRUOLIŲ;1342167313;Ne;11;2;4;17
17202;Vilkpėdės;GUDRUOLIŲ;6671311193;Ne;0;2;0;2
17203;Vilkpėdės;GUDRUOLIŲ;7114183123;Ne;1;2;2;5
17204;Vilkpėdės;SMALSUOLIŲ;4095366279;Ne;0;20;0;20
17205;Vilkpėdės;SMALSUOLIŲ;1019057127;Ne;1;2;2;5
17206;Vilkpėdės;SMALSUOLIŲ;6522707709;Ne;2;3;5;10
17207;Vilkpėdės;SMALSUOLIŲ;1655985778;Ne;14;2;4;20
17208;Vilkpėdės;SMALSUOLIŲ;4311938034;Ne;2;2;2;6
17209;Vilkpėdės;SMALSUOLIŲ;3350784810;Ne;0;11;0;11
17210;Vilkpėdės;SMALSUOLIŲ;5346798201;Ne;0;12;0;12
17211;Vilkpėdės;SMALSUOLIŲ;5551822633;Ne;0;12;0;12
17212;Vilkpėdės;SMALSUOLIŲ;9544418642;Ne;0;2;3;5
17213;Vilkpėdės;SMALSUOLIŲ;1063740772;Ne;0;2;0;2
17214;Vilkpėdės;SMALSUOLIŲ;3666145718;Ne;0;3;2;5
17215;Vilkpėdės;SMALSUOLIŲ;5633014328;Ne;0;3;0;3
17216;Vilkpėdės;SMALSUOLIŲ;3737265597;Ne;1;7;2;10
17217;Vilkpėdės;SMALSUOLIŲ;5422061533;Ne;0;3;0;3
17218;Vilkpėdės;SMALSUOLIŲ;3720639726;Ne;0;2;0;2
17219;Vilkpėdės;SMALSUOLIŲ;2241104719;Ne;0;2;0;2
17220;Vilkpėdės;SMALSUOLIŲ;6690742997;Ne;0;3;0;3
17221;Vilkpėdės;KODĖLČIŲ;6283767445;Ne;0;3;1;4
17222;Vilkpėdės;KODĖLČIŲ;9605430333;Ne;5;4;2;11
17223;Vilkpėdės;KODĖLČIŲ;7745776486;Taip;0;8;0;8
17224;Vilkpėdės;KODĖLČIŲ;8969001990;Ne;9;2;2;13
17225;Vilkpėdės;KODĖLČIŲ;7158737372;Ne;15;5;2;22
17226;Vilkpėdės;KODĖLČIŲ;3785308006;Ne;0;3;0;3
17227;Vilkpėdės;KODĖLČIŲ;6744834487;Ne;0;5;1;6
17228;Vilkpėdės;KODĖLČIŲ;4166416292;Ne;0;14;0;14
17229;Vilkpėdės;KODĖLČIŲ;9601934563;Ne;0;2;0;2
17230;Vilkpėdės;KODĖLČIŲ;7401886306;Ne;0;7;0;7
17231;Vilkpėdės;KODĖLČIŲ;7284081203;Ne;15;2;2;19
17232;Vilkpėdės;KODĖLČIŲ;1528619779;Ne;0;3;0;3
17233;Vilkpėdės;KODĖLČIŲ;2359315281;Ne;0;1;0;1
17234;Vilkpėdės;KODĖLČIŲ;4255757333;Ne;3;3;2;8
17235;Vilkpėdės;KODĖLČIŲ;5053032081;Ne;0;2;0;2
17236;Vilkpėdės;KODĖLČIŲ;6778288398;Ne;2;1;2;5
17237;Vilkpėdės;KODĖLČIŲ;1537270256;Ne;3;4;3;10
17238;Vilkpėdės;KODĖLČIŲ;3229559339;Ne;3;4;3;10
17239;Vilkpėdės;MOKSLINČIŲ;9294350205;Ne;3;0;2;5
17240;Vilkpėdės;MOKSLINČIŲ;5048931309;Ne;4;0;3;7
17241;Vilkpėdės;MOKSLINČIŲ;7698759895;Ne;8;5;2;15
17242;Vilkpėdės;MOKSLINČIŲ;1807884737;Ne;0;2;0;2
17243;Vilkpėdės;MOKSLINČIŲ;2251274741;Ne;0;5;0;5
17244;Vilkpėdės;MOKSLINČIŲ;6816745585;Ne;0;0;2;2
17245;Vilkpėdės;MOKSLINČIŲ;9460356725;Ne;4;1;2;7
17246;Vilkpėdės;MOKSLINČIŲ;8128254701;Ne;0;4;0;4
17247;Vilkpėdės;MOKSLINČIŲ;8015392054;Ne;0;1;0;1
17248;Vilkpėdės;MOKSLINČIŲ;2320350937;Ne;0;3;0;3
17249;Vilkpėdės;MOKSLINČIŲ;7747013579;Ne;1;2;2;5
17250;Vilkpėdės;MOKSLINČIŲ;3987021185;Ne;4;1;4;9
17251;Vilkpėdės;MOKSLINČIŲ;7908813288;Ne;0;2;2;4
17252;Vilkpėdės;MOKSLINČIŲ;9795696242;Ne;0;0;2;2
17253;Vilkpėdės;MOKSLINČIŲ;8581661608;Ne;0;2;0;2
17254;Vilkpėdės;MOKSLINČIŲ;6261547304;Ne;3;2;2;7
17255;Vilkpėdės;MOKSLINČIŲ;2420271759;Ne;8;6;2;16
17256;Vilkpėdės;MOKSLINČIŲ;3696611509;Ne;13;1;2;16
17257;Vilkpėdės;MOKSLINČIŲ;4735164204;Ne;2;2;2;6
17258;Vilkpėdės;MOKSLINČIŲ;2604179994;Ne;4;2;2;8
17259;Vilkpėdės;MOKSLINČIŲ;3888880306;Ne;0;5;2;7
17260;Vilkpėdės;MOKSLINČIŲ;1063561954;Ne;0;1;0;1
17261;Vilkpėdės;MOKSLINČIŲ;8783790519;Ne;0;5;0;5
17262;Žiburėlis;Nykštukai;4109288891;Ne;0;22;0;22
17263;Žiburėlis;Nykštukai;7522040537;Ne;0;6;0;6
17264;Žiburėlis;Nykštukai;1015624216;Ne;0;2;0;2
17265;Žiburėlis;Nykštukai;4387021429;Ne;0;6;0;6
17266;Žiburėlis;Nykštukai;4910787530;Ne;0;18;0;18
17267;Žiburėlis;Nykštukai;9783567484;Ne;0;11;0;11
17268;Žiburėlis;Nykštukai;4916545915;Taip;0;2;0;2
17269;Žiburėlis;Nykštukai;8133371774;Ne;0;13;0;13
17270;Žiburėlis;Nykštukai;7278242428;Taip;1;2;0;3
17271;Žiburėlis;Nykštukai;5732540560;Ne;0;4;0;4
17272;Žiburėlis;Nykštukai;1833704617;Ne;0;3;0;3
17273;Žiburėlis;Nykštukai;2163018032;Ne;0;16;0;16
17274;Žiburėlis;Nykštukai;4581800760;Taip;2;0;2;4
17275;Žiburėlis;Nykštukai;5002691930;Ne;0;1;0;1
17276;Žiburėlis;Nykštukai;8346571253;Ne;0;1;0;1
17277;Žiburėlis;Nykštukai;5098955523;Ne;0;5;0;5
17278;Žiburėlis;Nykštukai;5629404179;Ne;0;2;0;2
17279;Žiburėlis;Nykštukai;6647598068;Ne;0;2;0;2
17280;Žiburėlis;Nykštukai;1190058462;Taip;0;2;0;2
17281;Žiburėlis;Nykštukai;7111530833;Ne;2;3;0;5
17282;Žiburėlis;Nykštukai;9526477121;Ne;0;6;0;6
17283;Žiburėlis;"Žiniukai ";3687703187;Ne;0;4;0;4
17284;Žiburėlis;"Žiniukai ";1061646244;Ne;0;3;0;3
17285;Žiburėlis;"Žiniukai ";8215816053;Ne;0;2;1;3
17286;Žiburėlis;"Žiniukai ";7465939429;Ne;1;0;2;3
17287;Žiburėlis;"Žiniukai ";4710995351;Ne;0;6;0;6
17288;Žiburėlis;"Žiniukai ";7211961512;Ne;0;1;0;1
17289;Žiburėlis;"Žiniukai ";1559091567;Ne;0;7;0;7
17290;Žiburėlis;"Žiniukai ";3750024153;Ne;0;7;0;7
17291;Žiburėlis;"Žiniukai ";7633450988;Ne;0;7;0;7
17292;Žiburėlis;"Žiniukai ";8480167191;Ne;0;21;0;21
17293;Žiburėlis;"Žiniukai ";2292895729;Ne;0;17;0;17
17294;Žiburėlis;"Žiniukai ";2253167147;Ne;0;2;0;2
17295;Žiburėlis;"Žiniukai ";7163594513;Ne;1;0;5;6
17296;Žiburėlis;"Žiniukai ";5408766721;Ne;0;1;2;3
17297;Žiburėlis;"Žiniukai ";1764592065;Ne;0;5;0;5
17298;Žiburėlis;"Žiniukai ";7862546963;Ne;0;1;0;1
17299;Žiburėlis;"Žiniukai ";8902837168;Ne;0;1;0;1
17300;Žiburėlis;"Žiniukai ";6696156248;Ne;1;0;6;7
17301;Žiburėlis;"Žiniukai ";3938379566;Ne;0;2;0;2
17302;Žiburėlis;"Žiniukai ";5174211773;Ne;0;2;0;2
17303;Žiburėlis;"Žiniukai ";9818415192;Ne;0;11;0;11
17304;Žiburėlis;"Smalsiukai ";5438697081;Ne;0;2;2;4
17305;Žiburėlis;"Smalsiukai ";1126972447;Ne;1;7;4;12
17306;Žiburėlis;"Smalsiukai ";3936418539;Ne;0;3;0;3
17307;Žiburėlis;"Smalsiukai ";2072972990;Ne;0;0;1;1
17308;Žiburėlis;"Smalsiukai ";3835820013;Ne;0;1;0;1
17309;Žiburėlis;"Smalsiukai ";8875517201;Ne;3;4;3;10
17310;Žiburėlis;"Smalsiukai ";8065557477;Ne;0;1;1;2
17311;Žiburėlis;"Smalsiukai ";1843213137;Ne;0;2;1;3
17312;Žiburėlis;"Smalsiukai ";8953230752;Ne;0;2;2;4
17313;Žiburėlis;"Smalsiukai ";7402647048;Ne;0;1;1;2
17314;Žiburėlis;"Smalsiukai ";9352485231;Ne;0;2;2;4
17315;Žiburėlis;"Smalsiukai ";2491972986;Ne;2;3;4;9
17316;Žiburėlis;"Smalsiukai ";8973307069;Ne;0;3;0;3
17317;Žiburėlis;"Smalsiukai ";7825665451;Ne;0;4;0;4
17318;Žiburėlis;"Smalsiukai ";8970153523;Ne;0;0;3;3
17319;Žiburėlis;"Smalsiukai ";5145195661;Ne;3;7;2;12
17320;Žiburėlis;"Smalsiukai ";8018718405;Ne;0;1;2;3
17321;Žiburėlis;"Giliukai ";7310274376;Ne;0;3;0;3
17322;Žiburėlis;"Giliukai ";1090883494;Ne;0;7;0;7
17323;Žiburėlis;"Giliukai ";9215654134;Taip;0;1;0;1
17324;Žiburėlis;"Giliukai ";2866098551;Ne;0;10;2;12
17325;Žiburėlis;"Giliukai ";6918525245;Ne;0;9;0;9
17326;Žiburėlis;"Giliukai ";6946621147;Ne;0;6;0;6
17327;Žiburėlis;"Giliukai ";5148264064;Ne;0;11;0;11
17328;Žiburėlis;"Giliukai ";6733333096;Ne;0;5;0;5
17329;Žiburėlis;"Giliukai ";6232492947;Ne;0;4;0;4
17330;Žiburėlis;"Giliukai ";3807588865;Ne;0;5;0;5
17331;Žiburėlis;"Giliukai ";4091901597;Ne;0;2;0;2
17332;Žiburėlis;"Giliukai ";4016969144;Ne;0;7;0;7
17333;Žiburėlis;"Giliukai ";3776569251;Ne;0;2;0;2
17334;Žiburėlis;"Giliukai ";9494271740;Ne;0;7;0;7
17335;Žiburėlis;"Giliukai ";3992503848;Ne;5;2;4;11
17336;Žiburėlis;"Giliukai ";8440073413;Ne;0;7;0;7
17337;Žiburėlis;"Giliukai ";6121237159;Ne;0;7;0;7
17338;Žiburėlis;"Giliukai ";6289338466;Ne;0;12;0;12
17339;Žiburėlis;"Giliukai ";7977098545;Ne;0;5;0;5
17340;Žiburėlis;"Giliukai ";8697451319;Ne;0;2;0;2
17341;Žiburėlis;Meškiukai;3593851196;Ne;0;18;1;19
17342;Žiburėlis;Meškiukai;9470154520;Ne;0;3;0;3
17343;Žiburėlis;Meškiukai;2285666668;Ne;0;12;2;14
17344;Žiburėlis;Meškiukai;2836519241;Ne;0;4;0;4
17345;Žiburėlis;Meškiukai;9321467329;Ne;0;5;0;5
17346;Žiburėlis;Meškiukai;2254407798;Ne;0;4;0;4
17347;Žiburėlis;Meškiukai;4887304311;Ne;0;5;0;5
17348;Žiburėlis;Meškiukai;1651713696;Ne;0;6;0;6
17349;Žiburėlis;Meškiukai;1105220246;Ne;0;11;1;12
17350;Žiburėlis;Meškiukai;8415647388;Ne;0;7;0;7
17351;Žiburėlis;Meškiukai;2371990135;Ne;0;12;2;14
17352;Žiburėlis;Meškiukai;6218255066;Ne;0;3;2;5
17353;Žiburėlis;Meškiukai;3522480911;Taip;0;9;0;9
17354;Žiburėlis;Meškiukai;4667559315;Ne;0;7;0;7
17355;Žiburėlis;Meškiukai;1606332622;Ne;0;5;0;5
17356;Žiburėlis;Meškiukai;1758251348;Ne;0;3;0;3
17357;Žiburėlis;Meškiukai;8284913889;Ne;0;7;0;7
17358;Žiburėlis;Meškiukai;1121755119;Ne;0;4;0;4
17359;Žiburėlis;Meškiukai;2851350451;Ne;0;5;0;5
17360;Žiburėlis;Meškiukai;6206770019;Ne;0;18;0;18
17361;Žiburėlis;Viščiukai;2720743003;Ne;0;0;3;3
17362;Žiburėlis;Viščiukai;9806711776;Ne;0;0;1;1
17363;Žiburėlis;Viščiukai;7426295852;Ne;7;1;0;8
17364;Žiburėlis;Viščiukai;9160488283;Ne;2;0;2;4
17365;Žiburėlis;Viščiukai;3069436943;Ne;11;0;4;15
17366;Žiburėlis;Viščiukai;1507346142;Ne;12;0;2;14
17367;Žiburėlis;Viščiukai;4066875778;Ne;0;0;1;1
17368;Žiburėlis;Viščiukai;9369610274;Ne;2;1;3;6
17369;Žiburėlis;Viščiukai;9009869114;Ne;2;0;0;2
17370;Žiburėlis;Viščiukai;1839099729;Ne;0;0;1;1
17371;Žiburėlis;Viščiukai;1758228365;Ne;1;0;2;3
17372;Žiburėlis;Viščiukai;2382486049;Ne;0;0;3;3
17373;Žiburėlis;Viščiukai;5490536675;Ne;2;0;0;2
17374;Žiburėlis;Viščiukai;8694628008;Ne;7;0;2;9
17375;Žiburėlis;"Drambliukai ";5115160061;Taip;32;0;0;32
17376;Žiburėlis;"Drambliukai ";7364102991;Ne;11;2;6;19
17377;Žiburėlis;"Drambliukai ";8179414341;Ne;0;3;0;3
17378;Žiburėlis;"Drambliukai ";3323538690;Ne;0;2;0;2
17379;Žiburėlis;"Drambliukai ";3738184802;Ne;3;1;2;6
17380;Žiburėlis;"Drambliukai ";8603154782;Ne;0;2;0;2
17381;Žiburėlis;"Drambliukai ";5213049603;Ne;3;14;2;19
17382;Žiburėlis;"Drambliukai ";6750601280;Taip;0;3;0;3
17383;Žiburėlis;"Drambliukai ";9048781241;Ne;0;3;0;3
17384;Žiburėlis;"Drambliukai ";6126086504;Ne;0;12;0;12
17385;Žiburėlis;"Drambliukai ";7687475882;Ne;6;0;4;10
17386;Žiburėlis;"Drambliukai ";8444514098;Ne;8;22;2;32
17387;Žiburėlis;"Drambliukai ";4459356832;Ne;2;3;2;7
17388;Žiburėlis;"Drambliukai ";3787858744;Ne;0;3;0;3
17389;Žiburėlis;"Drambliukai ";5579727416;Ne;0;5;0;5
17390;Žiburėlis;"Drambliukai ";1449541244;Ne;0;25;0;25
17391;Žiburėlis;"Drambliukai ";2472729022;Ne;8;8;2;18
17392;Žiburėlis;BORUŽIUKAI;3723613593;Ne;2;1;2;5
17393;Žiburėlis;BORUŽIUKAI;9964255985;Ne;3;0;2;5
17394;Žiburėlis;BORUŽIUKAI;7895148630;Taip;4;4;2;10
17395;Žiburėlis;BORUŽIUKAI;8936912406;Ne;3;3;2;8
17396;Žiburėlis;BORUŽIUKAI;1422951221;Ne;0;2;0;2
17397;Žiburėlis;BORUŽIUKAI;5793531526;Ne;0;8;0;8
17398;Žiburėlis;BORUŽIUKAI;6128571259;Taip;0;1;0;1
17399;Žiburėlis;BORUŽIUKAI;3760039280;Ne;2;3;2;7
17400;Žiburėlis;BORUŽIUKAI;5799439634;Ne;0;1;0;1
17401;Žiburėlis;BORUŽIUKAI;4229040996;Ne;0;2;0;2
17402;Žiburėlis;BORUŽIUKAI;8373944614;Ne;9;2;6;17
17403;Žiburėlis;BORUŽIUKAI;9256751455;Ne;0;0;1;1
17404;Žiburėlis;BORUŽIUKAI;2077823704;Ne;3;0;5;8
17405;Žiburėlis;BORUŽIUKAI;9357376188;Ne;0;3;0;3
17406;Žiburėlis;BORUŽIUKAI;4233222771;Ne;2;2;0;4
17407;Žiburėlis;BORUŽIUKAI;9029039015;Ne;0;2;0;2
17408;Žiburėlis;BORUŽIUKAI;7017574924;Ne;0;6;0;6
17409;Žiburėlis;BORUŽIUKAI;1661456806;Ne;0;1;0;1
17410;Žiburėlis;BORUŽIUKAI;2527837980;Ne;3;3;2;8
17411;Žiburėlis;BORUŽIUKAI;9771442035;Ne;0;4;2;6
17412;Žiburėlis;SPINDULIUKAI;2995697464;Ne;8;3;2;13
17413;Žiburėlis;SPINDULIUKAI;7856708616;Ne;11;2;2;15
17414;Žiburėlis;SPINDULIUKAI;5205959106;Ne;1;3;3;7
17415;Žiburėlis;SPINDULIUKAI;5951659866;Ne;4;5;0;9
17416;Žiburėlis;SPINDULIUKAI;1775465307;Ne;0;5;0;5
17417;Žiburėlis;SPINDULIUKAI;4720567144;Taip;2;2;2;6
17418;Žiburėlis;SPINDULIUKAI;2808361570;Ne;13;0;2;15
17419;Žiburėlis;SPINDULIUKAI;5881242405;Ne;0;5;2;7
17420;Žiburėlis;SPINDULIUKAI;2131951626;Ne;2;5;2;9
17421;Žiburėlis;SPINDULIUKAI;3253759256;Taip;2;2;2;6
17422;Žiburėlis;SPINDULIUKAI;6969335298;Ne;2;9;2;13
17423;Žiburėlis;SPINDULIUKAI;5835919483;Ne;8;3;2;13
17424;Žiburėlis;SPINDULIUKAI;4738991020;Ne;8;2;4;14
17425;Žiburėlis;SPINDULIUKAI;6080914975;Ne;10;2;2;14
17426;Žiburėlis;SPINDULIUKAI;9325991773;Ne;0;3;0;3
17427;Žiburėlis;SPINDULIUKAI;6674351628;Ne;0;10;0;10
17428;Žiburėlis;SPINDULIUKAI;5075522632;Ne;0;4;0;4
17429;Žiburėlis;SPINDULIUKAI;1908345602;Ne;7;1;2;10
17430;Žiburėlis;SPINDULIUKAI;8140848665;Ne;13;2;4;19
17431;Žiburėlis;SPINDULIUKAI;4727673956;Ne;5;1;2;8
17432;Žiburėlis;SPINDULIUKAI;7140031765;Taip;5;0;2;7
17433;Žiburėlis;SPINDULIUKAI;2186032732;Ne;0;2;0;2
17434;Žiburėlis;KIŠKUČIAI;6492467281;Ne;3;1;3;7
17435;Žiburėlis;KIŠKUČIAI;3352845095;Ne;3;3;2;8
17436;Žiburėlis;KIŠKUČIAI;1004953300;Taip;0;1;0;1
17437;Žiburėlis;KIŠKUČIAI;3296994981;Ne;3;2;2;7
17438;Žiburėlis;KIŠKUČIAI;6019278045;Ne;4;0;2;6
17439;Žiburėlis;KIŠKUČIAI;5418413225;Ne;0;2;0;2
17440;Žiburėlis;KIŠKUČIAI;6044837042;Taip;0;9;0;9
17441;Žiburėlis;KIŠKUČIAI;1334695206;Ne;13;2;2;17
17442;Žiburėlis;KIŠKUČIAI;7597762608;Ne;0;1;0;1
17443;Žiburėlis;KIŠKUČIAI;6562748977;Ne;8;3;2;13
17444;Žiburėlis;KIŠKUČIAI;4477396434;Ne;1;6;2;9
17445;Žiburėlis;KIŠKUČIAI;2712358146;Taip;18;2;2;22
17446;Žiburėlis;KIŠKUČIAI;5410394172;Ne;0;5;0;5
17447;Žiburėlis;KIŠKUČIAI;4003368130;Ne;18;2;2;22
17448;Žiburėlis;KIŠKUČIAI;2456703958;Ne;1;2;2;5
17449;Žiburėlis;KIŠKUČIAI;1868558773;Taip;0;6;0;6
17450;Žiburėlis;KIŠKUČIAI;2083500905;Ne;0;2;0;2
17451;Žiburėlis;KIŠKUČIAI;6577061306;Ne;0;6;0;6
17452;Žiburėlis;KIŠKUČIAI;9731661697;Ne;3;0;2;5
17453;Žiburėlis;DRUGELIAI;9551175579;Ne;8;1;4;13
17454;Žiburėlis;DRUGELIAI;2872122574;Ne;22;0;0;22
17455;Žiburėlis;DRUGELIAI;5422660783;Ne;9;5;2;16
17456;Žiburėlis;DRUGELIAI;5758539955;Ne;0;18;0;18
17457;Žiburėlis;DRUGELIAI;3780842203;Ne;0;2;0;2
17458;Žiburėlis;DRUGELIAI;6751043071;Ne;12;0;4;16
17459;Žiburėlis;DRUGELIAI;8082088504;Taip;0;4;0;4
17460;Žiburėlis;DRUGELIAI;5025452484;Taip;6;2;2;10
17461;Žiburėlis;DRUGELIAI;5724506894;Ne;0;8;0;8
17462;Žiburėlis;DRUGELIAI;8207315673;Taip;8;0;2;10
17463;Žiburėlis;DRUGELIAI;4656467260;Ne;0;2;0;2
17464;Žiburėlis;DRUGELIAI;9344950711;Ne;8;2;2;12
17465;Žiburėlis;DRUGELIAI;6274583813;Ne;0;1;0;1
17466;Žiburėlis;DRUGELIAI;5194593598;Ne;11;0;2;13
17467;Žiburėlis;DRUGELIAI;2383554216;Ne;3;9;2;14
17468;Žiburėlis;DRUGELIAI;9041469393;Taip;2;2;2;6
17469;Žiburėlis;DRUGELIAI;8285987095;Ne;3;10;2;15
17470;Žiburėlis;DRUGELIAI;8752098051;Ne;0;1;0;1
17471;Žiburėlis;DRUGELIAI;4937518207;Ne;0;2;0;2
17472;Bangelė;Aštuonkojai;6216334243;Ne;6;3;2;11
17473;Bangelė;Aštuonkojai;8406002339;Ne;3;2;7;12
17474;Bangelė;Aštuonkojai;8385661612;Ne;10;0;6;16
17475;Bangelė;Aštuonkojai;7434358474;Ne;0;16;2;18
17476;Bangelė;Aštuonkojai;3471355267;Ne;0;10;0;10
17477;Bangelė;Aštuonkojai;6978215876;Ne;0;0;5;5
17478;Bangelė;Aštuonkojai;9801978617;Ne;0;5;0;5
17479;Bangelė;Aštuonkojai;9608900293;Ne;6;0;4;10
17480;Bangelė;Aštuonkojai;7107685761;Ne;0;2;0;2
17481;Bangelė;Aštuonkojai;5994720767;Ne;8;5;2;15
17482;Bangelė;Aštuonkojai;4532810332;Ne;0;7;0;7
17483;Bangelė;Aštuonkojai;8575020060;Ne;0;2;2;4
17484;Bangelė;Aštuonkojai;3344441441;Ne;9;0;4;13
17485;Bangelė;Aštuonkojai;2858929915;Ne;0;2;0;2
17486;Bangelė;Aštuonkojai;7068305612;Ne;3;17;2;22
17487;Bangelė;Aštuonkojai;8661284187;Ne;0;0;2;2
17488;Bangelė;Aštuonkojai;8943721679;Ne;7;10;3;20
17489;Bangelė;Aštuonkojai;2491928697;Ne;0;0;1;1
17490;Bangelė;Delfinukai,;9142460659;Ne;8;1;4;13
17491;Bangelė;Delfinukai,;6566277472;Ne;4;0;4;8
17492;Bangelė;Delfinukai,;1541525635;Ne;0;2;5;7
17493;Bangelė;Delfinukai,;7362196984;Ne;13;0;5;18
17494;Bangelė;Delfinukai,;4317054990;Ne;0;6;0;6
17495;Bangelė;Delfinukai,;4651237403;Ne;13;0;4;17
17496;Bangelė;Delfinukai,;4712616315;Ne;0;3;0;3
17497;Bangelė;Delfinukai,;2518820268;Ne;5;2;2;9
17498;Bangelė;Delfinukai,;4940247006;Ne;20;0;2;22
17499;Bangelė;Delfinukai,;8335931279;Taip;0;6;0;6
17500;Bangelė;Delfinukai,;9311379746;Ne;0;1;7;8
17501;Bangelė;Delfinukai,;5980274157;Ne;13;1;2;16
17502;Bangelė;Delfinukai,;9955097720;Ne;3;0;2;5
17503;Bangelė;Delfinukai,;4851593235;Ne;0;1;7;8
17504;Bangelė;Delfinukai,;8998648968;Ne;4;2;4;10
17505;Bangelė;Delfinukai,;2127734178;Ne;4;0;2;6
17506;Bangelė;Delfinukai,;2107766301;Ne;3;2;2;7
17507;Bangelė;Delfinukai,;5237434283;Ne;3;7;2;12
17508;Bangelė;Delfinukai,;7352647183;Ne;0;0;2;2
17509;Bangelė;Delfinukai,;1859896454;Ne;0;0;2;2
17510;Bangelė;"Saulės spindulėliai";9488932192;Ne;20;0;2;22
17511;Bangelė;"Saulės spindulėliai";4843411757;Ne;5;0;2;7
17512;Bangelė;"Saulės spindulėliai";1754002501;Ne;0;1;0;1
17513;Bangelė;"Saulės spindulėliai";6953698592;Ne;0;3;0;3
17514;Bangelė;"Saulės spindulėliai";3063439996;Taip;0;4;0;4
17515;Bangelė;"Saulės spindulėliai";6026399355;Ne;0;3;0;3
17516;Bangelė;"Saulės spindulėliai";2156837975;Ne;0;5;0;5
17517;Bangelė;"Saulės spindulėliai";9143945953;Ne;0;6;0;6
17518;Bangelė;"Saulės spindulėliai";3022508446;Ne;0;2;2;4
17519;Bangelė;"Saulės spindulėliai";5476753511;Ne;0;2;3;5
17520;Bangelė;"Saulės spindulėliai";5546256869;Ne;0;1;0;1
17521;Bangelė;"Saulės spindulėliai";6980232224;Ne;0;1;0;1
17522;Bangelė;"Saulės spindulėliai";1390623903;Ne;0;8;0;8
17523;Bangelė;"Saulės spindulėliai";9788923823;Ne;4;5;2;11
17524;Bangelė;"Saulės spindulėliai";7136625230;Ne;0;6;0;6
17525;Bangelė;"Saulės spindulėliai";9168310196;Ne;8;4;2;14
17526;Bangelė;"Saulės spindulėliai";9790680407;Taip;6;2;3;11
17527;Bangelė;"Pingvinukai ";2405364948;Ne;1;2;3;6
17528;Bangelė;"Pingvinukai ";7782233807;Ne;0;19;0;19
17529;Bangelė;"Pingvinukai ";8959248662;Ne;3;0;3;6
17530;Bangelė;"Pingvinukai ";5054826517;Ne;1;0;2;3
17531;Bangelė;"Pingvinukai ";8943497040;Ne;0;6;0;6
17532;Bangelė;"Pingvinukai ";8297403610;Ne;0;0;6;6
17533;Bangelė;"Pingvinukai ";2023033514;Ne;0;0;3;3
17534;Bangelė;"Pingvinukai ";3351519357;Ne;2;0;2;4
17535;Bangelė;"Pingvinukai ";7794085741;Ne;9;0;7;16
17536;Bangelė;"Pingvinukai ";2279517392;Ne;6;0;4;10
17537;Bangelė;"Pingvinukai ";6433126719;Ne;0;5;0;5
17538;Bangelė;"Pingvinukai ";9740713810;Ne;6;0;5;11
17539;Bangelė;"Pingvinukai ";5829865386;Ne;0;0;8;8
17540;Bangelė;"Pingvinukai ";7808569484;Ne;7;2;5;14
17541;Bangelė;"Pingvinukai ";8981519368;Ne;2;0;3;5
17542;Bangelė;"Pingvinukai ";2362345363;Ne;10;0;2;12
17543;Bangelė;"Jūros žvaigždutės ";9447145378;Ne;13;0;5;18
17544;Bangelė;"Jūros žvaigždutės ";8745595583;Ne;18;2;2;22
17545;Bangelė;"Jūros žvaigždutės ";6174617493;Ne;3;8;2;13
17546;Bangelė;"Jūros žvaigždutės ";8075810032;Ne;0;2;0;2
17547;Bangelė;"Jūros žvaigždutės ";2624013880;Ne;6;0;6;12
17548;Bangelė;"Jūros žvaigždutės ";6397805392;Ne;0;8;0;8
17549;Bangelė;"Jūros žvaigždutės ";1724955001;Ne;0;2;2;4
17550;Bangelė;"Jūros žvaigždutės ";5961647252;Ne;8;2;2;12
17551;Bangelė;"Jūros žvaigždutės ";3851738513;Ne;0;2;0;2
17552;Bangelė;"Jūros žvaigždutės ";4891131242;Ne;8;2;2;12
17553;Bangelė;"Jūros žvaigždutės ";8931569423;Ne;3;0;2;5
17554;Bangelė;"Jūros žvaigždutės ";7364368699;Ne;0;3;0;3
17555;Bangelė;"Jūros žvaigždutės ";7755966282;Ne;0;2;3;5
17556;Bangelė;"Jūros žvaigždutės ";6400785821;Ne;0;2;0;2
17557;Bangelė;"Jūros žvaigždutės ";8765892966;Ne;0;6;0;6
17558;Bangelė;"Jūros žvaigždutės ";4480762963;Ne;0;2;0;2
17559;Bangelė;"Jūros žvaigždutės ";5370269001;Ne;0;14;0;14
17560;Bangelė;Žuvytės;7174742281;Ne;13;2;4;19
17561;Bangelė;Žuvytės;6806911810;Ne;3;10;2;15
17562;Bangelė;Žuvytės;6548270099;Ne;8;0;4;12
17563;Bangelė;Žuvytės;7074211876;Ne;2;0;3;5
17564;Bangelė;Žuvytės;4086446380;Ne;2;2;2;6
17565;Bangelė;Žuvytės;9268294844;Ne;0;3;0;3
17566;Bangelė;Žuvytės;5229147553;Ne;6;0;2;8
17567;Bangelė;Žuvytės;4831656996;Ne;6;0;6;12
17568;Bangelė;Žuvytės;3069288815;Ne;3;0;2;5
17569;Bangelė;Žuvytės;9633372201;Ne;6;1;4;11
17570;Bangelė;Žuvytės;9729929020;Ne;5;0;2;7
17571;Bangelė;Žuvytės;8563674709;Ne;3;7;2;12
17572;Bangelė;Žuvytės;5673493708;Ne;13;4;2;19
17573;Bangelė;Žuvytės;3946690047;Taip;0;0;2;2
17574;Bangelė;Žuvytės;3500097405;Ne;7;0;2;9
17575;Bangelė;Žuvytės;1544311819;Ne;1;0;2;3
17576;Bangelė;Žuvytės;4080993439;Ne;4;0;2;6
17577;Bangelė;Žuvytės;3744789873;Ne;1;0;2;3
17578;Bangelė;Žuvytės;3016778137;Ne;3;0;2;5
17579;Bangelė;Žuvytės;1898671487;Ne;3;0;2;5
17580;Bangelė;Ruoniai;7685394517;Ne;1;1;2;4
17581;Bangelė;Ruoniai;8758933649;Ne;0;2;4;6
17582;Bangelė;Ruoniai;8702632542;Ne;3;4;2;9
17583;Bangelė;Ruoniai;6480681705;Ne;1;3;2;6
17584;Bangelė;Ruoniai;7142694888;Ne;4;6;4;14
17585;Bangelė;Ruoniai;8734511431;Ne;1;3;2;6
17586;Bangelė;Ruoniai;1895213200;Ne;3;0;4;7
17587;Bangelė;Ruoniai;9765268154;Taip;3;8;2;13
17588;Bangelė;Ruoniai;8495423628;Ne;4;2;2;8
17589;Bangelė;Ruoniai;7419016784;Ne;1;2;2;5
17590;Bangelė;Ruoniai;5190563034;Ne;1;0;4;5
17591;Bangelė;Ruoniai;9980881014;Ne;3;0;2;5
17592;Bangelė;Ruoniai;9954762483;Ne;5;5;2;12
17593;Bangelė;Ruoniai;9493465898;Ne;4;3;4;11
17594;Bangelė;Ruoniai;5597329949;Ne;3;5;2;10
17595;Bangelė;Ruoniai;2134225414;Ne;10;0;4;14
17596;Bangelė;Ruoniai;4494049529;Ne;0;0;6;6
17597;Bangelė;Ruoniai;3334029244;Ne;8;0;6;14
17598;Bangelė;Ruoniai;6496580354;Ne;8;3;6;17
17599;Bangelė;Ruoniai;6165322599;Ne;0;11;0;11
17600;Bangelė;"Pagrandukai ";9355348960;Ne;0;3;3;6
17601;Bangelė;"Pagrandukai ";1467390411;Ne;1;0;2;3
17602;Bangelė;"Pagrandukai ";7503518328;Ne;0;2;0;2
17603;Bangelė;"Pagrandukai ";7432980844;Ne;3;10;2;15
17604;Bangelė;"Pagrandukai ";7729373603;Ne;12;0;2;14
17605;Bangelė;"Pagrandukai ";5237637695;Ne;0;2;1;3
17606;Bangelė;"Pagrandukai ";7138947462;Ne;0;2;1;3
17607;Bangelė;"Pagrandukai ";2535189316;Ne;2;4;2;8
17608;Bangelė;"Pagrandukai ";9430653481;Ne;0;0;2;2
17609;Bangelė;"Pagrandukai ";4558724094;Ne;16;0;2;18
17610;Bangelė;"Pagrandukai ";3557202302;Ne;0;16;3;19
17611;Bangelė;"Pagrandukai ";7188182741;Ne;0;0;3;3
17612;Bangelė;"Zuikučiai ";6925192867;Ne;3;0;2;5
17613;Bangelė;"Zuikučiai ";6965660021;Ne;0;1;1;2
17614;Bangelė;"Zuikučiai ";3994276744;Ne;6;0;6;12
17615;Bangelė;"Zuikučiai ";3059847953;Ne;2;9;2;13
17616;Bangelė;"Zuikučiai ";5909385625;Taip;6;0;5;11
17617;Bangelė;"Zuikučiai ";4401415720;Ne;3;0;2;5
17618;Bangelė;"Zuikučiai ";1610384455;Ne;0;3;0;3
17619;Bangelė;"Zuikučiai ";9841829359;Ne;0;2;0;2
17620;Bangelė;"Zuikučiai ";8836768508;Ne;18;2;2;22
17621;Bangelė;"Zuikučiai ";6100558953;Ne;5;2;6;13
17622;Bangelė;"Zuikučiai ";5192643204;Ne;0;0;3;3
17623;Bangelė;Vėžliukai;4037426263;Ne;2;0;4;6
17624;Bangelė;Vėžliukai;7862345122;Ne;4;0;6;10
17625;Bangelė;Vėžliukai;2630571748;Ne;5;10;2;17
17626;Bangelė;Vėžliukai;3978683237;Ne;2;0;5;7
17627;Bangelė;Vėžliukai;5779198855;Ne;0;14;0;14
17628;Bangelė;Vėžliukai;5746189515;Ne;0;5;0;5
17629;Bangelė;Vėžliukai;8454369872;Taip;0;3;0;3
17630;Bangelė;Vėžliukai;9561221619;Ne;0;3;0;3
17631;Bangelė;Vėžliukai;1182624046;Ne;0;8;0;8
17632;Bangelė;Vėžliukai;9010238689;Taip;0;6;0;6
17633;Bangelė;Vėžliukai;9128326823;Ne;0;5;0;5
17634;Bangelė;Vėžliukai;6415607960;Ne;5;0;8;13
17635;Bangelė;Vėžliukai;2730545639;Ne;6;0;2;8
17636;Bangelė;Vėžliukai;2301343701;Ne;0;4;0;4
17637;Bangelė;Vėžliukai;6506241123;Ne;3;0;4;7
17638;Bangelė;Vėžliukai;8950435528;Ne;1;2;2;5
17639;Gėlynas;PAKALNUTĖ;4557380282;Ne;0;0;22;22
17640;Gėlynas;PAKALNUTĖ;6884111634;Ne;0;0;4;4
17641;Gėlynas;PAKALNUTĖ;1548317086;Ne;7;0;2;9
17642;Gėlynas;PAKALNUTĖ;3470963396;Ne;1;0;3;4
17643;Gėlynas;PAKALNUTĖ;6053841081;Ne;7;0;2;9
17644;Gėlynas;PAKALNUTĖ;2171064300;Ne;2;0;3;5
17645;Gėlynas;PAKALNUTĖ;2404562144;Ne;0;8;0;8
17646;Gėlynas;PAKALNUTĖ;7504469409;Ne;7;0;3;10
17647;Gėlynas;PAKALNUTĖ;4366442459;Ne;2;2;3;7
17648;Gėlynas;PAKALNUTĖ;1463783538;Ne;2;0;4;6
17649;Gėlynas;PAKALNUTĖ;7064068912;Ne;11;1;5;17
17650;Gėlynas;PAKALNUTĖ;1822933936;Ne;8;0;2;10
17651;Gėlynas;PAKALNUTĖ;4668195919;Ne;6;0;7;13
17652;Gėlynas;PAKALNUTĖ;8555408466;Ne;0;16;0;16
17653;Gėlynas;PAKALNUTĖ;2377323648;Ne;3;2;2;7
17654;Gėlynas;PAKALNUTĖ;5382148888;Ne;0;2;0;2
17655;Gėlynas;PAKALNUTĖ;6296728638;Ne;2;0;2;4
17656;Gėlynas;PAKALNUTĖ;2273705177;Ne;0;0;4;4
17657;Gėlynas;PAKALNUTĖ;5350834071;Ne;0;0;2;2
17658;Gėlynas;PAKALNUTĖ;2520140743;Taip;2;0;2;4
17659;Gėlynas;PAKALNUTĖ;6244314445;Ne;6;2;4;12
17660;Gėlynas;PAKALNUTĖ;9707677931;Ne;2;0;4;6
17661;Gėlynas;VARPELIS;1505666690;Ne;0;3;2;5
17662;Gėlynas;VARPELIS;9330385153;Ne;8;2;4;14
17663;Gėlynas;VARPELIS;9724668402;Ne;1;2;4;7
17664;Gėlynas;VARPELIS;2742456983;Ne;3;2;5;10
17665;Gėlynas;VARPELIS;2784709117;Ne;0;0;3;3
17666;Gėlynas;VARPELIS;6114995335;Ne;3;2;2;7
17667;Gėlynas;VARPELIS;6815740588;Ne;0;2;1;3
17668;Gėlynas;VARPELIS;3606076029;Ne;0;0;5;5
17669;Gėlynas;VARPELIS;5291444399;Ne;0;0;1;1
17670;Gėlynas;VARPELIS;5320531856;Ne;0;2;2;4
17671;Gėlynas;VARPELIS;7730322729;Ne;0;1;3;4
17672;Gėlynas;VARPELIS;4505012978;Ne;6;0;6;12
17673;Gėlynas;VARPELIS;9508507084;Ne;0;22;0;22
17674;Gėlynas;VARPELIS;2348787949;Ne;4;2;2;8
17675;Gėlynas;VARPELIS;5541707540;Ne;0;2;0;2
17676;Gėlynas;VARPELIS;5124029118;Ne;1;0;2;3
17677;Gėlynas;VARPELIS;6528464599;Ne;3;2;4;9
17678;Gėlynas;VARPELIS;8615943743;Ne;3;0;2;5
17679;Gėlynas;VARPELIS;3572020585;Ne;3;0;3;6
17680;Gėlynas;VARPELIS;8458276300;Ne;3;0;2;5
17681;Gėlynas;VARPELIS;8999346908;Ne;0;2;0;2
17682;Gėlynas;RAKTAŽOLĖ;7389502638;Ne;3;0;5;8
17683;Gėlynas;RAKTAŽOLĖ;1590299264;Ne;2;0;7;9
17684;Gėlynas;RAKTAŽOLĖ;5751256561;Ne;10;0;5;15
17685;Gėlynas;RAKTAŽOLĖ;8080660097;Ne;0;0;4;4
17686;Gėlynas;RAKTAŽOLĖ;6875794958;Ne;7;0;6;13
17687;Gėlynas;RAKTAŽOLĖ;3492361041;Ne;0;0;4;4
17688;Gėlynas;RAKTAŽOLĖ;6451922757;Ne;5;0;2;7
17689;Gėlynas;RAKTAŽOLĖ;7150367866;Ne;3;0;4;7
17690;Gėlynas;RAKTAŽOLĖ;4983822000;Ne;7;0;4;11
17691;Gėlynas;RAKTAŽOLĖ;9462822190;Ne;0;2;0;2
17692;Gėlynas;RAKTAŽOLĖ;3549079170;Ne;5;0;2;7
17693;Gėlynas;RAKTAŽOLĖ;4824667762;Ne;0;2;0;2
17694;Gėlynas;RAKTAŽOLĖ;7998013477;Ne;0;2;2;4
17695;Gėlynas;RAKTAŽOLĖ;8447789767;Ne;12;2;4;18
17696;Gėlynas;RAKTAŽOLĖ;1468588114;Ne;0;1;0;1
17697;Gėlynas;RAKTAŽOLĖ;9305282699;Ne;0;2;2;4
17698;Gėlynas;RAKTAŽOLĖ;1235384604;Ne;0;0;3;3
17699;Gėlynas;RAKTAŽOLĖ;8693415786;Ne;0;0;3;3
17700;Gėlynas;RAKTAŽOLĖ;2800420481;Ne;0;2;0;2
17701;Gėlynas;RAKTAŽOLĖ;8444505017;Ne;6;0;3;9
17702;Gėlynas;SAULĖGRĄŽA;3746597878;Ne;0;0;3;3
17703;Gėlynas;SAULĖGRĄŽA;9182072776;Ne;2;2;5;9
17704;Gėlynas;SAULĖGRĄŽA;1862266440;Ne;0;0;2;2
17705;Gėlynas;SAULĖGRĄŽA;4292724541;Ne;0;0;1;1
17706;Gėlynas;SAULĖGRĄŽA;2790269385;Ne;5;2;4;11
17707;Gėlynas;SAULĖGRĄŽA;7988094745;Ne;0;2;0;2
17708;Gėlynas;SAULĖGRĄŽA;4192292896;Ne;0;2;0;2
17709;Gėlynas;SAULĖGRĄŽA;9552677108;Ne;0;0;9;9
17710;Gėlynas;SAULĖGRĄŽA;2608369575;Ne;0;0;9;9
17711;Gėlynas;SAULĖGRĄŽA;1949260962;Ne;0;2;0;2
17712;Gėlynas;SAULĖGRĄŽA;6635004996;Ne;3;0;6;9
17713;Gėlynas;SAULĖGRĄŽA;5942466822;Ne;4;0;2;6
17714;Gėlynas;SAULĖGRĄŽA;2193861056;Ne;0;0;4;4
17715;Gėlynas;SAULĖGRĄŽA;6826311903;Ne;0;2;0;2
17716;Gėlynas;SAULĖGRĄŽA;9230984365;Ne;5;0;4;9
17717;Gėlynas;SAULĖGRĄŽA;6221721945;Ne;4;6;7;17
17718;Gėlynas;SAULĖGRĄŽA;7005278902;Ne;0;0;2;2
17719;Gėlynas;SAULĖGRĄŽA;6790040590;Ne;1;2;3;6
17720;Gėlynas;SAULĖGRĄŽA;4854709904;Ne;0;0;6;6
17721;Gėlynas;SAULĖGRĄŽA;1665668966;Ne;0;0;3;3
17722;Gėlynas;SAULĖGRĄŽA;1570975863;Ne;0;0;4;4
17723;Gėlynas;SAULĖGRĄŽA;9302757372;Ne;0;14;8;22
17724;Gėlynas;SAULĖGRĄŽA;6342888072;Ne;0;0;1;1
17725;Gėlynas;RAMUNĖLĖ;5813156578;Ne;0;0;2;2
17726;Gėlynas;RAMUNĖLĖ;8550986498;Ne;1;0;6;7
17727;Gėlynas;RAMUNĖLĖ;1003739544;Taip;0;0;18;18
17728;Gėlynas;RAMUNĖLĖ;8483711968;Ne;0;0;1;1
17729;Gėlynas;RAMUNĖLĖ;5576414317;Ne;0;0;11;11
17730;Gėlynas;RAMUNĖLĖ;1625163282;Ne;0;0;3;3
17731;Gėlynas;RAMUNĖLĖ;2968257637;Ne;3;0;2;5
17732;Gėlynas;RAMUNĖLĖ;9063119595;Ne;0;0;1;1
17733;Gėlynas;RAMUNĖLĖ;1923691283;Taip;2;0;4;6
17734;Gėlynas;RAMUNĖLĖ;1360487284;Ne;2;0;4;6
17735;Gėlynas;RAMUNĖLĖ;2043763411;Ne;6;0;4;10
17736;Gėlynas;RAMUNĖLĖ;4666515153;Ne;0;0;1;1
17737;Gėlynas;RAMUNĖLĖ;6447818933;Ne;0;0;2;2
17738;Gėlynas;ŽIBUTĖ;8681345327;Ne;0;2;0;2
17739;Gėlynas;ŽIBUTĖ;1556683639;Ne;7;0;3;10
17740;Gėlynas;ŽIBUTĖ;2885148633;Ne;0;0;3;3
17741;Gėlynas;ŽIBUTĖ;9786032406;Ne;3;0;5;8
17742;Gėlynas;ŽIBUTĖ;6053762333;Ne;0;2;8;10
17743;Gėlynas;ŽIBUTĖ;4018507719;Ne;5;0;2;7
17744;Gėlynas;ŽIBUTĖ;4012165601;Ne;2;0;2;4
17745;Gėlynas;ŽIBUTĖ;7633304238;Ne;0;16;0;16
17746;Gėlynas;ŽIBUTĖ;1579053252;Ne;9;2;4;15
17747;Gėlynas;ŽIBUTĖ;9980617252;Ne;0;0;4;4
17748;Gėlynas;ŽIBUTĖ;9859626078;Ne;0;2;12;14
17749;Gėlynas;ŽIBUTĖ;1073904355;Ne;0;2;2;4
17750;Gėlynas;ŽIBUTĖ;9256960820;Ne;7;0;4;11
17751;Gėlynas;ŽIBUTĖ;9513419357;Ne;8;2;2;12
17752;Gėlynas;ŽIBUTĖ;3629326461;Ne;11;1;5;17
17753;Obelėlė;Gudručiai;9900484892;Ne;3;1;2;6
17754;Obelėlė;Gudručiai;9586720282;Ne;0;2;2;4
17755;Obelėlė;Gudručiai;9567704282;Ne;0;8;0;8
17756;Obelėlė;Gudručiai;4015702815;Ne;0;2;0;2
17757;Obelėlė;Gudručiai;4309139638;Ne;0;1;0;1
17758;Obelėlė;Gudručiai;5141585309;Ne;0;2;2;4
17759;Obelėlė;Gudručiai;9736557012;Ne;0;2;4;6
17760;Obelėlė;Gudručiai;6720058972;Ne;0;2;2;4
17761;Obelėlė;Gudručiai;2204293216;Ne;1;2;4;7
17762;Obelėlė;Gudručiai;1184082097;Ne;0;0;2;2
17763;Obelėlė;Gudručiai;2533715287;Ne;0;22;0;22
17764;Obelėlė;Gudručiai;1312484983;Ne;3;5;2;10
17765;Obelėlė;Gudručiai;1565630870;Ne;0;2;3;5
17766;Obelėlė;Gudručiai;1598785483;Ne;0;8;0;8
17767;Obelėlė;Gudručiai;2170134084;Ne;1;8;4;13
17768;Obelėlė;Gudručiai;8155712451;Ne;0;2;0;2
17769;Obelėlė;Gudručiai;1362135757;Ne;0;2;1;3
17770;Obelėlė;Gudručiai;3769993089;Ne;3;0;3;6
17771;Obelėlė;Gudručiai;1630067014;Ne;0;5;1;6
17772;Obelėlė;Gudručiai;2053807216;Ne;0;2;4;6
17773;Obelėlė;Pasakaitė;9008900055;Ne;0;3;0;3
17774;Obelėlė;Pasakaitė;9332534001;Ne;0;3;0;3
17775;Obelėlė;Pasakaitė;1788880520;Ne;4;0;10;14
17776;Obelėlė;Pasakaitė;2465101384;Ne;3;0;5;8
17777;Obelėlė;Pasakaitė;5366112771;Ne;3;0;5;8
17778;Obelėlė;Pasakaitė;3452970142;Taip;0;1;2;3
17779;Obelėlė;Pasakaitė;4505857257;Ne;0;5;0;5
17780;Obelėlė;Pasakaitė;6945301927;Ne;3;2;2;7
17781;Obelėlė;Pasakaitė;5603904852;Ne;0;0;1;1
17782;Obelėlė;Pasakaitė;9995891955;Ne;0;2;2;4
17783;Obelėlė;Pasakaitė;3646359565;Ne;6;0;4;10
17784;Obelėlė;Pasakaitė;2663004768;Ne;0;0;5;5
17785;Obelėlė;Pasakaitė;4707488292;Ne;17;0;0;17
17786;Obelėlė;Pasakaitė;2031637374;Ne;3;0;3;6
17787;Obelėlė;Pasakaitė;4678269928;Taip;0;0;7;7
17788;Obelėlė;Pasakaitė;8060994250;Ne;2;0;3;5
17789;Obelėlė;Pasakaitė;5617103957;Ne;4;2;2;8
17790;Obelėlė;Pasakaitė;6321178561;Ne;14;1;2;17
17791;Obelėlė;Pasakaitė;9903010418;Ne;7;0;3;10
17792;Obelėlė;Pasakaitė;4673426170;Ne;13;2;2;17
17793;Obelėlė;Pasakaitė;7901070568;Ne;0;0;2;2
17794;Obelėlė;Svajokliai;9981446556;Ne;0;2;2;4
17795;Obelėlė;Svajokliai;1469593267;Ne;1;2;3;6
17796;Obelėlė;Svajokliai;9819048265;Ne;0;10;3;13
17797;Obelėlė;Svajokliai;1010954005;Ne;3;0;2;5
17798;Obelėlė;Svajokliai;4489212434;Ne;0;0;1;1
17799;Obelėlė;Svajokliai;6325027163;Ne;0;0;3;3
17800;Obelėlė;Svajokliai;5620250331;Ne;0;0;2;2
17801;Obelėlė;Svajokliai;1705232474;Ne;0;0;1;1
17802;Obelėlė;Svajokliai;7094715237;Ne;2;0;5;7
17803;Obelėlė;Svajokliai;9070960601;Ne;0;2;3;5
17804;Obelėlė;Svajokliai;8231489868;Ne;0;2;0;2
17805;Obelėlė;Svajokliai;3986892111;Ne;0;2;0;2
17806;Obelėlė;Svajokliai;7003947655;Ne;0;1;1;2
17807;Obelėlė;Svajokliai;9641297002;Ne;0;2;2;4
17808;Obelėlė;Svajokliai;8918176312;Ne;3;2;4;9
17809;Obelėlė;Svajokliai;8604451971;Ne;0;0;1;1
17810;Obelėlė;Svajokliai;7794072582;Ne;8;0;3;11
17811;Obelėlė;Svajokliai;6785654280;Ne;0;0;14;14
17812;Obelėlė;Svajokliai;6311322617;Ne;0;1;3;4
17813;Obelėlė;Svajokliai;2813927086;Ne;1;2;4;7
17814;Obelėlė;Smalsučiai;6497584911;Ne;0;0;1;1
17815;Obelėlė;Smalsučiai;7687093936;Ne;0;0;1;1
17816;Obelėlė;Smalsučiai;7108517080;Ne;0;0;2;2
17817;Obelėlė;Smalsučiai;6008839269;Ne;0;6;0;6
17818;Obelėlė;Smalsučiai;4987747783;Ne;2;0;4;6
17819;Obelėlė;Smalsučiai;5085970254;Ne;1;0;2;3
17820;Obelėlė;Smalsučiai;8709758561;Ne;5;0;2;7
17821;Obelėlė;Smalsučiai;4318546408;Ne;3;2;2;7
17822;Obelėlė;Smalsučiai;5739522736;Ne;0;0;3;3
17823;Obelėlė;Smalsučiai;2631405243;Ne;0;0;4;4
17824;Obelėlė;Smalsučiai;8173307704;Ne;6;2;2;10
17825;Obelėlė;Smalsučiai;6720808705;Ne;2;2;3;7
17826;Obelėlė;Smalsučiai;7850656031;Ne;0;2;2;4
17827;Obelėlė;Smalsučiai;9084969712;Taip;2;0;3;5
17828;Obelėlė;Smalsučiai;6364101139;Ne;0;6;0;6
17829;Obelėlė;Smalsučiai;8183287212;Ne;0;1;1;2
17830;Obelėlė;Smalsučiai;2574840626;Ne;0;13;0;13
17831;Obelėlė;Smalsučiai;8981403984;Ne;17;0;5;22
17832;Obelėlė;Pabiručiai;2035035265;Ne;0;0;1;1
17833;Obelėlė;Pabiručiai;5763713052;Ne;11;0;4;15
17834;Obelėlė;Pabiručiai;8579887226;Ne;7;0;4;11
17835;Obelėlė;Pabiručiai;6946457363;Ne;0;0;1;1
17836;Obelėlė;Pabiručiai;8948297718;Ne;2;0;3;5
17837;Obelėlė;Pabiručiai;5599466885;Ne;3;0;5;8
17838;Obelėlė;Pabiručiai;9634414572;Ne;2;0;2;4
17839;Obelėlė;Pabiručiai;2262107831;Ne;1;0;2;3
17840;Obelėlė;Pabiručiai;4851824672;Ne;0;6;0;6
17841;Obelėlė;Pabiručiai;3526079444;Ne;4;0;2;6
17842;Obelėlė;Pabiručiai;9731565368;Ne;2;2;3;7
17843;Obelėlė;Pabiručiai;8827515572;Ne;7;0;1;8
17844;Obelėlė;Pabiručiai;2399173200;Ne;4;0;2;6
17845;Obelėlė;Pabiručiai;8443192155;Ne;1;0;2;3
17846;Obelėlė;Pabiručiai;9627134967;Ne;1;1;5;7
17847;Obelėlė;Pabiručiai;4575139158;Ne;12;0;5;17
17848;Obelėlė;Strakaliukai;1706102918;Taip;0;2;0;2
17849;Obelėlė;Strakaliukai;8682794598;Ne;0;8;2;10
17850;Obelėlė;Strakaliukai;8754552660;Ne;7;2;4;13
17851;Obelėlė;Strakaliukai;9716500560;Ne;0;0;1;1
17852;Obelėlė;Strakaliukai;4251418414;Ne;6;0;4;10
17853;Obelėlė;Strakaliukai;7128421330;Ne;5;1;2;8
17854;Obelėlė;Strakaliukai;5943314566;Ne;0;12;0;12
17855;Obelėlė;Strakaliukai;3116100694;Ne;0;2;2;4
17856;Obelėlė;Strakaliukai;5741823041;Ne;0;2;1;3
17857;Obelėlė;Strakaliukai;8050551266;Ne;5;1;2;8
17858;Obelėlė;Strakaliukai;7468335279;Ne;9;2;2;13
17859;Obelėlė;Strakaliukai;1180508643;Ne;0;6;0;6
17860;Obelėlė;Strakaliukai;7124393375;Ne;0;2;4;6
17861;Obelėlė;Strakaliukai;5001844064;Ne;0;2;2;4
17862;Obelėlė;Strakaliukai;1537769810;Ne;1;10;2;13
17863;Obelėlė;Strakaliukai;5776116844;Ne;0;2;4;6
17864;Obelėlė;Strakaliukai;1419189517;Ne;3;2;4;9
17865;Obelėlė;Strakaliukai;3425736276;Ne;8;2;2;12
17866;Obelėlė;Strakaliukai;8487088625;Ne;0;1;1;2
17867;Obelėlė;Strakaliukai;5374979248;Ne;2;0;3;5
17868;Obelėlė;Saulutė;2772753891;Taip;0;10;3;13
17869;Obelėlė;Saulutė;8486560892;Ne;5;0;2;7
17870;Obelėlė;Saulutė;1858251094;Ne;3;0;3;6
17871;Obelėlė;Saulutė;2893378990;Ne;2;0;6;8
17872;Obelėlė;Saulutė;7491934262;Ne;5;0;8;13
17873;Obelėlė;Saulutė;9043542844;Ne;0;0;5;5
17874;Obelėlė;Saulutė;4321210604;Ne;6;0;4;10
17875;Obelėlė;Saulutė;4209489251;Ne;0;0;4;4
17876;Obelėlė;Saulutė;4309622934;Ne;5;0;6;11
17877;Obelėlė;Saulutė;3590915973;Ne;0;0;2;2
17878;Obelėlė;Saulutė;6470533765;Ne;5;3;2;10
17879;Obelėlė;Saulutė;8223715886;Ne;5;3;2;10
17880;Obelėlė;Saulutė;8461505586;Ne;0;0;4;4
17881;Obelėlė;Saulutė;2730569223;Ne;3;0;6;9
17882;Obelėlė;Saulutė;4218895290;Ne;0;1;4;5
17883;Obelėlė;Saulutė;3460171136;Taip;0;0;3;3
17884;Obelėlė;Saulutė;4262041356;Ne;0;0;4;4
17885;Obelėlė;Rieduliukai;7358561581;Ne;7;0;2;9
17886;Obelėlė;Rieduliukai;6288343928;Ne;3;0;2;5
17887;Obelėlė;Rieduliukai;8518041886;Ne;8;0;3;11
17888;Obelėlė;Rieduliukai;9980499571;Ne;10;0;2;12
17889;Obelėlė;Rieduliukai;7254219285;Ne;9;7;3;19
17890;Obelėlė;Rieduliukai;9329425457;Ne;0;0;4;4
17891;Obelėlė;Rieduliukai;9418600546;Ne;6;0;2;8
17892;Obelėlė;Rieduliukai;1246354139;Ne;3;0;2;5
17893;Obelėlė;Rieduliukai;4004797759;Ne;13;0;4;17
17894;Obelėlė;Rieduliukai;4872101613;Ne;1;0;3;4
17895;Obelėlė;Rieduliukai;8963630504;Ne;4;0;3;7
17896;Obelėlė;Rieduliukai;5441524884;Ne;5;0;5;10
17897;Obelėlė;Rieduliukai;3210789582;Ne;10;0;4;14
17898;Obelėlė;Rieduliukai;1039878043;Ne;10;0;4;14
17899;Obelėlė;Rieduliukai;7111855298;Ne;5;0;2;7
17900;Obelėlė;Rieduliukai;9359921446;Ne;9;0;3;12
17901;Obelėlė;Žirniukai;9542303128;Ne;3;0;2;5
17902;Obelėlė;Žirniukai;3886008149;Ne;8;2;3;13
17903;Obelėlė;Žirniukai;4676986978;Ne;3;0;2;5
17904;Obelėlė;Žirniukai;9222485883;Ne;7;8;0;15
17905;Obelėlė;Žirniukai;4708077301;Ne;8;4;2;14
17906;Obelėlė;Žirniukai;3199776998;Ne;5;0;3;8
17907;Obelėlė;Žirniukai;4979811410;Taip;5;0;2;7
17908;Obelėlė;Žirniukai;1369344706;Ne;5;0;7;12
17909;Obelėlė;Žirniukai;2561695305;Ne;18;0;2;20
17910;Obelėlė;Žirniukai;1329818819;Ne;3;0;2;5
17911;Obelėlė;Žirniukai;5933225940;Ne;3;0;5;8
17912;Obelėlė;Žirniukai;3347690540;Ne;4;0;3;7
17913;Obelėlė;Žirniukai;9502503757;Ne;3;0;5;8
17914;Obelėlė;Žirniukai;3474007758;Ne;11;0;2;13
17915;Obelėlė;Žirniukai;8777938603;Ne;2;1;5;8
17916;Obelėlė;Žirniukai;5213900934;Ne;7;0;4;11
17917;Obelėlė;Žirniukai;4862765923;Ne;10;0;4;14
17918;Obelėlė;Bičiuliai;5209482838;Ne;2;0;4;6
17919;Obelėlė;Bičiuliai;8422696011;Ne;0;2;1;3
17920;Obelėlė;Bičiuliai;1799603610;Ne;17;0;5;22
17921;Obelėlė;Bičiuliai;5192989376;Taip;0;22;0;22
17922;Obelėlė;Bičiuliai;5503843905;Ne;0;2;0;2
17923;Obelėlė;Bičiuliai;3287262204;Ne;0;0;3;3
17924;Obelėlė;Bičiuliai;1222183008;Ne;8;2;3;13
17925;Obelėlė;Bičiuliai;7813350634;Ne;3;0;3;6
17926;Obelėlė;Bičiuliai;6133596410;Ne;3;8;4;15
17927;Obelėlė;Bičiuliai;3568124213;Ne;7;0;3;10
17928;Obelėlė;Bičiuliai;2702773541;Ne;8;0;8;16
17929;Obelėlė;Bičiuliai;5478392319;Ne;0;0;2;2
17930;Obelėlė;Bičiuliai;4223995429;Ne;1;2;2;5
17931;Obelėlė;Bičiuliai;9005520809;Ne;0;0;2;2
17932;Obelėlė;Bičiuliai;8982197866;Ne;0;4;1;5
17933;Obelėlė;Bičiuliai;5073364608;Ne;17;0;0;17
17934;Obelėlė;Bičiuliai;3881456534;Ne;1;2;2;5
17935;Obelėlė;Kodėlčiukai;9960526051;Ne;0;0;3;3
17936;Obelėlė;Kodėlčiukai;1050919659;Ne;6;0;3;9
17937;Obelėlė;Kodėlčiukai;7014872044;Ne;5;0;5;10
17938;Obelėlė;Kodėlčiukai;3028107343;Ne;9;0;3;12
17939;Obelėlė;Kodėlčiukai;4717038536;Ne;3;0;3;6
17940;Obelėlė;Kodėlčiukai;4840134079;Ne;3;0;4;7
17941;Obelėlė;Kodėlčiukai;8762518354;Ne;4;0;5;9
17942;Obelėlė;Kodėlčiukai;3320493372;Ne;1;0;2;3
17943;Obelėlė;Kodėlčiukai;8366162313;Ne;0;2;0;2
17944;Obelėlė;Kodėlčiukai;2227383487;Ne;0;2;3;5
17945;Obelėlė;Kodėlčiukai;8818153952;Ne;0;0;1;1
17946;Obelėlė;Kodėlčiukai;4887103549;Ne;5;0;5;10
17947;Obelėlė;Kodėlčiukai;5221918341;Taip;2;0;2;4
17948;Obelėlė;Kodėlčiukai;5233321854;Ne;4;0;3;7
17949;Obelėlė;Kodėlčiukai;1472630240;Ne;2;0;0;2
17950;Obelėlė;Kodėlčiukai;7422668691;Ne;10;0;3;13
17951;Obelėlė;Kodėlčiukai;6138943813;Ne;6;3;0;9
17952;Obelėlė;Pagrandukai;7934967787;Ne;13;0;2;15
17953;Obelėlė;Pagrandukai;8711370875;Ne;0;0;2;2
17954;Obelėlė;Pagrandukai;6938326798;Ne;2;0;1;3
17955;Obelėlė;Pagrandukai;9258651395;Ne;5;0;2;7
17956;Obelėlė;Pagrandukai;3563701047;Ne;3;0;2;5
17957;Obelėlė;Pagrandukai;8664564820;Taip;5;0;3;8
17958;Obelėlė;Pagrandukai;9170515841;Ne;4;0;1;5
17959;Obelėlė;Pagrandukai;9514739912;Ne;2;0;0;2
17960;Obelėlė;Pagrandukai;7368698046;Ne;6;0;3;9
17961;Obelėlė;Pagrandukai;3738932600;Taip;0;0;4;4
17962;Obelėlė;Pagrandukai;2203568007;Ne;12;0;2;14
17963;Obelėlė;Pagrandukai;1423488655;Ne;0;0;5;5
17964;Obelėlė;Pagrandukai;6045739549;Ne;3;0;2;5
17965;Obelėlė;Pagrandukai;1349713214;Ne;0;22;0;22
17966;Spygliukas;Bitutės;8272537768;Ne;0;0;1;1
17967;Spygliukas;Bitutės;9444569348;Ne;3;0;2;5
17968;Spygliukas;Bitutės;8404929784;Ne;0;2;0;2
17969;Spygliukas;Bitutės;4835818382;Ne;0;2;0;2
17970;Spygliukas;Bitutės;3041184642;Ne;0;2;0;2
17971;Spygliukas;Bitutės;9413950200;Ne;0;2;0;2
17972;Spygliukas;Bitutės;5134327772;Ne;0;2;0;2
17973;Spygliukas;Bitutės;8869320003;Ne;0;2;0;2
17974;Spygliukas;Bitutės;8476882854;Ne;2;4;0;6
17975;Spygliukas;Bitutės;3761715811;Ne;4;7;0;11
17976;Spygliukas;Bitutės;8270525839;Ne;0;1;0;1
17977;Spygliukas;Bitutės;3697691132;Ne;10;2;0;12
17978;Spygliukas;Bitutės;1550737449;Ne;20;2;0;22
17979;Spygliukas;Bitutės;2395961015;Ne;10;0;0;10
17980;Spygliukas;Bitutės;5180736358;Ne;0;0;1;1
17981;Spygliukas;Bitutės;9431217584;Ne;0;5;0;5
17982;Spygliukas;Bitutės;8289288541;Ne;2;1;1;4
17983;Spygliukas;Bitutės;8825264090;Ne;3;1;3;7
17984;Spygliukas;Kiškučiai;8246739374;Ne;3;0;2;5
17985;Spygliukas;Kiškučiai;8426426785;Ne;0;3;0;3
17986;Spygliukas;Kiškučiai;1243647769;Ne;6;2;2;10
17987;Spygliukas;Kiškučiai;6680699873;Ne;22;0;0;22
17988;Spygliukas;Kiškučiai;5043843336;Ne;2;0;0;2
17989;Spygliukas;Kiškučiai;8509447147;Ne;0;2;0;2
17990;Spygliukas;Kiškučiai;2955219028;Ne;20;2;0;22
17991;Spygliukas;Kiškučiai;5739075961;Ne;4;0;2;6
17992;Spygliukas;Kiškučiai;1823720183;Ne;16;2;2;20
17993;Spygliukas;Kiškučiai;1775612723;Ne;12;0;4;16
17994;Spygliukas;Kiškučiai;7324915516;Ne;11;1;2;14
17995;Spygliukas;Kiškučiai;6414439254;Ne;11;1;2;14
17996;Spygliukas;Kiškučiai;8565217488;Ne;8;0;5;13
17997;Spygliukas;Kiškučiai;3065727701;Ne;3;0;5;8
17998;Spygliukas;Kiškučiai;2367685286;Ne;0;22;0;22
17999;Spygliukas;Kiškučiai;7663839690;Ne;1;0;4;5
18000;Spygliukas;Kiškučiai;2738766977;Ne;0;1;0;1
18001;Spygliukas;Kiškučiai;4409209677;Ne;6;1;4;11
18002;Spygliukas;Kiškučiai;9060123423;Ne;7;0;5;12
18003;Spygliukas;Boružėlės;5615854225;Ne;0;4;0;4
18004;Spygliukas;Boružėlės;1927028026;Ne;2;3;1;6
18005;Spygliukas;Boružėlės;7261580644;Ne;0;6;0;6
18006;Spygliukas;Boružėlės;6246925536;Ne;2;1;2;5
18007;Spygliukas;Boružėlės;3094528907;Ne;0;3;0;3
18008;Spygliukas;Boružėlės;8299276429;Ne;1;1;1;3
18009;Spygliukas;Boružėlės;8981549891;Ne;0;18;0;18
18010;Spygliukas;Boružėlės;7243104877;Ne;7;2;0;9
18011;Spygliukas;Boružėlės;9813995933;Taip;0;9;0;9
18012;Spygliukas;Boružėlės;4013601534;Ne;12;1;1;14
18013;Spygliukas;Boružėlės;1436452804;Ne;3;7;3;13
18014;Spygliukas;Boružėlės;6383264068;Ne;0;0;1;1
18015;Spygliukas;Boružėlės;1330384915;Ne;2;0;1;3
18016;Spygliukas;Boružėlės;1037321774;Ne;0;1;0;1
18017;Spygliukas;Boružėlės;9025238241;Ne;4;3;1;8
18018;Spygliukas;Boružėlės;5255993275;Ne;2;0;0;2
18019;Spygliukas;Ežiukai;2164549239;Ne;2;0;3;5
18020;Spygliukas;Ežiukai;4340767624;Ne;0;0;1;1
18021;Spygliukas;Ežiukai;4615217628;Ne;2;9;0;11
18022;Spygliukas;Ežiukai;5612894706;Ne;5;0;2;7
18023;Spygliukas;Ežiukai;6552944183;Ne;3;0;2;5
18024;Spygliukas;Ežiukai;1353217998;Ne;0;0;2;2
18025;Spygliukas;Ežiukai;6459076295;Ne;0;2;0;2
18026;Spygliukas;Ežiukai;7749937772;Ne;16;0;2;18
18027;Spygliukas;Ežiukai;5160835235;Taip;1;2;0;3
18028;Spygliukas;Ežiukai;2719100414;Ne;5;3;3;11
18029;Spygliukas;Ežiukai;1429613380;Ne;4;2;2;8
18030;Spygliukas;Ežiukai;4026252608;Ne;0;4;1;5
18031;Spygliukas;Ežiukai;4098112375;Ne;5;0;2;7
18032;Spygliukas;Ežiukai;9321493897;Ne;0;2;3;5
18033;Spygliukas;Ežiukai;7908419787;Ne;3;0;4;7
18034;Spygliukas;Ežiukai;5366783639;Ne;0;2;0;2
18035;Spygliukas;Ežiukai;3088387895;Ne;3;2;2;7
18036;Spygliukas;Ežiukai;7287543571;Ne;4;0;5;9
18037;Spygliukas;Ežiukai;3297728501;Ne;0;1;0;1
18038;Spygliukas;Ežiukai;3959227706;Ne;4;0;2;6
18039;Spygliukas;Geniukai;8821434815;Ne;6;0;3;9
18040;Spygliukas;Geniukai;2713999021;Ne;2;5;0;7
18041;Spygliukas;Geniukai;5782501698;Ne;2;0;0;2
18042;Spygliukas;Geniukai;6700076900;Ne;12;0;2;14
18043;Spygliukas;Geniukai;8338260940;Ne;0;3;1;4
18044;Spygliukas;Geniukai;9945315122;Ne;0;7;0;7
18045;Spygliukas;Geniukai;1291429206;Ne;0;3;0;3
18046;Spygliukas;Geniukai;7477731865;Ne;2;0;0;2
18047;Spygliukas;Geniukai;7561072315;Ne;2;0;0;2
18048;Spygliukas;Geniukai;2950722789;Ne;8;1;2;11
18049;Spygliukas;Geniukai;8093949301;Ne;7;0;1;8
18050;Spygliukas;Geniukai;9141146733;Ne;2;0;2;4
18051;Spygliukas;Geniukai;6363991196;Ne;7;0;2;9
18052;Spygliukas;Geniukai;8308394841;Ne;0;10;0;10
18053;Spygliukas;Geniukai;1127941700;Ne;0;2;0;2
18054;Spygliukas;Geniukai;9783154498;Ne;2;0;0;2
18055;Spygliukas;Geniukai;8581453160;Ne;0;0;1;1
18056;Spygliukas;Geniukai;7573756485;Ne;2;0;2;4
18057;Spygliukas;Geniukai;9770852356;Ne;4;0;4;8
18058;Spygliukas;Riešutėliai;9070219319;Ne;0;8;0;8
18059;Spygliukas;Riešutėliai;1333556956;Ne;3;3;2;8
18060;Spygliukas;Riešutėliai;7271659513;Ne;0;5;0;5
18061;Spygliukas;Riešutėliai;4634660174;Ne;0;2;0;2
18062;Spygliukas;Riešutėliai;8646122773;Ne;1;3;1;5
18063;Spygliukas;Riešutėliai;7924880159;Ne;0;2;0;2
18064;Spygliukas;Riešutėliai;4368224847;Ne;0;3;1;4
18065;Spygliukas;Riešutėliai;9316731983;Ne;0;1;0;1
18066;Spygliukas;Riešutėliai;5012876830;Ne;0;0;1;1
18067;Spygliukas;Riešutėliai;2315421636;Ne;0;9;0;9
18068;Spygliukas;Riešutėliai;7125425492;Ne;0;2;1;3
18069;Spygliukas;Riešutėliai;5214431060;Ne;1;2;3;6
18070;Spygliukas;Riešutėliai;9052337501;Ne;7;2;2;11
18071;Spygliukas;Riešutėliai;1974541155;Ne;0;2;1;3
18072;Spygliukas;Riešutėliai;4505044604;Ne;13;2;0;15
18073;Spygliukas;Riešutėliai;9086986643;Ne;0;1;0;1
18074;Spygliukas;Pelėdžiukai;3569857813;Ne;0;2;1;3
18075;Spygliukas;Pelėdžiukai;5493599614;Ne;0;2;0;2
18076;Spygliukas;Pelėdžiukai;4577592862;Ne;0;10;0;10
18077;Spygliukas;Pelėdžiukai;6931145017;Ne;1;0;2;3
18078;Spygliukas;Pelėdžiukai;8802722601;Ne;0;2;0;2
18079;Spygliukas;Pelėdžiukai;9285259322;Ne;0;4;0;4
18080;Spygliukas;Pelėdžiukai;6835488489;Ne;0;3;0;3
18081;Spygliukas;Pelėdžiukai;3919560072;Ne;5;1;3;9
18082;Spygliukas;Pelėdžiukai;1341333016;Ne;15;2;2;19
18083;Spygliukas;Pelėdžiukai;5561426508;Ne;0;2;3;5
18084;Spygliukas;Pelėdžiukai;8806126755;Ne;0;1;0;1
18085;Spygliukas;Pelėdžiukai;4477402331;Ne;2;2;4;8
18086;Spygliukas;Pelėdžiukai;2772801133;Ne;4;4;2;10
18087;Spygliukas;Pelėdžiukai;6332646009;Ne;0;2;0;2
18088;Spygliukas;Pelėdžiukai;3706443395;Ne;0;3;0;3
18089;Spygliukas;Pelėdžiukai;3416275094;Ne;0;2;3;5
18090;Spygliukas;Pelėdžiukai;1401951658;Ne;0;10;0;10
18091;Spygliukas;Pelėdžiukai;7900652746;Ne;0;2;0;2
18092;Spygliukas;Pelėdžiukai;6248409896;Ne;0;3;0;3
18093;Spygliukas;Zylutės;2135024989;Ne;0;22;0;22
18094;Spygliukas;Zylutės;7351963782;Ne;9;0;4;13
18095;Spygliukas;Zylutės;9348022137;Ne;6;0;3;9
18096;Spygliukas;Zylutės;3804738695;Ne;10;0;3;13
18097;Spygliukas;Zylutės;3036959597;Ne;4;0;4;8
18098;Spygliukas;Zylutės;5565042215;Ne;6;0;4;10
18099;Spygliukas;Zylutės;4161787684;Ne;1;0;3;4
18100;Spygliukas;Zylutės;8536017163;Ne;5;0;2;7
18101;Spygliukas;Zylutės;6061859914;Ne;0;22;0;22
18102;Spygliukas;Zylutės;4097562838;Ne;8;0;4;12
18103;Spygliukas;Zylutės;6021859437;Ne;5;0;2;7
18104;Spygliukas;Zylutės;5357257525;Ne;14;0;4;18
18105;Spygliukas;Zylutės;9382060963;Ne;3;0;4;7
18106;Spygliukas;Zylutės;8246963847;Ne;12;0;4;16
18107;Spygliukas;Skruzdėliukai;9155444846;Ne;0;6;0;6
18108;Spygliukas;Skruzdėliukai;6828136677;Ne;4;2;1;7
18109;Spygliukas;Skruzdėliukai;7524773805;Ne;0;6;0;6
18110;Spygliukas;Skruzdėliukai;2921299830;Ne;0;11;0;11
18111;Spygliukas;Skruzdėliukai;5513126879;Ne;2;0;0;2
18112;Spygliukas;Skruzdėliukai;3458761442;Ne;0;1;0;1
18113;Spygliukas;Skruzdėliukai;9211070397;Ne;9;0;4;13
18114;Spygliukas;Skruzdėliukai;1210648053;Ne;3;0;2;5
18115;Spygliukas;Skruzdėliukai;4974008654;Ne;8;3;4;15
18116;Spygliukas;Skruzdėliukai;4928125811;Ne;3;0;0;3
18117;Spygliukas;Skruzdėliukai;6749921681;Ne;0;2;0;2
18118;Spygliukas;Voveraitės;9112172144;Ne;4;2;5;11
18119;Spygliukas;Voveraitės;7897603878;Ne;0;3;0;3
18120;Spygliukas;Voveraitės;7741841634;Ne;0;4;0;4
18121;Spygliukas;Voveraitės;3077468722;Ne;1;2;3;6
18122;Spygliukas;Voveraitės;1177439438;Ne;0;3;0;3
18123;Spygliukas;Voveraitės;4948147941;Ne;2;0;4;6
18124;Spygliukas;Voveraitės;2272141731;Ne;0;3;2;5
18125;Spygliukas;Voveraitės;6587957213;Ne;0;2;0;2
18126;Spygliukas;Voveraitės;1426267001;Ne;0;3;0;3
18127;Spygliukas;Voveraitės;8189748611;Ne;6;2;2;10
18128;Spygliukas;Voveraitės;6405496193;Ne;0;2;0;2
18129;Spygliukas;Voveraitės;7113913750;Ne;0;2;2;4
18130;Spygliukas;Voveraitės;9231097598;Ne;2;2;5;9
18131;Spygliukas;Voveraitės;4681061579;Ne;0;2;2;4
18132;Spygliukas;Voveraitės;7313828707;Ne;0;1;0;1
18133;Spygliukas;Voveraitės;1234195733;Ne;0;7;0;7
18134;Spygliukas;Giliukų;1761340174;Ne;6;0;2;8
18135;Spygliukas;Giliukų;4854168938;Ne;0;0;1;1
18136;Spygliukas;Giliukų;7522567241;Ne;0;1;2;3
18137;Spygliukas;Giliukų;7460280684;Ne;0;21;0;21
18138;Spygliukas;Giliukų;4429961491;Ne;0;3;0;3
18139;Spygliukas;Giliukų;8821028259;Ne;0;0;2;2
18140;Spygliukas;Giliukų;6485350404;Ne;11;0;3;14
18141;Spygliukas;Giliukų;3237501537;Ne;1;3;5;9
18142;Spygliukas;Giliukų;8722863277;Ne;2;3;3;8
18143;Spygliukas;Giliukų;3603606800;Ne;0;2;0;2
18144;Spygliukas;Giliukų;7776811391;Ne;2;4;0;6
18145;Spygliukas;Giliukų;3777763305;Ne;4;0;2;6
18146;Spygliukas;Giliukų;4626877679;Ne;0;2;0;2
18147;Spygliukas;Giliukų;4494339318;Taip;2;0;0;2
18148;Spygliukas;Drugeliai;8178732077;Ne;0;22;0;22
18149;Spygliukas;Drugeliai;5164567779;Ne;0;1;0;1
18150;Spygliukas;Drugeliai;9465470810;Ne;5;0;2;7
18151;Spygliukas;Drugeliai;9601530981;Ne;2;0;0;2
18152;Spygliukas;Drugeliai;3317395260;Ne;6;1;2;9
18153;Spygliukas;Drugeliai;6858338620;Ne;7;0;2;9
18154;Spygliukas;Drugeliai;5638595939;Ne;6;2;2;10
18155;Spygliukas;Drugeliai;8408234202;Ne;4;0;2;6
18156;Spygliukas;Drugeliai;1729199382;Ne;1;5;3;9
18157;Spygliukas;Drugeliai;5006372835;Ne;5;0;3;8
18158;Spygliukas;Drugeliai;3268222954;Ne;10;0;4;14
18159;Spygliukas;Drugeliai;3066293772;Ne;0;0;3;3
18160;Spygliukas;Drugeliai;2632672131;Ne;0;1;0;1
18161;Vieversys;Žirniukai;5365334453;Ne;15;0;2;17
18162;Vieversys;Žirniukai;7029322013;Ne;0;3;2;5
18163;Vieversys;Žirniukai;2869545222;Ne;4;0;3;7
18164;Vieversys;Žirniukai;7601876587;Ne;3;0;2;5
18165;Vieversys;Žirniukai;8129566710;Ne;0;2;2;4
18166;Vieversys;Žirniukai;5576923685;Ne;2;1;2;5
18167;Vieversys;Žirniukai;6052943894;Ne;3;0;2;5
18168;Vieversys;Žirniukai;3295424711;Ne;0;0;1;1
18169;Vieversys;Žirniukai;7309040730;Ne;0;0;2;2
18170;Vieversys;Žirniukai;3575906273;Ne;4;0;3;7
18171;Vieversys;Žirniukai;1724543625;Ne;1;0;2;3
18172;Vieversys;Žirniukai;2242368843;Ne;3;0;5;8
18173;Vieversys;Žirniukai;9666764935;Ne;1;0;7;8
18174;Vieversys;Žirniukai;8966020793;Ne;0;6;1;7
18175;Vieversys;Žirniukai;6000875464;Ne;0;2;3;5
18176;Vieversys;Varpelių;5150986489;Ne;3;2;2;7
18177;Vieversys;Varpelių;9463693741;Ne;11;0;4;15
18178;Vieversys;Varpelių;1924774817;Ne;3;0;2;5
18179;Vieversys;Varpelių;3595005599;Ne;3;0;2;5
18180;Vieversys;Varpelių;9155896981;Ne;0;4;2;6
18181;Vieversys;Varpelių;5160814541;Ne;3;2;2;7
18182;Vieversys;Varpelių;9580031042;Ne;0;3;0;3
18183;Vieversys;Varpelių;2635722489;Ne;0;2;1;3
18184;Vieversys;Varpelių;3262738994;Ne;0;3;0;3
18185;Vieversys;Varpelių;8350070741;Ne;3;0;2;5
18186;Vieversys;Varpelių;1727558984;Ne;8;0;1;9
18187;Vieversys;Varpelių;3780226431;Ne;11;0;3;14
18188;Vieversys;Varpelių;3572628491;Ne;5;0;0;5
18189;Vieversys;Varpelių;1128991679;Ne;2;0;2;4
18190;Vieversys;Varpelių;7611047781;Ne;0;2;3;5
18191;Vieversys;Varpelių;8079885165;Ne;5;0;3;8
18192;Vieversys;Varpelių;4510888337;Ne;0;4;0;4
18193;Vieversys;Kiškučių;3405502715;Ne;0;2;0;2
18194;Vieversys;Kiškučių;6127272124;Ne;0;2;0;2
18195;Vieversys;Kiškučių;4892622551;Ne;0;0;1;1
18196;Vieversys;Kiškučių;3360981720;Taip;0;0;2;2
18197;Vieversys;Kiškučių;5654533451;Ne;0;2;0;2
18198;Vieversys;Kiškučių;9985374057;Ne;0;1;2;3
18199;Vieversys;Kiškučių;4741252829;Ne;4;0;2;6
18200;Vieversys;Kiškučių;2140887757;Ne;3;0;2;5
18201;Vieversys;Kiškučių;3164280186;Ne;0;1;3;4
18202;Vieversys;Kiškučių;1748006118;Ne;3;0;2;5
18203;Vieversys;Kiškučių;4690095102;Ne;0;2;0;2
18204;Vieversys;Kiškučių;7048475906;Ne;0;2;0;2
18205;Vieversys;Kiškučių;2663322242;Ne;12;0;0;12
18206;Vieversys;Kiškučių;7596355010;Ne;0;14;0;14
18207;Vieversys;Kiškučių;9322322737;Ne;3;2;4;9
18208;Vieversys;Kiškučių;9164615794;Ne;0;8;0;8
18209;Vieversys;Kiškučių;8174124875;Taip;0;2;0;2
18210;Vieversys;Pelėdžiukų;3681120339;Ne;0;13;0;13
18211;Vieversys;Pelėdžiukų;6882614465;Ne;3;2;2;7
18212;Vieversys;Pelėdžiukų;7007620994;Ne;0;0;1;1
18213;Vieversys;Pelėdžiukų;3946609345;Ne;1;2;4;7
18214;Vieversys;Pelėdžiukų;9686787125;Ne;0;2;0;2
18215;Vieversys;Pelėdžiukų;3684937630;Ne;0;1;0;1
18216;Vieversys;Pelėdžiukų;4455039401;Ne;1;2;4;7
18217;Vieversys;Pelėdžiukų;6563139211;Ne;1;4;3;8
18218;Vieversys;Pelėdžiukų;4294676988;Ne;0;2;3;5
18219;Vieversys;Pelėdžiukų;4835022593;Ne;0;0;5;5
18220;Vieversys;Pelėdžiukų;3249717073;Ne;0;4;1;5
18221;Vieversys;Pelėdžiukų;7120329258;Ne;0;2;0;2
18222;Vieversys;Pelėdžiukų;9494957750;Ne;0;2;2;4
18223;Vieversys;Pelėdžiukų;9835682858;Ne;0;10;0;10
18224;Vieversys;Pelėdžiukų;5907903394;Ne;0;7;0;7
18225;Vieversys;Pelėdžiukų;5769453869;Ne;0;2;3;5
18226;Vieversys;Saulučių;8492908398;Ne;5;0;0;5
18227;Vieversys;Saulučių;8706336322;Ne;8;0;2;10
18228;Vieversys;Saulučių;5966170543;Ne;1;2;2;5
18229;Vieversys;Saulučių;9268459013;Ne;4;2;2;8
18230;Vieversys;Saulučių;2072413459;Ne;0;0;3;3
18231;Vieversys;Saulučių;9476611261;Taip;0;22;0;22
18232;Vieversys;Saulučių;9978867863;Ne;0;18;0;18
18233;Vieversys;Saulučių;5479620291;Ne;8;0;4;12
18234;Vieversys;Saulučių;6083402842;Ne;3;0;2;5
18235;Vieversys;Saulučių;3601928285;Ne;3;0;4;7
18236;Vieversys;Saulučių;6839896363;Ne;0;0;1;1
18237;Vieversys;Saulučių;2661027772;Taip;2;0;0;2
18238;Vieversys;Saulučių;4428101863;Ne;0;8;0;8
18239;Vieversys;Saulučių;5417413393;Ne;7;0;2;9
18240;Vieversys;Saulučių;4335653911;Ne;1;0;3;4
18241;Vieversys;Saulučių;2931875387;Ne;0;1;0;1
18242;Vieversys;Saulučių;9092693925;Taip;0;1;6;7
18243;Vieversys;Kregždučių;3156245273;Ne;0;0;3;3
18244;Vieversys;Kregždučių;5645852451;Taip;0;2;0;2
18245;Vieversys;Kregždučių;7998100115;Ne;0;2;0;2
18246;Vieversys;Kregždučių;9093088054;Ne;0;9;0;9
18247;Vieversys;Kregždučių;2849852593;Ne;0;0;3;3
18248;Vieversys;Kregždučių;6808541662;Ne;0;4;1;5
18249;Vieversys;Kregždučių;2529690060;Ne;0;2;2;4
18250;Vieversys;Kregždučių;2230503026;Ne;0;2;0;2
18251;Vieversys;Kregždučių;7568415178;Ne;0;0;3;3
18252;Vieversys;Kregždučių;6157594693;Ne;4;2;2;8
18253;Vieversys;Kregždučių;1322953831;Ne;0;8;0;8
18254;Vieversys;Kregždučių;9090281352;Ne;0;0;1;1
18255;Vieversys;Kregždučių;4308330177;Ne;0;2;3;5
18256;Vieversys;Kregždučių;4347494053;Ne;0;2;2;4
18257;Vieversys;Kregždučių;3122763958;Ne;1;2;3;6
18258;Vieversys;Kregždučių;2938302462;Ne;0;0;2;2
18259;Vieversys;Kregždučių;9577869269;Ne;0;0;3;3
18260;Vieversys;Boružėlių;8587368497;Ne;1;2;2;5
18261;Vieversys;Boružėlių;9884517851;Ne;0;1;0;1
18262;Vieversys;Boružėlių;4565799599;Ne;0;2;0;2
18263;Vieversys;Boružėlių;7399326463;Ne;13;0;4;17
18264;Vieversys;Boružėlių;4088189914;Ne;0;2;0;2
18265;Vieversys;Boružėlių;7364582681;Ne;0;4;0;4
18266;Vieversys;Boružėlių;8084767846;Ne;0;2;0;2
18267;Vieversys;Boružėlių;9826657384;Ne;0;2;0;2
18268;Vieversys;Boružėlių;3731412573;Ne;0;2;0;2
18269;Vieversys;Boružėlių;7429565381;Ne;6;2;4;12
18270;Vieversys;Boružėlių;4297477514;Ne;5;0;3;8
18271;Vieversys;Boružėlių;8816714193;Ne;0;0;3;3
18272;Vieversys;Boružėlių;2701284187;Ne;7;0;0;7
18273;Vieversys;Boružėlių;6234199996;Ne;13;0;1;14
18274;Vieversys;Boružėlių;4183584366;Ne;2;0;0;2
18275;Vieversys;Boružėlių;4061364544;Ne;0;0;1;1
18276;Vieversys;Boružėlių;8446180685;Ne;16;0;2;18
18277;Vieversys;Boružėlių;1013074080;Ne;7;11;0;18
18278;Vieversys;Boružėlių;6838828193;Ne;0;2;0;2
18279;Vieversys;Bitučių;7427200045;Ne;0;0;1;1
18280;Vieversys;Bitučių;8339300439;Ne;0;13;0;13
18281;Vieversys;Bitučių;6133686703;Ne;2;0;1;3
18282;Vieversys;Bitučių;8916379820;Ne;1;0;3;4
18283;Vieversys;Bitučių;6070871599;Ne;3;1;0;4
18284;Vieversys;Bitučių;8443729534;Ne;2;0;0;2
18285;Vieversys;Bitučių;5598338574;Taip;6;0;2;8
18286;Vieversys;Bitučių;3798183613;Ne;1;0;4;5
18287;Vieversys;Bitučių;3539906884;Ne;0;22;0;22
18288;Vieversys;Bitučių;5226457473;Ne;0;22;0;22
18289;Vieversys;Bitučių;4138476832;Ne;8;2;2;12
18290;Vieversys;Bitučių;1844718177;Ne;0;6;0;6
18291;Vieversys;Smalsučių;9412299328;Ne;3;0;2;5
18292;Vieversys;Smalsučių;8199984460;Ne;0;0;14;14
18293;Vieversys;Smalsučių;7539934804;Ne;2;0;5;7
18294;Vieversys;Smalsučių;1714096583;Ne;8;0;4;12
18295;Vieversys;Smalsučių;8371839883;Ne;0;0;5;5
18296;Vieversys;Smalsučių;6474334564;Ne;0;0;5;5
18297;Vieversys;Smalsučių;4952182897;Ne;0;2;2;4
18298;Vieversys;Smalsučių;2092872414;Ne;0;0;2;2
18299;Vieversys;Smalsučių;5394635510;Ne;0;0;3;3
18300;Vieversys;Smalsučių;1160455554;Ne;0;0;3;3
18301;Vieversys;Smalsučių;8200432952;Ne;15;0;7;22
18302;Vieversys;Smalsučių;2535992834;Ne;2;0;2;4
18303;Vieversys;Smalsučių;4974924858;Ne;0;2;3;5
18304;Vieversys;Smalsučių;7111551694;Ne;0;0;2;2
18305;Vieversys;Smalsučių;2107000312;Ne;0;0;2;2
18306;Vieversys;Smalsučių;4743593002;Ne;0;0;3;3
18307;Vieversys;Smalsučių;6092848276;Ne;0;0;12;12
18308;Vieversys;Smalsučių;6498432810;Ne;0;0;12;12
18309;Vieversys;Kodėlčiukų;5037806018;Ne;5;0;3;8
18310;Vieversys;Kodėlčiukų;1752359969;Taip;0;5;0;5
18311;Vieversys;Kodėlčiukų;6791121542;Ne;0;2;0;2
18312;Vieversys;Kodėlčiukų;5898422871;Ne;2;5;0;7
18313;Vieversys;Kodėlčiukų;6709556873;Ne;0;0;3;3
18314;Vieversys;Kodėlčiukų;4193031329;Ne;0;2;0;2
18315;Vieversys;Kodėlčiukų;7453156612;Ne;0;0;1;1
18316;Vieversys;Kodėlčiukų;6926960486;Ne;0;1;1;2
18317;Vieversys;Kodėlčiukų;3180687885;Ne;8;2;2;12
18318;Vieversys;Kodėlčiukų;1881076551;Ne;0;2;3;5
18319;Vieversys;Kodėlčiukų;1384388802;Ne;3;4;2;9
18320;Vieversys;Kodėlčiukų;2562413607;Ne;0;5;0;5
18321;Vieversys;Kodėlčiukų;9965162863;Ne;1;0;1;2
18322;Vieversys;Kodėlčiukų;4702339508;Taip;2;0;1;3
18323;Vieversys;Kodėlčiukų;4631238425;Ne;0;2;3;5
18324;Vieversys;Kodėlčiukų;8512643926;Ne;3;0;2;5
18325;Vieversys;Kodėlčiukų;7967372524;Ne;2;0;2;4
18326;Vieversys;Kodėlčiukų;4703696958;Ne;0;5;0;5
18327;Vieversys;NYKŠTUKAI;7778432049;Ne;0;0;2;2
18328;Vieversys;NYKŠTUKAI;2143285915;Ne;0;0;2;2
18329;Vieversys;NYKŠTUKAI;7340840045;Ne;1;2;6;9
18330;Vieversys;NYKŠTUKAI;6388747880;Ne;2;0;2;4
18331;Vieversys;NYKŠTUKAI;3557067985;Ne;4;5;5;14
18332;Vieversys;NYKŠTUKAI;8054640386;Ne;0;2;0;2
18333;Vieversys;NYKŠTUKAI;9812354315;Ne;7;0;0;7
18334;Vieversys;NYKŠTUKAI;4482612962;Ne;13;2;4;19
18335;Vieversys;NYKŠTUKAI;6408198729;Ne;4;2;3;9
18336;Vieversys;DRUGELIAI;2638813853;Ne;0;0;8;8
18337;Vieversys;DRUGELIAI;7508850558;Ne;1;0;2;3
18338;Vieversys;DRUGELIAI;1552959751;Ne;6;0;2;8
18339;Vieversys;DRUGELIAI;6669012722;Ne;3;2;2;7
18340;Vieversys;DRUGELIAI;7708807923;Ne;0;2;0;2
18341;Vieversys;DRUGELIAI;4129333932;Ne;2;0;0;2
18342;Vieversys;DRUGELIAI;1720061988;Ne;0;5;0;5
18343;Vieversys;DRUGELIAI;6014448044;Ne;0;3;0;3
18344;Vieversys;DRUGELIAI;6222790462;Ne;0;20;0;20
18345;Vieversys;DRUGELIAI;1752390411;Ne;0;5;0;5
18346;Vieversys;DRUGELIAI;4743557459;Ne;9;13;0;22
18347;Vieversys;DRUGELIAI;9377014366;Ne;15;0;4;19
18348;Vieversys;DRUGELIAI;8595221658;Ne;0;1;0;1
18349;Žirmūnėliai;SAULUTĖS;4922028935;Ne;0;0;1;1
18350;Žirmūnėliai;SAULUTĖS;1948299433;Ne;0;0;1;1
18351;Žirmūnėliai;SAULUTĖS;4763350308;Ne;2;0;3;5
18352;Žirmūnėliai;SAULUTĖS;5626711530;Ne;0;7;0;7
18353;Žirmūnėliai;SAULUTĖS;6072407337;Ne;0;2;0;2
18354;Žirmūnėliai;SAULUTĖS;4338673048;Ne;0;3;0;3
18355;Žirmūnėliai;SAULUTĖS;8242112212;Ne;0;7;0;7
18356;Žirmūnėliai;SAULUTĖS;1940552890;Ne;0;2;0;2
18357;Žirmūnėliai;SAULUTĖS;2392106040;Ne;0;2;0;2
18358;Žirmūnėliai;SAULUTĖS;4343419766;Ne;0;1;0;1
18359;Žirmūnėliai;SAULUTĖS;9145626116;Ne;14;4;4;22
18360;Žirmūnėliai;SAULUTĖS;7675488865;Ne;0;5;0;5
18361;Žirmūnėliai;SAULUTĖS;8345632807;Ne;0;2;0;2
18362;Žirmūnėliai;SAULUTĖS;8592714547;Ne;0;4;0;4
18363;Žirmūnėliai;SAULUTĖS;4134541560;Ne;0;3;0;3
18364;Žirmūnėliai;SAULUTĖS;8481357052;Ne;2;0;0;2
18365;Žirmūnėliai;GILIUKAI;6430944858;Ne;0;0;2;2
18366;Žirmūnėliai;GILIUKAI;3562689670;Ne;0;2;0;2
18367;Žirmūnėliai;GILIUKAI;3767421827;Ne;2;2;4;8
18368;Žirmūnėliai;GILIUKAI;4327504033;Ne;1;0;4;5
18369;Žirmūnėliai;GILIUKAI;5104310002;Ne;1;7;2;10
18370;Žirmūnėliai;GILIUKAI;1025809131;Taip;3;0;2;5
18371;Žirmūnėliai;GILIUKAI;6899109664;Ne;0;4;0;4
18372;Žirmūnėliai;GILIUKAI;5089884149;Ne;0;0;3;3
18373;Žirmūnėliai;GILIUKAI;1791977446;Ne;0;4;2;6
18374;Žirmūnėliai;GILIUKAI;6875484657;Ne;4;0;4;8
18375;Žirmūnėliai;GILIUKAI;9871163622;Ne;0;0;2;2
18376;Žirmūnėliai;GILIUKAI;3532895278;Ne;0;2;0;2
18377;Žirmūnėliai;GILIUKAI;2959090234;Ne;0;0;3;3
18378;Žirmūnėliai;GILIUKAI;5486475468;Ne;0;0;2;2
18379;Žirmūnėliai;GILIUKAI;8618410295;Ne;10;0;4;14
18380;Žirmūnėliai;GILIUKAI;1941509002;Ne;3;0;10;13
18381;Žirmūnėliai;GILIUKAI;3646039695;Ne;0;7;0;7
18382;Žirmūnėliai;GILIUKAI;2866010286;Ne;0;2;0;2
18383;Žirmūnėliai;GILIUKAI;2904787614;Ne;0;2;0;2
18384;Žirmūnėliai;GILIUKAI;4807331877;Ne;3;0;3;6
18385;Žirmūnėliai;DRUGELIAI;2802717644;Ne;1;2;2;5
18386;Žirmūnėliai;DRUGELIAI;3029428022;Ne;1;0;2;3
18387;Žirmūnėliai;DRUGELIAI;5281338626;Ne;1;1;4;6
18388;Žirmūnėliai;DRUGELIAI;9280663182;Ne;0;14;0;14
18389;Žirmūnėliai;DRUGELIAI;6427861912;Ne;1;2;2;5
18390;Žirmūnėliai;DRUGELIAI;2736632324;Ne;0;1;0;1
18391;Žirmūnėliai;DRUGELIAI;2870069039;Ne;6;0;2;8
18392;Žirmūnėliai;DRUGELIAI;8271996884;Ne;0;3;1;4
18393;Žirmūnėliai;DRUGELIAI;4291114238;Ne;0;5;0;5
18394;Žirmūnėliai;DRUGELIAI;3012945005;Ne;2;0;2;4
18395;Žirmūnėliai;DRUGELIAI;8782085662;Ne;0;4;1;5
18396;Žirmūnėliai;DRUGELIAI;4836165731;Ne;2;2;4;8
18397;Žirmūnėliai;DRUGELIAI;9472372819;Ne;0;0;2;2
18398;Žirmūnėliai;DRUGELIAI;3174613910;Ne;2;0;2;4
18399;Žirmūnėliai;DRUGELIAI;6812682361;Ne;3;0;2;5
18400;Žirmūnėliai;DRUGELIAI;5668266601;Ne;2;0;3;5
18401;Žirmūnėliai;DRUGELIAI;5616289290;Ne;0;3;0;3
18402;Žirmūnėliai;DRUGELIAI;9908958250;Taip;0;10;0;10
18403;Žirmūnėliai;DRUGELIAI;9978718231;Ne;7;2;2;11
18404;Žirmūnėliai;BORUŽIUKAI;5209700153;Ne;0;0;1;1
18405;Žirmūnėliai;BORUŽIUKAI;4815427530;Ne;0;0;1;1
18406;Žirmūnėliai;BORUŽIUKAI;5316869112;Ne;2;10;3;15
18407;Žirmūnėliai;BORUŽIUKAI;6641667315;Ne;2;5;2;9
18408;Žirmūnėliai;BORUŽIUKAI;8538773532;Ne;3;5;2;10
18409;Žirmūnėliai;BORUŽIUKAI;1401001989;Ne;3;3;2;8
18410;Žirmūnėliai;BORUŽIUKAI;5154076629;Ne;0;2;0;2
18411;Žirmūnėliai;BORUŽIUKAI;1356219744;Ne;4;3;2;9
18412;Žirmūnėliai;BORUŽIUKAI;2985092368;Ne;4;1;3;8
18413;Žirmūnėliai;BORUŽIUKAI;2841958534;Ne;6;2;2;10
18414;Žirmūnėliai;BORUŽIUKAI;8999160836;Ne;0;4;0;4
18415;Žirmūnėliai;BORUŽIUKAI;5736502380;Ne;0;3;2;5
18416;Žirmūnėliai;BORUŽIUKAI;9241738140;Ne;0;2;0;2
18417;Žirmūnėliai;BORUŽIUKAI;9378860669;Ne;0;2;0;2
18418;Žirmūnėliai;BORUŽIUKAI;8607934394;Ne;0;4;1;5
18419;Žirmūnėliai;BORUŽIUKAI;7422544482;Ne;0;2;0;2
18420;Žirmūnėliai;BORUŽIUKAI;5723289396;Ne;0;2;2;4
18421;Žirmūnėliai;BORUŽIUKAI;4336415033;Ne;0;2;0;2
18422;Žirmūnėliai;BORUŽIUKAI;8917966812;Ne;0;2;1;3
18423;Žirmūnėliai;BORUŽIUKAI;8459217612;Ne;2;0;3;5
18424;Žirmūnėliai;EŽIUKAI;7011701994;Ne;0;1;0;1
18425;Žirmūnėliai;EŽIUKAI;2661052835;Ne;0;6;0;6
18426;Žirmūnėliai;EŽIUKAI;1655437833;Ne;0;2;0;2
18427;Žirmūnėliai;EŽIUKAI;3640979388;Ne;0;4;0;4
18428;Žirmūnėliai;EŽIUKAI;6878528100;Ne;0;2;2;4
18429;Žirmūnėliai;EŽIUKAI;8440187348;Ne;1;2;3;6
18430;Žirmūnėliai;EŽIUKAI;4565479092;Ne;0;1;0;1
18431;Žirmūnėliai;EŽIUKAI;4968278870;Ne;0;2;1;3
18432;Žirmūnėliai;EŽIUKAI;2693415717;Ne;0;1;0;1
18433;Žirmūnėliai;EŽIUKAI;7953019230;Ne;1;4;2;7
18434;Žirmūnėliai;EŽIUKAI;3180116136;Ne;0;4;1;5
18435;Žirmūnėliai;EŽIUKAI;9759491055;Ne;0;3;0;3
18436;Žirmūnėliai;EŽIUKAI;1127214387;Ne;0;2;1;3
18437;Žirmūnėliai;EŽIUKAI;4101748829;Ne;0;7;0;7
18438;Žirmūnėliai;EŽIUKAI;2379638934;Ne;0;12;0;12
18439;Žirmūnėliai;EŽIUKAI;4710829908;Ne;0;4;0;4
18440;Žirmūnėliai;EŽIUKAI;7996709950;Ne;0;2;0;2
18441;Žirmūnėliai;EŽIUKAI;7580002502;Ne;7;2;2;11
18442;Žirmūnėliai;EŽIUKAI;4638575301;Ne;0;2;0;2
18443;Žirmūnėliai;EŽIUKAI;3310847619;Ne;0;2;4;6
18444;Žirmūnėliai;EŽIUKAI;1977798059;Ne;0;2;0;2
18445;Žirmūnėliai;ŽVIRBLIUKAI;6817236579;Ne;0;3;0;3
18446;Žirmūnėliai;ŽVIRBLIUKAI;7410921362;Ne;0;4;0;4
18447;Žirmūnėliai;ŽVIRBLIUKAI;4218266688;Ne;0;2;0;2
18448;Žirmūnėliai;ŽVIRBLIUKAI;7020486370;Ne;0;2;0;2
18449;Žirmūnėliai;ŽVIRBLIUKAI;3449815783;Ne;0;2;0;2
18450;Žirmūnėliai;ŽVIRBLIUKAI;7892626521;Ne;0;11;0;11
18451;Žirmūnėliai;ŽVIRBLIUKAI;4778339658;Ne;0;12;0;12
18452;Žirmūnėliai;ŽVIRBLIUKAI;9541122034;Ne;0;2;0;2
18453;Žirmūnėliai;ŽVIRBLIUKAI;8209309240;Ne;0;13;0;13
18454;Žirmūnėliai;ŽVIRBLIUKAI;2837129621;Ne;0;2;0;2
18455;Žirmūnėliai;ŽVIRBLIUKAI;1273684243;Ne;0;2;3;5
18456;Žirmūnėliai;ŽVIRBLIUKAI;2971175236;Ne;1;3;2;6
18457;Žirmūnėliai;ŽVIRBLIUKAI;6594728970;Ne;1;4;2;7
18458;Žirmūnėliai;ŽVIRBLIUKAI;3795476732;Ne;6;4;2;12
18459;Žirmūnėliai;ŽVIRBLIUKAI;9732291476;Ne;0;0;3;3
18460;Žirmūnėliai;ŽVIRBLIUKAI;7087770068;Ne;0;5;0;5
18461;Žirmūnėliai;ŽVIRBLIUKAI;3431320961;Ne;0;4;0;4
18462;Žirmūnėliai;ŽVIRBLIUKAI;1571242696;Ne;0;7;0;7
18463;Žirmūnėliai;SPALVELĖS;9936156579;Ne;0;2;0;2
18464;Žirmūnėliai;SPALVELĖS;6259368139;Ne;4;4;5;13
18465;Žirmūnėliai;SPALVELĖS;6934204209;Ne;3;2;2;7
18466;Žirmūnėliai;SPALVELĖS;9306935083;Ne;0;11;0;11
18467;Žirmūnėliai;SPALVELĖS;9042509512;Ne;6;5;2;13
18468;Žirmūnėliai;SPALVELĖS;5076712824;Ne;0;4;0;4
18469;Žirmūnėliai;SPALVELĖS;8444883234;Ne;0;4;3;7
18470;Žirmūnėliai;SPALVELĖS;3977279181;Ne;0;1;0;1
18471;Žirmūnėliai;SPALVELĖS;8002655555;Ne;0;14;0;14
18472;Žirmūnėliai;SPALVELĖS;1116572386;Ne;8;2;2;12
18473;Žirmūnėliai;SPALVELĖS;1255294064;Ne;2;2;0;4
18474;Žirmūnėliai;SPALVELĖS;3520677404;Ne;3;4;3;10
18475;Žirmūnėliai;SPALVELĖS;5646794795;Ne;5;0;2;7
18476;Žirmūnėliai;SPALVELĖS;7589155099;Ne;3;2;2;7
18477;Žirmūnėliai;SPALVELĖS;5901940160;Ne;3;0;3;6
18478;Žirmūnėliai;SPALVELĖS;4641264260;Ne;1;1;2;4
18479;Žirmūnėliai;SPALVELĖS;9858198555;Ne;0;5;0;5
18480;Žirmūnėliai;SPALVELĖS;6523502376;Ne;1;0;2;3
18481;Žirmūnėliai;DEBESĖLIAI;6908512961;Ne;0;14;0;14
18482;Žirmūnėliai;DEBESĖLIAI;3330603362;Ne;5;2;4;11
18483;Žirmūnėliai;DEBESĖLIAI;5440814849;Ne;8;2;2;12
18484;Žirmūnėliai;DEBESĖLIAI;8136265008;Ne;0;19;0;19
18485;Žirmūnėliai;DEBESĖLIAI;7568228423;Ne;0;0;4;4
18486;Žirmūnėliai;DEBESĖLIAI;9813507899;Ne;0;3;0;3
18487;Žirmūnėliai;DEBESĖLIAI;8687642039;Ne;0;0;2;2
18488;Žirmūnėliai;DEBESĖLIAI;5982848146;Ne;0;2;0;2
18489;Žirmūnėliai;DEBESĖLIAI;4653124134;Ne;3;0;2;5
18490;Žirmūnėliai;DEBESĖLIAI;4501490189;Ne;0;2;3;5
18491;Žirmūnėliai;DEBESĖLIAI;8239982682;Taip;0;0;1;1
18492;Žirmūnėliai;DEBESĖLIAI;6066212109;Ne;0;2;0;2
18493;Žirmūnėliai;DEBESĖLIAI;9759504463;Ne;0;2;0;2
18494;Žirmūnėliai;DEBESĖLIAI;3641319043;Ne;0;2;0;2
18495;Žirmūnėliai;DEBESĖLIAI;5622319185;Ne;8;2;2;12
18496;Žirmūnėliai;DEBESĖLIAI;7053321410;Ne;9;0;3;12
18497;Žirmūnėliai;DEBESĖLIAI;4512970900;Ne;0;6;0;6
18498;Žirmūnėliai;DEBESĖLIAI;8615363279;Ne;0;2;0;2
18499;Žirmūnėliai;VIŠČIUKAI;9688789802;Ne;8;0;2;10
18500;Žirmūnėliai;VIŠČIUKAI;2898177059;Ne;0;1;0;1
18501;Žirmūnėliai;VIŠČIUKAI;1512873821;Ne;10;1;2;13
18502;Žirmūnėliai;VIŠČIUKAI;5659912057;Ne;0;2;3;5
18503;Žirmūnėliai;VIŠČIUKAI;4019091254;Ne;2;0;4;6
18504;Žirmūnėliai;VIŠČIUKAI;7517228946;Ne;0;0;1;1
18505;Žirmūnėliai;VIŠČIUKAI;1522323117;Ne;0;2;0;2
18506;Žirmūnėliai;VIŠČIUKAI;3144841534;Ne;4;0;3;7
18507;Žirmūnėliai;VIŠČIUKAI;6640314231;Ne;10;0;4;14
18508;Žirmūnėliai;VIŠČIUKAI;7421097025;Ne;3;0;4;7
18509;Žirmūnėliai;VIŠČIUKAI;4464218112;Ne;2;0;3;5
18510;Žirmūnėliai;VIŠČIUKAI;7287108760;Ne;0;0;7;7
18511;Žirmūnėliai;VIŠČIUKAI;2353478333;Ne;2;0;4;6
18512;Žirmūnėliai;VIŠČIUKAI;4260032711;Ne;9;0;2;11
18513;Žirmūnėliai;VIŠČIUKAI;2821518346;Taip;0;2;0;2
18514;Žirmūnėliai;ZUIKUČIŲ;2074215403;Ne;20;0;2;22
18515;Žirmūnėliai;ZUIKUČIŲ;5981759291;Ne;2;3;2;7
18516;Žirmūnėliai;ZUIKUČIŲ;6122934687;Ne;3;0;2;5
18517;Žirmūnėliai;ZUIKUČIŲ;3560820710;Taip;2;0;4;6
18518;Žirmūnėliai;ZUIKUČIŲ;1582955541;Ne;3;3;2;8
18519;Žirmūnėliai;ZUIKUČIŲ;5772120262;Ne;0;0;16;16
18520;Žirmūnėliai;ZUIKUČIŲ;9448915252;Ne;18;0;2;20
18521;Žirmūnėliai;ZUIKUČIŲ;8526701525;Ne;3;0;2;5
18522;Žirmūnėliai;ZUIKUČIŲ;9953641492;Ne;7;2;5;14
18523;Žirmūnėliai;ZUIKUČIŲ;1498162175;Ne;13;0;2;15
18524;Žirmūnėliai;ZUIKUČIŲ;7232606752;Ne;10;0;5;15
18525;Žirmūnėliai;ZUIKUČIŲ;2857408011;Taip;0;10;0;10
18526;Žirmūnėliai;ZUIKUČIŲ;7771277342;Ne;4;0;3;7
18527;Žirmūnėliai;ZUIKUČIŲ;3825102173;Ne;11;0;4;15
18528;Žirmūnėliai;ZUIKUČIŲ;2069337771;Ne;14;0;2;16
18529;Žirmūnėliai;OBUOLIUKAI;4575123456;Ne;0;4;0;4
18530;Žirmūnėliai;OBUOLIUKAI;9002868728;Ne;0;1;3;4
18531;Žirmūnėliai;OBUOLIUKAI;2073922023;Taip;0;1;0;1
18532;Žirmūnėliai;OBUOLIUKAI;7059249540;Ne;2;1;2;5
18533;Žirmūnėliai;OBUOLIUKAI;4999561481;Ne;2;0;2;4
18534;Žirmūnėliai;OBUOLIUKAI;6358006462;Ne;7;1;4;12
18535;Žirmūnėliai;OBUOLIUKAI;2497258407;Ne;0;6;0;6
18536;Žirmūnėliai;OBUOLIUKAI;3949374730;Ne;0;1;0;1
18537;Žirmūnėliai;OBUOLIUKAI;6869102228;Ne;0;5;0;5
18538;Žirmūnėliai;OBUOLIUKAI;9367849317;Ne;0;2;0;2
18539;Žirmūnėliai;OBUOLIUKAI;9892620134;Ne;0;0;1;1
18540;Žirmūnėliai;OBUOLIUKAI;6450412481;Ne;4;2;2;8
18541;Žirmūnėliai;OBUOLIUKAI;9225654910;Ne;0;7;0;7
18542;Žirmūnėliai;OBUOLIUKAI;5483418311;Ne;3;3;3;9
18543;Žirmūnėliai;OBUOLIUKAI;7945713337;Ne;0;3;0;3
18544;Žirmūnėliai;OBUOLIUKAI;8823426998;Ne;0;4;1;5
18545;Žirmūnėliai;OBUOLIUKAI;2263820829;Ne;15;1;4;20
18546;Žirmūnėliai;OBUOLIUKAI;9682309860;Ne;3;2;4;9
18547;Žirmūnėliai;OBUOLIUKAI;9924145022;Ne;0;4;1;5
18548;Žirmūnėliai;DAINORĖLIAI;6397359786;Ne;9;0;4;13
18549;Žirmūnėliai;DAINORĖLIAI;3493835685;Ne;0;10;0;10
18550;Žirmūnėliai;DAINORĖLIAI;7113999217;Ne;12;0;7;19
18551;Žirmūnėliai;DAINORĖLIAI;9483005892;Ne;13;0;2;15
18552;Žirmūnėliai;DAINORĖLIAI;6736693899;Ne;8;0;2;10
18553;Žirmūnėliai;DAINORĖLIAI;1162986139;Ne;6;0;2;8
18554;Žirmūnėliai;DAINORĖLIAI;9220007612;Ne;4;0;6;10
18555;Žirmūnėliai;DAINORĖLIAI;2991492176;Ne;0;0;7;7
18556;Žirmūnėliai;DAINORĖLIAI;3319602277;Ne;6;0;3;9
18557;Žirmūnėliai;DAINORĖLIAI;5750554959;Ne;9;0;2;11
18558;Žirmūnėliai;DAINORĖLIAI;8512701905;Ne;8;1;4;13
18559;Žirmūnėliai;DAINORĖLIAI;6026141001;Ne;8;2;2;12
18560;"Dainorėliai (Ankštoji g. 11)";VARPELIAI;3094277796;Ne;10;0;5;15
18561;"Dainorėliai (Ankštoji g. 11)";VARPELIAI;2340411409;Ne;0;0;1;1
18562;"Dainorėliai (Ankštoji g. 11)";VARPELIAI;3205801143;Ne;10;0;2;12
18563;"Dainorėliai (Ankštoji g. 11)";VARPELIAI;6708318702;Ne;2;0;4;6
18564;"Dainorėliai (Ankštoji g. 11)";VARPELIAI;3463422617;Ne;0;0;2;2
18565;"Dainorėliai (Ankštoji g. 11)";VARPELIAI;5326096582;Ne;1;5;4;10
18566;"Dainorėliai (Ankštoji g. 11)";VARPELIAI;4812986408;Ne;1;4;4;9
18567;"Dainorėliai (Ankštoji g. 11)";VARPELIAI;1822342787;Ne;15;1;2;18
18568;"Dainorėliai (Ankštoji g. 11)";VARPELIAI;6652070415;Ne;0;0;2;2
18569;"Dainorėliai (Ankštoji g. 11)";VARPELIAI;5098256007;Ne;6;1;2;9
18570;"Dainorėliai (Ankštoji g. 11)";VARPELIAI;5900613350;Ne;2;0;3;5
18571;"Dainorėliai (Ankštoji g. 11)";VARPELIAI;7476236758;Ne;0;1;2;3
18572;"Dainorėliai (Ankštoji g. 11)";VARPELIAI;4312828453;Ne;5;0;3;8
18573;"Dainorėliai (Ankštoji g. 11)";VARPELIAI;2732648440;Ne;6;0;9;15
18574;"Dainorėliai (Ankštoji g. 11)";VARPELIAI;1505858775;Ne;5;0;4;9
18575;"Dainorėliai (Ankštoji g. 11)";VARPELIAI;9612167901;Ne;1;13;4;18
18576;"Dainorėliai (Ankštoji g. 11)";VARPELIAI;6192380237;Ne;5;0;5;10
18577;"Dainorėliai (Ankštoji g. 11)";VARPELIAI;9372212913;Ne;2;0;2;4
18578;"Dainorėliai (Ankštoji g. 11)";ŽIOGELIAI;5591598390;Ne;0;2;0;2
18579;"Dainorėliai (Ankštoji g. 11)";ŽIOGELIAI;8140354445;Ne;0;10;1;11
18580;"Dainorėliai (Ankštoji g. 11)";ŽIOGELIAI;2450726148;Ne;0;6;0;6
18581;"Dainorėliai (Ankštoji g. 11)";ŽIOGELIAI;5793828922;Ne;0;4;0;4
18582;"Dainorėliai (Ankštoji g. 11)";ŽIOGELIAI;7591953671;Ne;5;4;5;14
18583;"Dainorėliai (Ankštoji g. 11)";ŽIOGELIAI;6169434322;Ne;0;3;0;3
18584;"Dainorėliai (Ankštoji g. 11)";ŽIOGELIAI;2094849111;Ne;3;7;2;12
18585;"Dainorėliai (Ankštoji g. 11)";ŽIOGELIAI;3887433142;Ne;0;4;2;6
18586;"Dainorėliai (Ankštoji g. 11)";ŽIOGELIAI;2541781620;Ne;7;7;2;16
18587;"Dainorėliai (Ankštoji g. 11)";ŽIOGELIAI;8239000041;Ne;0;2;0;2
18588;"Dainorėliai (Ankštoji g. 11)";ŽIOGELIAI;7984447187;Ne;0;14;0;14
18589;"Dainorėliai (Ankštoji g. 11)";ŽIOGELIAI;5715129088;Ne;3;0;2;5
18590;"Dainorėliai (Ankštoji g. 11)";ŽIOGELIAI;9132532505;Ne;0;2;0;2
18591;"Dainorėliai (Ankštoji g. 11)";ŽIOGELIAI;3592770633;Ne;0;0;1;1
18592;"Dainorėliai (Ankštoji g. 11)";ŽIOGELIAI;3598951899;Ne;4;4;2;10
18593;"Dainorėliai (Ankštoji g. 11)";ŽIOGELIAI;4973241539;Ne;8;0;16;24
18594;"Dainorėliai (Ankštoji g. 11)";ŽIOGELIAI;8280877177;Ne;2;4;3;9
18595;"Dainorėliai (Ankštoji g. 11)";ŽIOGELIAI;2215481883;Ne;0;3;0;3
18596;"Dainorėliai (Ankštoji g. 11)";DRUGELIAI;6403389248;Ne;0;4;0;4
18597;"Dainorėliai (Ankštoji g. 11)";DRUGELIAI;2703267758;Ne;0;2;0;2
18598;"Dainorėliai (Ankštoji g. 11)";DRUGELIAI;6899629612;Ne;0;1;0;1
18599;"Dainorėliai (Ankštoji g. 11)";DRUGELIAI;2605119306;Ne;6;3;2;11
18600;"Dainorėliai (Ankštoji g. 11)";DRUGELIAI;9976869100;Ne;0;2;0;2
18601;"Dainorėliai (Ankštoji g. 11)";DRUGELIAI;3063825996;Ne;0;10;0;10
18602;"Dainorėliai (Ankštoji g. 11)";DRUGELIAI;5854379630;Ne;0;16;2;18
18603;"Dainorėliai (Ankštoji g. 11)";DRUGELIAI;3711954197;Ne;0;4;0;4
18604;"Dainorėliai (Ankštoji g. 11)";DRUGELIAI;3573324654;Ne;0;2;0;2
18605;"Dainorėliai (Ankštoji g. 11)";DRUGELIAI;8088948564;Ne;5;3;2;10
18606;"Dainorėliai (Ankštoji g. 11)";DRUGELIAI;2803571247;Ne;2;3;2;7
18607;"Dainorėliai (Ankštoji g. 11)";DRUGELIAI;5084474142;Ne;4;2;2;8
18608;"Dainorėliai (Ankštoji g. 11)";DRUGELIAI;1332165159;Ne;23;0;5;28
18609;"Dainorėliai (Ankštoji g. 11)";DRUGELIAI;8684975630;Ne;5;2;2;9
18610;"Dainorėliai (Ankštoji g. 11)";DRUGELIAI;2740773904;Ne;3;3;2;8
18611;"Dainorėliai (Ankštoji g. 11)";DRUGELIAI;9303046800;Ne;0;0;4;4
18612;"Dainorėliai (Ankštoji g. 11)";DRUGELIAI;9592384914;Ne;2;1;1;4
18613;"Dainorėliai (Ankštoji g. 11)";DRUGELIAI;3741337791;Ne;0;2;0;2
18614;"Dainorėliai (Ankštoji g. 11)";DRUGELIAI;7478484190;Ne;0;5;0;5
18615;"Dainorėliai (Ankštoji g. 11)";DRUGELIAI;7030974201;Ne;1;0;6;7
18616;"Dainorėliai (Ankštoji g. 11)";"1 klasė";88781762328;Ne;0;2;0;2
18617;"Dainorėliai (Ankštoji g. 11)";"1 klasė";5959380807;Ne;0;2;0;2
18618;"Dainorėliai (Ankštoji g. 11)";"1 klasė";7822546498;Ne;0;2;0;2
18619;"Dainorėliai (Ankštoji g. 11)";"1 klasė";4591161640;Ne;0;2;0;2
18620;"Dainorėliai (Ankštoji g. 11)";"1 klasė";9319771186;Ne;2;2;0;4
18621;"Dainorėliai (Ankštoji g. 11)";"1 klasė";6909583023;Ne;0;2;0;2
18622;"Dainorėliai (Ankštoji g. 11)";"1 klasė";9996171088;Ne;3;2;0;5
18623;"Dainorėliai (Ankštoji g. 11)";"1 klasė";6493730577;Ne;0;2;0;2
18624;"Dainorėliai (Ankštoji g. 11)";"1 klasė";7320625500;Ne;0;2;0;2
18625;"Dainorėliai (Ankštoji g. 11)";"1 klasė";7664689396;Ne;0;2;0;2
18626;"Dainorėliai (Ankštoji g. 11)";"1 klasė";2917508421;Ne;4;2;0;6
18627;"Dainorėliai (Ankštoji g. 11)";"1 klasė";2812688181;Ne;0;2;0;2
18628;"Dainorėliai (Ankštoji g. 11)";"1 klasė";18233813290;Ne;0;6;0;6
18629;"Dainorėliai (Ankštoji g. 11)";"1 klasė";2095914442;Ne;1;2;0;3
18630;"Dainorėliai (Ankštoji g. 11)";"1 klasė";4255893222;Ne;0;2;0;2
18631;"Dainorėliai (Ankštoji g. 11)";"1 klasė";1666616466;Ne;1;2;0;3
18632;"Dainorėliai (Ankštoji g. 11)";"1 klasė";1307749129;Ne;0;2;0;2
18633;"Dainorėliai (Ankštoji g. 11)";"1 klasė";1088248393;Ne;0;2;0;2
18634;"Dainorėliai (Ankštoji g. 11)";"1 klasė";2031800114;Ne;5;2;0;7
18635;"Dainorėliai (Ankštoji g. 11)";"1 klasė";43097490633;Ne;3;2;0;5
18636;"Dainorėliai (Ankštoji g. 11)";"1 klasė";65467351140;Ne;1;2;0;3
18637;"Dainorėliai (Ankštoji g. 11)";"1 klasė";87242570532;Ne;0;2;0;2
18638;"Dainorėliai (Ankštoji g. 11)";"1 klasė";5693385617;Ne;0;2;0;2
18639;"Dainorėliai (Ankštoji g. 11)";"1 klasė";9608529135;Ne;0;2;0;2
18640;"Dainorėliai (Ankštoji g. 11)";"1 klasė";68134437706;Ne;0;2;0;2
18641;"Dainorėliai (Ankštoji g. 11)";"1 klasė";3034686938;Ne;0;2;0;2
18642;"Dainorėliai (Ankštoji g. 11)";"2 klasė";2520667095;Ne;0;2;1;3
18643;"Dainorėliai (Ankštoji g. 11)";"2 klasė";1333499160;Ne;0;2;1;3
18644;"Dainorėliai (Ankštoji g. 11)";"2 klasė";50432354832;Ne;0;2;3;5
18645;"Dainorėliai (Ankštoji g. 11)";"2 klasė";1626877066;Ne;0;2;1;3
18646;"Dainorėliai (Ankštoji g. 11)";"2 klasė";1158895670;Ne;0;2;0;2
18647;"Dainorėliai (Ankštoji g. 11)";"2 klasė";73649870571;Ne;0;2;1;3
18648;"Dainorėliai (Ankštoji g. 11)";"2 klasė";1531362555;Ne;0;2;3;5
18649;"Dainorėliai (Ankštoji g. 11)";"2 klasė";19286303769;Ne;0;2;0;2
18650;"Dainorėliai (Ankštoji g. 11)";"2 klasė";73386013083;Ne;0;2;1;3
18651;"Dainorėliai (Ankštoji g. 11)";"2 klasė";27521381629;Ne;0;2;0;2
18652;"Dainorėliai (Ankštoji g. 11)";"2 klasė";53935690864;Ne;0;2;0;2
18653;"Dainorėliai (Ankštoji g. 11)";"2 klasė";2287353933;Ne;0;2;4;6
18654;"Dainorėliai (Ankštoji g. 11)";"2 klasė";1120848949;Ne;0;2;2;4
18655;"Dainorėliai (Ankštoji g. 11)";"2 klasė";36313982965;Ne;0;2;0;2
18656;"Dainorėliai (Ankštoji g. 11)";"2 klasė";86659723162;Ne;0;2;0;2
18657;"Dainorėliai (Ankštoji g. 11)";"2 klasė";6195426672;Ne;0;2;5;7
18658;"Dainorėliai (Ankštoji g. 11)";"2 klasė";5479496104;Ne;0;2;7;9
18659;"Dainorėliai (Ankštoji g. 11)";"2 klasė";94480397292;Ne;0;2;0;2
18660;"Dainorėliai (Ankštoji g. 11)";"2 klasė";6404337541;Ne;0;2;0;2
18661;"Dainorėliai (Ankštoji g. 11)";"2 klasė";49483881135;Ne;0;2;6;8
18662;"Dainorėliai (Ankštoji g. 11)";"2 klasė";86187568203;Ne;0;2;0;2
18663;"Dainorėliai (Ankštoji g. 11)";"2 klasė";1015870220;Ne;0;2;0;2
18664;"Dainorėliai (Ankštoji g. 11)";"2 klasė";1515552402;Ne;0;2;9;11
18665;"Dainorėliai (Ankštoji g. 11)";"2 klasė";7114409929;Ne;0;2;8;10
18666;"Dainorėliai (Ankštoji g. 11)";"2 klasė";1084400276;Ne;0;2;2;4
18667;"Dainorėliai (Ankštoji g. 11)";"2 klasė";1910653135;Ne;0;2;1;3
18668;"Dainorėliai (Ankštoji g. 11)";"3 klasė";67124516230;Ne;4;2;0;6
18669;"Dainorėliai (Ankštoji g. 11)";"3 klasė";7506194777;Ne;0;2;0;2
18670;"Dainorėliai (Ankštoji g. 11)";"3 klasė";1829858221;Ne;0;2;0;2
18671;"Dainorėliai (Ankštoji g. 11)";"3 klasė";1470784692;Ne;0;2;0;2
18672;"Dainorėliai (Ankštoji g. 11)";"3 klasė";7569146994;Ne;0;2;0;2
18673;"Dainorėliai (Ankštoji g. 11)";"3 klasė";45577031767;Ne;0;2;0;2
18674;"Dainorėliai (Ankštoji g. 11)";"3 klasė";1646521870;Ne;5;2;0;7
18675;"Dainorėliai (Ankštoji g. 11)";"3 klasė";29132059636;Ne;0;2;0;2
18676;"Dainorėliai (Ankštoji g. 11)";"3 klasė";32573583030;Ne;0;2;0;2
18677;"Dainorėliai (Ankštoji g. 11)";"3 klasė";97947842490;Ne;0;2;0;2
18678;"Dainorėliai (Ankštoji g. 11)";"3 klasė";63211091321;Ne;0;2;0;2
18679;"Dainorėliai (Ankštoji g. 11)";"3 klasė";87717571411;Ne;0;2;0;2
18680;"Dainorėliai (Ankštoji g. 11)";"3 klasė";18936645521;Ne;0;2;0;2
18681;"Dainorėliai (Ankštoji g. 11)";"3 klasė";80499999855;Ne;0;2;0;2
18682;"Dainorėliai (Ankštoji g. 11)";"3 klasė";6948863728;Ne;2;2;0;4
18683;"Dainorėliai (Ankštoji g. 11)";"3 klasė";2531690903;Ne;7;2;0;9
18684;"Dainorėliai (Ankštoji g. 11)";"3 klasė";35134511946;Ne;0;2;0;2
18685;"Dainorėliai (Ankštoji g. 11)";"3 klasė";1121139222;Ne;0;2;0;2
18686;"Dainorėliai (Ankštoji g. 11)";"3 klasė";99597416067;Ne;0;2;0;2
18687;"Dainorėliai (Ankštoji g. 11)";"3 klasė";77718940253;Ne;0;2;0;2
18688;"Dainorėliai (Ankštoji g. 11)";"3 klasė";5236797727;Ne;0;2;0;2
18689;"Dainorėliai (Ankštoji g. 11)";"3 klasė";33847164571;Ne;3;2;0;5
18690;"Dainorėliai (Ankštoji g. 11)";"4 klasė";34219208558;Ne;2;0;0;2
18691;"Dainorėliai (Ankštoji g. 11)";"4 klasė";2045625141;Ne;4;0;0;4
18692;"Dainorėliai (Ankštoji g. 11)";"4 klasė";2441164154;Ne;1;0;0;1
18693;"Dainorėliai (Ankštoji g. 11)";"4 klasė";2142553899;Ne;4;0;0;4
18694;"Dainorėliai (Ankštoji g. 11)";"4 klasė";98830139164;Ne;3;0;0;3
18695;"Dainorėliai (Ankštoji g. 11)";"4 klasė";79461209783;Ne;1;0;0;1
18696;"Dainorėliai (Ankštoji g. 11)";"4 klasė";47323045857;Ne;2;0;0;2
18697;"Dainorėliai (Ankštoji g. 11)";"4 klasė";25073134850;Ne;5;0;0;5
18698;"Dainorėliai (Ankštoji g. 11)";"4 klasė";84999972369;Ne;4;0;0;4
18699;"Dainorėliai (Ankštoji g. 11)";"4 klasė";69732047046;Ne;2;0;0;2
18700;"Dainorėliai (Ankštoji g. 11)";SAULUTĖS;8857018998;Ne;0;8;0;8
18701;"Dainorėliai (Ankštoji g. 11)";SAULUTĖS;4612995336;Ne;0;2;0;2
18702;"Dainorėliai (Ankštoji g. 11)";SAULUTĖS;6704354150;Ne;0;2;4;6
18703;"Dainorėliai (Ankštoji g. 11)";SAULUTĖS;5632663846;Ne;5;2;0;7
18704;"Dainorėliai (Ankštoji g. 11)";SAULUTĖS;6385439136;Ne;0;4;0;4
18705;"Dainorėliai (Ankštoji g. 11)";SAULUTĖS;1552829080;Ne;0;4;0;4
18706;"Dainorėliai (Ankštoji g. 11)";SAULUTĖS;5410183494;Ne;0;2;3;5
18707;"Dainorėliai (Ankštoji g. 11)";SAULUTĖS;5587907483;Ne;0;4;6;10
18708;"Dainorėliai (Ankštoji g. 11)";SAULUTĖS;2064843848;Ne;4;2;0;6
18709;"Dainorėliai (Ankštoji g. 11)";SAULUTĖS;5687390372;Ne;0;3;0;3
18710;"Dainorėliai (Ankštoji g. 11)";SAULUTĖS;7804441689;Ne;4;2;0;6
18711;"Dainorėliai (Ankštoji g. 11)";SAULUTĖS;6090746954;Ne;0;3;0;3
18712;"Dainorėliai (Ankštoji g. 11)";SAULUTĖS;4431804759;Ne;0;2;0;2
18713;"Dainorėliai (Ankštoji g. 11)";SAULUTĖS;6697149560;Ne;0;2;1;3
18714;"Dainorėliai (Ankštoji g. 11)";SAULUTĖS;3762178533;Ne;5;1;0;6
18715;"Dainorėliai (Ankštoji g. 11)";SAULUTĖS;4798415786;Ne;0;5;0;5
18716;"Dainorėliai (Ankštoji g. 11)";SAULUTĖS;4079711515;Ne;0;2;0;2
18717;"Dainorėliai (Ankštoji g. 11)";SAULUTĖS;4798415786;Ne;0;5;0;5
18718;"Dainorėliai (Ankštoji g. 11)";SAULUTĖS;4798415786;Ne;0;5;0;5
18719;"Dainorėliai (Ankštoji g. 11)";SAULUTĖS;4969782237;Ne;0;3;0;3
18720;Lokiukas;BITUTĖS;3397999534;Ne;0;2;2;4
18721;Lokiukas;BITUTĖS;2126391728;Ne;1;0;2;3
18722;Lokiukas;BITUTĖS;4551069961;Ne;8;2;4;14
18723;Lokiukas;BITUTĖS;8059759103;Ne;0;2;2;4
18724;Lokiukas;BITUTĖS;5217458476;Ne;0;9;0;9
18725;Lokiukas;BITUTĖS;6260486656;Ne;8;5;2;15
18726;Lokiukas;BITUTĖS;9480025132;Ne;3;2;2;7
18727;Lokiukas;BITUTĖS;8334800302;Ne;0;2;4;6
18728;Lokiukas;BITUTĖS;1987485885;Ne;0;5;0;5
18729;Lokiukas;BITUTĖS;5794303981;Ne;3;2;7;12
18730;Lokiukas;BITUTĖS;2671053309;Taip;0;7;0;7
18731;Lokiukas;BITUTĖS;1647778939;Ne;0;0;1;1
18732;Lokiukas;BITUTĖS;8994257898;Ne;2;2;3;7
18733;Lokiukas;BITUTĖS;8378138411;Ne;0;2;1;3
18734;Lokiukas;BITUTĖS;8656751314;Ne;0;12;0;12
18735;Lokiukas;BITUTĖS;2181315008;Ne;0;1;0;1
18736;Lokiukas;BITUTĖS;3896883842;Ne;5;3;2;10
18737;Lokiukas;BITUTĖS;7920238202;Ne;0;2;1;3
18738;Lokiukas;BITUTĖS;3329205450;Ne;6;7;2;15
18739;Lokiukas;BITUTĖS;6612382588;Ne;3;2;2;7
18740;Lokiukas;"1 B klasė";1210407640;Ne;7;2;0;9
18741;Lokiukas;"1 B klasė";1733486244;Ne;9;2;0;11
18742;Lokiukas;"1 B klasė";6336140882;Ne;13;2;0;15
18743;Lokiukas;"1 B klasė";3485639108;Ne;0;2;0;2
18744;Lokiukas;"1 B klasė";1606617694;Ne;5;2;0;7
18745;Lokiukas;"1 B klasė";8243342948;Ne;1;2;0;3
18746;Lokiukas;"1 B klasė";3991821717;Ne;7;2;0;9
18747;Lokiukas;"1 B klasė";4633366779;Ne;9;2;0;11
18748;Lokiukas;"1 B klasė";1188049956;Ne;0;2;0;2
18749;Lokiukas;"1 B klasė";5446430319;Ne;6;2;0;8
18750;Lokiukas;"1 B klasė";2354942164;Ne;8;2;0;10
18751;Lokiukas;"1 B klasė";35364823312;Ne;1;2;0;3
18752;Lokiukas;"1 B klasė";8687864179;Ne;0;2;0;2
18753;Lokiukas;"1 B klasė";5076773045;Ne;2;2;0;4
18754;Lokiukas;"1 B klasė";1620856143;Ne;6;2;0;8
18755;Lokiukas;"1 B klasė";1604886863;Ne;4;2;0;6
18756;Lokiukas;"1 B klasė";54341630847;Ne;1;2;0;3
18757;Lokiukas;"1 B klasė";8320696048;Ne;2;2;0;4
18758;Lokiukas;"1 B klasė";2701448160;Ne;0;2;0;2
18759;Lokiukas;"1 B klasė";4024866819;Ne;1;2;0;3
18760;Lokiukas;"1 B klasė";2753402906;Ne;5;2;0;7
18761;Lokiukas;"1 B klasė";5275588088;Ne;5;2;0;7
18762;Lokiukas;"1 B klasė";67972824332;Ne;0;2;0;2
18763;Lokiukas;"1 B klasė";9053427316;Ne;0;2;0;2
18764;Lokiukas;"1 B klasė";8189217660;Ne;7;2;0;9
18765;Lokiukas;"1 B klasė";3423529085;Ne;6;2;0;8
18766;Lokiukas;"1 A klasė";2642065594;Ne;0;2;0;2
18767;Lokiukas;"1 A klasė";1025576053;Ne;0;2;0;2
18768;Lokiukas;"1 A klasė";6069516217;Ne;0;2;0;2
18769;Lokiukas;"1 A klasė";34546519642;Ne;6;2;0;8
18770;Lokiukas;"1 A klasė";1752784666;Ne;1;2;0;3
18771;Lokiukas;"1 A klasė";7943213321;Ne;2;2;0;4
18772;Lokiukas;"1 A klasė";8915504279;Ne;0;2;0;2
18773;Lokiukas;"1 A klasė";8796640190;Ne;2;2;0;4
18774;Lokiukas;"1 A klasė";5943412920;Ne;5;2;0;7
18775;Lokiukas;"1 A klasė";3694653020;Ne;1;2;0;3
18776;Lokiukas;"1 A klasė";8902619265;Ne;0;2;0;2
18777;Lokiukas;"1 A klasė";1040288021;Ne;7;2;0;9
18778;Lokiukas;"1 A klasė";8286358519;Ne;5;2;0;7
18779;Lokiukas;"1 A klasė";3744484616;Ne;0;2;0;2
18780;Lokiukas;"1 A klasė";6758550653;Ne;7;2;0;9
18781;Lokiukas;"1 A klasė";5467387832;Ne;2;2;0;4
18782;Lokiukas;"1 A klasė";9336617879;Ne;0;2;0;2
18783;Lokiukas;"1 A klasė";1886540733;Ne;1;2;0;3
18784;Lokiukas;"1 A klasė";7936978436;Ne;5;2;0;7
18785;Lokiukas;"1 A klasė";3843999609;Ne;0;2;0;2
18786;Lokiukas;"1 A klasė";1898004894;Ne;0;2;0;2
18787;Lokiukas;"1 A klasė";2397366916;Ne;0;2;0;2
18788;Lokiukas;"1 A klasė";4985243068;Ne;9;2;0;11
18789;Lokiukas;"1 A klasė";7623203279;Ne;2;2;0;4
18790;Lokiukas;"1 A klasė";7623203279;Ne;2;2;0;4
18791;Lokiukas;GUDRUČIAI;3930463578;Ne;1;2;4;7
18792;Lokiukas;GUDRUČIAI;6277388612;Ne;0;2;0;2
18793;Lokiukas;GUDRUČIAI;4919744559;Ne;7;4;2;13
18794;Lokiukas;GUDRUČIAI;1974049743;Ne;0;5;1;6
18795;Lokiukas;GUDRUČIAI;9354491312;Ne;4;2;3;9
18796;Lokiukas;GUDRUČIAI;6091878190;Ne;0;0;1;1
18797;Lokiukas;GUDRUČIAI;3826815202;Ne;1;2;5;8
18798;Lokiukas;GUDRUČIAI;7208757038;Ne;3;2;2;7
18799;Lokiukas;GUDRUČIAI;4660479216;Ne;0;2;0;2
18800;Lokiukas;GUDRUČIAI;1049009199;Ne;0;3;0;3
18801;Lokiukas;GUDRUČIAI;8440973450;Ne;0;7;2;9
18802;Lokiukas;GUDRUČIAI;8481539433;Ne;3;2;2;7
18803;Lokiukas;GUDRUČIAI;3411390558;Ne;0;2;0;2
18804;Lokiukas;GUDRUČIAI;2185853339;Ne;0;2;0;2
18805;Lokiukas;GUDRUČIAI;5131051261;Ne;0;2;2;4
18806;Lokiukas;GUDRUČIAI;3832151457;Ne;2;12;2;16
18807;Lokiukas;BORUŽĖLĖS;5473316050;Ne;0;5;0;5
18808;Lokiukas;BORUŽĖLĖS;2266747745;Ne;8;12;2;22
18809;Lokiukas;BORUŽĖLĖS;8758248334;Ne;7;3;2;12
18810;Lokiukas;BORUŽĖLĖS;9673257342;Ne;0;3;0;3
18811;Lokiukas;BORUŽĖLĖS;5893844708;Ne;6;1;2;9
18812;Lokiukas;BORUŽĖLĖS;3015119335;Ne;8;7;2;17
18813;Lokiukas;BORUŽĖLĖS;7509043689;Ne;8;12;2;22
18814;Lokiukas;BORUŽĖLĖS;1756658146;Ne;3;2;2;7
18815;Lokiukas;BORUŽĖLĖS;4417116107;Ne;2;2;3;7
18816;Lokiukas;BORUŽĖLĖS;3849212461;Ne;3;2;9;14
18817;Lokiukas;BORUŽĖLĖS;3668903653;Ne;3;2;4;9
18818;Lokiukas;BORUŽĖLĖS;2466354050;Ne;8;2;2;12
18819;Lokiukas;BORUŽĖLĖS;6827710384;Ne;8;12;2;22
18820;Lokiukas;BORUŽĖLĖS;5843699073;Ne;14;2;4;20
18821;Lokiukas;BORUŽĖLĖS;7955048052;Ne;3;2;2;7
18822;Lokiukas;BORUŽĖLĖS;8144936688;Ne;2;5;3;10
18823;Lokiukas;BORUŽĖLĖS;2999594131;Ne;2;2;2;6
18824;Lokiukas;BORUŽĖLĖS;8420913680;Taip;12;2;5;19
18825;Lokiukas;BORUŽĖLĖS;8139809541;Ne;14;2;2;18
18826;Lokiukas;BORUŽĖLĖS;2754009962;Ne;7;0;2;9
18827;Lokiukas;BORUŽĖLĖS;3383354228;Ne;9;2;3;14
18828;Lokiukas;ANČIUKAI;5944620142;Ne;5;2;2;9
18829;Lokiukas;ANČIUKAI;9253014845;Ne;8;4;2;14
18830;Lokiukas;ANČIUKAI;2323620627;Ne;8;4;2;14
18831;Lokiukas;ANČIUKAI;7147146400;Ne;3;1;2;6
18832;Lokiukas;ANČIUKAI;8311551538;Ne;4;3;2;9
18833;Lokiukas;ANČIUKAI;5837961451;Ne;4;2;4;10
18834;Lokiukas;ANČIUKAI;7991284293;Ne;0;22;0;22
18835;Lokiukas;ANČIUKAI;5503888257;Ne;4;0;2;6
18836;Lokiukas;ANČIUKAI;7195614260;Ne;3;3;2;8
18837;Lokiukas;ANČIUKAI;1243077419;Ne;0;22;0;22
18838;Lokiukas;ANČIUKAI;1027917827;Ne;0;7;0;7
18839;Lokiukas;ANČIUKAI;1741109639;Ne;0;22;0;22
18840;Lokiukas;ANČIUKAI;6944809045;Ne;2;0;3;5
18841;Lokiukas;ANČIUKAI;5785049399;Ne;0;2;0;2
18842;Lokiukas;KODĖLČIUKAI;8630112458;Ne;4;4;3;11
18843;Lokiukas;KODĖLČIUKAI;4585621105;Ne;0;2;0;2
18844;Lokiukas;KODĖLČIUKAI;8576418875;Ne;8;6;2;16
18845;Lokiukas;KODĖLČIUKAI;6869785650;Ne;0;9;0;9
18846;Lokiukas;KODĖLČIUKAI;4849031542;Ne;2;2;2;6
18847;Lokiukas;KODĖLČIUKAI;2625981190;Ne;3;2;2;7
18848;Lokiukas;KODĖLČIUKAI;4617372387;Ne;0;1;0;1
18849;Lokiukas;KODĖLČIUKAI;5401463671;Ne;0;5;0;5
18850;Lokiukas;KODĖLČIUKAI;9798351980;Ne;0;4;3;7
18851;Lokiukas;KODĖLČIUKAI;1170293017;Ne;7;2;4;13
18852;Lokiukas;KODĖLČIUKAI;9996442005;Ne;0;5;0;5
18853;Lokiukas;KODĖLČIUKAI;4317453894;Ne;0;4;0;4
18854;Lokiukas;KODĖLČIUKAI;3876368364;Ne;1;2;2;5
18855;Lokiukas;KODĖLČIUKAI;7426579018;Ne;0;2;1;3
18856;Lokiukas;KODĖLČIUKAI;1724976098;Ne;6;2;5;13
18857;Lokiukas;KODĖLČIUKAI;3733581089;Ne;3;2;2;7
18858;Lokiukas;KODĖLČIUKAI;1076719080;Ne;3;4;5;12
18859;Lokiukas;KODĖLČIUKAI;6102196040;Ne;0;2;0;2
18860;Lokiukas;KODĖLČIUKAI;9779789133;Ne;0;2;0;2
18861;Lokiukas;KODĖLČIUKAI;6987657237;Ne;2;1;2;5
18862;Lokiukas;KODĖLČIUKAI;5353687011;Ne;7;4;2;13
18863;Lokiukas;DRUGELIAI;4858829710;Ne;3;2;2;7
18864;Lokiukas;DRUGELIAI;4206181176;Ne;0;2;0;2
18865;Lokiukas;DRUGELIAI;4442073527;Ne;0;2;0;2
18866;Lokiukas;DRUGELIAI;7532603655;Ne;0;2;1;3
18867;Lokiukas;DRUGELIAI;7006828256;Ne;0;2;0;2
18868;Lokiukas;DRUGELIAI;8596706753;Ne;7;5;2;14
18869;Lokiukas;DRUGELIAI;4197547631;Ne;0;5;0;5
18870;Lokiukas;DRUGELIAI;8266708371;Ne;0;1;0;1
18871;Lokiukas;DRUGELIAI;7195184433;Ne;2;2;2;6
18872;Lokiukas;DRUGELIAI;2374601283;Ne;0;7;1;8
18873;Lokiukas;DRUGELIAI;1390586527;Ne;6;9;4;19
18874;Lokiukas;DRUGELIAI;2093224908;Ne;2;2;2;6
18875;Lokiukas;DRUGELIAI;1341265560;Ne;3;3;2;8
18876;Lokiukas;DRUGELIAI;5131662172;Ne;0;2;0;2
18877;Lokiukas;DRUGELIAI;4284574166;Ne;0;22;0;22
18878;Lokiukas;DRUGELIAI;1913742619;Ne;4;2;4;10
18879;Lokiukas;DRUGELIAI;4521556853;Ne;5;2;2;9
18880;Lokiukas;DRUGELIAI;5092095494;Ne;0;13;1;14
18881;Lokiukas;"2 A klasė";1626698185;Ne;9;2;0;11
18882;Lokiukas;"2 A klasė";39222094073;Ne;2;2;0;4
18883;Lokiukas;"2 A klasė";69364831994;Ne;0;2;0;2
18884;Lokiukas;"2 A klasė";74169282323;Ne;0;2;0;2
18885;Lokiukas;"2 A klasė";1625137322;Ne;9;2;0;11
18886;Lokiukas;"2 A klasė";8452600632;Ne;6;2;0;8
18887;Lokiukas;"2 A klasė";35890122494;Ne;9;2;0;11
18888;Lokiukas;"2 A klasė";8270572748;Ne;3;2;0;5
18889;Lokiukas;"2 A klasė";2170176922;Ne;6;2;0;8
18890;Lokiukas;"2 A klasė";8455869600;Ne;2;2;0;4
18891;Lokiukas;"2 A klasė";34800098950;Ne;0;2;0;2
18892;Lokiukas;"2 A klasė";3825101647;Ne;20;2;0;22
18893;Lokiukas;"2 A klasė";8618280811;Ne;7;2;0;9
18894;Lokiukas;"2 A klasė";8323172347;Ne;3;2;0;5
18895;Lokiukas;"2 A klasė";7844351275;Ne;6;2;0;8
18896;Lokiukas;"2 A klasė";2045735700;Ne;11;2;0;13
18897;Lokiukas;"2 A klasė";3981653153;Ne;0;2;0;2
18898;Lokiukas;"2 A klasė";6318538591;Ne;0;2;0;2
18899;Lokiukas;"2 A klasė";43500434912;Ne;3;2;0;5
18900;Lokiukas;"2 A klasė";25141529581;Ne;4;2;0;6
18901;Lokiukas;"2 A klasė";3369746590;Ne;1;2;0;3
18902;Lokiukas;"2 A klasė";3004895246;Ne;1;2;0;3
18903;Lokiukas;"2 A klasė";3061816821;Ne;6;2;0;8
18904;Lokiukas;"2 A klasė";56069293343;Ne;15;2;0;17
18905;Lokiukas;"2 A klasė";4677444685;Ne;4;2;0;6
18906;Lokiukas;"2 B klasė";14605095801;Ne;1;2;0;3
18907;Lokiukas;"2 B klasė";39975872119;Ne;0;2;0;2
18908;Lokiukas;"2 B klasė";8568285232;Ne;11;2;0;13
18909;Lokiukas;"2 B klasė";5453470660;Ne;4;2;0;6
18910;Lokiukas;"2 B klasė";5879386524;Ne;0;2;0;2
18911;Lokiukas;"2 B klasė";7591418969;Ne;0;2;0;2
18912;Lokiukas;"2 B klasė";8036643654;Ne;0;2;0;2
18913;Lokiukas;"2 B klasė";2548712970;Ne;3;2;0;5
18914;Lokiukas;"2 B klasė";4427448272;Ne;20;2;0;22
18915;Lokiukas;"2 B klasė";4580716838;Ne;2;2;0;4
18916;Lokiukas;"2 B klasė";2673522432;Ne;12;2;0;14
18917;Lokiukas;"2 B klasė";8399364170;Ne;1;2;0;3
18918;Lokiukas;"2 B klasė";9625041533;Ne;3;2;0;5
18919;Lokiukas;"2 B klasė";2476231041;Ne;7;2;0;9
18920;Lokiukas;"2 B klasė";5943583254;Ne;0;2;0;2
18921;Lokiukas;"2 B klasė";5437008837;Ne;1;2;0;3
18922;Lokiukas;"2 B klasė";4569798381;Ne;5;2;0;7
18923;Lokiukas;"2 B klasė";97284171512;Ne;0;2;0;2
18924;Lokiukas;"2 B klasė";3070998871;Ne;3;2;0;5
18925;Lokiukas;"2 B klasė";9501202273;Ne;1;2;0;3
18926;Lokiukas;"2 B klasė";20659573470;Ne;20;2;0;22
18927;Lokiukas;"2 B klasė";8943496964;Ne;0;2;0;2
18928;Lokiukas;"2 B klasė";3505492809;Ne;3;2;0;5
18929;Lokiukas;"3 A klasė";83086633109;Ne;2;2;0;4
18930;Lokiukas;"3 A klasė";131300206;Ne;6;2;0;8
18931;Lokiukas;"3 A klasė";82025637099;Ne;5;2;0;7
18932;Lokiukas;"3 A klasė";73515179103;Ne;4;2;0;6
18933;Lokiukas;"3 A klasė";73696992182;Ne;10;2;0;12
18934;Lokiukas;"3 A klasė";8240261104;Ne;1;2;0;3
18935;Lokiukas;"3 A klasė";83528495608;Ne;6;2;0;8
18936;Lokiukas;"3 A klasė";8846527481;Ne;0;2;0;2
18937;Lokiukas;"3 A klasė";67133709394;Ne;3;2;0;5
18938;Lokiukas;"3 A klasė";66528256040;Ne;4;2;0;6
18939;Lokiukas;"3 A klasė";36677665098;Ne;5;2;0;7
18940;Lokiukas;"3 A klasė";1056075876;Ne;0;2;0;2
18941;Lokiukas;"3 A klasė";52940830874;Ne;6;2;0;8
18942;Lokiukas;"3 A klasė";1201125655;Ne;7;2;0;9
18943;Lokiukas;"3 A klasė";38884246104;Ne;4;2;0;6
18944;Lokiukas;"3 A klasė";2502465398;Ne;1;2;0;3
18945;Lokiukas;"3 A klasė";9890308887;Ne;0;2;0;2
18946;Lokiukas;"3 A klasė";77512682081;Ne;0;2;0;2
18947;Lokiukas;"3 A klasė";86120193313;Ne;0;2;0;2
18948;Lokiukas;"3 A klasė";45028887854;Ne;0;2;0;2
18949;Lokiukas;"3 A klasė";51237034253;Ne;4;2;0;6
18950;Lokiukas;"3 A klasė";27403835292;Ne;2;2;0;4
18951;Lokiukas;"3 A klasė";4989577303;Ne;5;2;0;7
18952;Lokiukas;"3 A klasė";1106442860;Ne;1;2;0;3
18953;Lokiukas;"3 A klasė";1224477393;Ne;5;2;0;7
18954;Lokiukas;"3 B klasė";61807094999;Ne;0;2;0;2
18955;Lokiukas;"3 B klasė";51059574159;Ne;3;2;0;5
18956;Lokiukas;"3 B klasė";32714964224;Ne;2;2;0;4
18957;Lokiukas;"3 B klasė";8920359311;Ne;1;2;0;3
18958;Lokiukas;"3 B klasė";2959877846;Ne;20;2;0;22
18959;Lokiukas;"3 B klasė";57505829630;Ne;7;2;0;9
18960;Lokiukas;"3 B klasė";1072148409;Ne;3;2;0;5
18961;Lokiukas;"3 B klasė";7130407913;Ne;6;2;0;8
18962;Lokiukas;"3 B klasė";7235277422;Ne;5;2;0;7
18963;Lokiukas;"3 B klasė";1133294157;Ne;2;2;0;4
18964;Lokiukas;"3 B klasė";7334971595;Ne;1;2;0;3
18965;Lokiukas;"3 B klasė";92373834478;Ne;1;2;0;3
18966;Lokiukas;"3 B klasė";2054450461;Ne;0;2;0;2
18967;Lokiukas;"3 B klasė";14234831040;Ne;2;2;0;4
18968;Lokiukas;"3 B klasė";4662981914;Ne;10;2;0;12
18969;Lokiukas;"3 B klasė";6414861823;Ne;9;2;0;11
18970;Lokiukas;"3 B klasė";98045145204;Ne;20;2;0;22
18971;Lokiukas;"3 B klasė";68390568000;Ne;3;2;0;5
18972;Lokiukas;"3 B klasė";14937983736;Ne;0;2;0;2
18973;Lokiukas;"3 B klasė";8996622650;Ne;0;2;0;2
18974;Lokiukas;"3 B klasė";2078673522;Ne;4;2;0;6
18975;Lokiukas;"3 B klasė";40006848965;Ne;2;2;0;4
18976;Lokiukas;"3 B klasė";3255141230;Ne;0;2;0;2
18977;Lokiukas;"3 B klasė";3255141230;Ne;0;2;0;2
18978;Lokiukas;"3 B klasė";38001876942;Ne;5;2;0;7
18979;Lokiukas;"4 A klasė";15406362908;Ne;7;2;0;9
18980;Lokiukas;"4 A klasė";45122233067;Ne;1;2;0;3
18981;Lokiukas;"4 A klasė";10948160841;Ne;20;2;0;22
18982;Lokiukas;"4 A klasė";21802863853;Ne;0;2;0;2
18983;Lokiukas;"4 A klasė";22979689191;Ne;9;2;0;11
18984;Lokiukas;"4 A klasė";80754592972;Ne;4;2;0;6
18985;Lokiukas;"4 A klasė";14903100496;Ne;0;2;0;2
18986;Lokiukas;"4 A klasė";4608275224;Ne;2;2;0;4
18987;Lokiukas;"4 A klasė";99706061553;Ne;16;2;0;18
18988;Lokiukas;"4 A klasė";7785940412;Ne;1;2;0;3
18989;Lokiukas;"4 A klasė";72092394330;Ne;4;2;0;6
18990;Lokiukas;"4 A klasė";35769782473;Ne;20;2;0;22
18991;Lokiukas;"4 A klasė";38531751377;Ne;1;2;0;3
18992;Lokiukas;"4 A klasė";59840033826;Ne;3;2;0;5
18993;Lokiukas;"4 A klasė";80793623068;Ne;5;2;0;7
18994;Lokiukas;"4 A klasė";43070670534;Ne;6;2;0;8
18995;Lokiukas;"4 A klasė";5198408183;Ne;11;2;0;13
18996;Lokiukas;"4 A klasė";24099693663;Ne;20;2;0;22
18997;Lokiukas;"4 A klasė";9747265775;Ne;20;2;0;22
18998;Lokiukas;"4 A klasė";93374754851;Ne;2;2;0;4
18999;Lokiukas;"4 A klasė";25170045140;Ne;20;2;0;22
19000;Lokiukas;"4 A klasė";84273668685;Ne;3;2;0;5
19001;Lokiukas;"4 A klasė";15685936471;Ne;5;2;0;7
19002;Lokiukas;"4 A klasė";97609897018;Ne;9;2;0;11
19003;Lokiukas;"4 A klasė";23688235312;Ne;0;2;0;2
19004;Lokiukas;"4 A klasė";15574258138;Ne;1;2;0;3
19005;Lokiukas;"4 A klasė";9077016953;Ne;10;2;0;12
19006;Lokiukas;"4 A klasė";24523198513;Ne;20;2;0;22
19007;Lokiukas;"4 A klasė";29577495646;Ne;10;2;0;12
19008;Lokiukas;"4 B klasė";32506466236;Ne;6;2;0;8
19009;Lokiukas;"4 B klasė";7324496782;Ne;0;2;0;2
19010;Lokiukas;"4 B klasė";10811780420;Ne;4;2;0;6
19011;Lokiukas;"4 B klasė";28796727185;Ne;20;2;0;22
19012;Lokiukas;"4 B klasė";88415635113;Ne;13;2;0;15
19013;Lokiukas;"4 B klasė";95910336503;Ne;13;2;0;15
19014;Lokiukas;"4 B klasė";7903535850;Ne;7;2;0;9
19015;Lokiukas;"4 B klasė";7497324442;Ne;16;2;0;18
19016;Lokiukas;"4 B klasė";96046361641;Ne;1;2;0;3
19017;Lokiukas;"4 B klasė";18646642032;Ne;0;2;0;2
19018;Lokiukas;"4 B klasė";79109699217;Ne;3;2;0;5
19019;Lokiukas;"4 B klasė";61890775725;Ne;16;2;0;18
19020;Lokiukas;"4 B klasė";24221829774;Ne;8;2;0;10
19021;Lokiukas;"4 B klasė";58513885211;Ne;4;2;0;6
19022;Lokiukas;"4 B klasė";50713289266;Ne;0;2;0;2
19023;Lokiukas;"4 B klasė";20231469825;Ne;3;2;0;5
19024;Lokiukas;"4 B klasė";1146878499;Ne;10;2;0;12
19025;Lokiukas;"4 B klasė";46587243900;Ne;0;2;0;2
19026;Lokiukas;"4 B klasė";9141446821;Ne;4;2;0;6
19027;Lokiukas;"4 B klasė";75507005694;Ne;2;2;0;4
19028;Lokiukas;"4 B klasė";73426072972;Ne;8;2;0;10
19029;Lokiukas;"4 B klasė";59913848400;Ne;17;2;0;19
19030;Lokiukas;"4 B klasė";62268017779;Ne;5;2;0;7
19031;Lokiukas;"4 B klasė";2105377652;Ne;1;2;0;3
19032;Lokiukas;"4 B klasė";39867459515;Ne;10;2;0;12
19033;Lokiukas;"4 B klasė";5311341721;Ne;20;2;0;22
19034;Lokiukas;"4 B klasė";9516336072;Ne;4;2;0;6
19035;Šaltinėlis;Ančiukų;3901200729;Ne;8;2;2;12
19036;Šaltinėlis;Ančiukų;1312785137;Ne;6;1;4;11
19037;Šaltinėlis;Ančiukų;9209105445;Ne;10;3;3;16
19038;Šaltinėlis;Ančiukų;9112527921;Ne;3;2;2;7
19039;Šaltinėlis;Ančiukų;9398488555;Ne;3;2;2;7
19040;Šaltinėlis;Ančiukų;2027779524;Ne;5;3;1;9
19041;Šaltinėlis;Ančiukų;5498764523;Ne;0;3;4;7
19042;Šaltinėlis;Ančiukų;4226929875;Ne;12;2;2;16
19043;Šaltinėlis;Ančiukų;1489377928;Ne;8;0;4;12
19044;Šaltinėlis;Ančiukų;5005394548;Ne;8;0;4;12
19045;Šaltinėlis;Ančiukų;1102861619;Ne;5;0;4;9
19046;Šaltinėlis;Ančiukų;1928794692;Ne;7;0;4;11
19047;Šaltinėlis;Ančiukų;1742421427;Ne;4;0;4;8
19048;Šaltinėlis;Ančiukų;9581384663;Ne;6;2;2;10
19049;Šaltinėlis;Ančiukų;9465174636;Ne;6;0;2;8
19050;Šaltinėlis;Ančiukų;8034195267;Ne;0;0;4;4
19051;Šaltinėlis;Ančiukų;5455997139;Ne;7;2;2;11
19052;Šaltinėlis;Ančiukų;9588260206;Ne;9;0;6;15
19053;Šaltinėlis;Ančiukų;8116985061;Ne;17;0;3;20
19054;Šaltinėlis;Ančiukų;6371994202;Ne;6;4;2;12
19055;Šaltinėlis;Ančiukų;6244924079;Ne;13;0;4;17
19056;Šaltinėlis;Ančiukų;3806267811;Ne;12;0;5;17
19057;Šaltinėlis;Bitučių;7311831014;Ne;0;4;0;4
19058;Šaltinėlis;Bitučių;5854723120;Ne;0;14;1;15
19059;Šaltinėlis;Bitučių;1678450741;Ne;7;2;2;11
19060;Šaltinėlis;Bitučių;5833136956;Ne;1;3;2;6
19061;Šaltinėlis;Bitučių;3483756240;Ne;3;2;4;9
19062;Šaltinėlis;Bitučių;6380346298;Ne;0;3;0;3
19063;Šaltinėlis;Bitučių;5799032398;Ne;0;2;3;5
19064;Šaltinėlis;Bitučių;5525740049;Ne;0;4;1;5
19065;Šaltinėlis;Bitučių;5343279219;Ne;3;3;2;8
19066;Šaltinėlis;Bitučių;3507180650;Ne;8;2;2;12
19067;Šaltinėlis;Bitučių;7118672118;Ne;0;4;0;4
19068;Šaltinėlis;Bitučių;8950694484;Ne;7;2;3;12
19069;Šaltinėlis;Bitučių;2465009553;Ne;0;4;1;5
19070;Šaltinėlis;Bitučių;5382567842;Ne;0;2;0;2
19071;Šaltinėlis;Bitučių;4681460322;Ne;11;3;2;16
19072;Šaltinėlis;Bitučių;3968514430;Ne;0;4;0;4
19073;Šaltinėlis;Bitučių;6721510313;Ne;0;2;0;2
19074;Šaltinėlis;Bitučių;1978469605;Ne;0;2;4;6
19075;Šaltinėlis;Bitučių;5774391181;Ne;0;2;2;4
19076;Šaltinėlis;Bitučių;2499890317;Ne;11;2;2;15
19077;Šaltinėlis;Bitučių;7650840990;Ne;15;2;3;20
19078;Šaltinėlis;Bitučių;5345738219;Ne;0;3;0;3
19079;Šaltinėlis;Bitučių;3579974049;Ne;5;2;3;10
19080;Šaltinėlis;Bitučių;4743907195;Ne;3;2;5;10
19081;Šaltinėlis;Bitučių;1287205292;Ne;8;1;2;11
19082;Šaltinėlis;Bitučių;7973137015;Ne;6;2;4;12
19083;Šaltinėlis;Bitučių;7519967594;Ne;7;3;3;13
19084;Šaltinėlis;Bitučių;3017437426;Ne;0;2;1;3
19085;Šaltinėlis;Bitučių;9983153464;Ne;3;2;3;8
19086;Šaltinėlis;Saulutės;3159555258;Ne;8;4;2;14
19087;Šaltinėlis;Saulutės;9753396159;Ne;0;0;2;2
19088;Šaltinėlis;Saulutės;8258039377;Ne;0;2;0;2
19089;Šaltinėlis;Saulutės;2550355455;Ne;0;0;3;3
19090;Šaltinėlis;Saulutės;5871681602;Ne;7;2;4;13
19091;Šaltinėlis;Saulutės;3448242910;Ne;0;3;0;3
19092;Šaltinėlis;Saulutės;8147526528;Ne;0;1;0;1
19093;Šaltinėlis;Saulutės;6109197821;Ne;0;0;2;2
19094;Šaltinėlis;Saulutės;8439306703;Ne;0;1;2;3
19095;Šaltinėlis;Saulutės;3505001330;Ne;6;1;4;11
19096;Šaltinėlis;Saulutės;8973369897;Ne;0;2;3;5
19097;Šaltinėlis;Saulutės;6145605567;Ne;0;9;0;9
19098;Šaltinėlis;Saulutės;3780870805;Ne;0;0;4;4
19099;Šaltinėlis;Saulutės;2157520281;Ne;0;1;3;4
19100;Šaltinėlis;Saulutės;8995954572;Ne;5;0;3;8
19101;Šaltinėlis;Saulutės;5996579651;Ne;0;2;0;2
19102;Šaltinėlis;Saulutės;9613234759;Ne;8;2;3;13
19103;Šaltinėlis;Saulutės;9218436977;Ne;2;1;4;7
19104;Šaltinėlis;Meškiukų;6915625306;Ne;3;0;2;5
19105;Šaltinėlis;Meškiukų;6645807642;Ne;5;2;4;11
19106;Šaltinėlis;Meškiukų;9759912102;Ne;0;2;0;2
19107;Šaltinėlis;Meškiukų;4664741207;Ne;0;1;2;3
19108;Šaltinėlis;Meškiukų;1400918201;Ne;6;8;2;16
19109;Šaltinėlis;Meškiukų;1656674673;Ne;2;2;2;6
19110;Šaltinėlis;Meškiukų;4248763165;Ne;0;22;0;22
19111;Šaltinėlis;Meškiukų;5982018366;Ne;0;2;0;2
19112;Šaltinėlis;Meškiukų;9922223978;Ne;9;2;4;15
19113;Šaltinėlis;Meškiukų;8995077908;Ne;0;2;0;2
19114;Šaltinėlis;Meškiukų;5982188743;Ne;3;0;4;7
19115;Šaltinėlis;Meškiukų;6586783795;Ne;0;5;0;5
19116;Šaltinėlis;Meškiukų;7468640592;Ne;5;2;2;9
19117;Šaltinėlis;Meškiukų;4064231806;Ne;2;2;2;6
19118;Šaltinėlis;Meškiukų;4159654434;Ne;4;0;3;7
19119;Šaltinėlis;Meškiukų;6688536661;Ne;3;3;2;8
19120;Šaltinėlis;Meškiukų;8880659539;Ne;0;2;5;7
19121;Šaltinėlis;Meškiukų;3228788999;Ne;0;4;0;4
19122;Šaltinėlis;Meškiukų;5905345563;Ne;9;0;4;13
19123;Šaltinėlis;Meškiukų;2332065937;Ne;0;1;2;3
19124;Šaltinėlis;Meškiukų;4936982698;Ne;0;4;0;4
19125;Šaltinėlis;Nykštukai;9766640995;Ne;9;0;6;15
19126;Šaltinėlis;Nykštukai;3356138058;Ne;0;2;3;5
19127;Šaltinėlis;Nykštukai;5434349511;Ne;11;0;3;14
19128;Šaltinėlis;Nykštukai;4226068669;Ne;3;0;2;5
19129;Šaltinėlis;Nykštukai;2976773344;Ne;8;2;4;14
19130;Šaltinėlis;Nykštukai;3687243030;Ne;6;3;2;11
19131;Šaltinėlis;Nykštukai;4364256563;Ne;10;0;1;11
19132;Šaltinėlis;Nykštukai;9333013048;Ne;0;0;3;3
19133;Šaltinėlis;Nykštukai;4029616063;Ne;11;2;3;16
19134;Šaltinėlis;Nykštukai;6530797082;Ne;0;0;4;4
19135;Šaltinėlis;Nykštukai;7534585887;Ne;4;0;7;11
19136;Šaltinėlis;Nykštukai;8977029692;Ne;0;4;0;4
19137;Šaltinėlis;Nykštukai;7120592596;Ne;5;2;2;9
19138;Šaltinėlis;Nykštukai;3497881408;Ne;1;3;2;6
19139;Šaltinėlis;Nykštukai;6383844995;Ne;1;0;4;5
19140;Šaltinėlis;Nykštukai;1441937630;Ne;1;0;6;7
19141;Šaltinėlis;Nykštukai;4742849747;Ne;4;2;6;12
19142;Šaltinėlis;Nykštukai;2353630084;Ne;5;2;1;8
19143;Šaltinėlis;Nykštukai;5593692486;Ne;3;0;4;7
19144;Šaltinėlis;Nykštukai;1496105338;Ne;8;0;5;13
19145;Šaltinėlis;Nykštukai;7432957835;Ne;6;0;6;12
19146;Šaltinėlis;Nykštukai;1468854968;Ne;6;3;3;12
19147;Šaltinėlis;Perliukų;2825412170;Ne;2;2;3;7
19148;Šaltinėlis;Perliukų;1686009371;Ne;10;0;4;14
19149;Šaltinėlis;Perliukų;9075507649;Ne;0;0;2;2
19150;Šaltinėlis;Perliukų;7068058767;Ne;0;2;3;5
19151;Šaltinėlis;Perliukų;2189112609;Ne;1;0;7;8
19152;Šaltinėlis;Perliukų;8914777163;Ne;5;2;2;9
19153;Šaltinėlis;Perliukų;7387221265;Ne;1;2;2;5
19154;Šaltinėlis;Perliukų;9674923143;Ne;0;0;6;6
19155;Šaltinėlis;Perliukų;1823048790;Ne;0;1;0;1
19156;Šaltinėlis;Perliukų;3073692882;Ne;0;0;4;4
19157;Šaltinėlis;Perliukų;5325974488;Ne;8;2;4;14
19158;Šaltinėlis;Perliukų;2022956307;Ne;5;0;2;7
19159;Šaltinėlis;Perliukų;2126751248;Ne;10;2;1;13
19160;Šaltinėlis;Perliukų;3271931810;Ne;0;0;8;8
19161;Šaltinėlis;Perliukų;1445108285;Ne;3;2;2;7
19162;Šaltinėlis;Perliukų;7133044918;Ne;5;0;3;8
19163;Šaltinėlis;Perliukų;2806453623;Ne;4;0;4;8
19164;Šaltinėlis;Perliukų;9691993251;Ne;0;2;0;2
19165;Šaltinėlis;Perliukų;8695191968;Ne;0;2;1;3
19166;Šaltinėlis;Perliukų;4430546695;Ne;0;2;0;2
19167;Šaltinėlis;BORUŽĖLĖS;2222188915;Ne;15;0;4;19
19168;Šaltinėlis;BORUŽĖLĖS;1012869495;Ne;4;0;4;8
19169;Šaltinėlis;BORUŽĖLĖS;7007255432;Ne;5;6;3;14
19170;Šaltinėlis;BORUŽĖLĖS;2704220005;Ne;0;0;1;1
19171;Šaltinėlis;BORUŽĖLĖS;7074953363;Ne;10;0;4;14
19172;Šaltinėlis;BORUŽĖLĖS;1283839856;Ne;0;2;1;3
19173;Šaltinėlis;BORUŽĖLĖS;4754031495;Ne;3;0;3;6
19174;Šaltinėlis;BORUŽĖLĖS;8806353914;Ne;2;2;6;10
19175;Šaltinėlis;BORUŽĖLĖS;5943247739;Ne;2;0;4;6
19176;Šaltinėlis;BORUŽĖLĖS;9258088219;Ne;3;0;3;6
19177;Šaltinėlis;BORUŽĖLĖS;4825400376;Ne;6;0;3;9
19178;Šaltinėlis;BORUŽĖLĖS;8979939577;Ne;5;0;5;10
19179;Šaltinėlis;BORUŽĖLĖS;2053262491;Ne;5;0;4;9
19180;Šaltinėlis;BORUŽĖLĖS;2856977335;Ne;2;0;2;4
19181;Šaltinėlis;BORUŽĖLĖS;6553155860;Ne;13;0;4;17
19182;Šaltinėlis;"4B klasė";93256161233;Ne;0;2;0;2
19183;Šaltinėlis;"4B klasė";83173349544;Ne;0;3;0;3
19184;Šaltinėlis;"4B klasė";39088869084;Ne;0;6;0;6
19185;Šaltinėlis;"4B klasė";1422035829;Ne;0;2;0;2
19186;Šaltinėlis;"4B klasė";7711903999;Ne;0;2;0;2
19187;Šaltinėlis;"4B klasė";95542489944;Ne;0;3;0;3
19188;Šaltinėlis;"4B klasė";3072314714;Ne;0;3;0;3
19189;Šaltinėlis;"4B klasė";1220687492;Ne;0;2;0;2
19190;Šaltinėlis;"4B klasė";74337710550;Ne;0;2;0;2
19191;Šaltinėlis;"4B klasė";35401075864;Ne;0;2;0;2
19192;Šaltinėlis;"4B klasė";19630605543;Ne;0;9;0;9
19193;Šaltinėlis;"4B klasė";84522552145;Ne;0;6;0;6
19194;Šaltinėlis;"4B klasė";3626545396;Ne;0;8;0;8
19195;Šaltinėlis;"4B klasė";6317111400;Ne;0;3;0;3
19196;Šaltinėlis;"4B klasė";4762756751;Ne;0;2;0;2
19197;Šaltinėlis;"4B klasė";72372808270;Ne;0;6;0;6
19198;Šaltinėlis;"4B klasė";1924418657;Ne;0;3;0;3
19199;Šaltinėlis;"4B klasė";77194317310;Ne;0;7;0;7
19200;Šaltinėlis;"4B klasė";57847832778;Ne;0;9;0;9
19201;Šaltinėlis;"4B klasė";2099800744;Ne;0;6;0;6
19202;Šaltinėlis;"4B klasė";70315400705;Ne;0;6;0;6
19203;Šaltinėlis;"4B klasė";81082410620;Ne;0;3;0;3
19204;Šaltinėlis;1A;6487378225;Ne;0;2;0;2
19205;Šaltinėlis;1A;56396772538;Ne;0;2;0;2
19206;Šaltinėlis;1A;5251390843;Ne;0;2;0;2
19207;Šaltinėlis;1A;8500790262;Ne;0;2;0;2
19208;Šaltinėlis;1A;4332884673;Ne;0;3;0;3
19209;Šaltinėlis;1A;3493429067;Ne;0;4;0;4
19210;Šaltinėlis;1A;9362495172;Ne;0;3;0;3
19211;Šaltinėlis;1A;6462738640;Ne;0;7;0;7
19212;Šaltinėlis;1A;77872075694;Ne;0;2;0;2
19213;Šaltinėlis;1A;7133143923;Ne;0;5;0;5
19214;Šaltinėlis;1A;6887838949;Ne;0;22;0;22
19215;Šaltinėlis;1A;1543331408;Ne;0;2;0;2
19216;Šaltinėlis;1A;2630875135;Ne;0;2;0;2
19217;Šaltinėlis;1A;9218883174;Ne;0;4;0;4
19218;Šaltinėlis;1A;2973820849;Ne;0;9;0;9
19219;Šaltinėlis;1A;7737797979;Ne;0;2;0;2
19220;Šaltinėlis;1A;9820788524;Ne;0;22;0;22
19221;Šaltinėlis;1A;2646901307;Ne;0;9;0;9
19222;Šaltinėlis;1A;9274165569;Ne;0;2;0;2
19223;Šaltinėlis;1A;3691635011;Ne;0;2;0;2
19224;Šaltinėlis;1A;2084451705;Ne;0;3;0;3
19225;Šaltinėlis;"2A klasė";1580090516;Ne;0;2;0;2
19226;Šaltinėlis;"2A klasė";2034838765;Ne;0;2;0;2
19227;Šaltinėlis;"2A klasė";2105963102;Ne;0;2;0;2
19228;Šaltinėlis;"2A klasė";3582666579;Ne;0;3;0;3
19229;Šaltinėlis;"2A klasė";46569341613;Ne;0;3;0;3
19230;Šaltinėlis;"2A klasė";2801321116;Ne;0;3;0;3
19231;Šaltinėlis;"2A klasė";1091056386;Ne;0;3;0;3
19232;Šaltinėlis;"2A klasė";52142182972;Ne;0;22;0;22
19233;Šaltinėlis;"2A klasė";6880337593;Ne;0;5;0;5
19234;Šaltinėlis;"2A klasė";9188065549;Ne;0;4;0;4
19235;Šaltinėlis;"2A klasė";9305706589;Ne;0;2;0;2
19236;Šaltinėlis;"2A klasė";3516760367;Ne;0;2;0;2
19237;Šaltinėlis;"2A klasė";56542341895;Ne;0;2;0;2
19238;Šaltinėlis;"2A klasė";5077603802;Ne;0;4;0;4
19239;Šaltinėlis;"2A klasė";1910670134;Ne;0;2;0;2
19240;Šaltinėlis;"2A klasė";9595350871;Ne;0;2;0;2
19241;Šaltinėlis;"2A klasė";15925823621;Ne;0;2;0;2
19242;Šaltinėlis;"2A klasė";8902634958;Ne;0;7;0;7
19243;Šaltinėlis;"2A klasė";9757246434;Ne;0;13;0;13
19244;Šaltinėlis;"2A klasė";7262120071;Ne;0;2;0;2
19245;Šaltinėlis;"2A klasė";1004445904;Ne;0;2;0;2
19246;Šaltinėlis;"2B klasė";84494627465;Ne;0;2;0;2
19247;Šaltinėlis;"2B klasė";2146141461;Ne;0;2;0;2
19248;Šaltinėlis;"2B klasė";6068980312;Ne;0;8;0;8
19249;Šaltinėlis;"2B klasė";9425353041;Ne;0;4;0;4
19250;Šaltinėlis;"2B klasė";17147527171;Ne;0;22;0;22
19251;Šaltinėlis;"2B klasė";1716801722;Ne;0;2;0;2
19252;Šaltinėlis;"2B klasė";2333071711;Ne;0;6;0;6
19253;Šaltinėlis;"2B klasė";23301579810;Ne;0;22;0;22
19254;Šaltinėlis;"2B klasė";526307704;Ne;0;4;0;4
19255;Šaltinėlis;"2B klasė";1958647188;Ne;0;6;0;6
19256;Šaltinėlis;"2B klasė";1583520894;Ne;0;5;0;5
19257;Šaltinėlis;"2B klasė";11083638216;Ne;0;6;0;6
19258;Šaltinėlis;"2B klasė";1023238509;Ne;0;3;0;3
19259;Šaltinėlis;"3A klasė";32264290873;Ne;0;2;0;2
19260;Šaltinėlis;"3A klasė";1767635282;Ne;0;2;0;2
19261;Šaltinėlis;"3A klasė";1390316465;Ne;0;6;0;6
19262;Šaltinėlis;"3A klasė";5442943843;Ne;0;4;0;4
19263;Šaltinėlis;"3A klasė";6764006747;Ne;0;5;0;5
19264;Šaltinėlis;"3A klasė";1658370782;Ne;0;3;0;3
19265;Šaltinėlis;"3A klasė";10918276041;Ne;0;3;0;3
19266;Šaltinėlis;"3A klasė";3455754351;Ne;0;22;0;22
19267;Šaltinėlis;"3A klasė";66575684640;Ne;0;2;0;2
19268;Šaltinėlis;"3A klasė";86592374576;Ne;0;22;0;22
19269;Šaltinėlis;"3A klasė";13808708760;Ne;0;3;0;3
19270;Šaltinėlis;"3A klasė";1614411921;Ne;0;3;0;3
19271;Šaltinėlis;"3A klasė";79406746980;Ne;0;3;0;3
19272;Šaltinėlis;"3A klasė";3577137327;Ne;0;2;0;2
19273;Šaltinėlis;"3A klasė";1224027643;Ne;0;2;0;2
19274;Šaltinėlis;"3A klasė";48525545812;Ne;0;4;0;4
19275;Šaltinėlis;"3A klasė";3022926855;Ne;0;2;0;2
19276;Šaltinėlis;"3A klasė";1190394855;Ne;0;5;0;5
19277;Šaltinėlis;"3A klasė";40186714037;Ne;0;2;0;2
19278;Šaltinėlis;"3A klasė";1456486363;Ne;0;3;0;3
19279;Šaltinėlis;"3A klasė";32949623652;Ne;0;3;0;3
19280;Šaltinėlis;"4A klasė";14213856824;Ne;0;2;0;2
19281;Šaltinėlis;"4A klasė";80649337160;Ne;0;2;0;2
19282;Šaltinėlis;"4A klasė";92958012146;Ne;0;3;0;3
19283;Šaltinėlis;"4A klasė";84656960510;Ne;0;22;0;22
19284;Šaltinėlis;"4A klasė";83621946293;Ne;0;22;0;22
19285;Šaltinėlis;"4A klasė";67808618878;Ne;0;22;0;22
19286;Šaltinėlis;"4A klasė";1278910777;Ne;0;3;0;3
19287;Šaltinėlis;"4A klasė";9647785988;Ne;0;2;0;2
19288;Šaltinėlis;"4A klasė";82671662416;Ne;0;2;0;2
19289;Šaltinėlis;"4A klasė";54025577281;Ne;0;3;0;3
19290;Šaltinėlis;"4A klasė";488285764;Ne;0;2;0;2
19291;Šaltinėlis;"4A klasė";29482180151;Ne;0;2;0;2
19292;Šaltinėlis;"4A klasė";54753218491;Ne;0;2;0;2
19293;Šaltinėlis;"4A klasė";86029472773;Ne;0;2;0;2
19294;Šaltinėlis;"4A klasė";64821172553;Ne;0;22;0;22
19295;Šaltinėlis;"4A klasė";5744976843;Ne;0;7;0;7
19296;Šaltinėlis;"4A klasė";25459069972;Ne;0;2;0;2
19297;Šaltinėlis;"4A klasė";6669392157;Ne;0;2;0;2
19298;Šaltinėlis;"4A klasė";89358384113;Ne;0;4;0;4
19299;Šaltinėlis;"4A klasė";28956971978;Ne;0;3;0;3
19300;Šaltinėlis;"4A klasė";4050444191;Ne;0;4;0;4
19301;Šaltinėlis;"4A klasė";89093437170;Ne;0;7;0;7
19302;Šaltinėlis;"4A klasė";51872331010;Ne;0;7;0;7
19303;Šaltinėlis;1B;7723290276;Ne;0;3;0;3
19304;Šaltinėlis;1B;3660687688;Ne;0;2;0;2
19305;Šaltinėlis;1B;1348724947;Ne;0;22;0;22
19306;Šaltinėlis;1B;2230403251;Ne;0;2;0;2
19307;Šaltinėlis;1B;4387568448;Ne;0;2;0;2
19308;Šaltinėlis;1B;2658414287;Ne;0;9;0;9
19309;Šaltinėlis;1B;7918995181;Ne;0;15;0;15
19310;Šaltinėlis;1B;3638565578;Ne;0;2;0;2
19311;Šaltinėlis;1B;1367082230;Ne;0;1;0;1
19312;Šaltinėlis;1B;5869977541;Ne;0;2;0;2
19313;Šaltinėlis;1B;5099997904;Ne;0;2;0;2
19314;Šaltinėlis;1B;8721116918;Ne;0;7;0;7
19315;Šaltinėlis;1B;3609939325;Ne;0;2;0;2
19316;Šaltinėlis;1B;7211267255;Ne;0;4;0;4
19317;Šaltinėlis;1B;9108653045;Ne;0;2;0;2
19318;Šaltinėlis;1B;6816346946;Ne;0;12;0;12
19319;Šaltinėlis;1B;5495098615;Ne;0;3;0;3
19320;Šaltinėlis;1B;9762392403;Ne;0;3;0;3
19321;Gabijėlė;GANDRIUKŲ;4498088417;Ne;0;9;0;9
19322;Gabijėlė;GANDRIUKŲ;2277489032;Ne;0;0;2;2
19323;Gabijėlė;GANDRIUKŲ;8994076883;Ne;0;0;2;2
19324;Gabijėlė;GANDRIUKŲ;7087892822;Ne;0;3;2;5
19325;Gabijėlė;GANDRIUKŲ;5057272847;Ne;0;3;5;8
19326;Gabijėlė;GANDRIUKŲ;3532989398;Ne;0;3;1;4
19327;Gabijėlė;GANDRIUKŲ;2215880644;Ne;0;4;3;7
19328;Gabijėlė;GANDRIUKŲ;3799003783;Ne;8;2;2;12
19329;Gabijėlė;GANDRIUKŲ;5513530983;Ne;0;2;0;2
19330;Gabijėlė;GANDRIUKŲ;6004026516;Ne;0;4;0;4
19331;Gabijėlė;GANDRIUKŲ;4634029418;Ne;0;2;0;2
19332;Gabijėlė;GANDRIUKŲ;2491503656;Ne;0;7;0;7
19333;Gabijėlė;GANDRIUKŲ;8904768332;Ne;0;1;2;3
19334;Gabijėlė;GANDRIUKŲ;5715645968;Ne;1;2;2;5
19335;Gabijėlė;GANDRIUKŲ;8572833698;Ne;2;0;2;4
19336;Gabijėlė;GANDRIUKŲ;5054419205;Ne;0;4;0;4
19337;Gabijėlė;GANDRIUKŲ;9929652398;Ne;0;2;0;2
19338;Gabijėlė;GANDRIUKŲ;7530976246;Ne;0;2;4;6
19339;Gabijėlė;GANDRIUKŲ;3920525584;Ne;0;0;2;2
19340;Gabijėlė;GANDRIUKŲ;2682112101;Ne;0;4;0;4
19341;Gabijėlė;GANDRIUKŲ;5312189552;Ne;0;3;0;3
19342;Gabijėlė;LAKŠTINGALIUKŲ;7019425859;Ne;0;10;0;10
19343;Gabijėlė;LAKŠTINGALIUKŲ;1611004144;Ne;0;9;0;9
19344;Gabijėlė;LAKŠTINGALIUKŲ;5862882027;Ne;8;2;2;12
19345;Gabijėlė;LAKŠTINGALIUKŲ;8798786098;Ne;8;2;3;13
19346;Gabijėlė;LAKŠTINGALIUKŲ;8035360208;Ne;0;11;0;11
19347;Gabijėlė;LAKŠTINGALIUKŲ;2384469423;Ne;1;2;4;7
19348;Gabijėlė;LAKŠTINGALIUKŲ;8926268619;Ne;12;2;4;18
19349;Gabijėlė;LAKŠTINGALIUKŲ;9480021589;Ne;0;1;0;1
19350;Gabijėlė;LAKŠTINGALIUKŲ;3215569531;Ne;0;1;0;1
19351;Gabijėlė;LAKŠTINGALIUKŲ;5992403900;Ne;0;1;2;3
19352;Gabijėlė;LAKŠTINGALIUKŲ;9116943443;Ne;6;1;4;11
19353;Gabijėlė;LAKŠTINGALIUKŲ;8383489040;Ne;0;1;0;1
19354;Gabijėlė;LAKŠTINGALIUKŲ;6927730664;Ne;9;1;2;12
19355;Gabijėlė;LAKŠTINGALIUKŲ;7444385669;Ne;9;2;2;13
19356;Gabijėlė;LAKŠTINGALIUKŲ;9398722388;Ne;0;8;0;8
19357;Gabijėlė;LAKŠTINGALIUKŲ;9491327802;Ne;8;0;2;10
19358;Gabijėlė;LAKŠTINGALIUKŲ;6730947751;Ne;0;3;1;4
19359;Gabijėlė;LAKŠTINGALIUKŲ;2550300871;Ne;0;6;0;6
19360;Gabijėlė;LAKŠTINGALIUKŲ;9324498850;Ne;7;5;2;14
19361;Gabijėlė;LAKŠTINGALIUKŲ;8314088016;Ne;3;0;2;5
19362;Gabijėlė;LAKŠTINGALIUKŲ;6295299651;Ne;3;0;2;5
19363;Gabijėlė;LAKŠTINGALIUKŲ;9694544564;Ne;5;0;2;7
19364;Gabijėlė;ŽVIRBLIUKŲ;7043775905;Ne;8;3;2;13
19365;Gabijėlė;ŽVIRBLIUKŲ;4475530177;Ne;0;2;1;3
19366;Gabijėlė;ŽVIRBLIUKŲ;5743861607;Ne;0;4;2;6
19367;Gabijėlė;ŽVIRBLIUKŲ;7410541320;Ne;0;4;0;4
19368;Gabijėlė;ŽVIRBLIUKŲ;4493192224;Ne;3;4;2;9
19369;Gabijėlė;ŽVIRBLIUKŲ;9259964641;Ne;0;2;0;2
19370;Gabijėlė;ŽVIRBLIUKŲ;3268231136;Ne;16;2;2;20
19371;Gabijėlė;ŽVIRBLIUKŲ;5332825339;Ne;0;3;0;3
19372;Gabijėlė;ŽVIRBLIUKŲ;2264669298;Ne;0;6;0;6
19373;Gabijėlė;ŽVIRBLIUKŲ;5942625633;Ne;0;3;1;4
19374;Gabijėlė;ŽVIRBLIUKŲ;3155403180;Ne;0;2;2;4
19375;Gabijėlė;ŽVIRBLIUKŲ;1158461185;Ne;0;2;2;4
19376;Gabijėlė;ŽVIRBLIUKŲ;3218415151;Ne;12;3;2;17
19377;Gabijėlė;ŽVIRBLIUKŲ;8823299212;Ne;0;2;1;3
19378;Gabijėlė;ŽVIRBLIUKŲ;8879972953;Ne;3;2;4;9
19379;Gabijėlė;ŽVIRBLIUKŲ;9627906252;Ne;0;2;0;2
19380;Gabijėlė;ŽVIRBLIUKŲ;1725665169;Ne;0;2;0;2
19381;Gabijėlė;ŽVIRBLIUKŲ;6674038058;Ne;0;2;0;2
19382;Gabijėlė;ŽVIRBLIUKŲ;4146051969;Ne;2;1;2;5
19383;Gabijėlė;ŽVIRBLIUKŲ;6604681536;Ne;3;1;2;6
19384;Gabijėlė;ŽVIRBLIUKŲ;1273722177;Ne;0;6;0;6
19385;Gabijėlė;ŽVIRBLIUKŲ;6310234092;Ne;3;2;2;7
19386;Gabijėlė;ŽVIRBLIUKŲ;6154378055;Ne;15;0;4;19
19387;Gabijėlė;ŽVIRBLIUKŲ;9259673720;Ne;4;2;2;8
19388;Gabijėlė;ŽVIRBLIUKŲ;8292463617;Ne;0;2;2;4
19389;Gabijėlė;GENIUKŲ;9215101617;Ne;3;0;4;7
19390;Gabijėlė;GENIUKŲ;4827797140;Ne;0;10;0;10
19391;Gabijėlė;GENIUKŲ;6931780900;Ne;8;1;2;11
19392;Gabijėlė;GENIUKŲ;2030555139;Ne;3;3;2;8
19393;Gabijėlė;GENIUKŲ;4908791060;Ne;0;0;1;1
19394;Gabijėlė;GENIUKŲ;7261932151;Ne;0;1;2;3
19395;Gabijėlė;GENIUKŲ;2539692903;Ne;0;4;0;4
19396;Gabijėlė;GENIUKŲ;6923511443;Ne;2;8;2;12
19397;Gabijėlė;GENIUKŲ;8384795164;Ne;0;4;3;7
19398;Gabijėlė;GENIUKŲ;3209491491;Ne;8;1;2;11
19399;Gabijėlė;GENIUKŲ;8185042446;Ne;8;0;5;13
19400;Gabijėlė;GENIUKŲ;9413654318;Ne;0;0;6;6
19401;Gabijėlė;GENIUKŲ;5297866989;Ne;0;2;0;2
19402;Gabijėlė;GENIUKŲ;4664011011;Ne;8;0;4;12
19403;Gabijėlė;GENIUKŲ;4490619514;Ne;3;0;2;5
19404;Gabijėlė;GENIUKŲ;1021920133;Ne;0;0;6;6
19405;Gabijėlė;GENIUKŲ;1345747441;Ne;3;0;12;15
19406;Gabijėlė;GENIUKŲ;6469409776;Ne;1;0;5;6
19407;Gabijėlė;GENIUKŲ;6539078572;Ne;0;9;0;9
19408;Gabijėlė;GENIUKŲ;7509112343;Ne;3;2;3;8
19409;Gabijėlė;GENIUKŲ;1713559750;Ne;3;0;2;5
19410;Gabijėlė;DAGILIUKŲ;9348393550;Ne;4;2;5;11
19411;Gabijėlė;DAGILIUKŲ;4264925447;Ne;4;2;5;11
19412;Gabijėlė;DAGILIUKŲ;9120107749;Ne;0;2;3;5
19413;Gabijėlė;DAGILIUKŲ;9494313873;Ne;0;2;1;3
19414;Gabijėlė;DAGILIUKŲ;9783343968;Ne;0;2;0;2
19415;Gabijėlė;DAGILIUKŲ;3017939983;Ne;0;2;0;2
19416;Gabijėlė;DAGILIUKŲ;4462129182;Ne;12;2;2;16
19417;Gabijėlė;DAGILIUKŲ;9503639471;Ne;0;2;1;3
19418;Gabijėlė;DAGILIUKŲ;1988597157;Ne;3;2;3;8
19419;Gabijėlė;DAGILIUKŲ;9895518740;Ne;6;2;4;12
19420;Gabijėlė;DAGILIUKŲ;9449023766;Ne;0;5;0;5
19421;Gabijėlė;DAGILIUKŲ;1286688629;Ne;5;2;2;9
19422;Gabijėlė;DAGILIUKŲ;1455856766;Ne;1;2;2;5
19423;Gabijėlė;DAGILIUKŲ;3700639354;Ne;0;3;0;3
19424;Gabijėlė;DAGILIUKŲ;6438144206;Ne;3;1;4;8
19425;Gabijėlė;DAGILIUKŲ;8662914262;Ne;0;17;0;17
19426;Gabijėlė;DAGILIUKŲ;9280283478;Ne;7;0;3;10
19427;Gabijėlė;DAGILIUKŲ;2254104149;Ne;0;2;0;2
19428;Gabijėlė;DAGILIUKŲ;8078326688;Ne;0;2;1;3
19429;Gabijėlė;DAGILIUKŲ;2386980295;Ne;0;2;0;2
19430;Gabijėlė;DAGILIUKŲ;9581539166;Ne;9;2;3;14
19431;Gabijėlė;DAGILIUKŲ;3548399391;Ne;0;2;6;8
19432;Gabijėlė;DAGILIUKŲ;4328252445;Ne;5;2;3;10
19433;Gabijėlė;DAGILIUKŲ;9893869150;Ne;8;2;2;12
19434;Gabijėlė;PELEDŽIUKŲ;4170105224;Ne;0;5;1;6
19435;Gabijėlė;PELEDŽIUKŲ;5675574534;Ne;0;0;2;2
19436;Gabijėlė;PELEDŽIUKŲ;5163460269;Ne;0;1;1;2
19437;Gabijėlė;PELEDŽIUKŲ;1356830225;Ne;0;0;4;4
19438;Gabijėlė;PELEDŽIUKŲ;9265103627;Ne;0;0;2;2
19439;Gabijėlė;PELEDŽIUKŲ;9451897367;Ne;11;0;2;13
19440;Gabijėlė;PELEDŽIUKŲ;2128428173;Ne;5;0;5;10
19441;Gabijėlė;PELEDŽIUKŲ;7028670164;Ne;2;0;8;10
19442;Gabijėlė;PELEDŽIUKŲ;5481472116;Ne;2;0;2;4
19443;Gabijėlė;PELEDŽIUKŲ;2885913045;Ne;5;0;4;9
19444;Gabijėlė;PELEDŽIUKŲ;5869580147;Ne;0;0;4;4
19445;Gabijėlė;PELEDŽIUKŲ;7096789623;Ne;0;0;5;5
19446;Gabijėlė;PELEDŽIUKŲ;4724322463;Ne;0;8;0;8
19447;Gabijėlė;PELEDŽIUKŲ;1810898809;Taip;0;2;4;6
19448;Gabijėlė;PELEDŽIUKŲ;5801792404;Ne;9;0;4;13
19449;Gabijėlė;PELEDŽIUKŲ;5579070948;Ne;0;1;0;1
19450;Gabijėlė;PELEDŽIUKŲ;1076369632;Ne;3;0;3;6
19451;Gabijėlė;PELEDŽIUKŲ;8549800358;Ne;13;0;2;15
19452;Gabijėlė;PELEDŽIUKŲ;2048046055;Ne;0;0;4;4
19453;Gabijėlė;PELEDŽIUKŲ;8088806507;Ne;0;2;0;2
19454;Gabijėlė;PELEDŽIUKŲ;6728495961;Ne;3;0;6;9
19455;Gabijėlė;KREGZDŽIUKŲ;1759118326;Ne;0;13;0;13
19456;Gabijėlė;KREGZDŽIUKŲ;9533325351;Ne;0;12;0;12
19457;Gabijėlė;KREGZDŽIUKŲ;5407565441;Ne;3;0;3;6
19458;Gabijėlė;KREGZDŽIUKŲ;6845038692;Ne;0;8;0;8
19459;Gabijėlė;KREGZDŽIUKŲ;9683202312;Ne;0;2;1;3
19460;Gabijėlė;KREGZDŽIUKŲ;2357515455;Ne;7;0;2;9
19461;Gabijėlė;KREGZDŽIUKŲ;1574272380;Ne;0;20;0;20
19462;Gabijėlė;KREGZDŽIUKŲ;9675186834;Ne;11;0;5;16
19463;Gabijėlė;KREGZDŽIUKŲ;2634722171;Ne;4;2;4;10
19464;Gabijėlė;KREGZDŽIUKŲ;4317708029;Ne;0;20;0;20
19465;Gabijėlė;KREGZDŽIUKŲ;8555272917;Ne;0;7;0;7
19466;Gabijėlė;KREGZDŽIUKŲ;1142939183;Ne;0;7;0;7
19467;Gabijėlė;KREGZDŽIUKŲ;9676186208;Ne;0;6;0;6
19468;Gabijėlė;KREGZDŽIUKŲ;3584692524;Ne;2;2;2;6
19469;Gabijėlė;KREGZDŽIUKŲ;8613821848;Ne;13;0;4;17
19470;Gabijėlė;KREGZDŽIUKŲ;7038167942;Ne;0;6;0;6
19471;Gabijėlė;KREGZDŽIUKŲ;6570702235;Ne;3;1;3;7
19472;Gabijėlė;KREGZDŽIUKŲ;9528783892;Ne;0;14;0;14
19473;Gabijėlė;KREGZDŽIUKŲ;9358478209;Ne;0;0;2;2
19474;Gabijėlė;KREGZDŽIUKŲ;9030890792;Ne;0;0;2;2
19475;Gabijėlė;KREGZDŽIUKŲ;3031333199;Ne;0;0;3;3
19476;Gabijėlė;KREGZDŽIUKŲ;9116153981;Ne;3;0;2;5
19477;Gabijėlė;KREGZDŽIUKŲ;4575230225;Ne;6;1;2;9
19478;Gabijėlė;ZYLIUKŲ;7700700293;Ne;9;2;8;19
19479;Gabijėlė;ZYLIUKŲ;6759447513;Ne;0;4;0;4
19480;Gabijėlė;ZYLIUKŲ;1090635644;Ne;6;0;5;11
19481;Gabijėlė;ZYLIUKŲ;2764185879;Ne;3;2;2;7
19482;Gabijėlė;ZYLIUKŲ;6463161337;Ne;0;2;4;6
19483;Gabijėlė;ZYLIUKŲ;7921467223;Ne;1;0;2;3
19484;Gabijėlė;ZYLIUKŲ;6562965816;Ne;1;2;3;6
19485;Gabijėlė;ZYLIUKŲ;7047606048;Ne;0;2;0;2
19486;Gabijėlė;ZYLIUKŲ;6983092888;Ne;0;1;3;4
19487;Gabijėlė;ZYLIUKŲ;8362509831;Ne;5;0;2;7
19488;Gabijėlė;ZYLIUKŲ;4907669556;Ne;0;6;0;6
19489;Gabijėlė;ZYLIUKŲ;1947898190;Ne;5;6;5;16
19490;Gabijėlė;ZYLIUKŲ;2384174631;Ne;4;0;8;12
19491;Gabijėlė;ZYLIUKŲ;3181607628;Ne;6;0;4;10
19492;Gabijėlė;ZYLIUKŲ;4166561084;Ne;0;0;2;2
19493;Gabijėlė;ZYLIUKŲ;5736012194;Ne;4;0;4;8
19494;Gabijėlė;ZYLIUKŲ;4712780337;Ne;3;0;2;5
19495;Gabijėlė;ZYLIUKŲ;1004297369;Ne;3;0;7;10
19496;Gabijėlė;ZYLIUKŲ;7180444215;Ne;0;0;4;4
19497;Gabijėlė;ZYLIUKŲ;6446842432;Ne;4;0;4;8
19498;Gabijėlė;VOLUNGĖLIŲ;2099510027;Ne;7;1;4;12
19499;Gabijėlė;VOLUNGĖLIŲ;6842537434;Ne;0;6;0;6
19500;Gabijėlė;VOLUNGĖLIŲ;2227816651;Ne;0;6;0;6
19501;Gabijėlė;VOLUNGĖLIŲ;6956030813;Ne;13;2;2;17
19502;Gabijėlė;VOLUNGĖLIŲ;3902737481;Ne;0;8;0;8
19503;Gabijėlė;VOLUNGĖLIŲ;8733551230;Ne;14;0;2;16
19504;Gabijėlė;VOLUNGĖLIŲ;3763595874;Ne;0;3;0;3
19505;Gabijėlė;VOLUNGĖLIŲ;5360985745;Ne;0;0;2;2
19506;Gabijėlė;VOLUNGĖLIŲ;5737066080;Ne;4;2;4;10
19507;Gabijėlė;VOLUNGĖLIŲ;8312753333;Ne;0;8;0;8
19508;Gabijėlė;VOLUNGĖLIŲ;2523400466;Ne;0;1;0;1
19509;Gabijėlė;VOLUNGĖLIŲ;8569742033;Ne;3;2;2;7
19510;Gabijėlė;VOLUNGĖLIŲ;8327903800;Ne;9;2;3;14
19511;Gabijėlė;VOLUNGĖLIŲ;6960725029;Ne;15;0;4;19
19512;Gabijėlė;VOLUNGĖLIŲ;3995459990;Ne;0;12;0;12
19513;Gabijėlė;VOLUNGĖLIŲ;3267339129;Ne;0;1;2;3
19514;Gabijėlė;VOLUNGĖLIŲ;4304012457;Ne;9;0;4;13
19515;Gabijėlė;VOLUNGĖLIŲ;3324631994;Ne;0;1;0;1
19516;Gabijėlė;ANČIUKŲ;2107898976;Ne;0;9;0;9
19517;Gabijėlė;ANČIUKŲ;4000838897;Ne;5;4;4;13
19518;Gabijėlė;ANČIUKŲ;5060265729;Ne;6;1;4;11
19519;Gabijėlė;ANČIUKŲ;3972933727;Ne;8;1;4;13
19520;Gabijėlė;ANČIUKŲ;9657713903;Ne;9;0;4;13
19521;Gabijėlė;ANČIUKŲ;4087903129;Ne;0;6;0;6
19522;Gabijėlė;ANČIUKŲ;2398441433;Ne;1;0;4;5
19523;Gabijėlė;ANČIUKŲ;7049399327;Ne;10;0;2;12
19524;Gabijėlė;ANČIUKŲ;8611258788;Ne;14;0;2;16
19525;Gabijėlė;ANČIUKŲ;8834028360;Ne;8;0;4;12
19526;Gabijėlė;ANČIUKŲ;1002680245;Ne;12;0;4;16
19527;Gabijėlė;ANČIUKŲ;6393256426;Ne;8;0;4;12
19528;Gabijėlė;ANČIUKŲ;4692161807;Ne;0;0;2;2
19529;Gabijėlė;ANČIUKŲ;6040818549;Ne;9;5;2;16
19530;Gabijėlė;ANČIUKŲ;6481368028;Ne;15;0;4;19
19531;Gabijėlė;ANČIUKŲ;7590725504;Ne;0;1;0;1
19532;Gabijėlė;ANČIUKŲ;1230236612;Ne;7;0;4;11
19533;Gabijėlė;ANČIUKŲ;5776683791;Ne;1;0;0;1
19534;Gabijėlė;ANČIUKŲ;6850461646;Ne;0;0;4;4
19535;Gabijėlė;ANČIUKŲ;1525969706;Ne;8;0;2;10
19536;Gabijėlė;ANČIUKŲ;5310270057;Ne;5;1;2;8
19537;Gabijėlė;ANČIUKŲ;5124024813;Ne;3;0;2;5
19538;Gabijėlė;ANČIUKŲ;5925818434;Ne;5;0;2;7
19539;Gabijėlė;ANČIUKŲ;5925818434;Ne;5;0;2;7
19540;Gabijėlė;BALANDŽIUKŲ;3652632748;Ne;4;2;5;11
19541;Gabijėlė;BALANDŽIUKŲ;8514099621;Ne;2;0;3;5
19542;Gabijėlė;BALANDŽIUKŲ;6795173519;Ne;7;0;2;9
19543;Gabijėlė;BALANDŽIUKŲ;6748378606;Ne;0;4;1;5
19544;Gabijėlė;BALANDŽIUKŲ;7558307454;Ne;8;0;2;10
19545;Gabijėlė;BALANDŽIUKŲ;1612957739;Ne;11;0;4;15
19546;Gabijėlė;BALANDŽIUKŲ;8388297947;Ne;2;0;4;6
19547;Gabijėlė;BALANDŽIUKŲ;7888013969;Ne;6;0;2;8
19548;Gabijėlė;BALANDŽIUKŲ;3011163947;Ne;6;0;2;8
19549;Gabijėlė;BALANDŽIUKŲ;5788152675;Ne;5;0;5;10
19550;Gabijėlė;BALANDŽIUKŲ;6296983654;Ne;0;7;0;7
19551;Gabijėlė;BALANDŽIUKŲ;4160646449;Ne;11;2;4;17
19552;Gabijėlė;BALANDŽIUKŲ;1467864178;Ne;2;0;2;4
19553;Gabijėlė;BALANDŽIUKŲ;2185615215;Ne;2;0;5;7
19554;Gabijėlė;BALANDŽIUKŲ;4959332778;Ne;3;0;2;5
19555;Gabijėlė;BALANDŽIUKŲ;9279727778;Ne;0;2;0;2
19556;Gabijėlė;BALANDŽIUKŲ;7224216275;Ne;0;9;3;12
19557;Gabijėlė;BALANDŽIUKŲ;7447079902;Ne;4;2;4;10
19558;Gabijėlė;BALANDŽIUKŲ;2289016022;Ne;7;0;4;11
19559;Gabijėlė;BALANDŽIUKŲ;8698788528;Ne;3;0;2;5
19560;Gabijėlė;BALANDŽIUKŲ;8965185578;Ne;4;0;4;8
19561;Gabijėlė;VYTURIUKŲ;6131649116;Ne;8;0;14;22
19562;Gabijėlė;VYTURIUKŲ;8461048184;Ne;6;0;4;10
19563;Gabijėlė;VYTURIUKŲ;7894667201;Ne;0;0;6;6
19564;Gabijėlė;VYTURIUKŲ;3960795412;Ne;3;0;2;5
19565;Gabijėlė;VYTURIUKŲ;3973977318;Ne;0;0;2;2
19566;Gabijėlė;VYTURIUKŲ;3454061135;Ne;2;0;5;7
19567;Gabijėlė;VYTURIUKŲ;9628900843;Ne;0;0;3;3
19568;Gabijėlė;VYTURIUKŲ;5769331689;Ne;1;0;2;3
19569;Gabijėlė;VYTURIUKŲ;5652244967;Ne;8;5;2;15
19570;Gabijėlė;VYTURIUKŲ;3343196830;Ne;8;0;2;10
19571;Gabijėlė;VYTURIUKŲ;1523190444;Ne;3;0;2;5
19572;Gabijėlė;VYTURIUKŲ;7295985579;Ne;3;0;2;5
19573;Gabijėlė;VYTURIUKŲ;6834871835;Ne;8;0;3;11
19574;Gabijėlė;VYTURIUKŲ;1185216449;Ne;0;7;0;7
19575;Gabijėlė;VYTURIUKŲ;6107630313;Ne;9;0;3;12
19576;Gabijėlė;VYTURIUKŲ;4248856615;Ne;0;3;0;3
19577;Gabijėlė;VYTURIUKŲ;4355537090;Ne;0;0;2;2
19578;Gabijėlė;STRAZDELIŲ;7010757358;Ne;8;2;2;12
19579;Gabijėlė;STRAZDELIŲ;7721807115;Ne;10;0;2;12
19580;Gabijėlė;STRAZDELIŲ;1317441841;Ne;0;5;0;5
19581;Gabijėlė;STRAZDELIŲ;4496696197;Ne;2;0;2;4
19582;Gabijėlė;STRAZDELIŲ;1995157457;Ne;7;2;2;11
19583;Gabijėlė;STRAZDELIŲ;5312756424;Ne;0;0;2;2
19584;Gabijėlė;STRAZDELIŲ;8853553967;Ne;1;2;2;5
19585;Gabijėlė;STRAZDELIŲ;7873372479;Ne;13;2;2;17
19586;Gabijėlė;STRAZDELIŲ;1843742298;Ne;6;1;2;9
19587;Gabijėlė;STRAZDELIŲ;6360474547;Ne;0;10;0;10
19588;Gabijėlė;STRAZDELIŲ;6137289651;Ne;7;0;4;11
19589;Gabijėlė;STRAZDELIŲ;7338336807;Ne;0;6;0;6
19590;Gabijėlė;STRAZDELIŲ;2831569080;Ne;3;4;2;9
19591;Gabijėlė;STRAZDELIŲ;7178485867;Ne;0;8;0;8
19592;Gabijėlė;LIEPSNELIŲ;3607805987;Ne;7;0;2;9
19593;Gabijėlė;LIEPSNELIŲ;5545178531;Ne;0;0;2;2
19594;Gabijėlė;LIEPSNELIŲ;6767640941;Ne;5;0;2;7
19595;Gabijėlė;LIEPSNELIŲ;9974370666;Ne;13;0;4;17
19596;Gabijėlė;LIEPSNELIŲ;9739945109;Ne;15;0;3;18
19597;Gabijėlė;LIEPSNELIŲ;5929075145;Ne;0;1;2;3
19598;Gabijėlė;LIEPSNELIŲ;5111623638;Ne;4;0;6;10
19599;Gabijėlė;LIEPSNELIŲ;6689082073;Ne;6;2;6;14
19600;Gabijėlė;LIEPSNELIŲ;5333058186;Ne;6;0;4;10
19601;Gabijėlė;LIEPSNELIŲ;8784967945;Ne;2;0;3;5
19602;Gabijėlė;LIEPSNELIŲ;5560227836;Ne;0;20;0;20
19603;Gabijėlė;LIEPSNELIŲ;2137785518;Ne;11;0;5;16
19604;Gabijėlė;GULBIUKŲ;5267166908;Ne;3;0;2;5
19605;Gabijėlė;GULBIUKŲ;5101043078;Ne;0;6;0;6
19606;Gabijėlė;GULBIUKŲ;2594203606;Ne;5;0;3;8
19607;Gabijėlė;GULBIUKŲ;9220191419;Ne;0;0;2;2
19608;Gabijėlė;GULBIUKŲ;3554373183;Ne;10;0;4;14
19609;Gabijėlė;GULBIUKŲ;9773341100;Ne;5;0;2;7
19610;Gabijėlė;GULBIUKŲ;4984087823;Ne;0;0;5;5
19611;Gabijėlė;GULBIUKŲ;6087116523;Ne;0;0;3;3
19612;Gabijėlė;GULBIUKŲ;8725246789;Ne;6;0;4;10
19613;Gabijėlė;GULBIUKŲ;8817074528;Ne;0;0;1;1
19614;Gabijėlė;GULBIUKŲ;1046603287;Ne;6;0;4;10
19615;Gabijėlė;GULBIUKŲ;8217857692;Ne;0;1;0;1
19616;Gabijėlė;GULBIUKŲ;4807870665;Ne;7;0;6;13
19617;Gabijėlė;GULBIUKŲ;5885231742;Ne;4;0;6;10
19618;Gabijėlė;SAKALĖLIŲ;7392240890;Ne;2;8;4;14
19619;Gabijėlė;SAKALĖLIŲ;1481910063;Ne;5;0;9;14
19620;Gabijėlė;SAKALĖLIŲ;8970842145;Ne;6;3;4;13
19621;Gabijėlė;SAKALĖLIŲ;8597241034;Ne;0;0;2;2
19622;Gabijėlė;SAKALĖLIŲ;5298975959;Ne;3;0;4;7
19623;Gabijėlė;SAKALĖLIŲ;2237979473;Ne;9;0;6;15
19624;Gabijėlė;SAKALĖLIŲ;3217755689;Ne;1;0;5;6
19625;Gabijėlė;SAKALĖLIŲ;8317843419;Ne;0;16;1;17
19626;Gabijėlė;SAKALĖLIŲ;8810727175;Ne;3;0;2;5
19627;Gabijėlė;SAKALĖLIŲ;5247539074;Ne;8;0;2;10
19628;Gabijėlė;SAKALĖLIŲ;5473567608;Ne;0;0;1;1
19629;Gabijėlė;SAKALĖLIŲ;6744589499;Ne;3;7;3;13
19630;Gabijėlė;SAKALĖLIŲ;4494016622;Ne;3;0;2;5
19631;Gabijėlė;SAKALĖLIŲ;7804655608;Ne;6;0;6;12
19632;Gabijėlė;SAKALĖLIŲ;2459512602;Ne;0;0;2;2
19633;Gabijėlė;GERVELIŲ;2000945646;Ne;11;0;4;15
19634;Gabijėlė;GERVELIŲ;7015425600;Ne;0;2;0;2
19635;Gabijėlė;GERVELIŲ;8783241759;Ne;20;0;2;22
19636;Gabijėlė;GERVELIŲ;9940768072;Ne;8;0;5;13
19637;Gabijėlė;GERVELIŲ;3634759008;Ne;5;0;4;9
19638;Gabijėlė;GERVELIŲ;3952209045;Ne;8;0;2;10
19639;Gabijėlė;GERVELIŲ;6031035788;Ne;0;0;1;1
19640;Gabijėlė;GERVELIŲ;6492217904;Ne;3;0;6;9
19641;Gabijėlė;GERVELIŲ;6977401578;Ne;4;0;4;8
19642;Gabijėlė;GERVELIŲ;1826223317;Ne;0;0;5;5
19643;Gabijėlė;GERVELIŲ;6121611546;Ne;6;0;2;8
19644;Gabijėlė;GERVELIŲ;2118463552;Ne;3;0;8;11
19645;Gabijėlė;GERVELIŲ;4895199396;Ne;0;0;1;1
19646;Gabijėlė;GERVELIŲ;3064541598;Ne;10;0;5;15
19647;"Pilaitukas (I. Kanto al. 7A)";BITUTĖS;8943142551;Ne;8;1;2;11
19648;"Pilaitukas (I. Kanto al. 7A)";BITUTĖS;6225968272;Ne;8;1;2;11
19649;"Pilaitukas (I. Kanto al. 7A)";BITUTĖS;2892275540;Ne;8;0;2;10
19650;"Pilaitukas (I. Kanto al. 7A)";BITUTĖS;5904710385;Ne;8;0;2;10
19651;"Pilaitukas (I. Kanto al. 7A)";BITUTĖS;1486895496;Ne;8;0;2;10
19652;"Pilaitukas (I. Kanto al. 7A)";BITUTĖS;1746050808;Ne;4;2;2;8
19653;"Pilaitukas (I. Kanto al. 7A)";BITUTĖS;9441608677;Ne;5;1;2;8
19654;"Pilaitukas (I. Kanto al. 7A)";BITUTĖS;7555601497;Ne;0;2;0;2
19655;"Pilaitukas (I. Kanto al. 7A)";BITUTĖS;5979852431;Ne;8;3;2;13
19656;"Pilaitukas (I. Kanto al. 7A)";BITUTĖS;9950619644;Ne;11;3;4;18
19657;"Pilaitukas (I. Kanto al. 7A)";BITUTĖS;2633256935;Ne;5;0;4;9
19658;"Pilaitukas (I. Kanto al. 7A)";BITUTĖS;8747053041;Ne;9;0;4;13
19659;"Pilaitukas (I. Kanto al. 7A)";BITUTĖS;6271751691;Ne;3;0;2;5
19660;"Pilaitukas (I. Kanto al. 7A)";BITUTĖS;9306169443;Ne;4;0;4;8
19661;"Pilaitukas (I. Kanto al. 7A)";BITUTĖS;1568651642;Ne;10;0;3;13
19662;"Pilaitukas (I. Kanto al. 7A)";BITUTĖS;5155899628;Ne;11;1;2;14
19663;"Pilaitukas (I. Kanto al. 7A)";BITUTĖS;5340877261;Ne;11;1;2;14
19664;"Pilaitukas (I. Kanto al. 7A)";BITUTĖS;6064545501;Ne;5;2;4;11
19665;"Pilaitukas (I. Kanto al. 7A)";BITUTĖS;3751157025;Ne;11;0;4;15
19666;"Pilaitukas (I. Kanto al. 7A)";ZUIKUČIAI;4118652467;Ne;3;3;2;8
19667;"Pilaitukas (I. Kanto al. 7A)";ZUIKUČIAI;1841240800;Ne;3;1;2;6
19668;"Pilaitukas (I. Kanto al. 7A)";ZUIKUČIAI;4710865219;Ne;3;1;2;6
19669;"Pilaitukas (I. Kanto al. 7A)";ZUIKUČIAI;6054821801;Ne;0;2;0;2
19670;"Pilaitukas (I. Kanto al. 7A)";ZUIKUČIAI;5691854235;Ne;1;0;2;3
19671;"Pilaitukas (I. Kanto al. 7A)";ZUIKUČIAI;3952708917;Ne;11;2;4;17
19672;"Pilaitukas (I. Kanto al. 7A)";ZUIKUČIAI;6337917448;Ne;3;4;2;9
19673;"Pilaitukas (I. Kanto al. 7A)";ZUIKUČIAI;3636976107;Ne;3;6;2;11
19674;"Pilaitukas (I. Kanto al. 7A)";ZUIKUČIAI;5026344198;Ne;1;2;2;5
19675;"Pilaitukas (I. Kanto al. 7A)";ZUIKUČIAI;8207648026;Ne;18;0;2;20
19676;"Pilaitukas (I. Kanto al. 7A)";ZUIKUČIAI;3921932673;Ne;18;0;2;20
19677;"Pilaitukas (I. Kanto al. 7A)";ZUIKUČIAI;5682244165;Ne;2;2;2;6
19678;"Pilaitukas (I. Kanto al. 7A)";ZUIKUČIAI;1290017967;Ne;0;6;0;6
19679;"Pilaitukas (I. Kanto al. 7A)";ZUIKUČIAI;5564784922;Ne;0;3;3;6
19680;"Pilaitukas (I. Kanto al. 7A)";ZUIKUČIAI;9150579386;Ne;7;0;4;11
19681;"Pilaitukas (I. Kanto al. 7A)";ZUIKUČIAI;6238537739;Ne;6;0;4;10
19682;"Pilaitukas (I. Kanto al. 7A)";ZUIKUČIAI;6876537203;Ne;8;0;2;10
19683;"Pilaitukas (I. Kanto al. 7A)";ZUIKUČIAI;4312344789;Ne;3;0;5;8
19684;"Pilaitukas (I. Kanto al. 7A)";ZUIKUČIAI;1040103641;Ne;2;0;2;4
19685;"Pilaitukas (I. Kanto al. 7A)";ANČIUKAI;3357097410;Ne;2;1;2;5
19686;"Pilaitukas (I. Kanto al. 7A)";ANČIUKAI;7773318230;Ne;5;7;2;14
19687;"Pilaitukas (I. Kanto al. 7A)";ANČIUKAI;4097742120;Ne;0;1;0;1
19688;"Pilaitukas (I. Kanto al. 7A)";ANČIUKAI;2923272767;Ne;0;1;0;1
19689;"Pilaitukas (I. Kanto al. 7A)";ANČIUKAI;8620858011;Ne;4;2;4;10
19690;"Pilaitukas (I. Kanto al. 7A)";ANČIUKAI;4286388920;Ne;1;0;2;3
19691;"Pilaitukas (I. Kanto al. 7A)";ANČIUKAI;3761827714;Ne;3;2;2;7
19692;"Pilaitukas (I. Kanto al. 7A)";ANČIUKAI;8643066116;Ne;3;2;2;7
19693;"Pilaitukas (I. Kanto al. 7A)";ANČIUKAI;1120549352;Ne;0;16;0;16
19694;"Pilaitukas (I. Kanto al. 7A)";ANČIUKAI;6888607864;Ne;10;2;2;14
19695;"Pilaitukas (I. Kanto al. 7A)";ANČIUKAI;7876850509;Ne;2;3;2;7
19696;"Pilaitukas (I. Kanto al. 7A)";ANČIUKAI;3035456834;Ne;0;3;0;3
19697;"Pilaitukas (I. Kanto al. 7A)";ANČIUKAI;2476942319;Ne;0;1;0;1
19698;"Pilaitukas (I. Kanto al. 7A)";ANČIUKAI;8033540052;Ne;8;0;2;10
19699;"Pilaitukas (I. Kanto al. 7A)";ANČIUKAI;7189824054;Ne;4;3;2;9
19700;"Pilaitukas (I. Kanto al. 7A)";ANČIUKAI;9332831979;Ne;1;2;2;5
19701;"Pilaitukas (I. Kanto al. 7A)";ANČIUKAI;5706918634;Ne;12;0;2;14
19702;"Pilaitukas (I. Kanto al. 7A)";ANČIUKAI;8954370321;Ne;3;2;4;9
19703;"Pilaitukas (I. Kanto al. 7A)";ANČIUKAI;1660462256;Ne;0;4;0;4
19704;"Pilaitukas (I. Kanto al. 7A)";MEŠKIUKAI;8577357264;Ne;0;1;1;2
19705;"Pilaitukas (I. Kanto al. 7A)";MEŠKIUKAI;5297214263;Ne;7;1;2;10
19706;"Pilaitukas (I. Kanto al. 7A)";MEŠKIUKAI;8268790017;Ne;5;0;2;7
19707;"Pilaitukas (I. Kanto al. 7A)";MEŠKIUKAI;2054626415;Ne;1;0;2;3
19708;"Pilaitukas (I. Kanto al. 7A)";MEŠKIUKAI;9742268665;Ne;14;6;0;20
19709;"Pilaitukas (I. Kanto al. 7A)";MEŠKIUKAI;8322980583;Ne;3;2;2;7
19710;"Pilaitukas (I. Kanto al. 7A)";MEŠKIUKAI;1610122884;Ne;1;2;4;7
19711;"Pilaitukas (I. Kanto al. 7A)";MEŠKIUKAI;3867660147;Ne;1;2;4;7
19712;"Pilaitukas (I. Kanto al. 7A)";MEŠKIUKAI;2365387089;Ne;0;0;1;1
19713;"Pilaitukas (I. Kanto al. 7A)";MEŠKIUKAI;9670329628;Ne;0;12;0;12
19714;"Pilaitukas (I. Kanto al. 7A)";MEŠKIUKAI;7750575554;Ne;0;3;0;3
19715;"Pilaitukas (I. Kanto al. 7A)";MEŠKIUKAI;9397435605;Ne;0;2;2;4
19716;"Pilaitukas (I. Kanto al. 7A)";MEŠKIUKAI;9187961584;Ne;0;2;1;3
19717;"Pilaitukas (I. Kanto al. 7A)";MEŠKIUKAI;7781507786;Ne;5;0;3;8
19718;"Pilaitukas (I. Kanto al. 7A)";MEŠKIUKAI;1362132769;Ne;0;1;2;3
19719;"Pilaitukas (I. Kanto al. 7A)";MEŠKIUKAI;3027792710;Ne;8;2;2;12
19720;"Pilaitukas (I. Kanto al. 7A)";MEŠKIUKAI;6807166920;Ne;0;4;0;4
19721;"Pilaitukas (I. Kanto al. 7A)";MEŠKIUKAI;1591276987;Ne;1;0;2;3
19722;"Pilaitukas (I. Kanto al. 7A)";MEŠKIUKAI;2830212921;Ne;1;5;2;8
19723;"Pilaitukas (I. Kanto al. 7A)";MEŠKIUKAI;9930306085;Ne;20;0;2;22
19724;"Pilaitukas (I. Kanto al. 7A)";ŽUVYTĖS;2317213283;Ne;0;1;2;3
19725;"Pilaitukas (I. Kanto al. 7A)";ŽUVYTĖS;4353195155;Ne;4;3;2;9
19726;"Pilaitukas (I. Kanto al. 7A)";ŽUVYTĖS;8913709682;Ne;0;3;0;3
19727;"Pilaitukas (I. Kanto al. 7A)";ŽUVYTĖS;8877142428;Ne;0;2;0;2
19728;"Pilaitukas (I. Kanto al. 7A)";ŽUVYTĖS;2862447956;Ne;0;4;0;4
19729;"Pilaitukas (I. Kanto al. 7A)";ŽUVYTĖS;8727175656;Ne;0;4;0;4
19730;"Pilaitukas (I. Kanto al. 7A)";ŽUVYTĖS;8207194955;Ne;0;2;1;3
19731;"Pilaitukas (I. Kanto al. 7A)";ŽUVYTĖS;5640802570;Ne;0;2;0;2
19732;"Pilaitukas (I. Kanto al. 7A)";ŽUVYTĖS;8993885764;Ne;0;2;0;2
19733;"Pilaitukas (I. Kanto al. 7A)";ŽUVYTĖS;9260893320;Ne;1;2;2;5
19734;"Pilaitukas (I. Kanto al. 7A)";ŽUVYTĖS;5710747769;Ne;6;1;2;9
19735;"Pilaitukas (I. Kanto al. 7A)";ŽUVYTĖS;5206637809;Ne;5;0;7;12
19736;"Pilaitukas (I. Kanto al. 7A)";ŽUVYTĖS;5288784331;Ne;0;0;1;1
19737;"Pilaitukas (I. Kanto al. 7A)";ŽUVYTĖS;9688421636;Ne;4;4;2;10
19738;"Pilaitukas (I. Kanto al. 7A)";ŽUVYTĖS;1704055907;Ne;4;2;6;12
19739;"Pilaitukas (I. Kanto al. 7A)";ŽUVYTĖS;8255398803;Ne;10;2;2;14
19740;"Pilaitukas (I. Kanto al. 7A)";ŽUVYTĖS;6426415533;Ne;0;1;2;3
19741;"Pilaitukas (I. Kanto al. 7A)";ŽUVYTĖS;9735358433;Ne;0;2;1;3
19742;"Pilaitukas (I. Kanto al. 7A)";ŽUVYTĖS;9878890346;Ne;3;2;2;7
19743;"Pilaitukas (I. Kanto al. 7A)";PAUKŠTELIAI;1295215465;Ne;1;2;2;5
19744;"Pilaitukas (I. Kanto al. 7A)";PAUKŠTELIAI;7082099968;Ne;8;5;2;15
19745;"Pilaitukas (I. Kanto al. 7A)";PAUKŠTELIAI;1253300093;Ne;0;2;0;2
19746;"Pilaitukas (I. Kanto al. 7A)";PAUKŠTELIAI;3037850837;Ne;8;2;2;12
19747;"Pilaitukas (I. Kanto al. 7A)";PAUKŠTELIAI;1729494874;Ne;0;2;0;2
19748;"Pilaitukas (I. Kanto al. 7A)";PAUKŠTELIAI;2242454299;Ne;1;2;3;6
19749;"Pilaitukas (I. Kanto al. 7A)";PAUKŠTELIAI;9793278788;Ne;0;2;0;2
19750;"Pilaitukas (I. Kanto al. 7A)";PAUKŠTELIAI;4082490488;Ne;10;2;2;14
19751;"Pilaitukas (I. Kanto al. 7A)";PAUKŠTELIAI;3345387791;Ne;6;2;2;10
19752;"Pilaitukas (I. Kanto al. 7A)";PAUKŠTELIAI;6099109886;Ne;0;2;2;4
19753;"Pilaitukas (I. Kanto al. 7A)";PAUKŠTELIAI;3541354283;Ne;0;1;0;1
19754;"Pilaitukas (I. Kanto al. 7A)";PAUKŠTELIAI;3519198814;Ne;1;2;2;5
19755;"Pilaitukas (I. Kanto al. 7A)";PAUKŠTELIAI;5740951665;Ne;3;2;2;7
19756;"Pilaitukas (I. Kanto al. 7A)";PAUKŠTELIAI;4591799893;Ne;0;22;0;22
19757;"Pilaitukas (I. Kanto al. 7A)";PAUKŠTELIAI;6308557885;Ne;8;2;2;12
19758;"Pilaitukas (I. Kanto al. 7A)";PAUKŠTELIAI;6514731102;Ne;9;2;2;13
19759;"Pilaitukas (I. Kanto al. 7A)";PAUKŠTELIAI;5988165204;Ne;3;0;0;3
19760;"Pilaitukas (I. Kanto al. 7A)";PAUKŠTELIAI;5331915157;Ne;0;2;0;2
19761;"Pilaitukas (I. Kanto al. 7A)";PAUKŠTELIAI;8169484415;Ne;8;3;2;13
19762;"Pilaitukas (I. Kanto al. 7A)";PAUKŠTELIAI;3159733673;Ne;2;3;3;8
19763;"Pilaitukas (I. Kanto al. 7A)";BORUŽĖLĖS;9898379569;Ne;1;2;3;6
19764;"Pilaitukas (I. Kanto al. 7A)";BORUŽĖLĖS;5185051301;Ne;4;2;2;8
19765;"Pilaitukas (I. Kanto al. 7A)";BORUŽĖLĖS;1731106179;Ne;2;13;2;17
19766;"Pilaitukas (I. Kanto al. 7A)";BORUŽĖLĖS;3784944532;Ne;11;2;4;17
19767;"Pilaitukas (I. Kanto al. 7A)";BORUŽĖLĖS;5186675623;Ne;3;0;2;5
19768;"Pilaitukas (I. Kanto al. 7A)";BORUŽĖLĖS;4317406707;Ne;0;2;1;3
19769;"Pilaitukas (I. Kanto al. 7A)";BORUŽĖLĖS;4589130143;Ne;0;1;1;2
19770;"Pilaitukas (I. Kanto al. 7A)";BORUŽĖLĖS;1944443723;Ne;7;2;3;12
19771;"Pilaitukas (I. Kanto al. 7A)";BORUŽĖLĖS;6280870972;Ne;10;2;6;18
19772;"Pilaitukas (I. Kanto al. 7A)";BORUŽĖLĖS;8380819975;Ne;0;2;2;4
19773;"Pilaitukas (I. Kanto al. 7A)";BORUŽĖLĖS;3849247594;Ne;6;2;5;13
19774;"Pilaitukas (I. Kanto al. 7A)";BORUŽĖLĖS;5201301769;Ne;1;2;4;7
19775;"Pilaitukas (I. Kanto al. 7A)";BORUŽĖLĖS;2555073719;Ne;5;2;3;10
19776;"Pilaitukas (I. Kanto al. 7A)";BORUŽĖLĖS;6835592675;Ne;2;2;8;12
19777;"Pilaitukas (I. Kanto al. 7A)";BORUŽĖLĖS;5066594124;Ne;7;5;4;16
19778;"Pilaitukas (I. Kanto al. 7A)";BORUŽĖLĖS;2336933998;Ne;3;0;2;5
19779;"Pilaitukas (I. Kanto al. 7A)";BORUŽĖLĖS;8047683859;Ne;10;2;2;14
19780;"Pilaitukas (I. Kanto al. 7A)";BORUŽĖLĖS;8694369154;Ne;10;2;2;14
19781;"Pilaitukas (I. Kanto al. 7A)";BORUŽĖLĖS;9587140991;Ne;15;2;4;21
19782;"Pilaitukas (I. Kanto al. 7A)";BORUŽĖLĖS;9405479859;Ne;1;2;2;5
19783;"Pilaitukas (I. Kanto al. 7A)";DRUGELIAI;2917197418;Ne;6;2;4;12
19784;"Pilaitukas (I. Kanto al. 7A)";DRUGELIAI;7807341574;Ne;6;2;2;10
19785;"Pilaitukas (I. Kanto al. 7A)";DRUGELIAI;5215800828;Ne;0;3;0;3
19786;"Pilaitukas (I. Kanto al. 7A)";DRUGELIAI;2414941263;Ne;0;0;9;9
19787;"Pilaitukas (I. Kanto al. 7A)";DRUGELIAI;7830059468;Ne;3;4;2;9
19788;"Pilaitukas (I. Kanto al. 7A)";DRUGELIAI;5901884512;Ne;0;0;5;5
19789;"Pilaitukas (I. Kanto al. 7A)";DRUGELIAI;8710069256;Ne;13;0;2;15
19790;"Pilaitukas (I. Kanto al. 7A)";DRUGELIAI;3609692114;Ne;13;0;2;15
19791;"Pilaitukas (I. Kanto al. 7A)";DRUGELIAI;9601295632;Ne;3;0;4;7
19792;"Pilaitukas (I. Kanto al. 7A)";DRUGELIAI;2768655540;Ne;7;6;3;16
19793;"Pilaitukas (I. Kanto al. 7A)";DRUGELIAI;1052452915;Ne;15;0;2;17
19794;"Pilaitukas (I. Kanto al. 7A)";DRUGELIAI;7478616628;Ne;0;5;0;5
19795;"Pilaitukas (I. Kanto al. 7A)";DRUGELIAI;1134083816;Ne;0;6;0;6
19796;"Pilaitukas (I. Kanto al. 7A)";DRUGELIAI;1452645899;Ne;2;2;2;6
19797;"Pilaitukas (I. Kanto al. 7A)";DRUGELIAI;8092422909;Ne;4;7;4;15
19798;"Pilaitukas (I. Kanto al. 7A)";DRUGELIAI;3211200431;Ne;3;1;2;6
19799;"Pilaitukas (I. Kanto al. 7A)";PELIUKAI;9246925227;Ne;14;0;2;16
19800;"Pilaitukas (I. Kanto al. 7A)";PELIUKAI;7808204054;Ne;2;1;2;5
19801;"Pilaitukas (I. Kanto al. 7A)";PELIUKAI;8769116377;Ne;4;0;2;6
19802;"Pilaitukas (I. Kanto al. 7A)";PELIUKAI;8501376663;Ne;0;2;0;2
19803;"Pilaitukas (I. Kanto al. 7A)";PELIUKAI;5421602723;Ne;0;6;0;6
19804;"Pilaitukas (I. Kanto al. 7A)";PELIUKAI;6754825353;Ne;0;5;0;5
19805;"Pilaitukas (I. Kanto al. 7A)";PELIUKAI;8168228529;Ne;0;1;0;1
19806;"Pilaitukas (I. Kanto al. 7A)";PELIUKAI;6833933586;Ne;3;4;2;9
19807;"Pilaitukas (I. Kanto al. 7A)";PELIUKAI;2416277190;Ne;5;0;3;8
19808;"Pilaitukas (I. Kanto al. 7A)";PELIUKAI;1270365948;Ne;2;1;2;5
19809;"Pilaitukas (I. Kanto al. 7A)";PELIUKAI;7604004800;Ne;0;5;0;5
19810;"Pilaitukas (I. Kanto al. 7A)";PELIUKAI;9556421129;Ne;0;0;1;1
19811;"Pilaitukas (I. Kanto al. 7A)";PELIUKAI;3954210452;Ne;7;0;2;9
19812;"Pilaitukas (I. Kanto al. 7A)";PELIUKAI;3651140874;Ne;3;1;2;6
19813;"Pilaitukas (I. Kanto al. 7A)";PELIUKAI;2823859128;Ne;0;1;0;1
19814;"Pilaitukas (I. Kanto al. 7A)";PELIUKAI;7750936973;Ne;0;6;0;6
19815;"Pilaitukas (I. Kanto al. 7A)";PELIUKAI;6185954940;Ne;3;0;4;7
19816;"Pilaitukas (I. Kanto al. 7A)";PELIUKAI;1781241002;Ne;3;0;3;6
19817;"Pilaitukas (I. Kanto al. 7A)";PELIUKAI;7766403199;Ne;2;2;3;7
19818;"Pilaitukas (I. Kanto al. 7A)";PELIUKAI;4383174356;Ne;0;0;1;1
19819;"Pilaitukas (I. Kanto al. 7A)";KAČIUKAI;1585341963;Ne;0;4;0;4
19820;"Pilaitukas (I. Kanto al. 7A)";KAČIUKAI;9038324313;Ne;0;2;0;2
19821;"Pilaitukas (I. Kanto al. 7A)";KAČIUKAI;7594484959;Ne;5;2;2;9
19822;"Pilaitukas (I. Kanto al. 7A)";KAČIUKAI;2463482642;Ne;3;0;2;5
19823;"Pilaitukas (I. Kanto al. 7A)";KAČIUKAI;3080014745;Ne;2;5;0;7
19824;"Pilaitukas (I. Kanto al. 7A)";KAČIUKAI;8009040109;Ne;0;2;0;2
19825;"Pilaitukas (I. Kanto al. 7A)";KAČIUKAI;2105380328;Ne;0;5;0;5
19826;"Pilaitukas (I. Kanto al. 7A)";KAČIUKAI;5326689274;Ne;3;2;3;8
19827;"Pilaitukas (I. Kanto al. 7A)";KAČIUKAI;9653647227;Ne;3;2;3;8
19828;"Pilaitukas (I. Kanto al. 7A)";KAČIUKAI;4022543517;Ne;0;2;0;2
19829;"Pilaitukas (I. Kanto al. 7A)";KAČIUKAI;3825942473;Ne;1;10;2;13
19830;"Pilaitukas (I. Kanto al. 7A)";KAČIUKAI;1611371690;Ne;2;0;10;12
19831;"Pilaitukas (I. Kanto al. 7A)";KAČIUKAI;9247501721;Ne;3;2;2;7
19832;"Pilaitukas (I. Kanto al. 7A)";KAČIUKAI;6436694057;Ne;0;2;3;5
19833;"Pilaitukas (I. Kanto al. 7A)";KAČIUKAI;9974310580;Ne;8;1;2;11
19834;"Pilaitukas (I. Kanto al. 7A)";KAČIUKAI;6235375235;Ne;0;2;6;8
19835;"Pilaitukas (I. Kanto al. 7A)";KAČIUKAI;9914575692;Ne;0;3;1;4
19836;"Pilaitukas (I. Kanto al. 7A)";KAČIUKAI;4341157841;Ne;0;0;1;1
19837;"Pilaitukas (I. Kanto al. 7A)";SAULUTĖS;2110996493;Ne;5;0;4;9
19838;"Pilaitukas (I. Kanto al. 7A)";SAULUTĖS;8306015313;Ne;13;4;2;19
19839;"Pilaitukas (I. Kanto al. 7A)";SAULUTĖS;8801358120;Ne;8;0;4;12
19840;"Pilaitukas (I. Kanto al. 7A)";SAULUTĖS;3927713632;Ne;8;0;4;12
19841;"Pilaitukas (I. Kanto al. 7A)";SAULUTĖS;1970389617;Ne;11;0;2;13
19842;"Pilaitukas (I. Kanto al. 7A)";SAULUTĖS;1351676866;Ne;9;0;3;12
19843;"Pilaitukas (I. Kanto al. 7A)";SAULUTĖS;4947536980;Ne;11;0;2;13
19844;"Pilaitukas (I. Kanto al. 7A)";SAULUTĖS;8484807843;Ne;10;1;4;15
19845;"Pilaitukas (I. Kanto al. 7A)";SAULUTĖS;8586082743;Ne;3;7;2;12
19846;"Pilaitukas (I. Kanto al. 7A)";SAULUTĖS;8693322790;Ne;5;0;6;11
19847;"Pilaitukas (I. Kanto al. 7A)";SAULUTĖS;1294204962;Ne;6;0;4;10
19848;"Pilaitukas (I. Kanto al. 7A)";SAULUTĖS;9041750889;Ne;0;22;0;22
19849;"Pilaitukas (I. Kanto al. 7A)";MENULIUKAI;1620231835;Ne;1;0;4;5
19850;"Pilaitukas (I. Kanto al. 7A)";MENULIUKAI;8873155277;Ne;13;2;2;17
19851;"Pilaitukas (I. Kanto al. 7A)";MENULIUKAI;1532252453;Ne;4;1;2;7
19852;"Pilaitukas (I. Kanto al. 7A)";MENULIUKAI;8225571149;Ne;7;2;4;13
19853;"Pilaitukas (I. Kanto al. 7A)";MENULIUKAI;7855892595;Ne;4;0;3;7
19854;"Pilaitukas (I. Kanto al. 7A)";MENULIUKAI;8058057477;Ne;8;2;4;14
19855;"Pilaitukas (I. Kanto al. 7A)";MENULIUKAI;7369920743;Ne;1;2;3;6
19856;"Pilaitukas (I. Kanto al. 7A)";MENULIUKAI;9106756175;Ne;15;0;2;17
19857;"Pilaitukas (I. Kanto al. 7A)";MENULIUKAI;5213352941;Ne;5;2;4;11
19858;"Pilaitukas (I. Kanto al. 7A)";MENULIUKAI;4811066607;Ne;0;0;2;2
19859;"Pilaitukas (I. Kanto al. 7A)";MENULIUKAI;3258857371;Ne;3;0;4;7
19860;"Pilaitukas (I. Kanto al. 7A)";MENULIUKAI;1025359287;Ne;1;0;4;5
19861;"Pilaitukas (I. Kanto al. 7A)";MENULIUKAI;4917076546;Ne;0;0;2;2
19862;"Pilaitukas (I. Kanto al. 7A)";MENULIUKAI;9800474455;Ne;12;2;4;18
19863;"Pilaitukas (I. Kanto al. 7A)";MENULIUKAI;2215317686;Ne;3;0;2;5
19864;"Pilaitukas (I. Kanto al. 7A)";MENULIUKAI;1528707459;Ne;22;0;0;22
19865;"Pilaitukas (I. Kanto al. 7A)";ĖŽIUKAI;6019760696;Ne;1;1;2;4
19866;"Pilaitukas (I. Kanto al. 7A)";ĖŽIUKAI;2342453729;Ne;0;3;0;3
19867;"Pilaitukas (I. Kanto al. 7A)";ĖŽIUKAI;2484405944;Ne;1;0;5;6
19868;"Pilaitukas (I. Kanto al. 7A)";ĖŽIUKAI;3283178614;Ne;8;0;4;12
19869;"Pilaitukas (I. Kanto al. 7A)";ĖŽIUKAI;4577941964;Ne;4;0;2;6
19870;"Pilaitukas (I. Kanto al. 7A)";ĖŽIUKAI;9099718179;Ne;5;0;2;7
19871;"Pilaitukas (I. Kanto al. 7A)";ĖŽIUKAI;7075283592;Ne;4;3;2;9
19872;"Pilaitukas (I. Kanto al. 7A)";ĖŽIUKAI;8312146534;Ne;0;2;0;2
19873;"Pilaitukas (I. Kanto al. 7A)";ĖŽIUKAI;3437303302;Ne;3;0;2;5
19874;"Pilaitukas (I. Kanto al. 7A)";ĖŽIUKAI;1955352672;Ne;3;0;4;7
19875;"Pilaitukas (I. Kanto al. 7A)";ĖŽIUKAI;2982393064;Ne;8;0;4;12
19876;"Pilaitukas (I. Kanto al. 7A)";ĖŽIUKAI;1251079289;Ne;3;1;2;6
19877;"Pilaitukas (I. Kanto al. 7A)";ĖŽIUKAI;2600504692;Ne;7;2;6;15
19878;"Pilaitukas (I. Kanto al. 7A)";ĖŽIUKAI;2717071397;Ne;9;2;3;14
19879;"Pilaitukas (I. Kanto al. 7A)";ĖŽIUKAI;9577523612;Ne;3;0;3;6
19880;"Pilaitukas (I. Kanto al. 7A)";ĖŽIUKAI;6509866343;Ne;8;0;8;16
19881;Švelnukas;Pelėdžiukai;8016531082;Ne;0;2;0;2
19882;Švelnukas;Pelėdžiukai;8219071968;Ne;3;0;2;5
19883;Švelnukas;Pelėdžiukai;9008722163;Ne;0;3;0;3
19884;Švelnukas;Pelėdžiukai;5699300764;Ne;0;5;2;7
19885;Švelnukas;Pelėdžiukai;1116279011;Ne;5;5;2;12
19886;Švelnukas;Pelėdžiukai;3892058023;Ne;5;4;2;11
19887;Švelnukas;Pelėdžiukai;5681611554;Ne;0;6;3;9
19888;Švelnukas;Pelėdžiukai;8589226595;Ne;2;0;3;5
19889;Švelnukas;Pelėdžiukai;9802064955;Ne;0;2;1;3
19890;Švelnukas;Pelėdžiukai;5041138716;Ne;0;0;1;1
19891;Švelnukas;Pelėdžiukai;3804532959;Ne;0;2;0;2
19892;Švelnukas;Pelėdžiukai;1462620951;Ne;0;1;0;1
19893;Švelnukas;Pelėdžiukai;8650902343;Ne;5;2;2;9
19894;Švelnukas;Pelėdžiukai;1409803554;Ne;0;3;0;3
19895;Švelnukas;Pelėdžiukai;1991507109;Ne;5;6;2;13
19896;Švelnukas;Pelėdžiukai;9808833734;Ne;0;0;1;1
19897;Švelnukas;Pelėdžiukai;6318581157;Ne;0;0;1;1
19898;Švelnukas;Pelėdžiukai;6069027553;Ne;0;0;3;3
19899;Švelnukas;Pelėdžiukai;7489142128;Ne;0;0;2;2
19900;Švelnukas;Ežiukai;4711482287;Ne;3;0;2;5
19901;Švelnukas;Ežiukai;2892176166;Ne;0;0;1;1
19902;Švelnukas;Ežiukai;2400781175;Ne;0;3;0;3
19903;Švelnukas;Ežiukai;6209334207;Ne;0;2;0;2
19904;Švelnukas;Ežiukai;1201550386;Ne;4;2;2;8
19905;Švelnukas;Ežiukai;2348752207;Ne;0;22;0;22
19906;Švelnukas;Ežiukai;1143579276;Ne;3;0;4;7
19907;Švelnukas;Ežiukai;3645855145;Ne;0;1;0;1
19908;Švelnukas;Ežiukai;9402567487;Ne;11;3;4;18
19909;Švelnukas;Ežiukai;3235768013;Taip;1;7;2;10
19910;Švelnukas;Ežiukai;9347355242;Ne;1;1;5;7
19911;Švelnukas;Ežiukai;3832011837;Ne;0;0;1;1
19912;Švelnukas;Ežiukai;9829912750;Ne;5;1;3;9
19913;Švelnukas;Ežiukai;9394816723;Ne;5;0;2;7
19914;Švelnukas;Ežiukai;6658530716;Ne;11;0;4;15
19915;Švelnukas;Ežiukai;6004580752;Ne;3;2;2;7
19916;Švelnukas;Ežiukai;4035050422;Ne;0;1;2;3
19917;Švelnukas;Ežiukai;4048599050;Ne;1;1;2;4
19918;Švelnukas;Ežiukai;9712567632;Ne;2;0;2;4
19919;Švelnukas;Ežiukai;2106591525;Ne;0;6;3;9
19920;Švelnukas;Švelnukai;4681584014;Ne;3;2;4;9
19921;Švelnukas;Švelnukai;6607578153;Ne;0;0;4;4
19922;Švelnukas;Švelnukai;8847738918;Ne;0;1;1;2
19923;Švelnukas;Švelnukai;1982267458;Ne;8;0;2;10
19924;Švelnukas;Švelnukai;9766734938;Ne;0;3;0;3
19925;Švelnukas;Švelnukai;3020524039;Ne;7;2;2;11
19926;Švelnukas;Švelnukai;1411710913;Ne;0;2;0;2
19927;Švelnukas;Švelnukai;5032829856;Ne;0;2;2;4
19928;Švelnukas;Švelnukai;5213589179;Ne;8;5;2;15
19929;Švelnukas;Švelnukai;4544791546;Ne;3;2;2;7
19930;Švelnukas;Švelnukai;1963518457;Ne;8;2;2;12
19931;Švelnukas;Švelnukai;4194249709;Ne;0;6;0;6
19932;Švelnukas;Švelnukai;5936821902;Ne;5;0;1;6
19933;Švelnukas;Švelnukai;7607215137;Ne;3;2;2;7
19934;Švelnukas;Švelnukai;4629757899;Ne;4;6;2;12
19935;Švelnukas;Švelnukai;6964997767;Ne;12;2;5;19
19936;Švelnukas;Švelnukai;8951810066;Ne;3;0;4;7
19937;Švelnukas;Švelnukai;2663990082;Ne;8;2;2;12
19938;Švelnukas;Švelnukai;6204286255;Ne;8;0;2;10
19939;Švelnukas;Švelnukai;5960966542;Ne;0;2;0;2
19940;Švelnukas;Boružiukai;3849957906;Ne;0;2;2;4
19941;Švelnukas;Boružiukai;5550841477;Ne;0;2;0;2
19942;Švelnukas;Boružiukai;9722532034;Ne;1;0;2;3
19943;Švelnukas;Boružiukai;1264256177;Ne;0;3;1;4
19944;Švelnukas;Boružiukai;1332533332;Ne;0;0;5;5
19945;Švelnukas;Boružiukai;4134678301;Ne;0;6;0;6
19946;Švelnukas;Boružiukai;8458233793;Ne;0;6;1;7
19947;Švelnukas;Boružiukai;7967996032;Ne;0;0;1;1
19948;Švelnukas;Boružiukai;8951980999;Ne;0;0;1;1
19949;Švelnukas;Boružiukai;4990399144;Ne;0;5;0;5
19950;Švelnukas;Boružiukai;9575767514;Ne;0;8;2;10
19951;Švelnukas;Boružiukai;6282137936;Ne;1;2;2;5
19952;Švelnukas;Boružiukai;9479536507;Ne;0;2;0;2
19953;Švelnukas;Boružiukai;2088128734;Ne;0;2;0;2
19954;Švelnukas;Boružiukai;2077614498;Ne;0;0;1;1
19955;Švelnukas;Boružiukai;3145935641;Ne;0;1;1;2
19956;Švelnukas;Boružiukai;4404904322;Ne;0;2;3;5
19957;Švelnukas;Boružiukai;8895028305;Ne;0;2;2;4
19958;Švelnukas;Boružiukai;4961854528;Ne;0;7;1;8
19959;Švelnukas;Boružiukai;4823928859;Ne;0;2;0;2
19960;Švelnukas;Smalsučiai;9558811523;Ne;3;0;4;7
19961;Švelnukas;Smalsučiai;5085517759;Ne;3;2;2;7
19962;Švelnukas;Smalsučiai;1661019352;Ne;0;7;0;7
19963;Švelnukas;Smalsučiai;5554625346;Ne;6;0;3;9
19964;Švelnukas;Smalsučiai;3282020958;Ne;6;0;3;9
19965;Švelnukas;Smalsučiai;2730288544;Ne;0;2;0;2
19966;Švelnukas;Smalsučiai;5805289419;Ne;0;0;3;3
19967;Švelnukas;Smalsučiai;1415899173;Ne;3;0;2;5
19968;Švelnukas;Smalsučiai;8193690277;Ne;0;2;0;2
19969;Švelnukas;Smalsučiai;3472774028;Ne;0;1;6;7
19970;Švelnukas;Smalsučiai;5845744917;Ne;18;2;2;22
19971;Švelnukas;Smalsučiai;6764222588;Ne;0;2;8;10
19972;Švelnukas;Smalsučiai;1840752560;Ne;6;3;7;16
19973;Švelnukas;Smalsučiai;8268391509;Ne;4;2;4;10
19974;Švelnukas;Smalsučiai;4467095100;Ne;0;0;10;10
19975;Švelnukas;Smalsučiai;7125883267;Ne;0;0;2;2
19976;Švelnukas;Smalsučiai;8210720087;Ne;3;1;2;6
19977;Švelnukas;Smalsučiai;4427274462;Ne;3;0;3;6
19978;Švelnukas;Smalsučiai;1836913588;Ne;2;0;2;4
19979;Švelnukas;Smalsučiai;1100719254;Ne;0;0;2;2
19980;Švelnukas;Smalsučiai;8829819783;Ne;0;2;20;22
19981;Švelnukas;Nykštukai;1058623863;Ne;8;1;2;11
19982;Švelnukas;Nykštukai;7987715134;Ne;1;3;4;8
19983;Švelnukas;Nykštukai;3455801077;Ne;4;0;2;6
19984;Švelnukas;Nykštukai;9371102717;Ne;5;0;2;7
19985;Švelnukas;Nykštukai;3576731010;Ne;0;0;2;2
19986;Švelnukas;Nykštukai;6714948468;Ne;1;0;2;3
19987;Švelnukas;Nykštukai;5969852813;Taip;0;22;0;22
19988;Švelnukas;Nykštukai;5483481191;Ne;0;0;5;5
19989;Švelnukas;Nykštukai;4169142642;Ne;3;0;2;5
19990;Švelnukas;Nykštukai;5097880045;Ne;2;6;2;10
19991;Švelnukas;Nykštukai;8572664468;Ne;2;0;8;10
19992;Švelnukas;Nykštukai;1983560609;Ne;11;1;4;16
19993;Švelnukas;Nykštukai;6135073159;Ne;5;2;2;9
19994;Švelnukas;Nykštukai;2507975729;Ne;3;0;2;5
19995;Švelnukas;Nykštukai;6731324414;Ne;2;0;4;6
19996;Švelnukas;Nykštukai;5066121542;Ne;4;0;3;7
19997;Švelnukas;Nykštukai;3173070733;Ne;0;4;0;4
19998;Boružėlė;"Nykštukai gudručiai";7736917485;Ne;0;2;11;13
19999;Boružėlė;"Nykštukai gudručiai";9520696660;Ne;0;2;0;2
20000;Boružėlė;"Nykštukai gudručiai";5691884576;Ne;0;2;0;2
20001;Boružėlė;"Nykštukai gudručiai";9193273478;Ne;1;2;2;5
20002;Boružėlė;"Nykštukai gudručiai";3237771499;Ne;4;6;2;12
20003;Boružėlė;"Nykštukai gudručiai";8359957290;Ne;4;4;2;10
20004;Boružėlė;"Nykštukai gudručiai";8141240094;Ne;0;2;20;22
20005;Boružėlė;"Nykštukai gudručiai";2349571778;Ne;3;1;2;6
20006;Boružėlė;"Nykštukai gudručiai";1894170218;Ne;3;0;6;9
20007;Boružėlė;"Nykštukai gudručiai";3509512899;Ne;2;1;2;5
20008;Boružėlė;"Nykštukai gudručiai";8888151470;Ne;2;1;2;5
20009;Boružėlė;"Nykštukai gudručiai";3430953692;Ne;3;11;2;16
20010;Boružėlė;"Nykštukai gudručiai";6166247730;Ne;0;1;0;1
20011;Boružėlė;"Nykštukai gudručiai";8365962523;Ne;0;4;0;4
20012;Boružėlė;"Nykštukai gudručiai";6876323023;Ne;0;1;0;1
20013;Boružėlė;"Nykštukai gudručiai";2744894565;Ne;3;3;2;8
20014;Boružėlė;"Nykštukai gudručiai";6590829182;Ne;1;2;2;5
20015;Boružėlė;"Nykštukai gudručiai";3129825206;Ne;0;10;0;10
20016;Boružėlė;"Nykštukai gudručiai";9771767352;Ne;3;7;2;12
20017;Boružėlė;"Nykštukai gudručiai";8789209196;Ne;0;2;0;2
20018;Boružėlė;"Nykštukai gudručiai";2571360077;Ne;0;3;0;3
20019;Boružėlė;"Nykštukai gudručiai";9078805020;Ne;1;1;2;4
20020;Boružėlė;"Saulės zuikučiai";4554260776;Ne;0;2;0;2
20021;Boružėlė;"Saulės zuikučiai";5298170118;Ne;3;4;2;9
20022;Boružėlė;"Saulės zuikučiai";2133849514;Ne;0;2;0;2
20023;Boružėlė;"Saulės zuikučiai";1116012068;Ne;0;2;3;5
20024;Boružėlė;"Saulės zuikučiai";1292298259;Ne;0;2;2;4
20025;Boružėlė;"Saulės zuikučiai";3130977416;Ne;0;1;0;1
20026;Boružėlė;"Saulės zuikučiai";7256396576;Ne;5;2;2;9
20027;Boružėlė;"Saulės zuikučiai";4323998138;Ne;0;0;2;2
20028;Boružėlė;"Saulės zuikučiai";2087238951;Ne;0;2;0;2
20029;Boružėlė;"Saulės zuikučiai";4509233532;Ne;0;2;0;2
20030;Boružėlė;"Saulės zuikučiai";3952645542;Ne;0;2;0;2
20031;Boružėlė;"Saulės zuikučiai";5516103398;Ne;0;0;8;8
20032;Boružėlė;"Saulės zuikučiai";8259586236;Ne;0;3;0;3
20033;Boružėlė;"Saulės zuikučiai";3955841578;Ne;0;3;0;3
20034;Boružėlė;"Saulės zuikučiai";1583223569;Ne;0;3;0;3
20035;Boružėlė;"Saulės zuikučiai";4433248526;Ne;0;2;0;2
20036;Boružėlė;"Saulės zuikučiai";1547802140;Ne;0;0;2;2
20037;Boružėlė;"Saulės zuikučiai";4020348640;Ne;0;0;1;1
20038;Boružėlė;"Saulės zuikučiai";2561969142;Ne;0;2;1;3
20039;Boružėlė;"Saulės zuikučiai";7262515868;Ne;0;2;0;2
20040;Boružėlė;"Saulės zuikučiai";6527254253;Ne;3;2;2;7
20041;Boružėlė;"Saulės zuikučiai";2515608520;Ne;1;1;2;4
20042;Boružėlė;Gėlytės;1146297996;Ne;0;3;2;5
20043;Boružėlė;Gėlytės;3288141024;Ne;4;0;4;8
20044;Boružėlė;Gėlytės;1166207929;Ne;0;4;0;4
20045;Boružėlė;Gėlytės;7956982615;Ne;0;2;0;2
20046;Boružėlė;Gėlytės;4637656311;Ne;5;0;4;9
20047;Boružėlė;Gėlytės;3226733236;Ne;2;2;2;6
20048;Boružėlė;Gėlytės;6070356395;Ne;3;3;2;8
20049;Boružėlė;Gėlytės;4180537253;Ne;5;4;2;11
20050;Boružėlė;Gėlytės;6722353853;Ne;9;2;4;15
20051;Boružėlė;Gėlytės;8376436755;Ne;0;1;0;1
20052;Boružėlė;Gėlytės;3300678477;Ne;0;2;0;2
20053;Boružėlė;Gėlytės;7763958937;Ne;2;9;2;13
20054;Boružėlė;Gėlytės;9855354210;Ne;6;0;2;8
20055;Boružėlė;Gėlytės;3354291446;Ne;5;1;4;10
20056;Boružėlė;Gėlytės;8520403894;Taip;20;0;2;22
20057;Boružėlė;Gėlytės;4268486154;Ne;4;0;4;8
20058;Boružėlė;Gėlytės;7614216150;Ne;7;2;2;11
20059;Boružėlė;Gėlytės;4448964310;Ne;2;5;3;10
20060;Boružėlė;Gėlytės;8205706322;Ne;9;2;4;15
20061;Boružėlė;Gėlytės;8834231529;Ne;8;0;4;12
20062;Boružėlė;Gėlytės;8929444125;Ne;3;0;7;10
20063;Boružėlė;Gėlytės;3604658753;Ne;1;2;5;8
20064;Boružėlė;Gėlytės;9255292099;Ne;0;4;0;4
20065;Boružėlė;Smalsutis;2629139832;Ne;0;1;0;1
20066;Boružėlė;Smalsutis;4125177837;Ne;0;4;2;6
20067;Boružėlė;Smalsutis;6734750713;Ne;5;2;7;14
20068;Boružėlė;Smalsutis;5456349784;Ne;0;0;5;5
20069;Boružėlė;Smalsutis;9615931888;Ne;2;0;0;2
20070;Boružėlė;Smalsutis;9993823313;Ne;13;2;2;17
20071;Boružėlė;Smalsutis;3891448188;Ne;0;0;5;5
20072;Boružėlė;Smalsutis;4606274286;Ne;6;1;2;9
20073;Boružėlė;Smalsutis;8956248864;Ne;3;0;3;6
20074;Boružėlė;Smalsutis;8239372270;Ne;4;4;2;10
20075;Boružėlė;Smalsutis;7132100212;Ne;8;0;5;13
20076;Boružėlė;Smalsutis;6367963436;Ne;0;10;2;12
20077;Boružėlė;Smalsutis;5220224249;Ne;0;0;2;2
20078;Boružėlė;Smalsutis;1969793682;Ne;0;2;4;6
20079;Boružėlė;Smalsutis;6767206150;Ne;0;1;2;3
20080;Boružėlė;Smalsutis;6430695398;Ne;0;7;1;8
20081;Boružėlė;Smalsutis;4859297816;Ne;4;0;6;10
20082;Boružėlė;Smalsutis;7089148766;Ne;3;1;2;6
20083;Boružėlė;Drugeliai;8357946299;Ne;0;2;0;2
20084;Boružėlė;Drugeliai;1130980139;Ne;0;3;2;5
20085;Boružėlė;Drugeliai;6463583187;Ne;0;4;0;4
20086;Boružėlė;Drugeliai;3136028536;Ne;3;1;2;6
20087;Boružėlė;Drugeliai;2211576663;Ne;0;2;0;2
20088;Boružėlė;Drugeliai;1559001916;Ne;2;1;2;5
20089;Boružėlė;Drugeliai;4233602822;Ne;0;3;1;4
20090;Boružėlė;Drugeliai;9463322491;Ne;0;3;0;3
20091;Boružėlė;Drugeliai;3108758436;Ne;0;1;1;2
20092;Boružėlė;Drugeliai;8482813204;Ne;0;10;0;10
20093;Boružėlė;Drugeliai;6369070055;Ne;0;0;3;3
20094;Boružėlė;Drugeliai;6902130914;Ne;0;0;2;2
20095;Boružėlė;Drugeliai;3459207879;Ne;1;2;2;5
20096;Boružėlė;Drugeliai;6980022864;Ne;0;6;0;6
20097;Boružėlė;Drugeliai;7756929745;Ne;0;2;0;2
20098;Boružėlė;Drugeliai;5726187445;Ne;0;1;2;3
20099;Boružėlė;Drugeliai;2308405580;Ne;0;0;1;1
20100;Boružėlė;Drugeliai;6049501362;Ne;0;1;0;1
20101;Boružėlė;Drugeliai;8213060214;Ne;7;0;2;9
20102;Boružėlė;Drugeliai;3331238309;Ne;7;0;4;11
20103;Boružėlė;Drugeliai;2783338563;Ne;0;2;0;2
20104;Boružėlė;Drugeliai;3271262071;Ne;0;2;0;2
20105;Boružėlė;Vyturėliai;7934628014;Ne;0;0;1;1
20106;Boružėlė;Vyturėliai;7887412867;Ne;0;1;0;1
20107;Boružėlė;Vyturėliai;6233993159;Ne;0;0;1;1
20108;Boružėlė;Vyturėliai;6721005189;Ne;0;2;0;2
20109;Boružėlė;Vyturėliai;3991218067;Ne;3;6;2;11
20110;Boružėlė;Vyturėliai;2104101406;Ne;4;1;2;7
20111;Boružėlė;Vyturėliai;8377410278;Ne;6;1;3;10
20112;Boružėlė;Vyturėliai;4928818565;Ne;0;5;2;7
20113;Boružėlė;Vyturėliai;5619719965;Ne;0;2;0;2
20114;Boružėlė;Vyturėliai;9822629428;Ne;2;2;2;6
20115;Boružėlė;Vyturėliai;9663535338;Ne;2;2;2;6
20116;Boružėlė;Vyturėliai;1929202434;Ne;3;0;2;5
20117;Boružėlė;Vyturėliai;4217116059;Ne;8;2;2;12
20118;Boružėlė;Vyturėliai;8165748779;Ne;4;1;4;9
20119;Boružėlė;Vyturėliai;7068409148;Ne;0;11;0;11
20120;Boružėlė;Vyturėliai;8434178580;Ne;3;1;6;10
20121;Boružėlė;Vyturėliai;1551933321;Ne;2;1;2;5
20122;Boružėlė;Vyturėliai;3281431237;Ne;2;0;0;2
20123;Boružėlė;Žvaigždutės;4990831292;Ne;3;0;2;5
20124;Boružėlė;Žvaigždutės;9838823214;Ne;1;2;2;5
20125;Boružėlė;Žvaigždutės;7825636053;Ne;0;2;0;2
20126;Boružėlė;Žvaigždutės;7901880926;Ne;3;2;4;9
20127;Boružėlė;Žvaigždutės;6242220139;Ne;0;2;0;2
20128;Boružėlė;Žvaigždutės;3489498503;Ne;3;3;2;8
20129;Boružėlė;Žvaigždutės;5274016839;Ne;0;2;0;2
20130;Boružėlė;Žvaigždutės;9720535449;Ne;0;1;0;1
20131;Boružėlė;Žvaigždutės;3140264242;Ne;0;2;0;2
20132;Boružėlė;Žvaigždutės;5307997577;Ne;7;2;3;12
20133;Boružėlė;Žvaigždutės;8916241914;Ne;0;2;0;2
20134;Boružėlė;Žvaigždutės;6724101421;Ne;0;2;0;2
20135;Boružėlė;Žvaigždutės;8820827882;Ne;0;4;2;6
20136;Boružėlė;Žvaigždutės;5242187638;Ne;0;2;0;2
20137;Boružėlė;Žvaigždutės;1799882790;Ne;0;2;0;2
20138;Boružėlė;Žvaigždutės;5420788580;Ne;0;4;4;8
20139;Boružėlė;Žvaigždutės;6130634131;Ne;5;0;4;9
20140;Boružėlė;Žvaigždutės;2075050639;Ne;8;0;2;10
20141;Boružėlė;Ąžuoliukai;1874865061;Ne;0;20;0;20
20142;Boružėlė;Ąžuoliukai;6820122408;Ne;3;1;2;6
20143;Boružėlė;Ąžuoliukai;6708666819;Ne;4;1;5;10
20144;Boružėlė;Ąžuoliukai;9818317963;Ne;3;3;3;9
20145;Boružėlė;Ąžuoliukai;6297693776;Ne;8;0;4;12
20146;Boružėlė;Ąžuoliukai;5401338963;Ne;0;4;1;5
20147;Boružėlė;Ąžuoliukai;8734782540;Ne;0;13;2;15
20148;Boružėlė;Ąžuoliukai;7065907155;Ne;0;2;1;3
20149;Boružėlė;Ąžuoliukai;4113917886;Ne;0;12;4;16
20150;Boružėlė;Ąžuoliukai;1608652924;Ne;1;10;7;18
20151;Boružėlė;Ąžuoliukai;3005601935;Ne;0;16;6;22
20152;Boružėlė;Ąžuoliukai;8752343077;Ne;0;8;0;8
20153;Boružėlė;Ąžuoliukai;4727351240;Ne;6;12;2;20
20154;Boružėlė;Ąžuoliukai;4497753570;Ne;0;7;9;16
20155;Boružėlė;Ąžuoliukai;1865891989;Ne;6;1;2;9
20156;Boružėlė;Ąžuoliukai;8739264310;Taip;4;10;2;16
20157;Boružėlė;Ąžuoliukai;3097874340;Ne;9;2;4;15
20158;Boružėlė;Ąžuoliukai;7149439740;Ne;0;14;8;22
20159;Boružėlė;Ąžuoliukai;1630903587;Ne;0;15;0;15
20160;Boružėlė;Ąžuoliukai;9964146295;Ne;1;0;2;3
20161;Boružėlė;Ąžuoliukai;9544043839;Ne;3;0;2;5
20162;Boružėlė;Saulutės;9492548829;Ne;6;2;2;10
20163;Boružėlė;Saulutės;5437943626;Ne;7;2;2;11
20164;Boružėlė;Saulutės;3503931241;Ne;4;2;2;8
20165;Boružėlė;Saulutės;8882070834;Ne;7;0;4;11
20166;Boružėlė;Saulutės;2999335505;Ne;3;0;2;5
20167;Boružėlė;Saulutės;6265279517;Ne;4;2;4;10
20168;Boružėlė;Saulutės;6275425512;Ne;15;0;3;18
20169;Boružėlė;Saulutės;2879726579;Ne;11;0;4;15
20170;Boružėlė;Saulutės;3953507461;Ne;7;4;2;13
20171;Boružėlė;Saulutės;1492091211;Ne;2;2;2;6
20172;Boružėlė;Saulutės;1830043506;Ne;2;2;2;6
20173;Boružėlė;Saulutės;5680510186;Ne;6;2;2;10
20174;Boružėlė;Saulutės;1152697871;Ne;3;8;2;13
20175;Boružėlė;Saulutės;1779839709;Ne;0;5;0;5
20176;Boružėlė;Saulutės;7652740249;Ne;3;3;2;8
20177;Boružėlė;Saulutės;7260471712;Ne;2;6;2;10
20178;Boružėlė;Saulutės;5064892417;Ne;0;2;0;2
20179;Boružėlė;Saulutės;8577301586;Ne;0;3;0;3
20180;Boružėlė;Saulutės;8660954142;Ne;0;3;0;3
20181;Boružėlė;Saulutės;3093287452;Ne;0;0;2;2
20182;Boružėlė;Saulutės;7596876368;Ne;3;2;3;8
20183;Boružėlė;Ežiukai;8195442951;Ne;0;4;6;10
20184;Boružėlė;Ežiukai;6448688592;Ne;0;4;1;5
20185;Boružėlė;Ežiukai;2429696310;Ne;0;4;3;7
20186;Boružėlė;Ežiukai;9893643199;Ne;3;9;2;14
20187;Boružėlė;Ežiukai;3112016309;Ne;8;0;4;12
20188;Boružėlė;Ežiukai;5394149649;Ne;8;0;4;12
20189;Boružėlė;Ežiukai;9391811395;Ne;0;8;0;8
20190;Boružėlė;Ežiukai;8167376712;Ne;0;2;0;2
20191;Boružėlė;Ežiukai;1784594085;Ne;0;4;0;4
20192;Boružėlė;Ežiukai;9423458813;Ne;0;4;1;5
20193;Boružėlė;Ežiukai;5825164520;Ne;0;2;0;2
20194;Boružėlė;Ežiukai;7190980006;Ne;2;4;2;8
20195;Boružėlė;Ežiukai;7459531236;Ne;6;0;6;12
20196;Boružėlė;Ežiukai;8818358360;Ne;6;0;6;12
20197;Boružėlė;Ežiukai;1693082285;Ne;0;7;0;7
20198;Boružėlė;Ežiukai;2926620929;Ne;0;10;0;10
20199;Boružėlė;Ežiukai;6609156790;Ne;0;6;0;6
20200;Boružėlė;Ežiukai;8291389794;Ne;3;2;2;7
20201;Boružėlė;Ežiukai;2524469162;Ne;0;1;0;1
20202;Boružėlė;Ežiukai;5492228053;Ne;0;4;1;5
20203;Boružėlė;Ežiukai;6087811262;Ne;1;2;4;7
20204;Boružėlė;Boružiukai;8944790932;Ne;2;2;2;6
20205;Boružėlė;Boružiukai;2298750617;Ne;0;0;1;1
20206;Boružėlė;Boružiukai;3097217902;Ne;6;2;2;10
20207;Boružėlė;Boružiukai;6026505923;Ne;3;0;2;5
20208;Boružėlė;Boružiukai;4771951587;Ne;13;2;2;17
20209;Boružėlė;Boružiukai;8868736347;Ne;0;7;0;7
20210;Boružėlė;Boružiukai;3814031203;Ne;4;0;2;6
20211;Boružėlė;Boružiukai;1070536820;Ne;0;21;0;21
20212;Boružėlė;Boružiukai;6856426845;Ne;1;0;3;4
20213;Boružėlė;Boružiukai;8512180544;Ne;3;1;2;6
20214;Boružėlė;Boružiukai;3209486458;Ne;0;4;0;4
20215;Boružėlė;Boružiukai;3972950428;Ne;3;3;4;10
20216;Boružėlė;Boružiukai;6010385301;Ne;0;1;0;1
20217;Boružėlė;Boružiukai;2304719318;Ne;13;2;4;19
20218;Boružėlė;Boružiukai;5667227930;Ne;2;0;3;5
20219;Boružėlė;Boružiukai;5545252373;Ne;0;7;0;7
20220;Boružėlė;Nykštukai;1966066642;Ne;8;0;2;10
20221;Boružėlė;Nykštukai;6267999965;Ne;0;1;0;1
20222;Boružėlė;Nykštukai;6776735311;Ne;4;2;4;10
20223;Boružėlė;Nykštukai;6221965115;Ne;5;0;6;11
20224;Boružėlė;Nykštukai;2657554726;Ne;2;0;2;4
20225;Boružėlė;Nykštukai;2930463607;Ne;0;1;0;1
20226;Boružėlė;Nykštukai;6529896335;Ne;0;2;3;5
20227;Boružėlė;Nykštukai;6273128752;Ne;11;3;2;16
20228;Boružėlė;Nykštukai;6733644286;Ne;0;2;1;3
20229;Boružėlė;Nykštukai;2984478360;Ne;0;2;2;4
20230;Boružėlė;Nykštukai;3471567359;Ne;0;1;0;1
20231;Boružėlė;Nykštukai;1444196386;Ne;9;1;4;14
20232;Boružėlė;Nykštukai;8970308091;Ne;10;0;6;16
20233;Boružėlė;Nykštukai;6330458151;Ne;0;20;0;20
20234;Boružėlė;Nykštukai;7436380846;Ne;6;2;2;10
20235;Žaliakalnio;Drugeliai;8056516915;Ne;0;3;0;3
20236;Žaliakalnio;Drugeliai;9106286038;Ne;6;0;4;10
20237;Žaliakalnio;Drugeliai;1004188539;Ne;3;2;2;7
20238;Žaliakalnio;Drugeliai;9762481841;Ne;8;0;2;10
20239;Žaliakalnio;Drugeliai;9710185940;Ne;4;6;4;14
20240;Žaliakalnio;Drugeliai;5626776693;Ne;8;0;2;10
20241;Žaliakalnio;Drugeliai;4945570058;Ne;3;4;2;9
20242;Žaliakalnio;Drugeliai;6521902343;Ne;1;7;2;10
20243;Žaliakalnio;Drugeliai;9790375448;Ne;0;9;0;9
20244;Žaliakalnio;Drugeliai;7966604753;Ne;0;2;0;2
20245;Žaliakalnio;Drugeliai;7078689014;Ne;0;2;1;3
20246;Žaliakalnio;Drugeliai;4642184038;Ne;0;1;0;1
20247;Žaliakalnio;Drugeliai;7229655569;Ne;3;0;0;3
20248;Žaliakalnio;Drugeliai;4888533074;Ne;6;3;4;13
20249;Žaliakalnio;Drugeliai;5305220570;Ne;3;0;2;5
20250;Žaliakalnio;Drugeliai;8852165484;Ne;3;4;3;10
20251;Žaliakalnio;Drugeliai;9167631614;Ne;3;9;2;14
20252;Žaliakalnio;Drugeliai;6166482260;Ne;0;11;0;11
20253;Žaliakalnio;Boružėlių;5843020412;Ne;0;4;0;4
20254;Žaliakalnio;Boružėlių;7087535800;Ne;0;5;0;5
20255;Žaliakalnio;Boružėlių;1528111839;Ne;0;2;0;2
20256;Žaliakalnio;Boružėlių;7023886811;Ne;0;4;0;4
20257;Žaliakalnio;Boružėlių;2284465378;Ne;0;2;0;2
20258;Žaliakalnio;Boružėlių;7977009681;Ne;0;2;0;2
20259;Žaliakalnio;Boružėlių;2808776865;Ne;8;2;2;12
20260;Žaliakalnio;Boružėlių;2278681435;Ne;0;2;0;2
20261;Žaliakalnio;Boružėlių;9421259943;Ne;0;0;5;5
20262;Žaliakalnio;Boružėlių;3105500733;Ne;0;3;0;3
20263;Žaliakalnio;Boružėlių;1200844791;Ne;0;4;2;6
20264;Žaliakalnio;Boružėlių;8052539476;Ne;0;18;0;18
20265;Žaliakalnio;Boružėlių;6590016097;Ne;0;4;0;4
20266;Žaliakalnio;Boružėlių;8304431519;Ne;3;3;2;8
20267;Žaliakalnio;Boružėlių;5488964606;Ne;0;2;0;2
20268;Žaliakalnio;Boružėlių;8429135626;Ne;0;10;0;10
20269;Žaliakalnio;Boružėlių;8073554707;Ne;3;4;4;11
20270;Žaliakalnio;Boružėlių;2987217910;Ne;0;17;0;17
20271;Žaliakalnio;Boružėlių;9032003195;Ne;0;11;0;11
20272;Žaliakalnio;Boružėlių;8715718525;Ne;3;0;2;5
20273;Žaliakalnio;Boružėlių;6602037942;Ne;3;1;2;6
20274;Žaliakalnio;Boružėlių;4961762841;Ne;0;3;0;3
20275;Žaliakalnio;Boružėlių;3027735957;Ne;2;2;2;6
20276;Žaliakalnio;Zuikučiai;3072808139;Ne;4;21;4;29
20277;Žaliakalnio;Zuikučiai;6392556928;Ne;10;0;2;12
20278;Žaliakalnio;Zuikučiai;9382616403;Ne;0;2;0;2
20279;Žaliakalnio;Zuikučiai;2111418502;Ne;0;16;0;16
20280;Žaliakalnio;Zuikučiai;2654494663;Ne;0;7;0;7
20281;Žaliakalnio;Zuikučiai;8576412247;Ne;0;22;0;22
20282;Žaliakalnio;Zuikučiai;9317649996;Ne;0;9;0;9
20283;Žaliakalnio;Zuikučiai;6872615333;Ne;7;4;2;13
20284;Žaliakalnio;Zuikučiai;5645294219;Ne;7;5;2;14
20285;Žaliakalnio;Zuikučiai;4879096956;Ne;0;12;0;12
20286;Žaliakalnio;Zuikučiai;7258677907;Ne;11;4;4;19
20287;Žaliakalnio;Zuikučiai;9868348859;Ne;12;0;4;16
20288;Žaliakalnio;Zuikučiai;5939383017;Ne;0;7;0;7
20289;Žaliakalnio;Zuikučiai;4231316753;Ne;8;2;2;12
20290;Žaliakalnio;Zuikučiai;9478722760;Ne;0;10;0;10
20291;Žaliakalnio;Zuikučiai;7099047041;Ne;8;2;2;12
20292;Žaliakalnio;Zuikučiai;9378617562;Ne;4;3;2;9
20293;Žaliakalnio;Zuikučiai;6659576919;Ne;23;2;2;27
20294;Žaliakalnio;Zuikučiai;7047556229;Ne;0;18;0;18
20295;Žaliakalnio;Zuikučiai;4563419248;Ne;6;5;4;15
20296;Žaliakalnio;Zuikučiai;3032513275;Ne;28;2;2;32
20297;Žaliakalnio;Zuikučiai;7495990953;Taip;0;10;0;10
20298;Žaliakalnio;Bitutė;5744370516;Ne;0;3;0;3
20299;Žaliakalnio;Bitutė;3619817569;Ne;0;2;0;2
20300;Žaliakalnio;Bitutė;3905448562;Ne;0;3;2;5
20301;Žaliakalnio;Bitutė;8481665290;Ne;0;2;0;2
20302;Žaliakalnio;Bitutė;8950583202;Ne;2;6;0;8
20303;Žaliakalnio;Bitutė;6324315523;Ne;3;3;2;8
20304;Žaliakalnio;Bitutė;6877235095;Ne;0;2;0;2
20305;Žaliakalnio;Bitutė;2280683252;Ne;0;4;0;4
20306;Žaliakalnio;Bitutė;7711347723;Ne;0;0;9;9
20307;Žaliakalnio;Bitutė;4561672875;Ne;8;2;2;12
20308;Žaliakalnio;Bitutė;8185190219;Ne;3;2;2;7
20309;Žaliakalnio;Bitutė;7830692152;Ne;3;3;2;8
20310;Žaliakalnio;Bitutė;1423481154;Ne;0;4;0;4
20311;Žaliakalnio;Bitutė;4928400872;Ne;0;3;0;3
20312;Žaliakalnio;Bitutė;2613771302;Ne;0;3;0;3
20313;Žaliakalnio;Bitutė;8599646291;Ne;0;2;0;2
20314;Žaliakalnio;Bitutė;1343293430;Ne;0;4;0;4
20315;Žaliakalnio;Bitutė;3721878250;Ne;8;3;2;13
20316;Žaliakalnio;Bitutė;6291287113;Ne;0;3;2;5
20317;Žaliakalnio;Bitutė;1173977434;Ne;5;3;6;14
20318;Žaliakalnio;Bitutė;9485995178;Ne;5;9;2;16
20319;Žaliakalnio;Bitutė;8179329874;Ne;0;2;2;4
20320;Žaliakalnio;Bitutė;1309236035;Ne;0;4;1;5
20321;Žaliakalnio;Bitutė;8534973941;Ne;0;22;0;22
20322;Žaliakalnio;Nykštukų;9069518153;Ne;0;20;0;20
20323;Žaliakalnio;Nykštukų;8142435757;Ne;13;4;4;21
20324;Žaliakalnio;Nykštukų;3446593135;Ne;0;3;0;3
20325;Žaliakalnio;Nykštukų;1064854294;Ne;4;4;2;10
20326;Žaliakalnio;Nykštukų;4891656355;Ne;0;4;0;4
20327;Žaliakalnio;Nykštukų;1632465983;Ne;16;4;2;22
20328;Žaliakalnio;Nykštukų;8472945857;Ne;0;2;0;2
20329;Žaliakalnio;Nykštukų;9521104462;Taip;8;2;2;12
20330;Žaliakalnio;Nykštukų;5565027085;Ne;3;9;2;14
20331;Žaliakalnio;Nykštukų;2242604156;Ne;18;6;2;26
20332;Žaliakalnio;Nykštukų;9801618806;Ne;0;1;2;3
20333;Žaliakalnio;Nykštukų;2225778044;Ne;0;4;0;4
20334;Žaliakalnio;Nykštukų;4255734788;Ne;7;3;2;12
20335;Žaliakalnio;Nykštukų;7793937917;Ne;11;3;2;16
20336;Žaliakalnio;Nykštukų;8117013474;Ne;3;3;2;8
20337;Žaliakalnio;Nykštukų;7205368281;Ne;0;2;2;4
20338;Žaliakalnio;Nykštukų;4036239701;Ne;0;19;0;19
20339;Žaliakalnio;Nykštukų;5258266970;Ne;5;0;2;7
20340;Žaliakalnio;Nykštukų;3041002600;Ne;2;6;2;10
20341;Žaliakalnio;Nykštukų;7636933790;Ne;4;14;2;20
20342;Žaliakalnio;Nykštukų;4154737541;Ne;3;4;2;9
20343;Žaliakalnio;Nykštukų;2155412338;Ne;0;19;0;19
20344;Žaliakalnio;Nykštukų;1511302012;Ne;10;2;0;12
20345;Žaliakalnio;ŽIOGELIAI;2426844621;Ne;4;4;2;10
20346;Žaliakalnio;ŽIOGELIAI;5752912101;Ne;0;5;0;5
20347;Žaliakalnio;ŽIOGELIAI;9967098834;Ne;0;2;1;3
20348;Žaliakalnio;ŽIOGELIAI;1133557422;Ne;0;7;0;7
20349;Žaliakalnio;ŽIOGELIAI;3464935314;Ne;5;0;2;7
20350;Žaliakalnio;ŽIOGELIAI;7648422668;Ne;0;3;0;3
20351;Žaliakalnio;ŽIOGELIAI;4702470511;Ne;0;7;0;7
20352;Žaliakalnio;ŽIOGELIAI;2272043654;Ne;3;2;2;7
20353;Žaliakalnio;ŽIOGELIAI;8518422934;Ne;0;2;0;2
20354;Žaliakalnio;ŽIOGELIAI;6674631040;Ne;0;2;0;2
20355;Žaliakalnio;ŽIOGELIAI;8245784590;Ne;15;0;4;19
20356;Žaliakalnio;ŽIOGELIAI;8383425712;Ne;0;4;3;7
20357;Žaliakalnio;ŽIOGELIAI;7025195076;Ne;0;2;0;2
20358;Žaliakalnio;ŽIOGELIAI;2514763739;Ne;0;4;0;4
20359;Žaliakalnio;ŽIOGELIAI;8891815592;Ne;3;2;2;7
20360;Žaliakalnio;ŽIOGELIAI;6294045755;Ne;0;11;0;11
20361;Žaliakalnio;ŽIOGELIAI;8232697563;Ne;3;4;2;9
20362;Žaliakalnio;ŽIOGELIAI;2694424532;Ne;0;6;0;6
20363;Žaliakalnio;ŽIOGELIAI;6136717862;Ne;0;2;0;2
20364;Žaliakalnio;ŽIOGELIAI;8316505307;Ne;0;9;0;9
20365;Žaliakalnio;ŽIOGELIAI;8568306789;Ne;0;6;0;6
20366;Žaliakalnio;ŽIOGELIAI;9383567339;Ne;0;5;0;5
20367;Žaliakalnio;SAULUTĖS;2328766492;Ne;0;4;0;4
20368;Žaliakalnio;SAULUTĖS;1253655689;Ne;0;4;0;4
20369;Žaliakalnio;SAULUTĖS;3016537413;Ne;0;9;0;9
20370;Žaliakalnio;SAULUTĖS;6795532166;Ne;0;5;0;5
20371;Žaliakalnio;SAULUTĖS;7913029369;Ne;0;4;0;4
20372;Žaliakalnio;SAULUTĖS;7793917852;Ne;3;4;3;10
20373;Žaliakalnio;SAULUTĖS;3018398546;Ne;0;9;0;9
20374;Žaliakalnio;SAULUTĖS;8765159796;Ne;3;14;2;19
20375;Žaliakalnio;SAULUTĖS;3028921540;Ne;23;2;2;27
20376;Žaliakalnio;SAULUTĖS;4355433666;Ne;7;3;2;12
20377;Žaliakalnio;SAULUTĖS;9016032548;Ne;0;5;0;5
20378;Žaliakalnio;SAULUTĖS;1715385224;Ne;4;4;2;10
20379;Žaliakalnio;SAULUTĖS;3304186400;Taip;3;21;0;24
20380;Žaliakalnio;SAULUTĖS;3434815790;Ne;0;2;0;2
20381;Žaliakalnio;SAULUTĖS;3832291926;Ne;0;5;0;5
20382;Žaliakalnio;SAULUTĖS;7071209465;Ne;13;2;2;17
20383;Žaliakalnio;SAULUTĖS;7543073516;Ne;0;8;0;8
20384;Žaliakalnio;SAULUTĖS;9379373983;Ne;0;2;0;2
20385;Žaliakalnio;SAULUTĖS;2806386840;Ne;6;4;1;11
20386;Žaliakalnio;SAULUTĖS;9267349375;Ne;0;5;0;5
20387;Žaliakalnio;SAULUTĖS;7989372873;Ne;5;6;2;13
20388;Žaliakalnio;SAULUTĖS;4412760433;Ne;1;5;2;8
20389;Žaliakalnio;SAULUTĖS;4177369871;Ne;14;3;2;19
20390;Volungė;Bitutės;6661730121;Ne;5;0;2;7
20391;Volungė;Bitutės;5791161943;Ne;0;1;2;3
20392;Volungė;Bitutės;3307326410;Ne;0;9;5;14
20393;Volungė;Bitutės;5300334761;Ne;0;2;0;2
20394;Volungė;Bitutės;4013639324;Ne;0;2;3;5
20395;Volungė;Bitutės;2599441104;Ne;3;2;4;9
20396;Volungė;Bitutės;5892600735;Ne;2;7;7;16
20397;Volungė;Bitutės;1902122510;Ne;0;2;1;3
20398;Volungė;Bitutės;1752817125;Ne;12;2;2;16
20399;Volungė;Bitutės;3515725398;Ne;0;2;4;6
20400;Volungė;Bitutės;3666364101;Ne;2;2;3;7
20401;Volungė;Bitutės;7151952679;Ne;0;2;3;5
20402;Volungė;Bitutės;5960027749;Ne;0;2;6;8
20403;Volungė;Bitutės;5149291935;Ne;0;0;1;1
20404;Volungė;Bitutės;8166517073;Ne;0;0;2;2
20405;Volungė;Bitutės;9842009354;Ne;4;2;3;9
20406;Volungė;Bitutės;4437625791;Ne;2;0;2;4
20407;Volungė;Bitutės;9933980783;Ne;0;2;3;5
20408;Volungė;Bitutės;4685227759;Ne;0;2;1;3
20409;Volungė;Boružiukai;6445614647;Ne;22;0;0;22
20410;Volungė;Boružiukai;9382043452;Ne;0;7;0;7
20411;Volungė;Boružiukai;6127398531;Ne;0;2;0;2
20412;Volungė;Boružiukai;1592634034;Ne;4;2;3;9
20413;Volungė;Boružiukai;5588544003;Ne;0;3;0;3
20414;Volungė;Boružiukai;3758750922;Ne;0;0;19;19
20415;Volungė;Boružiukai;2663288986;Ne;0;2;0;2
20416;Volungė;Boružiukai;5561683986;Ne;3;2;2;7
20417;Volungė;Boružiukai;9562426487;Ne;5;14;0;19
20418;Volungė;Boružiukai;4136178027;Ne;0;3;0;3
20419;Volungė;Boružiukai;4664635246;Taip;2;0;4;6
20420;Volungė;Boružiukai;8987748481;Ne;2;0;6;8
20421;Volungė;Boružiukai;5882826586;Ne;0;8;0;8
20422;Volungė;Boružiukai;5338942678;Ne;2;0;2;4
20423;Volungė;Boružiukai;5054666349;Ne;0;10;0;10
20424;Volungė;Žvirbliukai;2360026330;Ne;0;2;0;2
20425;Volungė;Žvirbliukai;2051410463;Ne;10;0;2;12
20426;Volungė;Žvirbliukai;5074093178;Ne;0;0;1;1
20427;Volungė;Žvirbliukai;5750385275;Taip;16;0;2;18
20428;Volungė;Žvirbliukai;9575894080;Ne;3;2;2;7
20429;Volungė;Žvirbliukai;8927595898;Ne;9;2;2;13
20430;Volungė;Žvirbliukai;9384821249;Ne;0;1;2;3
20431;Volungė;Žvirbliukai;5361410157;Ne;0;2;0;2
20432;Volungė;Žvirbliukai;3028611395;Ne;5;0;4;9
20433;Volungė;Žvirbliukai;2949033093;Ne;5;2;2;9
20434;Volungė;Žvirbliukai;2159667991;Ne;12;2;2;16
20435;Volungė;Žvirbliukai;5470252589;Ne;0;2;8;10
20436;Volungė;Žvirbliukai;1022606584;Ne;1;2;2;5
20437;Volungė;Žvirbliukai;8894121428;Ne;0;2;0;2
20438;Volungė;Žvirbliukai;9139746132;Ne;7;0;4;11
20439;Volungė;Žvirbliukai;3332069842;Ne;0;2;2;4
20440;Volungė;Žvirbliukai;4605844193;Ne;0;2;0;2
20441;Volungė;Žiogeliai;6360834021;Ne;0;1;4;5
20442;Volungė;Žiogeliai;4856240879;Ne;0;2;1;3
20443;Volungė;Žiogeliai;9816038480;Ne;0;1;2;3
20444;Volungė;Žiogeliai;8640511964;Ne;0;2;3;5
20445;Volungė;Žiogeliai;5170536566;Ne;0;2;3;5
20446;Volungė;Žiogeliai;8421730419;Ne;2;7;7;16
20447;Volungė;Žiogeliai;6532202782;Ne;8;2;8;18
20448;Volungė;Žiogeliai;2712034356;Ne;4;2;5;11
20449;Volungė;Žiogeliai;2246291631;Ne;0;2;0;2
20450;Volungė;Žiogeliai;2456643081;Ne;2;2;3;7
20451;Volungė;Žiogeliai;6920821813;Ne;0;1;1;2
20452;Volungė;Žiogeliai;8299305464;Ne;0;2;1;3
20453;Volungė;Žiogeliai;1781838937;Ne;0;2;0;2
20454;Volungė;Žiogeliai;1988082807;Ne;0;2;0;2
20455;Volungė;Žiogeliai;3091641738;Ne;0;2;1;3
20456;Volungė;Žiogeliai;8578521969;Ne;0;2;0;2
20457;Volungė;Žiogeliai;5710662590;Ne;0;2;1;3
20458;Volungė;Žiogeliai;4839484528;Ne;13;2;2;17
20459;Volungė;Žiogeliai;5174427959;Ne;1;1;2;4
20460;Volungė;Žiogeliai;7281448136;Ne;0;2;4;6
20461;Volungė;Žiogeliai;2187800215;Ne;0;2;1;3
20462;Volungė;Pelėdžiukai;6431477042;Ne;0;2;4;6
20463;Volungė;Pelėdžiukai;3528581949;Ne;0;2;5;7
20464;Volungė;Pelėdžiukai;1137713075;Ne;0;5;0;5
20465;Volungė;Pelėdžiukai;2322594823;Ne;6;0;3;9
20466;Volungė;Pelėdžiukai;7965601199;Ne;0;2;4;6
20467;Volungė;Pelėdžiukai;2603335248;Ne;1;0;0;1
20468;Volungė;Pelėdžiukai;3746978206;Ne;0;2;0;2
20469;Volungė;Pelėdžiukai;1974650443;Ne;0;0;3;3
20470;Volungė;Pelėdžiukai;2068447339;Ne;0;22;0;22
20471;Volungė;Pelėdžiukai;9188994935;Ne;0;13;0;13
20472;Volungė;Pelėdžiukai;1757041481;Ne;0;2;7;9
20473;Volungė;Pelėdžiukai;8285309230;Ne;0;2;3;5
20474;Volungė;Pelėdžiukai;7149986415;Ne;0;2;6;8
20475;Volungė;Pelėdžiukai;4598763851;Ne;0;2;0;2
20476;Volungė;Pelėdžiukai;2627555750;Ne;5;0;4;9
20477;Volungė;Pelėdžiukai;7867741556;Ne;0;0;5;5
20478;Volungė;Pelėdžiukai;7971287899;Ne;2;7;2;11
20479;Volungė;Pelėdžiukai;9729285419;Ne;0;2;7;9
20480;Volungė;Pelėdžiukai;8459167833;Ne;0;2;1;3
20481;Volungė;Drugeliai;6280208510;Ne;0;4;2;6
20482;Volungė;Drugeliai;4032261812;Ne;0;2;4;6
20483;Volungė;Drugeliai;6488473384;Ne;2;0;3;5
20484;Volungė;Drugeliai;8045459660;Ne;4;2;6;12
20485;Volungė;Drugeliai;1402200673;Ne;4;2;6;12
20486;Volungė;Drugeliai;7574856429;Ne;2;0;3;5
20487;Volungė;Drugeliai;2686827560;Ne;0;2;1;3
20488;Volungė;Drugeliai;9973604148;Ne;1;0;2;3
20489;Volungė;Drugeliai;8905401944;Ne;0;0;5;5
20490;Volungė;Drugeliai;1164632050;Ne;0;2;1;3
20491;Volungė;Drugeliai;2923810441;Ne;0;2;0;2
20492;Volungė;Drugeliai;6782622442;Ne;3;2;5;10
20493;Volungė;Drugeliai;3020629341;Ne;2;0;2;4
20494;Volungė;Drugeliai;4252713086;Ne;0;2;2;4
20495;Volungė;Drugeliai;2530804242;Ne;0;0;2;2
20496;Volungė;Drugeliai;4745609424;Taip;0;0;7;7
20497;Volungė;Drugeliai;7584598377;Ne;0;1;3;4
20498;Volungė;"SKRUZDĖLIUKAI ";3394646139;Ne;10;0;6;16
20499;Volungė;"SKRUZDĖLIUKAI ";4223287277;Ne;0;0;3;3
20500;Volungė;"SKRUZDĖLIUKAI ";6464890465;Ne;11;0;3;14
20501;Volungė;"SKRUZDĖLIUKAI ";2493541457;Ne;10;0;4;14
20502;Volungė;"SKRUZDĖLIUKAI ";1948015523;Ne;0;1;0;1
20503;Volungė;"SKRUZDĖLIUKAI ";1101228927;Ne;3;0;2;5
20504;Volungė;"SKRUZDĖLIUKAI ";5332306628;Ne;11;2;4;17
20505;Volungė;"SKRUZDĖLIUKAI ";9319825151;Ne;6;2;2;10
20506;Volungė;"SKRUZDĖLIUKAI ";6370584522;Ne;6;0;3;9
20507;Volungė;"SKRUZDĖLIUKAI ";8168630107;Ne;6;4;2;12
20508;Volungė;"SKRUZDĖLIUKAI ";8992514683;Ne;7;2;2;11
20509;Volungė;"SKRUZDĖLIUKAI ";5833091791;Ne;0;0;2;2
20510;Volungė;"SKRUZDĖLIUKAI ";5994884455;Ne;0;0;1;1
20511;Volungė;"SKRUZDĖLIUKAI ";3818924175;Ne;0;2;3;5
20512;Volungė;"SKRUZDĖLIUKAI ";8244731771;Ne;0;2;1;3
20513;Volungė;"SKRUZDĖLIUKAI ";6110117105;Ne;6;0;5;11
20514;Volungė;"SKRUZDĖLIUKAI ";4944556574;Taip;3;2;3;8
20515;Volungė;"SKRUZDĖLIUKAI ";2212423676;Ne;1;2;7;10
20516;Volungė;"SKRUZDĖLIUKAI ";5942497397;Ne;3;1;5;9
20517;Volungė;"SKRUZDĖLIUKAI ";4991465781;Ne;0;2;0;2
20518;Volungė;"SKRUZDĖLIUKAI ";8613580206;Ne;0;2;6;8
20519;Volungė;Zylutės;1040993908;Ne;3;2;2;7
20520;Volungė;Zylutės;6715770777;Ne;0;0;6;6
20521;Volungė;Zylutės;2874194121;Ne;3;2;2;7
20522;Volungė;Zylutės;4363877851;Ne;0;1;0;1
20523;Volungė;Zylutės;1877753679;Ne;6;0;4;10
20524;Volungė;Zylutės;9005691348;Ne;0;0;4;4
20525;Volungė;Zylutės;2765042584;Ne;0;0;4;4
20526;Volungė;Zylutės;7754202158;Ne;0;0;2;2
20527;Volungė;Zylutės;9519564424;Ne;5;0;4;9
20528;Volungė;Zylutės;5345072950;Ne;0;2;3;5
20529;Volungė;Zylutės;3042694602;Ne;3;0;2;5
20530;Volungė;Zylutės;1744137167;Ne;14;2;4;20
20531;Volungė;Zylutės;2404239677;Ne;0;0;1;1
20532;Volungė;Zylutės;7928027786;Ne;3;0;4;7
20533;Giliukas;SMALSUČIAI;9462634699;Ne;5;1;2;8
20534;Giliukas;SMALSUČIAI;7646966187;Ne;2;0;5;7
20535;Giliukas;SMALSUČIAI;3274313536;Ne;0;4;2;6
20536;Giliukas;SMALSUČIAI;9287193955;Ne;0;9;0;9
20537;Giliukas;SMALSUČIAI;7944198886;Ne;9;0;4;13
20538;Giliukas;SMALSUČIAI;5527212334;Ne;4;2;2;8
20539;Giliukas;SMALSUČIAI;9499591494;Ne;7;2;2;11
20540;Giliukas;SMALSUČIAI;2099575372;Ne;2;0;6;8
20541;Giliukas;SMALSUČIAI;7195772641;Ne;3;0;2;5
20542;Giliukas;SMALSUČIAI;4258921446;Ne;1;2;2;5
20543;Giliukas;SMALSUČIAI;1439350058;Ne;6;2;3;11
20544;Giliukas;SMALSUČIAI;4843920452;Ne;4;0;3;7
20545;Giliukas;SMALSUČIAI;2004782696;Ne;0;2;0;2
20546;Giliukas;SMALSUČIAI;8977247073;Ne;4;0;3;7
20547;Giliukas;SMALSUČIAI;9475918013;Ne;2;0;4;6
20548;Giliukas;SMALSUČIAI;9229086918;Ne;4;2;2;8
20549;Giliukas;SMALSUČIAI;8147492951;Ne;3;0;2;5
20550;Giliukas;SMALSUČIAI;2349166172;Ne;2;0;5;7
20551;Giliukas;SMALSUČIAI;8241215831;Ne;13;0;2;15
20552;Giliukas;GUDRUČIAI;4960232685;Ne;0;2;0;2
20553;Giliukas;GUDRUČIAI;9458262379;Ne;0;0;1;1
20554;Giliukas;GUDRUČIAI;6148883070;Ne;0;4;0;4
20555;Giliukas;GUDRUČIAI;7425654504;Ne;0;10;0;10
20556;Giliukas;GUDRUČIAI;7130696530;Ne;0;5;0;5
20557;Giliukas;GUDRUČIAI;6422178450;Ne;0;3;0;3
20558;Giliukas;GUDRUČIAI;3150981084;Ne;0;15;0;15
20559;Giliukas;GUDRUČIAI;6134554678;Ne;0;9;0;9
20560;Giliukas;GUDRUČIAI;3137768675;Ne;8;2;2;12
20561;Giliukas;GUDRUČIAI;2064182165;Ne;0;1;2;3
20562;Giliukas;GUDRUČIAI;6956862865;Ne;2;4;2;8
20563;Giliukas;GUDRUČIAI;9617542456;Ne;0;3;0;3
20564;Giliukas;GUDRUČIAI;9274289812;Ne;0;1;0;1
20565;Giliukas;GUDRUČIAI;3718774263;Ne;9;0;0;9
20566;Giliukas;GUDRUČIAI;9152432124;Ne;3;0;3;6
20567;Giliukas;GUDRUČIAI;4854370266;Ne;0;2;2;4
20568;Giliukas;GUDRUČIAI;6338583515;Ne;0;4;0;4
20569;Giliukas;GUDRUČIAI;6703080106;Ne;0;6;0;6
20570;Giliukas;GUDRUČIAI;4347883309;Ne;0;1;0;1
20571;Giliukas;PABIRUČIAI;4183026763;Ne;2;1;2;5
20572;Giliukas;PABIRUČIAI;4247090684;Ne;6;0;4;10
20573;Giliukas;PABIRUČIAI;2379370477;Ne;0;1;0;1
20574;Giliukas;PABIRUČIAI;3054591644;Ne;3;2;2;7
20575;Giliukas;PABIRUČIAI;3870143024;Ne;0;3;2;5
20576;Giliukas;PABIRUČIAI;6914013230;Ne;1;1;3;5
20577;Giliukas;PABIRUČIAI;7013767174;Ne;0;0;2;2
20578;Giliukas;PABIRUČIAI;4810236703;Ne;0;2;1;3
20579;Giliukas;PABIRUČIAI;4105974682;Ne;3;0;4;7
20580;Giliukas;PABIRUČIAI;8874804636;Ne;0;0;2;2
20581;Giliukas;PABIRUČIAI;8626920684;Ne;4;2;4;10
20582;Giliukas;PABIRUČIAI;7012272912;Ne;0;0;1;1
20583;Giliukas;PABIRUČIAI;2229737837;Ne;2;2;2;6
20584;Giliukas;PABIRUČIAI;1075275967;Ne;0;0;2;2
20585;Giliukas;PABIRUČIAI;3268682615;Ne;1;0;3;4
20586;Giliukas;PABIRUČIAI;4838600191;Ne;4;0;6;10
20587;Giliukas;PABIRUČIAI;1395779355;Ne;8;0;3;11
20588;Giliukas;PABIRUČIAI;7541075946;Ne;1;0;4;5
20589;Giliukas;ŠVELNUKAI;9224387185;Ne;0;0;2;2
20590;Giliukas;ŠVELNUKAI;9360994563;Ne;6;0;2;8
20591;Giliukas;ŠVELNUKAI;2012365132;Ne;6;0;4;10
20592;Giliukas;ŠVELNUKAI;4565216956;Ne;4;0;3;7
20593;Giliukas;ŠVELNUKAI;5834233526;Ne;0;0;3;3
20594;Giliukas;ŠVELNUKAI;5000654626;Ne;0;0;1;1
20595;Giliukas;ŠVELNUKAI;8973584424;Ne;2;0;2;4
20596;Giliukas;ŠVELNUKAI;9679421414;Ne;13;0;4;17
20597;Giliukas;ŠVELNUKAI;3238820351;Ne;4;0;5;9
20598;Giliukas;ŠVELNUKAI;4340602792;Ne;3;1;3;7
20599;Giliukas;ŠVELNUKAI;6563305502;Ne;4;10;2;16
20600;Giliukas;ŠVELNUKAI;4301950538;Ne;5;0;4;9
20601;Giliukas;ŠVELNUKAI;7657935162;Ne;7;0;3;10
20602;Giliukas;ŠVELNUKAI;3839624551;Ne;0;0;1;1
20603;Giliukas;ŽINIUKAI;2502801547;Ne;8;5;2;15
20604;Giliukas;ŽINIUKAI;2562809633;Ne;8;2;2;12
20605;Giliukas;ŽINIUKAI;5201020765;Ne;3;4;2;9
20606;Giliukas;ŽINIUKAI;2042324002;Ne;0;5;0;5
20607;Giliukas;ŽINIUKAI;2801731379;Ne;9;4;2;15
20608;Giliukas;ŽINIUKAI;8499893356;Ne;0;17;0;17
20609;Giliukas;ŽINIUKAI;9205911152;Ne;11;0;6;17
20610;Giliukas;ŽINIUKAI;3720032249;Ne;6;0;4;10
20611;Giliukas;ŽINIUKAI;3659105022;Ne;0;8;0;8
20612;Giliukas;ŽINIUKAI;4940718205;Ne;8;2;6;16
20613;Giliukas;ŽINIUKAI;8491008130;Ne;7;15;4;26
20614;Giliukas;ŽINIUKAI;4163383707;Ne;4;10;3;17
20615;Giliukas;ŽINIUKAI;1332725572;Ne;0;10;0;10
20616;Giliukas;ŽINIUKAI;2798676079;Ne;0;4;0;4
20617;Giliukas;ŽINIUKAI;4404761569;Ne;18;0;4;22
20618;Giliukas;ŽINIUKAI;1915809569;Ne;0;1;0;1
20619;Giliukas;ŽINIUKAI;2787116787;Ne;5;4;2;11
20620;Giliukas;MYLIMUKAI;7481387658;Ne;0;2;0;2
20621;Giliukas;MYLIMUKAI;7290236898;Ne;13;0;4;17
20622;Giliukas;MYLIMUKAI;2045566679;Ne;2;0;2;4
20623;Giliukas;MYLIMUKAI;8012946026;Ne;11;0;4;15
20624;Giliukas;MYLIMUKAI;7406406981;Ne;10;0;4;14
20625;Giliukas;MYLIMUKAI;2169949712;Ne;0;5;0;5
20626;Giliukas;MYLIMUKAI;5467076457;Ne;2;0;3;5
20627;Giliukas;MYLIMUKAI;2109668106;Ne;4;0;2;6
20628;Giliukas;MYLIMUKAI;6650117646;Ne;2;1;2;5
20629;Giliukas;MYLIMUKAI;5199968458;Ne;10;0;2;12
20630;Giliukas;MYLIMUKAI;3185622470;Ne;5;5;2;12
20631;Giliukas;MYLIMUKAI;8414652507;Ne;7;10;5;22
20632;Giliukas;MYLIMUKAI;7560774044;Ne;0;0;3;3
20633;Giliukas;MYLIMUKAI;3717956257;Ne;2;0;3;5
20634;Giliukas;ČIAUŠKUČIAI;8701216181;Ne;3;2;2;7
20635;Giliukas;ČIAUŠKUČIAI;6742406486;Ne;0;2;3;5
20636;Giliukas;ČIAUŠKUČIAI;9556962586;Ne;0;0;2;2
20637;Giliukas;ČIAUŠKUČIAI;2840410579;Ne;3;2;2;7
20638;Giliukas;ČIAUŠKUČIAI;2378721717;Ne;0;0;2;2
20639;Giliukas;ČIAUŠKUČIAI;7316126011;Ne;0;0;1;1
20640;Giliukas;ČIAUŠKUČIAI;3728323646;Ne;11;0;2;13
20641;Giliukas;ČIAUŠKUČIAI;1710286878;Ne;9;0;5;14
20642;Giliukas;ČIAUŠKUČIAI;9704885611;Ne;0;2;0;2
20643;Giliukas;ČIAUŠKUČIAI;7993049824;Ne;3;0;4;7
20644;Giliukas;ČIAUŠKUČIAI;2700296404;Ne;0;0;2;2
20645;Giliukas;ČIAUŠKUČIAI;9160815037;Ne;6;0;2;8
20646;Giliukas;ČIAUŠKUČIAI;1221640023;Ne;0;1;0;1
20647;Giliukas;ČIAUŠKUČIAI;2298554837;Ne;0;0;2;2
20648;Giliukas;ČIAUŠKUČIAI;7871670134;Ne;0;0;2;2
20649;Giliukas;ŠNEKUČIAI;1762536884;Ne;3;2;2;7
20650;Giliukas;ŠNEKUČIAI;2612551188;Ne;4;0;2;6
20651;Giliukas;ŠNEKUČIAI;9366734581;Ne;5;4;4;13
20652;Giliukas;ŠNEKUČIAI;7053406257;Ne;8;0;3;11
20653;Giliukas;ŠNEKUČIAI;2226855971;Ne;6;2;2;10
20654;Giliukas;ŠNEKUČIAI;2742106493;Ne;4;1;2;7
20655;Giliukas;ŠNEKUČIAI;3726149759;Ne;0;3;0;3
20656;Giliukas;ŠNEKUČIAI;6748766233;Ne;0;2;0;2
20657;Giliukas;ŠNEKUČIAI;6953123617;Ne;0;3;1;4
20658;Giliukas;ŠNEKUČIAI;5222092567;Ne;5;0;2;7
20659;Giliukas;ŠNEKUČIAI;5300517567;Ne;0;2;0;2
20660;Giliukas;ŠNEKUČIAI;3055598917;Ne;4;0;2;6
20661;Giliukas;ŠNEKUČIAI;4581414740;Ne;7;0;4;11
20662;Giliukas;ŠNEKUČIAI;7431116067;Ne;2;0;0;2
20663;Giliukas;ŠNEKUČIAI;7205807049;Ne;0;1;0;1
20664;Giliukas;ŠNEKUČIAI;1165810193;Ne;0;2;0;2
20665;Giliukas;ŠNEKUČIAI;1916905497;Ne;5;1;2;8
20666;Giliukas;ŠNEKUČIAI;4207939009;Ne;2;0;2;4
20667;"Lazdynų mokykla (Žėručio g. 4)";LEPG;7487278074;Ne;0;3;1;4
20668;"Lazdynų mokykla (Žėručio g. 4)";LEPG;7320049068;Ne;0;3;2;5
20669;"Lazdynų mokykla (Žėručio g. 4)";LEPG;1396367371;Ne;0;3;1;4
20670;"Lazdynų mokykla (Žėručio g. 4)";LEPG;7324846434;Ne;0;3;2;5
20671;"Lazdynų mokykla (Žėručio g. 4)";LEPG;7659209862;Ne;3;3;2;8
20672;"Lazdynų mokykla (Žėručio g. 4)";LEPG;9654428418;Ne;0;3;1;4
20673;"Lazdynų mokykla (Žėručio g. 4)";LEPG;7824446288;Ne;0;7;0;7
20674;"Lazdynų mokykla (Žėručio g. 4)";LEPG;3435025978;Ne;3;3;8;14
20675;"Lazdynų mokykla (Žėručio g. 4)";LEPG;5420067622;Ne;0;3;0;3
20676;"Lazdynų mokykla (Žėručio g. 4)";LEPG;1738732866;Ne;2;3;4;9
20677;"Lazdynų mokykla (Žėručio g. 4)";LEPG;2059342403;Ne;0;3;0;3
20678;"Lazdynų mokykla (Žėručio g. 4)";LEPG;3268305561;Ne;0;3;0;3
20679;"Lazdynų mokykla (Žėručio g. 4)";LEPG;4562536818;Ne;0;9;0;9
20680;"Lazdynų mokykla (Žėručio g. 4)";LEPG;8990701154;Ne;17;3;2;22
20681;"Lazdynų mokykla (Žėručio g. 4)";LEPG;2666441234;Ne;0;3;2;5
20682;"Lazdynų mokykla (Žėručio g. 4)";LEPG;9382900638;Ne;0;3;0;3
20683;"Lazdynų mokykla (Žėručio g. 4)";LEPG;1624578455;Ne;0;3;0;3
20684;"Lazdynų mokykla (Žėručio g. 4)";RUPG-1;4776074273;Ne;11;3;3;17
20685;"Lazdynų mokykla (Žėručio g. 4)";RUPG-1;7110858765;Ne;3;3;2;8
20686;"Lazdynų mokykla (Žėručio g. 4)";RUPG-1;6577255841;Ne;4;3;2;9
20687;"Lazdynų mokykla (Žėručio g. 4)";RUPG-1;7647195979;Ne;3;3;2;8
20688;"Lazdynų mokykla (Žėručio g. 4)";RUPG-1;4715171946;Ne;2;3;4;9
20689;"Lazdynų mokykla (Žėručio g. 4)";RUPG-1;2700475528;Ne;1;3;2;6
20690;"Lazdynų mokykla (Žėručio g. 4)";RUPG-1;7180617984;Ne;0;3;1;4
20691;"Lazdynų mokykla (Žėručio g. 4)";RUPG-1;2308739823;Ne;0;3;2;5
20692;"Lazdynų mokykla (Žėručio g. 4)";RUPG-1;5015519090;Ne;11;3;3;17
20693;"Lazdynų mokykla (Žėručio g. 4)";RUPG-1;9968637187;Ne;17;3;2;22
20694;"Lazdynų mokykla (Žėručio g. 4)";RUPG-1;8886654664;Ne;5;3;3;11
20695;"Lazdynų mokykla (Žėručio g. 4)";RUPG-1;1351714626;Ne;0;3;3;6
20696;"Lazdynų mokykla (Žėručio g. 4)";RUPG-1;4494932923;Ne;0;3;1;4
20697;"Lazdynų mokykla (Žėručio g. 4)";RUPG-1;2035060922;Ne;0;3;0;3
20698;"Lazdynų mokykla (Žėručio g. 4)";RUPG-1;8900756351;Ne;0;0;1;1
20699;"Lazdynų mokykla (Žėručio g. 4)";RUPG-2;3837424301;Ne;0;3;2;5
20700;"Lazdynų mokykla (Žėručio g. 4)";RUPG-2;3715070791;Ne;0;3;1;4
20701;"Lazdynų mokykla (Žėručio g. 4)";RUPG-2;8720878006;Ne;0;22;0;22
20702;"Lazdynų mokykla (Žėručio g. 4)";RUPG-2;8675089149;Ne;0;3;2;5
20703;"Lazdynų mokykla (Žėručio g. 4)";RUPG-2;7963866641;Ne;0;3;2;5
20704;"Lazdynų mokykla (Žėručio g. 4)";RUPG-2;9982496951;Ne;1;3;3;7
20705;"Lazdynų mokykla (Žėručio g. 4)";RUPG-2;8229454863;Ne;2;3;4;9
20706;"Lazdynų mokykla (Žėručio g. 4)";RUPG-2;1118653070;Ne;0;3;0;3
20707;"Lazdynų mokykla (Žėručio g. 4)";RUPG-2;5806696915;Ne;0;4;1;5
20708;"Lazdynų mokykla (Žėručio g. 4)";RUPG-2;3634678954;Ne;0;3;1;4
20709;"Lazdynų mokykla (Žėručio g. 4)";RUPG-2;5770044886;Ne;0;4;0;4
20710;"Lazdynų mokykla (Žėručio g. 4)";RUPG-2;2539006620;Ne;0;22;0;22
20711;"Lazdynų mokykla (Žėručio g. 4)";RUPG-2;8757701456;Ne;8;3;2;13
20712;"Lazdynų mokykla (Žėručio g. 4)";RUPG-2;4165354124;Ne;0;3;1;4
20713;"Lazdynų mokykla (Žėručio g. 4)";RUPG-2;9534937419;Ne;0;3;1;4
20714;"Lazdynų mokykla (Žėručio g. 4)";RUPG-2;8448546818;Ne;0;22;0;22
20715;"„Atžalyno” mokykla-darželis";Giliukai;7652421432;Ne;0;1;1;2
20716;"„Atžalyno” mokykla-darželis";Giliukai;1961428224;Ne;0;2;0;2
20717;"„Atžalyno” mokykla-darželis";Giliukai;9101301819;Ne;0;1;4;5
20718;"„Atžalyno” mokykla-darželis";Giliukai;8320161812;Ne;5;2;2;9
20719;"„Atžalyno” mokykla-darželis";Giliukai;7669725276;Ne;0;4;0;4
20720;"„Atžalyno” mokykla-darželis";Giliukai;4784990018;Ne;7;2;5;14
20721;"„Atžalyno” mokykla-darželis";Giliukai;2462839180;Ne;0;5;0;5
20722;"„Atžalyno” mokykla-darželis";Giliukai;8070499557;Ne;0;2;8;10
20723;"„Atžalyno” mokykla-darželis";Giliukai;1915676392;Ne;2;2;1;5
20724;"„Atžalyno” mokykla-darželis";Giliukai;4107946143;Ne;0;1;0;1
20725;"„Atžalyno” mokykla-darželis";Giliukai;9913048992;Ne;0;2;4;6
20726;"„Atžalyno” mokykla-darželis";Giliukai;5335059675;Ne;1;0;8;9
20727;"„Atžalyno” mokykla-darželis";Giliukai;9690554753;Ne;18;2;2;22
20728;"„Atžalyno” mokykla-darželis";Giliukai;2446697763;Ne;0;2;1;3
20729;"„Atžalyno” mokykla-darželis";Giliukai;7579781779;Ne;7;2;2;11
20730;"„Atžalyno” mokykla-darželis";Giliukai;7883570492;Ne;0;2;10;12
20731;"„Atžalyno” mokykla-darželis";Giliukai;4616870552;Ne;0;1;1;2
20732;"„Atžalyno” mokykla-darželis";Giliukai;5986664970;Ne;0;2;0;2
20733;"„Atžalyno” mokykla-darželis";Giliukai;6903825217;Ne;9;2;7;18
20734;"„Atžalyno” mokykla-darželis";Giliukai;8357021249;Ne;0;2;0;2
20735;"„Atžalyno” mokykla-darželis";Giliukai;4582284727;Ne;0;2;0;2
20736;"„Atžalyno” mokykla-darželis";Giliukai;4785607785;Ne;0;2;1;3
20737;"„Atžalyno” mokykla-darželis";Giliukai;4166521512;Ne;7;2;4;13
20738;"„Atžalyno” mokykla-darželis";Giliukai;8372179128;Ne;2;2;5;9
20739;"„Atžalyno” mokykla-darželis";Riešutėliai;4360099345;Ne;19;0;2;21
20740;"„Atžalyno” mokykla-darželis";Riešutėliai;5947938371;Ne;20;0;4;24
20741;"„Atžalyno” mokykla-darželis";Riešutėliai;5384245347;Ne;3;0;4;7
20742;"„Atžalyno” mokykla-darželis";Riešutėliai;4246430352;Ne;10;2;3;15
20743;"„Atžalyno” mokykla-darželis";Riešutėliai;8574494664;Ne;15;5;4;24
20744;"„Atžalyno” mokykla-darželis";Riešutėliai;5815412814;Ne;5;0;4;9
20745;"„Atžalyno” mokykla-darželis";Riešutėliai;4161658496;Ne;0;6;2;8
20746;"„Atžalyno” mokykla-darželis";Riešutėliai;8942132574;Ne;8;3;4;15
20747;"„Atžalyno” mokykla-darželis";Riešutėliai;7368616441;Ne;4;0;10;14
20748;"„Atžalyno” mokykla-darželis";Riešutėliai;5242752663;Ne;8;0;2;10
20749;"„Atžalyno” mokykla-darželis";Riešutėliai;5709028342;Ne;9;3;4;16
20750;"„Atžalyno” mokykla-darželis";Riešutėliai;8803555426;Ne;3;0;3;6
20751;"„Atžalyno” mokykla-darželis";Riešutėliai;5994983369;Ne;3;6;2;11
20752;"„Atžalyno” mokykla-darželis";Riešutėliai;7676614240;Ne;8;1;2;11
20753;"„Atžalyno” mokykla-darželis";Riešutėliai;3751729666;Ne;16;0;3;19
20754;"„Atžalyno” mokykla-darželis";Riešutėliai;3441950153;Ne;8;4;2;14
20755;"„Atžalyno” mokykla-darželis";Riešutėliai;4223591454;Ne;8;2;3;13
20756;"„Atžalyno” mokykla-darželis";Riešutėliai;8625074554;Ne;10;7;0;17
20757;"„Atžalyno” mokykla-darželis";Žirniukai;2849915655;Ne;6;2;3;11
20758;"„Atžalyno” mokykla-darželis";Žirniukai;6120955217;Ne;6;9;2;17
20759;"„Atžalyno” mokykla-darželis";Žirniukai;1787256844;Ne;16;1;6;23
20760;"„Atžalyno” mokykla-darželis";Žirniukai;2547003287;Ne;16;1;6;23
20761;"„Atžalyno” mokykla-darželis";Žirniukai;4503448206;Ne;0;2;3;5
20762;"„Atžalyno” mokykla-darželis";Žirniukai;3664056583;Ne;0;11;2;13
20763;"„Atžalyno” mokykla-darželis";Žirniukai;5456248305;Ne;13;0;3;16
20764;"„Atžalyno” mokykla-darželis";Žirniukai;3719072139;Ne;5;2;3;10
20765;"„Atžalyno” mokykla-darželis";Žirniukai;9245994735;Ne;18;0;6;24
20766;"„Atžalyno” mokykla-darželis";Žirniukai;2000352986;Ne;6;5;4;15
20767;"„Atžalyno” mokykla-darželis";Žirniukai;2177213062;Ne;18;0;3;21
20768;"„Atžalyno” mokykla-darželis";Žirniukai;4635394632;Ne;10;0;8;18
20769;"„Atžalyno” mokykla-darželis";Žirniukai;3524131672;Ne;7;0;4;11
20770;"„Atžalyno” mokykla-darželis";Žirniukai;4840490901;Ne;6;3;6;15
20771;"„Atžalyno” mokykla-darželis";Žirniukai;4796052680;Ne;2;0;8;10
20772;"„Atžalyno” mokykla-darželis";Žirniukai;3181675972;Ne;0;0;3;3
20773;"„Atžalyno” mokykla-darželis";Žirniukai;8163063211;Ne;10;0;9;19
20774;"„Atžalyno” mokykla-darželis";Žirniukai;4431437971;Ne;0;5;2;7
20775;"„Atžalyno” mokykla-darželis";Žirniukai;3770167696;Ne;1;0;7;8
20776;"„Atžalyno” mokykla-darželis";Žirniukai;6307949550;Ne;18;0;14;32
20777;"„Atžalyno” mokykla-darželis";VYŠNIUKAI;9216535506;Ne;0;2;0;2
20778;"„Atžalyno” mokykla-darželis";VYŠNIUKAI;6960661098;Ne;3;1;2;6
20779;"„Atžalyno” mokykla-darželis";VYŠNIUKAI;1059756637;Ne;5;2;2;9
20780;"„Atžalyno” mokykla-darželis";VYŠNIUKAI;7999992997;Ne;20;0;2;22
20781;"„Atžalyno” mokykla-darželis";VYŠNIUKAI;8872288787;Ne;10;2;4;16
20782;"„Atžalyno” mokykla-darželis";VYŠNIUKAI;5410469885;Ne;1;2;2;5
20783;"„Atžalyno” mokykla-darželis";VYŠNIUKAI;5878874414;Ne;0;4;0;4
20784;"„Atžalyno” mokykla-darželis";VYŠNIUKAI;3930056490;Ne;0;2;0;2
20785;"„Atžalyno” mokykla-darželis";VYŠNIUKAI;6984404118;Ne;4;0;6;10
20786;"„Atžalyno” mokykla-darželis";VYŠNIUKAI;6939741360;Ne;6;5;2;13
20787;"„Atžalyno” mokykla-darželis";VYŠNIUKAI;5398871923;Ne;8;3;2;13
20788;"„Atžalyno” mokykla-darželis";VYŠNIUKAI;3046953980;Ne;7;0;3;10
20789;"„Atžalyno” mokykla-darželis";VYŠNIUKAI;2825064244;Ne;8;2;4;14
20790;"„Atžalyno” mokykla-darželis";VYŠNIUKAI;3768908704;Ne;2;3;2;7
20791;"„Atžalyno” mokykla-darželis";VYŠNIUKAI;6959131424;Ne;3;1;2;6
20792;"„Atžalyno” mokykla-darželis";VYŠNIUKAI;1851189680;Ne;8;3;2;13
20793;"„Atžalyno” mokykla-darželis";VYŠNIUKAI;5562429493;Ne;3;2;4;9
20794;"„Atžalyno” mokykla-darželis";PIPIRIUKAI;5615246040;Ne;3;2;7;12
20795;"„Atžalyno” mokykla-darželis";PIPIRIUKAI;1988657552;Ne;8;0;16;24
20796;"„Atžalyno” mokykla-darželis";PIPIRIUKAI;6721771665;Ne;10;2;4;16
20797;"„Atžalyno” mokykla-darželis";PIPIRIUKAI;2921181385;Ne;8;0;7;15
20798;"„Atžalyno” mokykla-darželis";PIPIRIUKAI;2108706876;Ne;11;2;7;20
20799;"„Atžalyno” mokykla-darželis";PIPIRIUKAI;1228919159;Ne;16;5;2;23
20800;"„Atžalyno” mokykla-darželis";PIPIRIUKAI;3919301151;Ne;1;6;5;12
20801;"„Atžalyno” mokykla-darželis";PIPIRIUKAI;3624299098;Ne;6;8;2;16
20802;"„Atžalyno” mokykla-darželis";PIPIRIUKAI;2537063401;Ne;7;2;5;14
20803;"„Atžalyno” mokykla-darželis";PIPIRIUKAI;3204191459;Ne;4;8;2;14
20804;"„Atžalyno” mokykla-darželis";PIPIRIUKAI;5321475187;Ne;0;3;3;6
20805;"„Atžalyno” mokykla-darželis";PIPIRIUKAI;3015863723;Ne;8;7;4;19
20806;"„Atžalyno” mokykla-darželis";PIPIRIUKAI;3323233525;Ne;8;7;4;19
20807;"„Atžalyno” mokykla-darželis";PIPIRIUKAI;4596770586;Ne;9;2;4;15
20808;"„Atžalyno” mokykla-darželis";PIPIRIUKAI;1664011018;Ne;14;2;4;20
20809;"„Atžalyno” mokykla-darželis";PIPIRIUKAI;1866452425;Ne;6;2;0;8
20810;"„Atžalyno” mokykla-darželis";PIPIRIUKAI;9737568538;Ne;5;2;2;9
20811;"„Atžalyno” mokykla-darželis";PIPIRIUKAI;5406800599;Ne;5;5;2;12
20812;"„Atžalyno” mokykla-darželis";PIPIRIUKAI;3312254613;Ne;0;7;0;7
20813;"„Atžalyno” mokykla-darželis";PIPIRIUKAI;1443004141;Ne;0;0;9;9
20814;"Vilniaus Naujininkų mokykla";"SAULĖS ZUIKUČIAI";9856315057;Taip;6;2;0;8
20815;"Vilniaus Naujininkų mokykla";"SAULĖS ZUIKUČIAI";1901250406;Ne;0;6;0;6
20816;"Vilniaus Naujininkų mokykla";"SAULĖS ZUIKUČIAI";9411054207;Ne;0;6;0;6
20817;"Vilniaus Naujininkų mokykla";"SAULĖS ZUIKUČIAI";9544088525;Ne;15;2;0;17
20818;"Vilniaus Naujininkų mokykla";"SAULĖS ZUIKUČIAI";9488762308;Ne;16;2;0;18
20819;"Vilniaus Naujininkų mokykla";"SAULĖS ZUIKUČIAI";3929956703;Ne;13;2;0;15
20820;"Vilniaus Naujininkų mokykla";"SAULĖS ZUIKUČIAI";3502355847;Ne;8;0;0;8
20821;"Vilniaus Naujininkų mokykla";"SAULĖS ZUIKUČIAI";4675274695;Taip;12;3;0;15
20822;"Vilniaus Naujininkų mokykla";"SAULĖS ZUIKUČIAI";3243090025;Ne;0;2;2;4
20823;"Vilniaus Naujininkų mokykla";"SAULĖS ZUIKUČIAI";9786654519;Ne;3;1;0;4
20824;"Vilniaus Naujininkų mokykla";"SAULĖS ZUIKUČIAI";8161853174;Ne;11;2;0;13
20825;"Vilniaus Naujininkų mokykla";"SAULĖS ZUIKUČIAI";6235626283;Ne;0;2;1;3
20826;"Vilniaus Naujininkų mokykla";"SAULĖS ZUIKUČIAI";9699407871;Ne;0;2;0;2
20827;"Vilniaus Naujininkų mokykla";"SAULĖS ZUIKUČIAI";4317656984;Ne;5;2;2;9
20828;"Vilniaus Naujininkų mokykla";SMALSUČIAI;3654667879;Ne;4;0;0;4
20829;"Vilniaus Naujininkų mokykla";SMALSUČIAI;5236782382;Ne;8;2;0;10
20830;"Vilniaus Naujininkų mokykla";SMALSUČIAI;7020599764;Ne;2;2;0;4
20831;"Vilniaus Naujininkų mokykla";SMALSUČIAI;3192556582;Ne;0;6;0;6
20832;"Vilniaus Naujininkų mokykla";SMALSUČIAI;4985740210;Ne;0;2;1;3
20833;"Vilniaus Naujininkų mokykla";SMALSUČIAI;1460027521;Ne;15;0;0;15
20834;"Vilniaus Naujininkų mokykla";SMALSUČIAI;9993335478;Ne;5;2;0;7
20835;"Vilniaus Naujininkų mokykla";SMALSUČIAI;9990953133;Ne;4;0;0;4
20836;"Vilniaus Naujininkų mokykla";SMALSUČIAI;1306106945;Ne;4;2;0;6
20837;"Vilniaus Naujininkų mokykla";SMALSUČIAI;8555610571;Ne;20;2;0;22
20838;"Vilniaus Naujininkų mokykla";SMALSUČIAI;8637047688;Ne;3;1;0;4
20839;"Vilniaus Naujininkų mokykla";SMALSUČIAI;6417648753;Ne;4;0;0;4
20840;"Vilniaus Naujininkų mokykla";SMALSUČIAI;7407987673;Ne;0;2;0;2
20841;"Vilniaus Naujininkų mokykla";SMALSUČIAI;8935072613;Ne;12;2;1;15
20842;"Vilniaus Naujininkų mokykla";SMALSUČIAI;5512321795;Ne;0;8;0;8
20843;"Vilniaus Naujininkų mokykla";SMALSUČIAI;3810550099;Ne;0;2;0;2
20844;"Vilniaus Naujininkų mokykla";SMALSUČIAI;1096474672;Ne;0;2;2;4
20845;"Vilniaus Naujininkų mokykla";SMALSUČIAI;4784667239;Ne;13;2;0;15
20846;"Vilniaus Naujininkų mokykla";SMALSUČIAI;3475476348;Ne;10;2;1;13
20847;"Vilniaus karaliaus Mindaugo mokykla";"PUG 2";4684525618;Ne;0;0;3;3
20848;"Vilniaus karaliaus Mindaugo mokykla";"PUG 2";2938446054;Ne;0;2;0;2
20849;"Vilniaus karaliaus Mindaugo mokykla";"PUG 2";3068754741;Ne;0;2;0;2
20850;"Vilniaus karaliaus Mindaugo mokykla";"PUG 2";4992188525;Ne;8;0;3;11
20851;"Vilniaus karaliaus Mindaugo mokykla";"PUG 2";2287044278;Ne;0;2;3;5
20852;"Vilniaus karaliaus Mindaugo mokykla";"PUG 2";7615716438;Ne;0;0;4;4
20853;"Vilniaus karaliaus Mindaugo mokykla";"PUG 2";6906137103;Ne;2;0;0;2
20854;"Vilniaus karaliaus Mindaugo mokykla";"PUG 2";8229593318;Ne;0;2;1;3
20855;"Vilniaus karaliaus Mindaugo mokykla";"PUG 2";7236658561;Ne;0;2;3;5
20856;"Vilniaus karaliaus Mindaugo mokykla";"PUG 2";8456560292;Ne;0;2;1;3
20857;"Vilniaus karaliaus Mindaugo mokykla";"PUG 2";6384832317;Ne;6;2;4;12
20858;"Vilniaus karaliaus Mindaugo mokykla";"PUG 2";9670205249;Ne;2;0;2;4
20859;"Vilniaus karaliaus Mindaugo mokykla";"PUG 2";3741784446;Ne;0;22;0;22
20860;"Vilniaus karaliaus Mindaugo mokykla";"PUG 2";8578903763;Ne;1;0;6;7
20861;"Vilniaus karaliaus Mindaugo mokykla";"PUG 2";8340697546;Ne;2;0;2;4
20862;"Vilniaus karaliaus Mindaugo mokykla";"PUG 2";3281475303;Ne;0;2;0;2
20863;"Vilniaus karaliaus Mindaugo mokykla";"PUG 2";9780684867;Ne;0;0;2;2
20864;"Vilniaus karaliaus Mindaugo mokykla";"PUG 2";4920263429;Ne;0;0;3;3
20865;"Vilniaus karaliaus Mindaugo mokykla";"PUG 1";3888408459;Ne;0;0;2;2
20866;"Vilniaus karaliaus Mindaugo mokykla";"PUG 1";6315627367;Ne;4;0;2;6
20867;"Vilniaus karaliaus Mindaugo mokykla";"PUG 1";7043125057;Ne;4;2;2;8
20868;"Vilniaus karaliaus Mindaugo mokykla";"PUG 1";5640182548;Ne;2;1;2;5
20869;"Vilniaus karaliaus Mindaugo mokykla";"PUG 1";1998073387;Ne;0;2;0;2
20870;"Vilniaus karaliaus Mindaugo mokykla";"PUG 1";9790803767;Ne;0;2;0;2
20871;"Vilniaus karaliaus Mindaugo mokykla";"PUG 1";4405567649;Ne;0;1;0;1
20872;"Vilniaus karaliaus Mindaugo mokykla";"PUG 1";5752454925;Ne;0;0;4;4
20873;"Vilniaus karaliaus Mindaugo mokykla";"PUG 1";5648658237;Ne;0;0;6;6
20874;"Vilniaus karaliaus Mindaugo mokykla";"PUG 1";5946007985;Ne;0;3;1;4
20875;"Vilniaus karaliaus Mindaugo mokykla";"PUG 1";7770852445;Ne;0;3;1;4
20876;"Vilniaus karaliaus Mindaugo mokykla";"PUG 1";3953844737;Ne;0;2;1;3
20877;"Vilniaus karaliaus Mindaugo mokykla";"PUG 1";7271589727;Ne;0;5;1;6
20878;"Vilniaus karaliaus Mindaugo mokykla";"PUG 1";1403569615;Ne;0;2;0;2
20879;"Vilniaus karaliaus Mindaugo mokykla";"PUG 1";9651789217;Ne;0;2;2;4
20880;"Vilniaus karaliaus Mindaugo mokykla";"PUG 1";2926077771;Ne;0;8;0;8
20881;"Vilniaus karaliaus Mindaugo mokykla";"PUG 1";3587941684;Ne;0;5;1;6
20882;"Vilniaus karaliaus Mindaugo mokykla";"PUG 1";2549704540;Ne;0;6;0;6
20883;"Vilniaus karaliaus Mindaugo mokykla";"PUG 1";2361829423;Ne;0;0;3;3
20884;"Vilniaus karaliaus Mindaugo mokykla";"PUG 3";6406285034;Ne;0;2;3;5
20885;"Vilniaus karaliaus Mindaugo mokykla";"PUG 3";7433354196;Ne;0;0;4;4
20886;"Vilniaus karaliaus Mindaugo mokykla";"PUG 3";3252419072;Ne;3;0;2;5
20887;"Vilniaus karaliaus Mindaugo mokykla";"PUG 3";9056468879;Ne;0;0;5;5
20888;"Vilniaus karaliaus Mindaugo mokykla";"PUG 3";4559316741;Ne;0;2;1;3
20889;"Vilniaus karaliaus Mindaugo mokykla";"PUG 3";1945918102;Ne;0;2;2;4
20890;"Vilniaus karaliaus Mindaugo mokykla";"PUG 3";1814323427;Ne;0;2;7;9
20891;"Vilniaus karaliaus Mindaugo mokykla";"PUG 3";7351939034;Ne;0;9;2;11
20892;"Vilniaus karaliaus Mindaugo mokykla";"PUG 3";2319707653;Ne;0;0;3;3
20893;"Vilniaus karaliaus Mindaugo mokykla";"PUG 3";4741154518;Ne;0;2;1;3
20894;"Vilniaus karaliaus Mindaugo mokykla";"PUG 3";4215451069;Ne;0;0;1;1
20895;"Vilniaus karaliaus Mindaugo mokykla";"PUG 3";9921191336;Ne;0;2;2;4
20896;"Vilniaus karaliaus Mindaugo mokykla";"PUG 3";2044795759;Ne;2;0;3;5
20897;"Vilniaus karaliaus Mindaugo mokykla";"PUG 3";5103259175;Ne;0;0;8;8
20898;"Vilniaus karaliaus Mindaugo mokykla";"PUG 3";5613442667;Ne;5;0;4;9
20899;"Vilniaus karaliaus Mindaugo mokykla";"PUG 3";7149197796;Ne;0;22;0;22
20900;"Vilniaus karaliaus Mindaugo mokykla";"PUG 3";8705825002;Ne;0;0;1;1
20901;"Vilniaus karaliaus Mindaugo mokykla";"PUG 3";7638190553;Ne;10;0;2;12
20902;"Vilniaus karaliaus Mindaugo mokykla";"PUG 3";6762306583;Ne;4;2;4;10
20903;"Vilniaus karaliaus Mindaugo mokykla";"PUG 3";1621497786;Ne;0;0;1;1
20904;"Vilniaus Levo Karsavino vidurinė mokykla";PELEDŽIUKAI;4043810535;Ne;0;5;0;5
20905;"Vilniaus Levo Karsavino vidurinė mokykla";PELEDŽIUKAI;1887013803;Ne;0;5;2;7
20906;"Vilniaus Levo Karsavino vidurinė mokykla";PELEDŽIUKAI;6464887268;Ne;0;7;0;7
20907;"Vilniaus Levo Karsavino vidurinė mokykla";PELEDŽIUKAI;5876182759;Ne;0;6;0;6
20908;"Vilniaus Levo Karsavino vidurinė mokykla";PELEDŽIUKAI;6569135467;Ne;2;6;2;10
20909;"Vilniaus Levo Karsavino vidurinė mokykla";PELEDŽIUKAI;3117948118;Ne;0;5;0;5
20910;"Vilniaus Levo Karsavino vidurinė mokykla";PELEDŽIUKAI;2654373943;Ne;3;6;3;12
20911;"Vilniaus Levo Karsavino vidurinė mokykla";PELEDŽIUKAI;9988041515;Ne;0;5;0;5
20912;"Vilniaus Levo Karsavino vidurinė mokykla";PELEDŽIUKAI;9108428738;Ne;0;5;0;5
20913;"Vilniaus Levo Karsavino vidurinė mokykla";PELEDŽIUKAI;6099940488;Ne;4;5;2;11
20914;"Vilniaus Levo Karsavino vidurinė mokykla";PELEDŽIUKAI;7824348276;Ne;0;5;2;7
20915;"Vilniaus Levo Karsavino vidurinė mokykla";PELEDŽIUKAI;3547185618;Ne;0;5;0;5
20916;"Vilniaus Levo Karsavino vidurinė mokykla";PELEDŽIUKAI;2681013154;Ne;0;7;0;7
20917;"Vilniaus Levo Karsavino vidurinė mokykla";PELEDŽIUKAI;3780475392;Ne;0;10;0;10
20918;"Vilniaus Levo Karsavino vidurinė mokykla";PELEDŽIUKAI;3211649292;Ne;0;5;1;6
20919;"Vilniaus Levo Karsavino vidurinė mokykla";PELEDŽIUKAI;8386409466;Ne;0;5;2;7
20920;"Vilniaus Levo Karsavino vidurinė mokykla";PELEDŽIUKAI;3059970035;Ne;0;5;0;5
20921;"Vilniaus Levo Karsavino vidurinė mokykla";PELEDŽIUKAI;7023534254;Ne;0;5;2;7
20922;"Vilniaus Levo Karsavino vidurinė mokykla";PELEDŽIUKAI;4493469560;Ne;2;5;2;9
20923;"Vilniaus Levo Karsavino vidurinė mokykla";PELEDŽIUKAI;3608920051;Ne;0;6;0;6
20924;"Vilniaus Levo Karsavino vidurinė mokykla";ŽINIUKAI;4416434150;Ne;5;5;4;14
20925;"Vilniaus Levo Karsavino vidurinė mokykla";ŽINIUKAI;9325387975;Ne;0;5;4;9
20926;"Vilniaus Levo Karsavino vidurinė mokykla";ŽINIUKAI;2013694393;Ne;15;5;2;22
20927;"Vilniaus Levo Karsavino vidurinė mokykla";ŽINIUKAI;2107123106;Ne;0;5;4;9
20928;"Vilniaus Levo Karsavino vidurinė mokykla";ŽINIUKAI;7482740111;Ne;0;5;0;5
20929;"Vilniaus Levo Karsavino vidurinė mokykla";ŽINIUKAI;5408157164;Ne;0;5;3;8
20930;"Vilniaus Levo Karsavino vidurinė mokykla";ŽINIUKAI;2122665619;Ne;0;5;2;7
20931;"Vilniaus Levo Karsavino vidurinė mokykla";ŽINIUKAI;1632925219;Ne;0;5;4;9
20932;"Vilniaus Levo Karsavino vidurinė mokykla";ŽINIUKAI;1750209600;Ne;0;5;0;5
20933;"Vilniaus Levo Karsavino vidurinė mokykla";ŽINIUKAI;8364902911;Ne;0;5;0;5
20934;"Vilniaus Levo Karsavino vidurinė mokykla";ŽINIUKAI;8827421660;Ne;0;5;0;5
20935;"Vilniaus Levo Karsavino vidurinė mokykla";ŽINIUKAI;3943002728;Ne;3;5;3;11
20936;"Vilniaus Levo Karsavino vidurinė mokykla";ŽINIUKAI;2697867000;Ne;0;5;4;9
20937;"Vilniaus Levo Karsavino vidurinė mokykla";ŽINIUKAI;1165219272;Ne;0;5;0;5
20938;"Vilniaus Levo Karsavino vidurinė mokykla";ŽINIUKAI;7541217656;Ne;3;5;2;10
20939;"Vilniaus Levo Karsavino vidurinė mokykla";ŽINIUKAI;6391999153;Ne;2;5;2;9
20940;"Vilniaus Levo Karsavino vidurinė mokykla";ŽINIUKAI;4613894944;Ne;0;5;6;11
20941;"Vilniaus Levo Karsavino vidurinė mokykla";ŽINIUKAI;8517226350;Ne;0;5;0;5
20942;"Vilniaus Levo Karsavino vidurinė mokykla";ŽINIUKAI;5102718403;Ne;2;5;4;11
20943;"Vilniaus Levo Karsavino vidurinė mokykla";ŽINIUKAI;5692603837;Ne;4;5;2;11
20944;"Vilniaus Levo Karsavino vidurinė mokykla";ŽINIUKAI;6945510312;Ne;3;5;5;13
20945;"Vilniaus Liepkalnio Pagrindinė Mokykla";Bitutės;3144718477;Ne;1;2;2;5
20946;"Vilniaus Liepkalnio Pagrindinė Mokykla";Bitutės;5682528849;Ne;0;2;4;6
20947;"Vilniaus Liepkalnio Pagrindinė Mokykla";Bitutės;1777442316;Ne;0;2;2;4
20948;"Vilniaus Liepkalnio Pagrindinė Mokykla";Bitutės;8723898832;Ne;1;2;4;7
20949;"Vilniaus Liepkalnio Pagrindinė Mokykla";Bitutės;8080492986;Ne;3;2;2;7
20950;"Vilniaus Liepkalnio Pagrindinė Mokykla";Bitutės;3239288878;Ne;3;2;6;11
20951;"Vilniaus Liepkalnio Pagrindinė Mokykla";Bitutės;6829438486;Ne;0;2;1;3
20952;"Vilniaus Liepkalnio Pagrindinė Mokykla";Bitutės;3369970611;Ne;1;2;4;7
20953;"Vilniaus Liepkalnio Pagrindinė Mokykla";Bitutės;4344780723;Ne;0;2;3;5
20954;"Vilniaus Liepkalnio Pagrindinė Mokykla";Bitutės;1085400709;Ne;0;2;2;4
20955;"Vilniaus Liepkalnio Pagrindinė Mokykla";Bitutės;8387453394;Ne;0;2;2;4
20956;"Vilniaus Liepkalnio Pagrindinė Mokykla";Bitutės;8478417679;Ne;0;2;1;3
20957;"Vilniaus Pranciškaus Skorinos gimnazija";SAULYTĖ;3621289572;Ne;1;2;2;5
20958;"Vilniaus Pranciškaus Skorinos gimnazija";SAULYTĖ;8946940285;Ne;0;2;7;9
20959;"Vilniaus Pranciškaus Skorinos gimnazija";SAULYTĖ;2978563798;Ne;0;7;1;8
20960;"Vilniaus Pranciškaus Skorinos gimnazija";SAULYTĖ;2347857813;Ne;3;2;5;10
20961;"Vilniaus Pranciškaus Skorinos gimnazija";SAULYTĖ;2220506064;Ne;0;10;9;19
20962;"Vilniaus Pranciškaus Skorinos gimnazija";SAULYTĖ;1797706575;Ne;0;10;9;19
20963;"Vilniaus Pranciškaus Skorinos gimnazija";SAULYTĖ;9424930375;Ne;0;10;9;19
20964;"Vilniaus Pranciškaus Skorinos gimnazija";SAULYTĖ;3558729735;Ne;0;10;0;10
20965;"Vilniaus Pranciškaus Skorinos gimnazija";SAULYTĖ;7197420388;Ne;0;2;0;2
20966;"Vilniaus Pranciškaus Skorinos gimnazija";SAULYTĖ;9107920165;Ne;0;2;0;2
20967;"Vilniaus Pranciškaus Skorinos gimnazija";SAULYTĖ;2290343066;Ne;0;30;0;30
20968;"Vilniaus Pranciškaus Skorinos gimnazija";SAULYTĖ;4500542668;Ne;0;2;3;5
20969;"Vilniaus Pranciškaus Skorinos gimnazija";SAULYTĖ;2782818158;Ne;0;2;1;3
20970;"Vilniaus Pranciškaus Skorinos gimnazija";SAULYTĖ;4719223490;Ne;1;2;2;5
20971;"Vilniaus Pranciškaus Skorinos gimnazija";SAULYTĖ;6892006495;Ne;1;6;0;7
20972;"Vilniaus Pranciškaus Skorinos gimnazija";SAULYTĖ;8592478282;Ne;0;2;4;6
20973;"Vilniaus Pranciškaus Skorinos gimnazija";SAULYTĖ;4522879237;Ne;0;2;18;20
20974;"Vilniaus Simono Konarskio gimnazija";"1 GR.";6861123988;Ne;0;0;1;1
20975;"Vilniaus Simono Konarskio gimnazija";"1 GR.";9009809585;Ne;13;0;2;15
20976;"Vilniaus Simono Konarskio gimnazija";"1 GR.";4048726627;Ne;0;0;1;1
20977;"Vilniaus Simono Konarskio gimnazija";"1 GR.";6693019825;Ne;8;0;2;10
20978;"Vilniaus Simono Konarskio gimnazija";"1 GR.";1532248269;Ne;1;0;3;4
20979;"Vilniaus Simono Konarskio gimnazija";"1 GR.";3675401775;Ne;3;0;4;7
20980;"Vilniaus Simono Konarskio gimnazija";"1 GR.";4338067260;Ne;2;0;2;4
20981;"Vilniaus Simono Konarskio gimnazija";"1 GR.";3641822841;Ne;4;0;2;6
20982;"Vilniaus Simono Konarskio gimnazija";"1 GR.";4858617162;Ne;13;0;2;15
20983;"Vilniaus Simono Konarskio gimnazija";"1 GR.";9065848425;Ne;3;0;2;5
20984;"Vilniaus Simono Konarskio gimnazija";"1 GR.";7230987338;Ne;0;0;4;4
20985;"Vilniaus Trakų Vokės gimnazija";DRUGELIAI;8874384610;Ne;4;2;5;11
20986;"Vilniaus Trakų Vokės gimnazija";DRUGELIAI;4535167417;Ne;1;2;2;5
20987;"Vilniaus Trakų Vokės gimnazija";DRUGELIAI;2539647111;Ne;0;2;0;2
20988;"Vilniaus Trakų Vokės gimnazija";DRUGELIAI;2453791555;Ne;11;1;2;14
20989;"Vilniaus Trakų Vokės gimnazija";DRUGELIAI;4854440884;Ne;5;22;0;27
20990;"Vilniaus Trakų Vokės gimnazija";DRUGELIAI;2761614687;Ne;5;22;0;27
20991;"Vilniaus Trakų Vokės gimnazija";DRUGELIAI;8706990390;Ne;19;0;0;19
20992;"Vilniaus Trakų Vokės gimnazija";DRUGELIAI;9094930495;Ne;1;2;3;6
20993;"Vilniaus Trakų Vokės gimnazija";DRUGELIAI;9483709021;Ne;0;2;0;2
20994;"Vilniaus Trakų Vokės gimnazija";DRUGELIAI;2880299812;Ne;0;0;1;1
20995;"Vilniaus Trakų Vokės gimnazija";DRUGELIAI;9506008651;Ne;4;0;3;7
20996;"Vilniaus Trakų Vokės gimnazija";DRUGELIAI;6326568445;Ne;0;3;1;4
20997;"Vilniaus Trakų Vokės gimnazija";DRUGELIAI;1360046096;Ne;8;2;4;14
20998;"Vilniaus Trakų Vokės gimnazija";DRUGELIAI;2503382218;Ne;3;0;2;5
20999;"Vilniaus Trakų Vokės gimnazija";DRUGELIAI;3278842582;Ne;0;2;0;2
21000;"Vilniaus Trakų Vokės gimnazija";DRUGELIAI;3611639112;Ne;3;3;2;8
21001;"Vilniaus Trakų Vokės gimnazija";DRUGELIAI;8605461082;Ne;2;0;3;5
21002;"Vilniaus Trakų Vokės gimnazija";DRUGELIAI;3328527700;Ne;0;2;4;6
21003;"Vilniaus Trakų Vokės gimnazija";DRUGELIAI;5206616285;Ne;6;2;2;10
21004;"Vilniaus Trakų Vokės gimnazija";DRUGELIAI;8929514493;Ne;1;2;4;7
21005;"Vilniaus Trakų Vokės gimnazija";DRUGELIAI;9233090228;Ne;10;0;3;13
21006;"Vilniaus Trakų Vokės gimnazija";VOVERIUKAI;1088928094;Ne;0;0;2;2
21007;"Vilniaus Trakų Vokės gimnazija";VOVERIUKAI;7318458282;Ne;9;2;3;14
21008;"Vilniaus Trakų Vokės gimnazija";VOVERIUKAI;1080300137;Ne;8;2;2;12
21009;"Vilniaus Trakų Vokės gimnazija";VOVERIUKAI;2469340933;Ne;3;0;2;5
21010;"Vilniaus Trakų Vokės gimnazija";VOVERIUKAI;6908913934;Ne;11;2;3;16
21011;"Vilniaus Trakų Vokės gimnazija";VOVERIUKAI;4362066941;Ne;4;7;0;11
21012;"Vilniaus Trakų Vokės gimnazija";VOVERIUKAI;3555513755;Ne;0;4;0;4
21013;"Vilniaus Trakų Vokės gimnazija";VOVERIUKAI;5338798362;Ne;6;2;0;8
21014;"Vilniaus Trakų Vokės gimnazija";VOVERIUKAI;9582511053;Ne;0;9;0;9
21015;"Vilniaus Trakų Vokės gimnazija";VOVERIUKAI;3319243283;Ne;0;0;1;1
21016;"Vilniaus Trakų Vokės gimnazija";VOVERIUKAI;1039690987;Ne;2;0;4;6
21017;"Vilniaus Trakų Vokės gimnazija";VOVERIUKAI;6908487075;Ne;2;2;5;9
21018;"Vilniaus Trakų Vokės gimnazija";VOVERIUKAI;1910363787;Ne;5;2;4;11
21019;"Vilniaus Trakų Vokės gimnazija";VOVERIUKAI;7858812338;Ne;3;0;2;5
21020;"Vilniaus Trakų Vokės gimnazija";VOVERIUKAI;3913623741;Ne;0;0;2;2
21021;"Vilniaus Trakų Vokės gimnazija";VOVERIUKAI;4520091712;Ne;2;0;1;3
21022;"Vilniaus Trakų Vokės gimnazija";VOVERIUKAI;8168960897;Ne;6;2;4;12
21023;"Vilniaus Trakų Vokės gimnazija";VOVERIUKAI;1057189769;Ne;4;0;2;6
21024;"Vilniaus Trakų Vokės gimnazija";VOVERIUKAI;4014027030;Ne;5;0;5;10
21025;"Vilniaus Trakų Vokės gimnazija";VOVERIUKAI;7660240598;Ne;13;6;2;21
21026;"Vilniaus Trakų Vokės gimnazija";VOVERIUKAI;4438127190;Ne;8;0;9;17
21027;"Vilniaus Trakų Vokės gimnazija";VOVERIUKAI;2388817616;Ne;2;0;4;6
21028;"Vilniaus Trakų Vokės gimnazija";VOVERIUKAI;8472834181;Ne;16;1;2;19
21029;"Vilniaus Trakų Vokės gimnazija";BITUTĖS;6369848950;Ne;2;1;4;7
21030;"Vilniaus Trakų Vokės gimnazija";BITUTĖS;6732422645;Ne;0;3;1;4
21031;"Vilniaus Trakų Vokės gimnazija";BITUTĖS;7909596435;Ne;14;1;4;19
21032;"Vilniaus Trakų Vokės gimnazija";BITUTĖS;6751625456;Ne;6;1;2;9
21033;"Vilniaus Trakų Vokės gimnazija";BITUTĖS;7752786907;Ne;7;2;4;13
21034;"Vilniaus Trakų Vokės gimnazija";BITUTĖS;2475068032;Ne;0;0;4;4
21035;"Vilniaus Trakų Vokės gimnazija";BITUTĖS;9819489467;Ne;0;2;0;2
21036;"Vilniaus Trakų Vokės gimnazija";BITUTĖS;2516219363;Ne;0;5;5;10
21037;"Vilniaus Trakų Vokės gimnazija";BITUTĖS;2571561865;Ne;6;1;3;10
21038;"Vilniaus Trakų Vokės gimnazija";BITUTĖS;6765094662;Ne;0;5;0;5
21039;"Vilniaus Trakų Vokės gimnazija";BITUTĖS;4601374629;Ne;3;0;5;8
21040;"Vilniaus Trakų Vokės gimnazija";BITUTĖS;9051697544;Ne;1;2;8;11
21041;"Vilniaus Trakų Vokės gimnazija";BITUTĖS;3346395516;Ne;0;3;1;4
21042;"Vilniaus Trakų Vokės gimnazija";BITUTĖS;9453317084;Ne;5;2;2;9
21043;"Vilniaus Trakų Vokės gimnazija";BITUTĖS;2869217654;Taip;0;2;0;2
21044;"Vilniaus Trakų Vokės gimnazija";BITUTĖS;7508070996;Ne;10;2;15;27
21045;"Vilniaus Trakų Vokės gimnazija";BITUTĖS;1602352855;Ne;0;1;12;13
21046;"Vilniaus Trakų Vokės gimnazija";BITUTĖS;5695160925;Ne;0;0;5;5
21047;"Vilniaus Trakų Vokės gimnazija";BITUTĖS;9668538340;Ne;0;6;2;8
21048;"Vilniaus Trakų Vokės gimnazija";BITUTĖS;3449317958;Ne;4;1;3;8
21049;"Vilniaus Trakų Vokės gimnazija";BITUTĖS;1398572100;Ne;8;3;4;15
21050;"Vilniaus Trakų Vokės gimnazija";BITUTĖS;2469486746;Ne;3;1;7;11
21051;"Vilniaus Ryto progimnazija";RYTUKAI;3397350274;Ne;8;0;3;11
21052;"Vilniaus Ryto progimnazija";RYTUKAI;4822495270;Ne;8;0;3;11
21053;"Vilniaus Ryto progimnazija";RYTUKAI;5267128750;Ne;1;0;3;4
21054;"Vilniaus Ryto progimnazija";RYTUKAI;9197480840;Ne;0;0;1;1
21055;"Vilniaus Ryto progimnazija";RYTUKAI;2537442505;Ne;0;0;3;3
21056;"Vilniaus Ryto progimnazija";RYTUKAI;7365398150;Ne;1;0;3;4
21057;"Vilniaus Ryto progimnazija";RYTUKAI;7873373923;Ne;0;0;2;2
21058;"Vilniaus Ryto progimnazija";RYTUKAI;7638618099;Ne;0;0;2;2
21059;"Vilniaus Ryto progimnazija";RYTUKAI;6852734826;Ne;3;0;5;8
21060;"Vilniaus Ryto progimnazija";RYTUKAI;5494350183;Ne;0;3;0;3
21061;"Vilniaus Ryto progimnazija";RYTUKAI;4086461803;Ne;2;0;2;4
21062;"Vilniaus Ryto progimnazija";RYTUKAI;2921485707;Ne;13;0;3;16
21063;"Vilniaus Ryto progimnazija";RYTUKAI;4029370760;Ne;1;0;2;3
21064;"Vilniaus Salininkų gimnazija";"Priešmokyklinė A";6850925495;Ne;0;2;0;2
21065;"Vilniaus Salininkų gimnazija";"Priešmokyklinė A";6577237672;Ne;0;2;0;2
21066;"Vilniaus Salininkų gimnazija";"Priešmokyklinė A";2760231414;Ne;0;2;0;2
21067;"Vilniaus Salininkų gimnazija";"Priešmokyklinė A";7665409499;Ne;3;2;2;7
21068;"Vilniaus Salininkų gimnazija";"Priešmokyklinė A";8603759429;Ne;0;2;0;2
21069;"Vilniaus Salininkų gimnazija";"Priešmokyklinė A";9724367035;Ne;0;2;0;2
21070;"Vilniaus Salininkų gimnazija";"Priešmokyklinė A";8995565864;Ne;0;2;0;2
21071;"Vilniaus Salininkų gimnazija";"Priešmokyklinė A";7782972361;Ne;7;2;2;11
21072;"Vilniaus Salininkų gimnazija";"Priešmokyklinė A";8394582546;Ne;0;4;0;4
21073;"Vilniaus Salininkų gimnazija";"Priešmokyklinė A";6327046935;Ne;2;2;3;7
21074;"Vilniaus Salininkų gimnazija";"Priešmokyklinė A";4425748908;Ne;0;8;0;8
21075;"Vilniaus Salininkų gimnazija";"Priešmokyklinė A";8774984357;Ne;0;7;0;7
21076;"Vilniaus Salininkų gimnazija";"Priešmokyklinė A";6155979185;Ne;3;3;2;8
21077;"Vilniaus Salininkų gimnazija";"Priešmokyklinė A";6485917683;Ne;0;3;0;3
21078;"Vilniaus Salininkų gimnazija";"Priešmokyklinė A";8206979332;Ne;0;3;0;3
21079;"Vilniaus Salininkų gimnazija";"Priešmokyklinė A";7737045952;Ne;0;2;0;2
21080;"Vilniaus Salininkų gimnazija";"Priešmokyklinė A";4323257798;Ne;0;2;0;2
21081;"Vilniaus Salininkų gimnazija";"Priešmokyklinė A";1975168626;Ne;0;2;0;2
21082;"Vilniaus Salininkų gimnazija";"Priešmokyklinė A";8016341646;Ne;0;2;1;3
21083;"Vilniaus Salininkų gimnazija";"Priešmokyklinė A";2262425557;Ne;1;2;2;5
21084;"Vilniaus Salininkų gimnazija";"PRIEŠMOKYKLINĖ B";5427013789;Ne;0;3;1;4
21085;"Vilniaus Salininkų gimnazija";"PRIEŠMOKYKLINĖ B";3100499807;Ne;0;4;0;4
21086;"Vilniaus Salininkų gimnazija";"PRIEŠMOKYKLINĖ B";5867676844;Ne;0;2;2;4
21087;"Vilniaus Salininkų gimnazija";"PRIEŠMOKYKLINĖ B";3122948974;Ne;0;2;0;2
21088;"Vilniaus Salininkų gimnazija";"PRIEŠMOKYKLINĖ B";3585435095;Ne;9;2;2;13
21089;"Vilniaus Salininkų gimnazija";"PRIEŠMOKYKLINĖ B";1658695150;Ne;0;2;3;5
21090;"Vilniaus Salininkų gimnazija";"PRIEŠMOKYKLINĖ B";3737834032;Ne;0;2;0;2
21091;"Vilniaus Salininkų gimnazija";"PRIEŠMOKYKLINĖ B";9344614003;Ne;0;2;0;2
21092;"Vilniaus Salininkų gimnazija";"PRIEŠMOKYKLINĖ B";2808778763;Ne;0;2;1;3
21093;"Vilniaus Salininkų gimnazija";"PRIEŠMOKYKLINĖ B";9890660815;Ne;0;2;0;2
21094;"Vilniaus Salininkų gimnazija";"PRIEŠMOKYKLINĖ B";8189699392;Ne;0;2;0;2
21095;"Vilniaus Salininkų gimnazija";"PRIEŠMOKYKLINĖ B";8047582970;Ne;0;2;1;3
21096;"Vilniaus Salininkų gimnazija";"PRIEŠMOKYKLINĖ B";3739751121;Ne;2;2;2;6
21097;"Vilniaus Salininkų gimnazija";"PRIEŠMOKYKLINĖ B";7403996266;Ne;0;2;3;5
21098;"Vilniaus Salininkų gimnazija";"PRIEŠMOKYKLINĖ B";2495718547;Ne;0;2;4;6
21099;"Vilniaus Salininkų gimnazija";"PRIEŠMOKYKLINĖ B";9813360176;Ne;3;3;2;8
21100;"Vilniaus Salininkų gimnazija";"PRIEŠMOKYKLINĖ B";6656578271;Ne;0;2;1;3
21101;"Vilniaus Salininkų gimnazija";"PRIEŠMOKYKLINĖ B";6266609965;Ne;0;3;0;3
21102;"Vilniaus Salininkų gimnazija";"PRIEŠMOKYKLINĖ B";3196285660;Ne;1;2;2;5
21103;"Vilniaus Salininkų gimnazija";"PRIEŠMOKYKLINĖ B";4771867627;Ne;5;2;4;11
21104;"Vilniaus „Spindulio“ progimnazija";PM2;4119370256;Ne;0;3;0;3
21105;"Vilniaus „Spindulio“ progimnazija";PM2;8076961367;Ne;0;3;0;3
21106;"Vilniaus „Spindulio“ progimnazija";PM2;8439204095;Ne;0;2;0;2
21107;"Vilniaus „Spindulio“ progimnazija";PM2;6352250868;Ne;0;2;0;2
21108;"Vilniaus „Spindulio“ progimnazija";PM2;7273838695;Ne;0;2;0;2
21109;"Vilniaus „Spindulio“ progimnazija";PM2;8440546956;Ne;0;2;0;2
21110;"Vilniaus „Spindulio“ progimnazija";PM2;1030958414;Ne;0;3;0;3
21111;"Vilniaus „Spindulio“ progimnazija";PM2;5030400578;Ne;0;10;0;10
21112;"Vilniaus „Spindulio“ progimnazija";PM2;1200205376;Ne;1;2;2;5
21113;"Vilniaus „Spindulio“ progimnazija";PM2;2010703982;Ne;0;2;0;2
21114;"Vilniaus „Spindulio“ progimnazija";PM2;1455509576;Ne;3;2;2;7
21115;"Vilniaus „Spindulio“ progimnazija";PM2;6935992202;Ne;4;2;4;10
21116;"Vilniaus „Spindulio“ progimnazija";PM2;2094258481;Ne;2;4;2;8
21117;"Vilniaus „Spindulio“ progimnazija";PM2;1005082012;Ne;3;2;5;10
21118;"Vilniaus „Spindulio“ progimnazija";PM2;7197544314;Ne;0;2;0;2
21119;"Vilniaus „Spindulio“ progimnazija";PM2;4678970810;Ne;1;2;2;5
21120;"Vilniaus „Spindulio“ progimnazija";PM2;3985610575;Ne;3;2;4;9
21121;"Vilniaus „Spindulio“ progimnazija";PM2;6531930806;Ne;0;2;0;2
21122;"Vilniaus „Spindulio“ progimnazija";PM2;4179507316;Ne;2;2;2;6
21123;"Vilniaus „Spindulio“ progimnazija";PM2;5783537897;Ne;0;2;0;2
21124;"Vilniaus „Spindulio“ progimnazija";PM2;8936645508;Ne;3;2;4;9
21125;"Vilniaus „Spindulio“ progimnazija";PM2;1153948822;Ne;0;2;0;2
21126;"Vilniaus „Spindulio“ progimnazija";PM2;3284212595;Ne;0;2;0;2
21127;"Vilniaus „Spindulio“ progimnazija";PM2;8728791932;Ne;3;2;2;7
21128;"Vilniaus „Spindulio“ progimnazija";PM1;8160982025;Ne;1;2;2;5
21129;"Vilniaus „Spindulio“ progimnazija";PM1;5835209357;Ne;0;2;0;2
21130;"Vilniaus „Spindulio“ progimnazija";PM1;6578506861;Ne;0;2;1;3
21131;"Vilniaus „Spindulio“ progimnazija";PM1;9628317328;Ne;2;2;4;8
21132;"Vilniaus „Spindulio“ progimnazija";PM1;9898412288;Ne;3;2;3;8
21133;"Vilniaus „Spindulio“ progimnazija";PM1;6577214344;Ne;0;2;4;6
21134;"Vilniaus „Spindulio“ progimnazija";PM1;8432654056;Ne;0;2;0;2
21135;"Vilniaus „Spindulio“ progimnazija";PM1;7487111570;Ne;0;2;1;3
21136;"Vilniaus „Spindulio“ progimnazija";PM1;5327627748;Ne;0;2;3;5
21137;"Vilniaus „Spindulio“ progimnazija";PM1;6575909478;Ne;0;2;0;2
21138;"Vilniaus „Spindulio“ progimnazija";PM1;6047881184;Ne;0;7;0;7
21139;"Vilniaus „Spindulio“ progimnazija";PM1;6826790492;Ne;0;2;0;2
21140;"Vilniaus „Spindulio“ progimnazija";PM1;5123666058;Ne;0;4;1;5
21141;"Vilniaus „Spindulio“ progimnazija";PM1;5305660046;Ne;0;2;1;3
21142;"Vilniaus „Spindulio“ progimnazija";PM1;5210301367;Ne;0;2;0;2
21143;"Vilniaus „Spindulio“ progimnazija";PM1;2948291866;Ne;0;2;2;4
21144;"Vilniaus „Spindulio“ progimnazija";PM1;2945894661;Ne;2;2;3;7
21145;"Vilniaus „Spindulio“ progimnazija";PM1;1392036584;Ne;10;2;4;16
21146;"Vilniaus „Spindulio“ progimnazija";PM1;4713803167;Ne;8;3;2;13
21147;"Vilniaus „Spindulio“ progimnazija";PM1;2066127119;Ne;3;2;2;7
21148;"Vilniaus „Spindulio“ progimnazija";PM1;9074294473;Ne;0;22;0;22
21149;"Vilniaus „Spindulio“ progimnazija";PM1;3554823424;Ne;0;2;1;3
21150;"Vilniaus „Spindulio“ progimnazija";PM1;4347116918;Ne;3;2;2;7
21151;"Vilniaus Vladislavo Sirokomlės gimnazija";Nykštukai;1588062393;Ne;0;11;0;11
21152;"Vilniaus Vladislavo Sirokomlės gimnazija";Nykštukai;4715704693;Ne;0;5;0;5
21153;"Vilniaus Vladislavo Sirokomlės gimnazija";Nykštukai;6451722893;Ne;0;2;2;4
21154;"Vilniaus Vladislavo Sirokomlės gimnazija";Nykštukai;2923698853;Ne;0;32;0;32
21155;"Vilniaus Vladislavo Sirokomlės gimnazija";Nykštukai;7364698713;Ne;10;6;0;16
21156;"Vilniaus Vladislavo Sirokomlės gimnazija";Nykštukai;6613003059;Ne;0;3;0;3
21157;"Vilniaus Vladislavo Sirokomlės gimnazija";Nykštukai;7113970557;Ne;3;6;2;11
21158;"Vilniaus Vladislavo Sirokomlės gimnazija";Nykštukai;1698478530;Ne;8;2;2;12
21159;"Vilniaus Vladislavo Sirokomlės gimnazija";Nykštukai;7413098580;Ne;5;5;0;10
21160;"Vilniaus Vladislavo Sirokomlės gimnazija";Nykštukai;6843262303;Ne;0;3;0;3
21161;"Vilniaus Vladislavo Sirokomlės gimnazija";Nykštukai;5150028968;Ne;2;4;0;6
21162;"Vilniaus Vladislavo Sirokomlės gimnazija";Nykštukai;5999318972;Ne;4;4;2;10
21163;"Vilniaus Vladislavo Sirokomlės gimnazija";Nykštukai;2092319455;Ne;1;10;2;13
21164;"Vilniaus Vladislavo Sirokomlės gimnazija";Nykštukai;5822045625;Ne;0;3;0;3
21165;"Vilniaus Vladislavo Sirokomlės gimnazija";Nykštukai;2373600520;Ne;0;3;0;3
21166;"Vilniaus Vladislavo Sirokomlės gimnazija";Nykštukai;6166192468;Ne;0;7;0;7
21167;"Vilniaus Vladislavo Sirokomlės gimnazija";Nykštukai;1272758839;Taip;3;3;2;8
21168;"Vilniaus Vladislavo Sirokomlės gimnazija";Nykštukai;1512245903;Ne;3;2;2;7
21169;"Vilniaus Vladislavo Sirokomlės gimnazija";Smurfai;2262586409;Ne;0;32;0;32
21170;"Vilniaus Vladislavo Sirokomlės gimnazija";Smurfai;9457457032;Ne;0;3;0;3
21171;"Vilniaus Vladislavo Sirokomlės gimnazija";Smurfai;5041189990;Ne;0;3;0;3
21172;"Vilniaus Vladislavo Sirokomlės gimnazija";Smurfai;7429739147;Ne;13;4;2;19
21173;"Vilniaus Vladislavo Sirokomlės gimnazija";Smurfai;6866592245;Ne;0;2;0;2
21174;"Vilniaus Vladislavo Sirokomlės gimnazija";Smurfai;9396676137;Ne;0;2;0;2
21175;"Vilniaus Vladislavo Sirokomlės gimnazija";Smurfai;9353066785;Ne;0;2;0;2
21176;"Vilniaus Vladislavo Sirokomlės gimnazija";Smurfai;4415030161;Ne;0;3;2;5
21177;"Vilniaus Vladislavo Sirokomlės gimnazija";Smurfai;1386916991;Ne;0;7;0;7
21178;"Vilniaus Vladislavo Sirokomlės gimnazija";Smurfai;2999425729;Ne;5;3;2;10
21179;"Vilniaus Vladislavo Sirokomlės gimnazija";Smurfai;7334310944;Ne;6;3;2;11
21180;"Vilniaus Vladislavo Sirokomlės gimnazija";Smurfai;6385918522;Ne;0;7;0;7
21181;"Vilniaus Vladislavo Sirokomlės gimnazija";Smurfai;1894717954;Ne;0;2;0;2
21182;"Vilniaus Vladislavo Sirokomlės gimnazija";Smurfai;3810261864;Ne;0;5;0;5
21183;"Vilniaus Vladislavo Sirokomlės gimnazija";Smurfai;4658530212;Ne;0;9;0;9
21184;"Vilniaus Vladislavo Sirokomlės gimnazija";Smurfai;4191386053;Ne;0;4;0;4
21185;"Vilniaus Vladislavo Sirokomlės gimnazija";Smurfai;4760204642;Ne;0;2;0;2
21186;"Vilniaus Vladislavo Sirokomlės gimnazija";Smurfai;3316897176;Ne;3;3;2;8
21187;"Vilniaus „Pelėdos” pradinė mokykla";BITUTĖS;1540892686;Ne;1;2;2;5
21188;"Vilniaus „Pelėdos” pradinė mokykla";BITUTĖS;1775717256;Ne;3;2;2;7
21189;"Vilniaus „Pelėdos” pradinė mokykla";BITUTĖS;7587887488;Ne;3;2;2;7
21190;"Vilniaus „Pelėdos” pradinė mokykla";BITUTĖS;6886461269;Ne;0;2;4;6
21191;"Vilniaus „Pelėdos” pradinė mokykla";BITUTĖS;8466974910;Ne;0;4;2;6
21192;"Vilniaus „Pelėdos” pradinė mokykla";BITUTĖS;8874979704;Ne;0;2;0;2
21193;"Vilniaus „Pelėdos” pradinė mokykla";BITUTĖS;4315677064;Ne;4;2;2;8
21194;"Vilniaus „Pelėdos” pradinė mokykla";BITUTĖS;3247532201;Ne;7;2;5;14
21195;"Vilniaus „Pelėdos” pradinė mokykla";BITUTĖS;5490544278;Ne;3;0;2;5
21196;"Vilniaus „Pelėdos” pradinė mokykla";BITUTĖS;2737277656;Ne;0;2;2;4
21197;"Vilniaus „Pelėdos” pradinė mokykla";BITUTĖS;6505671642;Ne;1;0;3;4
21198;"Vilniaus „Pelėdos” pradinė mokykla";BITUTĖS;6191899254;Ne;0;2;2;4
21199;"Vilniaus „Pelėdos” pradinė mokykla";BITUTĖS;8016820352;Ne;0;1;0;1
21200;"Vilniaus „Pelėdos” pradinė mokykla";BITUTĖS;6191427974;Ne;0;2;1;3
21201;"Vilniaus „Pelėdos” pradinė mokykla";BITUTĖS;8650379074;Ne;8;2;3;13
21202;"Vilniaus „Pelėdos” pradinė mokykla";BITUTĖS;8874149122;Ne;0;2;0;2
21203;"Vilniaus „Pelėdos” pradinė mokykla";BITUTĖS;3318222372;Ne;0;2;0;2
21204;"Vilniaus „Pelėdos” pradinė mokykla";BITUTĖS;5061655822;Ne;8;2;7;17
21205;"Vilniaus „Pelėdos” pradinė mokykla";BITUTĖS;7960825423;Ne;4;4;4;12
21206;"Vilniaus „Pelėdos” pradinė mokykla";BITUTĖS;4324931449;Ne;2;2;2;6
21207;"Vilniaus „Pelėdos” pradinė mokykla";BITUTĖS;5924332293;Ne;1;2;6;9
21208;"Vilniaus Joachimo Lelevelio inžinerijos gimnazija";0A;7508357392;Ne;0;2;0;2
21209;"Vilniaus Joachimo Lelevelio inžinerijos gimnazija";0A;9106152447;Ne;0;2;0;2
21210;"Vilniaus Joachimo Lelevelio inžinerijos gimnazija";0A;4033866425;Ne;0;5;0;5
21211;"Vilniaus Joachimo Lelevelio inžinerijos gimnazija";0A;8086994543;Ne;0;2;0;2
21212;"Vilniaus Joachimo Lelevelio inžinerijos gimnazija";0A;2701042709;Ne;0;2;0;2
21213;"Vilniaus Joachimo Lelevelio inžinerijos gimnazija";0A;3649329598;Ne;0;5;0;5
21214;"Vilniaus Joachimo Lelevelio inžinerijos gimnazija";0A;2225787182;Ne;0;2;0;2
21215;"Vilniaus Joachimo Lelevelio inžinerijos gimnazija";0A;7307307882;Ne;0;9;0;9
21216;"Vilniaus Joachimo Lelevelio inžinerijos gimnazija";0A;6316768460;Ne;4;2;0;6
21217;"Vilniaus Joachimo Lelevelio inžinerijos gimnazija";0A;9798993200;Ne;2;2;0;4
21218;"Vilniaus Joachimo Lelevelio inžinerijos gimnazija";0A;6417545510;Ne;4;2;0;6
21219;"Vilniaus Joachimo Lelevelio inžinerijos gimnazija";0B;9965517774;Ne;0;6;0;6
21220;"Vilniaus Joachimo Lelevelio inžinerijos gimnazija";0B;7138581709;Ne;0;6;0;6
21221;"Vilniaus Joachimo Lelevelio inžinerijos gimnazija";0B;7911007041;Ne;0;6;0;6
21222;"Vilniaus Joachimo Lelevelio inžinerijos gimnazija";0B;2125410714;Ne;1;4;0;5
21223;"Vilniaus Joachimo Lelevelio inžinerijos gimnazija";0B;7956422880;Ne;7;2;0;9
21224;"Vilniaus Joachimo Lelevelio inžinerijos gimnazija";0B;8446233414;Ne;4;5;0;9
21225;"Vilniaus Joachimo Lelevelio inžinerijos gimnazija";0B;5689369492;Ne;4;4;0;8
21226;"Vilniaus Joachimo Lelevelio inžinerijos gimnazija";0B;8797584508;Ne;5;2;0;7
21227;"Vilniaus Joachimo Lelevelio inžinerijos gimnazija";0B;7553024183;Ne;12;2;0;14
21228;"Vilniaus Joachimo Lelevelio inžinerijos gimnazija";0B;6861062723;Ne;4;4;0;8
21229;"Vilniaus Joachimo Lelevelio inžinerijos gimnazija";0B;8703116268;Ne;0;10;0;10
21230;"Vilniaus Joachimo Lelevelio inžinerijos gimnazija";0B;4312062240;Ne;15;2;0;17
21231;"Vilniaus Juzefo Ignacijaus Kraševskio gimnazija";DRUGĖLIAI;5157814568;Ne;11;2;3;16
21232;"Vilniaus Juzefo Ignacijaus Kraševskio gimnazija";DRUGĖLIAI;8747343811;Ne;0;2;4;6
21233;"Vilniaus Juzefo Ignacijaus Kraševskio gimnazija";DRUGĖLIAI;7502911642;Ne;0;2;4;6
21234;"Vilniaus Juzefo Ignacijaus Kraševskio gimnazija";DRUGĖLIAI;6028582927;Ne;0;2;1;3
21235;"Vilniaus Juzefo Ignacijaus Kraševskio gimnazija";DRUGĖLIAI;6403149921;Ne;0;2;6;8
21236;"Vilniaus Juzefo Ignacijaus Kraševskio gimnazija";DRUGĖLIAI;5328263421;Ne;3;2;5;10
21237;"Vilniaus Juzefo Ignacijaus Kraševskio gimnazija";DRUGĖLIAI;4022408510;Ne;0;2;0;2
21238;"Vilniaus Juzefo Ignacijaus Kraševskio gimnazija";DRUGĖLIAI;4257115650;Ne;0;2;2;4
21239;"Vilniaus Juzefo Ignacijaus Kraševskio gimnazija";DRUGĖLIAI;8521846076;Ne;0;9;0;9
21240;"Vilniaus Juzefo Ignacijaus Kraševskio gimnazija";DRUGĖLIAI;6427289718;Ne;5;2;5;12
21241;"Vilniaus Juzefo Ignacijaus Kraševskio gimnazija";DRUGĖLIAI;8214699601;Ne;0;9;0;9
21242;"Vilniaus Juzefo Ignacijaus Kraševskio gimnazija";DRUGĖLIAI;7685428258;Ne;8;2;2;12
21243;"Vilniaus Juzefo Ignacijaus Kraševskio gimnazija";DRUGĖLIAI;6781303455;Ne;0;5;0;5
21244;"Vilniaus Juzefo Ignacijaus Kraševskio gimnazija";DRUGĖLIAI;7841179083;Ne;0;2;2;4
21245;"Vilniaus Juzefo Ignacijaus Kraševskio gimnazija";DRUGĖLIAI;4845049639;Ne;0;2;1;3
21246;"Vilniaus Juzefo Ignacijaus Kraševskio gimnazija";DRUGĖLIAI;3522200752;Ne;0;7;0;7
21247;"Vilniaus Juzefo Ignacijaus Kraševskio gimnazija";DRUGĖLIAI;8808382134;Ne;9;2;6;17
21248;"Vilniaus Juzefo Ignacijaus Kraševskio gimnazija";DRUGĖLIAI;9333766622;Ne;7;8;2;17
21249;"Vilniaus Juzefo Ignacijaus Kraševskio gimnazija";DRUGĖLIAI;3698808100;Ne;0;7;0;7
21250;"Vilniaus Jono Pauliaus II progimnazija";Nykštukai;2493612905;Ne;0;2;0;2
21251;"Vilniaus Jono Pauliaus II progimnazija";Nykštukai;6742119549;Ne;0;8;0;8
21252;"Vilniaus Jono Pauliaus II progimnazija";Nykštukai;8047799576;Ne;0;3;0;3
21253;"Vilniaus Jono Pauliaus II progimnazija";Nykštukai;1381191703;Ne;0;22;0;22
21254;"Vilniaus Jono Pauliaus II progimnazija";Nykštukai;9042329808;Ne;0;3;2;5
21255;"Vilniaus Jono Pauliaus II progimnazija";Nykštukai;5909697341;Ne;0;3;0;3
21256;"Vilniaus Jono Pauliaus II progimnazija";Nykštukai;6525761466;Ne;3;2;0;5
21257;"Vilniaus Jono Pauliaus II progimnazija";Nykštukai;1254369602;Ne;0;7;1;8
21258;"Vilniaus Jono Pauliaus II progimnazija";Nykštukai;3346154143;Ne;4;2;2;8
21259;"Vilniaus Jono Pauliaus II progimnazija";Nykštukai;5734602455;Ne;1;2;2;5
21260;"Vilniaus Jono Pauliaus II progimnazija";Nykštukai;8054114720;Ne;0;3;0;3
21261;"Vilniaus Jono Pauliaus II progimnazija";Nykštukai;2190583964;Ne;3;3;2;8
21262;"Vilniaus Jono Pauliaus II progimnazija";Nykštukai;3920229653;Ne;3;2;2;7
21263;"Vilniaus Jono Pauliaus II progimnazija";Nykštukai;8092890260;Ne;0;10;0;10
21264;"Vilniaus Jono Pauliaus II progimnazija";Nykštukai;3998988004;Ne;5;2;2;9
21265;"Vilniaus Jono Pauliaus II progimnazija";Nykštukai;6756184787;Ne;0;3;1;4
21266;"Vilniaus Jono Pauliaus II progimnazija";Nykštukai;5768470608;Ne;0;2;1;3
21267;"Vilniaus Jono Pauliaus II progimnazija";Nykštukai;3584347608;Ne;0;2;0;2
21268;"Vilniaus Jono Pauliaus II progimnazija";Nykštukai;2948716989;Ne;0;3;0;3
21269;"Vilniaus Jono Pauliaus II progimnazija";Žiniukai;3687735991;Ne;14;3;2;19
21270;"Vilniaus Jono Pauliaus II progimnazija";Žiniukai;8678437720;Ne;0;3;0;3
21271;"Vilniaus Jono Pauliaus II progimnazija";Žiniukai;4543822765;Ne;0;2;0;2
21272;"Vilniaus Jono Pauliaus II progimnazija";Žiniukai;7459673719;Ne;3;2;2;7
21273;"Vilniaus Jono Pauliaus II progimnazija";Žiniukai;4566817285;Ne;0;4;0;4
21274;"Vilniaus Jono Pauliaus II progimnazija";Žiniukai;3332865242;Ne;0;2;3;5
21275;"Vilniaus Jono Pauliaus II progimnazija";Žiniukai;5978993456;Ne;0;2;0;2
21276;"Vilniaus Jono Pauliaus II progimnazija";Žiniukai;4288487063;Ne;0;2;0;2
21277;"Vilniaus Jono Pauliaus II progimnazija";Žiniukai;9522524163;Ne;0;4;4;8
21278;"Vilniaus Jono Pauliaus II progimnazija";Žiniukai;6712878938;Ne;0;2;0;2
21279;"Vilniaus Jono Pauliaus II progimnazija";Žiniukai;9414051187;Ne;0;2;1;3
21280;"Vilniaus Jono Pauliaus II progimnazija";Žiniukai;8812316692;Ne;0;2;0;2
21281;"Vilniaus Jono Pauliaus II progimnazija";Žiniukai;9357757604;Ne;4;5;2;11
21282;"Vilniaus Jono Pauliaus II progimnazija";Žiniukai;4291690659;Ne;0;2;0;2
21283;"Vilniaus Jono Pauliaus II progimnazija";Žiniukai;3489127587;Ne;8;3;2;13
21284;"Vilniaus Jono Pauliaus II progimnazija";Žiniukai;3772830210;Ne;3;2;3;8
21285;"Vilniaus Jono Pauliaus II progimnazija";Žiniukai;5043122065;Ne;0;7;0;7
21286;"Vilniaus Jono Pauliaus II progimnazija";Žiniukai;3349199472;Ne;3;4;2;9
21287;"Vilniaus Jono Pauliaus II progimnazija";Žiniukai;2654794460;Ne;3;2;2;7
21288;"Vilniaus Jono Pauliaus II progimnazija";Žiniukai;6478873536;Ne;4;2;0;6
21289;"Vilniaus Jono Pauliaus II progimnazija";Spindulėlis;5492437864;Ne;0;2;0;2
21290;"Vilniaus Jono Pauliaus II progimnazija";Spindulėlis;3269357241;Ne;2;4;2;8
21291;"Vilniaus Jono Pauliaus II progimnazija";Spindulėlis;2840112908;Ne;3;3;3;9
21292;"Vilniaus Jono Pauliaus II progimnazija";Spindulėlis;4433799070;Ne;3;2;2;7
21293;"Vilniaus Jono Pauliaus II progimnazija";Spindulėlis;5440679175;Ne;3;4;0;7
21294;"Vilniaus Jono Pauliaus II progimnazija";Spindulėlis;7178844364;Ne;0;4;0;4
21295;"Vilniaus Jono Pauliaus II progimnazija";Spindulėlis;4426643908;Ne;0;3;0;3
21296;"Vilniaus Jono Pauliaus II progimnazija";Spindulėlis;6281687751;Ne;0;2;0;2
21297;"Vilniaus Jono Pauliaus II progimnazija";Spindulėlis;6996900411;Ne;7;2;2;11
21298;"Vilniaus Jono Pauliaus II progimnazija";Spindulėlis;2090334618;Ne;0;2;3;5
21299;"Vilniaus Jono Pauliaus II progimnazija";Spindulėlis;8753972322;Ne;0;2;0;2
21300;"Vilniaus Jono Pauliaus II progimnazija";Spindulėlis;6435612222;Ne;0;3;1;4
21301;"Vilniaus Jono Pauliaus II progimnazija";Spindulėlis;1583038469;Ne;8;2;4;14
21302;"Vilniaus Jono Pauliaus II progimnazija";Spindulėlis;9226214856;Ne;0;2;0;2
21303;"Vilniaus Jono Pauliaus II progimnazija";Spindulėlis;3121251271;Ne;0;3;0;3
21304;"Vilniaus Jono Pauliaus II progimnazija";Spindulėlis;4189943614;Ne;0;3;0;3
21305;"Vilniaus Jono Pauliaus II progimnazija";Spindulėlis;2515028280;Ne;2;5;2;9
21306;"Vilniaus Jono Pauliaus II progimnazija";Spindulėlis;5987294293;Ne;0;13;3;16
21307;"Vilniaus Jono Pauliaus II progimnazija";Spindulėlis;9531574134;Ne;1;3;2;6
21308;"Vilniaus Jono Pauliaus II progimnazija";Spindulėlis;8043493934;Ne;0;2;0;2
21309;"Vilniaus Jono Pauliaus II progimnazija";Uogytės;3502278745;Ne;0;2;0;2
21310;"Vilniaus Jono Pauliaus II progimnazija";Uogytės;3445649442;Ne;2;2;2;6
21311;"Vilniaus Jono Pauliaus II progimnazija";Uogytės;3900091129;Ne;5;2;4;11
21312;"Vilniaus Jono Pauliaus II progimnazija";Uogytės;6367875352;Ne;0;3;5;8
21313;"Vilniaus Jono Pauliaus II progimnazija";Uogytės;2843328732;Ne;0;2;3;5
21314;"Vilniaus Jono Pauliaus II progimnazija";Uogytės;1440531672;Ne;0;2;0;2
21315;"Vilniaus Jono Pauliaus II progimnazija";Uogytės;1502013942;Ne;8;2;2;12
21316;"Vilniaus Jono Pauliaus II progimnazija";Uogytės;2205400512;Ne;0;2;0;2
21317;"Vilniaus Jono Pauliaus II progimnazija";Uogytės;4969561425;Ne;1;2;2;5
21318;"Vilniaus Jono Pauliaus II progimnazija";Uogytės;4726351175;Ne;0;2;0;2
21319;"Vilniaus Jono Pauliaus II progimnazija";Uogytės;5028510873;Ne;12;2;2;16
21320;"Vilniaus Jono Pauliaus II progimnazija";Uogytės;4335378625;Ne;0;2;1;3
21321;"Vilniaus Jono Pauliaus II progimnazija";Uogytės;5600979545;Ne;0;2;5;7
21322;"Vilniaus Jono Pauliaus II progimnazija";Uogytės;8459980712;Ne;21;2;4;27
21323;"Vilniaus Jono Pauliaus II progimnazija";Uogytės;7089883250;Ne;0;2;0;2
21324;"Vilniaus Jono Pauliaus II progimnazija";Uogytės;4733227215;Ne;7;2;3;12
21325;"Vilniaus Jono Pauliaus II progimnazija";Uogytės;1290248125;Ne;4;2;6;12
21326;"Vilniaus Jono Pauliaus II progimnazija";Uogytės;9037835899;Ne;14;2;5;21
21327;"Vilniaus Jono Pauliaus II progimnazija";Uogytės;9235884407;Ne;0;31;0;31
21328;"Vilniaus Jono Pauliaus II progimnazija";Uogytės;8949018147;Ne;3;2;2;7
21329;"Vilniaus Verkių mokykla-daugiafunkcis centras";"SĮUP I m.m., SĮUP II m.m. klasė";1853931111;Ne;0;12;0;12
21330;"Vilniaus Verkių mokykla-daugiafunkcis centras";"SĮUP I m.m., SĮUP II m.m. klasė";2457359072;Ne;0;2;0;2
21331;"Vilniaus Verkių mokykla-daugiafunkcis centras";"SĮUP I m.m., SĮUP II m.m. klasė";6808441017;Ne;0;2;0;2
21332;"Vilniaus Verkių mokykla-daugiafunkcis centras";"SĮUP I m.m., SĮUP II m.m. klasė";7886245604;Ne;0;7;0;7
21333;"Vilniaus Verkių mokykla-daugiafunkcis centras";"SĮUP I m.m., SĮUP II m.m. klasė";5256639859;Ne;0;2;0;2
21334;"Vilniaus Verkių mokykla-daugiafunkcis centras";"SĮUP I m.m., SĮUP II m.m. klasė";6213577188;Ne;0;18;0;18
21335;"Vilniaus Verkių mokykla-daugiafunkcis centras";"SĮUP I m.m., SĮUP II m.m. klasė";8732243137;Ne;0;3;0;3
21336;"Vilniaus Verkių mokykla-daugiafunkcis centras";"SĮUP I m.m., SĮUP II m.m. klasė";6301505187;Ne;0;3;0;3
21337;"Vilniaus Verkių mokykla-daugiafunkcis centras";"SĮUP I m.m., SĮUP II m.m. klasė";9975744237;Ne;0;9;0;9
21338;"Vilniaus Verkių mokykla-daugiafunkcis centras";"SĮUP I m.m., SĮUP II m.m. klasė";5476038315;Ne;0;3;0;3
21339;"Vilniaus Verkių mokykla-daugiafunkcis centras";"SĮUP I m.m., SĮUP II m.m., SĮUP III m.m. klasė ";4518835802;Ne;0;13;0;13
21340;"Vilniaus Verkių mokykla-daugiafunkcis centras";"SĮUP I m.m., SĮUP II m.m., SĮUP III m.m. klasė ";9666721487;Ne;0;12;0;12
21341;"Vilniaus Verkių mokykla-daugiafunkcis centras";"SĮUP I m.m., SĮUP II m.m., SĮUP III m.m. klasė ";2714397701;Ne;0;2;0;2
21342;"Vilniaus Verkių mokykla-daugiafunkcis centras";"SĮUP I m.m., SĮUP II m.m., SĮUP III m.m. klasė ";4054448861;Ne;0;4;0;4
21343;"Vilniaus Verkių mokykla-daugiafunkcis centras";"SĮUP I m.m., SĮUP II m.m., SĮUP III m.m. klasė ";4857786109;Ne;0;4;0;4
21344;"Vilniaus Verkių mokykla-daugiafunkcis centras";"SĮUP I m.m., SĮUP II m.m., SĮUP III m.m. klasė ";9330275690;Ne;0;2;0;2
21345;"Vilniaus Verkių mokykla-daugiafunkcis centras";"SĮUP I m.m., SĮUP II m.m., SĮUP III m.m. klasė ";6901885288;Ne;0;2;0;2
21346;"Vilniaus Verkių mokykla-daugiafunkcis centras";"SĮUP I m.m., SĮUP II m.m., SĮUP III m.m. klasė ";7381890668;Ne;0;3;0;3
21347;"Vilniaus Verkių mokykla-daugiafunkcis centras";"SĮUP I m.m., SĮUP II m.m., SĮUP III m.m. klasė ";2708620759;Ne;0;8;0;8
21348;"Vilniaus Verkių mokykla-daugiafunkcis centras";"SĮUP I m.m., SĮUP II m.m., SĮUP III m.m. klasė ";7323583579;Ne;0;6;0;6
21349;"Vilniaus Verkių mokykla-daugiafunkcis centras";"9, 10 L klasė";2810286239;Ne;0;22;0;22
21350;"Vilniaus Verkių mokykla-daugiafunkcis centras";"9, 10 L klasė";2054806833;Ne;0;5;0;5
21351;"Vilniaus Verkių mokykla-daugiafunkcis centras";"9, 10 L klasė";9613466086;Ne;0;14;0;14
21352;"Vilniaus Verkių mokykla-daugiafunkcis centras";"9, 10 L klasė";9613466086;Ne;0;14;0;14
21353;"Vilniaus Verkių mokykla-daugiafunkcis centras";"9, 10 L klasė";7616694308;Ne;0;15;0;15
21354;"Vilniaus Verkių mokykla-daugiafunkcis centras";"9, 10 L klasė";1480378589;Ne;0;22;0;22
21355;"Vilniaus Verkių mokykla-daugiafunkcis centras";"9, 10 L klasė";3519068093;Ne;0;3;0;3
21356;"Vilniaus Verkių mokykla-daugiafunkcis centras";"9, 10 L klasė";1990482351;Ne;0;6;0;6
21357;"Vilniaus Verkių mokykla-daugiafunkcis centras";"9, 10 S klasė";8199430682;Ne;0;3;0;3
21358;"Vilniaus Verkių mokykla-daugiafunkcis centras";"9, 10 S klasė";1368271218;Ne;0;2;0;2
21359;"Vilniaus Verkių mokykla-daugiafunkcis centras";"9, 10 S klasė";7689301739;Ne;0;12;0;12
21360;"Vilniaus Verkių mokykla-daugiafunkcis centras";"9, 10 S klasė";6396691531;Ne;0;22;0;22
21361;"Vilniaus Verkių mokykla-daugiafunkcis centras";"9, 10 S klasė";1937996951;Ne;0;2;0;2
21362;"Vilniaus Verkių mokykla-daugiafunkcis centras";"9, 10 S klasė";7819002176;Ne;0;5;0;5
21363;"Vilniaus Verkių mokykla-daugiafunkcis centras";"9, 10 S klasė";9420292538;Ne;0;2;0;2
21364;"Vilniaus Verkių mokykla-daugiafunkcis centras";"9, 10 S klasė";5030855634;Ne;0;22;0;22
21365;"Vilniaus Verkių mokykla-daugiafunkcis centras";"9, 10 S klasė";1259538808;Ne;0;22;0;22
21366;"Vilniaus Verkių mokykla-daugiafunkcis centras";"9, 10 S klasė";5835522029;Ne;0;2;0;2
21367;"Vilniaus Verkių mokykla-daugiafunkcis centras";"8, 9 S klasė";2360897023;Ne;0;2;0;2
21368;"Vilniaus Verkių mokykla-daugiafunkcis centras";"8, 9 S klasė";2415067230;Ne;0;7;0;7
21369;"Vilniaus Verkių mokykla-daugiafunkcis centras";"8, 9 S klasė";1514869108;Ne;0;4;0;4
21370;"Vilniaus Verkių mokykla-daugiafunkcis centras";"8, 9 S klasė";3145397791;Ne;0;7;0;7
21371;"Vilniaus Verkių mokykla-daugiafunkcis centras";"8, 9 S klasė";8779088808;Ne;0;13;0;13
21372;"Vilniaus Verkių mokykla-daugiafunkcis centras";"8, 9 S klasė";3870610295;Ne;0;4;0;4
21373;"Vilniaus Verkių mokykla-daugiafunkcis centras";"8, 9 S klasė";3444507772;Ne;0;2;0;2
21374;"Vilniaus Verkių mokykla-daugiafunkcis centras";"8, 9 S klasė";3215674630;Ne;0;4;0;4
21375;"Vilniaus Verkių mokykla-daugiafunkcis centras";"7 S klasė";3631392717;Ne;0;4;0;4
21376;"Vilniaus Verkių mokykla-daugiafunkcis centras";"7 S klasė";11657021053;Ne;0;2;0;2
21377;"Vilniaus Verkių mokykla-daugiafunkcis centras";"7 S klasė";13432910676;Ne;0;17;0;17
21378;"Vilniaus Verkių mokykla-daugiafunkcis centras";"7 S klasė";8272359516;Ne;0;8;0;8
21379;"Vilniaus Verkių mokykla-daugiafunkcis centras";"7 S klasė";9598385220;Ne;0;14;0;14
21380;"Vilniaus Verkių mokykla-daugiafunkcis centras";"7 S klasė";4914336091;Ne;0;2;0;2
21381;"Vilniaus Verkių mokykla-daugiafunkcis centras";"7 S klasė";4914336091;Ne;0;2;0;2
21382;"Vilniaus Verkių mokykla-daugiafunkcis centras";"7 S klasė";2254324740;Ne;0;7;0;7
21383;"Vilniaus Verkių mokykla-daugiafunkcis centras";"5, 6, 7, 8 L klasė";37572425955;Ne;0;3;0;3
21384;"Vilniaus Verkių mokykla-daugiafunkcis centras";"5, 6, 7, 8 L klasė";44425437058;Ne;0;7;0;7
21385;"Vilniaus Verkių mokykla-daugiafunkcis centras";"5, 6, 7, 8 L klasė";2261393560;Ne;0;17;0;17
21386;"Vilniaus Verkių mokykla-daugiafunkcis centras";"5, 6, 7, 8 L klasė";7438765543;Ne;0;13;0;13
21387;"Vilniaus Verkių mokykla-daugiafunkcis centras";"5, 6, 7, 8 L klasė";37848550744;Ne;0;22;0;22
21388;"Vilniaus Verkių mokykla-daugiafunkcis centras";"5, 6, 7, 8 L klasė";9362938835;Ne;0;4;0;4
21389;"Vilniaus Verkių mokykla-daugiafunkcis centras";"5, 6, 7, 8 L klasė";5937487837;Ne;0;2;0;2
21390;"Vilniaus Verkių mokykla-daugiafunkcis centras";"5, 6, 7, 8 L klasė";1350580842;Ne;0;4;0;4
21391;"Vilniaus Verkių mokykla-daugiafunkcis centras";"5, 6, 7, 8 L klasė";5865808613;Ne;0;2;0;2
21392;"Vilniaus Verkių mokykla-daugiafunkcis centras";"5, 6, 7, 8 L klasė";1891856371;Ne;0;2;0;2
21393;"Vilniaus Verkių mokykla-daugiafunkcis centras";"5, 6 S klasė";2396841187;Ne;0;7;0;7
21394;"Vilniaus Verkių mokykla-daugiafunkcis centras";"5, 6 S klasė";8342540661;Ne;0;6;0;6
21395;"Vilniaus Verkių mokykla-daugiafunkcis centras";"5, 6 S klasė";9634174513;Ne;0;4;0;4
21396;"Vilniaus Verkių mokykla-daugiafunkcis centras";"5, 6 S klasė";62513475987;Ne;0;2;0;2
21397;"Vilniaus Verkių mokykla-daugiafunkcis centras";"5, 6 S klasė";2728524848;Ne;0;3;0;3
21398;"Vilniaus Verkių mokykla-daugiafunkcis centras";"5, 6 S klasė";9816043688;Ne;0;8;0;8
21399;"Vilniaus Verkių mokykla-daugiafunkcis centras";"5, 6 S klasė";5899020119;Ne;0;2;0;2
21400;"Vilniaus Verkių mokykla-daugiafunkcis centras";"5, 6 S klasė";93185505974;Ne;0;3;0;3
21401;"Vilniaus Verkių mokykla-daugiafunkcis centras";"5, 6 S klasė";24268622677;Ne;0;3;0;3
21402;"Vilniaus Verkių mokykla-daugiafunkcis centras";"5, 6 S klasė";24268622677;Ne;0;3;0;3
21403;"Vilniaus Verkių mokykla-daugiafunkcis centras";"5, 6 S klasė";24268622677;Ne;0;3;0;3
21404;"Vilniaus Verkių mokykla-daugiafunkcis centras";"5, 6 S klasė";24268622677;Ne;0;3;0;3
21405;"Vilniaus Verkių mokykla-daugiafunkcis centras";"5, 6 S klasė";67335258608;Ne;0;22;0;22
21406;"Vilniaus Verkių mokykla-daugiafunkcis centras";"5, 6 S klasė";5754278814;Ne;0;22;0;22
21407;"Vilniaus Verkių mokykla-daugiafunkcis centras";"3, 4 S klasė";3669076308;Ne;0;3;0;3
21408;"Vilniaus Verkių mokykla-daugiafunkcis centras";"3, 4 S klasė";4436123342;Ne;0;2;0;2
21409;"Vilniaus Verkių mokykla-daugiafunkcis centras";"3, 4 S klasė";6417342868;Ne;0;8;0;8
21410;"Vilniaus Verkių mokykla-daugiafunkcis centras";"3, 4 S klasė";2428312586;Ne;0;3;0;3
21411;"Vilniaus Verkių mokykla-daugiafunkcis centras";"3, 4 S klasė";2160146000;Ne;0;3;0;3
21412;"Vilniaus Verkių mokykla-daugiafunkcis centras";"3, 4 S klasė";4675792296;Ne;0;22;0;22
21413;"Vilniaus Verkių mokykla-daugiafunkcis centras";"3, 4 S klasė";4675792296;Ne;0;22;0;22
21414;"Vilniaus Verkių mokykla-daugiafunkcis centras";"Priešmokyklinio, 1, 2 S klasė";7942036741;Ne;0;2;0;2
21415;"Vilniaus Verkių mokykla-daugiafunkcis centras";"Priešmokyklinio, 1, 2 S klasė";5586925136;Ne;0;3;0;3
21416;"Vilniaus Verkių mokykla-daugiafunkcis centras";"Priešmokyklinio, 1, 2 S klasė";1809511815;Ne;0;6;0;6
21417;"Vilniaus Verkių mokykla-daugiafunkcis centras";"Priešmokyklinio, 1, 2 S klasė";8844612659;Ne;0;5;0;5
21418;"Vilniaus Verkių mokykla-daugiafunkcis centras";"Priešmokyklinio, 1, 2 S klasė";42873989145;Ne;0;2;0;2
21419;"Vilniaus Verkių mokykla-daugiafunkcis centras";"Priešmokyklinio, 1, 2 S klasė";1732370199;Ne;0;3;0;3
21420;"Vilniaus Verkių mokykla-daugiafunkcis centras";"1, 2, 3, 4 S, L klasė rusų";9256422807;Ne;0;2;0;2
21421;"Vilniaus Verkių mokykla-daugiafunkcis centras";"1, 2, 3, 4 S, L klasė rusų";3504918499;Ne;0;2;0;2
21422;"Vilniaus Verkių mokykla-daugiafunkcis centras";"1, 2, 3, 4 S, L klasė rusų";3504918499;Ne;0;2;0;2
21423;"Vilniaus Verkių mokykla-daugiafunkcis centras";"1, 2, 3, 4 S, L klasė rusų";1515290326;Ne;0;2;0;2
21424;"Vilniaus Verkių mokykla-daugiafunkcis centras";"1, 2, 3, 4 S, L klasė rusų";7977250483;Ne;0;10;0;10
21425;"Vilniaus Verkių mokykla-daugiafunkcis centras";"1, 2, 3, 4 S, L klasė rusų";6951842417;Ne;0;2;0;2
21426;"Vilniaus Verkių mokykla-daugiafunkcis centras";"1, 2, 3, 4 S, L klasė rusų";4011623622;Ne;0;22;0;22
21427;"Vilniaus Verkių mokykla-daugiafunkcis centras";"1, 2, 3, 4 S, L klasė rusų";2064565430;Ne;0;2;0;2
21428;"Vilniaus Verkių mokykla-daugiafunkcis centras";"1, 2, 3, 5, 7 S, L klasė lenkų";6215345468;Ne;0;22;0;22
21429;"Vilniaus Verkių mokykla-daugiafunkcis centras";"1, 2, 3, 5, 7 S, L klasė lenkų";5802046806;Ne;0;7;0;7
21430;"Vilniaus Verkių mokykla-daugiafunkcis centras";"1, 2, 3, 5, 7 S, L klasė lenkų";7591511377;Ne;0;13;0;13
21431;"Vilniaus Verkių mokykla-daugiafunkcis centras";"1, 2, 3, 5, 7 S, L klasė lenkų";6868531249;Ne;0;13;0;13
21432;"Vilniaus Verkių mokykla-daugiafunkcis centras";"1, 2, 3, 5, 7 S, L klasė lenkų";6868531249;Ne;0;13;0;13
21433;"Vilniaus Verkių mokykla-daugiafunkcis centras";"1, 2, 3, 5, 7 S, L klasė lenkų";6868531249;Ne;0;13;0;13
21434;"Vilniaus Verkių mokykla-daugiafunkcis centras";"1, 2, 3, 5, 7 S, L klasė lenkų";6868531249;Ne;0;13;0;13
21435;"Vilniaus Verkių mokykla-daugiafunkcis centras";"1, 2, 3, 5, 7 S, L klasė lenkų";6868531249;Ne;0;13;0;13
21436;"Vilniaus Verkių mokykla-daugiafunkcis centras";"1, 2, 3, 5, 7 S, L klasė lenkų";6868531249;Ne;0;13;0;13
21437;"Vilniaus Verkių mokykla-daugiafunkcis centras";"1, 2, 3, 5, 7 S, L klasė lenkų";5603432321;Ne;0;2;0;2
21438;"Vilniaus Verkių mokykla-daugiafunkcis centras";"1, 2, 3, 5, 7 S, L klasė lenkų";9355917461;Ne;0;3;0;3
21439;"Vilniaus Verkių mokykla-daugiafunkcis centras";"1, 2, 3, 5, 7 S, L klasė lenkų";4187084284;Ne;0;7;0;7
21440;"Vilniaus Verkių mokykla-daugiafunkcis centras";"5, 6, 7, 8 L klasė RU";64637387481;Ne;0;4;0;4
21441;"Vilniaus Verkių mokykla-daugiafunkcis centras";"5, 6, 7, 8 L klasė RU";64637387481;Ne;0;4;0;4
21442;"Vilniaus Verkių mokykla-daugiafunkcis centras";"5, 6, 7, 8 L klasė RU";4066377955;Ne;0;18;0;18
21443;"Vilniaus Verkių mokykla-daugiafunkcis centras";"5, 6, 7, 8 L klasė RU";44372408680;Ne;0;2;0;2
21444;"Vilniaus Verkių mokykla-daugiafunkcis centras";"5, 6, 7, 8 L klasė RU";1503792026;Ne;0;9;0;9
21445;"Vilniaus Verkių mokykla-daugiafunkcis centras";"5, 6, 7, 8 L klasė RU";55421735777;Ne;0;4;0;4
21446;"Vilniaus Verkių mokykla-daugiafunkcis centras";"5, 6, 7, 8 L klasė RU";9259642351;Ne;0;22;0;22
21447;"Vilniaus Verkių mokykla-daugiafunkcis centras";" SĮUP I m.m., SĮUP II m.m. klasė RU";7000432264;Ne;0;22;0;22
21448;"Vilniaus Verkių mokykla-daugiafunkcis centras";" SĮUP I m.m., SĮUP II m.m. klasė RU";9098854782;Ne;0;8;0;8
21449;"Vilniaus Verkių mokykla-daugiafunkcis centras";" SĮUP I m.m., SĮUP II m.m. klasė RU";6937513931;Ne;0;22;0;22
21450;"Vilniaus Verkių mokykla-daugiafunkcis centras";" SĮUP I m.m., SĮUP II m.m. klasė RU";3155197214;Ne;0;22;0;22
21451;"Vilniaus Verkių mokykla-daugiafunkcis centras";" SĮUP I m.m., SĮUP II m.m. klasė RU";1454746961;Ne;0;3;0;3
21452;"Vilniaus Verkių mokykla-daugiafunkcis centras";" SĮUP I m.m., SĮUP II m.m. klasė RU";2076640938;Ne;0;6;0;6
21453;"Vilniaus Verkių mokykla-daugiafunkcis centras";" SĮUP I m.m., SĮUP II m.m. klasė RU";1062601239;Ne;0;4;0;4
21454;"Vilniaus Verkių mokykla-daugiafunkcis centras";" SĮUP I m.m., SĮUP II m.m. klasė RU";6958157444;Ne;0;6;0;6
21455;"Vilniaus Verkių mokykla-daugiafunkcis centras";" SĮUP I m.m., SĮUP II m.m. klasė RU";9430569608;Ne;0;22;0;22
21456;"Vilniaus Verkių mokykla-daugiafunkcis centras";" SĮUP I m.m., SĮUP II m.m. klasė RU";2305478898;Ne;0;8;0;8
21457;"Vilniaus Verkių mokykla-daugiafunkcis centras";" SĮUP I m.m., SĮUP II m.m. klasė RU";2518928115;Ne;0;3;0;3
21458;Gluosnis;KIŠKUČIAI;8689557248;Ne;0;2;0;2
21459;Gluosnis;KIŠKUČIAI;2984134115;Ne;8;0;6;14
21460;Gluosnis;KIŠKUČIAI;6955695422;Ne;0;0;3;3
21461;Gluosnis;KIŠKUČIAI;1305651237;Ne;2;0;3;5
21462;Gluosnis;KIŠKUČIAI;4285562600;Ne;2;3;2;7
21463;Gluosnis;KIŠKUČIAI;8009719622;Ne;0;2;0;2
21464;Gluosnis;KIŠKUČIAI;6883663577;Ne;17;0;0;17
21465;Gluosnis;KIŠKUČIAI;1512855055;Ne;2;0;1;3
21466;Gluosnis;KIŠKUČIAI;8337313448;Ne;0;0;1;1
21467;Gluosnis;KIŠKUČIAI;4632419177;Ne;2;0;3;5
21468;Gluosnis;KIŠKUČIAI;7769522093;Ne;18;2;2;22
21469;Gluosnis;KIŠKUČIAI;8928597187;Ne;0;5;3;8
21470;Gluosnis;KIŠKUČIAI;9993638596;Ne;2;0;4;6
21471;Gluosnis;KIŠKUČIAI;6994005000;Ne;0;1;0;1
21472;Gluosnis;KIŠKUČIAI;9221983318;Ne;2;0;5;7
21473;Gluosnis;KIŠKUČIAI;2187312618;Ne;3;2;2;7
21474;Gluosnis;KIŠKUČIAI;7073637619;Ne;1;0;5;6
21475;Gluosnis;KIŠKUČIAI;1391404073;Ne;4;0;2;6
21476;Gluosnis;KIŠKUČIAI;4591550636;Ne;4;8;2;14
21477;Gluosnis;KIŠKUČIAI;6212693015;Taip;7;6;3;16
21478;Gluosnis;KIŠKUČIAI;3673702157;Ne;1;0;0;1
21479;Gluosnis;EŽIUKAI;4153713911;Ne;0;1;0;1
21480;Gluosnis;EŽIUKAI;4493877427;Ne;1;0;4;5
21481;Gluosnis;EŽIUKAI;5350702449;Ne;0;6;0;6
21482;Gluosnis;EŽIUKAI;8577271806;Ne;0;2;2;4
21483;Gluosnis;EŽIUKAI;6622415563;Ne;0;1;0;1
21484;Gluosnis;EŽIUKAI;9788278155;Ne;0;2;2;4
21485;Gluosnis;EŽIUKAI;7974944779;Ne;0;3;0;3
21486;Gluosnis;EŽIUKAI;7526020668;Ne;0;1;0;1
21487;Gluosnis;EŽIUKAI;5522411084;Ne;0;2;1;3
21488;Gluosnis;EŽIUKAI;5392759654;Taip;6;0;4;10
21489;Gluosnis;EŽIUKAI;6681653921;Ne;0;7;0;7
21490;Gluosnis;EŽIUKAI;4902627153;Taip;3;2;8;13
21491;Gluosnis;EŽIUKAI;2525780494;Ne;6;5;2;13
21492;Gluosnis;EŽIUKAI;9389736360;Ne;5;2;2;9
21493;Gluosnis;EŽIUKAI;2707855273;Ne;0;6;0;6
21494;Gluosnis;EŽIUKAI;7523459118;Ne;8;0;5;13
21495;Gluosnis;EŽIUKAI;2794163383;Ne;2;0;2;4
21496;Gluosnis;EŽIUKAI;7264550578;Ne;0;2;1;3
21497;Gluosnis;EŽIUKAI;5368171142;Ne;3;6;2;11
21498;Gluosnis;EŽIUKAI;6754799196;Ne;1;0;4;5
21499;Gluosnis;EŽIUKAI;9888037899;Ne;6;0;8;14
21500;Gluosnis;MEŠKIUKAI;8981904827;Ne;0;0;2;2
21501;Gluosnis;MEŠKIUKAI;8998776286;Ne;0;2;0;2
21502;Gluosnis;MEŠKIUKAI;1846499141;Ne;20;0;2;22
21503;Gluosnis;MEŠKIUKAI;4905002832;Ne;0;4;0;4
21504;Gluosnis;MEŠKIUKAI;9102081648;Ne;0;0;1;1
21505;Gluosnis;MEŠKIUKAI;4498429439;Ne;0;0;2;2
21506;Gluosnis;MEŠKIUKAI;8259160584;Ne;0;3;2;5
21507;Gluosnis;MEŠKIUKAI;1235091885;Ne;0;7;0;7
21508;Gluosnis;MEŠKIUKAI;1165636758;Ne;0;2;4;6
21509;Gluosnis;MEŠKIUKAI;8499748544;Ne;0;1;0;1
21510;Gluosnis;MEŠKIUKAI;9699577397;Ne;0;0;6;6
21511;Gluosnis;MEŠKIUKAI;4107344313;Ne;5;0;3;8
21512;Gluosnis;MEŠKIUKAI;1101472999;Ne;0;3;0;3
21513;Gluosnis;MEŠKIUKAI;7995558671;Ne;4;2;2;8
21514;Gluosnis;MEŠKIUKAI;1602556462;Ne;14;0;0;14
21515;Gluosnis;MEŠKIUKAI;8842139496;Ne;0;0;3;3
21516;Gluosnis;MEŠKIUKAI;4060859156;Ne;3;0;2;5
21517;Gluosnis;MEŠKIUKAI;3323237449;Ne;0;9;0;9
21518;Gluosnis;MEŠKIUKAI;3038732180;Ne;10;3;3;16
21519;Gluosnis;MEŠKIUKAI;1712795835;Ne;0;3;0;3
21520;Gluosnis;BORUŽĖLĖS;8840658383;Ne;0;2;0;2
21521;Gluosnis;BORUŽĖLĖS;1102935178;Ne;0;2;3;5
21522;Gluosnis;BORUŽĖLĖS;2167312808;Ne;0;10;0;10
21523;Gluosnis;BORUŽĖLĖS;4204797742;Ne;0;11;0;11
21524;Gluosnis;BORUŽĖLĖS;6302765948;Ne;0;2;1;3
21525;Gluosnis;BORUŽĖLĖS;9938235476;Ne;0;7;0;7
21526;Gluosnis;BORUŽĖLĖS;2945796648;Ne;0;3;0;3
21527;Gluosnis;BORUŽĖLĖS;2173191971;Ne;0;5;3;8
21528;Gluosnis;BORUŽĖLĖS;4237053702;Ne;4;0;2;6
21529;Gluosnis;BORUŽĖLĖS;7731887361;Ne;4;0;2;6
21530;Gluosnis;BORUŽĖLĖS;8502947568;Ne;0;2;0;2
21531;Gluosnis;BORUŽĖLĖS;1335152703;Ne;3;2;2;7
21532;Gluosnis;BORUŽĖLĖS;1314992969;Ne;3;2;2;7
21533;Gluosnis;BORUŽĖLĖS;7833136455;Ne;3;0;2;5
21534;Gluosnis;BORUŽĖLĖS;2515646510;Ne;3;2;2;7
21535;Gluosnis;BORUŽĖLĖS;6086258054;Ne;0;0;2;2
21536;Gluosnis;BORUŽĖLĖS;1351519995;Ne;14;3;4;21
21537;Gluosnis;BORUŽĖLĖS;6960673767;Taip;0;3;0;3
21538;Gluosnis;LAPIUKAI;7025815772;Ne;0;2;0;2
21539;Gluosnis;LAPIUKAI;5266206726;Ne;3;0;3;6
21540;Gluosnis;LAPIUKAI;2968946946;Ne;0;0;1;1
21541;Gluosnis;LAPIUKAI;3190331209;Taip;6;1;2;9
21542;Gluosnis;LAPIUKAI;5376108804;Ne;0;0;3;3
21543;Gluosnis;LAPIUKAI;1664508998;Ne;2;2;3;7
21544;Gluosnis;LAPIUKAI;1296975213;Ne;2;0;2;4
21545;Gluosnis;LAPIUKAI;8227732558;Ne;0;1;0;1
21546;Gluosnis;LAPIUKAI;4146877525;Taip;0;10;1;11
21547;Gluosnis;LAPIUKAI;4616132460;Ne;0;2;0;2
21548;Gluosnis;LAPIUKAI;7090336454;Ne;3;3;2;8
21549;Gluosnis;LAPIUKAI;2889837198;Ne;1;0;8;9
21550;Gluosnis;PELĖDŽIUKAI;5633386146;Taip;9;0;5;14
21551;Gluosnis;PELĖDŽIUKAI;1144177849;Ne;0;2;2;4
21552;Gluosnis;PELĖDŽIUKAI;6747244713;Ne;8;0;4;12
21553;Gluosnis;PELĖDŽIUKAI;3900322680;Ne;7;0;2;9
21554;Gluosnis;PELĖDŽIUKAI;6729016081;Ne;3;0;2;5
21555;Gluosnis;PELĖDŽIUKAI;4069584911;Ne;5;2;2;9
21556;Gluosnis;PELĖDŽIUKAI;2423433989;Ne;0;5;1;6
21557;Gluosnis;PELĖDŽIUKAI;1263019496;Ne;6;2;2;10
21558;Gluosnis;PELĖDŽIUKAI;6119618742;Ne;7;0;2;9
21559;Gluosnis;PELĖDŽIUKAI;8109714321;Ne;3;0;5;8
21560;Gluosnis;PELĖDŽIUKAI;2794080237;Ne;0;13;0;13
21561;Gluosnis;PELĖDŽIUKAI;4564193030;Ne;0;3;2;5
21562;Gluosnis;PELĖDŽIUKAI;5623135790;Ne;3;7;2;12
21563;Gluosnis;PELĖDŽIUKAI;2310874591;Ne;9;0;8;17
21564;Gluosnis;PELĖDŽIUKAI;5210930032;Ne;1;2;2;5
21565;Gluosnis;PELĖDŽIUKAI;5008836118;Ne;6;0;3;9
21566;Gluosnis;PELĖDŽIUKAI;4224637208;Ne;0;3;0;3
21567;Gluosnis;PELĖDŽIUKAI;4361177196;Ne;5;0;4;9
21568;Gluosnis;PELĖDŽIUKAI;9484423786;Ne;8;0;5;13
21569;Gluosnis;PELĖDŽIUKAI;9423229931;Ne;11;0;4;15
21570;Gluosnis;PELĖDŽIUKAI;3578467708;Ne;4;0;3;7
21571;Gluosnis;VOVERIUKAI;4798207493;Ne;0;0;1;1
21572;Gluosnis;VOVERIUKAI;5822836262;Ne;4;0;2;6
21573;Gluosnis;VOVERIUKAI;8299388060;Ne;7;2;5;14
21574;Gluosnis;VOVERIUKAI;6617408330;Ne;0;0;1;1
21575;Gluosnis;VOVERIUKAI;5972818467;Ne;3;0;4;7
21576;Gluosnis;VOVERIUKAI;3400563947;Ne;0;1;1;2
21577;Gluosnis;VOVERIUKAI;5850079627;Ne;0;0;2;2
21578;Gluosnis;VOVERIUKAI;2243717506;Ne;1;0;8;9
21579;Gluosnis;VOVERIUKAI;8904254546;Ne;5;0;2;7
21580;Gluosnis;VOVERIUKAI;1757821835;Ne;2;2;4;8
21581;Gluosnis;VOVERIUKAI;8310409721;Ne;0;0;3;3
21582;Gluosnis;VOVERIUKAI;2746499687;Ne;3;0;3;6
21583;Gluosnis;VOVERIUKAI;1636516971;Ne;4;4;2;10
21584;Gluosnis;VOVERIUKAI;4566061172;Ne;0;0;2;2
21585;Gluosnis;DRUGELIAI;5949954525;Ne;0;7;0;7
21586;Gluosnis;DRUGELIAI;1716235604;Ne;0;5;1;6
21587;Gluosnis;DRUGELIAI;7642311375;Ne;0;6;0;6
21588;Gluosnis;DRUGELIAI;8430102757;Ne;0;2;0;2
21589;Gluosnis;DRUGELIAI;4125830926;Ne;0;2;0;2
21590;Gluosnis;DRUGELIAI;6358187113;Ne;1;2;4;7
21591;Gluosnis;DRUGELIAI;9084785666;Ne;0;3;2;5
21592;Gluosnis;DRUGELIAI;4940563623;Ne;0;3;0;3
21593;Gluosnis;DRUGELIAI;1113731535;Ne;0;5;0;5
21594;Gluosnis;DRUGELIAI;4653963373;Ne;0;2;2;4
21595;Gluosnis;DRUGELIAI;2458662117;Ne;3;0;3;6
21596;Gluosnis;DRUGELIAI;8314366921;Ne;0;0;3;3
21597;Gluosnis;DRUGELIAI;4220504133;Ne;0;2;0;2
21598;Gluosnis;DRUGELIAI;9931766935;Ne;0;2;5;7
21599;Gluosnis;DRUGELIAI;3527418865;Ne;0;2;2;4
21600;Gluosnis;DRUGELIAI;6914171069;Ne;0;3;0;3
21601;Gluosnis;DRUGELIAI;7756397778;Ne;0;0;1;1
21602;Gluosnis;DRUGELIAI;5943955268;Ne;0;0;7;7
21603;Gluosnis;DRUGELIAI;8690911930;Ne;0;10;6;16
21604;Gluosnis;DRUGELIAI;1543842220;Ne;0;0;4;4
21605;Gluosnis;DRUGELIAI;1787206205;Ne;0;6;0;6
21606;Gluosnis;DRUGELIAI;5264930854;Ne;0;2;0;2
21607;Gluosnis;BITUTĖS;4176300773;Ne;6;1;2;9
21608;Gluosnis;BITUTĖS;2554790908;Ne;0;2;0;2
21609;Gluosnis;BITUTĖS;8281499182;Ne;0;2;0;2
21610;Gluosnis;BITUTĖS;2403029153;Ne;0;1;2;3
21611;Gluosnis;BITUTĖS;6432475763;Ne;1;2;2;5
21612;Gluosnis;BITUTĖS;9542889575;Ne;0;2;0;2
21613;Gluosnis;BITUTĖS;1966484574;Ne;0;3;1;4
21614;Gluosnis;BITUTĖS;5889360726;Ne;1;2;4;7
21615;Gluosnis;BITUTĖS;8035097045;Ne;0;3;1;4
21616;Gluosnis;BITUTĖS;3362089746;Ne;0;1;2;3
21617;Gluosnis;BITUTĖS;7390361159;Ne;0;4;0;4
21618;Gluosnis;BITUTĖS;8380310240;Ne;3;2;2;7
21619;Gluosnis;BITUTĖS;4481544177;Ne;0;2;1;3
21620;Gluosnis;BITUTĖS;9098141563;Ne;1;4;3;8
21621;Gluosnis;BITUTĖS;9201769624;Ne;0;2;1;3
21622;Gluosnis;BITUTĖS;6767500085;Ne;1;0;3;4
21623;Gluosnis;BITUTĖS;6001358241;Ne;0;2;2;4
21624;Gluosnis;BITUTĖS;5380755693;Ne;0;2;2;4
21625;Gluosnis;BITUTĖS;6197840105;Ne;0;5;0;5
21626;Gluosnis;BITUTĖS;5204445760;Ne;0;5;1;6
21627;Gluosnis;BITUTĖS;5432102004;Ne;2;2;3;7
21628;"Vilniaus Simono Stanevičiaus progimnazija";BITUTĖS;7528014407;Ne;0;3;0;3
21629;"Vilniaus Simono Stanevičiaus progimnazija";BITUTĖS;5140264695;Ne;0;2;0;2
21630;"Vilniaus Simono Stanevičiaus progimnazija";BITUTĖS;6700169944;Ne;0;3;0;3
21631;"Vilniaus Simono Stanevičiaus progimnazija";BITUTĖS;9894466439;Ne;0;2;0;2
21632;"Vilniaus Simono Stanevičiaus progimnazija";BITUTĖS;5292978341;Ne;0;2;0;2
21633;"Vilniaus Simono Stanevičiaus progimnazija";BITUTĖS;5733610359;Ne;0;5;2;7
21634;"Vilniaus Simono Stanevičiaus progimnazija";BITUTĖS;2021296978;Ne;0;4;0;4
21635;"Vilniaus Simono Stanevičiaus progimnazija";BITUTĖS;8667155756;Ne;0;2;0;2
21636;"Vilniaus Simono Stanevičiaus progimnazija";BITUTĖS;1566011843;Ne;3;11;2;16
21637;"Vilniaus Simono Stanevičiaus progimnazija";BITUTĖS;9331479613;Ne;0;2;0;2
21638;"Vilniaus Simono Stanevičiaus progimnazija";BITUTĖS;4586098882;Ne;7;2;4;13
21639;"Vilniaus Simono Stanevičiaus progimnazija";BITUTĖS;4303490614;Ne;0;4;0;4
21640;"Vilniaus Simono Stanevičiaus progimnazija";BITUTĖS;8378295683;Ne;0;5;1;6
21641;"Vilniaus Simono Stanevičiaus progimnazija";BITUTĖS;8866490265;Ne;1;2;2;5
21642;"Vilniaus Simono Stanevičiaus progimnazija";BITUTĖS;2738119814;Ne;5;2;4;11
21643;"Vilniaus Simono Stanevičiaus progimnazija";BITUTĖS;3678796113;Ne;0;22;0;22
21644;"Vilniaus Simono Stanevičiaus progimnazija";BITUTĖS;7251592439;Ne;0;3;0;3
21645;"Vilniaus Simono Stanevičiaus progimnazija";BITUTĖS;2780141413;Ne;0;3;0;3
21646;"Vilniaus Simono Stanevičiaus progimnazija";BITUTĖS;7335784416;Ne;3;5;2;10
21647;"Vilniaus Simono Stanevičiaus progimnazija";BITUTĖS;6259640492;Ne;10;0;2;12
21648;"Vilniaus Simono Stanevičiaus progimnazija";BITUTĖS;6800864033;Ne;0;2;0;2
21649;"Vilniaus Simono Stanevičiaus progimnazija";KATINĖLIAI;1294225767;Ne;1;2;2;5
21650;"Vilniaus Simono Stanevičiaus progimnazija";KATINĖLIAI;9192285159;Ne;0;2;0;2
21651;"Vilniaus Simono Stanevičiaus progimnazija";KATINĖLIAI;2487784714;Ne;0;1;2;3
21652;"Vilniaus Simono Stanevičiaus progimnazija";KATINĖLIAI;7991650887;Ne;8;2;2;12
21653;"Vilniaus Simono Stanevičiaus progimnazija";KATINĖLIAI;4682659878;Ne;0;2;5;7
21654;"Vilniaus Simono Stanevičiaus progimnazija";KATINĖLIAI;1051805733;Ne;0;2;0;2
21655;"Vilniaus Simono Stanevičiaus progimnazija";KATINĖLIAI;4973969827;Ne;4;2;4;10
21656;"Vilniaus Simono Stanevičiaus progimnazija";KATINĖLIAI;1569084597;Ne;2;3;5;10
21657;"Vilniaus Simono Stanevičiaus progimnazija";KATINĖLIAI;5863422662;Ne;0;1;0;1
21658;"Vilniaus Simono Stanevičiaus progimnazija";KATINĖLIAI;1166282379;Ne;3;1;3;7
21659;"Vilniaus Simono Stanevičiaus progimnazija";KATINĖLIAI;6073971598;Ne;0;3;0;3
21660;"Vilniaus Simono Stanevičiaus progimnazija";KATINĖLIAI;2734024890;Ne;3;2;2;7
21661;"Vilniaus Simono Stanevičiaus progimnazija";KATINĖLIAI;2483957349;Ne;0;3;2;5
21662;"Vilniaus Simono Stanevičiaus progimnazija";KATINĖLIAI;6869418701;Ne;0;2;1;3
21663;"Vilniaus Simono Stanevičiaus progimnazija";KATINĖLIAI;6248532738;Ne;0;22;0;22
21664;"Vilniaus Simono Stanevičiaus progimnazija";KATINĖLIAI;8967704928;Ne;0;3;0;3
21665;"Vilniaus Simono Stanevičiaus progimnazija";KATINĖLIAI;4553345643;Ne;3;2;2;7
21666;"Vilniaus Simono Stanevičiaus progimnazija";KATINĖLIAI;8799003374;Ne;0;22;0;22
21667;"Vilniaus Simono Stanevičiaus progimnazija";KATINĖLIAI;7367485961;Ne;0;2;0;2
21668;"Vilniaus Simono Stanevičiaus progimnazija";KATINĖLIAI;1545323439;Ne;0;2;0;2
21669;"Vilniaus Simono Stanevičiaus progimnazija";KATINĖLIAI;9823633774;Ne;0;0;1;1
21670;"Vilniaus Saulėtekio mokykla-daugiafunkcinis centras";"PRIEŠMOKYKLINĖ 2";7903833413;Ne;0;2;2;4
21671;"Vilniaus Saulėtekio mokykla-daugiafunkcinis centras";"PRIEŠMOKYKLINĖ 2";3499348606;Ne;0;32;0;32
21672;"Vilniaus Saulėtekio mokykla-daugiafunkcinis centras";"PRIEŠMOKYKLINĖ 2";4730746531;Ne;0;2;11;13
21673;"Vilniaus Saulėtekio mokykla-daugiafunkcinis centras";"PRIEŠMOKYKLINĖ 2";1231703889;Ne;0;2;0;2
21674;"Vilniaus Saulėtekio mokykla-daugiafunkcinis centras";"PRIEŠMOKYKLINĖ 2";9471880764;Ne;0;2;4;6
21675;"Vilniaus Saulėtekio mokykla-daugiafunkcinis centras";"PRIEŠMOKYKLINĖ 2";8012122042;Ne;0;2;0;2
21676;"Vilniaus Saulėtekio mokykla-daugiafunkcinis centras";"PRIEŠMOKYKLINĖ 2";2034007263;Ne;0;2;0;2
21677;"Vilniaus Saulėtekio mokykla-daugiafunkcinis centras";"PRIEŠMOKYKLINĖ 2";7958528778;Ne;0;32;0;32
21678;"Vilniaus Saulėtekio mokykla-daugiafunkcinis centras";"PRIEŠMOKYKLINĖ 2";3080668107;Ne;0;2;3;5
21679;"Vilniaus Saulėtekio mokykla-daugiafunkcinis centras";"PRIEŠMOKYKLINĖ 2";6080664872;Ne;8;2;2;12
21680;"Vilniaus Saulėtekio mokykla-daugiafunkcinis centras";"PRIEŠMOKYKLINĖ 2";9962905184;Ne;0;2;0;2
21681;"Vilniaus Saulėtekio mokykla-daugiafunkcinis centras";"PRIEŠMOKYKLINĖ 2";3873345138;Ne;8;2;6;16
21682;"Vilniaus Saulėtekio mokykla-daugiafunkcinis centras";"PRIEŠMOKYKLINĖ 2";6702207851;Ne;2;2;6;10
21683;"Vilniaus Saulėtekio mokykla-daugiafunkcinis centras";"PRIEŠMOKYKLINĖ 2";5551184248;Ne;0;32;0;32
21684;"Vilniaus Saulėtekio mokykla-daugiafunkcinis centras";"PRIEŠMOKYKLINĖ 2";2631120189;Ne;16;2;10;28
21685;"Vilniaus Saulėtekio mokykla-daugiafunkcinis centras";"PRIEŠMOKYKLINĖ 2";4402503971;Ne;0;2;2;4
21686;"Vilniaus Saulėtekio mokykla-daugiafunkcinis centras";"PRIEŠMOKYKLINĖ 2";5998344519;Ne;5;2;3;10
21687;"Vilniaus Saulėtekio mokykla-daugiafunkcinis centras";"PRIEŠMOKYKLINĖ 2";1825755877;Ne;0;2;2;4
21688;"Vilniaus Saulėtekio mokykla-daugiafunkcinis centras";"PRIEŠMOKYKLINĖ  1";1816377082;Ne;0;2;2;4
21689;"Vilniaus Saulėtekio mokykla-daugiafunkcinis centras";"PRIEŠMOKYKLINĖ  1";7735063486;Ne;0;2;0;2
21690;"Vilniaus Saulėtekio mokykla-daugiafunkcinis centras";"PRIEŠMOKYKLINĖ  1";3744848906;Ne;0;2;1;3
21691;"Vilniaus Saulėtekio mokykla-daugiafunkcinis centras";"PRIEŠMOKYKLINĖ  1";4234425668;Ne;5;12;4;21
21692;"Vilniaus Saulėtekio mokykla-daugiafunkcinis centras";"PRIEŠMOKYKLINĖ  1";4852738818;Ne;7;2;0;9
21693;"Vilniaus Saulėtekio mokykla-daugiafunkcinis centras";"PRIEŠMOKYKLINĖ  1";5399981203;Ne;2;4;2;8
21694;"Vilniaus Saulėtekio mokykla-daugiafunkcinis centras";"PRIEŠMOKYKLINĖ  1";8997525194;Ne;0;2;4;6
21695;"Vilniaus Saulėtekio mokykla-daugiafunkcinis centras";"PRIEŠMOKYKLINĖ  1";6860696706;Ne;17;2;2;21
21696;"Vilniaus Saulėtekio mokykla-daugiafunkcinis centras";"PRIEŠMOKYKLINĖ  1";9031478765;Ne;1;2;2;5
21697;"Vilniaus Saulėtekio mokykla-daugiafunkcinis centras";"PRIEŠMOKYKLINĖ  1";5532685692;Ne;0;2;0;2
21698;"Vilniaus Saulėtekio mokykla-daugiafunkcinis centras";"PRIEŠMOKYKLINĖ  1";5817562139;Ne;0;31;0;31
21699;"Vilniaus Saulėtekio mokykla-daugiafunkcinis centras";"PRIEŠMOKYKLINĖ  1";8889959782;Ne;8;2;2;12
21700;"Vilniaus Saulėtekio mokykla-daugiafunkcinis centras";"PRIEŠMOKYKLINĖ  1";1625321820;Ne;8;2;2;12
21701;"Vilniaus Saulėtekio mokykla-daugiafunkcinis centras";"PRIEŠMOKYKLINĖ  1";3382354753;Ne;6;2;2;10
21702;"Vilniaus Saulėtekio mokykla-daugiafunkcinis centras";"PRIEŠMOKYKLINĖ  1";9099285081;Ne;14;2;2;18
21703;"Vilniaus Saulėtekio mokykla-daugiafunkcinis centras";"PRIEŠMOKYKLINĖ  1";1839351438;Ne;3;2;2;7
21704;"Vilniaus Saulėtekio mokykla-daugiafunkcinis centras";"PRIEŠMOKYKLINĖ  1";5586871557;Ne;0;31;0;31
21705;"Vilniaus Saulėtekio mokykla-daugiafunkcinis centras";"PRIEŠMOKYKLINĖ  1";2429527586;Ne;2;2;5;9
21706;"Vilniaus Maironio progimnazija";"1 PU";5652769035;Ne;3;2;3;8
21707;"Vilniaus Maironio progimnazija";"1 PU";5593526943;Ne;4;2;4;10
21708;"Vilniaus Maironio progimnazija";"1 PU";1603752483;Ne;7;2;7;16
21709;"Vilniaus Maironio progimnazija";"1 PU";6171650517;Ne;3;2;5;10
21710;"Vilniaus Maironio progimnazija";"1 PU";1591999024;Ne;1;2;2;5
21711;"Vilniaus Maironio progimnazija";"1 PU";5022388487;Ne;0;7;0;7
21712;"Vilniaus Maironio progimnazija";"1 PU";1024337077;Ne;0;32;0;32
21713;"Vilniaus Maironio progimnazija";"1 PU";6176234300;Ne;5;2;4;11
21714;"Vilniaus Maironio progimnazija";"1 PU";1339850717;Ne;8;2;2;12
21715;"Vilniaus Maironio progimnazija";"1 PU";4806652727;Ne;0;2;1;3
21716;"Vilniaus Maironio progimnazija";"1 PU";4570512336;Ne;0;2;3;5
21717;"Vilniaus Maironio progimnazija";"1 PU";6266095782;Ne;3;2;2;7
21718;"Vilniaus Maironio progimnazija";"1 PU";5322766823;Ne;0;2;1;3
21719;"Vilniaus Maironio progimnazija";"1 PU";9803206596;Ne;3;2;8;13
21720;"Vilniaus Maironio progimnazija";"1 PU";5957889361;Ne;0;2;1;3
21721;"Vilniaus Maironio progimnazija";"1 PU";2707029719;Ne;6;2;5;13
21722;"Vilniaus Maironio progimnazija";"1 PU";4917910801;Ne;9;2;2;13
21723;"Vilniaus Maironio progimnazija";"1 PU";3347146751;Ne;0;2;1;3
21724;"Vilniaus Maironio progimnazija";"1 PU";8393893311;Ne;1;2;5;8
21725;"Vilniaus Maironio progimnazija";"1 PU";2443856355;Ne;2;2;4;8
21726;"Vilniaus Maironio progimnazija";"1 PU";3443745088;Taip;0;2;1;3
21727;"Vilniaus Maironio progimnazija";"2 PU";7395477522;Ne;0;2;0;2
21728;"Vilniaus Maironio progimnazija";"2 PU";8768526171;Ne;0;2;0;2
21729;"Vilniaus Maironio progimnazija";"2 PU";6949120693;Ne;1;6;0;7
21730;"Vilniaus Maironio progimnazija";"2 PU";7080578299;Ne;5;2;4;11
21731;"Vilniaus Maironio progimnazija";"2 PU";9968072478;Ne;1;5;2;8
21732;"Vilniaus Maironio progimnazija";"2 PU";8480891793;Ne;2;3;3;8
21733;"Vilniaus Maironio progimnazija";"2 PU";2783708905;Ne;6;2;2;10
21734;"Vilniaus Maironio progimnazija";"2 PU";8946678515;Ne;0;2;2;4
21735;"Vilniaus Maironio progimnazija";"2 PU";3320524073;Ne;11;3;4;18
21736;"Vilniaus Maironio progimnazija";"2 PU";2339010385;Ne;0;3;2;5
21737;"Vilniaus Maironio progimnazija";"2 PU";3895256591;Ne;0;7;0;7
21738;"Vilniaus Maironio progimnazija";"2 PU";1827752731;Ne;1;2;2;5
21739;"Vilniaus Maironio progimnazija";"2 PU";7859096984;Ne;0;8;0;8
21740;"Vilniaus Maironio progimnazija";"2 PU";7252265838;Ne;8;2;2;12
21741;"Vilniaus Maironio progimnazija";"2 PU";5883751305;Ne;4;2;4;10
21742;"Vilniaus Maironio progimnazija";"2 PU";2215846642;Ne;3;2;2;7
21743;"Vilniaus Maironio progimnazija";"2 PU";2868899342;Ne;0;2;3;5
21744;"Vilniaus Maironio progimnazija";"2 PU";9804863902;Ne;1;3;1;5
21745;"Vilniaus Maironio progimnazija";"2 PU";8606551477;Ne;3;2;3;8
21746;"Vilniaus Maironio progimnazija";"2 PU";2334234258;Ne;0;2;2;4
21747;"Vilniaus Maironio progimnazija";"2 PU";9978625382;Ne;6;3;7;16
21748;"Vilniaus kunigaikščio Gedimino progimnazija";NYKŠTUKAI;5909584565;Ne;0;3;0;3
21749;"Vilniaus kunigaikščio Gedimino progimnazija";NYKŠTUKAI;6234943180;Ne;0;3;0;3
21750;"Vilniaus kunigaikščio Gedimino progimnazija";NYKŠTUKAI;2406183145;Ne;0;3;0;3
21751;"Vilniaus kunigaikščio Gedimino progimnazija";NYKŠTUKAI;2379660463;Ne;0;3;0;3
21752;"Vilniaus kunigaikščio Gedimino progimnazija";NYKŠTUKAI;3363824185;Ne;6;2;2;10
21753;"Vilniaus kunigaikščio Gedimino progimnazija";NYKŠTUKAI;9408948207;Ne;0;2;0;2
21754;"Vilniaus kunigaikščio Gedimino progimnazija";NYKŠTUKAI;6942029629;Ne;2;4;2;8
21755;"Vilniaus kunigaikščio Gedimino progimnazija";NYKŠTUKAI;7161727352;Ne;4;2;2;8
21756;"Vilniaus kunigaikščio Gedimino progimnazija";NYKŠTUKAI;5695333666;Ne;2;2;2;6
21757;"Vilniaus kunigaikščio Gedimino progimnazija";NYKŠTUKAI;8061678477;Ne;5;3;3;11
21758;"Vilniaus kunigaikščio Gedimino progimnazija";NYKŠTUKAI;4635123721;Ne;0;2;0;2
21759;"Vilniaus kunigaikščio Gedimino progimnazija";NYKŠTUKAI;6574415196;Ne;3;2;2;7
21760;"Vilniaus kunigaikščio Gedimino progimnazija";NYKŠTUKAI;9777202512;Ne;2;5;2;9
21761;"Vilniaus kunigaikščio Gedimino progimnazija";NYKŠTUKAI;5187411500;Ne;0;2;0;2
21762;"Vilniaus kunigaikščio Gedimino progimnazija";NYKŠTUKAI;1420438624;Ne;0;2;0;2
21763;"Vilniaus kunigaikščio Gedimino progimnazija";NYKŠTUKAI;4681686872;Ne;0;2;0;2
21764;"Gintarėlis (Popieriaus g. 46A)";SKRUZDĖLIUKAI;5738933125;Ne;0;10;2;12
21765;"Gintarėlis (Popieriaus g. 46A)";SKRUZDĖLIUKAI;7510541192;Ne;2;0;3;5
21766;"Gintarėlis (Popieriaus g. 46A)";SKRUZDĖLIUKAI;1955719034;Ne;6;2;2;10
21767;"Gintarėlis (Popieriaus g. 46A)";SKRUZDĖLIUKAI;1215549844;Ne;8;0;4;12
21768;"Gintarėlis (Popieriaus g. 46A)";SKRUZDĖLIUKAI;5961603860;Ne;7;3;2;12
21769;"Gintarėlis (Popieriaus g. 46A)";SKRUZDĖLIUKAI;4290033336;Ne;0;0;4;4
21770;"Gintarėlis (Popieriaus g. 46A)";SKRUZDĖLIUKAI;5474876914;Ne;2;1;6;9
21771;"Gintarėlis (Popieriaus g. 46A)";SKRUZDĖLIUKAI;6333647073;Ne;0;7;0;7
21772;"Gintarėlis (Popieriaus g. 46A)";SKRUZDĖLIUKAI;7274616480;Ne;0;6;1;7
21773;"Gintarėlis (Popieriaus g. 46A)";SKRUZDĖLIUKAI;1362980885;Ne;4;0;9;13
21774;"Gintarėlis (Popieriaus g. 46A)";SKRUZDĖLIUKAI;9762364250;Ne;0;4;0;4
21775;"Gintarėlis (Popieriaus g. 46A)";SKRUZDĖLIUKAI;7206593645;Ne;6;0;4;10
21776;"Gintarėlis (Popieriaus g. 46A)";SKRUZDĖLIUKAI;7400455090;Ne;2;4;5;11
21777;"Gintarėlis (Popieriaus g. 46A)";SKRUZDĖLIUKAI;7413074674;Ne;3;0;2;5
21778;"Gintarėlis (Popieriaus g. 46A)";PELĖDŽIUKAI;6506180216;Ne;0;7;0;7
21779;"Gintarėlis (Popieriaus g. 46A)";PELĖDŽIUKAI;9200073539;Ne;2;1;2;5
21780;"Gintarėlis (Popieriaus g. 46A)";PELĖDŽIUKAI;3254739432;Ne;1;0;5;6
21781;"Gintarėlis (Popieriaus g. 46A)";PELĖDŽIUKAI;8019543081;Ne;0;0;2;2
21782;"Gintarėlis (Popieriaus g. 46A)";PELĖDŽIUKAI;1628276472;Ne;2;4;2;8
21783;"Gintarėlis (Popieriaus g. 46A)";PELĖDŽIUKAI;8792175474;Ne;18;2;2;22
21784;"Gintarėlis (Popieriaus g. 46A)";PELĖDŽIUKAI;3304191482;Ne;3;0;4;7
21785;"Gintarėlis (Popieriaus g. 46A)";PELĖDŽIUKAI;2731865977;Ne;0;2;0;2
21786;"Gintarėlis (Popieriaus g. 46A)";PELĖDŽIUKAI;4181430769;Ne;5;1;5;11
21787;"Gintarėlis (Popieriaus g. 46A)";PELĖDŽIUKAI;3202819190;Ne;10;0;2;12
21788;"Gintarėlis (Popieriaus g. 46A)";PELĖDŽIUKAI;2308673417;Ne;0;1;0;1
21789;"Gintarėlis (Popieriaus g. 46A)";PELĖDŽIUKAI;6883573289;Ne;0;4;0;4
21790;"Gintarėlis (Popieriaus g. 46A)";PELĖDŽIUKAI;3127881266;Ne;0;2;3;5
21791;"Gintarėlis (Popieriaus g. 46A)";PELĖDŽIUKAI;2052962147;Ne;2;0;4;6
21792;"Gintarėlis (Popieriaus g. 46A)";PELĖDŽIUKAI;8677500463;Ne;10;0;5;15
21793;"Gintarėlis (Popieriaus g. 46A)";PELĖDŽIUKAI;7031945895;Ne;5;0;3;8
21794;"Gintarėlis (Popieriaus g. 46A)";PELĖDŽIUKAI;3744569118;Ne;0;1;0;1
21795;"Gintarėlis (Popieriaus g. 46A)";PELĖDŽIUKAI;8068499156;Ne;7;0;3;10
21796;"Gintarėlis (Popieriaus g. 46A)";"LINKSMASIS AVILYS";7872515649;Ne;11;4;2;17
21797;"Gintarėlis (Popieriaus g. 46A)";"LINKSMASIS AVILYS";7256557310;Ne;5;2;3;10
21798;"Gintarėlis (Popieriaus g. 46A)";"LINKSMASIS AVILYS";7010430969;Ne;0;4;2;6
21799;"Gintarėlis (Popieriaus g. 46A)";"LINKSMASIS AVILYS";8680339493;Ne;5;2;4;11
21800;"Gintarėlis (Popieriaus g. 46A)";"LINKSMASIS AVILYS";5223116373;Ne;4;3;2;9
21801;"Gintarėlis (Popieriaus g. 46A)";"LINKSMASIS AVILYS";6162836315;Ne;2;0;2;4
21802;"Gintarėlis (Popieriaus g. 46A)";"LINKSMASIS AVILYS";3825572125;Ne;0;3;4;7
21803;"Gintarėlis (Popieriaus g. 46A)";"LINKSMASIS AVILYS";1994856959;Ne;0;4;1;5
21804;"Gintarėlis (Popieriaus g. 46A)";"LINKSMASIS AVILYS";8223747534;Ne;0;6;1;7
21805;"Gintarėlis (Popieriaus g. 46A)";"LINKSMASIS AVILYS";1045355492;Ne;0;2;1;3
21806;"Gintarėlis (Popieriaus g. 46A)";"LINKSMASIS AVILYS";6193540660;Ne;12;2;4;18
21807;"Gintarėlis (Popieriaus g. 46A)";"LINKSMASIS AVILYS";7916257692;Ne;0;1;0;1
21808;"Gintarėlis (Popieriaus g. 46A)";"LINKSMASIS AVILYS";9045108717;Ne;14;0;4;18
21809;"Gintarėlis (Popieriaus g. 46A)";"LINKSMASIS AVILYS";5379858630;Ne;0;2;17;19
21810;"Gintarėlis (Popieriaus g. 46A)";"LINKSMASIS AVILYS";4556644354;Ne;8;0;5;13
21811;"Gintarėlis (Popieriaus g. 46A)";Varliukai;6821929306;Ne;0;0;5;5
21812;"Gintarėlis (Popieriaus g. 46A)";Varliukai;4263315669;Ne;11;0;4;15
21813;"Gintarėlis (Popieriaus g. 46A)";Varliukai;6514247750;Ne;3;0;4;7
21814;"Gintarėlis (Popieriaus g. 46A)";Varliukai;7510641510;Ne;0;0;2;2
21815;"Gintarėlis (Popieriaus g. 46A)";Varliukai;6534072038;Ne;0;4;0;4
21816;"Gintarėlis (Popieriaus g. 46A)";Varliukai;5478441530;Ne;0;3;2;5
21817;"Gintarėlis (Popieriaus g. 46A)";Varliukai;5771196440;Ne;1;0;2;3
21818;"Gintarėlis (Popieriaus g. 46A)";Varliukai;7783860076;Ne;0;2;0;2
21819;"Gintarėlis (Popieriaus g. 46A)";Varliukai;7201714826;Ne;0;1;0;1
21820;"Gintarėlis (Popieriaus g. 46A)";Varliukai;6796839291;Ne;0;7;0;7
21821;"Gintarėlis (Popieriaus g. 46A)";Varliukai;3842338529;Ne;0;22;0;22
21822;"Gintarėlis (Popieriaus g. 46A)";Varliukai;2742819175;Ne;0;1;1;2
21823;"Gintarėlis (Popieriaus g. 46A)";Varliukai;2692117849;Ne;5;11;2;18
21824;"Gintarėlis (Popieriaus g. 46A)";Varliukai;9063374884;Ne;2;4;2;8
21825;"Gintarėlis (Popieriaus g. 46A)";Varliukai;8226000686;Ne;0;9;0;9
21826;"Gintarėlis (Popieriaus g. 46A)";Varliukai;7128652904;Taip;0;2;5;7
21827;"Gintarėlis (Popieriaus g. 46A)";Varliukai;5726179660;Ne;9;0;2;11
21828;"Pušynėlis (A. Mickevičiaus g. 21)";DAIGIUKAI;8668906624;Ne;6;2;4;12
21829;"Pušynėlis (A. Mickevičiaus g. 21)";DAIGIUKAI;9835049161;Ne;0;5;0;5
21830;"Pušynėlis (A. Mickevičiaus g. 21)";DAIGIUKAI;8473976622;Ne;3;2;2;7
21831;"Pušynėlis (A. Mickevičiaus g. 21)";DAIGIUKAI;7200341988;Ne;8;0;4;12
21832;"Pušynėlis (A. Mickevičiaus g. 21)";DAIGIUKAI;6630085270;Ne;0;2;0;2
21833;"Pušynėlis (A. Mickevičiaus g. 21)";DAIGIUKAI;6321506677;Ne;0;22;0;22
21834;"Pušynėlis (A. Mickevičiaus g. 21)";DAIGIUKAI;7825721993;Ne;9;0;4;13
21835;"Pušynėlis (A. Mickevičiaus g. 21)";DAIGIUKAI;2905910220;Ne;0;0;3;3
21836;"Pušynėlis (A. Mickevičiaus g. 21)";DAIGIUKAI;2283845338;Ne;0;5;1;6
21837;"Pušynėlis (A. Mickevičiaus g. 21)";DAIGIUKAI;2543730165;Ne;5;0;5;10
21838;"Pušynėlis (A. Mickevičiaus g. 21)";NYKŠTUKAI;8820865805;Ne;0;16;0;16
21839;"Pušynėlis (A. Mickevičiaus g. 21)";NYKŠTUKAI;9520423020;Ne;0;6;2;8
21840;"Pušynėlis (A. Mickevičiaus g. 21)";NYKŠTUKAI;3574446664;Taip;0;3;0;3
21841;"Pušynėlis (A. Mickevičiaus g. 21)";NYKŠTUKAI;8512699165;Ne;0;6;0;6
21842;"Pušynėlis (A. Mickevičiaus g. 21)";NYKŠTUKAI;5364537212;Ne;1;7;5;13
21843;"Pušynėlis (A. Mickevičiaus g. 21)";NYKŠTUKAI;8327830781;Ne;2;3;3;8
21844;"Pušynėlis (A. Mickevičiaus g. 21)";NYKŠTUKAI;5317547220;Taip;0;0;4;4
21845;"Pušynėlis (A. Mickevičiaus g. 21)";NYKŠTUKAI;9025539389;Ne;3;0;2;5
21846;"Pušynėlis (A. Mickevičiaus g. 21)";NYKŠTUKAI;2763762463;Ne;0;3;0;3
21847;"Pušynėlis (A. Mickevičiaus g. 21)";NYKŠTUKAI;8211464695;Ne;0;4;2;6
21848;"Pušynėlis (A. Mickevičiaus g. 21)";NYKŠTUKAI;6270870180;Ne;0;6;0;6
21849;"Pušynėlis (A. Mickevičiaus g. 21)";NYKŠTUKAI;4685125111;Ne;0;1;0;1
21850;"Pušynėlis (A. Mickevičiaus g. 21)";NYKŠTUKAI;9717473430;Ne;5;1;2;8
21851;"Pušynėlis (A. Mickevičiaus g. 21)";NYKŠTUKAI;1057676386;Ne;0;1;0;1
21852;"Pušynėlis (A. Mickevičiaus g. 21)";NYKŠTUKAI;5512586591;Ne;3;0;4;7
21853;"Pušynėlis (A. Mickevičiaus g. 21)";NYKŠTUKAI;1085678424;Taip;2;0;2;4
21854;"Pušynėlis (A. Mickevičiaus g. 21)";GILIUKAI;9517319856;Ne;0;4;3;7
21855;"Pušynėlis (A. Mickevičiaus g. 21)";GILIUKAI;2825756894;Ne;10;1;2;13
21856;"Pušynėlis (A. Mickevičiaus g. 21)";GILIUKAI;4997004998;Ne;3;2;3;8
21857;"Pušynėlis (A. Mickevičiaus g. 21)";GILIUKAI;2712755125;Taip;0;0;1;1
21858;"Pušynėlis (A. Mickevičiaus g. 21)";GILIUKAI;9028515427;Ne;2;0;4;6
21859;"Pušynėlis (A. Mickevičiaus g. 21)";GILIUKAI;8298368128;Ne;11;0;2;13
21860;"Pušynėlis (A. Mickevičiaus g. 21)";GILIUKAI;8712141140;Ne;2;0;0;2
21861;"Pušynėlis (A. Mickevičiaus g. 21)";GILIUKAI;1050710006;Ne;0;3;0;3
21862;"Pušynėlis (A. Mickevičiaus g. 21)";GILIUKAI;1758632291;Ne;2;3;0;5
21863;"Pušynėlis (A. Mickevičiaus g. 21)";GILIUKAI;2892213973;Ne;0;3;0;3
21864;"Pušynėlis (A. Mickevičiaus g. 21)";GILIUKAI;7429853563;Ne;0;9;0;9
21865;"Pušynėlis (A. Mickevičiaus g. 21)";GILIUKAI;8464672994;Ne;0;4;2;6
21866;"Pušynėlis (A. Mickevičiaus g. 21)";GILIUKAI;1904434730;Ne;2;0;2;4
21867;"Pušynėlis (A. Mickevičiaus g. 21)";GILIUKAI;2222790161;Ne;0;2;0;2
21868;"Pušynėlis (A. Mickevičiaus g. 21)";GILIUKAI;8699085292;Ne;2;2;2;6
21869;"Pušynėlis (A. Mickevičiaus g. 21)";LINELIS;4126444564;Ne;2;5;2;9
21870;"Pušynėlis (A. Mickevičiaus g. 21)";LINELIS;4738909947;Ne;0;4;0;4
21871;"Pušynėlis (A. Mickevičiaus g. 21)";LINELIS;2315614501;Ne;0;2;0;2
21872;"Pušynėlis (A. Mickevičiaus g. 21)";LINELIS;3189188757;Ne;0;2;0;2
21873;"Pušynėlis (A. Mickevičiaus g. 21)";LINELIS;3682550072;Ne;0;3;1;4
21874;"Pušynėlis (A. Mickevičiaus g. 21)";LINELIS;8654487151;Ne;0;4;0;4
21875;"Pušynėlis (A. Mickevičiaus g. 21)";LINELIS;8837847094;Ne;6;1;6;13
21876;"Pušynėlis (A. Mickevičiaus g. 21)";LINELIS;6374352500;Ne;0;2;0;2
21877;"Pušynėlis (A. Mickevičiaus g. 21)";LINELIS;9216703884;Ne;0;2;0;2
21878;"Pušynėlis (A. Mickevičiaus g. 21)";LINELIS;5668765825;Ne;8;2;4;14
21879;"Pušynėlis (A. Mickevičiaus g. 21)";LINELIS;7685809238;Ne;5;2;2;9
21880;"Pušynėlis (A. Mickevičiaus g. 21)";LINELIS;7011836009;Ne;13;0;2;15
21881;"Pušynėlis (A. Mickevičiaus g. 21)";LINELIS;6735037523;Ne;9;1;2;12
21882;"Pušynėlis (A. Mickevičiaus g. 21)";LINELIS;9401101407;Ne;0;4;0;4
21883;"Pušynėlis (A. Mickevičiaus g. 21)";LINELIS;7881263225;Ne;1;1;2;4
21884;"Pušynėlis (A. Mickevičiaus g. 21)";LINELIS;1612049897;Ne;0;5;0;5
21885;"Pušynėlis (A. Mickevičiaus g. 21)";LINELIS;9920959446;Ne;0;2;0;2
21886;"Pušynėlis (A. Mickevičiaus g. 21)";LINELIS;4898147530;Ne;0;1;0;1
21887;"Pušynėlis (A. Mickevičiaus g. 21)";LINELIS;2228682366;Ne;3;7;2;12
21888;"Pušynėlis (A. Mickevičiaus g. 21)";LINELIS;4464615995;Ne;0;1;0;1
21889;"Naminukas (Klinikų g. 5)";VARPELIAI;3281707263;Ne;6;0;8;14
21890;"Naminukas (Klinikų g. 5)";VARPELIAI;3683089217;Ne;8;4;0;12
21891;"Naminukas (Klinikų g. 5)";VARPELIAI;1086919259;Ne;5;13;0;18
21892;"Naminukas (Klinikų g. 5)";VARPELIAI;2576516583;Ne;17;2;0;19
21893;"Naminukas (Klinikų g. 5)";VARPELIAI;8694425584;Ne;6;0;4;10
21894;"Naminukas (Klinikų g. 5)";VARPELIAI;8782832803;Ne;0;8;0;8
21895;"Naminukas (Klinikų g. 5)";VARPELIAI;7555926818;Ne;8;0;5;13
21896;"Naminukas (Klinikų g. 5)";VARPELIAI;8392480469;Ne;3;0;2;5
21897;"Naminukas (Klinikų g. 5)";VARPELIAI;9426969493;Ne;8;0;3;11
21898;"Naminukas (Klinikų g. 5)";VARPELIAI;6834388512;Ne;16;6;0;22
21899;"Naminukas (Klinikų g. 5)";VARPELIAI;8212264128;Ne;12;1;1;14
21900;"Naminukas (Klinikų g. 5)";VARPELIAI;8659342548;Ne;0;0;3;3
21901;"Naminukas (Klinikų g. 5)";VARPELIAI;1415188327;Ne;11;0;3;14
21902;"Naminukas (Klinikų g. 5)";VARPELIAI;5154177047;Ne;11;0;3;14
21903;"Naminukas (Klinikų g. 5)";VARPELIAI;5906891337;Ne;2;0;2;4
21904;"Naminukas (Klinikų g. 5)";SAULUTĖS;7947598191;Ne;0;2;2;4
21905;"Naminukas (Klinikų g. 5)";SAULUTĖS;1635395128;Ne;0;0;2;2
21906;"Naminukas (Klinikų g. 5)";SAULUTĖS;2516513740;Ne;0;3;0;3
21907;"Naminukas (Klinikų g. 5)";SAULUTĖS;2721723305;Ne;2;0;8;10
21908;"Naminukas (Klinikų g. 5)";SAULUTĖS;6559544449;Ne;0;0;2;2
21909;"Naminukas (Klinikų g. 5)";SAULUTĖS;8052458976;Ne;13;0;3;16
21910;"Naminukas (Klinikų g. 5)";SAULUTĖS;2089455192;Ne;0;2;0;2
21911;"Naminukas (Klinikų g. 5)";SAULUTĖS;1828220049;Ne;7;1;2;10
21912;"Naminukas (Klinikų g. 5)";SAULUTĖS;5172385044;Ne;1;0;19;20
21913;"Naminukas (Klinikų g. 5)";SAULUTĖS;7772300667;Ne;7;0;3;10
21914;"Naminukas (Klinikų g. 5)";SAULUTĖS;3497829075;Ne;0;7;0;7
21915;"Naminukas (Klinikų g. 5)";SAULUTĖS;3938225198;Ne;0;3;0;3
21916;"Naminukas (Klinikų g. 5)";SAULUTĖS;6515021073;Ne;0;0;18;18
21917;"Naminukas (Klinikų g. 5)";SAULUTĖS;9894306360;Ne;0;15;0;15
21918;"Naminukas (Klinikų g. 5)";SAULUTĖS;5991261279;Ne;0;0;4;4
21919;"Naminukas (Klinikų g. 5)";SAULUTĖS;9537360943;Ne;8;0;7;15
21920;"Naminukas (Klinikų g. 5)";SAULUTĖS;7304789836;Ne;3;1;0;4
21921;"Naminukas (Klinikų g. 5)";DRUGELIAI;7033053271;Ne;0;2;2;4
21922;"Naminukas (Klinikų g. 5)";DRUGELIAI;7184471307;Ne;0;0;4;4
21923;"Naminukas (Klinikų g. 5)";DRUGELIAI;8432194383;Ne;9;4;0;13
21924;"Naminukas (Klinikų g. 5)";DRUGELIAI;9835701381;Ne;2;0;0;2
21925;"Naminukas (Klinikų g. 5)";DRUGELIAI;1092799944;Ne;3;2;2;7
21926;"Naminukas (Klinikų g. 5)";DRUGELIAI;8595804874;Ne;0;2;10;12
21927;"Naminukas (Klinikų g. 5)";DRUGELIAI;3911352454;Ne;5;13;0;18
21928;"Naminukas (Klinikų g. 5)";DRUGELIAI;7107337857;Ne;9;2;3;14
21929;"Naminukas (Klinikų g. 5)";DRUGELIAI;7301768930;Ne;3;0;3;6
21930;"Naminukas (Klinikų g. 5)";DRUGELIAI;9212800864;Ne;5;2;0;7
21931;"Naminukas (Klinikų g. 5)";DRUGELIAI;2336627398;Ne;3;2;2;7
21932;"Naminukas (Klinikų g. 5)";DRUGELIAI;1879925655;Ne;9;3;1;13
21933;"Naminukas (Klinikų g. 5)";DRUGELIAI;2881576194;Ne;12;1;1;14
21934;"Naminukas (Klinikų g. 5)";DRUGELIAI;4836599508;Ne;0;10;2;12
21935;"Naminukas (Klinikų g. 5)";DRUGELIAI;4709625816;Ne;0;0;1;1
21936;"Naminukas (Klinikų g. 5)";DRUGELIAI;6471277755;Ne;0;2;1;3
21937;"Naminukas (Klinikų g. 5)";DRUGELIAI;1932169696;Ne;2;0;2;4
21938;"Naminukas (Klinikų g. 5)";DRUGELIAI;9215327479;Ne;5;0;4;9
21939;"Naminukas (Klinikų g. 5)";BITUTĖS;6592057292;Ne;9;2;4;15
21940;"Naminukas (Klinikų g. 5)";BITUTĖS;5578151523;Ne;0;2;1;3
21941;"Naminukas (Klinikų g. 5)";BITUTĖS;5288557629;Ne;0;5;0;5
21942;"Naminukas (Klinikų g. 5)";BITUTĖS;5233044803;Ne;0;0;1;1
21943;"Naminukas (Klinikų g. 5)";BITUTĖS;3791118736;Ne;3;1;2;6
21944;"Naminukas (Klinikų g. 5)";BITUTĖS;7099787230;Ne;4;2;2;8
21945;"Naminukas (Klinikų g. 5)";BITUTĖS;3088386659;Ne;0;2;0;2
21946;"Naminukas (Klinikų g. 5)";BITUTĖS;8412724452;Ne;0;0;2;2
21947;"Naminukas (Klinikų g. 5)";BITUTĖS;3276656641;Ne;0;0;8;8
21948;"Naminukas (Klinikų g. 5)";BITUTĖS;2004615252;Ne;3;2;4;9
21949;"Naminukas (Klinikų g. 5)";BITUTĖS;6633031473;Ne;0;2;1;3
21950;"Naminukas (Klinikų g. 5)";BITUTĖS;4116151797;Taip;4;1;6;11
21951;"Naminukas (Klinikų g. 5)";BITUTĖS;2339599448;Taip;3;1;2;6
21952;"Naminukas (Klinikų g. 5)";BITUTĖS;4077985773;Ne;7;2;2;11
21953;"Naminukas (Klinikų g. 5)";BITUTĖS;1454039572;Ne;9;1;2;12
21954;"Naminukas (Klinikų g. 5)";BITUTĖS;9740815635;Ne;0;0;1;1
21955;"Naminukas (Klinikų g. 5)";BITUTĖS;6949857110;Ne;0;2;0;2
21956;"Naminukas (Klinikų g. 5)";BITUTĖS;8039086094;Ne;6;2;3;11
21957;"Naminukas (Klinikų g. 5)";BITUTĖS;4171789569;Ne;3;3;2;8
21958;"Naminukas (Klinikų g. 5)";BITUTĖS;6880075874;Ne;0;2;0;2
21959;"Naminukas (Klinikų g. 5)";BITUTĖS;8793327541;Ne;0;2;0;2
21960;"Gervelė (Stadiono g. 5)";BORUŽĖLĖS;2696708010;Ne;4;0;2;6
21961;"Gervelė (Stadiono g. 5)";BORUŽĖLĖS;2136541073;Ne;4;0;4;8
21962;"Gervelė (Stadiono g. 5)";BORUŽĖLĖS;6066996878;Ne;3;0;2;5
21963;"Gervelė (Stadiono g. 5)";BORUŽĖLĖS;4354544070;Ne;6;0;2;8
21964;"Gervelė (Stadiono g. 5)";BORUŽĖLĖS;3448452820;Ne;8;0;6;14
21965;"Gervelė (Stadiono g. 5)";BORUŽĖLĖS;2794943031;Ne;3;0;6;9
21966;"Gervelė (Stadiono g. 5)";BORUŽĖLĖS;5697289420;Ne;7;0;4;11
21967;"Gervelė (Stadiono g. 5)";BORUŽĖLĖS;8763515382;Ne;11;0;4;15
21968;"Gervelė (Stadiono g. 5)";BORUŽĖLĖS;3516734802;Ne;7;1;2;10
21969;"Gervelė (Stadiono g. 5)";BORUŽĖLĖS;6336219323;Ne;1;0;3;4
21970;"Gervelė (Stadiono g. 5)";BORUŽĖLĖS;8067639732;Ne;11;2;2;15
21971;"Gervelė (Stadiono g. 5)";BORUŽĖLĖS;5435672672;Ne;0;7;0;7
21972;"Gervelė (Stadiono g. 5)";PAUKŠTELIAI;7959839478;Ne;0;2;0;2
21973;"Gervelė (Stadiono g. 5)";PAUKŠTELIAI;2892214705;Ne;0;13;0;13
21974;"Gervelė (Stadiono g. 5)";PAUKŠTELIAI;9154032804;Ne;0;14;0;14
21975;"Gervelė (Stadiono g. 5)";PAUKŠTELIAI;7843800194;Ne;0;5;0;5
21976;"Gervelė (Stadiono g. 5)";PAUKŠTELIAI;4588890423;Taip;3;10;2;15
21977;"Gervelė (Stadiono g. 5)";PAUKŠTELIAI;7847393041;Ne;14;2;4;20
21978;"Gervelė (Stadiono g. 5)";PAUKŠTELIAI;6427072260;Ne;1;0;2;3
21979;"Gervelė (Stadiono g. 5)";PAUKŠTELIAI;5285868851;Ne;5;0;2;7
21980;"Gervelė (Stadiono g. 5)";PAUKŠTELIAI;2622183564;Ne;20;0;2;22
21981;"Gervelė (Stadiono g. 5)";PAUKŠTELIAI;1006720360;Ne;3;2;2;7
21982;"Gervelė (Stadiono g. 5)";PAUKŠTELIAI;8190190100;Ne;0;3;0;3
21983;"Gervelė (Stadiono g. 5)";PAUKŠTELIAI;2712133300;Ne;6;7;2;15
21984;"Gervelė (Stadiono g. 5)";PAUKŠTELIAI;4191553800;Ne;3;0;3;6
21985;"Gervelė (Stadiono g. 5)";SPINDULĖLIAI;5705915729;Ne;0;1;0;1
21986;"Gervelė (Stadiono g. 5)";SPINDULĖLIAI;6241611652;Ne;0;5;0;5
21987;"Gervelė (Stadiono g. 5)";SPINDULĖLIAI;1204513844;Ne;0;2;2;4
21988;"Gervelė (Stadiono g. 5)";SPINDULĖLIAI;8710469480;Ne;0;6;2;8
21989;"Gervelė (Stadiono g. 5)";SPINDULĖLIAI;9777308731;Ne;0;0;2;2
21990;"Gervelė (Stadiono g. 5)";SPINDULĖLIAI;6573919007;Ne;0;7;0;7
21991;"Gervelė (Stadiono g. 5)";SPINDULĖLIAI;3567687304;Ne;0;0;3;3
21992;"Gervelė (Stadiono g. 5)";SPINDULĖLIAI;6372245141;Ne;0;2;1;3
21993;"Gervelė (Stadiono g. 5)";SPINDULĖLIAI;5818430690;Ne;0;2;5;7
21994;"Gervelė (Stadiono g. 5)";SPINDULĖLIAI;1515920896;Ne;0;6;0;6
21995;"Gervelė (Stadiono g. 5)";SPINDULĖLIAI;2031118410;Ne;0;1;0;1
21996;"Gervelė (Stadiono g. 5)";SPINDULĖLIAI;1751440418;Ne;0;2;1;3
21997;"Gervelė (Stadiono g. 5)";SPINDULĖLIAI;9486892110;Ne;0;0;1;1
21998;"Gervelė (Stadiono g. 5)";GĖLYTĖS;6621769160;Ne;8;2;3;13
21999;"Gervelė (Stadiono g. 5)";GĖLYTĖS;7115198351;Ne;7;0;2;9
22000;"Gervelė (Stadiono g. 5)";GĖLYTĖS;4832348492;Ne;10;1;2;13
22001;"Gervelė (Stadiono g. 5)";GĖLYTĖS;1749117711;Ne;0;2;2;4
22002;"Gervelė (Stadiono g. 5)";GĖLYTĖS;7855598075;Ne;6;4;2;12
22003;"Gervelė (Stadiono g. 5)";GĖLYTĖS;6488139414;Ne;0;1;3;4
22004;"Gervelė (Stadiono g. 5)";GĖLYTĖS;3216423543;Ne;8;0;2;10
22005;"Gervelė (Stadiono g. 5)";GĖLYTĖS;4925983616;Ne;0;2;3;5
22006;"Gervelė (Stadiono g. 5)";GĖLYTĖS;8423813651;Ne;0;0;2;2
22007;"Gervelė (Stadiono g. 5)";GĖLYTĖS;7952102572;Ne;14;2;4;20
22008;"Gervelė (Stadiono g. 5)";GĖLYTĖS;5966215998;Ne;10;2;2;14
22009;"Gervelė (Stadiono g. 5)";GĖLYTĖS;7463376031;Ne;0;15;0;15
22010;"Gervelė (Stadiono g. 5)";GĖLYTĖS;2431435960;Ne;9;2;4;15
22011;"Gervelė (Stadiono g. 5)";GĖLYTĖS;9100411947;Ne;8;2;3;13
22012;"Kūlverstukas (Mindaugo g. 7)";GNOMIKI;1720671485;Ne;0;9;0;9
22013;"Kūlverstukas (Mindaugo g. 7)";GNOMIKI;2501327054;Ne;0;1;0;1
22014;"Kūlverstukas (Mindaugo g. 7)";GNOMIKI;8348978878;Ne;4;3;2;9
22015;"Kūlverstukas (Mindaugo g. 7)";GNOMIKI;8927489885;Ne;0;2;1;3
22016;"Kūlverstukas (Mindaugo g. 7)";GNOMIKI;2709547427;Ne;0;2;0;2
22017;"Kūlverstukas (Mindaugo g. 7)";GNOMIKI;5532063862;Ne;0;0;1;1
22018;"Kūlverstukas (Mindaugo g. 7)";GNOMIKI;5747277587;Ne;3;2;2;7
22019;"Kūlverstukas (Mindaugo g. 7)";GNOMIKI;1848018684;Ne;0;1;0;1
22020;"Kūlverstukas (Mindaugo g. 7)";GNOMIKI;1166429762;Ne;8;0;4;12
22021;"Kūlverstukas (Mindaugo g. 7)";GNOMIKI;3239566139;Ne;0;9;0;9
22022;"Kūlverstukas (Mindaugo g. 7)";GNOMIKI;5260820316;Ne;0;3;0;3
22023;"Kūlverstukas (Mindaugo g. 7)";GNOMIKI;3029705994;Ne;0;7;4;11
22024;"Kūlverstukas (Mindaugo g. 7)";GNOMIKI;1869389013;Ne;1;1;2;4
22025;"Kūlverstukas (Mindaugo g. 7)";GNOMIKI;3201081769;Ne;0;0;17;17
22026;"Kūlverstukas (Mindaugo g. 7)";GNOMIKI;2822906102;Ne;3;2;2;7
22027;"Kūlverstukas (Mindaugo g. 7)";GNOMIKI;5879283662;Ne;0;0;1;1
22028;"Kūlverstukas (Mindaugo g. 7)";GNOMIKI;3336317999;Ne;0;0;1;1
22029;"Kūlverstukas (Mindaugo g. 7)";ZAIČIATA;8994705290;Ne;4;10;2;16
22030;"Kūlverstukas (Mindaugo g. 7)";ZAIČIATA;2494202134;Ne;0;7;0;7
22031;"Kūlverstukas (Mindaugo g. 7)";ZAIČIATA;2714297182;Ne;0;2;0;2
22032;"Kūlverstukas (Mindaugo g. 7)";ZAIČIATA;3660002342;Ne;0;0;1;1
22033;"Kūlverstukas (Mindaugo g. 7)";ZAIČIATA;7883325884;Ne;3;2;2;7
22034;"Kūlverstukas (Mindaugo g. 7)";ZAIČIATA;6621027840;Ne;0;0;5;5
22035;"Kūlverstukas (Mindaugo g. 7)";ZAIČIATA;6090797103;Ne;2;0;2;4
22036;"Kūlverstukas (Mindaugo g. 7)";ZAIČIATA;6872789727;Ne;0;1;0;1
22037;"Kūlverstukas (Mindaugo g. 7)";ZAIČIATA;1229210560;Ne;20;0;2;22
22038;"Kūlverstukas (Mindaugo g. 7)";ZAIČIATA;8841423764;Ne;17;0;4;21
22039;"Kūlverstukas (Mindaugo g. 7)";ZAIČIATA;8973143142;Ne;10;5;2;17
22040;"Kūlverstukas (Mindaugo g. 7)";ZAIČIATA;1443431065;Ne;0;0;1;1
22041;"Kūlverstukas (Mindaugo g. 7)";SVETLIAČKI;2154916232;Ne;0;8;0;8
22042;"Kūlverstukas (Mindaugo g. 7)";SVETLIAČKI;5794471794;Ne;0;0;3;3
22043;"Kūlverstukas (Mindaugo g. 7)";SVETLIAČKI;7829384850;Ne;1;0;2;3
22044;"Kūlverstukas (Mindaugo g. 7)";SVETLIAČKI;3449300504;Ne;3;2;2;7
22045;"Kūlverstukas (Mindaugo g. 7)";SVETLIAČKI;4352034102;Ne;0;0;5;5
22046;"Kūlverstukas (Mindaugo g. 7)";SVETLIAČKI;6497373567;Ne;0;0;1;1
22047;"Kūlverstukas (Mindaugo g. 7)";SVETLIAČKI;2434552926;Ne;0;0;3;3
22048;"Kūlverstukas (Mindaugo g. 7)";SVETLIAČKI;2589356040;Ne;8;0;9;17
22049;"Kūlverstukas (Mindaugo g. 7)";SVETLIAČKI;5079635330;Ne;4;0;6;10
22050;"Kūlverstukas (Mindaugo g. 7)";SVETLIAČKI;9021495553;Ne;0;0;14;14
22051;"Kūlverstukas (Mindaugo g. 7)";SVETLIAČKI;6319075079;Ne;0;0;2;2
22052;"Kūlverstukas (Mindaugo g. 7)";ZVONOČKI;1486878343;Ne;0;2;0;2
22053;"Kūlverstukas (Mindaugo g. 7)";ZVONOČKI;8835111916;Ne;0;4;1;5
22054;"Kūlverstukas (Mindaugo g. 7)";ZVONOČKI;5724787637;Ne;0;1;0;1
22055;"Kūlverstukas (Mindaugo g. 7)";ZVONOČKI;9835391223;Ne;3;2;3;8
22056;"Kūlverstukas (Mindaugo g. 7)";ZVONOČKI;1566191212;Ne;0;4;3;7
22057;"Kūlverstukas (Mindaugo g. 7)";ZVONOČKI;9569296370;Ne;3;6;4;13
22058;"Kūlverstukas (Mindaugo g. 7)";ZVONOČKI;1047459617;Ne;0;2;0;2
22059;"Kūlverstukas (Mindaugo g. 7)";ZVONOČKI;2091204077;Ne;0;7;0;7
22060;"Kūlverstukas (Mindaugo g. 7)";ZVONOČKI;4934613845;Ne;0;4;0;4
22061;"Kūlverstukas (Mindaugo g. 7)";ZVONOČKI;6463626516;Ne;1;2;4;7
22062;"Kūlverstukas (Mindaugo g. 7)";ZVONOČKI;8814110710;Ne;0;0;3;3
22063;"Kūlverstukas (Mindaugo g. 7)";ZVONOČKI;4152186586;Ne;0;2;3;5
22064;"Kūlverstukas (Mindaugo g. 7)";ZVONOČKI;6680792848;Ne;4;3;2;9
22065;"Kūlverstukas (Mindaugo g. 7)";ZVONOČKI;5731394231;Ne;0;2;0;2
22066;"Kūlverstukas (Mindaugo g. 7)";ZVONOČKI;1808699695;Ne;3;2;4;9
22067;"Kūlverstukas (Mindaugo g. 7)";ZVONOČKI;1646912457;Ne;0;5;0;5
22068;"Kūlverstukas (Mindaugo g. 7)";ZVONOČKI;4116831802;Ne;3;4;3;10
22069;"Kūlverstukas (Mindaugo g. 7)";ZVONOČKI;6219872984;Ne;0;2;5;7
22070;"Kūlverstukas (Mindaugo g. 7)";ZVONOČKI;9098427210;Ne;0;2;3;5
22071;"Kūlverstukas (Mindaugo g. 7)";ZVONOČKI;1916522637;Ne;0;0;2;2
22072;"Vilniaus Pavilnio pagrindinė mokykla";"PRIEŠMOKYKLINĖ RU";1445328501;Ne;0;3;0;3
22073;"Vilniaus Pavilnio pagrindinė mokykla";"PRIEŠMOKYKLINĖ RU";6537464526;Ne;0;4;0;4
22074;"Vilniaus Pavilnio pagrindinė mokykla";"PRIEŠMOKYKLINĖ RU";1509519996;Ne;0;8;0;8
22075;"Vilniaus Pavilnio pagrindinė mokykla";"PRIEŠMOKYKLINĖ RU";5706671963;Ne;3;2;2;7
22076;"Vilniaus Pavilnio pagrindinė mokykla";"PRIEŠMOKYKLINĖ RU";1035890284;Ne;3;2;4;9
22077;"Vilniaus Pavilnio pagrindinė mokykla";"PRIEŠMOKYKLINĖ RU";4602268315;Ne;3;2;2;7
22078;"Vilniaus Pavilnio pagrindinė mokykla";"PRIEŠMOKYKLINĖ RU";1107633909;Ne;3;6;2;11
22079;"Vilniaus Pavilnio pagrindinė mokykla";"PRIEŠMOKYKLINĖ RU";1344983194;Ne;0;2;4;6
22080;"Vilniaus Pavilnio pagrindinė mokykla";"PRIEŠMOKYKLINĖ RU";8684207189;Ne;0;22;0;22
22081;"Vilniaus Pavilnio pagrindinė mokykla";"PRIEŠMOKYKLINĖ RU";8262619320;Ne;0;4;1;5
22082;"Vilniaus Pavilnio pagrindinė mokykla";"PRIEŠMOKYKLINĖ RU";4516507512;Ne;0;7;0;7
22083;"Vilniaus Pavilnio pagrindinė mokykla";"PRIEŠMOKYKLINĖ PL";4038279267;Ne;0;2;4;6
22084;"Vilniaus Pavilnio pagrindinė mokykla";"PRIEŠMOKYKLINĖ PL";9533901360;Ne;1;2;2;5
22085;"Vilniaus Pavilnio pagrindinė mokykla";"PRIEŠMOKYKLINĖ PL";6716558946;Ne;2;2;2;6
22086;"Vilniaus Pavilnio pagrindinė mokykla";"PRIEŠMOKYKLINĖ PL";5760026802;Ne;1;2;4;7
22087;"Lazdynų mokykla (Liudvinavo g.128)";DRUGELIAI;7524849851;Ne;0;3;0;3
22088;"Lazdynų mokykla (Liudvinavo g.128)";DRUGELIAI;8650496265;Ne;0;2;1;3
22089;"Lazdynų mokykla (Liudvinavo g.128)";DRUGELIAI;9309081745;Taip;0;2;1;3
22090;"Lazdynų mokykla (Liudvinavo g.128)";DRUGELIAI;1951041742;Ne;0;2;0;2
22091;"Lazdynų mokykla (Liudvinavo g.128)";DRUGELIAI;9196184984;Taip;1;4;2;7
22092;"Lazdynų mokykla (Liudvinavo g.128)";DRUGELIAI;2767732459;Ne;0;15;0;15
22093;"Lazdynų mokykla (Liudvinavo g.128)";DRUGELIAI;6394098306;Ne;7;0;4;11
22094;"Lazdynų mokykla (Liudvinavo g.128)";DRUGELIAI;7074859809;Taip;8;2;4;14
22095;"Lazdynų mokykla (Liudvinavo g.128)";DRUGELIAI;4097980299;Ne;1;4;2;7
22096;"Lazdynų mokykla (Liudvinavo g.128)";DRUGELIAI;8001610972;Ne;1;4;2;7
22097;"Lazdynų mokykla (Liudvinavo g.128)";DRUGELIAI;5902104981;Ne;0;4;0;4
22098;"Lazdynų mokykla (Liudvinavo g.128)";DRUGELIAI;7590111138;Ne;4;4;2;10
22099;"Lazdynų mokykla (Liudvinavo g.128)";DRUGELIAI;2027751624;Ne;0;1;0;1
22100;"Lazdynų mokykla (Liudvinavo g.128)";DRUGELIAI;8011040528;Ne;3;4;2;9
22101;"Lazdynų mokykla (Liudvinavo g.128)";DRUGELIAI;5632106043;Ne;13;0;2;15
22102;"Lazdynų mokykla (Liudvinavo g.128)";ZUIKUČIAI;7232402011;Ne;4;4;2;10
22103;"Lazdynų mokykla (Liudvinavo g.128)";ZUIKUČIAI;4166599533;Ne;6;0;0;6
22104;"Lazdynų mokykla (Liudvinavo g.128)";ZUIKUČIAI;3265099747;Ne;2;0;3;5
22105;"Lazdynų mokykla (Liudvinavo g.128)";ZUIKUČIAI;3302443490;Ne;5;2;4;11
22106;"Lazdynų mokykla (Liudvinavo g.128)";ZUIKUČIAI;7000921682;Ne;0;0;2;2
22107;"Lazdynų mokykla (Liudvinavo g.128)";ZUIKUČIAI;3535244441;Ne;6;0;3;9
22108;"Lazdynų mokykla (Liudvinavo g.128)";ZUIKUČIAI;7594978836;Ne;0;2;0;2
22109;"Lazdynų mokykla (Liudvinavo g.128)";ZUIKUČIAI;5465094647;Ne;3;6;2;11
22110;"Lazdynų mokykla (Liudvinavo g.128)";ZUIKUČIAI;1044630813;Ne;9;1;2;12
22111;"Lazdynų mokykla (Liudvinavo g.128)";ZUIKUČIAI;7229926614;Ne;10;0;2;12
22112;"Lazdynų mokykla (Liudvinavo g.128)";ZUIKUČIAI;8899186547;Ne;7;0;5;12
22113;"Lazdynų mokykla (Liudvinavo g.128)";ZUIKUČIAI;5181200460;Ne;4;0;5;9
22114;"Lazdynų mokykla (Liudvinavo g.128)";ZUIKUČIAI;9169301469;Ne;1;0;3;4
22115;"Vilniaus Šilo mokykla";Boružėlės;7122041826;Ne;2;2;0;4
22116;"Vilniaus Šilo mokykla";Boružėlės;9967276147;Ne;0;2;0;2
22117;"Vilniaus Šilo mokykla";Boružėlės;5962551687;Ne;0;2;0;2
22118;"Vilniaus Šilo mokykla";Boružėlės;1196172221;Ne;8;2;0;10
22119;"Vilniaus Šilo mokykla";Boružėlės;1538635985;Ne;5;2;0;7
22120;"Vilniaus Šilo mokykla";Boružėlės;6136087920;Ne;0;22;0;22
22121;"Vilniaus Šilo mokykla";Boružėlės;4544126354;Ne;8;2;0;10
22122;"Vilniaus Šilo mokykla";Boružėlės;8897729962;Ne;5;2;0;7
22123;"Vilniaus Šilo mokykla";"3 spec.";73899364649;Ne;0;2;0;2
22124;"Vilniaus Šilo mokykla";"3 spec.";1417978731;Ne;6;2;0;8
22125;"Vilniaus Šilo mokykla";"3 spec.";28814860843;Ne;0;22;0;22
22126;"Vilniaus Šilo mokykla";"3 spec.";93519259505;Ne;0;22;0;22
22127;"Vilniaus Šilo mokykla";"3 spec.";63472451321;Ne;5;2;0;7
22128;"Vilniaus Šilo mokykla";"3 spec.";3473596157;Ne;6;2;0;8
22129;"Vilniaus Šilo mokykla";"3 spec.";1475766630;Ne;0;22;0;22
22130;"Vilniaus Šilo mokykla";"3 spec.";1401546788;Ne;4;2;0;6
22131;"Vilniaus Šilo mokykla";"7-10 spec.";9944901942;Ne;3;2;0;5
22132;"Vilniaus Šilo mokykla";"7-10 spec.";3333634089;Ne;0;22;0;22
22133;"Vilniaus Šilo mokykla";"7-10 spec.";8548722736;Ne;0;2;0;2
22134;"Vilniaus Šilo mokykla";"7-10 spec.";5255365063;Ne;1;2;0;3
22135;"Vilniaus Šilo mokykla";"7-10 spec.";6452740859;Ne;4;2;0;6
22136;"Vilniaus Šilo mokykla";"7-10 spec.";60608633947;Ne;0;2;0;2
22137;"Vilniaus Šilo mokykla";"7-10 spec.";4906175269;Ne;4;2;0;6
22138;"Vilniaus Šilo mokykla";"7-10 spec.";9264140610;Ne;1;2;0;3
22139;"Vilniaus Šilo mokykla";"7-10 lav.";92425322676;Ne;1;2;0;3
22140;"Vilniaus Šilo mokykla";"7-10 lav.";5905008395;Ne;0;2;0;2
22141;"Vilniaus Šilo mokykla";"7-10 lav.";4738867530;Ne;0;2;0;2
22142;"Vilniaus Šilo mokykla";"7-10 lav.";8490224829;Ne;0;2;0;2
22143;"Vilniaus Šilo mokykla";"7-10 lav.";81654551230;Ne;15;2;0;17
22144;"Vilniaus Šilo mokykla";"7-10 lav.";7740504510;Ne;3;2;0;5
22145;"Vilniaus Šilo mokykla";"7-10 lav.";5388697695;Ne;0;2;0;2
22146;"Vilniaus Šilo mokykla";"7-10 lav.";20604410476;Ne;0;2;0;2
22147;"Vilniaus Šilo mokykla";"7-10 lav.";6868265902;Ne;0;22;0;22
22148;"Vilniaus Šilo mokykla";"7-10 lav.";2234931428;Ne;0;22;0;22
22149;"Vilniaus Šilo mokykla";"SĮ A";6954467869;Ne;0;22;0;22
22150;"Vilniaus Šilo mokykla";"SĮ A";9354191217;Ne;3;2;0;5
22151;"Vilniaus Šilo mokykla";"SĮ A";9471629029;Ne;2;2;0;4
22152;"Vilniaus Šilo mokykla";"SĮ A";6088433049;Ne;2;2;0;4
22153;"Vilniaus Šilo mokykla";"SĮ A";1819519275;Ne;0;2;0;2
22154;"Vilniaus Šilo mokykla";"SĮ A";9845575989;Ne;0;2;0;2
22155;"Vilniaus Šilo mokykla";"SĮ A";3308772529;Ne;0;2;0;2
22156;"Vilniaus Šilo mokykla";"SĮ A";1726056983;Ne;6;2;0;8
22157;"Vilniaus Šilo mokykla";"SĮ A";3442250711;Ne;10;2;0;12
22158;"Vilniaus Šilo mokykla";"SĮ A";2755910347;Ne;0;2;0;2
22159;"Vilniaus Šilo mokykla";"SĮ C";1322335360;Ne;0;2;0;2
22160;"Vilniaus Šilo mokykla";"SĮ C";8642665550;Ne;7;2;0;9
22161;"Vilniaus Šilo mokykla";"SĮ C";5309862220;Ne;0;22;0;22
22162;"Vilniaus Šilo mokykla";"SĮ C";1010885560;Ne;0;2;0;2
22163;"Vilniaus Šilo mokykla";"SĮ C";2501187241;Ne;6;2;0;8
22164;"Vilniaus Šilo mokykla";"SĮ C";2681438925;Ne;0;2;0;2
22165;"Vilniaus Šilo mokykla";"8 spec.";948748525;Ne;3;2;0;5
22166;"Vilniaus Šilo mokykla";"8 spec.";1422218905;Ne;0;22;0;22
22167;"Vilniaus Šilo mokykla";"8 spec.";1177826873;Ne;0;2;0;2
22168;"Vilniaus Šilo mokykla";"8 spec.";3776046409;Ne;3;2;0;5
22169;"Vilniaus Šilo mokykla";"8 spec.";9784624648;Ne;6;2;0;8
22170;"Vilniaus Šilo mokykla";"8 spec.";3621978449;Ne;1;2;0;3
22171;"Vilniaus Šilo mokykla";"8 spec.";5186364504;Ne;0;22;0;22
22172;"Vilniaus Šilo mokykla";"8 spec.";9277299634;Ne;0;2;0;2
22173;"Vilniaus Šilo mokykla";"8 spec.";2672192094;Ne;5;2;0;7
22174;"Vilniaus Šilo mokykla";"8 spec.";2672192094;Ne;5;2;0;7
22175;"Vilniaus Šilo mokykla";"8-10 lav.";2020417997;Ne;11;2;0;13
22176;"Vilniaus Šilo mokykla";"8-10 lav.";1298624014;Ne;5;2;0;7
22177;"Vilniaus Šilo mokykla";"8-10 lav.";8926954085;Ne;0;2;0;2
22178;"Vilniaus Šilo mokykla";"8-10 lav.";1742331213;Ne;0;2;0;2
22179;"Vilniaus Šilo mokykla";"8-10 lav.";7040253931;Ne;0;2;0;2
22180;"Vilniaus Šilo mokykla";"8-10 lav.";8276932013;Ne;2;2;0;4
22181;"Vilniaus Šilo mokykla";"7 lav.";3612746646;Ne;3;2;0;5
22182;"Vilniaus Šilo mokykla";"7 lav.";9054390753;Ne;0;2;0;2
22183;"Vilniaus Šilo mokykla";"7 lav.";29353956408;Ne;2;2;0;4
22184;"Vilniaus Šilo mokykla";"7 lav.";83007167743;Ne;0;2;0;2
22185;"Vilniaus Šilo mokykla";"7 lav.";2862598950;Ne;1;2;0;3
22186;"Vilniaus Šilo mokykla";"7 lav.";67989956617;Ne;0;22;0;22
22187;"Vilniaus Šilo mokykla";"7 lav.";49892720109;Ne;0;2;0;2
22188;"Vilniaus Šilo mokykla";"7 lav.";7418552136;Ne;1;2;0;3
22189;"Vilniaus Šilo mokykla";"7-8 lav.";4081645294;Ne;0;2;0;2
22190;"Vilniaus Šilo mokykla";"7-8 lav.";1705610089;Ne;0;22;0;22
22191;"Vilniaus Šilo mokykla";"7-8 lav.";62142659591;Ne;0;2;0;2
22192;"Vilniaus Šilo mokykla";"7-8 lav.";8566222716;Ne;6;2;0;8
22193;"Vilniaus Šilo mokykla";"7-8 lav.";7056277395;Ne;0;22;0;22
22194;"Vilniaus Šilo mokykla";"7-8 lav.";74897451962;Ne;0;2;0;2
22195;"Vilniaus Šilo mokykla";"7-8 lav.";6700004229;Ne;3;2;0;5
22196;"Vilniaus Šilo mokykla";"7-8 lav.";50288610995;Ne;8;2;0;10
22197;"Vilniaus Šilo mokykla";"7-8 lav.";4416954354;Ne;10;2;0;12
22198;"Vilniaus Šilo mokykla";"6-9 spec.";4887033681;Ne;3;2;0;5
22199;"Vilniaus Šilo mokykla";"6-9 spec.";61123788986;Ne;0;22;0;22
22200;"Vilniaus Šilo mokykla";"6-9 spec.";2631958308;Ne;0;2;0;2
22201;"Vilniaus Šilo mokykla";"6-9 spec.";73335629450;Ne;3;2;0;5
22202;"Vilniaus Šilo mokykla";"6-9 spec.";6695507703;Ne;1;2;0;3
22203;"Vilniaus Šilo mokykla";"6-9 spec.";94126055953;Ne;3;2;0;5
22204;"Vilniaus Šilo mokykla";"6-9 spec.";6930420609;Ne;0;2;0;2
22205;"Vilniaus Šilo mokykla";"5-10 lav.";6356218442;Ne;1;2;0;3
22206;"Vilniaus Šilo mokykla";"5-10 lav.";88721781220;Ne;2;2;0;4
22207;"Vilniaus Šilo mokykla";"5-10 lav.";4990112920;Ne;1;2;0;3
22208;"Vilniaus Šilo mokykla";"5-10 lav.";9057435844;Ne;0;2;0;2
22209;"Vilniaus Šilo mokykla";"5-10 lav.";7354905114;Ne;0;2;0;2
22210;"Vilniaus Šilo mokykla";"5-10 lav.";4890362155;Ne;0;2;0;2
22211;"Vilniaus Šilo mokykla";"5-10 lav.";2000234311;Ne;0;2;0;2
22212;"Vilniaus Šilo mokykla";"5-10 lav.";63508565206;Ne;7;2;0;9
22213;"Vilniaus Šilo mokykla";"5-6 spec. RU";3419495275;Ne;4;2;0;6
22214;"Vilniaus Šilo mokykla";"5-6 spec. RU";9789373884;Ne;0;22;0;22
22215;"Vilniaus Šilo mokykla";"5-6 spec. RU";1989565075;Ne;0;22;0;22
22216;"Vilniaus Šilo mokykla";"5-6 spec. RU";11529512484;Ne;5;2;0;7
22217;"Vilniaus Šilo mokykla";"5-6 spec. RU";13277011762;Ne;0;2;0;2
22218;"Vilniaus Šilo mokykla";"5-6 spec. RU";34463714051;Ne;5;2;0;7
22219;"Vilniaus Šilo mokykla";"5-6 lav.";7329254454;Ne;0;22;0;22
22220;"Vilniaus Šilo mokykla";"5-6 lav.";1535004699;Ne;15;2;0;17
22221;"Vilniaus Šilo mokykla";"5-6 lav.";3194974747;Ne;0;2;0;2
22222;"Vilniaus Šilo mokykla";"5-6 lav.";26052502707;Ne;2;2;0;4
22223;"Vilniaus Šilo mokykla";"5-6 lav.";74782962545;Ne;0;22;0;22
22224;"Vilniaus Šilo mokykla";"5-6 lav.";72751441075;Ne;10;2;0;12
22225;"Vilniaus Šilo mokykla";"5-6 lav.";87692349348;Ne;0;22;0;22
22226;"Vilniaus Šilo mokykla";"3-4 spec. LT";5835827997;Ne;0;22;0;22
22227;"Vilniaus Šilo mokykla";"3-4 spec. LT";17920063762;Ne;2;2;0;4
22228;"Vilniaus Šilo mokykla";"3-4 spec. LT";7418149721;Ne;20;2;0;22
22229;"Vilniaus Šilo mokykla";"3-4 spec. LT";7418149721;Ne;20;2;0;22
22230;"Vilniaus Šilo mokykla";"3-4 spec. LT";19739614989;Ne;6;2;0;8
22231;"Vilniaus Šilo mokykla";"3-4 spec. LT";3366848846;Ne;2;2;0;4
22232;"Vilniaus Šilo mokykla";"3-4 spec. LT";78634860827;Ne;0;2;0;2
22233;"Vilniaus Šilo mokykla";"3-4 spec. LT";67103811533;Ne;9;2;0;11
22234;"Vilniaus Šilo mokykla";"3-4 spec. LT";30738331224;Ne;2;2;0;4
22235;"Vilniaus Šilo mokykla";"1 spec. B";3237698420;Ne;4;2;0;6
22236;"Vilniaus Šilo mokykla";"1 spec. B";1657452686;Ne;0;2;0;2
22237;"Vilniaus Šilo mokykla";"1 spec. B";3055294324;Ne;0;2;0;2
22238;"Vilniaus Šilo mokykla";"1 spec. B";9072764004;Ne;20;2;0;22
22239;"Vilniaus Šilo mokykla";"1 spec. B";1739403100;Ne;0;22;0;22
22240;"Vilniaus Šilo mokykla";"1 spec. B";8500010303;Ne;0;22;0;22
22241;"Vilniaus Šilo mokykla";"1 spec. B";60265156684;Ne;2;2;0;4
22242;"Vilniaus Šilo mokykla";"2-4 spec. RU";4908579339;Ne;6;2;0;8
22243;"Vilniaus Šilo mokykla";"2-4 spec. RU";2401287472;Ne;12;2;0;14
22244;"Vilniaus Šilo mokykla";"2-4 spec. RU";8817950372;Ne;2;2;0;4
22245;"Vilniaus Šilo mokykla";"2-4 spec. RU";8817950372;Ne;2;2;0;4
22246;"Vilniaus Šilo mokykla";"2-4 spec. RU";70678189213;Ne;0;2;0;2
22247;"Vilniaus Šilo mokykla";"2-4 spec. RU";4078721064;Ne;6;2;0;8
22248;"Vilniaus Šilo mokykla";"2-4 spec. RU";4574965127;Ne;0;2;0;2
22249;"Vilniaus Šilo mokykla";"2-4 spec. RU";6813357731;Ne;2;2;0;4
22250;"Vilniaus Šilo mokykla";"2 spec.";1153167430;Ne;11;2;0;13
22251;"Vilniaus Šilo mokykla";"2 spec.";4438939800;Ne;2;2;0;4
22252;"Vilniaus Šilo mokykla";"2 spec.";1971717759;Ne;5;2;0;7
22253;"Vilniaus Šilo mokykla";"2 spec.";2290889395;Ne;3;2;0;5
22254;"Vilniaus Šilo mokykla";"2 spec.";1180183091;Ne;0;22;0;22
22255;"Vilniaus Šilo mokykla";"2 spec.";8863021708;Ne;1;2;0;3
22256;"Vilniaus Šilo mokykla";"3-4 lav. ";3127870635;Ne;2;0;0;2
22257;"Vilniaus Šilo mokykla";"3-4 lav. ";1999375828;Ne;0;22;0;22
22258;"Vilniaus Šilo mokykla";"3-4 lav. ";2954393415;Ne;2;0;0;2
22259;"Vilniaus Šilo mokykla";"1 spec. A";5311183877;Ne;8;2;0;10
22260;"Vilniaus Šilo mokykla";"1 spec. A";1675384533;Ne;1;2;0;3
22261;"Vilniaus Šilo mokykla";"1 spec. A";2070454339;Ne;0;22;0;22
22262;"Vilniaus Šilo mokykla";"1 spec. A";8915901727;Ne;11;2;0;13
22263;"Vilniaus Šilo mokykla";"1 spec. A";7966574791;Ne;4;2;0;6
22264;"Vilniaus Šilo mokykla";"1 spec. A";2048595572;Ne;1;2;0;3
22265;"Vilniaus Šilo mokykla";"1 spec. A";30383556768;Ne;0;22;0;22
22266;"Vilniaus Šilo mokykla";"5-6 spec. ";90363704660;Ne;5;2;0;7
22267;"Vilniaus Šilo mokykla";"5-6 spec. ";3120638166;Ne;0;2;0;2
22268;"Vilniaus Šilo mokykla";"5-6 spec. ";1079077463;Ne;2;2;0;4
22269;"Vilniaus Šilo mokykla";"5-6 spec. ";2321953405;Ne;1;2;0;3
22270;"Vilniaus Šilo mokykla";"5-6 spec. ";2093680385;Ne;0;2;0;2
22271;"Vilniaus Šilo mokykla";"5-6 spec. ";3352991548;Ne;0;2;0;2
22272;"Vilniaus Šilo mokykla";"5-6 spec. ";1340301492;Ne;3;2;0;5
22273;"Vilniaus Šilo mokykla";"5-6 spec. ";987829287;Ne;17;2;0;19
22274;"Vilniaus Šilo mokykla";"5-6 spec. ";99943424821;Ne;0;2;0;2
22275;Malūnėlis;BITUTĖS;1001575740;Ne;0;2;0;2
22276;Malūnėlis;BITUTĖS;8618778205;Ne;0;5;0;5
22277;Malūnėlis;BITUTĖS;2545930114;Ne;8;4;2;14
22278;Malūnėlis;BITUTĖS;3329510128;Ne;10;3;2;15
22279;Malūnėlis;BITUTĖS;5402027714;Ne;0;2;0;2
22280;Malūnėlis;BITUTĖS;6199265600;Ne;0;4;0;4
22281;Malūnėlis;BITUTĖS;7144098762;Ne;3;4;2;9
22282;Malūnėlis;BITUTĖS;1146723570;Ne;2;1;2;5
22283;Malūnėlis;BITUTĖS;9891418762;Ne;8;8;2;18
22284;Malūnėlis;BITUTĖS;8642960989;Ne;3;4;2;9
22285;Malūnėlis;BITUTĖS;5959610426;Taip;8;2;4;14
22286;Malūnėlis;BITUTĖS;4367009696;Ne;2;13;2;17
22287;Malūnėlis;BITUTĖS;9936144392;Ne;0;4;0;4
22288;Malūnėlis;BITUTĖS;8440160819;Ne;3;0;2;5
22289;Malūnėlis;BITUTĖS;1528972517;Ne;0;15;0;15
22290;Malūnėlis;BITUTĖS;4202723476;Ne;2;0;2;4
22291;Malūnėlis;BITUTĖS;8007350745;Ne;3;0;2;5
22292;Malūnėlis;BITUTĖS;3402561453;Ne;0;5;0;5
22293;Malūnėlis;BITUTĖS;6805587761;Ne;5;4;4;13
22294;Malūnėlis;BITUTĖS;2495112045;Ne;13;0;2;15
22295;Malūnėlis;BITUTĖS;4802771311;Ne;0;1;0;1
22296;Malūnėlis;BITUTĖS;3935474148;Ne;1;2;2;5
22297;Malūnėlis;BITUTĖS;8528076375;Ne;0;12;0;12
22298;Malūnėlis;VOVERIUKAI;3293082023;Ne;0;2;0;2
22299;Malūnėlis;VOVERIUKAI;3779723692;Ne;0;2;0;2
22300;Malūnėlis;VOVERIUKAI;2029506037;Ne;6;0;2;8
22301;Malūnėlis;VOVERIUKAI;2246526281;Ne;0;0;2;2
22302;Malūnėlis;VOVERIUKAI;2192305527;Ne;5;5;4;14
22303;Malūnėlis;VOVERIUKAI;1770049356;Ne;0;2;0;2
22304;Malūnėlis;VOVERIUKAI;6081634102;Ne;3;10;2;15
22305;Malūnėlis;VOVERIUKAI;5540120728;Ne;3;11;2;16
22306;Malūnėlis;VOVERIUKAI;7556990784;Ne;4;2;2;8
22307;Malūnėlis;VOVERIUKAI;2525923211;Ne;0;4;0;4
22308;Malūnėlis;VOVERIUKAI;9304119075;Ne;2;0;0;2
22309;Malūnėlis;VOVERIUKAI;1574941416;Ne;6;0;2;8
22310;Malūnėlis;VOVERIUKAI;6531364407;Ne;3;6;2;11
22311;Malūnėlis;VOVERIUKAI;5727725132;Ne;0;2;0;2
22312;Malūnėlis;VOVERIUKAI;2637299307;Ne;7;13;0;20
22313;Malūnėlis;VOVERIUKAI;8277245773;Ne;0;10;0;10
22314;Malūnėlis;VOVERIUKAI;5686301875;Ne;3;2;2;7
22315;Malūnėlis;VOVERIUKAI;6928976717;Ne;2;1;0;3
22316;Malūnėlis;BORUŽĖLĖS;8551271848;Ne;0;3;2;5
22317;Malūnėlis;BORUŽĖLĖS;4787212056;Ne;5;1;4;10
22318;Malūnėlis;BORUŽĖLĖS;9185138453;Ne;0;13;0;13
22319;Malūnėlis;BORUŽĖLĖS;7350160970;Ne;0;9;0;9
22320;Malūnėlis;BORUŽĖLĖS;5722497620;Ne;8;5;2;15
22321;Malūnėlis;BORUŽĖLĖS;3364355098;Ne;9;2;2;13
22322;Malūnėlis;BORUŽĖLĖS;1523505295;Ne;4;4;2;10
22323;Malūnėlis;BORUŽĖLĖS;7756102926;Ne;4;3;2;9
22324;Malūnėlis;BORUŽĖLĖS;4164843364;Ne;0;3;0;3
22325;Malūnėlis;BORUŽĖLĖS;3504339452;Ne;1;7;2;10
22326;Malūnėlis;BORUŽĖLĖS;5197527972;Ne;3;2;2;7
22327;Malūnėlis;BORUŽĖLĖS;4288943715;Ne;7;2;4;13
22328;Malūnėlis;Skruzdėliukų;9798968369;Ne;2;1;2;5
22329;Malūnėlis;Skruzdėliukų;4859886340;Ne;7;2;4;13
22330;Malūnėlis;Skruzdėliukų;1213476648;Ne;4;2;2;8
22331;Malūnėlis;Skruzdėliukų;9300944734;Ne;9;4;2;15
22332;Malūnėlis;Skruzdėliukų;5877882690;Ne;7;2;4;13
22333;Malūnėlis;Skruzdėliukų;5474437579;Ne;0;3;1;4
22334;Malūnėlis;Skruzdėliukų;1549241453;Ne;3;2;6;11
22335;Malūnėlis;Skruzdėliukų;5478561852;Ne;3;1;2;6
22336;Malūnėlis;Skruzdėliukų;9207327884;Ne;0;22;0;22
22337;Malūnėlis;Skruzdėliukų;6609446450;Ne;0;1;0;1
22338;Malūnėlis;Skruzdėliukų;5687585794;Ne;6;2;2;10
22339;Malūnėlis;Skruzdėliukų;8076487157;Ne;1;0;6;7
22340;Malūnėlis;Skruzdėliukų;8751365673;Ne;0;2;2;4
22341;Malūnėlis;Skruzdėliukų;6575258889;Taip;1;0;2;3
22342;Malūnėlis;Skruzdėliukų;1003043129;Ne;3;0;2;5
22343;Malūnėlis;Skruzdėliukų;9894452403;Ne;0;8;0;8
22344;Malūnėlis;Skruzdėliukų;9342720464;Ne;4;5;2;11
22345;Malūnėlis;Skruzdėliukų;5232728972;Ne;2;0;4;6
22346;Malūnėlis;Skruzdėliukų;2574604828;Ne;0;9;0;9
22347;Malūnėlis;Žirniukų;3791873303;Ne;0;7;0;7
22348;Malūnėlis;Žirniukų;3031849277;Ne;5;0;2;7
22349;Malūnėlis;Žirniukų;6747286787;Ne;2;0;2;4
22350;Malūnėlis;Žirniukų;4539998453;Ne;0;2;0;2
22351;Malūnėlis;Žirniukų;6943968536;Ne;3;2;2;7
22352;Malūnėlis;Žirniukų;4841028952;Ne;2;4;2;8
22353;Malūnėlis;Žirniukų;7097858329;Ne;4;2;2;8
22354;Malūnėlis;Žirniukų;5893575540;Ne;5;4;3;12
22355;Malūnėlis;Žirniukų;1398391534;Ne;0;0;3;3
22356;Malūnėlis;Žirniukų;2961972215;Ne;8;9;2;19
22357;Malūnėlis;Žirniukų;5622982984;Ne;0;1;0;1
22358;Malūnėlis;Žirniukų;3315571256;Ne;0;4;0;4
22359;Malūnėlis;Žirniukų;3315571256;Ne;0;4;0;4
22360;Malūnėlis;Žirniukų;3315571256;Ne;0;4;0;4
22361;Malūnėlis;Žirniukų;9941335615;Ne;3;0;2;5
22362;Malūnėlis;Žirniukų;3464224841;Ne;5;3;2;10
22363;Malūnėlis;Žirniukų;6047042736;Ne;6;3;4;13
22364;Malūnėlis;Žirniukų;4875859413;Ne;10;0;4;14
22365;Malūnėlis;Žirniukų;9559372808;Ne;0;5;0;5
22366;Malūnėlis;Žirniukų;7740957549;Ne;0;2;1;3
22367;"Dainorėliai (Goštauto g. 4)";PUMPURĖLIAI;6132543858;Ne;0;17;0;17
22368;"Dainorėliai (Goštauto g. 4)";PUMPURĖLIAI;4560328911;Ne;13;4;0;17
22369;"Dainorėliai (Goštauto g. 4)";PUMPURĖLIAI;4435310580;Ne;2;2;0;4
22370;"Dainorėliai (Goštauto g. 4)";PUMPURĖLIAI;7197089520;Ne;5;6;4;15
22371;"Dainorėliai (Goštauto g. 4)";PUMPURĖLIAI;5534783929;Ne;6;7;0;13
22372;"Dainorėliai (Goštauto g. 4)";PUMPURĖLIAI;4826994208;Ne;5;2;0;7
22373;"Dainorėliai (Goštauto g. 4)";PUMPURĖLIAI;4848146301;Ne;2;0;0;2
22374;"Dainorėliai (Goštauto g. 4)";PUMPURĖLIAI;1796037404;Ne;2;2;0;4
22375;"Dainorėliai (Goštauto g. 4)";PUMPURĖLIAI;1030872812;Ne;2;6;0;8
22376;"Dainorėliai (Goštauto g. 4)";PUMPURĖLIAI;7986631005;Ne;9;4;5;18
22377;"Dainorėliai (Goštauto g. 4)";PUMPURĖLIAI;8664502412;Ne;4;0;0;4
22378;"Dainorėliai (Goštauto g. 4)";PUMPURĖLIAI;7802165127;Ne;2;4;0;6
22379;"Dainorėliai (Goštauto g. 4)";PUMPURĖLIAI;7961803424;Ne;13;0;0;13
22380;"Dainorėliai (Goštauto g. 4)";PUMPURĖLIAI;6203352124;Ne;6;4;0;10
22381;"Dainorėliai (Goštauto g. 4)";PUMPURĖLIAI;6254125398;Ne;2;11;0;13
22382;"Dainorėliai (Goštauto g. 4)";PUMPURĖLIAI;8097565000;Ne;10;2;0;12
22383;"Dainorėliai (Goštauto g. 4)";DEBESĖLIŲ;6513417505;Ne;13;0;0;13
22384;"Dainorėliai (Goštauto g. 4)";DEBESĖLIŲ;1873415679;Ne;0;15;0;15
22385;"Dainorėliai (Goštauto g. 4)";DEBESĖLIŲ;4286864865;Ne;3;0;0;3
22386;"Dainorėliai (Goštauto g. 4)";DEBESĖLIŲ;1554081754;Ne;6;2;0;8
22387;"Dainorėliai (Goštauto g. 4)";DEBESĖLIŲ;4033317616;Ne;7;1;0;8
22388;"Dainorėliai (Goštauto g. 4)";DEBESĖLIŲ;9285865812;Ne;3;0;0;3
22389;"Dainorėliai (Goštauto g. 4)";DEBESĖLIŲ;6284140548;Ne;2;8;0;10
22390;"Dainorėliai (Goštauto g. 4)";DEBESĖLIŲ;8015545426;Ne;0;13;0;13
22391;"Dainorėliai (Goštauto g. 4)";DEBESĖLIŲ;6362265057;Ne;3;0;0;3
22392;"Dainorėliai (Goštauto g. 4)";DEBESĖLIŲ;3561729784;Ne;4;0;2;6
22393;"Dainorėliai (Goštauto g. 4)";DEBESĖLIŲ;3705286231;Ne;10;0;0;10
22394;"Dainorėliai (Goštauto g. 4)";DEBESĖLIŲ;4302308605;Ne;3;0;0;3
22395;"Dainorėliai (Goštauto g. 4)";DEBESĖLIŲ;5714565603;Ne;3;0;0;3
22396;"Dainorėliai (Goštauto g. 4)";DEBESĖLIŲ;1233029451;Ne;0;29;0;29
22397;"Dainorėliai (Goštauto g. 4)";DEBESĖLIŲ;6449332338;Ne;6;2;0;8
22398;"Dainorėliai (Goštauto g. 4)";DEBESĖLIŲ;7304053939;Ne;3;0;0;3
22399;"Dainorėliai (Goštauto g. 4)";DEBESĖLIŲ;7611710213;Ne;4;0;0;4
22400;"Krivūlė (Vokiečių g. 1)";PABIRUČIAI;9011102232;Ne;0;0;9;9
22401;"Krivūlė (Vokiečių g. 1)";PABIRUČIAI;1944288576;Ne;1;0;2;3
22402;"Krivūlė (Vokiečių g. 1)";PABIRUČIAI;3696403149;Ne;13;3;1;17
22403;"Krivūlė (Vokiečių g. 1)";PABIRUČIAI;5721252419;Ne;3;5;4;12
22404;"Krivūlė (Vokiečių g. 1)";PABIRUČIAI;4600688626;Ne;0;0;8;8
22405;"Krivūlė (Vokiečių g. 1)";PABIRUČIAI;4884789671;Ne;0;0;6;6
22406;"Krivūlė (Vokiečių g. 1)";PABIRUČIAI;8678565710;Ne;5;0;5;10
22407;"Krivūlė (Vokiečių g. 1)";PABIRUČIAI;3976974038;Ne;1;2;2;5
22408;"Krivūlė (Vokiečių g. 1)";PABIRUČIAI;2259139771;Ne;16;0;4;20
22409;"Krivūlė (Vokiečių g. 1)";PABIRUČIAI;3138555448;Ne;0;22;0;22
22410;"Krivūlė (Vokiečių g. 1)";PABIRUČIAI;2784118970;Ne;0;0;5;5
22411;"Krivūlė (Vokiečių g. 1)";PABIRUČIAI;3227555647;Ne;6;0;7;13
22412;"Krivūlė (Vokiečių g. 1)";PABIRUČIAI;4261770381;Ne;5;0;1;6
22413;"Krivūlė (Vokiečių g. 1)";PABIRUČIAI;7556723960;Ne;6;0;2;8
22414;"Krivūlė (Vokiečių g. 1)";PABIRUČIAI;6422534805;Ne;6;1;4;11
22415;"Krivūlė (Vokiečių g. 1)";PABIRUČIAI;3209201717;Ne;4;0;5;9
22416;"Krivūlė (Vokiečių g. 1)";SMALSUČIAI;5304221329;Ne;0;2;0;2
22417;"Krivūlė (Vokiečių g. 1)";SMALSUČIAI;7508079584;Ne;0;0;2;2
22418;"Krivūlė (Vokiečių g. 1)";SMALSUČIAI;4814488445;Ne;0;2;0;2
22419;"Krivūlė (Vokiečių g. 1)";SMALSUČIAI;7997564406;Ne;0;5;0;5
22420;"Krivūlė (Vokiečių g. 1)";SMALSUČIAI;8710938907;Ne;5;1;5;11
22421;"Krivūlė (Vokiečių g. 1)";SMALSUČIAI;4491462086;Taip;5;0;9;14
22422;"Krivūlė (Vokiečių g. 1)";SMALSUČIAI;4773564048;Ne;0;2;2;4
22423;"Krivūlė (Vokiečių g. 1)";SMALSUČIAI;3324090723;Ne;6;0;5;11
22424;"Krivūlė (Vokiečių g. 1)";SMALSUČIAI;4094383258;Ne;0;0;2;2
22425;"Krivūlė (Vokiečių g. 1)";SMALSUČIAI;8042469720;Ne;0;6;0;6
22426;"Krivūlė (Vokiečių g. 1)";SMALSUČIAI;4845066055;Ne;5;2;9;16
22427;"Krivūlė (Vokiečių g. 1)";SMALSUČIAI;7528273082;Ne;0;2;0;2
22428;"Krivūlė (Vokiečių g. 1)";SMALSUČIAI;6521798502;Ne;0;0;2;2
22429;"Krivūlė (Vokiečių g. 1)";SMALSUČIAI;5790418638;Ne;3;0;7;10
22430;"Krivūlė (Vokiečių g. 1)";SMALSUČIAI;1851097789;Ne;3;0;3;6
22431;"Krivūlė (Vokiečių g. 1)";SMALSUČIAI;9625239512;Ne;3;0;6;9
22432;"Krivūlė (Vokiečių g. 1)";GUDRUČIAI;8520470321;Ne;0;0;6;6
22433;"Krivūlė (Vokiečių g. 1)";GUDRUČIAI;5753204752;Ne;0;0;10;10
22434;"Krivūlė (Vokiečių g. 1)";GUDRUČIAI;2536472220;Ne;0;2;3;5
22435;"Krivūlė (Vokiečių g. 1)";GUDRUČIAI;7727246187;Ne;0;3;0;3
22436;"Krivūlė (Vokiečių g. 1)";GUDRUČIAI;6072261879;Ne;6;0;6;12
22437;"Krivūlė (Vokiečių g. 1)";GUDRUČIAI;7904390075;Ne;0;0;1;1
22438;"Krivūlė (Vokiečių g. 1)";GUDRUČIAI;6931566125;Ne;1;2;2;5
22439;"Krivūlė (Vokiečių g. 1)";GUDRUČIAI;5149419581;Ne;3;0;6;9
22440;"Krivūlė (Vokiečių g. 1)";GUDRUČIAI;7789605738;Ne;3;2;4;9
22441;"Krivūlė (Vokiečių g. 1)";GUDRUČIAI;9693693101;Ne;2;0;3;5
22442;"Krivūlė (Vokiečių g. 1)";GUDRUČIAI;5462491857;Ne;0;9;4;13
22443;"Krivūlė (Vokiečių g. 1)";GUDRUČIAI;8871794542;Ne;6;1;4;11
22444;"Krivūlė (Vokiečių g. 1)";GUDRUČIAI;3076382863;Ne;0;0;1;1
22445;"Krivūlė (Vokiečių g. 1)";GUDRUČIAI;5199600243;Ne;0;0;7;7
22446;"Pumpurėlis (Trinapolio g. 11)";GUDRUČIAI;9353403057;Ne;3;0;4;7
22447;"Pumpurėlis (Trinapolio g. 11)";GUDRUČIAI;9353403057;Ne;3;0;4;7
22448;"Pumpurėlis (Trinapolio g. 11)";GUDRUČIAI;3387386473;Ne;0;10;0;10
22449;"Pumpurėlis (Trinapolio g. 11)";GUDRUČIAI;7177681927;Ne;11;0;2;13
22450;"Pumpurėlis (Trinapolio g. 11)";GUDRUČIAI;2130008026;Ne;2;0;2;4
22451;"Pumpurėlis (Trinapolio g. 11)";GUDRUČIAI;8475215020;Ne;8;0;4;12
22452;"Pumpurėlis (Trinapolio g. 11)";GUDRUČIAI;3333547914;Taip;12;2;4;18
22453;"Pumpurėlis (Trinapolio g. 11)";GUDRUČIAI;9550967420;Ne;0;15;7;22
22454;"Pumpurėlis (Trinapolio g. 11)";GUDRUČIAI;1750311606;Ne;0;0;2;2
22455;"Pumpurėlis (Trinapolio g. 11)";GUDRUČIAI;8134060801;Ne;0;22;0;22
22456;"Pumpurėlis (Trinapolio g. 11)";GUDRUČIAI;1682281017;Taip;4;0;2;6
22457;"Pumpurėlis (Trinapolio g. 11)";GUDRUČIAI;9154835447;Ne;4;0;4;8
22458;"Pumpurėlis (Trinapolio g. 11)";GUDRUČIAI;2071687578;Ne;5;0;2;7
22459;"Pumpurėlis (Trinapolio g. 11)";GUDRUČIAI;8090926450;Ne;11;2;2;15
22460;"Pumpurėlis (Trinapolio g. 11)";GUDRUČIAI;6459621192;Ne;8;0;4;12
22461;"Pumpurėlis (Trinapolio g. 11)";GUDRUČIAI;6766514486;Ne;3;0;3;6
22462;"Pumpurėlis (Trinapolio g. 11)";PABIRUČIAI;9824315755;Ne;4;0;4;8
22463;"Pumpurėlis (Trinapolio g. 11)";PABIRUČIAI;4565317498;Ne;8;5;2;15
22464;"Pumpurėlis (Trinapolio g. 11)";PABIRUČIAI;7910361194;Ne;12;0;4;16
22465;"Pumpurėlis (Trinapolio g. 11)";PABIRUČIAI;5249717804;Ne;3;0;3;6
22466;"Pumpurėlis (Trinapolio g. 11)";PABIRUČIAI;5403012236;Ne;9;0;4;13
22467;"Pumpurėlis (Trinapolio g. 11)";PABIRUČIAI;8704865319;Ne;7;6;2;15
22468;"Pumpurėlis (Trinapolio g. 11)";PABIRUČIAI;8207951541;Ne;8;2;2;12
22469;"Pumpurėlis (Trinapolio g. 11)";PABIRUČIAI;4696006714;Taip;0;14;0;14
22470;"Pumpurėlis (Trinapolio g. 11)";PABIRUČIAI;2187090934;Ne;0;0;1;1
22471;"Pumpurėlis (Trinapolio g. 11)";PABIRUČIAI;1222204689;Ne;2;0;6;8
22472;"Pumpurėlis (Trinapolio g. 11)";PABIRUČIAI;6920353753;Ne;9;2;4;15
22473;"Pumpurėlis (Trinapolio g. 11)";PABIRUČIAI;6920353753;Ne;9;2;4;15
22474;"Pumpurėlis (Trinapolio g. 11)";PABIRUČIAI;3841134563;Ne;5;0;2;7
22475;"Pumpurėlis (Trinapolio g. 11)";PABIRUČIAI;3841134563;Ne;5;0;2;7
22476;"Pumpurėlis (Trinapolio g. 11)";PABIRUČIAI;3841134563;Ne;5;0;2;7
22477;"Pumpurėlis (Trinapolio g. 11)";PABIRUČIAI;6732130591;Ne;1;0;4;5
22478;"Pumpurėlis (Trinapolio g. 11)";PABIRUČIAI;7145050820;Ne;2;0;5;7
22479;"Pumpurėlis (Trinapolio g. 11)";PABIRUČIAI;3464806589;Ne;1;0;7;8
22480;"Pumpurėlis (Trinapolio g. 11)";PABIRUČIAI;9012133443;Ne;0;1;0;1
22481;"Pumpurėlis (Trinapolio g. 11)";PABIRUČIAI;5703275497;Ne;0;0;2;2
22482;"Pumpurėlis (Trinapolio g. 11)";PABIRUČIAI;7199184901;Ne;0;2;5;7
22483;"Gilužis (Įsruties g. 30)";AITVARIUKŲ;3612834040;Ne;8;0;7;15
22484;"Gilužis (Įsruties g. 30)";AITVARIUKŲ;6279641042;Ne;5;0;2;7
22485;"Gilužis (Įsruties g. 30)";AITVARIUKŲ;2971604057;Ne;3;0;2;5
22486;"Gilužis (Įsruties g. 30)";AITVARIUKŲ;6430615720;Ne;8;2;2;12
22487;"Gilužis (Įsruties g. 30)";AITVARIUKŲ;4351997862;Ne;11;6;2;19
22488;"Gilužis (Įsruties g. 30)";AITVARIUKŲ;2094662680;Ne;16;1;2;19
22489;"Gilužis (Įsruties g. 30)";AITVARIUKŲ;6020457766;Ne;9;0;6;15
22490;"Gilužis (Įsruties g. 30)";AITVARIUKŲ;1766021430;Ne;7;2;2;11
22491;"Gilužis (Įsruties g. 30)";AITVARIUKŲ;2401999477;Ne;9;0;2;11
22492;"Gilužis (Įsruties g. 30)";AITVARIUKŲ;8268273217;Ne;3;4;5;12
22493;"Gilužis (Įsruties g. 30)";AITVARIUKŲ;8412189871;Ne;1;2;3;6
22494;"Gilužis (Įsruties g. 30)";AITVARIUKŲ;9434214933;Taip;8;0;2;10
22495;"Gilužis (Įsruties g. 30)";AITVARIUKŲ;4731369089;Ne;8;0;2;10
22496;"Gilužis (Įsruties g. 30)";AITVARIUKŲ;2614683353;Ne;12;0;2;14
22497;"Gilužis (Įsruties g. 30)";AITVARIUKŲ;2657805562;Ne;8;2;2;12
22498;"Gilužis (Įsruties g. 30)";AITVARIUKŲ;6713383000;Ne;12;0;2;14
22499;"Gilužis (Įsruties g. 30)";SPINDULIUKŲ;8951766269;Ne;11;0;2;13
22500;"Gilužis (Įsruties g. 30)";SPINDULIUKŲ;8712363813;Ne;2;0;5;7
22501;"Gilužis (Įsruties g. 30)";SPINDULIUKŲ;8499650174;Ne;8;2;0;10
22502;"Gilužis (Įsruties g. 30)";SPINDULIUKŲ;4939683067;Ne;8;0;2;10
22503;"Gilužis (Įsruties g. 30)";SPINDULIUKŲ;4483309790;Ne;7;0;2;9
22504;"Gilužis (Įsruties g. 30)";SPINDULIUKŲ;7513403761;Ne;3;3;2;8
22505;"Gilužis (Įsruties g. 30)";SPINDULIUKŲ;8587454386;Ne;8;2;2;12
22506;"Gilužis (Įsruties g. 30)";SPINDULIUKŲ;6582408024;Ne;4;0;2;6
22507;"Gilužis (Įsruties g. 30)";SPINDULIUKŲ;7606952525;Ne;4;0;5;9
22508;"Gilužis (Įsruties g. 30)";SPINDULIUKŲ;8238801880;Ne;15;0;2;17
22509;"Gilužis (Įsruties g. 30)";SPINDULIUKŲ;7924726810;Ne;5;0;4;9
22510;"Gilužis (Įsruties g. 30)";SPINDULIUKŲ;5971465705;Ne;20;0;2;22
22511;"Gilužis (Įsruties g. 30)";SPINDULIUKŲ;9352644751;Ne;3;2;5;10
22512;"Gilužis (Įsruties g. 30)";SPINDULIUKŲ;9689776829;Ne;6;0;5;11
22513;"Gilužis (Įsruties g. 30)";SPINDULIUKŲ;9807489364;Ne;13;0;2;15
22514;"Gilužis (Įsruties g. 30)";ŽIRNIUKŲ;1660797528;Ne;5;0;3;8
22515;"Gilužis (Įsruties g. 30)";ŽIRNIUKŲ;1584356386;Ne;13;0;3;16
22516;"Gilužis (Įsruties g. 30)";ŽIRNIUKŲ;8845494720;Ne;3;6;2;11
22517;"Gilužis (Įsruties g. 30)";ŽIRNIUKŲ;3355341868;Ne;11;0;3;14
22518;"Gilužis (Įsruties g. 30)";ŽIRNIUKŲ;1710906417;Ne;12;0;0;12
22519;"Gilužis (Įsruties g. 30)";ŽIRNIUKŲ;2831924292;Ne;8;0;5;13
22520;"Gilužis (Įsruties g. 30)";ŽIRNIUKŲ;5229186298;Ne;6;0;2;8
22521;"Gilužis (Įsruties g. 30)";ŽIRNIUKŲ;3250662431;Ne;6;1;2;9
22522;"Gilužis (Įsruties g. 30)";ŽIRNIUKŲ;8078194153;Ne;4;0;2;6
22523;"Gilužis (Įsruties g. 30)";ŽIRNIUKŲ;3224917490;Ne;2;3;5;10
22524;"Gilužis (Įsruties g. 30)";ŽIRNIUKŲ;3272561030;Ne;5;0;2;7
22525;"Gilužis (Įsruties g. 30)";ŽIRNIUKŲ;7620828905;Ne;3;0;2;5
22526;"Gilužis (Įsruties g. 30)";ŽIRNIUKŲ;1173529743;Ne;5;0;2;7
22527;"Gilužis (Įsruties g. 30)";ŽIRNIUKŲ;3504412599;Ne;17;0;2;19
22528;"Pilaitukas (Įsruties g. 27)";ŠNEKUČIAI;9940643503;Ne;3;0;4;7
22529;"Pilaitukas (Įsruties g. 27)";ŠNEKUČIAI;1445759374;Ne;2;0;0;2
22530;"Pilaitukas (Įsruties g. 27)";ŠNEKUČIAI;1859101624;Ne;0;0;2;2
22531;"Pilaitukas (Įsruties g. 27)";ŠNEKUČIAI;8479229073;Ne;2;0;1;3
22532;"Pilaitukas (Įsruties g. 27)";ŠNEKUČIAI;9731380502;Ne;5;0;2;7
22533;"Pilaitukas (Įsruties g. 27)";ŠNEKUČIAI;7224121082;Ne;4;0;4;8
22534;"Pilaitukas (Įsruties g. 27)";ŠNEKUČIAI;9115588495;Ne;2;0;3;5
22535;"Pilaitukas (Įsruties g. 27)";ŠNEKUČIAI;1082342063;Ne;1;0;3;4
22536;"Pilaitukas (Įsruties g. 27)";ŠNEKUČIAI;8801482035;Ne;6;0;6;12
22537;"Pilaitukas (Įsruties g. 27)";ŠNEKUČIAI;2894028512;Ne;2;0;0;2
22538;"Pilaitukas (Įsruties g. 27)";ŠNEKUČIAI;9622989196;Ne;7;0;4;11
22539;"Pilaitukas (Įsruties g. 27)";ŠNEKUČIAI;1356473379;Ne;0;22;0;22
22540;"Pilaitukas (Įsruties g. 27)";ŠNEKUČIAI;2883122532;Ne;3;0;2;5
22541;"Pilaitukas (Įsruties g. 27)";ŠNEKUČIAI;2883122532;Ne;3;0;2;5
22542;"Pilaitukas (Įsruties g. 27)";ŠNEKUČIAI;2883122532;Ne;3;0;2;5
22543;"Pilaitukas (Įsruties g. 27)";ŠNEKUČIAI;2939090118;Ne;2;0;0;2
22544;"Pilaitukas (Įsruties g. 27)";ŠNEKUČIAI;1309209771;Ne;0;0;1;1
22545;"Pilaitukas (Įsruties g. 27)";ŠNEKUČIAI;6092611227;Ne;2;0;4;6
22546;"Pilaitukas (Įsruties g. 27)";ŠNEKUČIAI;4567479900;Ne;1;0;0;1
22547;"Pilaitukas (Įsruties g. 27)";ŠNEKUČIAI;3653807287;Ne;3;0;4;7
22548;"Pilaitukas (Įsruties g. 27)";SMALSUČIAI;1815311248;Ne;5;0;4;9
22549;"Pilaitukas (Įsruties g. 27)";SMALSUČIAI;3215689222;Ne;5;13;2;20
22550;"Pilaitukas (Įsruties g. 27)";SMALSUČIAI;8755603496;Ne;3;0;2;5
22551;"Pilaitukas (Įsruties g. 27)";SMALSUČIAI;1974429718;Ne;8;1;3;12
22552;"Pilaitukas (Įsruties g. 27)";SMALSUČIAI;4544849086;Ne;3;0;5;8
22553;"Pilaitukas (Įsruties g. 27)";SMALSUČIAI;6934677745;Ne;3;0;2;5
22554;"Pilaitukas (Įsruties g. 27)";SMALSUČIAI;6496708020;Ne;12;0;2;14
22555;"Pilaitukas (Įsruties g. 27)";SMALSUČIAI;4608105047;Ne;8;0;4;12
22556;"Pilaitukas (Įsruties g. 27)";SMALSUČIAI;8698639192;Ne;0;0;8;8
22557;"Pilaitukas (Įsruties g. 27)";SMALSUČIAI;3273127718;Ne;0;2;0;2
22558;"Pilaitukas (Įsruties g. 27)";SMALSUČIAI;3501783231;Ne;2;0;2;4
22559;"Pilaitukas (Įsruties g. 27)";SMALSUČIAI;4898803794;Ne;3;3;2;8
22560;"Pilaitukas (Įsruties g. 27)";SMALSUČIAI;3544734838;Ne;0;0;1;1
22561;"Pilaitukas (Įsruties g. 27)";SMALSUČIAI;7034013577;Ne;4;2;4;10
22562;"Pilaitukas (Įsruties g. 27)";SMALSUČIAI;6906821879;Ne;4;0;6;10
22563;"Pilaitukas (Įsruties g. 27)";SMALSUČIAI;2210253038;Ne;3;10;2;15
22564;"Pilaitukas (Įsruties g. 27)";SMALSUČIAI;5490465905;Ne;1;3;2;6
22565;"Pilaitukas (Įsruties g. 27)";SMALSUČIAI;8787181006;Ne;3;4;2;9
22566;"Pilaitukas (Įsruties g. 27)";SMALSUČIAI;1793393776;Ne;0;1;5;6
22567;"Pilaitukas (Įsruties g. 27)";" GUDRUČIAI";3068325053;Ne;2;2;2;6
22568;"Pilaitukas (Įsruties g. 27)";" GUDRUČIAI";1571691020;Ne;2;2;2;6
22569;"Pilaitukas (Įsruties g. 27)";" GUDRUČIAI";9186679454;Ne;0;2;3;5
22570;"Pilaitukas (Įsruties g. 27)";" GUDRUČIAI";8584321345;Ne;0;2;0;2
22571;"Pilaitukas (Įsruties g. 27)";" GUDRUČIAI";3621245783;Ne;0;2;3;5
22572;"Pilaitukas (Įsruties g. 27)";" GUDRUČIAI";3927118900;Ne;0;15;1;16
22573;"Pilaitukas (Įsruties g. 27)";" GUDRUČIAI";5464065587;Ne;0;4;0;4
22574;"Pilaitukas (Įsruties g. 27)";" GUDRUČIAI";6844500395;Ne;0;2;0;2
22575;"Pilaitukas (Įsruties g. 27)";" GUDRUČIAI";5440233814;Ne;0;0;3;3
22576;"Pilaitukas (Įsruties g. 27)";" GUDRUČIAI";4810825253;Ne;0;4;1;5
22577;"Pilaitukas (Įsruties g. 27)";" GUDRUČIAI";9774222130;Ne;1;0;2;3
22578;"Pilaitukas (Įsruties g. 27)";" GUDRUČIAI";4623818227;Ne;0;2;0;2
22579;"Pilaitukas (Įsruties g. 27)";" GUDRUČIAI";7568744500;Ne;0;2;1;3
22580;"Pilaitukas (Įsruties g. 27)";" GUDRUČIAI";5407354218;Ne;3;5;2;10
22581;"Pilaitukas (Įsruties g. 27)";" GUDRUČIAI";5326258755;Ne;4;3;2;9
22582;"Pilaitukas (Įsruties g. 27)";" GUDRUČIAI";5063602139;Ne;6;3;2;11
22583;"Kodėlčiukas (Pavilnionių g. 29)";VOVERIUKAI;4489705749;Ne;11;0;5;16
22584;"Kodėlčiukas (Pavilnionių g. 29)";VOVERIUKAI;9356462891;Ne;1;0;3;4
22585;"Kodėlčiukas (Pavilnionių g. 29)";VOVERIUKAI;4828932295;Ne;6;0;2;8
22586;"Kodėlčiukas (Pavilnionių g. 29)";VOVERIUKAI;1599468117;Taip;1;2;7;10
22587;"Kodėlčiukas (Pavilnionių g. 29)";VOVERIUKAI;8950661240;Ne;0;0;5;5
22588;"Kodėlčiukas (Pavilnionių g. 29)";VOVERIUKAI;5826387149;Ne;4;0;4;8
22589;"Kodėlčiukas (Pavilnionių g. 29)";VOVERIUKAI;4464338045;Ne;16;0;2;18
22590;"Kodėlčiukas (Pavilnionių g. 29)";VOVERIUKAI;7670611028;Taip;10;0;4;14
22591;"Kodėlčiukas (Pavilnionių g. 29)";VOVERIUKAI;1495887897;Taip;8;0;2;10
22592;"Kodėlčiukas (Pavilnionių g. 29)";VOVERIUKAI;2004990546;Ne;0;0;3;3
22593;"Kodėlčiukas (Pavilnionių g. 29)";VOVERIUKAI;4463423519;Ne;0;0;1;1
22594;"Kodėlčiukas (Pavilnionių g. 29)";VOVERIUKAI;9262386562;Ne;1;0;2;3
22595;"Kodėlčiukas (Pavilnionių g. 29)";VOVERIUKAI;7015036278;Ne;0;3;3;6
22596;"Kodėlčiukas (Pavilnionių g. 29)";VOVERIUKAI;2624402719;Ne;5;0;6;11
22597;"Kodėlčiukas (Pavilnionių g. 29)";AITVARIUKAI;3071951746;Ne;0;0;1;1
22598;"Kodėlčiukas (Pavilnionių g. 29)";AITVARIUKAI;9389125350;Taip;0;0;2;2
22599;"Kodėlčiukas (Pavilnionių g. 29)";AITVARIUKAI;9389125350;Taip;0;0;2;2
22600;"Kodėlčiukas (Pavilnionių g. 29)";AITVARIUKAI;1784673088;Taip;8;0;5;13
22601;"Kodėlčiukas (Pavilnionių g. 29)";AITVARIUKAI;1784673088;Taip;8;0;5;13
22602;"Kodėlčiukas (Pavilnionių g. 29)";AITVARIUKAI;9573073973;Ne;0;2;0;2
22603;"Kodėlčiukas (Pavilnionių g. 29)";AITVARIUKAI;2429997257;Taip;3;0;3;6
22604;"Kodėlčiukas (Pavilnionių g. 29)";AITVARIUKAI;2429997257;Taip;3;0;3;6
22605;"Kodėlčiukas (Pavilnionių g. 29)";AITVARIUKAI;3735299373;Ne;0;2;2;4
22606;"Kodėlčiukas (Pavilnionių g. 29)";AITVARIUKAI;1775864846;Taip;0;9;3;12
22607;"Kodėlčiukas (Pavilnionių g. 29)";AITVARIUKAI;1775864846;Taip;0;9;3;12
22608;"Kodėlčiukas (Pavilnionių g. 29)";AITVARIUKAI;1029573241;Taip;5;0;6;11
22609;"Kodėlčiukas (Pavilnionių g. 29)";AITVARIUKAI;1029573241;Taip;5;0;6;11
22610;"Kodėlčiukas (Pavilnionių g. 29)";AITVARIUKAI;2892318767;Taip;7;0;5;12
22611;"Kodėlčiukas (Pavilnionių g. 29)";AITVARIUKAI;2892318767;Taip;7;0;5;12
22612;"Kodėlčiukas (Pavilnionių g. 29)";AITVARIUKAI;6809202793;Taip;4;0;5;9
22613;"Kodėlčiukas (Pavilnionių g. 29)";AITVARIUKAI;6809202793;Taip;4;0;5;9
22614;"Kodėlčiukas (Pavilnionių g. 29)";AITVARIUKAI;8707777661;Taip;16;0;1;17
22615;"Kodėlčiukas (Pavilnionių g. 29)";AITVARIUKAI;8707777661;Taip;16;0;1;17
22616;"Kodėlčiukas (Pavilnionių g. 29)";AITVARIUKAI;4366942357;Taip;0;0;3;3
22617;"Kodėlčiukas (Pavilnionių g. 29)";AITVARIUKAI;4366942357;Taip;0;0;3;3
22618;"Kodėlčiukas (Pavilnionių g. 29)";AITVARIUKAI;2601561338;Taip;4;0;7;11
22619;"Kodėlčiukas (Pavilnionių g. 29)";DEBESĖLIAI;2048119857;Ne;10;0;3;13
22620;"Kodėlčiukas (Pavilnionių g. 29)";DEBESĖLIAI;6567146331;Taip;0;0;1;1
22621;"Kodėlčiukas (Pavilnionių g. 29)";DEBESĖLIAI;6567146331;Taip;0;0;1;1
22622;"Kodėlčiukas (Pavilnionių g. 29)";DEBESĖLIAI;7141979862;Taip;10;0;2;12
22623;"Kodėlčiukas (Pavilnionių g. 29)";DEBESĖLIAI;7141979862;Taip;10;0;2;12
22624;"Kodėlčiukas (Pavilnionių g. 29)";DEBESĖLIAI;5786431452;Ne;4;0;4;8
22625;"Kodėlčiukas (Pavilnionių g. 29)";DEBESĖLIAI;1056383365;Ne;5;0;3;8
22626;"Kodėlčiukas (Pavilnionių g. 29)";DEBESĖLIAI;1725192281;Ne;0;2;3;5
22627;"Kodėlčiukas (Pavilnionių g. 29)";DEBESĖLIAI;1725192281;Ne;0;2;3;5
22628;"Kodėlčiukas (Pavilnionių g. 29)";DEBESĖLIAI;2914410829;Ne;11;0;3;14
22629;"Kodėlčiukas (Pavilnionių g. 29)";DEBESĖLIAI;3662576624;Ne;0;9;0;9
22630;"Kodėlčiukas (Pavilnionių g. 29)";DEBESĖLIAI;5286211766;Ne;8;0;4;12
22631;"Kodėlčiukas (Pavilnionių g. 29)";DEBESĖLIAI;5286211766;Ne;8;0;4;12
22632;"Kodėlčiukas (Pavilnionių g. 29)";DEBESĖLIAI;9370078535;Taip;0;0;1;1
22633;"Kodėlčiukas (Pavilnionių g. 29)";DEBESĖLIAI;9370078535;Taip;0;0;1;1
22634;"Kodėlčiukas (Pavilnionių g. 29)";LAPIUKAI;1891196716;Ne;0;2;0;2
22635;"Kodėlčiukas (Pavilnionių g. 29)";LAPIUKAI;8571338844;Ne;11;1;2;14
22636;"Kodėlčiukas (Pavilnionių g. 29)";LAPIUKAI;8571338844;Ne;11;1;2;14
22637;"Kodėlčiukas (Pavilnionių g. 29)";LAPIUKAI;1317117419;Ne;0;0;2;2
22638;"Kodėlčiukas (Pavilnionių g. 29)";LAPIUKAI;3684778189;Ne;7;1;2;10
22639;"Kodėlčiukas (Pavilnionių g. 29)";LAPIUKAI;6930466455;Ne;8;2;2;12
22640;"Kodėlčiukas (Pavilnionių g. 29)";LAPIUKAI;9735976439;Ne;4;0;5;9
22641;"Kodėlčiukas (Pavilnionių g. 29)";LAPIUKAI;9735976439;Ne;4;0;5;9
22642;"Kodėlčiukas (Pavilnionių g. 29)";LAPIUKAI;8735489387;Taip;0;0;4;4
22643;"Kodėlčiukas (Pavilnionių g. 29)";LAPIUKAI;8735489387;Taip;0;0;4;4
22644;"Kodėlčiukas (Pavilnionių g. 29)";LAPIUKAI;7299634969;Taip;12;0;2;14
22645;"Kodėlčiukas (Pavilnionių g. 29)";LAPIUKAI;7299634969;Taip;12;0;2;14
22646;"Kodėlčiukas (Pavilnionių g. 29)";LAPIUKAI;4119254199;Ne;0;0;2;2
22647;"Kodėlčiukas (Pavilnionių g. 29)";LAPIUKAI;4119254199;Ne;0;0;2;2
22648;"Kodėlčiukas (Pavilnionių g. 29)";LAPIUKAI;8896158382;Ne;2;0;2;4
22649;"Kodėlčiukas (Pavilnionių g. 29)";LAPIUKAI;8896158382;Ne;2;0;2;4
22650;"Kodėlčiukas (Pavilnionių g. 29)";LAPIUKAI;6826429156;Ne;0;0;2;2
22651;"Kodėlčiukas (Pavilnionių g. 29)";LAPIUKAI;6826429156;Ne;0;0;2;2
22652;"Kodėlčiukas (Pavilnionių g. 29)";EŽIUKAI;1761109453;Ne;0;2;10;12
22653;"Kodėlčiukas (Pavilnionių g. 29)";EŽIUKAI;1906930504;Ne;1;0;2;3
22654;"Kodėlčiukas (Pavilnionių g. 29)";EŽIUKAI;5925818434;Ne;0;7;0;7
22655;"Kodėlčiukas (Pavilnionių g. 29)";EŽIUKAI;5925818434;Ne;0;7;0;7
22656;"Kodėlčiukas (Pavilnionių g. 29)";EŽIUKAI;7107700885;Ne;0;20;0;20
22657;"Kodėlčiukas (Pavilnionių g. 29)";EŽIUKAI;7107700885;Ne;0;20;0;20
22658;"Kodėlčiukas (Pavilnionių g. 29)";EŽIUKAI;4842829705;Ne;0;20;0;20
22659;"Kodėlčiukas (Pavilnionių g. 29)";EŽIUKAI;4842829705;Ne;0;20;0;20
22660;"Kodėlčiukas (Pavilnionių g. 29)";EŽIUKAI;3529385544;Ne;0;0;3;3
22661;"Kodėlčiukas (Pavilnionių g. 29)";EŽIUKAI;2728038596;Ne;3;0;2;5
22662;"Kodėlčiukas (Pavilnionių g. 29)";EŽIUKAI;7035441207;Ne;7;2;2;11
22663;"Kodėlčiukas (Pavilnionių g. 29)";EŽIUKAI;2999381333;Ne;3;0;4;7
22664;"Kodėlčiukas (Pavilnionių g. 29)";EŽIUKAI;2999381333;Ne;3;0;4;7
22665;"Kodėlčiukas (Pavilnionių g. 29)";EŽIUKAI;5540660080;Ne;3;0;3;6
22666;"Kodėlčiukas (Pavilnionių g. 29)";EŽIUKAI;4795230461;Ne;0;0;2;2
22667;"Kodėlčiukas (Pavilnionių g. 29)";EŽIUKAI;9424975662;Ne;0;9;0;9
22668;"Kodėlčiukas (Pavilnionių g. 29)";EŽIUKAI;9424975662;Ne;0;9;0;9
22669;"Kodėlčiukas (Pavilnionių g. 29)";EŽIUKAI;3598405258;Ne;0;3;0;3
22670;"Kodėlčiukas (Pavilnionių g. 29)";EŽIUKAI;3598405258;Ne;0;3;0;3
22671;"Gilužis (Pajautos g. 5)";PAUKŠTELIŲ;9934325492;Ne;0;2;0;2
22672;"Gilužis (Pajautos g. 5)";PAUKŠTELIŲ;2883959240;Ne;0;0;5;5
22673;"Gilužis (Pajautos g. 5)";PAUKŠTELIŲ;6322255194;Ne;2;2;2;6
22674;"Gilužis (Pajautos g. 5)";PAUKŠTELIŲ;6572690788;Ne;1;2;2;5
22675;"Gilužis (Pajautos g. 5)";PAUKŠTELIŲ;8662424856;Ne;0;7;0;7
22676;"Gilužis (Pajautos g. 5)";PAUKŠTELIŲ;3646988912;Ne;0;4;0;4
22677;"Gilužis (Pajautos g. 5)";PAUKŠTELIŲ;5030871828;Ne;0;2;0;2
22678;"Gilužis (Pajautos g. 5)";PAUKŠTELIŲ;9919631327;Ne;3;2;2;7
22679;"Gilužis (Pajautos g. 5)";PAUKŠTELIŲ;3954379433;Ne;0;7;0;7
22680;"Gilužis (Pajautos g. 5)";PAUKŠTELIŲ;6129884232;Ne;5;1;4;10
22681;"Gilužis (Pajautos g. 5)";PAUKŠTELIŲ;9520598359;Ne;0;1;0;1
22682;"Gilužis (Pajautos g. 5)";PAUKŠTELIŲ;3804996594;Ne;3;0;2;5
22683;"Gilužis (Pajautos g. 5)";PAUKŠTELIŲ;6478152041;Ne;0;9;2;11
22684;"Gilužis (Pajautos g. 5)";PAUKŠTELIŲ;2524936605;Ne;0;2;0;2
22685;"Gilužis (Pajautos g. 5)";PAUKŠTELIŲ;8110869130;Ne;4;2;2;8
22686;"Gilužis (Pajautos g. 5)";PAUKŠTELIŲ;3141225891;Ne;0;2;0;2
