Nr.;"Darželio pavadinimas";"Grupės pavadinimas";"Vaiko Identifikacinis Nr.";"Deklaruotas mieste";"Pateisintos dėl ligos";"Pateisintos dėl kitų priežasčių";"Nepateisintos dienos";"Praleistos dienos Viso"
1;Aitvaras;"VIJURKAI (ALERG.)";6936031222;Taip;9;0;0;9
2;Aitvaras;"VIJURKAI (ALERG.)";2566375128;Taip;0;2;0;2
3;Aitvaras;"VIJURKAI (ALERG.)";1879540041;Taip;0;5;0;5
4;Aitvaras;"VIJURKAI (ALERG.)";1532588441;Taip;7;6;0;13
5;Aitvaras;"VIJURKAI (ALERG.)";8206046301;Taip;7;0;1;8
6;Aitvaras;"VIJURKAI (ALERG.)";1347364985;Taip;8;0;0;8
7;Aitvaras;"VIJURKAI (ALERG.)";9157794193;Taip;11;3;0;14
8;Aitvaras;"VIJURKAI (ALERG.)";9562494357;Taip;4;2;3;9
9;Aitvaras;"VIJURKAI (ALERG.)";6021342178;Taip;11;1;0;12
10;Aitvaras;"VIJURKAI (ALERG.)";2650483861;Taip;0;2;0;2
11;Aitvaras;"VIJURKAI (ALERG.)";4426643908;Ne;5;1;0;6
12;Aitvaras;"VIJURKAI (ALERG.)";2601983670;Taip;9;8;0;17
13;Aitvaras;"VIJURKAI (ALERG.)";2895663259;Taip;0;1;0;1
14;Aitvaras;"VIJURKAI (ALERG.)";3570820823;Taip;0;4;0;4
15;Aitvaras;"VIJURKAI (ALERG.)";6444377924;Taip;12;0;0;12
16;Aitvaras;"VIJURKAI (ALERG.)";4702400490;Taip;9;1;0;10
17;Aitvaras;"SMALSUČIAI (ALERG.)";4868552034;Taip;0;0;11;11
18;Aitvaras;"SMALSUČIAI (ALERG.)";6166757095;Taip;9;0;0;9
19;Aitvaras;"SMALSUČIAI (ALERG.)";4480921300;Taip;9;0;0;9
20;Aitvaras;"SMALSUČIAI (ALERG.)";1019661577;Taip;0;8;0;8
21;Aitvaras;"SMALSUČIAI (ALERG.)";5425259260;Taip;15;2;0;17
22;Aitvaras;"SMALSUČIAI (ALERG.)";6201118021;Taip;5;1;1;7
23;Aitvaras;"SMALSUČIAI (ALERG.)";5750154036;Taip;0;4;0;4
24;Aitvaras;"SMALSUČIAI (ALERG.)";6084096300;Taip;3;1;0;4
25;Aitvaras;"SMALSUČIAI (ALERG.)";2004112424;Taip;5;3;0;8
26;Aitvaras;"SMALSUČIAI (ALERG.)";5330618557;Taip;11;1;0;12
27;Aitvaras;"SMALSUČIAI (ALERG.)";3488467265;Taip;4;3;1;8
28;Aitvaras;"SMALSUČIAI (ALERG.)";9745864667;Taip;6;8;0;14
29;Aitvaras;"SMALSUČIAI (ALERG.)";9810370596;Taip;3;5;0;8
30;Aitvaras;"SMALSUČIAI (ALERG.)";1954364886;Taip;10;3;0;13
31;Aitvaras;"SMALSUČIAI (ALERG.)";3535659630;Taip;9;0;4;13
32;Aitvaras;"SMALSUČIAI (ALERG.)";4833313373;Taip;0;3;0;3
33;Aitvaras;"SMALSUČIAI (ALERG.)";24247118884;Taip;0;3;0;3
34;Aitvaras;"SMALSUČIAI (ALERG.)";5504431748;Taip;4;0;0;4
35;Aitvaras;"SMALSUČIAI (ALERG.)";5389627560;Ne;7;2;2;11
36;Aitvaras;"SMALSUČIAI (ALERG.)";2953536545;Taip;4;1;2;7
37;Aitvaras;"SMALSUČIAI (ALERG.)";1636794584;Ne;12;4;0;16
38;Aitvaras;"SMALSUČIAI (ALERG.)";5956333024;Taip;5;0;0;5
39;Aitvaras;"SMALSUČIAI (ALERG.)";5595233402;Taip;14;0;1;15
40;Aitvaras;PADAUŽIUKAI;1494094426;Taip;0;11;0;11
41;Aitvaras;PADAUŽIUKAI;9332771711;Taip;9;1;0;10
42;Aitvaras;PADAUŽIUKAI;6550426644;Taip;9;6;0;15
43;Aitvaras;PADAUŽIUKAI;5818794912;Taip;0;2;0;2
44;Aitvaras;PADAUŽIUKAI;58780461337;Ne;0;1;4;5
45;Aitvaras;PADAUŽIUKAI;2034293999;Taip;22;0;0;22
46;Aitvaras;PADAUŽIUKAI;44046627149;Ne;5;1;0;6
47;Aitvaras;PADAUŽIUKAI;43711349817;Taip;0;0;1;1
48;Aitvaras;PADAUŽIUKAI;2804106417;Taip;0;2;1;3
49;Aitvaras;PADAUŽIUKAI;2711888522;Taip;4;2;1;7
50;Aitvaras;PADAUŽIUKAI;1996524718;Taip;3;2;1;6
51;Aitvaras;PADAUŽIUKAI;4110585744;Taip;0;7;0;7
52;Aitvaras;PADAUŽIUKAI;7469656671;Taip;1;6;0;7
53;Aitvaras;PADAUŽIUKAI;6010324894;Taip;4;0;0;4
54;Aitvaras;PADAUŽIUKAI;2408952971;Taip;4;0;0;4
55;Aitvaras;PADAUŽIUKAI;47875842134;Taip;0;1;2;3
56;Aitvaras;PADAUŽIUKAI;40799643122;Taip;10;4;0;14
57;Aitvaras;PADAUŽIUKAI;9015675095;Taip;0;3;0;3
58;Aitvaras;PADAUŽIUKAI;8503279655;Ne;0;1;3;4
59;Aitvaras;PADAUŽIUKAI;8121858940;Ne;5;1;4;10
60;Aitvaras;PADAUŽIUKAI;6951219468;Taip;0;2;0;2
61;Aitvaras;"AITVARIUKAI (ALERG.)";3639102842;Taip;5;3;0;8
62;Aitvaras;"AITVARIUKAI (ALERG.)";7243387750;Taip;15;0;0;15
63;Aitvaras;"AITVARIUKAI (ALERG.)";6587437949;Ne;8;4;0;12
64;Aitvaras;"AITVARIUKAI (ALERG.)";7461284958;Taip;6;6;0;12
65;Aitvaras;"AITVARIUKAI (ALERG.)";3394251305;Taip;8;0;0;8
66;Aitvaras;"AITVARIUKAI (ALERG.)";6459307767;Taip;9;1;0;10
67;Aitvaras;"AITVARIUKAI (ALERG.)";5635576679;Ne;6;2;0;8
68;Aitvaras;"AITVARIUKAI (ALERG.)";7988247429;Taip;0;5;0;5
69;Aitvaras;"AITVARIUKAI (ALERG.)";8770777328;Taip;9;2;0;11
70;Aitvaras;"AITVARIUKAI (ALERG.)";3653879553;Taip;5;1;0;6
71;Aitvaras;"AITVARIUKAI (ALERG.)";9721273154;Taip;11;0;0;11
72;Aitvaras;"AITVARIUKAI (ALERG.)";5103105065;Taip;22;0;0;22
73;Aitvaras;"AITVARIUKAI (ALERG.)";8543644000;Taip;6;0;0;6
74;Aitvaras;"AITVARIUKAI (ALERG.)";1859647003;Taip;19;0;0;19
75;Aitvaras;"AITVARIUKAI (ALERG.)";4204923580;Taip;0;8;0;8
76;Aitvaras;"AITVARIUKAI (ALERG.)";4777266938;Taip;14;3;0;17
77;Aitvaras;"AITVARIUKAI (ALERG.)";7568388141;Taip;9;4;0;13
78;Aitvaras;"AITVARIUKAI (ALERG.)";3954840915;Taip;5;1;0;6
79;Aitvaras;"AITVARIUKAI (ALERG.)";2146963673;Taip;21;0;0;21
80;Aitvaras;"AITVARIUKAI (ALERG.)";9763502346;Taip;9;6;0;15
81;Aitvaras;"AITVARIUKAI (ALERG.)";9228736015;Taip;9;0;0;9
82;Aitvaras;"AITVARIUKAI (ALERG.)";3775634117;Taip;6;0;0;6
83;Aitvaras;"AITVARIUKAI (ALERG.)";2615576367;Ne;7;0;0;7
84;Aitvaras;"SAULĖS ZUIKUČIAI  (ALERG.)";5711324951;Taip;8;0;0;8
85;Aitvaras;"SAULĖS ZUIKUČIAI  (ALERG.)";5619137905;Taip;10;1;0;11
86;Aitvaras;"SAULĖS ZUIKUČIAI  (ALERG.)";4106097701;Taip;0;4;0;4
87;Aitvaras;"SAULĖS ZUIKUČIAI  (ALERG.)";2184231202;Taip;20;0;0;20
88;Aitvaras;"SAULĖS ZUIKUČIAI  (ALERG.)";2478737835;Taip;0;0;4;4
89;Aitvaras;"SAULĖS ZUIKUČIAI  (ALERG.)";1136438927;Taip;4;3;0;7
90;Aitvaras;"SAULĖS ZUIKUČIAI  (ALERG.)";8137900398;Taip;0;1;4;5
91;Aitvaras;"SAULĖS ZUIKUČIAI  (ALERG.)";9147954612;Taip;10;0;0;10
92;Aitvaras;"SAULĖS ZUIKUČIAI  (ALERG.)";2511844613;Taip;7;0;0;7
93;Aitvaras;"SAULĖS ZUIKUČIAI  (ALERG.)";7907357058;Taip;15;0;2;17
94;Aitvaras;"SAULĖS ZUIKUČIAI  (ALERG.)";9534206000;Taip;20;0;0;20
95;Aitvaras;"SAULĖS ZUIKUČIAI  (ALERG.)";3737054758;Ne;10;0;1;11
96;Aitvaras;"SAULĖS ZUIKUČIAI  (ALERG.)";4646876966;Taip;0;1;0;1
97;Aitvaras;"SAULĖS ZUIKUČIAI  (ALERG.)";9271534775;Taip;18;0;1;19
98;Aitvaras;"SAULĖS ZUIKUČIAI  (ALERG.)";8849563638;Taip;5;3;0;8
99;Aitvaras;"SAULĖS ZUIKUČIAI  (ALERG.)";6950820937;Taip;8;0;1;9
100;Aitvaras;"SAULĖS ZUIKUČIAI  (ALERG.)";5283056036;Taip;0;2;0;2
101;Aitvaras;"SAULĖS ZUIKUČIAI  (ALERG.)";5252728205;Taip;0;0;2;2
102;Aitvaras;"SAULĖS ZUIKUČIAI  (ALERG.)";2744696131;Taip;5;6;0;11
103;Aitvaras;"SAULĖS ZUIKUČIAI  (ALERG.)";2373509019;Taip;8;0;5;13
104;Aitvaras;"SAULĖS ZUIKUČIAI  (ALERG.)";2624566766;Taip;10;0;0;10
105;Aitvaras;"SAULĖS ZUIKUČIAI  (ALERG.)";3677551059;Ne;0;2;0;2
106;Aitvaras;"ŽEMYNUKAI (ALERG.)";8567255042;Ne;8;0;1;9
107;Aitvaras;"ŽEMYNUKAI (ALERG.)";6218019092;Taip;0;4;8;12
108;Aitvaras;"ŽEMYNUKAI (ALERG.)";7560642918;Taip;10;1;0;11
109;Aitvaras;"ŽEMYNUKAI (ALERG.)";3820930777;Taip;33;0;0;33
110;Aitvaras;"ŽEMYNUKAI (ALERG.)";6624986090;Taip;25;0;2;27
111;Aitvaras;"ŽEMYNUKAI (ALERG.)";4733627644;Taip;0;5;9;14
112;Aitvaras;"ŽEMYNUKAI (ALERG.)";3104109370;Taip;5;0;4;9
113;Aitvaras;"ŽEMYNUKAI (ALERG.)";7853714142;Taip;21;2;1;24
114;Aitvaras;"ŽEMYNUKAI (ALERG.)";1949144346;Taip;6;1;0;7
115;Aitvaras;"ŽEMYNUKAI (ALERG.)";8641433486;Taip;0;0;3;3
116;Aitvaras;"ŽEMYNUKAI (ALERG.)";3961423273;Taip;5;0;0;5
117;Aitvaras;"ŽEMYNUKAI (ALERG.)";9947610763;Taip;5;1;0;6
118;Aitvaras;"ŽEMYNUKAI (ALERG.)";7113016866;Taip;8;2;0;10
119;Aitvaras;"ŽEMYNUKAI (ALERG.)";4377666052;Taip;10;0;0;10
120;Aitvaras;"ŽEMYNUKAI (ALERG.)";8333823078;Taip;33;0;0;33
121;Aitvaras;"ŽEMYNUKAI (ALERG.)";5623106419;Taip;0;0;1;1
122;Aitvaras;"ŽEMYNUKAI (ALERG.)";5351333397;Taip;9;5;0;14
123;Aitvaras;"ŽEMYNUKAI (ALERG.)";2065988478;Taip;4;0;8;12
124;Aitvaras;"ŽEMYNUKAI (ALERG.)";3635354769;Taip;22;2;2;26
125;Aitvaras;"ŽEMYNUKAI (ALERG.)";3851322849;Taip;1;3;4;8
126;Aitvaras;"ŽEMYNUKAI (ALERG.)";7889947603;Taip;15;0;1;16
127;Aitvaras;"ŽEMYNUKAI (ALERG.)";1662289664;Taip;6;0;0;6
128;Aitvaras;"ŽEMYNUKAI (ALERG.)";2839442228;Ne;23;0;1;24
129;Aitvaras;"LINKSMUČIAI (ALERG.)";5238819066;Taip;0;0;1;1
130;Aitvaras;"LINKSMUČIAI (ALERG.)";7109001184;Taip;12;0;0;12
131;Aitvaras;"LINKSMUČIAI (ALERG.)";5378212904;Taip;22;0;0;22
132;Aitvaras;"LINKSMUČIAI (ALERG.)";3655710511;Taip;0;1;0;1
133;Aitvaras;"LINKSMUČIAI (ALERG.)";1091372798;Taip;10;4;1;15
134;Aitvaras;"LINKSMUČIAI (ALERG.)";8666824607;Taip;4;8;0;12
135;Aitvaras;"LINKSMUČIAI (ALERG.)";5612991255;Taip;0;1;0;1
136;Aitvaras;"LINKSMUČIAI (ALERG.)";7260577885;Taip;6;1;3;10
137;Aitvaras;"LINKSMUČIAI (ALERG.)";1599183050;Taip;0;0;1;1
138;Aitvaras;"LINKSMUČIAI (ALERG.)";1115202169;Taip;6;0;0;6
139;Aitvaras;"LINKSMUČIAI (ALERG.)";4613894944;Ne;5;2;0;7
140;Aitvaras;"LINKSMUČIAI (ALERG.)";4120515569;Taip;6;13;5;24
141;Aitvaras;"LINKSMUČIAI (ALERG.)";9885781306;Taip;16;0;0;16
142;Aitvaras;"LINKSMUČIAI (ALERG.)";4612994715;Taip;5;0;4;9
143;Aitvaras;"LINKSMUČIAI (ALERG.)";4176681907;Taip;0;10;0;10
144;Aitvaras;"LINKSMUČIAI (ALERG.)";6286268740;Taip;0;4;5;9
145;Aitvaras;"LINKSMUČIAI (ALERG.)";2547934790;Taip;20;1;0;21
146;Aitvaras;"LINKSMUČIAI (ALERG.)";2357399981;Ne;13;0;0;13
147;Aitvaras;"LINKSMUČIAI (ALERG.)";5572538840;Taip;9;5;0;14
148;Aitvaras;"LINKSMUČIAI (ALERG.)";4114397590;Taip;3;1;0;4
149;Aitvaras;NAMINUKAI;3053557807;Taip;10;0;5;15
150;Aitvaras;NAMINUKAI;6126913961;Taip;0;0;4;4
151;Aitvaras;NAMINUKAI;3347213578;Taip;0;1;7;8
152;Aitvaras;NAMINUKAI;9024245490;Taip;3;2;1;6
153;Aitvaras;NAMINUKAI;8512502118;Taip;2;1;1;4
154;Aitvaras;NAMINUKAI;2821221241;Taip;6;0;0;6
155;Aitvaras;NAMINUKAI;9039303562;Taip;10;0;4;14
156;Aitvaras;NAMINUKAI;6080549524;Taip;10;0;4;14
157;Aitvaras;NAMINUKAI;6110226958;Ne;0;0;7;7
158;Aitvaras;NAMINUKAI;4555281655;Taip;5;3;1;9
159;Aitvaras;NAMINUKAI;8043062737;Ne;8;1;3;12
160;Aitvaras;NAMINUKAI;3005447572;Taip;9;2;0;11
161;Aitvaras;NAMINUKAI;1549552392;Taip;0;2;1;3
162;Aitvaras;NAMINUKAI;4498792867;Taip;0;7;0;7
163;Aitvaras;NAMINUKAI;9490714865;Ne;4;2;0;6
164;Aitvaras;NAMINUKAI;1498630458;Taip;0;1;0;1
165;Aitvaras;NAMINUKAI;5967188507;Ne;7;0;3;10
166;Aitvaras;NAMINUKAI;5161069611;Taip;6;0;1;7
167;Aitvaras;NAMINUKAI;7934344218;Taip;7;0;0;7
168;Aitvaras;NAMINUKAI;6279152796;Taip;5;2;0;7
169;Aitvaras;ŠELMIAI;4984058405;Ne;11;0;0;11
170;Aitvaras;ŠELMIAI;9725401255;Taip;10;0;0;10
171;Aitvaras;ŠELMIAI;4547342872;Taip;10;2;0;12
172;Aitvaras;ŠELMIAI;5684526288;Taip;5;1;3;9
173;Aitvaras;ŠELMIAI;5601517340;Taip;0;9;0;9
174;Aitvaras;ŠELMIAI;1019103539;Taip;10;6;0;16
175;Aitvaras;ŠELMIAI;2185746898;Taip;14;3;0;17
176;Aitvaras;ŠELMIAI;8756012613;Taip;0;3;0;3
177;Aitvaras;ŠELMIAI;1203732956;Taip;18;0;0;18
178;Aitvaras;ŠELMIAI;5782609781;Taip;13;0;0;13
179;Aitvaras;ŠELMIAI;7805819121;Taip;13;1;1;15
180;Aitvaras;ŠELMIAI;8558414510;Taip;5;1;0;6
181;Aitvaras;ŠELMIAI;4551774368;Taip;5;1;0;6
182;Aitvaras;ŠELMIAI;7352233454;Taip;0;7;0;7
183;Aitvaras;ŠELMIAI;1901118931;Taip;3;1;0;4
184;Aitvaras;ŠELMIAI;4812423010;Taip;0;3;3;6
185;Aitvaras;ŠELMIAI;1112142035;Ne;3;1;5;9
186;Aitvaras;ŠELMIAI;8644983502;Taip;1;1;0;2
187;Aitvaras;ŠELMIAI;9295561516;Taip;0;6;0;6
188;Aitvaras;ŠELMIAI;6188186413;Taip;7;2;0;9
189;Aitvaras;ŠELMIAI;5886199823;Taip;3;0;0;3
190;Aitvaras;KODĖLČIUKAI;6214572150;Taip;22;0;0;22
191;Aitvaras;KODĖLČIUKAI;3323458595;Taip;0;1;0;1
192;Aitvaras;KODĖLČIUKAI;8065540507;Taip;9;0;2;11
193;Aitvaras;KODĖLČIUKAI;1288810999;Taip;6;0;4;10
194;Aitvaras;KODĖLČIUKAI;6501943902;Taip;5;7;0;12
195;Aitvaras;KODĖLČIUKAI;3101015381;Ne;0;0;1;1
196;Aitvaras;KODĖLČIUKAI;4350590529;Taip;0;5;1;6
197;Aitvaras;KODĖLČIUKAI;7777235021;Taip;13;0;0;13
198;Aitvaras;KODĖLČIUKAI;5641224483;Taip;0;1;0;1
199;Aitvaras;KODĖLČIUKAI;1830134108;Ne;0;4;3;7
200;Aitvaras;KODĖLČIUKAI;3178965623;Taip;0;2;0;2
201;Aitvaras;KODĖLČIUKAI;5905456814;Taip;3;2;0;5
202;Aitvaras;KODĖLČIUKAI;1761446849;Taip;20;0;0;20
203;Aitvaras;KODĖLČIUKAI;6739827530;Taip;10;1;0;11
204;Aitvaras;KODĖLČIUKAI;2807595769;Taip;0;4;0;4
205;Aitvaras;KODĖLČIUKAI;1252145346;Taip;5;8;2;15
206;Aitvaras;KODĖLČIUKAI;8439586875;Taip;12;1;0;13
207;Aitvaras;KODĖLČIUKAI;2328771385;Ne;5;7;0;12
208;Aitvaras;KODĖLČIUKAI;3735941659;Taip;3;0;0;3
209;Aitvaras;KODĖLČIUKAI;8360380303;Taip;3;2;0;5
210;Aitvaras;KODĖLČIUKAI;1594675221;Taip;8;1;0;9
211;Aitvaras;KODĖLČIUKAI;5922357091;Taip;0;3;0;3
212;Aitvaras;PABIRUČIAI;1495399113;Taip;10;1;0;11
213;Aitvaras;PABIRUČIAI;7136674662;Taip;0;9;0;9
214;Aitvaras;PABIRUČIAI;9949206639;Taip;3;0;11;14
215;Aitvaras;PABIRUČIAI;4613021421;Taip;6;1;0;7
216;Aitvaras;PABIRUČIAI;2887681961;Taip;17;7;0;24
217;Aitvaras;PABIRUČIAI;7922937851;Ne;7;0;0;7
218;Aitvaras;PABIRUČIAI;4085134058;Taip;16;0;0;16
219;Aitvaras;PABIRUČIAI;8746884740;Taip;0;0;2;2
220;Aitvaras;PABIRUČIAI;4163871634;Taip;12;7;0;19
221;Aitvaras;PABIRUČIAI;3988226974;Taip;12;7;0;19
222;Aitvaras;PABIRUČIAI;2239387580;Taip;4;1;2;7
223;Aitvaras;PABIRUČIAI;6119148164;Taip;11;1;0;12
224;Aitvaras;PABIRUČIAI;2892898328;Taip;8;7;0;15
225;Aitvaras;PABIRUČIAI;4760801928;Taip;12;0;12;24
226;Aitvaras;PABIRUČIAI;1599296739;Taip;3;0;23;26
227;Aitvaras;PABIRUČIAI;4987412561;Taip;5;0;0;5
228;Aitvaras;"SVAJOKLIAI  (ALERG.)";3429046261;Taip;6;0;0;6
229;Aitvaras;"SVAJOKLIAI  (ALERG.)";5659897032;Taip;22;0;0;22
230;Aitvaras;"SVAJOKLIAI  (ALERG.)";4618560397;Taip;11;0;0;11
231;Aitvaras;"SVAJOKLIAI  (ALERG.)";7745736525;Taip;0;0;1;1
232;Aitvaras;"SVAJOKLIAI  (ALERG.)";9209862610;Taip;3;12;0;15
233;Aitvaras;"SVAJOKLIAI  (ALERG.)";6191938291;Taip;14;0;1;15
234;Aitvaras;"SVAJOKLIAI  (ALERG.)";7006713502;Taip;4;0;2;6
235;Aitvaras;"SVAJOKLIAI  (ALERG.)";3923601422;Taip;12;2;1;15
236;Aitvaras;"SVAJOKLIAI  (ALERG.)";5790551266;Taip;5;2;0;7
237;Aitvaras;"SVAJOKLIAI  (ALERG.)";2975696317;Taip;10;0;0;10
238;Aitvaras;"SVAJOKLIAI  (ALERG.)";3891067128;Taip;10;1;0;11
239;Aitvaras;"SVAJOKLIAI  (ALERG.)";1030872812;Taip;3;3;0;6
240;Aitvaras;"SVAJOKLIAI  (ALERG.)";8352951885;Taip;11;0;0;11
241;Aitvaras;"SVAJOKLIAI  (ALERG.)";5255843693;Taip;7;0;0;7
242;Aitvaras;"SVAJOKLIAI  (ALERG.)";1448307414;Taip;3;0;1;4
243;Aitvaras;"SVAJOKLIAI  (ALERG.)";5593105541;Taip;8;2;1;11
244;Aitvaras;"SVAJOKLIAI  (ALERG.)";8963214183;Taip;11;0;0;11
245;Aitvaras;"SVAJOKLIAI  (ALERG.)";6319953077;Taip;0;4;0;4
246;Aitvaras;"SVAJOKLIAI  (ALERG.)";1131690624;Taip;6;4;0;10
247;Aitvaras;"SVAJOKLIAI  (ALERG.)";4801034095;Taip;3;0;0;3
248;Aitvaras;"SVAJOKLIAI  (ALERG.)";6916032116;Taip;3;2;0;5
249;Atžalėlės;Gėlytės;4284673729;Taip;0;21;1;22
250;Atžalėlės;Gėlytės;8695865604;Taip;13;0;0;13
251;Atžalėlės;Gėlytės;2385614957;Taip;0;3;2;5
252;Atžalėlės;Gėlytės;5432433423;Ne;0;11;0;11
253;Atžalėlės;Gėlytės;9715625283;Taip;0;14;0;14
254;Atžalėlės;Gėlytės;4682216852;Taip;0;0;1;1
255;Atžalėlės;Gėlytės;2131592139;Taip;1;2;0;3
256;Atžalėlės;Gėlytės;3191066669;Taip;15;0;0;15
257;Atžalėlės;Gėlytės;1500456945;Taip;4;16;2;22
258;Atžalėlės;Gėlytės;1722233272;Taip;0;12;0;12
259;Atžalėlės;Gėlytės;5310990513;Taip;0;3;0;3
260;Atžalėlės;Gėlytės;7702502252;Taip;0;13;0;13
261;Atžalėlės;Gėlytės;9189223222;Taip;10;5;0;15
262;Atžalėlės;Gėlytės;3283415814;Taip;8;8;0;16
263;Atžalėlės;Gėlytės;1146492807;Taip;0;0;1;1
264;Atžalėlės;Gėlytės;3870758086;Taip;0;3;1;4
265;Atžalėlės;Gėlytės;6202250600;Ne;5;0;4;9
266;Atžalėlės;Gėlytės;4098210138;Taip;6;0;1;7
267;Atžalėlės;Gėlytės;6177038838;Taip;10;1;1;12
268;Atžalėlės;Gėlytės;5742471497;Taip;0;6;5;11
269;Atžalėlės;Gėlytės;1137741059;Taip;7;2;0;9
270;Atžalėlės;Gėlytės;4238773173;Taip;0;1;1;2
271;Atžalėlės;Gėlytės;1036410428;Taip;5;2;0;7
272;Atžalėlės;Gėlytės;1450609695;Taip;0;5;0;5
273;Atžalėlės;Drugeliai;4643154006;Taip;6;4;0;10
274;Atžalėlės;Drugeliai;6903666624;Taip;7;0;1;8
275;Atžalėlės;Drugeliai;2315790531;Taip;8;4;0;12
276;Atžalėlės;Drugeliai;6782007470;Taip;0;14;0;14
277;Atžalėlės;Drugeliai;1805496887;Taip;12;3;5;20
278;Atžalėlės;Drugeliai;7953922166;Taip;16;1;0;17
279;Atžalėlės;Drugeliai;5147078840;Taip;0;4;0;4
280;Atžalėlės;Drugeliai;9222670655;Taip;0;4;0;4
281;Atžalėlės;Drugeliai;77261118958;Taip;9;2;0;11
282;Atžalėlės;Drugeliai;1429493246;Taip;5;7;0;12
283;Atžalėlės;Drugeliai;6114426973;Taip;3;8;0;11
284;Atžalėlės;Drugeliai;1456979448;Taip;4;4;0;8
285;Atžalėlės;Drugeliai;4032519781;Taip;9;6;0;15
286;Atžalėlės;Drugeliai;7756889911;Taip;0;13;0;13
287;Atžalėlės;Drugeliai;5063094678;Taip;1;1;3;5
288;Atžalėlės;Drugeliai;3422605135;Taip;0;3;3;6
289;Atžalėlės;Drugeliai;8718036014;Taip;15;3;0;18
290;Atžalėlės;Drugeliai;4884599397;Taip;15;3;0;18
291;Atžalėlės;Drugeliai;4902947406;Taip;5;0;0;5
292;Atžalėlės;Drugeliai;9463215947;Taip;0;1;4;5
293;Atžalėlės;Drugeliai;6570245757;Taip;12;1;0;13
294;Atžalėlės;Drugeliai;6695872204;Taip;3;7;0;10
295;Atžalėlės;Drugeliai;6393090675;Taip;10;4;2;16
296;Atžalėlės;Gandriukai;2083260403;Taip;0;12;10;22
297;Atžalėlės;Gandriukai;3692090073;Taip;16;0;0;16
298;Atžalėlės;Gandriukai;2078549599;Taip;4;0;4;8
299;Atžalėlės;Gandriukai;5119260525;Ne;8;0;3;11
300;Atžalėlės;Gandriukai;1024559742;Taip;11;0;0;11
301;Atžalėlės;Gandriukai;7510951079;Taip;4;6;0;10
302;Atžalėlės;Gandriukai;6594440062;Taip;12;0;0;12
303;Atžalėlės;Gandriukai;4293557144;Taip;0;10;11;21
304;Atžalėlės;Gandriukai;6211002805;Taip;0;0;2;2
305;Atžalėlės;Gandriukai;1305611902;Taip;0;0;8;8
306;Atžalėlės;Gandriukai;5102163688;Taip;12;0;0;12
307;Atžalėlės;Voveriukai;1865339755;Taip;15;0;0;15
308;Atžalėlės;Voveriukai;4467364336;Taip;14;0;1;15
309;Atžalėlės;Voveriukai;9699811980;Taip;5;0;2;7
310;Atžalėlės;Voveriukai;8847754477;Taip;17;0;0;17
311;Atžalėlės;Voveriukai;3795729265;Taip;14;0;2;16
312;Atžalėlės;Voveriukai;8201582382;Taip;18;1;0;19
313;Atžalėlės;Voveriukai;4362058013;Taip;18;1;0;19
314;Atžalėlės;Voveriukai;8819893830;Taip;0;2;14;16
315;Atžalėlės;Voveriukai;3069192413;Taip;11;0;1;12
316;Atžalėlės;Voveriukai;2067246260;Taip;10;1;8;19
317;Atžalėlės;Voveriukai;7532672266;Taip;13;5;0;18
318;Atžalėlės;Voveriukai;5705303891;Taip;9;1;0;10
319;Atžalėlės;Voveriukai;5650427433;Taip;0;1;0;1
320;Atžalėlės;Voveriukai;1316154666;Taip;16;1;0;17
321;Atžalėlės;Voveriukai;6975941393;Taip;13;0;0;13
322;Atžalėlės;Voveriukai;8138683218;Taip;5;6;0;11
323;Atžalėlės;Voveriukai;7689394485;Taip;8;7;0;15
324;Atžalėlės;Voveriukai;1804802235;Taip;12;0;0;12
325;Atžalėlės;Voveriukai;4996777116;Taip;10;3;0;13
326;Atžalėlės;Voveriukai;1426744251;Taip;14;0;0;14
327;Atžalėlės;Voveriukai;6684979914;Taip;8;0;0;8
328;Atžalėlės;Voveriukai;8470059012;Ne;0;1;11;12
329;Atžalėlės;Voveriukai;5767549779;Taip;4;10;0;14
330;Atžalėlės;Žirniukai;2374624441;Taip;8;5;0;13
331;Atžalėlės;Žirniukai;9707462467;Taip;8;0;0;8
332;Atžalėlės;Žirniukai;5584105084;Taip;0;0;2;2
333;Atžalėlės;Žirniukai;9677943321;Taip;0;0;1;1
334;Atžalėlės;Žirniukai;9967641617;Taip;11;4;0;15
335;Atžalėlės;Žirniukai;9508110719;Taip;9;0;0;9
336;Atžalėlės;Žirniukai;9085453655;Taip;11;0;0;11
337;Atžalėlės;Žirniukai;1538643591;Ne;0;15;7;22
338;Atžalėlės;Žirniukai;3143856911;Taip;5;10;0;15
339;Atžalėlės;Žirniukai;1212074068;Taip;16;0;1;17
340;Atžalėlės;Žirniukai;9736390705;Taip;18;0;0;18
341;Atžalėlės;Žirniukai;4661388894;Taip;0;9;0;9
342;Atžalėlės;Žirniukai;7196464328;Taip;12;3;0;15
343;Atžalėlės;Žirniukai;7522643082;Ne;20;1;1;22
344;Atžalėlės;Žirniukai;7613931447;Ne;23;0;1;24
345;Atžalėlės;Žirniukai;6723689098;Taip;1;1;3;5
346;Atžalėlės;Žirniukai;9281138840;Ne;0;1;9;10
347;Atžalėlės;Žirniukai;7018297883;Taip;0;13;0;13
348;Atžalėlės;Ežiukai;4227804985;Taip;5;0;0;5
349;Atžalėlės;Ežiukai;9053620501;Taip;0;0;3;3
350;Atžalėlės;Ežiukai;9054589111;Taip;8;0;1;9
351;Atžalėlės;Ežiukai;9346744866;Taip;3;4;0;7
352;Atžalėlės;Ežiukai;1505286928;Taip;8;5;0;13
353;Atžalėlės;Ežiukai;4148412941;Taip;4;7;0;11
354;Atžalėlės;Ežiukai;3333808381;Taip;10;0;0;10
355;Atžalėlės;Ežiukai;1710646812;Taip;19;0;1;20
356;Atžalėlės;Ežiukai;9481268935;Taip;7;0;0;7
357;Atžalėlės;Ežiukai;6447615639;Taip;0;1;5;6
358;Atžalėlės;Ežiukai;5972419628;Taip;0;6;0;6
359;Atžalėlės;Ežiukai;3738127350;Taip;3;0;2;5
360;Atžalėlės;Ežiukai;1423254771;Taip;4;0;3;7
361;Atžalėlės;Ežiukai;6665199013;Taip;7;1;0;8
362;Atžalėlės;Ežiukai;6108989129;Taip;4;0;0;4
363;Atžalėlės;Ežiukai;5174826594;Taip;3;0;1;4
364;Atžalėlės;Ežiukai;7501772398;Taip;7;0;0;7
365;Atžalėlės;Paukšteliai;7807313362;Taip;25;0;0;25
366;Atžalėlės;Paukšteliai;6537864486;Taip;9;1;0;10
367;Atžalėlės;Paukšteliai;8768704484;Taip;0;3;5;8
368;Atžalėlės;Paukšteliai;6675588261;Taip;5;3;2;10
369;Atžalėlės;Paukšteliai;8524244526;Taip;10;3;0;13
370;Atžalėlės;Paukšteliai;6873507667;Taip;8;2;0;10
371;Atžalėlės;Paukšteliai;7321516783;Taip;15;0;3;18
372;Atžalėlės;Paukšteliai;6265777690;Taip;7;8;0;15
373;Atžalėlės;Paukšteliai;1844980319;Taip;14;0;0;14
374;Atžalėlės;Paukšteliai;5997958773;Taip;13;0;0;13
375;Atžalėlės;Paukšteliai;8512283024;Taip;22;0;0;22
376;Atžalėlės;Paukšteliai;2078781673;Taip;11;0;0;11
377;Atžalėlės;Paukšteliai;1520206753;Taip;9;3;10;22
378;Atžalėlės;Paukšteliai;4790322154;Taip;7;4;0;11
379;Atžalėlės;Paukšteliai;4081717007;Taip;10;1;0;11
380;Atžalėlės;Paukšteliai;1089221288;Taip;2;0;0;2
381;Atžalėlės;Paukšteliai;7356877676;Taip;4;5;0;9
382;Atžalėlės;Paukšteliai;4392352210;Taip;12;0;2;14
383;Atžalėlės;Paukšteliai;1774212280;Taip;20;0;2;22
384;Atžalėlės;Meškiukai;8586739429;Taip;13;6;0;19
385;Atžalėlės;Meškiukai;9925178685;Taip;10;0;5;15
386;Atžalėlės;Meškiukai;2617568019;Ne;6;1;3;10
387;Atžalėlės;Meškiukai;4233689945;Taip;4;4;0;8
388;Atžalėlės;Meškiukai;8619613890;Taip;13;0;0;13
389;Atžalėlės;Meškiukai;3281114596;Taip;5;16;6;27
390;Atžalėlės;Meškiukai;5466374223;Taip;12;0;1;13
391;Atžalėlės;Meškiukai;2433029299;Taip;13;0;2;15
392;Atžalėlės;Meškiukai;5682652546;Taip;0;0;4;4
393;Atžalėlės;Meškiukai;9631336340;Ne;18;0;0;18
394;Atžalėlės;Meškiukai;2930612059;Ne;22;0;0;22
395;Atžalėlės;Meškiukai;6385777303;Ne;2;0;0;2
396;Atžalėlės;Meškiukai;2569491645;Taip;0;1;0;1
397;Atžalėlės;Meškiukai;1431197358;Taip;9;9;0;18
398;Atžalėlės;Meškiukai;8508450500;Ne;7;0;0;7
399;Atžalėlės;Meškiukai;4177753994;Taip;10;0;0;10
400;Atžalėlės;Meškiukai;3982090601;Taip;5;0;1;6
401;Atžalėlės;Meškiukai;3743308789;Taip;13;1;0;14
402;Atžalėlės;Meškiukai;2228759708;Taip;4;0;2;6
403;Atžalėlės;Meškiukai;7936991925;Taip;13;0;0;13
404;Atžalėlės;Meškiukai;8976815736;Taip;3;6;0;9
405;Atžalėlės;"BITUTĖS (MODULINĖ)";8707875125;Ne;22;0;0;22
406;Atžalėlės;"BITUTĖS (MODULINĖ)";8060332402;Taip;15;0;0;15
407;Atžalėlės;"BITUTĖS (MODULINĖ)";8396693160;Taip;14;0;0;14
408;Atžalėlės;"BITUTĖS (MODULINĖ)";6253257539;Taip;19;0;0;19
409;Atžalėlės;"BITUTĖS (MODULINĖ)";7052938312;Taip;18;0;0;18
410;Atžalėlės;"BITUTĖS (MODULINĖ)";3559977339;Taip;18;0;0;18
411;Atžalėlės;"BITUTĖS (MODULINĖ)";5593774275;Taip;5;3;5;13
412;Atžalėlės;"BITUTĖS (MODULINĖ)";8129858229;Taip;5;0;0;5
413;Atžalėlės;"BITUTĖS (MODULINĖ)";1939076303;Ne;2;5;4;11
414;Atžalėlės;"BITUTĖS (MODULINĖ)";2322329918;Taip;5;0;3;8
415;Atžalėlės;"BITUTĖS (MODULINĖ)";6368553568;Taip;5;3;3;11
416;Atžalėlės;"BITUTĖS (MODULINĖ)";5148142239;Taip;12;0;1;13
417;Atžalėlės;"ŠYPSENĖLĖS (MODULINĖ)";4071402757;Taip;12;0;2;14
418;Atžalėlės;"ŠYPSENĖLĖS (MODULINĖ)";1943349835;Taip;6;3;0;9
419;Atžalėlės;"ŠYPSENĖLĖS (MODULINĖ)";8564143904;Taip;14;0;2;16
420;Atžalėlės;"ŠYPSENĖLĖS (MODULINĖ)";2298114905;Taip;0;0;2;2
421;Atžalėlės;"ŠYPSENĖLĖS (MODULINĖ)";2957870292;Taip;1;0;0;1
422;Atžalėlės;"ŠYPSENĖLĖS (MODULINĖ)";3299724612;Taip;6;4;0;10
423;Atžalėlės;"BORUŽIUKAI (MODULINĖ)";3198845538;Taip;5;0;0;5
424;Atžalėlės;"BORUŽIUKAI (MODULINĖ)";8681809797;Taip;2;1;0;3
425;Atžalėlės;"BORUŽIUKAI (MODULINĖ)";3590987364;Taip;4;0;6;10
426;Atžalėlės;"BORUŽIUKAI (MODULINĖ)";1383944713;Taip;6;2;0;8
427;Atžalėlės;"BORUŽIUKAI (MODULINĖ)";5582697993;Taip;0;1;0;1
428;Atžalėlės;"BORUŽIUKAI (MODULINĖ)";9201449702;Taip;0;0;1;1
429;Atžalėlės;"BORUŽIUKAI (MODULINĖ)";7980775632;Taip;8;2;0;10
430;Atžalėlės;"SAULUTĖS (MODULINĖ)";2291204010;Taip;4;0;0;4
431;Atžalėlės;"SAULUTĖS (MODULINĖ)";1929417022;Taip;9;0;0;9
432;Atžalėlės;"SAULUTĖS (MODULINĖ)";3408850663;Taip;1;0;0;1
433;Atžalėlės;"SAULUTĖS (MODULINĖ)";4268941401;Taip;0;0;14;14
434;Atžalėlės;"SAULUTĖS (MODULINĖ)";1797932125;Taip;8;0;0;8
435;Atžalėlės;"SAULUTĖS (MODULINĖ)";2306086573;Ne;17;0;6;23
436;Atžalėlės;"SAULUTĖS (MODULINĖ)";8385741531;Taip;0;9;13;22
437;Atžalėlės;"SAULUTĖS (MODULINĖ)";8460997063;Taip;14;3;0;17
438;Atžalėlės;"SAULUTĖS (MODULINĖ)";8490088667;Taip;10;0;4;14
439;Atžalėlės;"SAULUTĖS (MODULINĖ)";5490741021;Taip;5;2;0;7
440;Atžalėlės;"SAULUTĖS (MODULINĖ)";1029520016;Taip;1;0;0;1
441;Atžalėlės;"SAULUTĖS (MODULINĖ)";8208908249;Taip;13;1;1;15
442;Atžalėlės;"SAULUTĖS (MODULINĖ)";6048763811;Taip;23;0;4;27
443;Aušrelė;PASAKIUKAI;1659335142;Taip;1;3;0;4
444;Aušrelė;PASAKIUKAI;1327431679;Taip;0;2;0;2
445;Aušrelė;PASAKIUKAI;6037757548;Taip;11;0;0;11
446;Aušrelė;PASAKIUKAI;7682402576;Taip;7;2;0;9
447;Aušrelė;PASAKIUKAI;1408751702;Taip;0;10;0;10
448;Aušrelė;PASAKIUKAI;6995749373;Ne;9;3;0;12
449;Aušrelė;PASAKIUKAI;8372554796;Taip;3;2;0;5
450;Aušrelė;PASAKIUKAI;1502146844;Ne;19;1;0;20
451;Aušrelė;PASAKIUKAI;8341539501;Taip;0;1;0;1
452;Aušrelė;PASAKIUKAI;8230362307;Taip;2;1;5;8
453;Aušrelė;PASAKIUKAI;4306578299;Taip;9;2;1;12
454;Aušrelė;PASAKIUKAI;5777214701;Taip;5;0;0;5
455;Aušrelė;PASAKIUKAI;6277405405;Taip;3;4;0;7
456;Aušrelė;PASAKIUKAI;3682523696;Taip;10;0;0;10
457;Aušrelė;PASAKIUKAI;34891640909;Taip;0;2;0;2
458;Aušrelė;PASAKIUKAI;2125080379;Taip;0;1;4;5
459;Aušrelė;PASAKIUKAI;3165692699;Ne;0;1;0;1
460;Aušrelė;BORUŽĖLĖS;6673034329;Taip;0;12;0;12
461;Aušrelė;BORUŽĖLĖS;4957581753;Taip;0;2;0;2
462;Aušrelė;BORUŽĖLĖS;1928260563;Taip;8;2;0;10
463;Aušrelė;BORUŽĖLĖS;8243716759;Taip;9;2;0;11
464;Aušrelė;BORUŽĖLĖS;1549962200;Taip;0;3;0;3
465;Aušrelė;BORUŽĖLĖS;4505922394;Taip;2;1;0;3
466;Aušrelė;BORUŽĖLĖS;7190665397;Taip;0;1;0;1
467;Aušrelė;BORUŽĖLĖS;2991828434;Taip;5;1;0;6
468;Aušrelė;BORUŽĖLĖS;8030685444;Taip;18;3;0;21
469;Aušrelė;BORUŽĖLĖS;1814972981;Taip;12;3;0;15
470;Aušrelė;BORUŽĖLĖS;3397741232;Taip;0;12;0;12
471;Aušrelė;SMALSUČIAI;6761263775;Taip;9;7;0;16
472;Aušrelė;SMALSUČIAI;3015028879;Taip;0;22;0;22
473;Aušrelė;SMALSUČIAI;5935579452;Taip;7;3;0;10
474;Aušrelė;SMALSUČIAI;2863655361;Taip;14;1;0;15
475;Aušrelė;SMALSUČIAI;2390128933;Taip;6;0;0;6
476;Aušrelė;SMALSUČIAI;8503309819;Taip;0;2;0;2
477;Aušrelė;SMALSUČIAI;2827216981;Taip;0;2;0;2
478;Aušrelė;SMALSUČIAI;9443641849;Taip;0;3;0;3
479;Aušrelė;SMALSUČIAI;7930717076;Taip;2;3;0;5
480;Aušrelė;SMALSUČIAI;7609339123;Taip;0;1;3;4
481;Aušrelė;SMALSUČIAI;1556010005;Taip;0;0;1;1
482;Aušrelė;SMALSUČIAI;5478028396;Taip;0;1;0;1
483;Aušrelė;SMALSUČIAI;7070013052;Taip;22;0;1;23
484;Aušrelė;SMALSUČIAI;3581155949;Taip;3;1;0;4
485;Aušrelė;SMALSUČIAI;6507218940;Taip;0;1;0;1
486;Aušrelė;SMALSUČIAI;2266390402;Taip;0;3;2;5
487;Aušrelė;SMALSUČIAI;8032661062;Taip;0;0;4;4
488;Aušrelė;SMALSUČIAI;4262596104;Taip;8;3;0;11
489;Aušrelė;SMALSUČIAI;1976613166;Taip;0;3;2;5
490;Aušrelė;KODĖLČIUKAI;7723159748;Taip;14;0;0;14
491;Aušrelė;KODĖLČIUKAI;7367268748;Taip;2;4;0;6
492;Aušrelė;KODĖLČIUKAI;3623813061;Taip;8;2;0;10
493;Aušrelė;KODĖLČIUKAI;4288695809;Taip;8;3;0;11
494;Aušrelė;KODĖLČIUKAI;8693750994;Taip;13;0;0;13
495;Aušrelė;KODĖLČIUKAI;7327544406;Taip;0;1;0;1
496;Aušrelė;KODĖLČIUKAI;9566144610;Taip;1;3;6;10
497;Aušrelė;KODĖLČIUKAI;6308519574;Ne;2;1;0;3
498;Aušrelė;KODĖLČIUKAI;3320399046;Ne;8;3;0;11
499;Aušrelė;KODĖLČIUKAI;6911735462;Taip;10;3;0;13
500;Aušrelė;KODĖLČIUKAI;4248808572;Taip;6;22;0;28
501;Aušrelė;KODĖLČIUKAI;5046027475;Taip;2;1;0;3
502;Aušrelė;KODĖLČIUKAI;8338569001;Taip;17;2;0;19
503;Aušrelė;KODĖLČIUKAI;2766357229;Ne;18;3;0;21
504;Aušrelė;KODĖLČIUKAI;7515666888;Taip;8;0;3;11
505;Aušrelė;KODĖLČIUKAI;8862488358;Taip;10;2;0;12
506;Aušrelė;KODĖLČIUKAI;4882556718;Taip;16;3;1;20
507;Aušrelė;KODĖLČIUKAI;6321332888;Taip;0;2;3;5
508;Aušrelė;PELĖDŽIUKAI;4725588671;Taip;10;1;0;11
509;Aušrelė;PELĖDŽIUKAI;3223092149;Taip;0;19;0;19
510;Aušrelė;PELĖDŽIUKAI;8580241126;Taip;0;0;4;4
511;Aušrelė;PELĖDŽIUKAI;2545065554;Taip;10;1;0;11
512;Aušrelė;PELĖDŽIUKAI;4227228548;Taip;0;8;0;8
513;Aušrelė;PELĖDŽIUKAI;8996445434;Taip;0;8;0;8
514;Aušrelė;PELĖDŽIUKAI;8411336992;Taip;12;1;1;14
515;Aušrelė;PELĖDŽIUKAI;8917907028;Taip;2;0;0;2
516;Aušrelė;PELĖDŽIUKAI;7494298336;Ne;19;1;0;20
517;Aušrelė;PELĖDŽIUKAI;4012186237;Taip;6;0;3;9
518;Aušrelė;PELĖDŽIUKAI;5312189552;Taip;0;7;1;8
519;Aušrelė;PELĖDŽIUKAI;1642358593;Ne;9;0;1;10
520;Aušrelė;PELĖDŽIUKAI;2294224426;Taip;8;1;0;9
521;Aušrelė;PELĖDŽIUKAI;1276792874;Taip;0;0;6;6
522;Aušrelė;AITVARIUKAI;6833654667;Taip;0;2;1;3
523;Aušrelė;AITVARIUKAI;8102749675;Ne;0;5;0;5
524;Aušrelė;AITVARIUKAI;4595435635;Taip;8;0;0;8
525;Aušrelė;AITVARIUKAI;9608444990;Taip;9;0;0;9
526;Aušrelė;AITVARIUKAI;6434548772;Taip;17;0;1;18
527;Aušrelė;AITVARIUKAI;9158248746;Taip;12;1;0;13
528;Aušrelė;AITVARIUKAI;7978186455;Taip;0;22;0;22
529;Aušrelė;AITVARIUKAI;5708459561;Taip;8;0;0;8
530;Aušrelė;AITVARIUKAI;1039180129;Taip;13;0;0;13
531;Aušrelė;AITVARIUKAI;3807967685;Taip;0;0;1;1
532;Aušrelė;AITVARIUKAI;6081100604;Ne;0;3;0;3
533;Aušrelė;AITVARIUKAI;7847650967;Taip;0;4;0;4
534;Aušrelė;AITVARIUKAI;5727081833;Ne;0;4;0;4
535;Aušrelė;AITVARIUKAI;8210698019;Taip;0;22;0;22
536;Aušrelė;AITVARIUKAI;4942168388;Ne;0;22;0;22
537;Aušrelė;AITVARIUKAI;7788139791;Taip;0;9;0;9
538;Aušrelė;AITVARIUKAI;6701969308;Taip;8;0;0;8
539;Aušrelė;BITUTĖS;1741716341;Taip;0;22;0;22
540;Aušrelė;BITUTĖS;9960201865;Taip;0;3;0;3
541;Aušrelė;BITUTĖS;2071674661;Ne;0;22;0;22
542;Aušrelė;BITUTĖS;1450827353;Taip;5;0;0;5
543;Aušrelė;BITUTĖS;5598494461;Taip;3;0;0;3
544;Aušrelė;BITUTĖS;4935192851;Ne;0;10;0;10
545;Aušrelė;BITUTĖS;9505496063;Ne;2;5;0;7
546;Aušrelė;BITUTĖS;1931955562;Taip;0;1;1;2
547;Aušrelė;BITUTĖS;5614774250;Ne;0;5;0;5
548;Aušrelė;BITUTĖS;6591538425;Taip;15;18;0;33
549;Aušrelė;BITUTĖS;8203256528;Taip;0;22;0;22
550;Aušrelė;BITUTĖS;5741252819;Taip;0;22;0;22
551;Aušrelė;BITUTĖS;1243825974;Taip;0;2;0;2
552;Aušrelė;BITUTĖS;2468245186;Taip;0;1;0;1
553;Aušrelė;BITUTĖS;5266959731;Taip;7;1;1;9
554;Aušrelė;ŽIRNIUKAI;1949809977;Taip;3;0;0;3
555;Aušrelė;ŽIRNIUKAI;9733877752;Taip;0;3;0;3
556;Aušrelė;ŽIRNIUKAI;2221714044;Taip;15;1;1;17
557;Aušrelė;ŽIRNIUKAI;1544869163;Ne;4;0;0;4
558;Aušrelė;ŽIRNIUKAI;6577540623;Taip;4;1;0;5
559;Aušrelė;ŽIRNIUKAI;5460833944;Taip;22;0;0;22
560;Aušrelė;ŽIRNIUKAI;6372004855;Taip;0;1;0;1
561;Aušrelė;ŽIRNIUKAI;3713528812;Taip;23;1;0;24
562;Aušrelė;ŽIRNIUKAI;2107898976;Ne;23;0;0;23
563;Aušrelė;ŽIRNIUKAI;1607338052;Taip;6;3;0;9
564;Aušrelė;ŽIRNIUKAI;8573348956;Taip;0;22;0;22
565;Aušrelė;ŽIRNIUKAI;6463141345;Taip;2;2;0;4
566;Aušrelė;ŽIRNIUKAI;1798478023;Ne;15;0;0;15
567;Aušrelė;ŽIRNIUKAI;1754138341;Taip;0;13;0;13
568;Aušrelė;ŽIRNIUKAI;6913824678;Taip;10;2;0;12
569;Aušrelė;ŽIRNIUKAI;8797157671;Taip;16;0;0;16
570;Aušrelė;ŽIRNIUKAI;4591518039;Ne;0;4;0;4
571;Aušrelė;ŽIRNIUKAI;8126701466;Taip;6;6;0;12
572;Aušrelė;GRYBUKAI;7406063630;Taip;5;0;0;5
573;Aušrelė;GRYBUKAI;9938762910;Taip;6;0;0;6
574;Aušrelė;GRYBUKAI;1463724119;Taip;9;2;0;11
575;Aušrelė;GRYBUKAI;8438945369;Taip;0;3;0;3
576;Aušrelė;GRYBUKAI;6672975558;Taip;0;7;2;9
577;Aušrelė;GRYBUKAI;4565813136;Taip;0;13;0;13
578;Aušrelė;GRYBUKAI;9877307844;Taip;21;0;1;22
579;Aušrelė;GRYBUKAI;8947695521;Taip;4;0;1;5
580;Aušrelė;GRYBUKAI;7130040621;Taip;0;1;2;3
581;Aušrelė;GRYBUKAI;2311552230;Taip;6;0;0;6
582;Aušrelė;GRYBUKAI;1458580523;Taip;13;0;0;13
583;Aušrelė;GRYBUKAI;1871799626;Taip;2;0;1;3
584;Aušrelė;GRYBUKAI;5733298006;Taip;11;1;0;12
585;Aušrelė;GRYBUKAI;4924950592;Ne;9;0;0;9
586;Aušrelė;GRYBUKAI;2466858636;Taip;0;22;0;22
587;Aušrelė;GRYBUKAI;2873845920;Taip;3;1;0;4
588;Aušrelė;GRYBUKAI;5904797250;Taip;16;0;0;16
589;Aušrelė;DRUGELIAI;9763241451;Ne;10;0;0;10
590;Aušrelė;DRUGELIAI;1209824814;Taip;13;2;1;16
591;Aušrelė;DRUGELIAI;7948024164;Taip;7;0;0;7
592;Aušrelė;DRUGELIAI;5429867368;Ne;0;11;0;11
593;Aušrelė;DRUGELIAI;3831695455;Ne;0;22;0;22
594;Aušrelė;DRUGELIAI;2737402297;Ne;0;0;2;2
595;Aušrelė;DRUGELIAI;3813270658;Ne;0;6;0;6
596;Aušrelė;DRUGELIAI;4254737302;Taip;15;0;0;15
597;Aušrelė;DRUGELIAI;4464947621;Taip;20;2;1;23
598;Aušrelė;DRUGELIAI;9126040500;Taip;5;3;0;8
599;Aušrelė;DRUGELIAI;7286960315;Taip;23;10;0;33
600;Aušrelė;DRUGELIAI;8102293098;Taip;0;1;0;1
601;Aušrelė;DRUGELIAI;2266835623;Taip;0;6;0;6
602;Aušrelė;DRUGELIAI;1094141305;Taip;20;0;0;20
603;Aušrelė;DRUGELIAI;9514049590;Taip;3;0;0;3
604;Aušrelė;DRUGELIAI;5709799539;Taip;11;0;0;11
605;Aušrelė;DRUGELIAI;8724802289;Taip;12;0;0;12
606;Aušrelė;DRUGELIAI;5815844340;Ne;17;0;0;17
607;Aušrelė;DRUGELIAI;5668908532;Taip;0;0;1;1
608;Aušrelė;NYKŠTUKAI;9914518299;Taip;14;0;0;14
609;Aušrelė;NYKŠTUKAI;8427699400;Taip;0;1;0;1
610;Aušrelė;NYKŠTUKAI;4297417711;Taip;10;1;0;11
611;Aušrelė;NYKŠTUKAI;4004600465;Taip;0;6;0;6
612;Aušrelė;NYKŠTUKAI;7964156691;Taip;0;7;0;7
613;Aušrelė;NYKŠTUKAI;7140465960;Taip;6;0;0;6
614;Aušrelė;NYKŠTUKAI;7937067384;Taip;0;2;0;2
615;Aušrelė;NYKŠTUKAI;8099338305;Taip;8;0;0;8
616;Aušrelė;NYKŠTUKAI;6513026989;Taip;3;0;0;3
617;Aušrelė;NYKŠTUKAI;4282189556;Taip;13;0;0;13
618;Aušrelė;NYKŠTUKAI;4252475967;Ne;0;6;0;6
619;Aušrelė;NYKŠTUKAI;8378225406;Taip;10;5;0;15
620;Aušrelė;NYKŠTUKAI;5018495543;Taip;10;1;0;11
621;Aušrelė;NYKŠTUKAI;3259828075;Taip;0;8;0;8
622;Aušrelė;NYKŠTUKAI;4952876188;Taip;5;4;0;9
623;Aušrelė;SPINDULIUKAI;8848358559;Taip;5;0;0;5
624;Aušrelė;SPINDULIUKAI;3194122285;Taip;9;13;0;22
625;Aušrelė;SPINDULIUKAI;5358736178;Taip;11;0;0;11
626;Aušrelė;SPINDULIUKAI;8801906679;Taip;14;2;0;16
627;Aušrelė;SPINDULIUKAI;7208341200;Ne;0;22;0;22
628;Aušrelė;SPINDULIUKAI;1446194971;Taip;0;16;0;16
629;Aušrelė;SPINDULIUKAI;2319188134;Taip;5;0;0;5
630;Aušrelė;SPINDULIUKAI;9251919940;Taip;0;0;22;22
631;Aušrelė;SPINDULIUKAI;8997650487;Taip;0;0;4;4
632;Aušrelė;SPINDULIUKAI;1805615293;Taip;9;3;0;12
633;Aušrelė;SPINDULIUKAI;7966060521;Taip;10;2;0;12
634;Aušrelė;SPINDULIUKAI;5866673884;Ne;0;2;1;3
635;Aušrelė;SPINDULIUKAI;6418762623;Taip;0;3;0;3
636;Aušrelė;SPINDULIUKAI;8835689988;Ne;5;2;0;7
637;Aušrelė;SPINDULIUKAI;5274919078;Taip;0;2;0;2
638;Aušrelė;SPINDULIUKAI;2981314491;Taip;9;0;0;9
639;Aušrelė;SPINDULIUKAI;2441221298;Taip;7;22;0;29
640;Beržynėlis;SVIRPLIUKAI;7360345539;Taip;18;0;0;18
641;Beržynėlis;SVIRPLIUKAI;4134371415;Taip;7;1;0;8
642;Beržynėlis;SVIRPLIUKAI;7278860816;Taip;3;1;0;4
643;Beržynėlis;SVIRPLIUKAI;4013099670;Taip;12;2;0;14
644;Beržynėlis;SVIRPLIUKAI;8404801225;Taip;11;0;0;11
645;Beržynėlis;SVIRPLIUKAI;8303684788;Taip;11;5;0;16
646;Beržynėlis;SVIRPLIUKAI;7953957525;Taip;11;3;0;14
647;Beržynėlis;SVIRPLIUKAI;3841363368;Taip;1;0;0;1
648;Beržynėlis;SVIRPLIUKAI;3418730586;Ne;2;1;0;3
649;Beržynėlis;SVIRPLIUKAI;1468551784;Taip;5;5;0;10
650;Beržynėlis;SVIRPLIUKAI;2221708263;Taip;11;3;0;14
651;Beržynėlis;SVIRPLIUKAI;8880151537;Taip;10;0;0;10
652;Beržynėlis;SVIRPLIUKAI;6516665294;Ne;10;4;0;14
653;Beržynėlis;SVIRPLIUKAI;9580286493;Taip;5;1;0;6
654;Beržynėlis;SVIRPLIUKAI;6673910279;Taip;14;0;0;14
655;Beržynėlis;SVIRPLIUKAI;8701990625;Taip;4;0;0;4
656;Beržynėlis;SVIRPLIUKAI;5027712732;Taip;15;2;0;17
657;Beržynėlis;SVIRPLIUKAI;7555487759;Taip;7;2;0;9
658;Beržynėlis;SVIRPLIUKAI;7788532819;Taip;20;0;0;20
659;Beržynėlis;SVIRPLIUKAI;3315079004;Taip;7;0;0;7
660;Beržynėlis;SVIRPLIUKAI;8533912024;Taip;18;3;0;21
661;Beržynėlis;PELEDŽIUKAI;3278699117;Taip;5;1;0;6
662;Beržynėlis;PELEDŽIUKAI;1516309509;Taip;9;3;1;13
663;Beržynėlis;PELEDŽIUKAI;1395819329;Taip;7;0;0;7
664;Beržynėlis;PELEDŽIUKAI;1838631438;Taip;5;0;0;5
665;Beržynėlis;PELEDŽIUKAI;9566341884;Taip;3;3;0;6
666;Beržynėlis;PELEDŽIUKAI;1682929565;Taip;0;0;5;5
667;Beržynėlis;PELEDŽIUKAI;7248602510;Ne;8;2;2;12
668;Beržynėlis;PELEDŽIUKAI;2681482042;Taip;0;5;3;8
669;Beržynėlis;PELEDŽIUKAI;5196910604;Taip;10;0;0;10
670;Beržynėlis;PELEDŽIUKAI;7649359221;Taip;10;0;0;10
671;Beržynėlis;PELEDŽIUKAI;6395436937;Taip;0;10;0;10
672;Beržynėlis;PELEDŽIUKAI;3641421009;Taip;16;1;0;17
673;Beržynėlis;PELEDŽIUKAI;2791734213;Taip;0;2;8;10
674;Beržynėlis;PELEDŽIUKAI;1136091326;Taip;6;0;0;6
675;Beržynėlis;PELEDŽIUKAI;71505149611;Taip;0;2;2;4
676;Beržynėlis;PELEDŽIUKAI;1639928056;Taip;5;2;0;7
677;Beržynėlis;PELEDŽIUKAI;1176943273;Taip;3;1;2;6
678;Beržynėlis;PELEDŽIUKAI;7929997884;Ne;9;5;0;14
679;Beržynėlis;PELEDŽIUKAI;8688852668;Taip;9;1;0;10
680;Beržynėlis;ŽIOGELIAI;5308596559;Taip;4;5;0;9
681;Beržynėlis;ŽIOGELIAI;4035764376;Taip;0;1;0;1
682;Beržynėlis;ŽIOGELIAI;4970999989;Taip;5;0;0;5
683;Beržynėlis;ŽIOGELIAI;1325972861;Taip;5;0;6;11
684;Beržynėlis;ŽIOGELIAI;9088059487;Taip;1;2;0;3
685;Beržynėlis;ŽIOGELIAI;5473666098;Taip;0;3;4;7
686;Beržynėlis;ŽIOGELIAI;7589778533;Taip;6;1;0;7
687;Beržynėlis;ŽIOGELIAI;8591800387;Taip;5;2;0;7
688;Beržynėlis;ŽIOGELIAI;6739927917;Ne;7;2;0;9
689;Beržynėlis;ŽIOGELIAI;2971686368;Taip;15;2;0;17
690;Beržynėlis;ŽIOGELIAI;9409317403;Taip;3;2;0;5
691;Beržynėlis;ŽIOGELIAI;9305279614;Taip;14;1;0;15
692;Beržynėlis;ŽIOGELIAI;9511051386;Taip;0;2;4;6
693;Beržynėlis;ŽIOGELIAI;8114761925;Taip;2;0;6;8
694;Beržynėlis;ŽIOGELIAI;5856519538;Taip;6;11;0;17
695;Beržynėlis;ŽIOGELIAI;3339522259;Ne;0;2;5;7
696;Beržynėlis;ŽIOGELIAI;6337962165;Taip;4;5;0;9
697;Beržynėlis;ŽIOGELIAI;6864823739;Taip;0;5;9;14
698;Beržynėlis;ŽIOGELIAI;9896122318;Ne;0;2;6;8
699;Beržynėlis;ŽIOGELIAI;3484188772;Ne;0;0;7;7
700;Beržynėlis;ŽVIRBLIUKAI;2193460960;Taip;13;0;0;13
701;Beržynėlis;ŽVIRBLIUKAI;2482395208;Taip;13;0;0;13
702;Beržynėlis;ŽVIRBLIUKAI;7057284039;Ne;5;2;0;7
703;Beržynėlis;ŽVIRBLIUKAI;2892553878;Taip;4;2;0;6
704;Beržynėlis;ŽVIRBLIUKAI;4466393687;Taip;0;3;0;3
705;Beržynėlis;ŽVIRBLIUKAI;4774769217;Taip;0;10;3;13
706;Beržynėlis;ŽVIRBLIUKAI;9503352345;Taip;18;0;0;18
707;Beržynėlis;ŽVIRBLIUKAI;8881566865;Taip;0;0;9;9
708;Beržynėlis;ŽVIRBLIUKAI;8280378527;Taip;0;4;0;4
709;Beržynėlis;ŽVIRBLIUKAI;6713134631;Taip;0;2;0;2
710;Beržynėlis;ŽVIRBLIUKAI;5593146590;Taip;6;1;0;7
711;Beržynėlis;ŽVIRBLIUKAI;9754455116;Taip;8;0;0;8
712;Beržynėlis;ŽVIRBLIUKAI;3334994408;Taip;8;4;0;12
713;Beržynėlis;ŽVIRBLIUKAI;9777841895;Taip;4;0;0;4
714;Beržynėlis;ŽVIRBLIUKAI;4161974847;Ne;11;3;0;14
715;Beržynėlis;ŽVIRBLIUKAI;3209966996;Taip;9;3;1;13
716;Beržynėlis;ŽVIRBLIUKAI;5194416351;Taip;9;4;0;13
717;Beržynėlis;ŽVIRBLIUKAI;1228384088;Taip;5;3;0;8
718;Beržynėlis;ŽVIRBLIUKAI;5189335842;Taip;0;2;0;2
719;Beržynėlis;ŽIRNIUKAI;6932094459;Taip;4;2;0;6
720;Beržynėlis;ŽIRNIUKAI;5864265458;Taip;14;3;0;17
721;Beržynėlis;ŽIRNIUKAI;2583982025;Taip;0;5;0;5
722;Beržynėlis;ŽIRNIUKAI;7870888327;Taip;9;0;0;9
723;Beržynėlis;ŽIRNIUKAI;1558469002;Taip;14;0;0;14
724;Beržynėlis;ŽIRNIUKAI;9603272698;Taip;22;0;0;22
725;Beržynėlis;ŽIRNIUKAI;9493489114;Taip;22;0;0;22
726;Beržynėlis;ŽIRNIUKAI;4786786104;Taip;9;3;0;12
727;Beržynėlis;ŽIRNIUKAI;4944466205;Taip;14;1;0;15
728;Beržynėlis;ŽIRNIUKAI;6392773584;Taip;9;2;0;11
729;Beržynėlis;ŽIRNIUKAI;2155662035;Taip;14;1;0;15
730;Beržynėlis;ŽIRNIUKAI;4978363316;Taip;17;2;0;19
731;Beržynėlis;ŽIRNIUKAI;6845342905;Taip;2;0;0;2
732;Beržynėlis;ŽIRNIUKAI;7806800327;Ne;20;0;0;20
733;Beržynėlis;VIŠČIUKAI;7016454952;Taip;18;0;0;18
734;Beržynėlis;VIŠČIUKAI;7903644161;Taip;3;4;5;12
735;Beržynėlis;VIŠČIUKAI;1707585750;Taip;11;0;0;11
736;Beržynėlis;VIŠČIUKAI;4382068779;Taip;11;0;1;12
737;Beržynėlis;VIŠČIUKAI;2272661119;Taip;14;2;0;16
738;Beržynėlis;VIŠČIUKAI;1831776326;Taip;21;0;0;21
739;Beržynėlis;VIŠČIUKAI;1118349439;Taip;4;0;0;4
740;Beržynėlis;VIŠČIUKAI;4369803044;Taip;13;1;0;14
741;Beržynėlis;VIŠČIUKAI;1503903200;Taip;10;0;0;10
742;Beržynėlis;VIŠČIUKAI;7972993168;Taip;12;0;0;12
743;Beržynėlis;VIŠČIUKAI;5049057730;Taip;17;0;0;17
744;Beržynėlis;VIŠČIUKAI;7084666673;Taip;2;1;0;3
745;Beržynėlis;VIŠČIUKAI;6592330036;Taip;14;0;0;14
746;Beržynėlis;VIŠČIUKAI;3100097647;Taip;0;0;22;22
747;Birutės;SKRUZDELIUKŲ;4968068043;Taip;3;0;1;4
748;Birutės;SKRUZDELIUKŲ;1761065941;Taip;7;6;1;14
749;Birutės;SKRUZDELIUKŲ;9610268046;Taip;8;0;0;8
750;Birutės;SKRUZDELIUKŲ;4027700332;Taip;6;0;0;6
751;Birutės;SKRUZDELIUKŲ;7685356079;Taip;3;0;1;4
752;Birutės;SKRUZDELIUKŲ;1105133326;Taip;5;1;14;20
753;Birutės;SKRUZDELIUKŲ;8636113039;Taip;0;4;0;4
754;Birutės;SKRUZDELIUKŲ;9411016611;Taip;0;2;0;2
755;Birutės;SKRUZDELIUKŲ;7119951690;Taip;6;5;0;11
756;Birutės;SKRUZDELIUKŲ;5154903444;Taip;2;1;0;3
757;Birutės;SKRUZDELIUKŲ;9541516589;Taip;0;0;4;4
758;Birutės;SKRUZDELIUKŲ;6815916679;Taip;6;1;0;7
759;Birutės;SKRUZDELIUKŲ;9187671201;Ne;11;0;0;11
760;Birutės;SKRUZDELIUKŲ;7404631298;Taip;14;0;0;14
761;Birutės;SKRUZDELIUKŲ;8432173636;Taip;15;1;0;16
762;Birutės;SKRUZDELIUKŲ;9904827482;Taip;5;2;0;7
763;Birutės;SKRUZDELIUKŲ;2140552221;Ne;0;0;2;2
764;Birutės;SKRUZDELIUKŲ;8413760872;Taip;15;3;0;18
765;Birutės;SKRUZDELIUKŲ;7940403585;Taip;9;1;0;10
766;Birutės;SKRUZDELIUKŲ;2859160609;Taip;2;4;0;6
767;Birutės;SKRUZDELIUKŲ;7251592439;Taip;3;0;0;3
768;Birutės;SKRUZDELIUKŲ;4375683234;Ne;5;1;1;7
769;Birutės;BITUČIŲ;1599159924;Ne;5;1;0;6
770;Birutės;BITUČIŲ;33770983649;Taip;0;18;0;18
771;Birutės;BITUČIŲ;87693588654;Taip;4;1;0;5
772;Birutės;BITUČIŲ;1234596925;Taip;7;0;0;7
773;Birutės;BITUČIŲ;5770026060;Taip;9;0;0;9
774;Birutės;BITUČIŲ;98391790116;Taip;7;0;2;9
775;Birutės;BITUČIŲ;5947971037;Taip;4;7;0;11
776;Birutės;BITUČIŲ;3870702348;Taip;4;3;0;7
777;Birutės;BITUČIŲ;3436637062;Taip;6;0;0;6
778;Birutės;BITUČIŲ;8465645434;Taip;13;0;5;18
779;Birutės;BITUČIŲ;9722922540;Taip;5;1;1;7
780;Birutės;BITUČIŲ;3061210677;Taip;5;1;0;6
781;Birutės;BITUČIŲ;6431396285;Taip;11;0;0;11
782;Birutės;BITUČIŲ;6081472534;Taip;6;1;0;7
783;Birutės;BITUČIŲ;2674259453;Taip;0;1;3;4
784;Birutės;BITUČIŲ;17865476849;Taip;14;0;0;14
785;Birutės;BITUČIŲ;2329522074;Taip;6;1;0;7
786;Birutės;BITUČIŲ;5164196372;Taip;4;0;1;5
787;Birutės;BITUČIŲ;6006110601;Taip;0;5;0;5
788;Birutės;BITUČIŲ;1243603625;Ne;7;0;0;7
789;Birutės;BITUČIŲ;4253571334;Taip;4;1;0;5
790;Birutės;BITUČIŲ;1447494370;Taip;2;1;2;5
791;Birutės;BORUŽIUKAI;5893851353;Taip;0;1;1;2
792;Birutės;BORUŽIUKAI;5457357625;Taip;11;0;0;11
793;Birutės;BORUŽIUKAI;5869137292;Taip;4;0;2;6
794;Birutės;BORUŽIUKAI;5026442722;Taip;10;1;0;11
795;Birutės;BORUŽIUKAI;6977276295;Taip;8;10;0;18
796;Birutės;BORUŽIUKAI;9289922622;Taip;0;0;1;1
797;Birutės;BORUŽIUKAI;1776142202;Taip;0;0;2;2
798;Birutės;BORUŽIUKAI;8011210158;Taip;4;0;0;4
799;Birutės;BORUŽIUKAI;4906874758;Taip;0;2;1;3
800;Birutės;BORUŽIUKAI;9263238557;Taip;0;6;0;6
801;Birutės;BORUŽIUKAI;4488481136;Taip;4;6;0;10
802;Birutės;BORUŽIUKAI;6460415179;Taip;0;2;0;2
803;Birutės;BORUŽIUKAI;6973898557;Taip;4;0;0;4
804;Birutės;BORUŽIUKAI;7033907787;Taip;8;0;1;9
805;Birutės;BORUŽIUKAI;5745377474;Taip;4;1;3;8
806;Birutės;BORUŽIUKAI;5897671273;Taip;4;0;6;10
807;Birutės;BORUŽIUKAI;2016711225;Taip;7;0;2;9
808;Birutės;BORUŽIUKAI;1400510886;Taip;3;0;0;3
809;Birutės;BORUŽIUKAI;7494879160;Ne;0;3;0;3
810;Birutės;BORUŽIUKAI;5875585426;Taip;0;0;1;1
811;Birutės;BORUŽIUKAI;7398022393;Taip;5;0;0;5
812;Birutės;BORUŽIUKAI;7712882120;Taip;10;0;0;10
813;Birutės;BORUŽIUKAI;7741922416;Taip;0;8;0;8
814;Birutės;BORUŽIUKAI;2681370776;Taip;9;0;0;9
815;Birutės;DRUGELIAI;8854957814;Taip;0;0;12;12
816;Birutės;DRUGELIAI;6263985683;Taip;18;0;0;18
817;Birutės;DRUGELIAI;4995437657;Ne;4;0;5;9
818;Birutės;DRUGELIAI;5957267018;Taip;3;0;3;6
819;Birutės;DRUGELIAI;1442496209;Taip;6;1;0;7
820;Birutės;DRUGELIAI;2318034045;Taip;14;0;0;14
821;Birutės;DRUGELIAI;9727836236;Ne;10;0;0;10
822;Birutės;DRUGELIAI;3516719248;Taip;0;0;3;3
823;Birutės;DRUGELIAI;5688633357;Ne;0;1;11;12
824;Birutės;DRUGELIAI;8559820030;Taip;0;0;17;17
825;Birutės;DRUGELIAI;9863681147;Taip;0;0;7;7
826;Birutės;DRUGELIAI;9307655828;Ne;17;0;0;17
827;Birutės;DRUGELIAI;3115571205;Taip;8;0;2;10
828;Birutės;DRUGELIAI;4674152995;Taip;9;0;0;9
829;Birutės;DRUGELIAI;5177528200;Taip;9;0;1;10
830;Birutės;DRUGELIAI;3391101786;Taip;6;0;1;7
831;Birutės;DRUGELIAI;7876057712;Taip;0;5;1;6
832;Birutės;DRUGELIAI;6765257633;Taip;14;0;0;14
833;Birutės;DRUGELIAI;2257683802;Taip;0;0;2;2
834;Birutės;DRUGELIAI;7336936451;Taip;0;12;2;14
835;Bitutė;Aitvariukų;4474600934;Taip;0;0;5;5
836;Bitutė;Aitvariukų;5606049201;Taip;0;5;0;5
837;Bitutė;Aitvariukų;6035394425;Taip;6;1;0;7
838;Bitutė;Aitvariukų;7132616264;Taip;0;13;0;13
839;Bitutė;Aitvariukų;8796728627;Ne;4;2;0;6
840;Bitutė;Aitvariukų;6030674568;Taip;14;1;0;15
841;Bitutė;Aitvariukų;9747786638;Taip;12;0;1;13
842;Bitutė;Aitvariukų;8259512455;Taip;15;0;1;16
843;Bitutė;Aitvariukų;9106644834;Taip;0;12;0;12
844;Bitutė;Aitvariukų;8670124052;Taip;6;0;0;6
845;Bitutė;Aitvariukų;6759511692;Taip;3;0;1;4
846;Bitutė;Aitvariukų;8908052679;Taip;0;10;0;10
847;Bitutė;Aitvariukų;4924483609;Taip;4;9;0;13
848;Bitutė;Aitvariukų;7447624247;Taip;0;10;0;10
849;Bitutė;Aitvariukų;5880651175;Taip;0;1;0;1
850;Bitutė;Ežiukų;56287634684;Taip;13;1;0;14
851;Bitutė;Ežiukų;5126303823;Taip;1;7;5;13
852;Bitutė;Ežiukų;4764586168;Taip;15;1;2;18
853;Bitutė;Ežiukų;8905075899;Taip;8;0;4;12
854;Bitutė;Ežiukų;6341806464;Ne;6;11;1;18
855;Bitutė;Ežiukų;50869152455;Taip;0;1;3;4
856;Bitutė;Ežiukų;7456328992;Ne;0;5;1;6
857;Bitutė;Ežiukų;2812580726;Ne;15;5;1;21
858;Bitutė;Ežiukų;8186706520;Ne;6;22;0;28
859;Bitutė;Ežiukų;1904108612;Taip;4;4;0;8
860;Bitutė;Ežiukų;5378885117;Taip;0;3;5;8
861;Bitutė;Ežiukų;2122052883;Taip;6;4;1;11
862;Bitutė;Ežiukų;4444523140;Taip;10;11;2;23
863;Bitutė;Ežiukų;4024758152;Taip;0;3;0;3
864;Bitutė;Ežiukų;4468366941;Taip;17;0;1;18
865;Bitutė;Ežiukų;5188828679;Taip;11;2;0;13
866;Bitutė;Ežiukų;8109028957;Taip;11;2;0;13
867;Bitutė;Ežiukų;3156654672;Taip;15;3;1;19
868;Bitutė;Žvirbliukų;7047262367;Taip;0;1;2;3
869;Bitutė;Žvirbliukų;3804171750;Taip;10;3;0;13
870;Bitutė;Žvirbliukų;8545377054;Taip;5;3;0;8
871;Bitutė;Žvirbliukų;5406667195;Taip;15;2;0;17
872;Bitutė;Žvirbliukų;4458990772;Taip;15;2;0;17
873;Bitutė;Žvirbliukų;3723040682;Taip;0;3;0;3
874;Bitutė;Žvirbliukų;2190439190;Taip;5;5;0;10
875;Bitutė;Žvirbliukų;7113693496;Taip;16;0;0;16
876;Bitutė;Žvirbliukų;2483462846;Taip;13;2;0;15
877;Bitutė;Žvirbliukų;7678106084;Taip;15;0;0;15
878;Bitutė;Žvirbliukų;6044969600;Taip;8;6;0;14
879;Bitutė;Žvirbliukų;2444289145;Taip;5;1;0;6
880;Bitutė;Žvirbliukų;3517750478;Taip;6;2;0;8
881;Bitutė;Žvirbliukų;5291764696;Taip;14;3;0;17
882;Bitutė;Žvirbliukų;9523588597;Taip;5;1;1;7
883;Bitutė;Žvirbliukų;3654065124;Taip;5;0;1;6
884;Bitutė;Žvirbliukų;9166624750;Taip;0;7;4;11
885;Bitutė;Žvirbliukų;8373105196;Taip;14;4;2;20
886;Bitutė;Žvirbliukų;6014726741;Taip;5;11;0;16
887;Bitutė;Žvirbliukų;4527880105;Taip;15;3;1;19
888;Bitutė;Žvirbliukų;9834697190;Taip;9;0;0;9
889;Bitutė;Gandriukų;8519978626;Ne;0;0;8;8
890;Bitutė;Gandriukų;1809034174;Ne;9;7;2;18
891;Bitutė;Gandriukų;6586888742;Taip;5;6;4;15
892;Bitutė;Gandriukų;5783154071;Ne;0;6;0;6
893;Bitutė;Gandriukų;7387822939;Ne;0;1;0;1
894;Bitutė;Gandriukų;6052204491;Ne;7;3;0;10
895;Bitutė;Gandriukų;37105491775;Taip;10;3;0;13
896;Bitutė;Gandriukų;90943054285;Taip;0;6;0;6
897;Bitutė;Gandriukų;6659750060;Ne;7;1;0;8
898;Bitutė;Gandriukų;9683582019;Taip;9;3;0;12
899;Bitutė;Gandriukų;11567978993;Taip;19;3;0;22
900;Bitutė;Gandriukų;7352524951;Taip;0;8;0;8
901;Bitutė;Gandriukų;2350260809;Taip;8;1;0;9
902;Bitutė;Gandriukų;27144303911;Taip;8;3;0;11
903;Bitutė;Gandriukų;1942685472;Taip;0;7;0;7
904;Bitutė;Gandriukų;1307749129;Taip;0;7;0;7
905;Bitutė;Gandriukų;5653055907;Taip;4;6;0;10
906;Bitutė;Gandriukų;6678928989;Ne;8;3;0;11
907;Bitutė;Gandriukų;1802887869;Taip;6;10;0;16
908;Bitutė;Gandriukų;51054491845;Taip;7;3;0;10
909;Bitutė;Gandriukų;4574673585;Taip;6;2;0;8
910;Bitutė;Gandriukų;47316276655;Taip;0;13;0;13
911;Bitutė;Pelėdžiukai;3254061362;Taip;0;3;0;3
912;Bitutė;Pelėdžiukai;5455919343;Taip;0;4;0;4
913;Bitutė;Pelėdžiukai;8743734366;Taip;10;3;0;13
914;Bitutė;Pelėdžiukai;6674923740;Taip;0;1;0;1
915;Bitutė;Pelėdžiukai;2804203556;Taip;5;3;0;8
916;Bitutė;Pelėdžiukai;8394685672;Taip;14;2;0;16
917;Bitutė;Pelėdžiukai;7056737587;Taip;5;0;0;5
918;Bitutė;Pelėdžiukai;4985270536;Taip;0;28;0;28
919;Bitutė;Pelėdžiukai;1590501589;Taip;0;28;0;28
920;Bitutė;Pelėdžiukai;3796188100;Taip;15;2;0;17
921;Bitutė;Pelėdžiukai;1564763789;Taip;0;9;0;9
922;Bitutė;Pelėdžiukai;5679397165;Taip;12;10;0;22
923;Bitutė;Pelėdžiukai;3432065233;Taip;12;9;0;21
924;Bitutė;Pelėdžiukai;1560715159;Taip;3;10;0;13
925;Bitutė;Pelėdžiukai;6204566294;Taip;0;1;0;1
926;Bitutė;Pelėdžiukai;2518730247;Taip;23;3;1;27
927;Bitutė;Pelėdžiukai;5810344229;Taip;5;0;0;5
928;Bitutė;Pelėdžiukai;4315172747;Taip;5;0;0;5
929;Bitutė;Pelėdžiukai;9838379838;Taip;14;11;0;25
930;Bitutė;Pelėdžiukai;3227252972;Ne;0;4;0;4
931;Bitutė;Boružėlių;8276590981;Taip;16;1;5;22
932;Bitutė;Boružėlių;3026526421;Taip;14;0;0;14
933;Bitutė;Boružėlių;7503203424;Ne;22;0;0;22
934;Bitutė;Boružėlių;1711888057;Taip;0;0;1;1
935;Bitutė;Boružėlių;8355346371;Taip;9;0;0;9
936;Bitutė;Boružėlių;2583001947;Taip;30;0;0;30
937;Bitutė;Boružėlių;9545405359;Taip;5;0;0;5
938;Bitutė;Boružėlių;2129484313;Taip;0;12;0;12
939;Bitutė;Boružėlių;9691450767;Taip;9;0;3;12
940;Bitutė;Boružėlių;3170266155;Taip;22;0;0;22
941;Bitutė;Boružėlių;6455582149;Taip;9;0;0;9
942;Bitutė;Boružėlių;2144809294;Taip;5;0;0;5
943;Bitutė;Boružėlių;8011051470;Taip;0;0;16;16
944;Bitutė;Boružėlių;9521938997;Taip;14;0;4;18
945;Bitutė;Boružėlių;9668365838;Taip;8;4;0;12
946;Bitutė;Boružėlių;3870675531;Taip;11;0;0;11
947;Bitutė;Boružėlių;7095475821;Ne;5;0;2;7
948;Bitutė;Boružėlių;6255439813;Taip;11;0;0;11
949;Bitutė;Boružėlių;2623999429;Taip;14;0;0;14
950;Bitutė;Boružėlių;6840722112;Taip;0;1;9;10
951;Bitutė;Boružėlių;4884898917;Taip;5;3;0;8
952;Bitutė;Boružėlių;4869423833;Taip;9;0;3;12
953;Bitutė;Boružėlių;5071978105;Taip;5;9;2;16
954;Bitutė;Šokliukų;8211710975;Taip;13;7;0;20
955;Bitutė;Šokliukų;8872286273;Taip;5;5;2;12
956;Bitutė;Šokliukų;5169768042;Taip;10;4;0;14
957;Bitutė;Šokliukų;4917599786;Ne;3;7;0;10
958;Bitutė;Šokliukų;1348548294;Taip;4;9;0;13
959;Bitutė;Šokliukų;7318555933;Taip;0;3;1;4
960;Bitutė;Šokliukų;1012702386;Taip;9;0;3;12
961;Bitutė;Šokliukų;9924340801;Ne;0;19;0;19
962;Bitutė;Šokliukų;7979566741;Taip;9;6;0;15
963;Bitutė;Šokliukų;7165511381;Taip;20;6;0;26
964;Bitutė;Šokliukų;9465186207;Taip;12;5;0;17
965;Bitutė;Šokliukų;2853616585;Ne;9;6;3;18
966;Bitutė;Šokliukų;5109258680;Taip;13;0;0;13
967;Bitutė;Šokliukų;8439759353;Taip;7;3;0;10
968;Bitutė;Šokliukų;3417576747;Taip;5;13;0;18
969;Bitutė;Šokliukų;8422448947;Ne;5;6;0;11
970;Bitutė;Šokliukų;7926482326;Taip;0;19;0;19
971;Bitutė;Šokliukų;5876700984;Taip;7;8;0;15
972;Bitutė;Šokliukų;2177537591;Ne;9;6;1;16
973;Bitutė;Šokliukų;5759407291;Taip;9;0;0;9
974;Bitutė;Šokliukų;4471813998;Taip;12;5;0;17
975;Bitutė;Šokliukų;9234090775;Ne;7;2;3;12
976;Bitutė;Drugelių;9094567866;Taip;6;6;3;15
977;Bitutė;Drugelių;5759595005;Taip;10;0;0;10
978;Bitutė;Drugelių;2085899696;Taip;15;0;0;15
979;Bitutė;Drugelių;2029309955;Taip;10;4;0;14
980;Bitutė;Drugelių;7376746010;Taip;10;1;1;12
981;Bitutė;Drugelių;5845408472;Taip;10;3;0;13
982;Bitutė;Drugelių;3611348253;Taip;14;2;1;17
983;Bitutė;Drugelių;8727525320;Taip;18;1;1;20
984;Bitutė;Drugelių;5796600501;Taip;0;5;3;8
985;Bitutė;Drugelių;1558826102;Taip;12;0;0;12
986;Bitutė;Drugelių;6325890676;Taip;24;0;0;24
987;Bitutė;Drugelių;2748400429;Taip;19;5;0;24
988;Bitutė;Drugelių;5146691157;Taip;0;0;2;2
989;Bitutė;Drugelių;2848732083;Taip;4;1;0;5
990;Bitutė;Drugelių;5278510767;Taip;5;2;0;7
991;Bitutė;Drugelių;8962725357;Taip;9;0;1;10
992;Bitutė;Drugelių;5471241132;Ne;15;0;0;15
993;Bitutė;Drugelių;1218462939;Taip;14;3;0;17
994;Bitutė;Drugelių;5081300818;Taip;19;0;0;19
995;Bitutė;Drugelių;7013249141;Taip;10;1;1;12
996;Bitutė;Drugelių;1397711778;Taip;10;3;2;15
997;Bitutė;Drugelių;8008237092;Taip;7;9;3;19
998;Bitutė;Drugelių;4545188971;Taip;19;5;0;24
999;Bitutė;Kiškučių;9451529077;Taip;0;8;1;9
1000;Bitutė;Kiškučių;1907876695;Taip;3;2;0;5
1001;Bitutė;Kiškučių;7720798466;Taip;3;1;0;4
1002;Bitutė;Kiškučių;1662815358;Taip;0;7;0;7
1003;Bitutė;Kiškučių;1733189730;Taip;0;4;0;4
1004;Bitutė;Kiškučių;9966437881;Ne;0;1;0;1
1005;Bitutė;Kiškučių;8373296210;Taip;9;0;0;9
1006;Bitutė;Kiškučių;1985958540;Taip;12;3;0;15
1007;Bitutė;Kiškučių;8743960488;Taip;6;2;0;8
1008;Bitutė;Kiškučių;9337144831;Taip;8;2;0;10
1009;Bitutė;Kiškučių;4566919587;Taip;6;2;0;8
1010;Bitutė;Kiškučių;2806899030;Taip;8;8;0;16
1011;Bitutė;Kiškučių;5443722813;Taip;0;12;0;12
1012;Bitutė;Kiškučių;1241863345;Taip;10;0;0;10
1013;Bitutė;Kiškučių;8789574593;Ne;19;0;0;19
1014;Bitutė;Kiškučių;8799003374;Taip;12;9;0;21
1015;Bitutė;Kiškučių;4639968278;Taip;11;3;0;14
1016;Bitutė;Kiškučių;9217178863;Taip;11;1;0;12
1017;Bitutė;Kiškučių;5490753578;Ne;11;0;1;12
1018;Bitutė;"Viščiukų ";3603716923;Taip;15;2;0;17
1019;Bitutė;"Viščiukų ";5181958187;Taip;13;5;0;18
1020;Bitutė;"Viščiukų ";7694916340;Taip;0;28;0;28
1021;Bitutė;"Viščiukų ";8303932330;Taip;10;2;0;12
1022;Bitutė;"Viščiukų ";8642411661;Taip;5;7;0;12
1023;Bitutė;"Viščiukų ";1198024852;Taip;11;2;0;13
1024;Bitutė;"Viščiukų ";9909017070;Taip;11;2;0;13
1025;Bitutė;"Viščiukų ";3811028304;Taip;10;2;0;12
1026;Bitutė;"Viščiukų ";9592567172;Taip;0;1;0;1
1027;Bitutė;"Viščiukų ";7619112317;Taip;7;8;0;15
1028;Bitutė;"Viščiukų ";1715987321;Taip;12;0;0;12
1029;Bitutė;"Viščiukų ";4926289620;Taip;13;6;0;19
1030;Bitutė;"Viščiukų ";8130382253;Taip;16;0;0;16
1031;Bitutė;"Viščiukų ";5869737425;Taip;16;0;0;16
1032;Bitutė;"Viščiukų ";5220694242;Taip;15;3;0;18
1033;Bitutė;"Viščiukų ";7535583229;Taip;0;3;0;3
1034;Bitutė;"Viščiukų ";4480187618;Taip;11;2;0;13
1035;Bitutė;"Viščiukų ";5061164237;Taip;6;2;0;8
1036;Bitutė;"Skruzdėliukai ";5686278261;Taip;21;3;0;24
1037;Bitutė;"Skruzdėliukai ";1423694056;Taip;8;1;0;9
1038;Bitutė;"Skruzdėliukai ";5942493696;Taip;7;5;0;12
1039;Bitutė;"Skruzdėliukai ";6311396261;Taip;17;7;0;24
1040;Bitutė;"Skruzdėliukai ";7145036085;Taip;10;1;2;13
1041;Bitutė;"Skruzdėliukai ";2252157473;Taip;14;0;0;14
1042;Bitutė;"Skruzdėliukai ";6169426273;Taip;10;5;3;18
1043;Bitutė;"Skruzdėliukai ";4513783927;Taip;10;0;0;10
1044;Bitutė;"Skruzdėliukai ";8667259778;Taip;17;8;3;28
1045;Bitutė;"Skruzdėliukai ";8607718704;Taip;0;0;4;4
1046;Bitutė;"Skruzdėliukai ";4413880918;Taip;8;0;2;10
1047;Bitutė;"Skruzdėliukai ";9436414962;Taip;10;11;0;21
1048;Bitutė;"Skruzdėliukai ";9864771568;Taip;15;3;7;25
1049;Bitutė;"Skruzdėliukai ";6353690252;Taip;15;0;1;16
1050;Bitutė;"Skruzdėliukai ";2160735504;Taip;7;5;0;12
1051;Bitutė;"Skruzdėliukai ";1387310054;Taip;16;0;0;16
1052;Bitutė;"Skruzdėliukai ";7245807233;Taip;14;8;0;22
1053;Bitutė;"Skruzdėliukai ";4467090141;Ne;0;2;2;4
1054;Bitutė;"Skruzdėliukai ";5433617195;Taip;0;16;0;16
1055;Bitutė;"Skruzdėliukai ";2391170362;Taip;10;8;0;18
1056;Bitutė;"Nykštukų ";1290146001;Taip;12;7;1;20
1057;Bitutė;"Nykštukų ";3359918177;Taip;14;7;0;21
1058;Bitutė;"Nykštukų ";9352292654;Taip;6;3;1;10
1059;Bitutė;"Nykštukų ";5421744666;Taip;16;0;0;16
1060;Bitutė;"Nykštukų ";9780599803;Taip;11;5;0;16
1061;Bitutė;"Nykštukų ";7741454857;Taip;9;0;1;10
1062;Bitutė;"Nykštukų ";3860047703;Ne;4;0;2;6
1063;Bitutė;"Nykštukų ";6226996242;Taip;12;8;0;20
1064;Bitutė;"Nykštukų ";1460746240;Taip;19;0;0;19
1065;Bitutė;"Nykštukų ";8896842164;Taip;0;28;0;28
1066;Bitutė;"Nykštukų ";2819417600;Taip;14;1;0;15
1067;Bitutė;"Nykštukų ";8561037889;Taip;14;2;0;16
1068;Bitutė;"Nykštukų ";6091108131;Taip;21;0;4;25
1069;Bitutė;"Nykštukų ";5375847129;Taip;8;6;0;14
1070;Bitutė;"Nykštukų ";3528436838;Taip;5;1;0;6
1071;Bitutė;"Nykštukų ";8270270602;Taip;23;0;1;24
1072;Bitutė;"Nykštukų ";4617493676;Taip;23;0;0;23
1073;Bitutė;"Nykštukų ";3806852067;Taip;19;1;0;20
1074;Coliukė;DRUGELIAI;3151183436;Taip;0;0;3;3
1075;Coliukė;DRUGELIAI;3323738649;Taip;6;0;0;6
1076;Coliukė;DRUGELIAI;6675290003;Taip;14;3;1;18
1077;Coliukė;DRUGELIAI;9890663421;Taip;16;0;0;16
1078;Coliukė;DRUGELIAI;7763035106;Taip;5;1;0;6
1079;Coliukė;DRUGELIAI;3628571567;Ne;0;8;0;8
1080;Coliukė;DRUGELIAI;9688432169;Taip;14;0;0;14
1081;Coliukė;DRUGELIAI;7513522378;Taip;13;1;0;14
1082;Coliukė;DRUGELIAI;8478006305;Taip;11;1;0;12
1083;Coliukė;DRUGELIAI;9352547729;Ne;4;1;0;5
1084;Coliukė;DRUGELIAI;3908791146;Taip;7;0;0;7
1085;Coliukė;DRUGELIAI;9750447455;Taip;14;3;0;17
1086;Coliukė;DRUGELIAI;3367789231;Taip;11;0;3;14
1087;Coliukė;DRUGELIAI;1220834062;Taip;8;0;0;8
1088;Coliukė;DRUGELIAI;3392367716;Taip;9;0;0;9
1089;Coliukė;DRUGELIAI;7621095517;Taip;16;0;1;17
1090;Coliukė;DRUGELIAI;4140716483;Taip;12;0;0;12
1091;Coliukė;DRUGELIAI;2385917598;Taip;8;0;0;8
1092;Coliukė;DRUGELIAI;4881447596;Taip;18;1;0;19
1093;Coliukė;DRUGELIAI;6224089401;Taip;8;11;1;20
1094;Coliukė;DRUGELIAI;7284465232;Taip;4;2;2;8
1095;Coliukė;DRUGELIAI;8756465257;Taip;14;3;0;17
1096;Coliukė;BITUTĖS;6725408547;Taip;16;0;0;16
1097;Coliukė;BITUTĖS;2167230398;Taip;0;5;0;5
1098;Coliukė;BITUTĖS;5349969025;Taip;6;0;0;6
1099;Coliukė;BITUTĖS;1960898805;Taip;0;6;0;6
1100;Coliukė;BITUTĖS;7920728387;Taip;7;1;0;8
1101;Coliukė;BITUTĖS;8767261039;Taip;9;2;0;11
1102;Coliukė;BITUTĖS;1968467455;Taip;0;7;0;7
1103;Coliukė;BITUTĖS;9462610674;Taip;0;6;0;6
1104;Coliukė;BITUTĖS;4188233426;Taip;2;2;0;4
1105;Coliukė;BITUTĖS;8457120425;Taip;0;2;0;2
1106;Coliukė;BITUTĖS;1240946719;Ne;8;4;0;12
1107;Coliukė;BITUTĖS;9331485675;Taip;5;6;0;11
1108;Coliukė;BITUTĖS;9311775782;Taip;7;3;0;10
1109;Coliukė;BITUTĖS;3346269598;Taip;6;0;0;6
1110;Coliukė;BITUTĖS;9879369365;Taip;8;7;0;15
1111;Coliukė;BITUTĖS;4845247006;Taip;5;3;0;8
1112;Coliukė;BITUTĖS;9885547263;Taip;7;0;1;8
1113;Coliukė;BITUTĖS;36554487034;Taip;10;3;0;13
1114;Coliukė;BITUTĖS;1458763954;Taip;3;1;0;4
1115;Coliukė;BITUTĖS;6860757091;Taip;10;3;0;13
1116;Coliukė;BITUTĖS;8517128464;Taip;0;3;0;3
1117;Coliukė;BITUTĖS;8149118599;Taip;0;3;2;5
1118;Coliukė;BITUTĖS;7345905007;Taip;10;2;0;12
1119;Coliukė;BITUTĖS;7358018315;Taip;9;0;2;11
1120;Coliukė;VABALIUKAI;1105879142;Taip;0;1;2;3
1121;Coliukė;VABALIUKAI;1537341012;Taip;4;0;1;5
1122;Coliukė;VABALIUKAI;6984254334;Taip;11;2;0;13
1123;Coliukė;VABALIUKAI;5835199087;Taip;9;5;0;14
1124;Coliukė;VABALIUKAI;4626722910;Taip;5;0;2;7
1125;Coliukė;VABALIUKAI;9526108197;Ne;13;4;0;17
1126;Coliukė;VABALIUKAI;1318558913;Taip;11;3;1;15
1127;Coliukė;VABALIUKAI;6475497234;Taip;0;1;3;4
1128;Coliukė;VABALIUKAI;5596775091;Taip;4;1;3;8
1129;Coliukė;VABALIUKAI;4172517506;Taip;2;13;0;15
1130;Coliukė;VABALIUKAI;4493314926;Taip;10;7;0;17
1131;Coliukė;VABALIUKAI;2469993058;Taip;9;7;0;16
1132;Coliukė;VABALIUKAI;4739310916;Taip;8;4;0;12
1133;Coliukė;VABALIUKAI;5541328815;Ne;14;1;0;15
1134;Coliukė;VABALIUKAI;4649987214;Taip;9;2;1;12
1135;Coliukė;VABALIUKAI;3905904092;Taip;20;1;0;21
1136;Coliukė;VABALIUKAI;9083546061;Taip;9;0;0;9
1137;Coliukė;VABALIUKAI;1476750428;Taip;9;0;0;9
1138;Coliukė;VABALIUKAI;8521846076;Ne;9;7;0;16
1139;Coliukė;VABALIUKAI;7622526793;Taip;0;7;0;7
1140;Coliukė;VABALIUKAI;1328505569;Ne;8;3;0;11
1141;Coliukė;VABALIUKAI;9268436167;Taip;2;13;0;15
1142;Coliukė;VABALIUKAI;9368334915;Ne;10;2;0;12
1143;Coliukė;VABALIUKAI;5108993131;Taip;6;1;0;7
1144;Coliukė;NYKŠTUKAI;6441253648;Taip;4;2;0;6
1145;Coliukė;NYKŠTUKAI;4537756081;Ne;0;14;2;16
1146;Coliukė;NYKŠTUKAI;4022408510;Taip;4;0;0;4
1147;Coliukė;NYKŠTUKAI;3719547522;Ne;4;6;1;11
1148;Coliukė;NYKŠTUKAI;6403149921;Ne;0;10;0;10
1149;Coliukė;NYKŠTUKAI;5450167562;Taip;5;1;0;6
1150;Coliukė;NYKŠTUKAI;9498557347;Taip;4;0;1;5
1151;Coliukė;NYKŠTUKAI;3384332079;Ne;4;1;8;13
1152;Coliukė;NYKŠTUKAI;5283583324;Ne;4;2;4;10
1153;Coliukė;NYKŠTUKAI;9334564869;Taip;22;0;0;22
1154;Coliukė;NYKŠTUKAI;6781303455;Taip;4;3;0;7
1155;Coliukė;NYKŠTUKAI;3140659021;Ne;13;0;9;22
1156;Coliukė;NYKŠTUKAI;4845049639;Taip;0;3;4;7
1157;Coliukė;NYKŠTUKAI;3221157300;Taip;20;0;0;20
1158;Coliukė;NYKŠTUKAI;7870865302;Ne;4;7;0;11
1159;Coliukė;NYKŠTUKAI;1575061659;Taip;5;0;0;5
1160;Coliukė;NYKŠTUKAI;3678496820;Taip;7;1;0;8
1161;Coliukė;NYKŠTUKAI;2321127662;Taip;4;0;1;5
1162;Coliukė;NYKŠTUKAI;8715608220;Ne;7;1;0;8
1163;Coliukė;NYKŠTUKAI;7502911642;Taip;4;10;0;14
1164;Coliukė;NYKŠTUKAI;4635299740;Taip;4;10;0;14
1165;Coliukė;GĖLYTĖS;9442511803;Taip;17;3;0;20
1166;Coliukė;GĖLYTĖS;6781663126;Taip;0;3;6;9
1167;Coliukė;GĖLYTĖS;6611713551;Taip;27;3;0;30
1168;Coliukė;GĖLYTĖS;6755886435;Taip;12;0;0;12
1169;Coliukė;GĖLYTĖS;1220385522;Taip;6;0;0;6
1170;Coliukė;GĖLYTĖS;8601059431;Taip;0;1;16;17
1171;Coliukė;GĖLYTĖS;1452034828;Taip;21;1;0;22
1172;Coliukė;GĖLYTĖS;6816085304;Taip;4;6;0;10
1173;Coliukė;GĖLYTĖS;6941719947;Taip;3;2;1;6
1174;Coliukė;GĖLYTĖS;5347456579;Taip;7;1;0;8
1175;Coliukė;GĖLYTĖS;9834829829;Taip;12;3;0;15
1176;Coliukė;GĖLYTĖS;9107676840;Taip;4;0;0;4
1177;Coliukė;GĖLYTĖS;8606195508;Ne;12;7;0;19
1178;Coliukė;GĖLYTĖS;4880932369;Taip;19;3;0;22
1179;Coliukė;"BORUŽĖLĖS (SPEC.)";2080118127;Taip;10;1;0;11
1180;Coliukė;"BORUŽĖLĖS (SPEC.)";2617816991;Taip;11;8;0;19
1181;Coliukė;"BORUŽĖLĖS (SPEC.)";1233731506;Taip;2;8;2;12
1182;Coliukė;"BORUŽĖLĖS (SPEC.)";1644303265;Taip;7;1;6;14
1183;Coliukė;"BORUŽĖLĖS (SPEC.)";5706671963;Taip;2;8;2;12
1184;Coliukė;"BORUŽĖLĖS (SPEC.)";4961762841;Taip;17;0;0;17
1185;Coliukė;"BORUŽĖLĖS (SPEC.)";7826554599;Taip;14;0;0;14
1186;Coliukė;"BORUŽĖLĖS (SPEC.)";6920961967;Ne;3;4;0;7
1187;Coliukė;"BORUŽĖLĖS (SPEC.)";1134875499;Taip;7;2;0;9
1188;Coliukė;"BORUŽĖLĖS (SPEC.)";2351866339;Taip;11;1;1;13
1189;Coliukė;"BORUŽĖLĖS (SPEC.)";5756690199;Taip;15;0;1;16
1190;Coliukė;"BORUŽĖLĖS (SPEC.)";6972921877;Taip;15;0;0;15
1191;Coliukė;"BORUŽĖLĖS (SPEC.)";2947495861;Ne;7;0;4;11
1192;Coliukė;"BORUŽĖLĖS (SPEC.)";6246392335;Taip;9;1;0;10
1193;Coliukė;"BORUŽĖLĖS (SPEC.)";8347206534;Ne;6;0;0;6
1194;Coliukė;"BORUŽĖLĖS (SPEC.)";5008183731;Taip;21;0;0;21
1195;Čiauškutis;BITUTĖS;7893181156;Ne;9;0;0;9
1196;Čiauškutis;BITUTĖS;7976738303;Ne;11;0;0;11
1197;Čiauškutis;BITUTĖS;4026881335;Taip;9;0;6;15
1198;Čiauškutis;BITUTĖS;9753680961;Taip;8;0;1;9
1199;Čiauškutis;BITUTĖS;4852837431;Taip;10;0;1;11
1200;Čiauškutis;BITUTĖS;4652951382;Ne;0;15;7;22
1201;Čiauškutis;BITUTĖS;3837360101;Taip;0;1;1;2
1202;Čiauškutis;BITUTĖS;2319237497;Taip;19;0;0;19
1203;Čiauškutis;BITUTĖS;1765857419;Ne;0;4;0;4
1204;Čiauškutis;BITUTĖS;7282041196;Taip;0;21;0;21
1205;Čiauškutis;ŽVIRBLIUKAI;7654242839;Taip;5;1;1;7
1206;Čiauškutis;ŽVIRBLIUKAI;9565722619;Taip;0;21;1;22
1207;Čiauškutis;ŽVIRBLIUKAI;5125518366;Taip;7;0;5;12
1208;Čiauškutis;ŽVIRBLIUKAI;4962200863;Taip;14;0;4;18
1209;Čiauškutis;ŽVIRBLIUKAI;7468763527;Taip;0;0;5;5
1210;Čiauškutis;ŽVIRBLIUKAI;7324659239;Taip;0;1;1;2
1211;Čiauškutis;ŽVIRBLIUKAI;4216443034;Taip;5;0;0;5
1212;Čiauškutis;ŽVIRBLIUKAI;2096533965;Ne;7;2;2;11
1213;Čiauškutis;ŽVIRBLIUKAI;9759888353;Taip;0;0;18;18
1214;Čiauškutis;ŽVIRBLIUKAI;8297774828;Taip;16;0;1;17
1215;Čiauškutis;SAULUTĖS;7027181377;Taip;0;19;3;22
1216;Čiauškutis;SAULUTĖS;43313173294;Taip;1;18;3;22
1217;Čiauškutis;SAULUTĖS;60265156684;Taip;5;6;11;22
1218;Čiauškutis;SAULUTĖS;9052859205;Taip;0;1;0;1
1219;Čiauškutis;SAULUTĖS;7367933940;Taip;4;0;0;4
1220;Čiauškutis;SAULUTĖS;4658994599;Taip;5;1;0;6
1221;Čiauškutis;SAULUTĖS;6115354862;Ne;0;0;12;12
1222;Čiauškutis;SAULUTĖS;5759367884;Taip;10;1;0;11
1223;Čiauškutis;SAULUTĖS;1313716840;Taip;0;1;1;2
1224;Čiauškutis;EŽIUKAI;2686038029;Taip;3;0;3;6
1225;Čiauškutis;EŽIUKAI;1928404791;Taip;0;0;3;3
1226;Čiauškutis;EŽIUKAI;7489733038;Taip;7;0;7;14
1227;Čiauškutis;EŽIUKAI;5404165993;Taip;0;1;2;3
1228;Čiauškutis;EŽIUKAI;1158816422;Taip;0;0;12;12
1229;Čiauškutis;EŽIUKAI;7239878097;Taip;7;0;0;7
1230;Čiauškutis;EŽIUKAI;5910818962;Ne;0;0;3;3
1231;Čiauškutis;EŽIUKAI;1234494170;Taip;9;0;2;11
1232;Čiauškutis;DRUGELIAI;7080320173;Taip;14;0;0;14
1233;Čiauškutis;DRUGELIAI;9072764004;Taip;10;0;0;10
1234;Čiauškutis;DRUGELIAI;1036358147;Taip;10;3;1;14
1235;Čiauškutis;DRUGELIAI;1750040659;Taip;6;0;3;9
1236;Čiauškutis;DRUGELIAI;8346845876;Taip;22;0;0;22
1237;Čiauškutis;DRUGELIAI;3724324861;Taip;1;21;0;22
1238;Čiauškutis;DRUGELIAI;2237570705;Taip;5;0;0;5
1239;Čiauškutis;DRUGELIAI;9073514151;Taip;1;0;0;1
1240;Čiauškutis;DRUGELIAI;4681902267;Taip;12;3;1;16
1241;Čiauškutis;GENELIAI;76449285846;Taip;0;3;1;4
1242;Čiauškutis;GENELIAI;6435287215;Taip;0;2;0;2
1243;Čiauškutis;GENELIAI;1456067541;Ne;13;1;0;14
1244;Čiauškutis;GENELIAI;1657452686;Taip;0;1;0;1
1245;Čiauškutis;GENELIAI;1739403100;Taip;0;22;0;22
1246;Čiauškutis;GENELIAI;6994301415;Ne;10;3;1;14
1247;Čiauškutis;GENELIAI;1224986101;Taip;0;5;0;5
1248;Čiauškutis;GENELIAI;1809511815;Taip;0;3;5;8
1249;Čiauškutis;LINKSMUČIAI;73016259669;Taip;2;1;3;6
1250;Čiauškutis;LINKSMUČIAI;7184626362;Taip;4;0;0;4
1251;Čiauškutis;LINKSMUČIAI;8689127061;Taip;18;1;3;22
1252;Čiauškutis;LINKSMUČIAI;9062135043;Taip;4;0;2;6
1253;Čiauškutis;LINKSMUČIAI;1533938659;Taip;8;1;3;12
1254;Čiauškutis;LINKSMUČIAI;3353905368;Ne;6;1;0;7
1255;Čiauškutis;LINKSMUČIAI;1306672095;Taip;5;1;2;8
1256;Čiauškutis;LINKSMUČIAI;2218793969;Taip;8;1;0;9
1257;Čiauškutis;LINKSMUČIAI;2672796261;Taip;4;0;2;6
1258;Čiauškutis;LINKSMUČIAI;8857039064;Taip;1;0;1;2
1259;Čiauškutis;KIŠKUČIAI;1900086424;Taip;0;4;0;4
1260;Čiauškutis;KIŠKUČIAI;1396093940;Taip;5;0;1;6
1261;Čiauškutis;KIŠKUČIAI;3465024013;Taip;14;7;2;23
1262;Čiauškutis;KIŠKUČIAI;2271458332;Taip;3;0;1;4
1263;Čiauškutis;KIŠKUČIAI;9754417066;Taip;1;0;2;3
1264;Čiauškutis;KIŠKUČIAI;8580034134;Taip;1;0;6;7
1265;Čiauškutis;KIŠKUČIAI;3650541072;Taip;0;0;7;7
1266;Čiauškutis;KIŠKUČIAI;2445742257;Taip;15;5;2;22
1267;Čiauškutis;KIŠKUČIAI;6785604459;Taip;22;0;0;22
1268;Čiauškutis;LAPIUKAI;5052137859;Ne;9;10;3;22
1269;Čiauškutis;LAPIUKAI;7428833348;Taip;9;0;0;9
1270;Čiauškutis;LAPIUKAI;9897499968;Taip;9;13;0;22
1271;Čiauškutis;LAPIUKAI;2737503753;Taip;0;0;1;1
1272;Čiauškutis;LAPIUKAI;8876608072;Taip;0;0;9;9
1273;Čiauškutis;LAPIUKAI;4881821738;Taip;9;0;3;12
1274;Čiauškutis;LAPIUKAI;4881821738;Taip;9;0;3;12
1275;Čiauškutis;LAPIUKAI;6810906239;Taip;14;8;1;23
1276;Čiauškutis;LAPIUKAI;9460608737;Taip;10;0;2;12
1277;Čiauškutis;MEŠKUČIAI;7135435979;Ne;7;0;2;9
1278;Čiauškutis;MEŠKUČIAI;7274368180;Taip;0;0;12;12
1279;Čiauškutis;MEŠKUČIAI;6146321785;Taip;0;21;1;22
1280;Čiauškutis;MEŠKUČIAI;6434727608;Taip;3;17;2;22
1281;Čiauškutis;MEŠKUČIAI;2172687454;Taip;0;0;1;1
1282;Čiauškutis;MEŠKUČIAI;3660195990;Taip;21;0;0;21
1283;Čiauškutis;PELĖDŽIUKAI;4971788697;Taip;0;1;0;1
1284;Čiauškutis;PELĖDŽIUKAI;9228568063;Taip;0;0;3;3
1285;Čiauškutis;PELĖDŽIUKAI;1561833758;Taip;0;0;3;3
1286;Čiauškutis;PELĖDŽIUKAI;7931998640;Taip;9;0;0;9
1287;Čiauškutis;PELĖDŽIUKAI;3700692073;Taip;0;0;2;2
1288;Čiauškutis;PELĖDŽIUKAI;3833382641;Taip;0;3;1;4
1289;Čiauškutis;PELĖDŽIUKAI;6615319751;Taip;12;0;2;14
1290;Čiauškutis;PELĖDŽIUKAI;2377986721;Ne;9;0;0;9
1291;Čiauškutis;PELĖDŽIUKAI;8111541739;Taip;0;0;1;1
1292;Čiauškutis;NYKŠTUKAI;8948893335;Taip;0;3;12;15
1293;Čiauškutis;NYKŠTUKAI;2633243682;Taip;0;2;0;2
1294;Čiauškutis;NYKŠTUKAI;4037117222;Taip;0;0;6;6
1295;Čiauškutis;NYKŠTUKAI;6726124641;Taip;5;5;0;10
1296;Čiauškutis;NYKŠTUKAI;6705934636;Taip;0;3;0;3
1297;Čiauškutis;NYKŠTUKAI;5957587644;Taip;10;0;12;22
1298;Čiauškutis;NYKŠTUKAI;5575614158;Taip;7;0;2;9
1299;Čiauškutis;NYKŠTUKAI;2044220236;Taip;0;1;2;3
1300;Čiauškutis;NYKŠTUKAI;7335655769;Ne;5;1;0;6
1301;Daigelis;Bitutės;2252139639;Ne;8;0;0;8
1302;Daigelis;Bitutės;6287557181;Taip;10;0;0;10
1303;Daigelis;Bitutės;1639589842;Taip;13;0;0;13
1304;Daigelis;Bitutės;1201983358;Ne;15;0;0;15
1305;Daigelis;Bitutės;8855668502;Taip;22;0;0;22
1306;Daigelis;Bitutės;6285764348;Ne;11;0;0;11
1307;Daigelis;Bitutės;3168019565;Ne;8;0;0;8
1308;Daigelis;Bitutės;4624516876;Taip;15;0;0;15
1309;Daigelis;Bitutės;1333421528;Taip;21;0;0;21
1310;Daigelis;Bitutės;3653331894;Ne;6;0;0;6
1311;Daigelis;Bitutės;7732386969;Taip;8;0;0;8
1312;Daigelis;"VIEVERSĖLIAI (SPEC)";3744848906;Ne;16;0;0;16
1313;Daigelis;"VIEVERSĖLIAI (SPEC)";6181876938;Taip;12;0;0;12
1314;Daigelis;"VIEVERSĖLIAI (SPEC)";9392290289;Taip;32;0;0;32
1315;Daigelis;"SAULUTĖ (SPEC.sav.)";8817603885;Ne;7;0;0;7
1316;Daigelis;"SAULUTĖ (SPEC.sav.)";1991961132;Ne;7;0;0;7
1317;Daigelis;Spinduliukai;4730746531;Taip;8;0;0;8
1318;Daigelis;Spinduliukai;5326415916;Ne;18;0;0;18
1319;Daigelis;Spinduliukai;9995500724;Taip;5;0;0;5
1320;Daigelis;Spinduliukai;9944007915;Taip;4;0;0;4
1321;Daigelis;Spinduliukai;7144378150;Taip;14;0;0;14
1322;Daigelis;Spinduliukai;3333255527;Taip;4;0;0;4
1323;Daigelis;Spinduliukai;6384314661;Taip;3;0;0;3
1324;Daigelis;Spinduliukai;3192556582;Taip;5;0;0;5
1325;Daigelis;Spinduliukai;6894804166;Taip;5;0;0;5
1326;Daigelis;Pelėdžiukai;6718987671;Taip;5;0;0;5
1327;Daigelis;Pelėdžiukai;7617554018;Taip;5;0;0;5
1328;Daigelis;Pelėdžiukai;2431435960;Taip;19;0;0;19
1329;Daigelis;Pelėdžiukai;7936810346;Taip;10;0;0;10
1330;Daigelis;Pelėdžiukai;7407987673;Ne;8;0;0;8
1331;Daigelis;Pelėdžiukai;1041144226;Ne;7;0;0;7
1332;Daigelis;Žvaigždutės;7391024066;Taip;16;0;0;16
1333;Daigelis;Žvaigždutės;9617493018;Taip;10;0;0;10
1334;Daigelis;Žvaigždutės;3933864704;Taip;14;0;0;14
1335;Daigelis;Žvaigždutės;4498253271;Ne;12;0;0;12
1336;Daigelis;Žvaigždutės;9026869540;Taip;4;0;0;4
1337;Daigelis;Žvaigždutės;8477963582;Taip;6;0;0;6
1338;Daigelis;Žvaigždutės;5590883475;Ne;15;0;0;15
1339;Daigelis;Žvaigždutės;9588934306;Ne;17;0;0;17
1340;Daigelis;Žvaigždutės;1284567777;Taip;6;0;0;6
1341;Daigelis;Skruzdėliukai;2609340865;Ne;5;0;0;5
1342;Daigelis;Skruzdėliukai;8535045138;Taip;9;0;0;9
1343;Daigelis;Skruzdėliukai;4682302955;Taip;11;0;0;11
1344;Daigelis;Skruzdėliukai;3383805498;Taip;15;0;0;15
1345;Daigelis;Skruzdėliukai;8499408010;Taip;19;0;0;19
1346;Daigelis;Skruzdėliukai;2958204022;Ne;5;0;0;5
1347;Daigelis;Skruzdėliukai;2303781119;Taip;20;0;0;20
1348;Daigelis;Skruzdėliukai;1934433044;Taip;8;0;0;8
1349;Daigelis;Skruzdėliukai;9552228706;Taip;22;0;0;22
1350;Daigelis;Skruzdėliukai;8317879752;Taip;14;0;0;14
1351;Daigelis;Lašeliai;3139261869;Taip;10;0;0;10
1352;Daigelis;Lašeliai;5826615344;Taip;10;0;0;10
1353;Daigelis;Lašeliai;5193951960;Taip;7;0;0;7
1354;Daigelis;Lašeliai;2068456116;Taip;1;0;0;1
1355;Daigelis;Lašeliai;9241073182;Taip;28;0;0;28
1356;Daigelis;Lašeliai;5546501262;Taip;11;0;0;11
1357;Daigelis;Lašeliai;4323184917;Ne;18;0;0;18
1358;Daigelis;Lašeliai;1570713358;Taip;10;0;0;10
1359;Daigelis;Gėlytės;2112477899;Taip;10;0;0;10
1360;Daigelis;Gėlytės;2603945833;Taip;9;0;0;9
1361;Daigelis;Gėlytės;5682388173;Taip;5;0;0;5
1362;Daigelis;Gėlytės;8374822794;Taip;5;0;0;5
1363;Daigelis;Gėlytės;6074261354;Ne;10;0;0;10
1364;Daigelis;Gėlytės;1895453461;Taip;5;0;0;5
1365;Daigelis;Gėlytės;8855198771;Taip;10;0;0;10
1366;Daigelis;Gėlytės;9987516903;Ne;16;0;0;16
1367;Daigelis;Funtiki;9724634409;Taip;23;0;0;23
1368;Daigelis;Funtiki;4162501269;Taip;8;0;0;8
1369;Daigelis;Funtiki;3544739738;Taip;8;0;0;8
1370;Daigelis;Funtiki;8802563390;Taip;16;0;0;16
1371;Daigelis;Funtiki;8052793731;Ne;12;0;0;12
1372;Daigelis;Funtiki;5367788682;Taip;11;0;0;11
1373;Daigelis;Funtiki;5503176248;Taip;11;0;0;11
1374;Daigelis;Nevaliaški;4129565516;Ne;1;0;0;1
1375;Daigelis;Nevaliaški;8016639677;Taip;10;0;0;10
1376;Daigelis;Nevaliaški;3002391297;Taip;5;0;0;5
1377;Delfinukas;Boružėlių;4196156707;Taip;0;0;1;1
1378;Delfinukas;Boružėlių;9184207705;Taip;0;2;0;2
1379;Delfinukas;Boružėlių;2819680099;Taip;2;5;0;7
1380;Delfinukas;Boružėlių;3205671100;Ne;0;1;0;1
1381;Delfinukas;Boružėlių;1119373532;Ne;20;0;2;22
1382;Delfinukas;Boružėlių;7737665102;Taip;3;0;0;3
1383;Delfinukas;Boružėlių;4985159933;Taip;0;1;0;1
1384;Delfinukas;Boružėlių;5443027988;Ne;0;6;0;6
1385;Delfinukas;Boružėlių;2163238846;Taip;18;0;0;18
1386;Delfinukas;Boružėlių;4567479900;Taip;33;0;0;33
1387;Delfinukas;Boružėlių;9747075687;Ne;3;3;0;6
1388;Delfinukas;Boružėlių;7312438969;Ne;0;0;3;3
1389;Delfinukas;Boružėlių;6071660741;Taip;17;0;0;17
1390;Delfinukas;Boružėlių;4327924499;Taip;10;3;2;15
1391;Delfinukas;Boružėlių;6693756145;Taip;0;1;0;1
1392;Delfinukas;Boružėlių;6301767635;Ne;8;2;0;10
1393;Delfinukas;Saulytės;8315269427;Taip;9;0;0;9
1394;Delfinukas;Saulytės;4215887291;Taip;0;2;0;2
1395;Delfinukas;Saulytės;3631520143;Taip;14;0;3;17
1396;Delfinukas;Saulytės;9424966984;Taip;0;0;14;14
1397;Delfinukas;Saulytės;6069600728;Taip;11;0;0;11
1398;Delfinukas;Saulytės;9729550922;Ne;0;5;0;5
1399;Delfinukas;Saulytės;1404270345;Taip;7;0;3;10
1400;Delfinukas;Saulytės;3842160990;Ne;0;0;1;1
1401;Delfinukas;Saulytės;8402529296;Ne;11;1;0;12
1402;Delfinukas;Saulytės;5642328792;Ne;7;4;2;13
1403;Delfinukas;Saulytės;8176576958;Taip;20;0;0;20
1404;Delfinukas;Saulytės;8275943176;Taip;10;0;6;16
1405;Delfinukas;Saulytės;8085530134;Ne;0;7;0;7
1406;Delfinukas;Saulytės;8148610460;Taip;8;2;1;11
1407;Delfinukas;Saulytės;6935992202;Taip;8;0;0;8
1408;Delfinukas;Saulytės;8186312409;Taip;4;3;0;7
1409;Delfinukas;Saulytės;7904803011;Taip;6;1;0;7
1410;Delfinukas;Saulytės;1873630966;Ne;0;3;0;3
1411;Delfinukas;Saulytės;5665463557;Taip;11;1;0;12
1412;Delfinukas;Saulytės;1296440609;Ne;11;0;2;13
1413;Delfinukas;Saulytės;5397241026;Taip;3;5;0;8
1414;Delfinukas;Pelėdžiukų;3940838205;Ne;10;0;0;10
1415;Delfinukas;Pelėdžiukų;8774145277;Taip;5;9;0;14
1416;Delfinukas;Pelėdžiukų;3770227955;Taip;10;0;0;10
1417;Delfinukas;Pelėdžiukų;6113662246;Taip;0;15;0;15
1418;Delfinukas;Pelėdžiukų;4710894128;Ne;0;1;0;1
1419;Delfinukas;Pelėdžiukų;1526129772;Ne;9;1;1;11
1420;Delfinukas;Pelėdžiukų;8659309242;Taip;10;6;0;16
1421;Delfinukas;Pelėdžiukų;8267992425;Taip;0;3;1;4
1422;Delfinukas;Pelėdžiukų;9319874239;Ne;0;1;0;1
1423;Delfinukas;Pelėdžiukų;2809947323;Ne;3;3;0;6
1424;Delfinukas;Pelėdžiukų;3465186420;Taip;8;1;5;14
1425;Delfinukas;Pelėdžiukų;4096274346;Taip;4;3;4;11
1426;Delfinukas;Pelėdžiukų;5246300518;Taip;10;0;8;18
1427;Delfinukas;Pelėdžiukų;3702341009;Taip;5;3;0;8
1428;Delfinukas;Pelėdžiukų;2420308954;Taip;0;0;4;4
1429;Delfinukas;Pelėdžiukų;6286748047;Taip;2;10;0;12
1430;Delfinukas;Pelėdžiukų;8432654056;Taip;1;1;8;10
1431;Delfinukas;Pelėdžiukų;1918878505;Taip;3;1;0;4
1432;Delfinukas;Pelėdžiukų;3795705735;Taip;5;0;3;8
1433;Delfinukas;Pelėdžiukų;1575125658;Taip;0;2;0;2
1434;Delfinukas;Pelėdžiukų;4384995354;Taip;0;1;0;1
1435;Delfinukas;Pelėdžiukų;3633392440;Ne;18;0;0;18
1436;Delfinukas;Varliukų;4949220786;Taip;4;4;0;8
1437;Delfinukas;Varliukų;2792051636;Taip;17;0;0;17
1438;Delfinukas;Varliukų;4780352568;Taip;0;3;1;4
1439;Delfinukas;Varliukų;3577180085;Taip;22;0;0;22
1440;Delfinukas;Varliukų;6115370195;Ne;6;0;2;8
1441;Delfinukas;Varliukų;3050258185;Taip;9;0;3;12
1442;Delfinukas;Varliukų;7976681530;Taip;0;0;1;1
1443;Delfinukas;Varliukų;4338259551;Taip;4;0;2;6
1444;Delfinukas;Varliukų;9360553910;Taip;5;7;0;12
1445;Delfinukas;Varliukų;6301601832;Taip;12;0;0;12
1446;Delfinukas;Varliukų;5095713834;Ne;18;2;0;20
1447;Delfinukas;Varliukų;5964021733;Taip;18;3;0;21
1448;Delfinukas;Varliukų;5821591959;Taip;6;7;0;13
1449;Delfinukas;Varliukų;9095895182;Taip;0;0;6;6
1450;Delfinukas;Varliukų;7072060541;Taip;15;0;0;15
1451;Delfinukas;Varliukų;3797355501;Taip;15;4;0;19
1452;Delfinukas;Varliukų;4254414928;Taip;15;0;0;15
1453;Delfinukas;Varliukų;7359531377;Taip;14;0;0;14
1454;Delfinukas;Varpelių;8913681176;Taip;4;1;0;5
1455;Delfinukas;Varpelių;9514189769;Taip;0;3;0;3
1456;Delfinukas;Varpelių;4713803167;Taip;0;8;0;8
1457;Delfinukas;Varpelių;8936645508;Taip;4;1;0;5
1458;Delfinukas;Varpelių;6047881184;Taip;0;7;1;8
1459;Delfinukas;Varpelių;3818558339;Taip;3;0;2;5
1460;Delfinukas;Varpelių;1484123788;Taip;0;3;0;3
1461;Delfinukas;Varpelių;4877757730;Taip;16;0;0;16
1462;Delfinukas;Varpelių;7973858761;Taip;9;2;3;14
1463;Delfinukas;Varpelių;9218154624;Ne;11;1;0;12
1464;Delfinukas;Varpelių;8950528288;Taip;1;0;1;2
1465;Delfinukas;Varpelių;8829835426;Ne;4;0;1;5
1466;Delfinukas;Varpelių;4500756171;Taip;11;0;0;11
1467;Delfinukas;Varpelių;8953230752;Ne;12;2;0;14
1468;Delfinukas;Varpelių;7780893730;Taip;0;1;1;2
1469;Delfinukas;Varpelių;9898427089;Taip;3;1;0;4
1470;Delfinukas;Varpelių;2730512600;Taip;0;1;0;1
1471;Delfinukas;Varpelių;8911433659;Taip;13;0;0;13
1472;Delfinukas;Drugeliai;7615519932;Ne;0;1;1;2
1473;Delfinukas;Drugeliai;6604115681;Taip;15;4;0;19
1474;Delfinukas;Drugeliai;5990192934;Taip;9;3;0;12
1475;Delfinukas;Drugeliai;9635669748;Taip;7;1;0;8
1476;Delfinukas;Drugeliai;8526813977;Taip;7;1;0;8
1477;Delfinukas;Drugeliai;6873181103;Taip;9;0;0;9
1478;Delfinukas;Drugeliai;4484804360;Taip;0;2;0;2
1479;Delfinukas;Drugeliai;8328481987;Taip;0;2;1;3
1480;Delfinukas;Drugeliai;6992505341;Taip;14;2;1;17
1481;Delfinukas;Drugeliai;8606989493;Taip;6;0;0;6
1482;Delfinukas;Drugeliai;6884260821;Taip;2;2;0;4
1483;Delfinukas;Drugeliai;2985669766;Taip;6;5;6;17
1484;Delfinukas;Drugeliai;7609115506;Taip;6;1;0;7
1485;Delfinukas;Drugeliai;6457042338;Taip;2;9;0;11
1486;Delfinukas;Drugeliai;5060445169;Taip;0;3;0;3
1487;Delfinukas;Drugeliai;3134897964;Taip;3;4;0;7
1488;Delfinukas;Drugeliai;8411289299;Taip;9;1;0;10
1489;Delfinukas;Drugeliai;2683746435;Taip;4;0;2;6
1490;Delfinukas;Drugeliai;6623617856;Taip;4;3;0;7
1491;Delfinukas;Žuvytės;8160982025;Taip;9;7;0;16
1492;Delfinukas;Žuvytės;6578506861;Taip;16;0;0;16
1493;Delfinukas;Žuvytės;9934325492;Ne;7;0;0;7
1494;Delfinukas;Žuvytės;6949000708;Taip;0;9;1;10
1495;Delfinukas;Žuvytės;6322255194;Taip;9;1;0;10
1496;Delfinukas;Žuvytės;6572690788;Taip;12;2;0;14
1497;Delfinukas;Žuvytės;7873373923;Taip;0;0;4;4
1498;Delfinukas;Žuvytės;9898412288;Taip;0;2;8;10
1499;Delfinukas;Žuvytės;3397350274;Taip;12;2;1;15
1500;Delfinukas;Žuvytės;9520598359;Ne;9;1;0;10
1501;Delfinukas;Žuvytės;3804996594;Ne;12;2;0;14
1502;Delfinukas;Žuvytės;2066127119;Taip;21;0;0;21
1503;Delfinukas;Žuvytės;7487111570;Taip;17;1;0;18
1504;Delfinukas;Žuvytės;8702718951;Taip;16;1;0;17
1505;Delfinukas;Žuvytės;6844500395;Taip;0;2;2;4
1506;Delfinukas;Žuvytės;6445868759;Taip;4;3;4;11
1507;Delfinukas;Žuvytės;9074294473;Taip;11;0;4;15
1508;Delfinukas;Žuvytės;4678970810;Taip;9;0;0;9
1509;Delfinukas;Žuvytės;6478152041;Taip;0;2;1;3
1510;Delfinukas;Delfinai;2890469172;Taip;0;0;7;7
1511;Delfinukas;Delfinai;9628317328;Taip;5;3;1;9
1512;Delfinukas;Delfinai;8038737019;Taip;0;1;0;1
1513;Delfinukas;Delfinai;5797308373;Taip;12;3;0;15
1514;Delfinukas;Delfinai;5241426445;Taip;0;3;0;3
1515;Delfinukas;Delfinai;3108430680;Taip;10;1;0;11
1516;Delfinukas;Delfinai;7663934825;Taip;7;0;0;7
1517;Delfinukas;Delfinai;2382077576;Taip;0;1;0;1
1518;Delfinukas;Delfinai;1200205376;Taip;0;8;0;8
1519;Delfinukas;Delfinai;7629622746;Taip;6;2;0;8
1520;Delfinukas;Delfinai;4347116918;Taip;0;22;0;22
1521;Delfinukas;Delfinai;1922513830;Taip;0;3;0;3
1522;Delfinukas;Delfinai;6270012707;Ne;8;4;0;12
1523;Delfinukas;Delfinai;8085481968;Taip;0;2;0;2
1524;Delfinukas;Delfinai;9605756229;Taip;0;2;0;2
1525;Delfinukas;Delfinai;3407321091;Taip;5;0;0;5
1526;Delfinukas;Delfinai;7354837777;Taip;18;0;0;18
1527;Delfinukas;Delfinai;9903010418;Taip;10;3;0;13
1528;Delfinukas;Delfinai;8884939114;Ne;4;0;0;4
1529;Delfinukas;Delfinai;6522639028;Taip;1;0;4;5
1530;Delfinukas;Delfinai;9253061888;Ne;4;0;3;7
1531;Delfinukas;Paukšteliai;7366145460;Taip;12;0;2;14
1532;Delfinukas;Paukšteliai;5278689745;Taip;16;1;1;18
1533;Delfinukas;Paukšteliai;6002086491;Taip;0;2;1;3
1534;Delfinukas;Paukšteliai;1164720538;Taip;5;3;0;8
1535;Delfinukas;Paukšteliai;9351906710;Taip;7;0;1;8
1536;Delfinukas;Paukšteliai;9629225917;Taip;8;0;0;8
1537;Delfinukas;Paukšteliai;9332794060;Ne;12;0;0;12
1538;Delfinukas;Paukšteliai;5368435217;Taip;12;0;21;33
1539;Delfinukas;Paukšteliai;6650725760;Taip;13;0;2;15
1540;Delfinukas;Paukšteliai;7968869585;Taip;22;0;0;22
1541;Delfinukas;Paukšteliai;5164599763;Taip;14;0;0;14
1542;Delfinukas;Paukšteliai;9776618488;Taip;21;0;1;22
1543;Delfinukas;Paukšteliai;9586646352;Taip;3;0;0;3
1544;Delfinukas;Paukšteliai;4561911078;Taip;14;0;4;18
1545;Delfinukas;Paukšteliai;4755699845;Taip;5;13;1;19
1546;Delfinukas;Kiškučiai;2094258481;Taip;3;1;0;4
1547;Delfinukas;Kiškučiai;4119370256;Taip;5;1;0;6
1548;Delfinukas;Kiškučiai;9602317911;Taip;8;3;0;11
1549;Delfinukas;Kiškučiai;8625023976;Taip;0;3;0;3
1550;Delfinukas;Kiškučiai;3284212595;Taip;0;0;2;2
1551;Delfinukas;Kiškučiai;5783537897;Taip;6;0;0;6
1552;Delfinukas;Kiškučiai;2010703982;Taip;5;0;0;5
1553;Delfinukas;Kiškučiai;8728791932;Taip;0;3;0;3
1554;Delfinukas;Kiškučiai;7365398150;Ne;2;0;1;3
1555;Delfinukas;Kiškučiai;2883959240;Taip;12;2;3;17
1556;Delfinukas;Kiškučiai;4179507316;Taip;7;1;0;8
1557;Delfinukas;Kiškučiai;8440546956;Taip;7;3;0;10
1558;Delfinukas;Kiškučiai;7638190553;Ne;0;1;0;1
1559;Delfinukas;Kiškučiai;6577214344;Taip;2;10;0;12
1560;Delfinukas;Kiškučiai;2537442505;Taip;17;0;0;17
1561;Delfinukas;BITUTĖS;9719348837;Taip;6;0;0;6
1562;Delfinukas;BITUTĖS;6211076154;Taip;7;0;0;7
1563;Delfinukas;BITUTĖS;6601922746;Taip;6;4;0;10
1564;Delfinukas;BITUTĖS;8896957908;Ne;9;0;1;10
1565;Delfinukas;BITUTĖS;3239635507;Taip;8;1;0;9
1566;Delfinukas;BITUTĖS;5339993544;Ne;10;2;0;12
1567;Delfinukas;BITUTĖS;6929926768;Taip;17;2;0;19
1568;Delfinukas;BITUTĖS;5557399916;Taip;11;0;0;11
1569;Delfinukas;BITUTĖS;8937594052;Taip;3;1;3;7
1570;Delfinukas;BITUTĖS;5179080544;Taip;0;11;0;11
1571;Delfinukas;BITUTĖS;9941631164;Taip;7;0;2;9
1572;Delfinukas;BITUTĖS;4198261848;Taip;0;2;0;2
1573;Delfinukas;BITUTĖS;8081895401;Taip;11;0;0;11
1574;Delfinukas;BITUTĖS;5600320855;Taip;0;17;0;17
1575;Delfinukas;BITUTĖS;9195828884;Taip;0;0;4;4
1576;Delfinukas;BITUTĖS;2377204734;Taip;10;4;0;14
1577;Delfinukas;BITUTĖS;6243471374;Taip;13;5;0;18
1578;Delfinukas;BITUTĖS;4303234827;Ne;22;0;0;22
1579;Delfinukas;BITUTĖS;6325092903;Taip;12;1;0;13
1580;Drevinukas;ZUIKUČIAI;5500759834;Taip;0;0;3;3
1581;Drevinukas;ZUIKUČIAI;9817317105;Taip;10;0;1;11
1582;Drevinukas;ZUIKUČIAI;1595081335;Taip;11;0;2;13
1583;Drevinukas;ZUIKUČIAI;2772424629;Taip;10;3;0;13
1584;Drevinukas;ZUIKUČIAI;5928234487;Taip;4;4;2;10
1585;Drevinukas;ZUIKUČIAI;8873060121;Taip;12;0;0;12
1586;Drevinukas;ZUIKUČIAI;1567790084;Taip;7;5;0;12
1587;Drevinukas;ZUIKUČIAI;3293457412;Taip;6;3;0;9
1588;Drevinukas;ZUIKUČIAI;6243097297;Taip;16;3;0;19
1589;Drevinukas;ZUIKUČIAI;5704489483;Taip;3;0;5;8
1590;Drevinukas;ZUIKUČIAI;7054681115;Taip;10;0;0;10
1591;Drevinukas;ZUIKUČIAI;5887233286;Taip;6;0;1;7
1592;Drevinukas;ZUIKUČIAI;3381363132;Taip;25;1;0;26
1593;Drevinukas;ZUIKUČIAI;3070518153;Taip;10;0;0;10
1594;Drevinukas;ZUIKUČIAI;4243045398;Taip;9;3;0;12
1595;Drevinukas;ZUIKUČIAI;4309475233;Taip;9;3;0;12
1596;Drevinukas;AŽUOLIUKŲ;1644656704;Taip;15;1;0;16
1597;Drevinukas;AŽUOLIUKŲ;5721031754;Taip;0;0;1;1
1598;Drevinukas;AŽUOLIUKŲ;4714478955;Taip;0;4;1;5
1599;Drevinukas;AŽUOLIUKŲ;8701250912;Taip;9;0;1;10
1600;Drevinukas;AŽUOLIUKŲ;8143614891;Taip;8;5;0;13
1601;Drevinukas;AŽUOLIUKŲ;4213259879;Taip;14;1;0;15
1602;Drevinukas;AŽUOLIUKŲ;5673244101;Taip;0;3;0;3
1603;Drevinukas;AŽUOLIUKŲ;3643007998;Ne;6;5;0;11
1604;Drevinukas;AŽUOLIUKŲ;4262951360;Taip;6;0;1;7
1605;Drevinukas;AŽUOLIUKŲ;5959004452;Ne;0;11;0;11
1606;Drevinukas;AŽUOLIUKŲ;7689145214;Taip;11;4;0;15
1607;Drevinukas;AŽUOLIUKŲ;4572837478;Taip;20;0;3;23
1608;Drevinukas;AŽUOLIUKŲ;1564065835;Taip;11;4;0;15
1609;Drevinukas;AŽUOLIUKŲ;9289471118;Taip;8;0;0;8
1610;Drevinukas;AŽUOLIUKŲ;9915130747;Ne;16;3;0;19
1611;Drevinukas;AŽUOLIUKŲ;6891793135;Taip;0;2;0;2
1612;Drevinukas;AŽUOLIUKŲ;1058927778;Taip;5;1;0;6
1613;Drevinukas;AŽUOLIUKŲ;9534007163;Ne;11;0;0;11
1614;Drevinukas;AŽUOLIUKŲ;2300338724;Taip;9;0;0;9
1615;Drevinukas;AŽUOLIUKŲ;3725760478;Taip;0;1;0;1
1616;Drevinukas;AŽUOLIUKŲ;9513405583;Taip;0;1;0;1
1617;Drevinukas;AŽUOLIUKŲ;5436821826;Taip;10;7;0;17
1618;Drevinukas;AŽUOLIUKŲ;8896207423;Taip;20;0;0;20
1619;Drevinukas;PELĖDŽIUKAI;1123115847;Taip;6;1;2;9
1620;Drevinukas;PELĖDŽIUKAI;1987939679;Ne;10;0;0;10
1621;Drevinukas;PELĖDŽIUKAI;9336227821;Taip;0;1;0;1
1622;Drevinukas;PELĖDŽIUKAI;4784716615;Taip;0;1;0;1
1623;Drevinukas;PELĖDŽIUKAI;2070374746;Taip;0;1;1;2
1624;Drevinukas;PELĖDŽIUKAI;8661862777;Taip;0;0;1;1
1625;Drevinukas;PELĖDŽIUKAI;9803670483;Taip;0;1;5;6
1626;Drevinukas;PELĖDŽIUKAI;16952164778;Taip;0;2;0;2
1627;Drevinukas;PELĖDŽIUKAI;3657451903;Taip;7;0;1;8
1628;Drevinukas;PELĖDŽIUKAI;8180027849;Taip;0;1;5;6
1629;Drevinukas;PELĖDŽIUKAI;4332606643;Taip;8;0;1;9
1630;Drevinukas;PELĖDŽIUKAI;7632515230;Taip;0;13;0;13
1631;Drevinukas;PELĖDŽIUKAI;6304169257;Taip;3;0;1;4
1632;Drevinukas;PELĖDŽIUKAI;5686116320;Taip;3;1;0;4
1633;Drevinukas;PELĖDŽIUKAI;56028675283;Taip;0;1;3;4
1634;Drevinukas;PELĖDŽIUKAI;85288014888;Taip;0;0;1;1
1635;Drevinukas;PELĖDŽIUKAI;1019214451;Taip;7;0;1;8
1636;Drevinukas;PELĖDŽIUKAI;6954102486;Ne;0;0;4;4
1637;Drevinukas;PELĖDŽIUKAI;2857797268;Taip;0;0;2;2
1638;Drevinukas;PELĖDŽIUKAI;6833120798;Taip;0;1;3;4
1639;Drevinukas;PELĖDŽIUKAI;7607135647;Taip;0;0;2;2
1640;Drevinukas;BORUŽĖLĖS;3046196006;Taip;0;4;0;4
1641;Drevinukas;BORUŽĖLĖS;4134729710;Taip;10;0;0;10
1642;Drevinukas;BORUŽĖLĖS;3032536983;Taip;5;0;0;5
1643;Drevinukas;BORUŽĖLĖS;3392249574;Taip;7;0;0;7
1644;Drevinukas;BORUŽĖLĖS;5524567803;Ne;0;0;11;11
1645;Drevinukas;BORUŽĖLĖS;9016985238;Taip;11;0;0;11
1646;Drevinukas;BORUŽĖLĖS;2929598743;Taip;10;0;0;10
1647;Drevinukas;BORUŽĖLĖS;4076576850;Ne;24;0;6;30
1648;Drevinukas;BORUŽĖLĖS;6373230526;Taip;0;0;14;14
1649;Drevinukas;BORUŽĖLĖS;4312429104;Taip;5;0;0;5
1650;Drevinukas;BORUŽĖLĖS;7642022439;Ne;0;0;4;4
1651;Drevinukas;BORUŽĖLĖS;6316000019;Ne;6;0;3;9
1652;Drevinukas;BORUŽĖLĖS;4404254932;Taip;7;0;0;7
1653;Drevinukas;BORUŽĖLĖS;2378493422;Taip;18;1;0;19
1654;Drevinukas;BORUŽĖLĖS;1859208322;Taip;5;0;3;8
1655;Drevinukas;BORUŽĖLĖS;8984653958;Taip;5;0;0;5
1656;Drevinukas;BORUŽĖLĖS;5620887702;Taip;0;3;0;3
1657;Drevinukas;BORUŽĖLĖS;2281463885;Taip;5;1;2;8
1658;Drevinukas;BORUŽĖLĖS;4662426451;Taip;8;1;0;9
1659;Drevinukas;BORUŽĖLĖS;5875459639;Taip;7;3;0;10
1660;Drevinukas;BORUŽĖLĖS;6582186497;Ne;6;0;0;6
1661;Drevinukas;BORUŽĖLĖS;7218201733;Taip;7;0;2;9
1662;Drevinukas;BITUTĖS;3981507849;Taip;4;1;0;5
1663;Drevinukas;BITUTĖS;7753238387;Taip;0;4;4;8
1664;Drevinukas;BITUTĖS;3617570755;Ne;22;0;0;22
1665;Drevinukas;BITUTĖS;5679723776;Taip;6;5;0;11
1666;Drevinukas;BITUTĖS;1720464417;Taip;4;2;0;6
1667;Drevinukas;BITUTĖS;6095020718;Taip;0;2;1;3
1668;Drevinukas;BITUTĖS;1099462840;Taip;1;0;10;11
1669;Drevinukas;BITUTĖS;1152161183;Taip;17;0;0;17
1670;Drevinukas;BITUTĖS;8611131264;Taip;6;5;0;11
1671;Drevinukas;BITUTĖS;8936058501;Taip;20;1;0;21
1672;Drevinukas;BITUTĖS;5348609358;Taip;11;1;0;12
1673;Drevinukas;BITUTĖS;1098647410;Taip;10;0;0;10
1674;Drevinukas;BITUTĖS;2312241894;Taip;2;1;2;5
1675;Drevinukas;BITUTĖS;5394143000;Taip;11;3;0;14
1676;Drevinukas;BITUTĖS;3871506691;Taip;0;4;0;4
1677;Drevinukas;BITUTĖS;6914111231;Taip;2;2;0;4
1678;Drevinukas;BITUTĖS;3377957769;Taip;0;0;5;5
1679;Drevinukas;BITUTĖS;2423143170;Taip;8;0;3;11
1680;Drevinukas;BITUTĖS;1343431478;Ne;10;0;0;10
1681;Drevinukas;BITUTĖS;1829421385;Taip;5;0;0;5
1682;Drevinukas;BITUTĖS;8262224710;Taip;9;5;0;14
1683;Drevinukas;BITUTĖS;8479979176;Taip;2;1;0;3
1684;Drevinukas;BITUTĖS;2531207946;Taip;3;1;0;4
1685;Drevinukas;NYKŠTUKAI;8385750920;Taip;11;0;1;12
1686;Drevinukas;NYKŠTUKAI;6165662595;Taip;0;4;6;10
1687;Drevinukas;NYKŠTUKAI;4147987057;Taip;12;4;0;16
1688;Drevinukas;NYKŠTUKAI;6645506336;Taip;8;12;0;20
1689;Drevinukas;NYKŠTUKAI;8940838262;Taip;0;1;0;1
1690;Drevinukas;NYKŠTUKAI;8719022482;Taip;8;0;0;8
1691;Drevinukas;NYKŠTUKAI;9695419813;Taip;0;1;13;14
1692;Drevinukas;NYKŠTUKAI;9517560132;Taip;0;1;0;1
1693;Drevinukas;NYKŠTUKAI;6895472558;Taip;9;0;4;13
1694;Drevinukas;NYKŠTUKAI;2571295179;Ne;0;13;0;13
1695;Drevinukas;NYKŠTUKAI;2820241608;Taip;10;4;0;14
1696;Drevinukas;NYKŠTUKAI;5999370094;Taip;2;0;0;2
1697;Drevinukas;NYKŠTUKAI;5860361695;Taip;0;4;0;4
1698;Drevinukas;NYKŠTUKAI;9845207619;Taip;4;7;6;17
1699;Drevinukas;NYKŠTUKAI;3192583690;Ne;11;1;3;15
1700;Drevinukas;NYKŠTUKAI;6659263391;Ne;11;1;3;15
1701;Drevinukas;NYKŠTUKAI;4588368596;Ne;8;0;0;8
1702;Drevinukas;SMALSUČIAI;4242944055;Taip;10;0;3;13
1703;Drevinukas;SMALSUČIAI;2179736991;Taip;5;0;0;5
1704;Drevinukas;SMALSUČIAI;9105675010;Taip;5;0;0;5
1705;Drevinukas;SMALSUČIAI;9004568476;Taip;15;0;0;15
1706;Drevinukas;SMALSUČIAI;9283862598;Taip;5;0;3;8
1707;Drevinukas;SMALSUČIAI;8578579808;Taip;5;0;5;10
1708;Drevinukas;SMALSUČIAI;3611870655;Taip;3;0;5;8
1709;Drevinukas;SMALSUČIAI;7241671439;Taip;11;0;1;12
1710;Drevinukas;SMALSUČIAI;2246885419;Taip;17;3;0;20
1711;Drevinukas;SMALSUČIAI;4089351543;Taip;0;6;2;8
1712;Drevinukas;SMALSUČIAI;2201342382;Ne;8;2;2;12
1713;Drevinukas;SMALSUČIAI;4759293403;Taip;16;0;0;16
1714;Drevinukas;SMALSUČIAI;7863529560;Taip;11;0;0;11
1715;Drevinukas;SMALSUČIAI;9715586195;Taip;7;1;0;8
1716;Drevinukas;SMALSUČIAI;1368495173;Taip;12;8;0;20
1717;Drevinukas;SMALSUČIAI;8284025903;Taip;7;5;4;16
1718;Drevinukas;SMALSUČIAI;6492987985;Taip;0;0;4;4
1719;Drevinukas;ŽVIRBLIUKAI;7252955092;Taip;9;0;4;13
1720;Drevinukas;ŽVIRBLIUKAI;8654858364;Taip;14;0;1;15
1721;Drevinukas;ŽVIRBLIUKAI;5445104383;Taip;10;0;0;10
1722;Drevinukas;ŽVIRBLIUKAI;2662147175;Taip;10;1;0;11
1723;Drevinukas;ŽVIRBLIUKAI;7801920518;Taip;0;1;21;22
1724;Drevinukas;ŽVIRBLIUKAI;1570356979;Taip;16;0;0;16
1725;Drevinukas;ŽVIRBLIUKAI;9123131368;Taip;3;0;0;3
1726;Drevinukas;ŽVIRBLIUKAI;8877080179;Taip;10;0;2;12
1727;Drevinukas;ŽVIRBLIUKAI;6492711565;Ne;10;0;1;11
1728;Drevinukas;ŽVIRBLIUKAI;2274377462;Taip;8;0;2;10
1729;Drevinukas;ŽVIRBLIUKAI;7316996793;Taip;6;7;0;13
1730;Drevinukas;ŽVIRBLIUKAI;3408981880;Taip;8;0;0;8
1731;Drevinukas;ŽVIRBLIUKAI;8953871512;Taip;10;0;0;10
1732;Drevinukas;ŽVIRBLIUKAI;3983656958;Taip;9;0;1;10
1733;Drevinukas;ŽVIRBLIUKAI;1957961770;Taip;3;0;3;6
1734;Drevinukas;ŽVIRBLIUKAI;5702650036;Taip;2;7;0;9
1735;Drugelis;NYKŠTUKŲ;9316073597;Taip;0;1;0;1
1736;Drugelis;NYKŠTUKŲ;3551095669;Taip;5;2;0;7
1737;Drugelis;NYKŠTUKŲ;1785724340;Taip;7;6;0;13
1738;Drugelis;NYKŠTUKŲ;6632884258;Taip;0;3;9;12
1739;Drugelis;NYKŠTUKŲ;7447519502;Taip;5;2;0;7
1740;Drugelis;NYKŠTUKŲ;4523513611;Ne;16;1;0;17
1741;Drugelis;NYKŠTUKŲ;6594452094;Taip;6;5;1;12
1742;Drugelis;NYKŠTUKŲ;5122256823;Taip;9;0;0;9
1743;Drugelis;NYKŠTUKŲ;4825232236;Taip;7;1;0;8
1744;Drugelis;NYKŠTUKŲ;7477547789;Ne;9;0;0;9
1745;Drugelis;NYKŠTUKŲ;8717445483;Taip;11;1;0;12
1746;Drugelis;NYKŠTUKŲ;4471405682;Taip;13;0;0;13
1747;Drugelis;NYKŠTUKŲ;4867387611;Taip;12;7;0;19
1748;Drugelis;NYKŠTUKŲ;7609530453;Taip;6;2;0;8
1749;Drugelis;NYKŠTUKŲ;8070030439;Taip;7;0;0;7
1750;Drugelis;NYKŠTUKŲ;3061896520;Taip;4;0;0;4
1751;Drugelis;NYKŠTUKŲ;4927896706;Taip;9;0;0;9
1752;Drugelis;NYKŠTUKŲ;5692743298;Ne;9;2;3;14
1753;Drugelis;NYKŠTUKŲ;6452921695;Taip;5;2;2;9
1754;Drugelis;NYKŠTUKŲ;8591548746;Ne;0;13;0;13
1755;Drugelis;SMALSUČIŲ;5121351234;Taip;17;0;1;18
1756;Drugelis;SMALSUČIŲ;6626437352;Ne;5;0;0;5
1757;Drugelis;SMALSUČIŲ;5000965458;Taip;20;0;0;20
1758;Drugelis;SMALSUČIŲ;9683350741;Taip;22;0;0;22
1759;Drugelis;SMALSUČIŲ;1617833459;Ne;5;0;0;5
1760;Drugelis;SMALSUČIŲ;4805858183;Taip;15;0;0;15
1761;Drugelis;SMALSUČIŲ;9650052415;Taip;11;0;2;13
1762;Drugelis;SMALSUČIŲ;5533529267;Taip;15;0;0;15
1763;Drugelis;SMALSUČIŲ;3733097479;Taip;11;3;0;14
1764;Drugelis;SMALSUČIŲ;9066572677;Taip;3;0;0;3
1765;Drugelis;SMALSUČIŲ;2196445523;Taip;12;6;0;18
1766;Drugelis;SMALSUČIŲ;3645668411;Taip;12;5;0;17
1767;Drugelis;SMALSUČIŲ;3261462674;Taip;12;5;0;17
1768;Drugelis;SMALSUČIŲ;8186338261;Taip;8;0;1;9
1769;Drugelis;SMALSUČIŲ;3372145698;Taip;4;0;0;4
1770;Drugelis;SMALSUČIŲ;2644563881;Taip;0;2;2;4
1771;Drugelis;SMALSUČIŲ;6613520046;Taip;10;0;0;10
1772;Drugelis;SMALSUČIŲ;6890441262;Taip;4;3;0;7
1773;Drugelis;MUMINUKŲ;7390061272;Taip;8;0;0;8
1774;Drugelis;MUMINUKŲ;3311620018;Ne;0;1;1;2
1775;Drugelis;MUMINUKŲ;8812550811;Taip;0;2;2;4
1776;Drugelis;MUMINUKŲ;5661335344;Taip;10;0;0;10
1777;Drugelis;MUMINUKŲ;6038184222;Taip;0;5;1;6
1778;Drugelis;MUMINUKŲ;9851124145;Taip;4;0;1;5
1779;Drugelis;MUMINUKŲ;7253876812;Taip;13;0;0;13
1780;Drugelis;MUMINUKŲ;1816845006;Taip;8;0;0;8
1781;Drugelis;MUMINUKŲ;1666992752;Taip;17;0;0;17
1782;Drugelis;MUMINUKŲ;9510744779;Taip;4;6;0;10
1783;Drugelis;MUMINUKŲ;9029137302;Taip;15;0;0;15
1784;Drugelis;MUMINUKŲ;9907121223;Taip;17;1;0;18
1785;Drugelis;MUMINUKŲ;8500348389;Ne;0;14;1;15
1786;Drugelis;MUMINUKŲ;1858504360;Taip;15;2;0;17
1787;Drugelis;MUMINUKŲ;8366330478;Taip;4;0;2;6
1788;Drugelis;MUMINUKŲ;8107970910;Taip;9;6;0;15
1789;Drugelis;MUMINUKŲ;5515894973;Taip;6;5;1;12
1790;Drugelis;MUMINUKŲ;8282807535;Taip;9;1;0;10
1791;Drugelis;MUMINUKŲ;3293212749;Taip;8;3;0;11
1792;Drugelis;MUMINUKŲ;2256221485;Taip;3;2;1;6
1793;Drugelis;MUMINUKŲ;9588931333;Taip;8;2;1;11
1794;Drugelis;MUMINUKŲ;3176174057;Ne;4;1;0;5
1795;Drugelis;MUMINUKŲ;1761596625;Taip;33;0;0;33
1796;Drugelis;PŪKUOTUKAI;9149748841;Ne;14;1;0;15
1797;Drugelis;PŪKUOTUKAI;1217635751;Taip;11;1;4;16
1798;Drugelis;PŪKUOTUKAI;9612696781;Taip;9;4;0;13
1799;Drugelis;PŪKUOTUKAI;27569805506;Ne;5;7;0;12
1800;Drugelis;PŪKUOTUKAI;1961898730;Taip;2;3;0;5
1801;Drugelis;PŪKUOTUKAI;7406396614;Taip;5;1;0;6
1802;Drugelis;PŪKUOTUKAI;1901608445;Taip;6;2;0;8
1803;Drugelis;PŪKUOTUKAI;1506988472;Taip;5;2;0;7
1804;Drugelis;PŪKUOTUKAI;1991420008;Taip;5;2;0;7
1805;Drugelis;PŪKUOTUKAI;1255124184;Taip;0;1;0;1
1806;Drugelis;PŪKUOTUKAI;1856912386;Taip;4;4;0;8
1807;Drugelis;PŪKUOTUKAI;1576853049;Taip;6;0;1;7
1808;Drugelis;PŪKUOTUKAI;68223183150;Taip;10;8;0;18
1809;Drugelis;PŪKUOTUKAI;1421438458;Ne;0;9;0;9
1810;Drugelis;PŪKUOTUKAI;5954059321;Taip;13;0;0;13
1811;Drugelis;PŪKUOTUKAI;1541276266;Ne;5;3;0;8
1812;Drugelis;PŪKUOTUKAI;53874036107;Taip;6;1;0;7
1813;Drugelis;PŪKUOTUKAI;4788423265;Taip;0;0;4;4
1814;Drugelis;PŪKUOTUKAI;3096906506;Taip;0;2;0;2
1815;Drugelis;SPINDULIUKAI;3081918342;Taip;12;0;1;13
1816;Drugelis;SPINDULIUKAI;3560294703;Ne;14;0;0;14
1817;Drugelis;SPINDULIUKAI;1215586620;Taip;11;2;2;15
1818;Drugelis;SPINDULIUKAI;9005448398;Taip;22;0;0;22
1819;Drugelis;SPINDULIUKAI;7775085427;Taip;0;8;0;8
1820;Drugelis;SPINDULIUKAI;2926662708;Ne;4;0;0;4
1821;Drugelis;SPINDULIUKAI;6504082488;Taip;0;4;0;4
1822;Drugelis;SPINDULIUKAI;7321544601;Taip;11;0;0;11
1823;Drugelis;SPINDULIUKAI;9296067137;Taip;22;0;0;22
1824;Drugelis;SPINDULIUKAI;9855121078;Taip;32;0;0;32
1825;Drugelis;SPINDULIUKAI;6068102133;Taip;22;0;0;22
1826;Drugelis;SPINDULIUKAI;7825151440;Taip;9;0;0;9
1827;Drugelis;SPINDULIUKAI;4812322553;Taip;11;3;0;14
1828;Drugelis;SPINDULIUKAI;6032568621;Taip;4;0;0;4
1829;Drugelis;SPINDULIUKAI;4580456500;Taip;18;0;0;18
1830;Drugelis;SPINDULIUKAI;8259051898;Taip;9;1;1;11
1831;Drugelis;SPINDULIUKAI;3567930528;Taip;8;3;0;11
1832;Drugelis;SPINDULIUKAI;2573357635;Taip;5;0;1;6
1833;Drugelis;KIŠKUČIAI;3603051567;Taip;8;0;0;8
1834;Drugelis;KIŠKUČIAI;4628926113;Ne;10;3;0;13
1835;Drugelis;KIŠKUČIAI;7307032077;Taip;5;4;0;9
1836;Drugelis;KIŠKUČIAI;1213610973;Taip;0;1;4;5
1837;Drugelis;KIŠKUČIAI;9211760307;Taip;0;0;1;1
1838;Drugelis;KIŠKUČIAI;6071997970;Taip;15;5;0;20
1839;Drugelis;KIŠKUČIAI;8819853863;Taip;10;0;0;10
1840;Drugelis;KIŠKUČIAI;5950704328;Taip;11;0;0;11
1841;Drugelis;KIŠKUČIAI;9900296726;Taip;15;0;0;15
1842;Drugelis;KIŠKUČIAI;4898099506;Taip;7;0;0;7
1843;Drugelis;KIŠKUČIAI;6997707085;Ne;11;1;0;12
1844;Drugelis;KIŠKUČIAI;1375535260;Taip;11;0;0;11
1845;Drugelis;KIŠKUČIAI;5857726963;Taip;6;3;2;11
1846;Drugelis;KIŠKUČIAI;1817932444;Taip;15;0;2;17
1847;Drugelis;KIŠKUČIAI;8891228382;Taip;5;0;0;5
1848;"Du gaideliai";Uodelių;8896316882;Taip;0;0;2;2
1849;"Du gaideliai";Uodelių;6704167983;Taip;11;0;2;13
1850;"Du gaideliai";Uodelių;6942798420;Taip;0;11;0;11
1851;"Du gaideliai";Uodelių;8420400705;Taip;0;9;0;9
1852;"Du gaideliai";Uodelių;2826490663;Taip;5;0;0;5
1853;"Du gaideliai";Uodelių;4157021754;Taip;15;0;1;16
1854;"Du gaideliai";Uodelių;7193151965;Ne;11;3;0;14
1855;"Du gaideliai";Uodelių;1968978650;Taip;4;0;0;4
1856;"Du gaideliai";Uodelių;2564259600;Taip;14;0;4;18
1857;"Du gaideliai";Uodelių;6132405512;Taip;0;12;0;12
1858;"Du gaideliai";Uodelių;2756525592;Taip;0;3;0;3
1859;"Du gaideliai";Uodelių;7563789811;Taip;9;1;0;10
1860;"Du gaideliai";Uodelių;9126780620;Taip;9;0;0;9
1861;"Du gaideliai";Uodelių;9374869616;Ne;0;2;0;2
1862;"Du gaideliai";Uodelių;5726096980;Taip;13;0;1;14
1863;"Du gaideliai";Uodelių;4408537397;Taip;0;5;0;5
1864;"Du gaideliai";Uodelių;1527839162;Taip;0;2;20;22
1865;"Du gaideliai";Uodelių;5809089345;Taip;13;0;0;13
1866;"Du gaideliai";Uodelių;8174023197;Ne;10;6;0;16
1867;"Du gaideliai";Uodelių;7372149799;Taip;12;3;0;15
1868;"Du gaideliai";Uodelių;5291934919;Taip;12;2;0;14
1869;"Du gaideliai";OŽIUKŲ;8744467866;Taip;4;0;0;4
1870;"Du gaideliai";OŽIUKŲ;7033276798;Taip;0;2;0;2
1871;"Du gaideliai";OŽIUKŲ;4798503931;Taip;10;0;0;10
1872;"Du gaideliai";OŽIUKŲ;5788923258;Taip;0;5;0;5
1873;"Du gaideliai";OŽIUKŲ;8042203623;Taip;0;15;0;15
1874;"Du gaideliai";OŽIUKŲ;2100449108;Taip;6;3;0;9
1875;"Du gaideliai";OŽIUKŲ;7575534590;Taip;0;2;0;2
1876;"Du gaideliai";OŽIUKŲ;3019797369;Taip;2;2;0;4
1877;"Du gaideliai";OŽIUKŲ;9356275460;Ne;7;1;1;9
1878;"Du gaideliai";OŽIUKŲ;6204233540;Taip;0;10;2;12
1879;"Du gaideliai";OŽIUKŲ;2845145754;Taip;0;7;0;7
1880;"Du gaideliai";OŽIUKŲ;7726490359;Taip;20;1;2;23
1881;"Du gaideliai";OŽIUKŲ;6762171696;Taip;5;0;0;5
1882;"Du gaideliai";OŽIUKŲ;5728374219;Taip;0;4;0;4
1883;"Du gaideliai";OŽIUKŲ;5611102395;Ne;0;10;0;10
1884;"Du gaideliai";OŽIUKŲ;8410547195;Taip;0;5;0;5
1885;"Du gaideliai";OŽIUKŲ;2905083899;Taip;10;0;0;10
1886;"Du gaideliai";OŽIUKŲ;9585785202;Ne;22;0;0;22
1887;"Du gaideliai";OŽIUKŲ;2151825222;Taip;10;4;0;14
1888;"Du gaideliai";OŽIUKŲ;8043896286;Taip;0;7;1;8
1889;"Du gaideliai";OŽIUKŲ;6053941133;Taip;0;6;0;6
1890;"Du gaideliai";OŽIUKŲ;6120647567;Taip;19;0;0;19
1891;"Du gaideliai";OŽIUKŲ;5668878259;Taip;4;0;7;11
1892;"Du gaideliai";Vištyčių;1135098595;Taip;10;0;2;12
1893;"Du gaideliai";Vištyčių;3370029981;Taip;9;2;0;11
1894;"Du gaideliai";Vištyčių;2240947701;Taip;0;2;1;3
1895;"Du gaideliai";Vištyčių;3507387826;Taip;1;5;0;6
1896;"Du gaideliai";Vištyčių;4144269068;Taip;0;11;0;11
1897;"Du gaideliai";Vištyčių;1785976627;Taip;9;0;3;12
1898;"Du gaideliai";Vištyčių;8047413507;Taip;0;3;1;4
1899;"Du gaideliai";Vištyčių;9568647033;Ne;10;0;0;10
1900;"Du gaideliai";Vištyčių;5894974508;Ne;6;3;0;9
1901;"Du gaideliai";Vištyčių;5998344519;Taip;6;1;3;10
1902;"Du gaideliai";Vištyčių;6247706405;Taip;9;0;0;9
1903;"Du gaideliai";Vištyčių;1751328192;Taip;4;1;0;5
1904;"Du gaideliai";Vištyčių;5652662610;Taip;0;0;1;1
1905;"Du gaideliai";Vištyčių;6870356241;Taip;3;1;0;4
1906;"Du gaideliai";Vištyčių;5103483956;Taip;3;7;0;10
1907;"Du gaideliai";Vištyčių;6348951959;Taip;22;0;0;22
1908;"Du gaideliai";Vištyčių;1268479215;Taip;9;6;0;15
1909;"Du gaideliai";Vištyčių;3854355215;Taip;0;0;21;21
1910;"Du gaideliai";Vištyčių;3849899284;Taip;14;0;0;14
1911;"Du gaideliai";Vištyčių;2262425557;Taip;12;0;2;14
1912;"Du gaideliai";GAIDŽIUKŲ;1758546983;Taip;0;17;0;17
1913;"Du gaideliai";GAIDŽIUKŲ;7783203480;Taip;4;13;0;17
1914;"Du gaideliai";GAIDŽIUKŲ;94639433266;Taip;0;4;1;5
1915;"Du gaideliai";GAIDŽIUKŲ;9324740716;Taip;11;2;0;13
1916;"Du gaideliai";GAIDŽIUKŲ;6715434585;Taip;7;7;0;14
1917;"Du gaideliai";GAIDŽIUKŲ;7084763712;Taip;10;3;0;13
1918;"Du gaideliai";GAIDŽIUKŲ;1500684755;Ne;0;18;0;18
1919;"Du gaideliai";GAIDŽIUKŲ;6750787450;Taip;0;4;4;8
1920;"Du gaideliai";GAIDŽIUKŲ;5430986033;Taip;8;0;2;10
1921;"Du gaideliai";GAIDŽIUKŲ;27733314504;Taip;12;5;0;17
1922;"Du gaideliai";GAIDŽIUKŲ;1074783418;Ne;5;0;0;5
1923;"Du gaideliai";GAIDŽIUKŲ;5167460184;Taip;8;0;0;8
1924;"Du gaideliai";GAIDŽIUKŲ;1549762923;Taip;11;2;0;13
1925;"Du gaideliai";GAIDŽIUKŲ;3771563320;Taip;5;2;1;8
1926;"Du gaideliai";GAIDŽIUKŲ;6203383711;Taip;5;6;0;11
1927;"Du gaideliai";GAIDŽIUKŲ;1962859229;Taip;0;2;0;2
1928;"Du gaideliai";GAIDŽIUKŲ;7373413569;Taip;0;6;0;6
1929;"Du gaideliai";GAIDŽIUKŲ;1557413692;Taip;10;3;0;13
1930;"Du gaideliai";GAIDŽIUKŲ;3273574176;Taip;19;1;0;20
1931;"Du gaideliai";GAIDŽIUKŲ;7471332824;Taip;0;9;0;9
1932;"Du gaideliai";GAIDŽIUKŲ;4378924981;Taip;12;2;0;14
1933;"Du gaideliai";Musyčių;9506572113;Taip;11;4;0;15
1934;"Du gaideliai";Musyčių;6224116229;Taip;7;0;0;7
1935;"Du gaideliai";Musyčių;6630053388;Ne;4;0;0;4
1936;"Du gaideliai";Musyčių;5867716168;Taip;21;0;0;21
1937;"Du gaideliai";Musyčių;3654057453;Taip;13;3;0;16
1938;"Du gaideliai";Musyčių;8921985681;Taip;0;16;3;19
1939;"Du gaideliai";Musyčių;1882241729;Taip;7;0;4;11
1940;"Du gaideliai";Musyčių;5225949099;Taip;8;1;0;9
1941;"Du gaideliai";Musyčių;4204930257;Taip;21;0;2;23
1942;"Du gaideliai";Musyčių;3206388799;Taip;15;12;0;27
1943;"Du gaideliai";Musyčių;2616106413;Taip;15;0;0;15
1944;"Du gaideliai";Musyčių;2084660815;Taip;10;0;0;10
1945;"Du gaideliai";Musyčių;9934568135;Taip;9;10;0;19
1946;"Du gaideliai";Musyčių;4799107717;Taip;4;2;0;6
1947;"Du gaideliai";Musyčių;8624394105;Taip;19;0;0;19
1948;"Du gaideliai";Musyčių;2122841302;Taip;14;5;0;19
1949;"Du gaideliai";Musyčių;7153424410;Taip;0;6;0;6
1950;"Du gaideliai";Musyčių;4557902728;Taip;4;0;4;8
1951;"Du gaideliai";Musyčių;5514521078;Taip;0;10;0;10
1952;"Du gaideliai";MALŪNO;9561040908;Taip;0;3;0;3
1953;"Du gaideliai";MALŪNO;1048130675;Taip;10;13;0;23
1954;"Du gaideliai";MALŪNO;3601150560;Taip;4;2;0;6
1955;"Du gaideliai";MALŪNO;1777283565;Taip;21;0;0;21
1956;"Du gaideliai";MALŪNO;1940981083;Taip;12;0;0;12
1957;"Du gaideliai";MALŪNO;5113352673;Taip;8;0;0;8
1958;"Du gaideliai";MALŪNO;9477645505;Taip;15;1;2;18
1959;"Du gaideliai";MALŪNO;5142411841;Ne;9;0;0;9
1960;"Du gaideliai";MALŪNO;7855653537;Taip;7;1;0;8
1961;"Du gaideliai";MALŪNO;9832883242;Taip;5;0;1;6
1962;"Du gaideliai";MALŪNO;9619723983;Taip;6;1;0;7
1963;"Du gaideliai";MALŪNO;5016914497;Taip;0;0;7;7
1964;"Du gaideliai";MALŪNO;5060904810;Taip;9;0;0;9
1965;"Du gaideliai";MALŪNO;4759244471;Taip;0;4;0;4
1966;"Du gaideliai";MALŪNO;6054058539;Taip;3;4;0;7
1967;"Du gaideliai";MALŪNO;7389148136;Taip;7;0;0;7
1968;Eglutė;RAMUNĖ;1422631723;Taip;0;17;0;17
1969;Eglutė;RAMUNĖ;6709551046;Ne;7;1;0;8
1970;Eglutė;RAMUNĖ;6093932811;Taip;8;1;0;9
1971;Eglutė;RAMUNĖ;2651867769;Taip;7;0;0;7
1972;Eglutė;RAMUNĖ;3473388722;Taip;0;1;0;1
1973;Eglutė;RAMUNĖ;2597978713;Ne;6;7;0;13
1974;Eglutė;RAMUNĖ;4451772812;Ne;14;5;0;19
1975;Eglutė;RAMUNĖ;8493750509;Taip;0;0;1;1
1976;Eglutė;RAMUNĖ;9929681000;Taip;5;0;3;8
1977;Eglutė;RAMUNĖ;6105927493;Taip;0;0;2;2
1978;Eglutė;RAMUNĖ;4560670047;Taip;10;0;1;11
1979;Eglutė;RAMUNĖ;1048451048;Taip;0;1;0;1
1980;Eglutė;RAMUNĖ;6142326330;Ne;0;18;0;18
1981;Eglutė;RAMUNĖ;9728550000;Taip;0;0;2;2
1982;Eglutė;RAMUNĖ;1534556744;Taip;6;5;0;11
1983;Eglutė;RAMUNĖ;4047404616;Taip;7;6;0;13
1984;Eglutė;RAMUNĖ;4230594049;Taip;6;1;0;7
1985;Eglutė;RAMUNĖ;2998190195;Ne;10;3;0;13
1986;Eglutė;RAMUNĖ;9402686801;Taip;0;10;0;10
1987;Eglutė;RAMUNĖ;6279703448;Ne;0;18;0;18
1988;Eglutė;RAMUNĖ;7598993411;Taip;9;6;0;15
1989;Eglutė;PELĖDŽIUKAI;9066178904;Taip;0;2;0;2
1990;Eglutė;PELĖDŽIUKAI;6518497374;Taip;20;0;0;20
1991;Eglutė;PELĖDŽIUKAI;3203786388;Taip;0;2;0;2
1992;Eglutė;PELĖDŽIUKAI;3178489517;Taip;6;2;2;10
1993;Eglutė;PELĖDŽIUKAI;3393414294;Taip;0;1;0;1
1994;Eglutė;PELĖDŽIUKAI;1510706652;Taip;0;7;0;7
1995;Eglutė;PELĖDŽIUKAI;1695732622;Taip;0;7;0;7
1996;Eglutė;PELĖDŽIUKAI;9333028072;Taip;9;0;0;9
1997;Eglutė;PELĖDŽIUKAI;5856250605;Taip;4;3;0;7
1998;Eglutė;PELĖDŽIUKAI;2082716398;Taip;4;2;3;9
1999;Eglutė;PELĖDŽIUKAI;3616979217;Taip;0;6;0;6
2000;Eglutė;PELĖDŽIUKAI;9950953029;Taip;0;3;4;7
2001;Eglutė;PELĖDŽIUKAI;6835296034;Taip;5;2;0;7
2002;Eglutė;PELĖDŽIUKAI;7148210944;Taip;0;8;0;8
2003;Eglutė;PELĖDŽIUKAI;1324622835;Taip;0;3;0;3
2004;Eglutė;PELĖDŽIUKAI;1209962222;Taip;0;2;3;5
2005;Eglutė;PELĖDŽIUKAI;3275796441;Ne;0;3;3;6
2006;Eglutė;PELĖDŽIUKAI;3390360525;Taip;0;2;1;3
2007;Eglutė;PELĖDŽIUKAI;1806495674;Taip;0;0;1;1
2008;Eglutė;KODĖLČIUKAI;4490295754;Ne;0;7;3;10
2009;Eglutė;KODĖLČIUKAI;3883122650;Taip;6;10;0;16
2010;Eglutė;KODĖLČIUKAI;7859815752;Taip;14;2;0;16
2011;Eglutė;KODĖLČIUKAI;4176597208;Taip;0;4;3;7
2012;Eglutė;KODĖLČIUKAI;7758643349;Taip;3;0;0;3
2013;Eglutė;KODĖLČIUKAI;6483580751;Taip;4;1;0;5
2014;Eglutė;KODĖLČIUKAI;5924994736;Taip;0;3;0;3
2015;Eglutė;KODĖLČIUKAI;1759383841;Ne;0;4;0;4
2016;Eglutė;KODĖLČIUKAI;6597261061;Taip;0;6;0;6
2017;Eglutė;KODĖLČIUKAI;9046652370;Taip;6;0;0;6
2018;Eglutė;KODĖLČIUKAI;9356785605;Taip;0;9;0;9
2019;Eglutė;KODĖLČIUKAI;8943684351;Taip;5;3;0;8
2020;Eglutė;KODĖLČIUKAI;8165126017;Taip;5;0;0;5
2021;Eglutė;KODĖLČIUKAI;9967488317;Taip;7;1;0;8
2022;Eglutė;KODĖLČIUKAI;3584247594;Taip;0;2;0;2
2023;Eglutė;KODĖLČIUKAI;9758104910;Ne;7;6;0;13
2024;Eglutė;KODĖLČIUKAI;1531942494;Ne;0;9;1;10
2025;Eglutė;KODĖLČIUKAI;4635123721;Taip;0;1;0;1
2026;Eglutė;KODĖLČIUKAI;9515238936;Taip;15;0;0;15
2027;Eglutė;KODĖLČIUKAI;5840014240;Taip;5;8;0;13
2028;Eglutė;KODĖLČIUKAI;5678727198;Taip;9;0;0;9
2029;Eglutė;OBUOLIUKAI;3799824061;Ne;0;10;0;10
2030;Eglutė;OBUOLIUKAI;1744942011;Taip;5;2;0;7
2031;Eglutė;OBUOLIUKAI;7027121333;Taip;6;5;2;13
2032;Eglutė;OBUOLIUKAI;6679186715;Taip;22;0;0;22
2033;Eglutė;OBUOLIUKAI;8655425408;Ne;9;0;0;9
2034;Eglutė;OBUOLIUKAI;3387392137;Ne;0;2;0;2
2035;Eglutė;OBUOLIUKAI;8384141923;Taip;18;3;0;21
2036;Eglutė;OBUOLIUKAI;3112281182;Ne;11;2;7;20
2037;Eglutė;OBUOLIUKAI;1432716037;Taip;6;3;0;9
2038;Eglutė;OBUOLIUKAI;4876032787;Taip;5;0;0;5
2039;Eglutė;OBUOLIUKAI;9542684993;Taip;5;0;0;5
2040;Eglutė;OBUOLIUKAI;6967074765;Taip;17;3;0;20
2041;Eglutė;OBUOLIUKAI;9054104040;Taip;10;0;0;10
2042;Eglutė;OBUOLIUKAI;9193920390;Taip;8;1;0;9
2043;Eglutė;OBUOLIUKAI;8246870069;Taip;0;2;4;6
2044;Eglutė;OBUOLIUKAI;1380219881;Taip;5;1;0;6
2045;Eglutė;OBUOLIUKAI;8721209423;Taip;15;0;0;15
2046;Eglutė;OBUOLIUKAI;1774538642;Taip;8;0;0;8
2047;Eglutė;OBUOLIUKAI;3903612086;Taip;9;0;0;9
2048;Eglutė;OBUOLIUKAI;7789753835;Taip;4;0;0;4
2049;Eglutė;KAŠTONAS;4099257155;Taip;11;2;0;13
2050;Eglutė;KAŠTONAS;6009794480;Taip;0;10;0;10
2051;Eglutė;KAŠTONAS;6539887315;Taip;8;0;0;8
2052;Eglutė;KAŠTONAS;4252256130;Taip;0;0;3;3
2053;Eglutė;KAŠTONAS;8534997648;Taip;11;0;9;20
2054;Eglutė;KAŠTONAS;7234851379;Taip;0;1;0;1
2055;Eglutė;KAŠTONAS;5636437290;Ne;7;2;1;10
2056;Eglutė;KAŠTONAS;5190045146;Taip;9;2;0;11
2057;Eglutė;KAŠTONAS;8797889347;Taip;6;0;0;6
2058;Eglutė;KAŠTONAS;1842517164;Taip;22;0;0;22
2059;Eglutė;KAŠTONAS;7703290039;Taip;8;0;0;8
2060;Eglutė;KAŠTONAS;7530638623;Taip;0;10;0;10
2061;Eglutė;KAŠTONAS;2121177107;Ne;9;0;0;9
2062;Eglutė;KAŠTONAS;2357276888;Taip;0;0;17;17
2063;Eglutė;KAŠTONAS;7098548563;Taip;5;0;0;5
2064;Eglutė;KAŠTONAS;6146679388;Taip;5;2;0;7
2065;Eglutė;KAŠTONAS;5166183300;Taip;13;6;0;19
2066;Eglutė;KAŠTONAS;7984911632;Taip;12;7;0;19
2067;Eglutė;KAŠTONAS;7811667336;Taip;8;1;0;9
2068;Eglutė;EŽIUKAI;7491022301;Ne;5;0;0;5
2069;Eglutė;EŽIUKAI;5943856319;Taip;0;3;10;13
2070;Eglutė;EŽIUKAI;6891834971;Taip;6;4;0;10
2071;Eglutė;EŽIUKAI;7307564177;Ne;0;5;8;13
2072;Eglutė;EŽIUKAI;7823828202;Ne;0;2;1;3
2073;Eglutė;EŽIUKAI;7354260503;Ne;0;2;0;2
2074;Eglutė;EŽIUKAI;9439309687;Taip;7;2;2;11
2075;Eglutė;EŽIUKAI;1122308715;Taip;0;1;0;1
2076;Eglutė;EŽIUKAI;8523618773;Ne;0;6;0;6
2077;Eglutė;EŽIUKAI;3856651647;Taip;15;3;0;18
2078;Eglutė;EŽIUKAI;8421062747;Taip;13;2;4;19
2079;Eglutė;EŽIUKAI;9992438336;Taip;0;3;1;4
2080;Eglutė;EŽIUKAI;5731355126;Taip;4;1;0;5
2081;Eglutė;EŽIUKAI;8364693548;Ne;0;13;0;13
2082;Eglutė;EŽIUKAI;3081691175;Taip;0;1;0;1
2083;Eglutė;EŽIUKAI;1265463853;Taip;0;12;3;15
2084;Eglutė;EŽIUKAI;1321901982;Taip;0;9;0;9
2085;Eglutė;EŽIUKAI;9527732584;Taip;0;1;0;1
2086;Eglutė;EŽIUKAI;8162972897;Taip;0;16;0;16
2087;Eglutė;EŽIUKAI;4348313801;Taip;0;5;7;12
2088;Eglutė;EŽIUKAI;9042793284;Taip;0;13;0;13
2089;Eglutė;GILĖ;1550045866;Ne;0;1;2;3
2090;Eglutė;GILĖ;8325288373;Taip;9;0;2;11
2091;Eglutė;GILĖ;6272115803;Ne;0;2;0;2
2092;Eglutė;GILĖ;6550999480;Taip;0;5;0;5
2093;Eglutė;GILĖ;5650957826;Taip;5;0;0;5
2094;Eglutė;GILĖ;8129230197;Taip;11;1;0;12
2095;Eglutė;GILĖ;1835565594;Taip;4;3;1;8
2096;Eglutė;GILĖ;1393626624;Taip;0;3;3;6
2097;Eglutė;GILĖ;2917925763;Taip;4;0;1;5
2098;Eglutė;GILĖ;3740322448;Taip;0;9;0;9
2099;Eglutė;GILĖ;1814323427;Taip;22;0;0;22
2100;Eglutė;GILĖ;5013664843;Taip;6;0;0;6
2101;Eglutė;GILĖ;2276311106;Taip;0;2;0;2
2102;Eglutė;GILĖ;6924344686;Taip;3;1;0;4
2103;Eglutė;GILĖ;5645197324;Taip;10;1;3;14
2104;Eglutė;GILĖ;7800243796;Taip;0;0;22;22
2105;Eglutė;GILĖ;9098132159;Taip;0;3;1;4
2106;Eglutė;GILĖ;2615824395;Taip;1;5;0;6
2107;Eglutė;GILĖ;1899379269;Taip;0;1;3;4
2108;Eglutė;GILĖ;3605053253;Taip;9;1;0;10
2109;Eglutė;SAULUTĖ;9741776217;Ne;0;4;0;4
2110;Eglutė;SAULUTĖ;5285593057;Taip;0;0;6;6
2111;Eglutė;SAULUTĖ;3091324735;Taip;0;3;0;3
2112;Eglutė;SAULUTĖ;8739346084;Taip;4;0;0;4
2113;Eglutė;SAULUTĖ;5518570006;Taip;8;4;0;12
2114;Eglutė;SAULUTĖ;5805450838;Ne;0;2;1;3
2115;Eglutė;SAULUTĖ;9084576953;Ne;0;3;16;19
2116;Eglutė;SAULUTĖ;6309529738;Taip;4;1;0;5
2117;Eglutė;SAULUTĖ;2259077568;Ne;0;2;0;2
2118;Eglutė;SAULUTĖ;4489150480;Taip;18;11;0;29
2119;Eglutė;SAULUTĖ;2425927050;Ne;3;10;0;13
2120;Eglutė;SAULUTĖ;5918429438;Taip;3;0;4;7
2121;Eglutė;SAULUTĖ;5275306818;Taip;0;2;10;12
2122;Eglutė;SAULUTĖ;2621445549;Taip;10;0;0;10
2123;Eglutė;SAULUTĖ;6328900251;Taip;5;3;2;10
2124;Eglutė;SAULUTĖ;9661883776;Taip;4;0;0;4
2125;Eglutė;SAULUTĖ;5505398901;Taip;2;1;0;3
2126;Eglutė;SAULUTĖ;8799063905;Taip;0;9;0;9
2127;Eglutė;SAULUTĖ;5108928996;Taip;10;0;0;10
2128;Eglutė;SAULUTĖ;6572235324;Taip;11;2;0;13
2129;Eglutė;SAULUTĖ;2872597971;Taip;8;0;0;8
2130;Eglutė;SAULUTĖ;6424893248;Taip;15;0;0;15
2131;Eglutė;SAULUTĖ;3690266358;Taip;0;2;1;3
2132;Eglutė;ŠARKELĖ;7831541089;Taip;6;1;2;9
2133;Eglutė;ŠARKELĖ;3430016771;Taip;22;0;0;22
2134;Eglutė;ŠARKELĖ;6382927775;Taip;9;6;0;15
2135;Eglutė;ŠARKELĖ;7919553451;Taip;0;3;0;3
2136;Eglutė;ŠARKELĖ;7658345479;Taip;9;2;0;11
2137;Eglutė;ŠARKELĖ;7229612001;Ne;12;0;0;12
2138;Eglutė;ŠARKELĖ;4932945207;Taip;8;14;0;22
2139;Eglutė;ŠARKELĖ;5407757245;Taip;10;0;0;10
2140;Eglutė;ŠARKELĖ;3237476593;Taip;0;1;0;1
2141;Eglutė;ŠARKELĖ;9542103745;Ne;10;1;1;12
2142;Eglutė;ŠARKELĖ;1122907387;Taip;5;3;0;8
2143;Eglutė;ŠARKELĖ;9686836846;Taip;6;2;0;8
2144;Eglutė;ŠARKELĖ;7735192219;Taip;7;0;0;7
2145;Eglutė;ŠARKELĖ;5779671024;Taip;0;7;0;7
2146;Eglutė;ŠARKELĖ;5783776734;Taip;0;9;0;9
2147;Eglutė;ŠARKELĖ;6653111225;Taip;3;0;3;6
2148;Eglutė;NYKŠTUKAI;3011330968;Taip;0;12;3;15
2149;Eglutė;NYKŠTUKAI;8037564034;Taip;0;15;0;15
2150;Eglutė;NYKŠTUKAI;3368734808;Taip;0;0;1;1
2151;Eglutė;NYKŠTUKAI;8749425471;Ne;10;3;0;13
2152;Eglutė;NYKŠTUKAI;4151258155;Taip;4;1;0;5
2153;Eglutė;NYKŠTUKAI;6965837585;Taip;0;2;1;3
2154;Eglutė;NYKŠTUKAI;5103022009;Taip;0;5;2;7
2155;Eglutė;NYKŠTUKAI;8542684582;Taip;0;0;17;17
2156;Eglutė;NYKŠTUKAI;3091697091;Taip;0;4;4;8
2157;Eglutė;NYKŠTUKAI;4823811890;Taip;5;2;0;7
2158;Eglutė;NYKŠTUKAI;9292940501;Taip;3;4;3;10
2159;Eglutė;NYKŠTUKAI;3210398495;Taip;0;3;1;4
2160;Eglutė;NYKŠTUKAI;7313013331;Taip;3;0;3;6
2161;Eglutė;NYKŠTUKAI;3051637136;Taip;10;2;1;13
2162;Eglutė;NYKŠTUKAI;4056836413;Taip;9;2;0;11
2163;Eglutė;NYKŠTUKAI;5810733285;Taip;11;0;1;12
2164;Eglutė;NYKŠTUKAI;3089527202;Taip;11;0;0;11
2165;Eglutė;NYKŠTUKAI;2669400743;Taip;0;10;0;10
2166;Eglutė;NYKŠTUKAI;9845413768;Taip;7;0;2;9
2167;Eglutė;NYKŠTUKAI;1460628870;Taip;0;0;8;8
2168;Eglutė;NYKŠTUKAI;4427853197;Taip;8;1;0;9
2169;Eglutė;ŽIRNIUKAI;3706904006;Taip;9;0;2;11
2170;Eglutė;ŽIRNIUKAI;8698242107;Taip;13;2;6;21
2171;Eglutė;ŽIRNIUKAI;2666894761;Taip;8;0;0;8
2172;Eglutė;ŽIRNIUKAI;2546506486;Ne;0;0;19;19
2173;Eglutė;ŽIRNIUKAI;4465995209;Taip;0;0;7;7
2174;Eglutė;ŽIRNIUKAI;9795027066;Ne;11;2;7;20
2175;Eglutė;ŽIRNIUKAI;3006002253;Taip;0;0;22;22
2176;Eglutė;ŽIRNIUKAI;4539946535;Taip;14;0;2;16
2177;Eglutė;ŽIRNIUKAI;4697026463;Taip;20;3;0;23
2178;Eglutė;ŽIRNIUKAI;3974970972;Taip;0;3;0;3
2179;Eglutė;ŽIRNIUKAI;9381529574;Taip;0;0;21;21
2180;Eglutė;ŽIRNIUKAI;9150254806;Taip;0;1;0;1
2181;Eglutė;ŽIRNIUKAI;7256251859;Taip;0;11;0;11
2182;Eglutė;ŽIRNIUKAI;6336987111;Taip;5;1;0;6
2183;Eglutė;ŽIRNIUKAI;2950414583;Taip;0;0;21;21
2184;Eglutė;ŽIRNIUKAI;1630732306;Ne;0;4;0;4
2185;Eglutė;BORUŽIUKAI;5592515139;Taip;6;0;0;6
2186;Eglutė;BORUŽIUKAI;9964146295;Ne;0;4;0;4
2187;Eglutė;BORUŽIUKAI;1630903587;Ne;0;18;0;18
2188;Eglutė;BORUŽIUKAI;7254436716;Taip;0;9;0;9
2189;Eglutė;BORUŽIUKAI;5982037450;Taip;11;0;0;11
2190;Eglutė;BORUŽIUKAI;7994301287;Taip;6;0;0;6
2191;Eglutė;BORUŽIUKAI;9300315869;Taip;13;1;0;14
2192;Eglutė;BORUŽIUKAI;7231828805;Taip;15;6;0;21
2193;Eglutė;BORUŽIUKAI;5704418881;Taip;17;0;0;17
2194;Eglutė;BORUŽIUKAI;8410302338;Taip;12;0;2;14
2195;Eglutė;BORUŽIUKAI;1667851586;Taip;6;0;3;9
2196;Eglutė;BORUŽIUKAI;1715411901;Taip;18;2;0;20
2197;Eglutė;BORUŽIUKAI;9875724921;Taip;18;0;0;18
2198;Eglutė;BORUŽIUKAI;7564179845;Taip;18;0;0;18
2199;Eglutė;BORUŽIUKAI;9178835404;Taip;8;14;0;22
2200;Eglutė;BORUŽIUKAI;5146804510;Taip;9;1;0;10
2201;Eglutė;BORUŽIUKAI;7618937988;Taip;0;12;0;12
2202;Eglutė;BORUŽIUKAI;6805213753;Taip;9;0;1;10
2203;Eglutė;BORUŽIUKAI;6773894090;Taip;6;0;1;7
2204;Gandriukas;Geniukai;1450834523;Taip;8;0;0;8
2205;Gandriukas;Geniukai;6957157069;Taip;13;0;0;13
2206;Gandriukas;Sakalėliai;2694943666;Ne;5;0;0;5
2207;Gandriukas;Sakalėliai;8127464845;Taip;10;0;0;10
2208;Gandriukas;Boružiukai;6897651229;Taip;18;0;0;18
2209;Gandriukas;Boružiukai;7241024564;Taip;5;0;0;5
2210;Gandriukas;Boružiukai;5263334330;Taip;1;0;0;1
2211;Gandriukas;Boružiukai;6729234534;Taip;7;0;0;7
2212;Gandriukas;Žirniukai;3754384456;Ne;7;0;0;7
2213;Gandriukas;Spindulėliai;7112171183;Taip;14;0;0;14
2214;Gandriukas;Spindulėliai;3708164152;Taip;11;0;0;11
2215;Gandriukas;Spindulėliai;8798650622;Taip;9;0;0;9
2216;Gandriukas;Meškiukai;4462806519;Taip;15;0;0;15
2217;Gandriukas;Meškiukai;2789579818;Taip;7;0;0;7
2218;Gandriukas;Meškiukai;7902095203;Taip;12;0;0;12
2219;Gandriukas;Meškiukai;7687725549;Ne;10;0;0;10
2220;Gandriukas;Pingvinukai;1056337221;Taip;13;0;0;13
2221;Gandriukas;ŽVIRBLIUKAI;8133467876;Taip;23;0;0;23
2222;Gandriukas;ŽVIRBLIUKAI;8011849712;Taip;10;0;0;10
2223;Gandriukas;ŽVIRBLIUKAI;7636796574;Ne;10;0;0;10
2224;Gandriukas;VIEVERSĖLIAI;4560474682;Taip;4;0;0;4
2225;Gandriukas;VIEVERSĖLIAI;3136926969;Taip;8;0;0;8
2226;Gandriukas;VIEVERSĖLIAI;8151770820;Taip;10;0;0;10
2227;Gandriukas;VIEVERSĖLIAI;9514634621;Taip;8;0;0;8
2228;Gandriukas;"IKIMOKYKKLINIO UGDYMO GRUPĖ";7540612706;Taip;12;0;0;12
2229;"Geniukų kalvė";SAULUTĖS;9557055841;Taip;5;4;0;9
2230;"Geniukų kalvė";SAULUTĖS;4329782598;Taip;0;8;0;8
2231;"Geniukų kalvė";SAULUTĖS;8932671578;Taip;16;0;0;16
2232;"Geniukų kalvė";SAULUTĖS;9711047774;Taip;0;0;1;1
2233;"Geniukų kalvė";SAULUTĖS;1910363787;Ne;0;2;0;2
2234;"Geniukų kalvė";SAULUTĖS;9522911738;Taip;18;0;0;18
2235;"Geniukų kalvė";SAULUTĖS;5348211316;Taip;0;7;0;7
2236;"Geniukų kalvė";SAULUTĖS;6384832317;Taip;14;1;2;17
2237;"Geniukų kalvė";SAULUTĖS;4946218794;Taip;0;3;0;3
2238;"Geniukų kalvė";SAULUTĖS;4525874796;Taip;0;0;2;2
2239;"Geniukų kalvė";SAULUTĖS;4745451344;Taip;0;0;5;5
2240;"Geniukų kalvė";SAULUTĖS;9768077014;Taip;0;1;0;1
2241;"Geniukų kalvė";SAULUTĖS;3889643236;Taip;14;1;0;15
2242;"Geniukų kalvė";SAULUTĖS;6102906310;Taip;0;1;0;1
2243;"Geniukų kalvė";SAULUTĖS;6016735700;Ne;6;0;3;9
2244;"Geniukų kalvė";SAULUTĖS;9976423099;Taip;13;3;0;16
2245;"Geniukų kalvė";SAULUTĖS;5180240547;Ne;0;1;2;3
2246;"Geniukų kalvė";BITUTĖS;5587035951;Taip;5;1;0;6
2247;"Geniukų kalvė";BITUTĖS;6527228763;Taip;5;0;1;6
2248;"Geniukų kalvė";BITUTĖS;9323779212;Taip;12;0;0;12
2249;"Geniukų kalvė";BITUTĖS;2110578252;Taip;0;0;3;3
2250;"Geniukų kalvė";BITUTĖS;8577323715;Taip;2;1;2;5
2251;"Geniukų kalvė";BITUTĖS;7453065865;Ne;6;0;1;7
2252;"Geniukų kalvė";BITUTĖS;4633553106;Taip;14;0;0;14
2253;"Geniukų kalvė";BITUTĖS;3669378459;Ne;11;0;0;11
2254;"Geniukų kalvė";BITUTĖS;4201333532;Taip;9;0;0;9
2255;"Geniukų kalvė";BITUTĖS;5102325807;Taip;27;0;0;27
2256;"Geniukų kalvė";BITUTĖS;1492140432;Ne;8;0;10;18
2257;"Geniukų kalvė";BITUTĖS;1426555835;Taip;6;2;0;8
2258;"Geniukų kalvė";BITUTĖS;6138451393;Taip;0;2;0;2
2259;"Geniukų kalvė";BITUTĖS;7747615302;Taip;0;6;0;6
2260;"Geniukų kalvė";BITUTĖS;4691978116;Taip;11;14;0;25
2261;"Geniukų kalvė";BITUTĖS;6111168227;Taip;0;0;3;3
2262;"Geniukų kalvė";BITUTĖS;7744441981;Taip;7;0;2;9
2263;"Geniukų kalvė";BITUTĖS;1209268848;Taip;5;0;3;8
2264;"Geniukų kalvė";BITUTĖS;6351861630;Taip;0;1;0;1
2265;"Geniukų kalvė";BITUTĖS;6214681079;Taip;3;2;0;5
2266;"Geniukų kalvė";BITUTĖS;3221034847;Taip;18;0;0;18
2267;"Geniukų kalvė";KIŠKUČIAI;5253380852;Taip;12;4;0;16
2268;"Geniukų kalvė";KIŠKUČIAI;2684344984;Taip;5;1;1;7
2269;"Geniukų kalvė";KIŠKUČIAI;5824747638;Taip;14;0;1;15
2270;"Geniukų kalvė";KIŠKUČIAI;9075192344;Taip;6;3;1;10
2271;"Geniukų kalvė";KIŠKUČIAI;5078771341;Taip;5;4;0;9
2272;"Geniukų kalvė";KIŠKUČIAI;4849740486;Ne;0;0;2;2
2273;"Geniukų kalvė";KIŠKUČIAI;9730758999;Taip;7;3;0;10
2274;"Geniukų kalvė";KIŠKUČIAI;9579750299;Taip;12;0;1;13
2275;"Geniukų kalvė";KIŠKUČIAI;9543553237;Taip;10;1;0;11
2276;"Geniukų kalvė";KIŠKUČIAI;2032408983;Taip;8;1;0;9
2277;"Geniukų kalvė";KIŠKUČIAI;4639389587;Ne;16;0;0;16
2278;"Geniukų kalvė";KIŠKUČIAI;4507631652;Ne;19;0;0;19
2279;"Geniukų kalvė";KIŠKUČIAI;9386761753;Taip;11;2;0;13
2280;"Geniukų kalvė";KIŠKUČIAI;4864216994;Taip;3;0;1;4
2281;"Geniukų kalvė";KIŠKUČIAI;5604315555;Taip;0;4;1;5
2282;"Geniukų kalvė";KIŠKUČIAI;7784155503;Taip;0;4;1;5
2283;"Geniukų kalvė";KIŠKUČIAI;6188518268;Taip;0;3;0;3
2284;"Geniukų kalvė";KIŠKUČIAI;1945456486;Taip;4;0;1;5
2285;"Geniukų kalvė";KIŠKUČIAI;3887137828;Taip;19;0;0;19
2286;"Geniukų kalvė";KIŠKUČIAI;2396085192;Taip;3;0;2;5
2287;"Geniukų kalvė";VYTURĖLIAI;5945583960;Taip;5;3;0;8
2288;"Geniukų kalvė";VYTURĖLIAI;1568133009;Taip;6;4;0;10
2289;"Geniukų kalvė";VYTURĖLIAI;8939171238;Taip;0;1;0;1
2290;"Geniukų kalvė";VYTURĖLIAI;2337226175;Taip;2;1;0;3
2291;"Geniukų kalvė";VYTURĖLIAI;2140334255;Ne;3;2;2;7
2292;"Geniukų kalvė";VYTURĖLIAI;4844734556;Taip;0;1;0;1
2293;"Geniukų kalvė";VYTURĖLIAI;8635708009;Taip;3;1;1;5
2294;"Geniukų kalvė";VYTURĖLIAI;4758435835;Taip;4;6;0;10
2295;"Geniukų kalvė";VYTURĖLIAI;2729442911;Ne;1;3;1;5
2296;"Geniukų kalvė";VYTURĖLIAI;23023070502;Taip;0;2;0;2
2297;"Geniukų kalvė";VYTURĖLIAI;9081596975;Taip;0;1;0;1
2298;"Geniukų kalvė";VYTURĖLIAI;8668696743;Ne;0;0;1;1
2299;"Geniukų kalvė";VYTURĖLIAI;2262014110;Taip;0;2;0;2
2300;"Geniukų kalvė";VYTURĖLIAI;2890934301;Ne;2;2;0;4
2301;"Geniukų kalvė";VYTURĖLIAI;2904091819;Taip;0;2;0;2
2302;"Geniukų kalvė";VYTURĖLIAI;1947173142;Taip;5;0;0;5
2303;"Geniukų kalvė";VYTURĖLIAI;43097490633;Taip;15;3;0;18
2304;"Geniukų kalvė";VYTURĖLIAI;30932565379;Taip;12;2;0;14
2305;"Geniukų kalvė";VYTURĖLIAI;5756909142;Taip;0;1;0;1
2306;"Geniukų kalvė";DRUGELIAI;9676782662;Taip;0;2;0;2
2307;"Geniukų kalvė";DRUGELIAI;7745656622;Taip;0;2;4;6
2308;"Geniukų kalvė";DRUGELIAI;6520429663;Taip;15;0;0;15
2309;"Geniukų kalvė";DRUGELIAI;5542539934;Ne;0;3;2;5
2310;"Geniukų kalvė";DRUGELIAI;9666918437;Taip;9;0;0;9
2311;"Geniukų kalvė";DRUGELIAI;6466912385;Taip;5;3;0;8
2312;"Geniukų kalvė";DRUGELIAI;2718961466;Taip;12;3;0;15
2313;"Geniukų kalvė";DRUGELIAI;2016254460;Taip;0;9;0;9
2314;"Geniukų kalvė";DRUGELIAI;3984265624;Taip;0;14;0;14
2315;"Geniukų kalvė";DRUGELIAI;4813232640;Taip;1;1;2;4
2316;"Geniukų kalvė";DRUGELIAI;7081093742;Taip;0;0;2;2
2317;"Geniukų kalvė";DRUGELIAI;5776314197;Taip;1;0;0;1
2318;"Geniukų kalvė";DRUGELIAI;1897809684;Taip;0;3;0;3
2319;"Geniukų kalvė";DRUGELIAI;8872900558;Taip;3;3;1;7
2320;"Geniukų kalvė";DRUGELIAI;2031800114;Taip;0;2;0;2
2321;"Geniukų kalvė";DRUGELIAI;1451190239;Taip;0;3;0;3
2322;"Geniukų kalvė";DRUGELIAI;6511955882;Taip;0;1;0;1
2323;"Geniukų kalvė";DRUGELIAI;2233161242;Taip;0;1;0;1
2324;"Geniukų kalvė";DRUGELIAI;6500641378;Taip;10;1;0;11
2325;"Geniukų kalvė";DRUGELIAI;2143334688;Taip;0;1;0;1
2326;"Geniukų kalvė";DRUGELIAI;6498149304;Taip;0;1;0;1
2327;"Geniukų kalvė";DRUGELIAI;9990243525;Taip;7;1;1;9
2328;"Geniukų kalvė";DRUGELIAI;48818906299;Taip;0;2;1;3
2329;"Geniukų kalvė";DRUGELIAI;4105170344;Taip;0;12;0;12
2330;"Geniukų kalvė";"SAULĖS ZUIKUČIAI";7033628178;Taip;3;3;0;6
2331;"Geniukų kalvė";"SAULĖS ZUIKUČIAI";7082945033;Taip;0;2;0;2
2332;"Geniukų kalvė";"SAULĖS ZUIKUČIAI";2313382307;Taip;0;1;2;3
2333;"Geniukų kalvė";"SAULĖS ZUIKUČIAI";8309953586;Taip;0;1;0;1
2334;"Geniukų kalvė";"SAULĖS ZUIKUČIAI";1443348537;Taip;0;0;4;4
2335;"Geniukų kalvė";"SAULĖS ZUIKUČIAI";2783285969;Taip;20;0;1;21
2336;"Geniukų kalvė";"SAULĖS ZUIKUČIAI";7500079028;Ne;0;0;16;16
2337;"Geniukų kalvė";"SAULĖS ZUIKUČIAI";8071493871;Taip;0;1;5;6
2338;"Geniukų kalvė";"SAULĖS ZUIKUČIAI";1718428600;Ne;3;0;2;5
2339;"Geniukų kalvė";"SAULĖS ZUIKUČIAI";8914605154;Taip;4;1;3;8
2340;"Geniukų kalvė";"SAULĖS ZUIKUČIAI";6016585056;Taip;8;0;3;11
2341;"Geniukų kalvė";"SAULĖS ZUIKUČIAI";2816691996;Taip;8;0;1;9
2342;"Geniukų kalvė";"SAULĖS ZUIKUČIAI";5512172533;Taip;4;6;0;10
2343;"Geniukų kalvė";"SAULĖS ZUIKUČIAI";1375674317;Taip;6;1;0;7
2344;"Geniukų kalvė";"SAULĖS ZUIKUČIAI";4722801116;Taip;5;0;0;5
2345;"Geniukų kalvė";"SAULĖS ZUIKUČIAI";5763009912;Taip;5;1;3;9
2346;"Geniukų kalvė";"SAULĖS ZUIKUČIAI";5245434552;Taip;5;1;0;6
2347;"Geniukų kalvė";"SAULĖS ZUIKUČIAI";2952604528;Taip;0;0;1;1
2348;"Geniukų kalvė";"SAULĖS ZUIKUČIAI";5725034297;Taip;12;1;0;13
2349;"Geniukų kalvė";"SAULĖS ZUIKUČIAI";1499735818;Taip;10;1;7;18
2350;"Geniukų kalvė";"SAULĖS ZUIKUČIAI";4186376527;Taip;14;1;0;15
2351;"Geniukų kalvė";"SAULĖS ZUIKUČIAI";5161600326;Taip;0;0;3;3
2352;"Geniukų kalvė";SMALSUČIAI;2499796674;Taip;0;6;0;6
2353;"Geniukų kalvė";SMALSUČIAI;5974481787;Taip;2;0;2;4
2354;"Geniukų kalvė";SMALSUČIAI;7915720190;Taip;7;0;2;9
2355;"Geniukų kalvė";SMALSUČIAI;7384802397;Taip;11;0;0;11
2356;"Geniukų kalvė";SMALSUČIAI;8985466295;Taip;4;3;0;7
2357;"Geniukų kalvė";SMALSUČIAI;5129841490;Taip;5;1;1;7
2358;"Geniukų kalvė";SMALSUČIAI;5705917381;Taip;5;1;1;7
2359;"Geniukų kalvė";SMALSUČIAI;4231659246;Taip;4;0;2;6
2360;"Geniukų kalvė";SMALSUČIAI;2300947427;Taip;9;3;0;12
2361;"Geniukų kalvė";SMALSUČIAI;1028242614;Taip;18;0;0;18
2362;"Geniukų kalvė";SMALSUČIAI;2596680448;Taip;6;1;0;7
2363;"Geniukų kalvė";SMALSUČIAI;6730270449;Taip;13;2;0;15
2364;"Geniukų kalvė";SMALSUČIAI;4405381922;Taip;9;0;0;9
2365;"Geniukų kalvė";SMALSUČIAI;6473724074;Taip;3;6;0;9
2366;"Geniukų kalvė";SMALSUČIAI;3627418555;Taip;0;8;0;8
2367;"Geniukų kalvė";SMALSUČIAI;9155681194;Taip;9;1;1;11
2368;"Geniukų kalvė";SMALSUČIAI;7440029486;Ne;5;3;1;9
2369;"Geniukų kalvė";SMALSUČIAI;7140298387;Ne;0;3;9;12
2370;"Geniukų kalvė";SMALSUČIAI;6168422514;Taip;22;0;0;22
2371;"Geniukų kalvė";SMALSUČIAI;6514696294;Taip;3;0;0;3
2372;"Geniukų kalvė";SMALSUČIAI;6757580298;Taip;11;0;2;13
2373;"Geniukų kalvė";RUDNOSIUKAI;7079072084;Taip;9;3;0;12
2374;"Geniukų kalvė";RUDNOSIUKAI;6060825704;Ne;0;0;1;1
2375;"Geniukų kalvė";RUDNOSIUKAI;6149037133;Taip;0;14;0;14
2376;"Geniukų kalvė";RUDNOSIUKAI;5883913787;Taip;10;0;0;10
2377;"Geniukų kalvė";RUDNOSIUKAI;2426186771;Taip;7;0;0;7
2378;"Geniukų kalvė";RUDNOSIUKAI;2836282651;Taip;6;0;0;6
2379;"Geniukų kalvė";RUDNOSIUKAI;9847003556;Taip;9;0;0;9
2380;"Geniukų kalvė";RUDNOSIUKAI;5443596677;Ne;0;1;0;1
2381;"Geniukų kalvė";RUDNOSIUKAI;7300853810;Taip;0;0;2;2
2382;"Geniukų kalvė";RUDNOSIUKAI;2839299179;Taip;10;2;0;12
2383;"Geniukų kalvė";RUDNOSIUKAI;3852896932;Taip;5;0;0;5
2384;"Geniukų kalvė";RUDNOSIUKAI;2165793561;Taip;15;6;0;21
2385;"Geniukų kalvė";RUDNOSIUKAI;8973285553;Taip;6;0;0;6
2386;"Geniukų kalvė";RUDNOSIUKAI;5559324196;Taip;0;2;0;2
2387;"Geniukų kalvė";RUDNOSIUKAI;4985606198;Taip;6;9;0;15
2388;"Geniukų kalvė";RUDNOSIUKAI;3631181701;Taip;0;2;3;5
2389;"Geniukų kalvė";RUDNOSIUKAI;3152130511;Taip;0;0;18;18
2390;"Geniukų kalvė";RUDNOSIUKAI;2798750158;Taip;5;3;0;8
2391;"Geniukų kalvė";RUDNOSIUKAI;6373989816;Taip;18;1;0;19
2392;"Geniukų kalvė";PELĖDŽIUKAI;2217221922;Ne;25;0;0;25
2393;"Geniukų kalvė";PELĖDŽIUKAI;8271041553;Taip;3;2;0;5
2394;"Geniukų kalvė";PELĖDŽIUKAI;1237228692;Taip;0;1;0;1
2395;"Geniukų kalvė";PELĖDŽIUKAI;2938446054;Taip;5;5;1;11
2396;"Geniukų kalvė";PELĖDŽIUKAI;3055777730;Taip;4;0;3;7
2397;"Geniukų kalvė";PELĖDŽIUKAI;6070945557;Taip;15;0;0;15
2398;"Geniukų kalvė";PELĖDŽIUKAI;1051563985;Taip;0;9;0;9
2399;"Geniukų kalvė";PELĖDŽIUKAI;6174114461;Taip;0;6;0;6
2400;"Geniukų kalvė";PELĖDŽIUKAI;2659298240;Taip;5;2;0;7
2401;"Geniukų kalvė";PELĖDŽIUKAI;6737863183;Taip;0;7;1;8
2402;"Geniukų kalvė";PELĖDŽIUKAI;5704223824;Taip;14;2;1;17
2403;"Geniukų kalvė";PELĖDŽIUKAI;1811866428;Ne;17;0;0;17
2404;"Geniukų kalvė";PELĖDŽIUKAI;6410008429;Taip;6;1;0;7
2405;"Geniukų kalvė";PELĖDŽIUKAI;4843411757;Taip;4;1;0;5
2406;"Geniukų kalvė";PELĖDŽIUKAI;8770345339;Taip;0;0;9;9
2407;"Geniukų kalvė";PELĖDŽIUKAI;5146141771;Taip;23;0;0;23
2408;"Geniukų kalvė";PELĖDŽIUKAI;1611845627;Taip;3;0;0;3
2409;"Geniukų kalvė";PELĖDŽIUKAI;9677583445;Ne;5;2;2;9
2410;"Geniukų kalvė";PELĖDŽIUKAI;6237208661;Taip;0;0;1;1
2411;"Geniukų kalvė";PELĖDŽIUKAI;9921191336;Taip;0;1;0;1
2412;"Geniukų kalvė";BORUŽĖLĖS;9613720001;Taip;0;9;0;9
2413;"Geniukų kalvė";BORUŽĖLĖS;4958738745;Taip;0;5;0;5
2414;"Geniukų kalvė";BORUŽĖLĖS;9069256760;Taip;13;0;0;13
2415;"Geniukų kalvė";BORUŽĖLĖS;5161535756;Taip;0;10;0;10
2416;"Geniukų kalvė";BORUŽĖLĖS;3493492581;Taip;0;2;1;3
2417;"Geniukų kalvė";BORUŽĖLĖS;3085228868;Taip;12;1;0;13
2418;"Geniukų kalvė";BORUŽĖLĖS;6794151223;Taip;17;0;0;17
2419;"Geniukų kalvė";BORUŽĖLĖS;4777155321;Taip;9;0;0;9
2420;"Geniukų kalvė";BORUŽĖLĖS;1037854104;Taip;9;0;0;9
2421;"Geniukų kalvė";BORUŽĖLĖS;2180860623;Ne;4;3;0;7
2422;"Geniukų kalvė";BORUŽĖLĖS;2205515766;Ne;4;1;0;5
2423;"Geniukų kalvė";BORUŽĖLĖS;8769761434;Taip;11;0;0;11
2424;"Geniukų kalvė";BORUŽĖLĖS;1891205998;Taip;0;1;4;5
2425;"Geniukų kalvė";BORUŽĖLĖS;9643242164;Taip;3;2;0;5
2426;"Geniukų kalvė";BORUŽĖLĖS;2665955524;Taip;1;2;0;3
2427;"Geniukų kalvė";BORUŽĖLĖS;4872435715;Taip;10;0;4;14
2428;"Geniukų kalvė";BORUŽĖLĖS;3297360222;Taip;6;10;0;16
2429;"Geniukų kalvė";BORUŽĖLĖS;2710207578;Taip;0;1;0;1
2430;"Geniukų kalvė";BORUŽĖLĖS;1046406910;Taip;7;0;0;7
2431;"Geniukų kalvė";BORUŽĖLĖS;1454724752;Taip;10;0;0;10
2432;"Geniukų kalvė";BORUŽĖLĖS;8052276633;Taip;0;4;0;4
2433;"Geniukų kalvė";BORUŽĖLĖS;3193006249;Taip;6;5;0;11
2434;"Geniukų kalvė";PAGRANDUKAI;1844495906;Taip;3;0;0;3
2435;"Geniukų kalvė";PAGRANDUKAI;7234620406;Taip;0;1;0;1
2436;"Geniukų kalvė";PAGRANDUKAI;4890413509;Taip;11;0;0;11
2437;"Geniukų kalvė";PAGRANDUKAI;2490231586;Taip;6;0;0;6
2438;"Geniukų kalvė";PAGRANDUKAI;9319251542;Taip;2;0;0;2
2439;"Geniukų kalvė";PAGRANDUKAI;7310171451;Taip;5;10;0;15
2440;"Geniukų kalvė";PAGRANDUKAI;8653679467;Taip;1;0;0;1
2441;"Geniukų kalvė";PAGRANDUKAI;9820642056;Taip;0;9;0;9
2442;"Geniukų kalvė";PAGRANDUKAI;5115570519;Taip;3;2;0;5
2443;"Geniukų kalvė";PAGRANDUKAI;6783296167;Taip;4;2;0;6
2444;"Geniukų kalvė";PAGRANDUKAI;8525540366;Taip;22;0;0;22
2445;"Geniukų kalvė";PAGRANDUKAI;5744371590;Taip;9;5;0;14
2446;"Geniukų kalvė";PAGRANDUKAI;5847488152;Ne;10;1;5;16
2447;"Geniukų kalvė";PAGRANDUKAI;3676717541;Taip;14;0;0;14
2448;"Geniukų kalvė";NYKŠTUKAI;7561521903;Taip;9;1;1;11
2449;"Geniukų kalvė";NYKŠTUKAI;2312298671;Ne;14;0;0;14
2450;"Geniukų kalvė";NYKŠTUKAI;8217855034;Taip;14;3;0;17
2451;"Geniukų kalvė";NYKŠTUKAI;1068112116;Taip;5;0;0;5
2452;"Geniukų kalvė";NYKŠTUKAI;1421857914;Taip;23;0;0;23
2453;"Geniukų kalvė";NYKŠTUKAI;1558977259;Taip;0;1;0;1
2454;"Geniukų kalvė";NYKŠTUKAI;4805806745;Taip;8;0;0;8
2455;"Geniukų kalvė";NYKŠTUKAI;1383717352;Taip;8;0;0;8
2456;"Geniukų kalvė";NYKŠTUKAI;3071724778;Taip;2;2;0;4
2457;"Geniukų kalvė";NYKŠTUKAI;2302465593;Taip;10;0;0;10
2458;"Geniukų kalvė";NYKŠTUKAI;3024701779;Taip;9;2;0;11
2459;"Geniukų kalvė";NYKŠTUKAI;1822730314;Taip;7;0;1;8
2460;"Geniukų kalvė";NYKŠTUKAI;3015544833;Taip;18;0;0;18
2461;"Geniukų kalvė";NYKŠTUKAI;6680434763;Taip;3;2;0;5
2462;"Geniukų kalvė";NYKŠTUKAI;7736527608;Taip;7;0;0;7
2463;"Geniukų kalvė";NYKŠTUKAI;6860580488;Taip;0;18;0;18
2464;"Geniukų kalvė";NYKŠTUKAI;9322790214;Taip;4;1;0;5
2465;Gelvonėlis;ĄŽUOLIUKAI;2329699993;Ne;0;1;0;1
2466;Gelvonėlis;ĄŽUOLIUKAI;9058956012;Taip;0;4;0;4
2467;Gelvonėlis;ĄŽUOLIUKAI;4111774915;Taip;0;2;0;2
2468;Gelvonėlis;ĄŽUOLIUKAI;3677100165;Ne;6;2;0;8
2469;Gelvonėlis;ĄŽUOLIUKAI;7449710008;Taip;0;10;0;10
2470;Gelvonėlis;ĄŽUOLIUKAI;9492898584;Ne;0;5;0;5
2471;Gelvonėlis;ĄŽUOLIUKAI;3942630720;Taip;0;16;0;16
2472;Gelvonėlis;ĄŽUOLIUKAI;1453271708;Taip;0;5;0;5
2473;Gelvonėlis;ĄŽUOLIUKAI;9756155028;Taip;5;3;0;8
2474;Gelvonėlis;ĄŽUOLIUKAI;8206816148;Ne;0;1;0;1
2475;Gelvonėlis;ĄŽUOLIUKAI;1274119900;Ne;0;1;0;1
2476;Gelvonėlis;ĄŽUOLIUKAI;5901499708;Taip;0;1;0;1
2477;Gelvonėlis;ĄŽUOLIUKAI;1403890893;Taip;0;3;0;3
2478;Gelvonėlis;ŽVIRBLIUKAI;6604992169;Taip;0;3;0;3
2479;Gelvonėlis;ŽVIRBLIUKAI;6556472766;Taip;14;0;2;16
2480;Gelvonėlis;ŽVIRBLIUKAI;7182180008;Taip;4;5;1;10
2481;Gelvonėlis;ŽVIRBLIUKAI;8885088900;Taip;9;1;5;15
2482;Gelvonėlis;ŽVIRBLIUKAI;2400289466;Taip;0;1;5;6
2483;Gelvonėlis;ŽVIRBLIUKAI;9493536517;Taip;3;0;2;5
2484;Gelvonėlis;ŽVIRBLIUKAI;9059244134;Taip;8;1;0;9
2485;Gelvonėlis;ŽVIRBLIUKAI;1987204544;Taip;0;9;0;9
2486;Gelvonėlis;ŽVIRBLIUKAI;2515471132;Taip;0;0;10;10
2487;Gelvonėlis;ŽVIRBLIUKAI;1085845218;Taip;14;0;0;14
2488;Gelvonėlis;ŽVIRBLIUKAI;6319058542;Taip;5;0;0;5
2489;Gelvonėlis;ŽVIRBLIUKAI;9538571448;Taip;5;3;0;8
2490;Gelvonėlis;ŽVIRBLIUKAI;9147186080;Taip;8;1;0;9
2491;Gelvonėlis;ŽVIRBLIUKAI;7620280474;Taip;6;0;0;6
2492;Gelvonėlis;ŽVIRBLIUKAI;7195164378;Taip;22;0;0;22
2493;Gelvonėlis;ŽVIRBLIUKAI;6598178467;Taip;0;2;12;14
2494;Gelvonėlis;ŽVIRBLIUKAI;6068473734;Taip;8;0;1;9
2495;Gelvonėlis;ŽVIRBLIUKAI;4913415466;Taip;8;0;1;9
2496;Gelvonėlis;ŽVIRBLIUKAI;8508450500;Ne;4;3;0;7
2497;Gelvonėlis;ŽVIRBLIUKAI;8704971956;Taip;16;0;0;16
2498;Gelvonėlis;ŽVIRBLIUKAI;4281431471;Taip;0;7;0;7
2499;Gelvonėlis;ŽVIRBLIUKAI;8976258838;Ne;3;0;0;3
2500;Gelvonėlis;RASELĖS;9667024635;Taip;13;1;0;14
2501;Gelvonėlis;RASELĖS;9369121356;Taip;9;1;0;10
2502;Gelvonėlis;RASELĖS;2119550116;Taip;9;1;1;11
2503;Gelvonėlis;RASELĖS;3788522708;Taip;5;1;0;6
2504;Gelvonėlis;RASELĖS;6317822775;Taip;18;1;0;19
2505;Gelvonėlis;RASELĖS;5047022305;Taip;12;1;0;13
2506;Gelvonėlis;RASELĖS;6189110767;Taip;12;1;0;13
2507;Gelvonėlis;RASELĖS;7983982378;Taip;0;5;0;5
2508;Gelvonėlis;RASELĖS;2108690954;Ne;14;1;0;15
2509;Gelvonėlis;RASELĖS;1753617545;Taip;9;1;1;11
2510;Gelvonėlis;RASELĖS;7759317220;Taip;5;3;0;8
2511;Gelvonėlis;RASELĖS;5721858659;Taip;7;1;0;8
2512;Gelvonėlis;RASELĖS;1399518471;Ne;12;1;2;15
2513;Gelvonėlis;RASELĖS;5283207520;Taip;3;1;0;4
2514;Gelvonėlis;RASELĖS;3059903126;Taip;0;1;0;1
2515;Gelvonėlis;RASELĖS;6226970200;Taip;17;1;0;18
2516;Gelvonėlis;RASELĖS;1246591538;Taip;11;1;0;12
2517;Gelvonėlis;RASELĖS;6256962184;Taip;17;1;0;18
2518;Gelvonėlis;RASELĖS;91441127098;Taip;8;1;1;10
2519;Gelvonėlis;RASELĖS;1610362831;Taip;11;1;0;12
2520;Gelvonėlis;RASELĖS;9387523651;Ne;0;14;0;14
2521;Gelvonėlis;RASELĖS;75676389361;Taip;7;1;2;10
2522;Gelvonėlis;RASELĖS;4120103012;Ne;10;1;0;11
2523;Gelvonėlis;SAULUTĖ;9396676137;Taip;6;0;0;6
2524;Gelvonėlis;SAULUTĖ;9353066785;Taip;6;0;0;6
2525;Gelvonėlis;SAULUTĖ;3121251271;Taip;0;7;0;7
2526;Gelvonėlis;SAULUTĖ;7429739147;Taip;19;3;0;22
2527;Gelvonėlis;SAULUTĖ;7392743619;Taip;11;0;0;11
2528;Gelvonėlis;SAULUTĖ;8228796927;Taip;8;0;0;8
2529;Gelvonėlis;SAULUTĖ;1368982977;Taip;5;0;0;5
2530;Gelvonėlis;SAULUTĖ;4550077609;Taip;5;0;0;5
2531;Gelvonėlis;SAULUTĖ;1734685590;Taip;0;8;4;12
2532;Gelvonėlis;SAULUTĖ;7936622964;Taip;15;9;0;24
2533;Gelvonėlis;SAULUTĖ;3719670896;Taip;11;1;0;12
2534;Gelvonėlis;SAULUTĖ;1672409070;Ne;5;3;0;8
2535;Gelvonėlis;SAULUTĖ;3771796903;Taip;8;1;0;9
2536;Gelvonėlis;SAULUTĖ;8022270555;Taip;17;0;0;17
2537;Gelvonėlis;SAULUTĖ;4268590631;Taip;13;0;0;13
2538;Gelvonėlis;SAULUTĖ;5598186460;Taip;10;5;0;15
2539;Gelvonėlis;SAULUTĖ;9767254134;Taip;13;2;0;15
2540;Gelvonėlis;SAULUTĖ;2452711535;Taip;11;5;0;16
2541;Gelvonėlis;PELĖDŽIUKAI;3830940009;Taip;3;1;3;7
2542;Gelvonėlis;PELĖDŽIUKAI;2742000725;Ne;0;0;5;5
2543;Gelvonėlis;PELĖDŽIUKAI;3147489259;Taip;0;1;0;1
2544;Gelvonėlis;PELĖDŽIUKAI;1284359362;Taip;4;5;0;9
2545;Gelvonėlis;PELĖDŽIUKAI;9798684265;Taip;7;0;2;9
2546;Gelvonėlis;PELĖDŽIUKAI;4855800131;Taip;14;0;0;14
2547;Gelvonėlis;PELĖDŽIUKAI;8775661719;Taip;0;0;4;4
2548;Gelvonėlis;PELĖDŽIUKAI;21684706944;Ne;0;1;2;3
2549;Gelvonėlis;PELĖDŽIUKAI;3089755141;Taip;9;1;6;16
2550;Gelvonėlis;PELĖDŽIUKAI;1408313697;Ne;5;1;2;8
2551;Gelvonėlis;PELĖDŽIUKAI;3670612781;Taip;4;1;1;6
2552;Gelvonėlis;PELĖDŽIUKAI;69073786634;Taip;4;1;1;6
2553;Gelvonėlis;PELĖDŽIUKAI;29928181395;Taip;5;0;0;5
2554;Gelvonėlis;PELĖDŽIUKAI;6255253658;Taip;5;1;0;6
2555;Gelvonėlis;PELĖDŽIUKAI;9323579468;Taip;0;3;1;4
2556;Gelvonėlis;PELĖDŽIUKAI;7919814808;Taip;0;1;7;8
2557;Gelvonėlis;PELĖDŽIUKAI;1355742622;Taip;0;8;0;8
2558;Gelvonėlis;DRUGELIAI;3371560338;Taip;0;3;0;3
2559;Gelvonėlis;DRUGELIAI;2407650243;Taip;0;2;0;2
2560;Gelvonėlis;DRUGELIAI;2896360160;Taip;25;0;0;25
2561;Gelvonėlis;DRUGELIAI;8365647638;Taip;0;11;0;11
2562;Gelvonėlis;DRUGELIAI;3618681535;Taip;17;0;0;17
2563;Gelvonėlis;DRUGELIAI;9386056584;Taip;16;0;0;16
2564;Gelvonėlis;DRUGELIAI;2114734415;Taip;15;0;0;15
2565;Gelvonėlis;DRUGELIAI;5882430535;Taip;4;0;0;4
2566;Gelvonėlis;DRUGELIAI;9140900868;Taip;28;0;0;28
2567;Gelvonėlis;DRUGELIAI;2645337382;Ne;19;0;0;19
2568;Gelvonėlis;DRUGELIAI;3813000890;Ne;5;5;0;10
2569;Gelvonėlis;DRUGELIAI;6662081736;Taip;9;0;0;9
2570;Gelvonėlis;DRUGELIAI;5379820728;Taip;12;0;0;12
2571;Gelvonėlis;DRUGELIAI;7938324572;Taip;9;4;0;13
2572;Gelvonėlis;DRUGELIAI;4228323474;Taip;4;0;0;4
2573;Gelvonėlis;DRUGELIAI;4162701876;Taip;13;7;0;20
2574;Gelvonėlis;DRUGELIAI;2407650243;Taip;0;2;0;2
2575;Gelvonėlis;VARPELIAI;9149117970;Taip;0;11;0;11
2576;Gelvonėlis;VARPELIAI;6451557430;Taip;10;0;0;10
2577;Gelvonėlis;VARPELIAI;6225854165;Taip;10;0;1;11
2578;Gelvonėlis;VARPELIAI;2791652988;Taip;14;1;1;16
2579;Gelvonėlis;VARPELIAI;2638430817;Taip;0;0;11;11
2580;Gelvonėlis;VARPELIAI;9600526942;Taip;0;11;0;11
2581;Gelvonėlis;VARPELIAI;1387948936;Taip;0;3;0;3
2582;Gelvonėlis;VARPELIAI;1462716950;Taip;13;3;0;16
2583;Gelvonėlis;VARPELIAI;6949090250;Taip;8;0;0;8
2584;Gelvonėlis;VARPELIAI;9622818893;Taip;15;0;2;17
2585;Gelvonėlis;VARPELIAI;6869418701;Taip;7;0;0;7
2586;Gelvonėlis;VARPELIAI;5207153784;Taip;7;1;2;10
2587;Gelvonėlis;VARPELIAI;9963769327;Taip;1;3;0;4
2588;Gelvonėlis;VARPELIAI;3192542909;Taip;11;8;0;19
2589;Gelvonėlis;VARPELIAI;1802520150;Taip;5;3;0;8
2590;Gelvonėlis;BORUŽĖLĖS;8209225630;Taip;7;4;0;11
2591;Gelvonėlis;BORUŽĖLĖS;6554989142;Ne;12;2;0;14
2592;Gelvonėlis;BORUŽĖLĖS;8056058298;Taip;0;1;0;1
2593;Gelvonėlis;BORUŽĖLĖS;2434789595;Ne;10;0;0;10
2594;Gelvonėlis;BORUŽĖLĖS;2698853686;Taip;14;1;0;15
2595;Gelvonėlis;BORUŽĖLĖS;4112607183;Taip;7;2;2;11
2596;Gelvonėlis;BORUŽĖLĖS;6243360625;Taip;0;11;0;11
2597;Gelvonėlis;BORUŽĖLĖS;5790038422;Taip;0;3;0;3
2598;Gelvonėlis;BORUŽĖLĖS;1587584701;Ne;5;0;0;5
2599;Gelvonėlis;BORUŽĖLĖS;8515746171;Taip;9;0;0;9
2600;Gelvonėlis;BORUŽĖLĖS;1712926391;Taip;16;0;1;17
2601;Gelvonėlis;BORUŽĖLĖS;6647585785;Taip;10;0;0;10
2602;Gelvonėlis;BORUŽĖLĖS;1539850989;Taip;5;0;0;5
2603;Gelvonėlis;BORUŽĖLĖS;1107633909;Ne;12;8;0;20
2604;Gelvonėlis;BORUŽĖLĖS;8973272332;Taip;25;0;0;25
2605;Gelvonėlis;BORUŽĖLĖS;9849765037;Taip;0;2;0;2
2606;Gelvonėlis;BORUŽĖLĖS;3846916445;Taip;10;1;0;11
2607;Gelvonėlis;BORUŽĖLĖS;4749071286;Taip;0;3;0;3
2608;Gelvonėlis;BORUŽĖLĖS;8806934077;Taip;0;0;21;21
2609;Gelvonėlis;BORUŽĖLĖS;3926733474;Taip;0;1;10;11
2610;Gelvonėlis;BORUŽĖLĖS;4620517551;Taip;10;0;5;15
2611;Gelvonėlis;BORUŽĖLĖS;6598688551;Taip;9;5;0;14
2612;Gelvonėlis;NYKŠTUKAI;8987012601;Taip;5;0;0;5
2613;Gelvonėlis;NYKŠTUKAI;1112841066;Taip;8;1;0;9
2614;Gelvonėlis;NYKŠTUKAI;2553846157;Taip;9;0;0;9
2615;Gelvonėlis;NYKŠTUKAI;8003522011;Taip;10;1;0;11
2616;Gelvonėlis;NYKŠTUKAI;5713586282;Taip;0;3;0;3
2617;Gelvonėlis;NYKŠTUKAI;3217646353;Ne;0;3;0;3
2618;Gelvonėlis;NYKŠTUKAI;8560940316;Taip;0;3;0;3
2619;Gelvonėlis;NYKŠTUKAI;8540204705;Taip;6;0;0;6
2620;Gelvonėlis;NYKŠTUKAI;8124516993;Taip;6;0;9;15
2621;Gelvonėlis;NYKŠTUKAI;9751580494;Ne;7;0;0;7
2622;Gelvonėlis;NYKŠTUKAI;4156493586;Taip;0;4;0;4
2623;Gelvonėlis;NYKŠTUKAI;5305480599;Taip;3;0;0;3
2624;Gelvonėlis;NYKŠTUKAI;5874473596;Taip;2;3;0;5
2625;Gelvonėlis;NYKŠTUKAI;9900244859;Taip;8;0;4;12
2626;Gelvonėlis;NYKŠTUKAI;9597033956;Taip;8;0;0;8
2627;Gelvonėlis;NYKŠTUKAI;4027647695;Ne;0;0;8;8
2628;Gelvonėlis;BITUTĖS;6534527571;Taip;10;5;0;15
2629;Gelvonėlis;BITUTĖS;1105838340;Taip;9;0;1;10
2630;Gelvonėlis;BITUTĖS;5444127599;Ne;9;3;0;12
2631;Gelvonėlis;BITUTĖS;1980703633;Taip;4;0;0;4
2632;Gelvonėlis;BITUTĖS;5633162524;Taip;10;0;0;10
2633;Gelvonėlis;BITUTĖS;6330751030;Taip;12;1;0;13
2634;Gelvonėlis;BITUTĖS;6710189985;Taip;13;4;0;17
2635;Gelvonėlis;BITUTĖS;5281400074;Taip;0;0;5;5
2636;Gelvonėlis;BITUTĖS;3514762919;Taip;20;4;4;28
2637;Gelvonėlis;BITUTĖS;8792171281;Taip;0;3;0;3
2638;Gelvonėlis;BITUTĖS;7850553299;Taip;7;0;2;9
2639;Gelvonėlis;BITUTĖS;1730718430;Ne;0;0;22;22
2640;Gelvonėlis;BITUTĖS;8480138654;Taip;20;0;0;20
2641;Gelvonėlis;BITUTĖS;7725313260;Taip;14;0;0;14
2642;Gelvonėlis;BITUTĖS;5816373550;Taip;4;3;0;7
2643;Gelvonėlis;BITUTĖS;4380468764;Taip;7;0;0;7
2644;Gelvonėlis;RAMUNĖLĖS;1104204810;Taip;10;3;0;13
2645;Gelvonėlis;RAMUNĖLĖS;1355774181;Taip;10;0;0;10
2646;Gelvonėlis;RAMUNĖLĖS;2774170680;Taip;22;1;4;27
2647;Gelvonėlis;RAMUNĖLĖS;3269417874;Taip;8;0;0;8
2648;Gelvonėlis;RAMUNĖLĖS;9403505858;Ne;12;0;1;13
2649;Gelvonėlis;RAMUNĖLĖS;7686930719;Ne;5;0;1;6
2650;Gelvonėlis;RAMUNĖLĖS;4450990418;Taip;19;3;0;22
2651;Gelvonėlis;RAMUNĖLĖS;7419947442;Taip;0;0;7;7
2652;Gelvonėlis;RAMUNĖLĖS;6883156109;Taip;12;0;0;12
2653;Gelvonėlis;RAMUNĖLĖS;1562829157;Taip;4;3;0;7
2654;Gelvonėlis;RAMUNĖLĖS;4211228746;Taip;7;0;0;7
2655;Gelvonėlis;RAMUNĖLĖS;6365451610;Taip;15;2;0;17
2656;Gelvonėlis;RAMUNĖLĖS;1661034338;Taip;17;1;0;18
2657;Gelvonėlis;RAMUNĖLĖS;6851036864;Taip;8;0;2;10
2658;Gelvonėlis;RAMUNĖLĖS;2821485779;Taip;3;0;0;3
2659;Gelvonėlis;RAMUNĖLĖS;6518583809;Taip;16;0;2;18
2660;Gelvonėlis;RAMUNĖLĖS;2818319130;Taip;4;0;1;5
2661;Gelvonėlis;RIEŠUTĖLIAI;3368423382;Taip;13;1;0;14
2662;Gelvonėlis;RIEŠUTĖLIAI;3973248307;Taip;9;0;0;9
2663;Gelvonėlis;RIEŠUTĖLIAI;5461812139;Ne;8;6;0;14
2664;Gelvonėlis;RIEŠUTĖLIAI;5986018609;Taip;1;3;11;15
2665;Gelvonėlis;RIEŠUTĖLIAI;8532801167;Ne;9;0;0;9
2666;Gelvonėlis;RIEŠUTĖLIAI;4208103106;Taip;23;1;5;29
2667;Gelvonėlis;RIEŠUTĖLIAI;8766702456;Taip;9;0;1;10
2668;Gelvonėlis;RIEŠUTĖLIAI;6305084811;Taip;7;0;2;9
2669;Gelvonėlis;RIEŠUTĖLIAI;2005647155;Ne;9;0;0;9
2670;Gelvonėlis;RIEŠUTĖLIAI;1266479895;Taip;0;1;0;1
2671;Gelvonėlis;RIEŠUTĖLIAI;5934077931;Taip;12;4;0;16
2672;Gelvonėlis;RIEŠUTĖLIAI;4280463938;Taip;0;6;0;6
2673;Gelvonėlis;RIEŠUTĖLIAI;6471921512;Taip;8;0;0;8
2674;Gelvonėlis;RIEŠUTĖLIAI;3448444552;Taip;0;3;0;3
2675;Gelvonėlis;RIEŠUTĖLIAI;4832167372;Taip;11;1;0;12
2676;Gelvonėlis;RIEŠUTĖLIAI;9301814935;Taip;9;0;0;9
2677;Gelvonėlis;RIEŠUTĖLIAI;1466616814;Taip;0;0;3;3
2678;Gelvonėlis;RIEŠUTĖLIAI;2015807805;Taip;10;0;2;12
2679;Gelvonėlis;RIEŠUTĖLIAI;9323228591;Taip;9;0;1;10
2680;Gelvonėlis;RIEŠUTĖLIAI;2360728722;Taip;3;0;7;10
2681;Gelvonėlis;RIEŠUTĖLIAI;9132529216;Ne;8;5;0;13
2682;"Gervelė (Dzūkų g. 32)";ŽIRNIUKAI;2523056808;Ne;0;0;2;2
2683;"Gervelė (Dzūkų g. 32)";ŽIRNIUKAI;8533480337;Taip;10;0;3;13
2684;"Gervelė (Dzūkų g. 32)";ŽIRNIUKAI;6895415337;Taip;0;0;4;4
2685;"Gervelė (Dzūkų g. 32)";ŽIRNIUKAI;6227091658;Taip;6;0;3;9
2686;"Gervelė (Dzūkų g. 32)";ŽIRNIUKAI;8439479958;Taip;0;0;6;6
2687;"Gervelė (Dzūkų g. 32)";ŽIRNIUKAI;6844406500;Ne;0;0;13;13
2688;"Gervelė (Dzūkų g. 32)";ŽIRNIUKAI;2359854614;Taip;12;0;1;13
2689;"Gervelė (Dzūkų g. 32)";ŽIRNIUKAI;1573560581;Taip;20;0;1;21
2690;"Gervelė (Dzūkų g. 32)";ŽIRNIUKAI;9133101055;Taip;11;0;2;13
2691;"Gervelė (Dzūkų g. 32)";ŽIRNIUKAI;7192663882;Taip;18;0;0;18
2692;"Gervelė (Dzūkų g. 32)";ŽIRNIUKAI;1783612448;Taip;10;0;4;14
2693;"Gervelė (Dzūkų g. 32)";ŽIRNIUKAI;6650473677;Taip;0;0;2;2
2694;"Gervelė (Dzūkų g. 32)";ŽIRNIUKAI;2563081304;Taip;8;0;0;8
2695;"Gervelė (Dzūkų g. 32)";ŽIRNIUKAI;1101877666;Ne;2;0;18;20
2696;"Gervelė (Dzūkų g. 32)";ŽIRNIUKAI;3164744527;Taip;0;0;3;3
2697;"Gervelė (Dzūkų g. 32)";ŽIRNIUKAI;2046282471;Taip;18;0;0;18
2698;"Gervelė (Dzūkų g. 32)";ŽIRNIUKAI;1024397071;Ne;0;0;3;3
2699;"Gervelė (Dzūkų g. 32)";ŽIRNIUKAI;7040713170;Ne;0;0;8;8
2700;"Gervelė (Dzūkų g. 32)";ŽIRNIUKAI;4075328330;Taip;0;0;11;11
2701;"Gervelė (Dzūkų g. 32)";LAŠIUKAI;3702908570;Taip;0;8;0;8
2702;"Gervelė (Dzūkų g. 32)";LAŠIUKAI;3647044817;Taip;10;0;3;13
2703;"Gervelė (Dzūkų g. 32)";LAŠIUKAI;6431701403;Taip;10;0;1;11
2704;"Gervelė (Dzūkų g. 32)";LAŠIUKAI;7721421570;Taip;0;3;0;3
2705;"Gervelė (Dzūkų g. 32)";LAŠIUKAI;2413995770;Taip;13;0;1;14
2706;"Gervelė (Dzūkų g. 32)";LAŠIUKAI;1637204236;Taip;26;1;0;27
2707;"Gervelė (Dzūkų g. 32)";LAŠIUKAI;8157865822;Taip;10;3;0;13
2708;"Gervelė (Dzūkų g. 32)";LAŠIUKAI;7924884022;Taip;0;14;0;14
2709;"Gervelė (Dzūkų g. 32)";LAŠIUKAI;6834663627;Taip;0;14;0;14
2710;"Gervelė (Dzūkų g. 32)";LAŠIUKAI;1323074335;Taip;13;0;0;13
2711;"Gervelė (Dzūkų g. 32)";LAŠIUKAI;6058944385;Taip;5;11;0;16
2712;"Gervelė (Dzūkų g. 32)";LAŠIUKAI;2446758975;Taip;6;5;0;11
2713;"Gervelė (Dzūkų g. 32)";LAŠIUKAI;1353920541;Taip;0;7;0;7
2714;"Gervelė (Dzūkų g. 32)";LAŠIUKAI;5799823801;Ne;10;0;0;10
2715;"Gervelė (Dzūkų g. 32)";LAŠIUKAI;4899690598;Ne;10;0;0;10
2716;"Gervelė (Dzūkų g. 32)";PABIRUČIAI;7317091881;Taip;4;0;3;7
2717;"Gervelė (Dzūkų g. 32)";PABIRUČIAI;7020599764;Ne;0;1;3;4
2718;"Gervelė (Dzūkų g. 32)";PABIRUČIAI;6951455424;Taip;0;0;2;2
2719;"Gervelė (Dzūkų g. 32)";PABIRUČIAI;1112844296;Taip;0;0;5;5
2720;"Gervelė (Dzūkų g. 32)";PABIRUČIAI;6287806975;Taip;11;2;0;13
2721;"Gervelė (Dzūkų g. 32)";PABIRUČIAI;6228025635;Taip;20;0;1;21
2722;"Gervelė (Dzūkų g. 32)";PABIRUČIAI;9977349707;Taip;6;9;0;15
2723;"Gervelė (Dzūkų g. 32)";PABIRUČIAI;6155979185;Ne;5;6;0;11
2724;"Gervelė (Dzūkų g. 32)";PABIRUČIAI;3333885493;Taip;6;1;0;7
2725;"Gervelė (Dzūkų g. 32)";PABIRUČIAI;4295743997;Taip;3;1;0;4
2726;"Gervelė (Dzūkų g. 32)";PABIRUČIAI;7935059565;Taip;16;0;0;16
2727;"Gervelė (Dzūkų g. 32)";PABIRUČIAI;5267617723;Taip;6;2;0;8
2728;"Gervelė (Dzūkų g. 32)";PABIRUČIAI;5953552777;Taip;8;2;0;10
2729;"Gervelė (Dzūkų g. 32)";PABIRUČIAI;4038179503;Taip;18;1;1;20
2730;"Gervelė (Dzūkų g. 32)";PABIRUČIAI;1160084928;Taip;15;0;4;19
2731;"Gervelė (Dzūkų g. 32)";PABIRUČIAI;6987657237;Taip;14;0;1;15
2732;"Gervelė (Dzūkų g. 32)";PABIRUČIAI;8016341646;Ne;3;0;1;4
2733;"Gervelė (Dzūkų g. 32)";PABIRUČIAI;5685222621;Taip;18;0;0;18
2734;"Gervelė (Dzūkų g. 32)";PABIRUČIAI;4294916559;Taip;8;4;0;12
2735;"Gervelė (Dzūkų g. 32)";PABIRUČIAI;3449674095;Ne;7;5;0;12
2736;"Gervelė (Dzūkų g. 32)";BITUTĖS;6448855055;Taip;0;1;0;1
2737;"Gervelė (Dzūkų g. 32)";BITUTĖS;6090290046;Taip;0;5;0;5
2738;"Gervelė (Dzūkų g. 32)";BITUTĖS;75080308291;Ne;0;6;0;6
2739;"Gervelė (Dzūkų g. 32)";BITUTĖS;6737174004;Taip;0;5;0;5
2740;"Gervelė (Dzūkų g. 32)";BITUTĖS;1616949023;Taip;18;3;0;21
2741;"Gervelė (Dzūkų g. 32)";BITUTĖS;3427400844;Taip;0;8;0;8
2742;"Gervelė (Dzūkų g. 32)";BITUTĖS;8152446576;Taip;4;1;2;7
2743;"Gervelė (Dzūkų g. 32)";BITUTĖS;7302238728;Taip;0;1;0;1
2744;"Gervelė (Dzūkų g. 32)";BITUTĖS;1400044294;Taip;0;1;4;5
2745;"Gervelė (Dzūkų g. 32)";BITUTĖS;8062089041;Ne;8;12;0;20
2746;"Gervelė (Dzūkų g. 32)";BITUTĖS;7697761552;Taip;5;3;0;8
2747;"Gervelė (Dzūkų g. 32)";BITUTĖS;5989713844;Taip;0;7;0;7
2748;"Gervelė (Dzūkų g. 32)";BITUTĖS;4560752068;Taip;0;8;0;8
2749;"Gervelė (Dzūkų g. 32)";BITUTĖS;89076506192;Taip;2;1;0;3
2750;"Gervelė (Dzūkų g. 32)";BITUTĖS;87619285504;Taip;0;3;5;8
2751;"Gervelė (Dzūkų g. 32)";BITUTĖS;1991238577;Taip;0;7;0;7
2752;"Gervelė (Dzūkų g. 32)";BITUTĖS;2167744244;Taip;5;6;0;11
2753;"Gervelė (Dzūkų g. 32)";BITUTĖS;3525060645;Taip;5;5;0;10
2754;"Gervelė (Dzūkų g. 32)";BITUTĖS;7162551366;Taip;0;22;0;22
2755;"Gervelė (Dzūkų g. 32)";BITUTĖS;9970293084;Taip;0;7;0;7
2756;"Gervelė (Dzūkų g. 32)";BURATINO;3946391650;Taip;0;4;0;4
2757;"Gervelė (Dzūkų g. 32)";BURATINO;7620764911;Taip;7;10;0;17
2758;"Gervelė (Dzūkų g. 32)";BURATINO;9239897472;Taip;10;3;0;13
2759;"Gervelė (Dzūkų g. 32)";BURATINO;8997525194;Taip;0;4;0;4
2760;"Gervelė (Dzūkų g. 32)";BURATINO;3359793310;Ne;12;2;5;19
2761;"Gervelė (Dzūkų g. 32)";BURATINO;9982951468;Taip;16;2;0;18
2762;"Gervelė (Dzūkų g. 32)";BURATINO;5900623823;Ne;0;22;0;22
2763;"Gervelė (Dzūkų g. 32)";BURATINO;4775822341;Taip;6;1;0;7
2764;"Gervelė (Dzūkų g. 32)";BURATINO;8012122042;Taip;0;9;0;9
2765;"Gervelė (Dzūkų g. 32)";BURATINO;2541771432;Ne;14;3;0;17
2766;"Gervelė (Dzūkų g. 32)";BURATINO;2913622440;Taip;15;0;1;16
2767;"Gervelė (Dzūkų g. 32)";BURATINO;3912789554;Ne;18;0;0;18
2768;"Gervelė (Dzūkų g. 32)";BURATINO;4434618210;Taip;5;4;0;9
2769;"Gervelė (Dzūkų g. 32)";BURATINO;1108744283;Taip;0;8;0;8
2770;"Gervelė (Dzūkų g. 32)";BURATINO;6166476760;Ne;9;0;3;12
2771;"Gervelė (Dzūkų g. 32)";BURATINO;4516538272;Taip;6;1;6;13
2772;"Gervelė (Dzūkų g. 32)";BURATINO;9256422807;Taip;13;3;0;16
2773;"Gervelė (Dzūkų g. 32)";BURATINO;3723783633;Taip;14;1;0;15
2774;"Gervelė (Dzūkų g. 32)";BURATINO;9997346812;Taip;13;2;1;16
2775;"Gervelė (Dzūkų g. 32)";BURATINO;8472436632;Taip;9;0;7;16
2776;"Gervelė (Dzūkų g. 32)";VIŠČIUKŲ;1020706652;Taip;13;0;3;16
2777;"Gervelė (Dzūkų g. 32)";VIŠČIUKŲ;9532470407;Taip;2;0;1;3
2778;"Gervelė (Dzūkų g. 32)";VIŠČIUKŲ;7205673717;Taip;5;0;5;10
2779;"Gervelė (Dzūkų g. 32)";VIŠČIUKŲ;7140356352;Taip;4;0;3;7
2780;"Gervelė (Dzūkų g. 32)";VIŠČIUKŲ;8598429197;Taip;3;0;13;16
2781;"Gervelė (Dzūkų g. 32)";VIŠČIUKŲ;9294388176;Taip;0;0;2;2
2782;"Gervelė (Dzūkų g. 32)";VIŠČIUKŲ;8392147716;Taip;17;0;1;18
2783;"Gervelė (Dzūkų g. 32)";VIŠČIUKŲ;5608916470;Taip;1;0;1;2
2784;"Gervelė (Dzūkų g. 32)";VIŠČIUKŲ;8098158634;Taip;6;2;0;8
2785;"Gervelė (Dzūkų g. 32)";VIŠČIUKŲ;3554640994;Taip;8;0;0;8
2786;"Gervelė (Dzūkų g. 32)";VIŠČIUKŲ;9478720027;Taip;19;0;0;19
2787;"Gervelė (Dzūkų g. 32)";VIŠČIUKŲ;4552290778;Ne;4;0;0;4
2788;"Gervelė (Dzūkų g. 32)";VIŠČIUKŲ;3170062234;Taip;11;0;7;18
2789;"Gervelė (Dzūkų g. 32)";VIŠČIUKŲ;1226130732;Ne;10;0;0;10
2790;"Gervelė (Dzūkų g. 32)";VIŠČIUKŲ;8983236945;Taip;0;0;22;22
2791;"Gilužis (Vydūno g. 11A)";Skruzdėliukų;35511006307;Taip;4;3;0;7
2792;"Gilužis (Vydūno g. 11A)";Skruzdėliukų;1671692484;Ne;0;2;0;2
2793;"Gilužis (Vydūno g. 11A)";Skruzdėliukų;1615293331;Taip;0;10;0;10
2794;"Gilužis (Vydūno g. 11A)";Skruzdėliukų;9474400084;Taip;5;4;0;9
2795;"Gilužis (Vydūno g. 11A)";Skruzdėliukų;5161095299;Ne;0;1;0;1
2796;"Gilužis (Vydūno g. 11A)";Skruzdėliukų;70959404439;Taip;0;3;0;3
2797;"Gilužis (Vydūno g. 11A)";Skruzdėliukų;8120898865;Taip;0;3;0;3
2798;"Gilužis (Vydūno g. 11A)";Skruzdėliukų;4611735601;Taip;11;7;0;18
2799;"Gilužis (Vydūno g. 11A)";Skruzdėliukų;4747769984;Taip;5;2;0;7
2800;"Gilužis (Vydūno g. 11A)";Skruzdėliukų;5920357223;Taip;0;2;0;2
2801;"Gilužis (Vydūno g. 11A)";Skruzdėliukų;8595541498;Taip;0;1;0;1
2802;"Gilužis (Vydūno g. 11A)";Skruzdėliukų;5365582271;Taip;19;3;0;22
2803;"Gilužis (Vydūno g. 11A)";Skruzdėliukų;7364297673;Taip;11;1;0;12
2804;"Gilužis (Vydūno g. 11A)";Skruzdėliukų;4362244070;Taip;11;2;0;13
2805;"Gilužis (Vydūno g. 11A)";Skruzdėliukų;2042514241;Taip;4;0;0;4
2806;"Gilužis (Vydūno g. 11A)";Skruzdėliukų;3216004438;Taip;0;2;0;2
2807;"Gilužis (Vydūno g. 11A)";Skruzdėliukų;7766747590;Taip;5;0;0;5
2808;"Gilužis (Vydūno g. 11A)";Skruzdėliukų;48365991937;Taip;11;4;0;15
2809;"Gilužis (Vydūno g. 11A)";Skruzdėliukų;1452016675;Taip;1;6;0;7
2810;"Gilužis (Vydūno g. 11A)";Skruzdėliukų;29586826889;Taip;5;1;0;6
2811;"Gilužis (Vydūno g. 11A)";Skruzdėliukų;3071312399;Taip;10;4;0;14
2812;"Gilužis (Vydūno g. 11A)";Skruzdėliukų;6233020671;Taip;0;3;2;5
2813;"Gilužis (Vydūno g. 11A)";Nykštukų;3132445117;Taip;0;3;0;3
2814;"Gilužis (Vydūno g. 11A)";Nykštukų;4147821853;Taip;0;2;0;2
2815;"Gilužis (Vydūno g. 11A)";Nykštukų;7937643339;Taip;4;1;0;5
2816;"Gilužis (Vydūno g. 11A)";Nykštukų;3473889426;Taip;5;1;0;6
2817;"Gilužis (Vydūno g. 11A)";Nykštukų;9362581908;Taip;5;1;0;6
2818;"Gilužis (Vydūno g. 11A)";Nykštukų;8899557365;Taip;14;2;0;16
2819;"Gilužis (Vydūno g. 11A)";Nykštukų;2661894041;Taip;13;0;0;13
2820;"Gilužis (Vydūno g. 11A)";Nykštukų;5109935385;Taip;7;1;1;9
2821;"Gilužis (Vydūno g. 11A)";Nykštukų;7228498662;Taip;2;3;2;7
2822;"Gilužis (Vydūno g. 11A)";Nykštukų;3335512812;Taip;0;4;0;4
2823;"Gilužis (Vydūno g. 11A)";Nykštukų;4156613717;Taip;11;2;0;13
2824;"Gilužis (Vydūno g. 11A)";Nykštukų;5713786735;Taip;0;2;0;2
2825;"Gilužis (Vydūno g. 11A)";Nykštukų;4956685016;Taip;3;1;0;4
2826;"Gilužis (Vydūno g. 11A)";Nykštukų;6315155554;Taip;9;1;0;10
2827;"Gilužis (Vydūno g. 11A)";Nykštukų;9332056404;Taip;11;1;0;12
2828;"Gilužis (Vydūno g. 11A)";Nykštukų;4541291716;Taip;0;1;0;1
2829;"Gilužis (Vydūno g. 11A)";Nykštukų;8522552650;Taip;21;1;0;22
2830;"Gilužis (Vydūno g. 11A)";Nykštukų;3176305306;Taip;0;5;5;10
2831;"Gilužis (Vydūno g. 11A)";Nykštukų;4094486541;Taip;14;0;0;14
2832;"Gilužis (Vydūno g. 11A)";Nykštukų;5088561405;Taip;5;6;0;11
2833;"Gilužis (Vydūno g. 11A)";Bitučių;1634295583;Ne;0;1;0;1
2834;"Gilužis (Vydūno g. 11A)";Bitučių;4360261750;Ne;0;1;0;1
2835;"Gilužis (Vydūno g. 11A)";Bitučių;2780710383;Taip;5;1;0;6
2836;"Gilužis (Vydūno g. 11A)";Bitučių;6931726275;Taip;5;2;0;7
2837;"Gilužis (Vydūno g. 11A)";Bitučių;1867185320;Taip;0;3;0;3
2838;"Gilužis (Vydūno g. 11A)";Bitučių;3429435736;Ne;9;1;0;10
2839;"Gilužis (Vydūno g. 11A)";Bitučių;8539946703;Ne;11;22;0;33
2840;"Gilužis (Vydūno g. 11A)";Bitučių;9000351000;Taip;9;1;0;10
2841;"Gilužis (Vydūno g. 11A)";Bitučių;5366174839;Taip;0;1;0;1
2842;"Gilužis (Vydūno g. 11A)";Bitučių;5162397237;Taip;0;7;0;7
2843;"Gilužis (Vydūno g. 11A)";Bitučių;7250617867;Taip;0;1;0;1
2844;"Gilužis (Vydūno g. 11A)";Bitučių;9053608903;Taip;14;3;0;17
2845;"Gilužis (Vydūno g. 11A)";Bitučių;6115776872;Taip;0;0;3;3
2846;"Gilužis (Vydūno g. 11A)";Bitučių;5651799121;Taip;11;0;5;16
2847;"Gilužis (Vydūno g. 11A)";Bitučių;2950813185;Taip;3;4;0;7
2848;"Gilužis (Vydūno g. 11A)";Bitučių;6515525848;Taip;8;0;0;8
2849;"Gilužis (Vydūno g. 11A)";Bitučių;2345403784;Taip;2;0;0;2
2850;"Gilužis (Vydūno g. 11A)";Kačiukų;1273655212;Taip;0;1;0;1
2851;"Gilužis (Vydūno g. 11A)";Kačiukų;4978922821;Taip;15;2;0;17
2852;"Gilužis (Vydūno g. 11A)";Kačiukų;2945406185;Taip;16;0;0;16
2853;"Gilužis (Vydūno g. 11A)";Kačiukų;1582241363;Ne;9;3;1;13
2854;"Gilužis (Vydūno g. 11A)";Kačiukų;7330938312;Taip;9;0;3;12
2855;"Gilužis (Vydūno g. 11A)";Kačiukų;6571132974;Taip;0;22;0;22
2856;"Gilužis (Vydūno g. 11A)";Kačiukų;7001112696;Taip;5;3;3;11
2857;"Gilužis (Vydūno g. 11A)";Kačiukų;9034842169;Taip;8;0;0;8
2858;"Gilužis (Vydūno g. 11A)";Kačiukų;6966795180;Taip;14;7;0;21
2859;"Gilužis (Vydūno g. 11A)";Kačiukų;5128383851;Taip;22;1;5;28
2860;"Gilužis (Vydūno g. 11A)";Kačiukų;8318405114;Taip;7;3;2;12
2861;"Gilužis (Vydūno g. 11A)";Kačiukų;7826015897;Taip;0;1;0;1
2862;"Gilužis (Vydūno g. 11A)";Kačiukų;4403218878;Taip;3;1;1;5
2863;"Gilužis (Vydūno g. 11A)";Kačiukų;9186274541;Taip;17;3;0;20
2864;"Gilužis (Vydūno g. 11A)";Kačiukų;3419281756;Taip;0;1;0;1
2865;"Gilužis (Vydūno g. 11A)";Kačiukų;1862524255;Taip;6;1;0;7
2866;"Gilužis (Vydūno g. 11A)";Kačiukų;9421351780;Taip;4;0;0;4
2867;"Gilužis (Vydūno g. 11A)";Kačiukų;6404411477;Taip;0;8;0;8
2868;"Gilužis (Vydūno g. 11A)";Kačiukų;4128387076;Taip;4;0;2;6
2869;"Gilužis (Vydūno g. 11A)";Kačiukų;7042664923;Taip;10;3;0;13
2870;"Gilužis (Vydūno g. 11A)";Kačiukų;9097165155;Ne;11;0;1;12
2871;"Gilužis (Vydūno g. 11A)";Kačiukų;8762534617;Taip;0;9;0;9
2872;"Gilužis (Vydūno g. 11A)";Pelėdžiukų;5217748032;Taip;0;10;0;10
2873;"Gilužis (Vydūno g. 11A)";Pelėdžiukų;5989314494;Taip;0;2;4;6
2874;"Gilužis (Vydūno g. 11A)";Pelėdžiukų;7998695149;Taip;13;0;0;13
2875;"Gilužis (Vydūno g. 11A)";Pelėdžiukų;7742783427;Taip;13;0;0;13
2876;"Gilužis (Vydūno g. 11A)";Pelėdžiukų;7358572344;Taip;0;6;0;6
2877;"Gilužis (Vydūno g. 11A)";Pelėdžiukų;4617259961;Taip;6;1;0;7
2878;"Gilužis (Vydūno g. 11A)";Pelėdžiukų;1222370750;Taip;14;8;0;22
2879;"Gilužis (Vydūno g. 11A)";Pelėdžiukų;9503516686;Taip;0;3;0;3
2880;"Gilužis (Vydūno g. 11A)";Pelėdžiukų;9833451628;Taip;2;7;0;9
2881;"Gilužis (Vydūno g. 11A)";Pelėdžiukų;6270071724;Taip;0;1;0;1
2882;"Gilužis (Vydūno g. 11A)";Pelėdžiukų;7505729606;Ne;12;0;0;12
2883;"Gilužis (Vydūno g. 11A)";Pelėdžiukų;4051726208;Taip;12;0;0;12
2884;"Gilužis (Vydūno g. 11A)";Pelėdžiukų;7092060789;Taip;9;1;0;10
2885;"Gilužis (Vydūno g. 11A)";Pelėdžiukų;4435227217;Taip;5;0;0;5
2886;"Gilužis (Vydūno g. 11A)";Pelėdžiukų;1804218972;Taip;0;2;0;2
2887;"Gilužis (Vydūno g. 11A)";Pelėdžiukų;2434419240;Taip;10;0;0;10
2888;"Gilužis (Vydūno g. 11A)";Pelėdžiukų;1832039250;Taip;9;3;2;14
2889;"Gilužis (Vydūno g. 11A)";Pelėdžiukų;3166161973;Taip;7;1;0;8
2890;"Gilužis (Vydūno g. 11A)";Pelėdžiukų;5070988982;Taip;17;1;0;18
2891;"Gilužis (Vydūno g. 11A)";Pelėdžiukų;7899274495;Taip;0;0;12;12
2892;"Gilužis (Vydūno g. 11A)";Pelėdžiukų;6093514885;Taip;5;1;0;6
2893;"Gilužis (Vydūno g. 11A)";Pelėdžiukų;2869506388;Taip;8;0;0;8
2894;"Gilužis (Vydūno g. 11A)";Pelėdžiukų;9520409342;Taip;9;0;0;9
2895;"Gilužis (Vydūno g. 11A)";Drugelių;6121625070;Taip;9;1;0;10
2896;"Gilužis (Vydūno g. 11A)";Drugelių;1770064694;Taip;0;1;0;1
2897;"Gilužis (Vydūno g. 11A)";Drugelių;9591229878;Taip;10;0;0;10
2898;"Gilužis (Vydūno g. 11A)";Drugelių;9092013248;Taip;13;9;0;22
2899;"Gilužis (Vydūno g. 11A)";Drugelių;9109883577;Ne;0;3;3;6
2900;"Gilužis (Vydūno g. 11A)";Drugelių;8006465211;Taip;0;0;5;5
2901;"Gilužis (Vydūno g. 11A)";Drugelių;5118401707;Taip;10;1;0;11
2902;"Gilužis (Vydūno g. 11A)";Drugelių;3190597262;Ne;0;1;5;6
2903;"Gilužis (Vydūno g. 11A)";Drugelių;2988856911;Taip;17;0;0;17
2904;"Gilužis (Vydūno g. 11A)";Drugelių;3532863024;Taip;0;22;0;22
2905;"Gilužis (Vydūno g. 11A)";Drugelių;1376645277;Taip;0;1;0;1
2906;"Gilužis (Vydūno g. 11A)";Drugelių;1410870589;Taip;7;7;0;14
2907;"Gilužis (Vydūno g. 11A)";Drugelių;6786334223;Taip;16;0;0;16
2908;"Gilužis (Vydūno g. 11A)";Drugelių;9112993465;Taip;12;0;0;12
2909;"Gilužis (Vydūno g. 11A)";Drugelių;4909329417;Taip;0;1;0;1
2910;"Gilužis (Vydūno g. 11A)";Drugelių;8244385001;Taip;0;1;0;1
2911;"Gilužis (Vydūno g. 11A)";Drugelių;6429142049;Taip;10;0;1;11
2912;"Gilužis (Vydūno g. 11A)";Drugelių;7731169885;Ne;7;1;2;10
2913;"Gilužis (Vydūno g. 11A)";Drugelių;1093643746;Taip;3;8;0;11
2914;"Gilužis (Vydūno g. 11A)";Drugelių;3902713866;Taip;6;0;0;6
2915;"Gilužis (Vydūno g. 11A)";Drugelių;6950139609;Taip;0;3;5;8
2916;"Gilužis (Vydūno g. 11A)";Drugelių;2397231165;Ne;10;1;0;11
2917;"Gilužis (Vydūno g. 11A)";Saulučių;17896774143;Taip;0;9;2;11
2918;"Gilužis (Vydūno g. 11A)";Saulučių;9918995545;Taip;0;2;0;2
2919;"Gilužis (Vydūno g. 11A)";Saulučių;4209000927;Taip;0;1;2;3
2920;"Gilužis (Vydūno g. 11A)";Saulučių;8595551150;Taip;0;1;0;1
2921;"Gilužis (Vydūno g. 11A)";Saulučių;4575619425;Taip;2;1;3;6
2922;"Gilužis (Vydūno g. 11A)";Saulučių;4473810097;Taip;0;4;0;4
2923;"Gilužis (Vydūno g. 11A)";Saulučių;1649256496;Taip;0;1;0;1
2924;"Gilužis (Vydūno g. 11A)";Saulučių;96550272401;Taip;7;0;0;7
2925;"Gilužis (Vydūno g. 11A)";Saulučių;69504888193;Taip;0;3;0;3
2926;"Gilužis (Vydūno g. 11A)";Saulučių;2391630554;Taip;0;1;0;1
2927;"Gilužis (Vydūno g. 11A)";Saulučių;18997894859;Taip;0;1;0;1
2928;"Gilužis (Vydūno g. 11A)";Saulučių;7744997250;Ne;16;1;0;17
2929;"Gilužis (Vydūno g. 11A)";Saulučių;32730847948;Taip;2;1;1;4
2930;"Gilužis (Vydūno g. 11A)";Saulučių;3181765606;Taip;0;1;0;1
2931;"Gilužis (Vydūno g. 11A)";Saulučių;5905237803;Taip;2;1;0;3
2932;"Gilužis (Vydūno g. 11A)";Saulučių;79805583046;Taip;0;1;0;1
2933;"Gilužis (Vydūno g. 11A)";Saulučių;2872439079;Taip;0;1;2;3
2934;"Gilužis (Vydūno g. 11A)";Saulučių;87425898496;Taip;0;1;0;1
2935;"Gilužis (Vydūno g. 11A)";Saulučių;35650138667;Taip;8;1;2;11
2936;"Gilužis (Vydūno g. 11A)";Saulučių;9367673896;Taip;7;1;0;8
2937;"Gilužis (Vydūno g. 11A)";Saulučių;1453976300;Taip;0;2;0;2
2938;"Gilužis (Vydūno g. 11A)";Saulučių;1211233315;Taip;0;0;1;1
2939;"Gilužis (Vydūno g. 11A)";Saulučių;5621912516;Taip;5;2;0;7
2940;"Gilužis (Vydūno g. 11A)";Paukštelių;46597815116;Taip;5;0;0;5
2941;"Gilužis (Vydūno g. 11A)";Paukštelių;1877467761;Ne;0;1;11;12
2942;"Gilužis (Vydūno g. 11A)";Paukštelių;1146713023;Taip;0;6;0;6
2943;"Gilužis (Vydūno g. 11A)";Paukštelių;1980250599;Taip;0;1;1;2
2944;"Gilužis (Vydūno g. 11A)";Paukštelių;1962914764;Taip;12;1;0;13
2945;"Gilužis (Vydūno g. 11A)";Paukštelių;2508958685;Ne;9;1;8;18
2946;"Gilužis (Vydūno g. 11A)";Paukštelių;72738770293;Taip;0;1;0;1
2947;"Gilužis (Vydūno g. 11A)";Paukštelių;8875479631;Taip;0;11;0;11
2948;"Gilužis (Vydūno g. 11A)";Paukštelių;5759145600;Taip;0;22;0;22
2949;"Gilužis (Vydūno g. 11A)";Paukštelių;8662424856;Taip;0;2;1;3
2950;"Gilužis (Vydūno g. 11A)";Paukštelių;2436416327;Taip;0;2;0;2
2951;"Gilužis (Vydūno g. 11A)";Paukštelių;6218943275;Taip;0;1;0;1
2952;"Gilužis (Vydūno g. 11A)";Paukštelių;2754594238;Taip;0;9;0;9
2953;"Gilužis (Vydūno g. 11A)";Paukštelių;8110869130;Taip;2;2;0;4
2954;"Gilužis (Vydūno g. 11A)";Paukštelių;1344240019;Taip;21;1;0;22
2955;"Gilužis (Vydūno g. 11A)";Paukštelių;4297300799;Taip;4;6;4;14
2956;"Gilužis (Vydūno g. 11A)";Paukštelių;8531121002;Taip;0;4;0;4
2957;"Gilužis (Vydūno g. 11A)";Paukštelių;9314893329;Taip;7;1;0;8
2958;"Gilužis (Vydūno g. 11A)";Paukštelių;46276990963;Taip;0;5;4;9
2959;"Gilužis (Vydūno g. 11A)";Paukštelių;5303511810;Taip;3;3;10;16
2960;"Gilužis (Vydūno g. 11A)";Obuoliukų;8201769917;Taip;7;3;0;10
2961;"Gilužis (Vydūno g. 11A)";Obuoliukų;9892608223;Taip;0;9;0;9
2962;"Gilužis (Vydūno g. 11A)";Obuoliukų;1540018160;Taip;8;0;0;8
2963;"Gilužis (Vydūno g. 11A)";Obuoliukų;7716908903;Taip;3;0;0;3
2964;"Gilužis (Vydūno g. 11A)";Obuoliukų;3131597174;Taip;11;3;0;14
2965;"Gilužis (Vydūno g. 11A)";Obuoliukų;6239369861;Taip;14;1;1;16
2966;"Gilužis (Vydūno g. 11A)";Obuoliukų;6172360933;Taip;3;2;0;5
2967;"Gilužis (Vydūno g. 11A)";Obuoliukų;7398446674;Taip;6;1;0;7
2968;"Gilužis (Vydūno g. 11A)";Obuoliukų;4592380105;Taip;33;0;0;33
2969;"Gilužis (Vydūno g. 11A)";Obuoliukų;4242362889;Taip;2;1;0;3
2970;"Gilužis (Vydūno g. 11A)";Obuoliukų;7560732216;Taip;2;1;0;3
2971;"Gilužis (Vydūno g. 11A)";Obuoliukų;5476140202;Taip;17;4;0;21
2972;"Gilužis (Vydūno g. 11A)";Obuoliukų;8194444043;Taip;7;0;0;7
2973;"Gilužis (Vydūno g. 11A)";Obuoliukų;7606394325;Ne;14;3;0;17
2974;"Gilužis (Vydūno g. 11A)";Obuoliukų;6737884137;Taip;8;8;0;16
2975;"Gilužis (Vydūno g. 11A)";Obuoliukų;6825745985;Taip;10;0;0;10
2976;"Gilužis (Vydūno g. 11A)";Obuoliukų;3458957423;Taip;16;3;0;19
2977;"Gilužis (Vydūno g. 11A)";Obuoliukų;8900414658;Taip;9;2;0;11
2978;"Gilužis (Vydūno g. 11A)";Obuoliukų;3219101391;Ne;13;2;0;15
2979;"Gilužis (Vydūno g. 11A)";Obuoliukų;4528131001;Taip;0;10;0;10
2980;"Gilužis (Vydūno g. 11A)";Obuoliukų;5895659747;Taip;6;8;0;14
2981;"Gilužis (Vydūno g. 11A)";KIŠKUČIŲ;5744027226;Taip;9;0;0;9
2982;"Gilužis (Vydūno g. 11A)";KIŠKUČIŲ;8639633038;Taip;4;0;1;5
2983;"Gilužis (Vydūno g. 11A)";KIŠKUČIŲ;5721924532;Taip;9;0;0;9
2984;"Gilužis (Vydūno g. 11A)";KIŠKUČIŲ;9484221435;Taip;0;0;1;1
2985;"Gilužis (Vydūno g. 11A)";KIŠKUČIŲ;6323747855;Taip;0;0;2;2
2986;"Gilužis (Vydūno g. 11A)";KIŠKUČIŲ;2680643896;Taip;30;3;0;33
2987;"Gilužis (Vydūno g. 11A)";KIŠKUČIŲ;5685074731;Taip;5;0;0;5
2988;"Gilužis (Vydūno g. 11A)";KIŠKUČIŲ;7632771776;Taip;5;0;1;6
2989;"Gilužis (Vydūno g. 11A)";KIŠKUČIŲ;7477282548;Taip;7;0;0;7
2990;"Gilužis (Vydūno g. 11A)";KIŠKUČIŲ;9061835019;Taip;0;0;2;2
2991;"Gilužis (Vydūno g. 11A)";KIŠKUČIŲ;7560574633;Ne;24;0;0;24
2992;"Gilužis (Vydūno g. 11A)";KIŠKUČIŲ;4199633620;Ne;9;1;0;10
2993;"Gilužis (Vydūno g. 11A)";KIŠKUČIŲ;9851612698;Ne;10;0;0;10
2994;"Gilužis (Vydūno g. 11A)";KIŠKUČIŲ;1391410955;Taip;0;22;0;22
2995;"Gilužis (Vydūno g. 11A)";KIŠKUČIŲ;6383469680;Taip;6;9;0;15
2996;"Gilužis (Vydūno g. 11A)";KIŠKUČIŲ;8341597766;Taip;9;0;0;9
2997;"Gilužis (Vydūno g. 11A)";KIŠKUČIŲ;3171560628;Taip;0;6;0;6
2998;"Gilužis (Vydūno g. 11A)";KIŠKUČIŲ;4347319425;Taip;9;0;0;9
2999;"Gilužis (Vydūno g. 11A)";KIŠKUČIŲ;8591741716;Ne;5;0;2;7
3000;"Gilužis (Vydūno g. 11A)";KIŠKUČIŲ;8877445672;Taip;11;0;0;11
3001;"Gilužis (Vydūno g. 11A)";KIŠKUČIŲ;9489594782;Taip;9;3;0;12
3002;"Gilužis (Vydūno g. 11A)";KIŠKUČIŲ;6185954940;Ne;0;0;3;3
3003;"Gilužis (Vydūno g. 11A)";Meškučių;7263432152;Ne;8;1;0;9
3004;"Gilužis (Vydūno g. 11A)";Meškučių;4655266106;Taip;0;1;0;1
3005;"Gilužis (Vydūno g. 11A)";Meškučių;3800593189;Ne;6;8;0;14
3006;"Gilužis (Vydūno g. 11A)";Meškučių;4174307847;Taip;3;0;0;3
3007;"Gilužis (Vydūno g. 11A)";Meškučių;8393554697;Ne;15;0;0;15
3008;"Gilužis (Vydūno g. 11A)";Meškučių;8301535013;Taip;1;0;0;1
3009;"Gilužis (Vydūno g. 11A)";Meškučių;2939982311;Taip;10;1;0;11
3010;"Gilužis (Vydūno g. 11A)";Meškučių;3365778697;Taip;9;8;0;17
3011;"Gilužis (Vydūno g. 11A)";Meškučių;7912093880;Ne;12;2;0;14
3012;"Gilužis (Vydūno g. 11A)";Meškučių;2389277783;Taip;0;5;2;7
3013;"Gilužis (Vydūno g. 11A)";Meškučių;2500949029;Taip;0;7;0;7
3014;"Gilužis (Vydūno g. 11A)";Meškučių;4741129495;Taip;19;3;0;22
3015;"Gilužis (Vydūno g. 11A)";Meškučių;7992750316;Taip;17;0;0;17
3016;"Gilužis (Vydūno g. 11A)";Meškučių;2577554894;Taip;13;0;0;13
3017;"Gilužis (Vydūno g. 11A)";Meškučių;6303770262;Taip;10;0;0;10
3018;"Gilužis (Vydūno g. 11A)";Meškučių;3148477315;Taip;18;0;0;18
3019;"Gilužis (Vydūno g. 11A)";Meškučių;1068375927;Taip;9;4;0;13
3020;"Gilužis (Vydūno g. 11A)";Meškučių;8476240141;Taip;6;0;0;6
3021;"Gilužis (Vydūno g. 11A)";Meškučių;8780573054;Taip;11;3;0;14
3022;"Gilužis (Vydūno g. 11A)";Meškučių;6185280967;Ne;15;0;0;15
3023;"Gilužis (Vydūno g. 11A)";Meškučių;5177805719;Taip;0;22;0;22
3024;"Gilužis (Vydūno g. 11A)";Meškučių;7045940267;Taip;4;2;0;6
3025;"Gilužis (Vydūno g. 11A)";Pagrandukai;6884146146;Taip;0;22;0;22
3026;"Gilužis (Vydūno g. 11A)";Pagrandukai;6920910054;Taip;22;0;0;22
3027;"Gilužis (Vydūno g. 11A)";Pagrandukai;5705945483;Taip;8;2;0;10
3028;"Gilužis (Vydūno g. 11A)";Pagrandukai;6501973647;Taip;13;0;0;13
3029;"Gilužis (Vydūno g. 11A)";Pagrandukai;5397975739;Taip;13;0;0;13
3030;"Gilužis (Vydūno g. 11A)";Pagrandukai;6109205159;Taip;12;1;0;13
3031;"Gilužis (Vydūno g. 11A)";Pagrandukai;2328338059;Taip;12;1;0;13
3032;"Gilužis (Vydūno g. 11A)";Pagrandukai;5376639182;Taip;4;3;0;7
3033;"Gilužis (Vydūno g. 11A)";Pagrandukai;5378701300;Taip;8;3;0;11
3034;"Gilužis (Vydūno g. 11A)";Pagrandukai;3366788027;Taip;8;3;0;11
3035;"Gilužis (Vydūno g. 11A)";Pagrandukai;9676661005;Ne;13;0;0;13
3036;"Gilužis (Vydūno g. 11A)";Pagrandukai;1306757860;Ne;13;0;0;13
3037;"Gilužis (Vydūno g. 11A)";Pagrandukai;2706629834;Taip;13;2;0;15
3038;"Gilužis (Vydūno g. 11A)";Pagrandukai;1604096952;Taip;17;0;0;17
3039;"Gilužis (Vydūno g. 11A)";Pagrandukai;5184511012;Taip;22;0;0;22
3040;"Gilužis (Vydūno g. 11A)";Pagrandukai;9587502317;Taip;22;0;0;22
3041;"Gilužis (Vydūno g. 11A)";Pagrandukai;4266998302;Taip;13;4;0;17
3042;"Gilužis (Vydūno g. 11A)";Pagrandukai;5334441484;Taip;15;1;0;16
3043;"Gilužis (Vydūno g. 11A)";Pagrandukai;6831107153;Taip;22;0;0;22
3044;"Gilužis (Vydūno g. 11A)";Pagrandukai;8852862161;Taip;22;0;0;22
3045;"Gilužis (Vydūno g. 11A)";Pagrandukai;2955779117;Taip;22;0;0;22
3046;"Gilužis (Vydūno g. 11A)";Boružėlių;5497242500;Taip;6;9;0;15
3047;"Gilužis (Vydūno g. 11A)";Boružėlių;2516315604;Taip;6;1;1;8
3048;"Gilužis (Vydūno g. 11A)";Boružėlių;9783700319;Taip;16;0;0;16
3049;"Gilužis (Vydūno g. 11A)";Boružėlių;5394693502;Taip;8;1;0;9
3050;"Gilužis (Vydūno g. 11A)";Boružėlių;4876074981;Taip;12;1;0;13
3051;"Gilužis (Vydūno g. 11A)";Boružėlių;2633680406;Taip;14;7;0;21
3052;"Gilužis (Vydūno g. 11A)";Boružėlių;2221786284;Taip;8;2;0;10
3053;"Gilužis (Vydūno g. 11A)";Boružėlių;3002266577;Taip;15;0;0;15
3054;"Gilužis (Vydūno g. 11A)";Boružėlių;5190752112;Ne;16;1;0;17
3055;"Gilužis (Vydūno g. 11A)";Boružėlių;2440762487;Ne;16;1;0;17
3056;"Gilužis (Vydūno g. 11A)";Boružėlių;4509741536;Ne;21;1;0;22
3057;"Gilužis (Vydūno g. 11A)";Boružėlių;9707968228;Taip;12;0;0;12
3058;"Gilužis (Vydūno g. 11A)";Boružėlių;8628253655;Taip;13;9;0;22
3059;"Gilužis (Vydūno g. 11A)";Boružėlių;9104005195;Taip;15;0;0;15
3060;"Gilužis (Vydūno g. 11A)";Boružėlių;5581417252;Taip;0;22;0;22
3061;"Gilužis (Vydūno g. 11A)";Boružėlių;4106792355;Taip;0;1;0;1
3062;"Gilužis (Vydūno g. 11A)";Boružėlių;4475698906;Taip;9;3;0;12
3063;"Gilužis (Vydūno g. 11A)";Boružėlių;1085130813;Taip;7;3;0;10
3064;"Gilužis (Vydūno g. 11A)";Boružėlių;2615087717;Taip;15;1;0;16
3065;"Gintarėlis (Didlaukio g. 35)";PAPŪGĖLĖS;8498936096;Taip;5;1;0;6
3066;"Gintarėlis (Didlaukio g. 35)";PAPŪGĖLĖS;8913652291;Taip;0;0;14;14
3067;"Gintarėlis (Didlaukio g. 35)";PAPŪGĖLĖS;2485750596;Taip;6;0;1;7
3068;"Gintarėlis (Didlaukio g. 35)";PAPŪGĖLĖS;1033624080;Taip;4;2;0;6
3069;"Gintarėlis (Didlaukio g. 35)";PAPŪGĖLĖS;2919700367;Ne;18;2;0;20
3070;"Gintarėlis (Didlaukio g. 35)";PAPŪGĖLĖS;1768789948;Taip;8;0;3;11
3071;"Gintarėlis (Didlaukio g. 35)";PAPŪGĖLĖS;2595566032;Taip;0;15;0;15
3072;"Gintarėlis (Didlaukio g. 35)";PAPŪGĖLĖS;9141438560;Taip;10;10;0;20
3073;"Gintarėlis (Didlaukio g. 35)";PAPŪGĖLĖS;2235045173;Taip;4;0;1;5
3074;"Gintarėlis (Didlaukio g. 35)";PAPŪGĖLĖS;9494521554;Taip;4;12;0;16
3075;"Gintarėlis (Didlaukio g. 35)";PAPŪGĖLĖS;7494884360;Taip;5;9;0;14
3076;"Gintarėlis (Didlaukio g. 35)";PAPŪGĖLĖS;7147842224;Taip;0;3;8;11
3077;"Gintarėlis (Didlaukio g. 35)";PAPŪGĖLĖS;5783939567;Taip;0;3;1;4
3078;"Gintarėlis (Didlaukio g. 35)";PAPŪGĖLĖS;7674351459;Taip;0;11;0;11
3079;"Gintarėlis (Didlaukio g. 35)";PAPŪGĖLĖS;6292664833;Taip;12;0;3;15
3080;"Gintarėlis (Didlaukio g. 35)";PAPŪGĖLĖS;8610886062;Taip;8;4;6;18
3081;"Gintarėlis (Didlaukio g. 35)";PAPŪGĖLĖS;5811396263;Taip;11;1;0;12
3082;"Gintarėlis (Didlaukio g. 35)";PAPŪGĖLĖS;1648843117;Taip;17;2;0;19
3083;"Gintarėlis (Didlaukio g. 35)";PAPŪGĖLĖS;1861324153;Taip;0;11;0;11
3084;"Gintarėlis (Didlaukio g. 35)";PAPŪGĖLĖS;3457974670;Taip;17;0;0;17
3085;"Gintarėlis (Didlaukio g. 35)";PAPŪGĖLĖS;1511718436;Ne;6;0;8;14
3086;"Gintarėlis (Didlaukio g. 35)";PAPŪGĖLĖS;4484711857;Taip;0;1;10;11
3087;"Gintarėlis (Didlaukio g. 35)";PAPŪGĖLĖS;6080108998;Taip;14;0;0;14
3088;"Gintarėlis (Didlaukio g. 35)";PAPŪGĖLĖS;6655645997;Taip;11;2;0;13
3089;"Gintarėlis (Didlaukio g. 35)";SPINDULIUKAI;9303448709;Taip;10;0;2;12
3090;"Gintarėlis (Didlaukio g. 35)";SPINDULIUKAI;6091264509;Taip;9;13;0;22
3091;"Gintarėlis (Didlaukio g. 35)";SPINDULIUKAI;56124970238;Taip;0;2;0;2
3092;"Gintarėlis (Didlaukio g. 35)";SPINDULIUKAI;4902086873;Taip;8;0;0;8
3093;"Gintarėlis (Didlaukio g. 35)";SPINDULIUKAI;22394648690;Ne;21;0;0;21
3094;"Gintarėlis (Didlaukio g. 35)";SPINDULIUKAI;34606130829;Taip;5;2;0;7
3095;"Gintarėlis (Didlaukio g. 35)";SPINDULIUKAI;21658913551;Taip;12;4;3;19
3096;"Gintarėlis (Didlaukio g. 35)";SPINDULIUKAI;8405210216;Ne;14;0;0;14
3097;"Gintarėlis (Didlaukio g. 35)";SPINDULIUKAI;18715625324;Taip;17;0;0;17
3098;"Gintarėlis (Didlaukio g. 35)";SPINDULIUKAI;2914156353;Taip;12;1;4;17
3099;"Gintarėlis (Didlaukio g. 35)";SPINDULIUKAI;4612041848;Taip;8;2;0;10
3100;"Gintarėlis (Didlaukio g. 35)";SPINDULIUKAI;5916948150;Taip;0;1;0;1
3101;"Gintarėlis (Didlaukio g. 35)";SPINDULIUKAI;45480802894;Ne;6;3;2;11
3102;"Gintarėlis (Didlaukio g. 35)";SPINDULIUKAI;3978892232;Taip;5;1;0;6
3103;"Gintarėlis (Didlaukio g. 35)";SPINDULIUKAI;1770479969;Taip;8;0;0;8
3104;"Gintarėlis (Didlaukio g. 35)";SPINDULIUKAI;1441282039;Taip;8;2;0;10
3105;"Gintarėlis (Didlaukio g. 35)";SPINDULIUKAI;9539570835;Taip;9;0;0;9
3106;"Gintarėlis (Didlaukio g. 35)";SPINDULIUKAI;7878911379;Taip;8;0;0;8
3107;"Gintarėlis (Didlaukio g. 35)";LAŠIUKAI;6142819210;Taip;5;1;0;6
3108;"Gintarėlis (Didlaukio g. 35)";LAŠIUKAI;7971810025;Taip;11;0;0;11
3109;"Gintarėlis (Didlaukio g. 35)";LAŠIUKAI;28704617970;Ne;8;1;0;9
3110;"Gintarėlis (Didlaukio g. 35)";LAŠIUKAI;8247701603;Taip;0;1;0;1
3111;"Gintarėlis (Didlaukio g. 35)";LAŠIUKAI;4498326942;Taip;0;2;0;2
3112;"Gintarėlis (Didlaukio g. 35)";LAŠIUKAI;4641943773;Taip;6;1;0;7
3113;"Gintarėlis (Didlaukio g. 35)";LAŠIUKAI;1655837441;Ne;0;1;0;1
3114;"Gintarėlis (Didlaukio g. 35)";LAŠIUKAI;1690400583;Taip;0;2;11;13
3115;"Gintarėlis (Didlaukio g. 35)";LAŠIUKAI;1826743229;Taip;0;3;0;3
3116;"Gintarėlis (Didlaukio g. 35)";LAŠIUKAI;9560190761;Taip;0;3;0;3
3117;"Gintarėlis (Didlaukio g. 35)";LAŠIUKAI;5434952733;Ne;5;1;0;6
3118;"Gintarėlis (Didlaukio g. 35)";LAŠIUKAI;5018151097;Taip;7;2;0;9
3119;"Gintarėlis (Didlaukio g. 35)";LAŠIUKAI;9230924100;Taip;0;1;4;5
3120;"Gintarėlis (Didlaukio g. 35)";LAŠIUKAI;4333780287;Taip;9;4;0;13
3121;"Gintarėlis (Didlaukio g. 35)";LAŠIUKAI;7286562743;Taip;13;1;0;14
3122;"Gintarėlis (Didlaukio g. 35)";LAŠIUKAI;1675553097;Taip;8;0;1;9
3123;"Gintarėlis (Didlaukio g. 35)";LAŠIUKAI;8000297636;Taip;15;2;0;17
3124;"Gintarėlis (Didlaukio g. 35)";LAŠIUKAI;6377674849;Taip;16;0;0;16
3125;"Gintarėlis (Didlaukio g. 35)";MEŠKUČIAI;2926488239;Taip;6;2;0;8
3126;"Gintarėlis (Didlaukio g. 35)";MEŠKUČIAI;6618240550;Taip;12;3;0;15
3127;"Gintarėlis (Didlaukio g. 35)";MEŠKUČIAI;8790078624;Taip;12;1;0;13
3128;"Gintarėlis (Didlaukio g. 35)";MEŠKUČIAI;2518840573;Ne;13;0;0;13
3129;"Gintarėlis (Didlaukio g. 35)";MEŠKUČIAI;5187894822;Taip;0;3;0;3
3130;"Gintarėlis (Didlaukio g. 35)";MEŠKUČIAI;3630567294;Taip;8;7;0;15
3131;"Gintarėlis (Didlaukio g. 35)";MEŠKUČIAI;5181872438;Taip;0;5;0;5
3132;"Gintarėlis (Didlaukio g. 35)";MEŠKUČIAI;1565802953;Taip;0;22;0;22
3133;"Gintarėlis (Didlaukio g. 35)";MEŠKUČIAI;2072435242;Taip;21;1;0;22
3134;"Gintarėlis (Didlaukio g. 35)";MEŠKUČIAI;7989239799;Taip;10;3;0;13
3135;"Gintarėlis (Didlaukio g. 35)";MEŠKUČIAI;4356211536;Ne;15;1;0;16
3136;"Gintarėlis (Didlaukio g. 35)";MEŠKUČIAI;1502740714;Taip;7;3;0;10
3137;"Gintarėlis (Didlaukio g. 35)";MEŠKUČIAI;6636835034;Taip;10;2;0;12
3138;"Gintarėlis (Didlaukio g. 35)";MEŠKUČIAI;3830154353;Ne;9;1;0;10
3139;"Gintarėlis (Didlaukio g. 35)";MEŠKUČIAI;3947405446;Taip;9;2;0;11
3140;"Gintarėlis (Didlaukio g. 35)";MEŠKUČIAI;7948438165;Taip;8;1;0;9
3141;"Gintarėlis (Didlaukio g. 35)";MEŠKUČIAI;4642142931;Taip;12;2;0;14
3142;"Gintarėlis (Didlaukio g. 35)";MEŠKUČIAI;6711753930;Taip;4;2;0;6
3143;"Gintarėlis (Didlaukio g. 35)";MEŠKUČIAI;9017592249;Taip;0;3;0;3
3144;"Gintarėlis (Didlaukio g. 35)";MEŠKUČIAI;8375475174;Taip;0;10;0;10
3145;"Gintarėlis (Didlaukio g. 35)";MEŠKUČIAI;7029401386;Taip;8;5;0;13
3146;"Gintarėlis (Didlaukio g. 35)";MEŠKUČIAI;7320085613;Taip;0;1;0;1
3147;"Gintarėlis (Didlaukio g. 35)";DRUGELIAI;1462949250;Taip;10;0;0;10
3148;"Gintarėlis (Didlaukio g. 35)";DRUGELIAI;9737200226;Taip;0;2;4;6
3149;"Gintarėlis (Didlaukio g. 35)";DRUGELIAI;6655809299;Taip;15;0;2;17
3150;"Gintarėlis (Didlaukio g. 35)";DRUGELIAI;2614258442;Taip;8;2;0;10
3151;"Gintarėlis (Didlaukio g. 35)";DRUGELIAI;1452402931;Taip;4;5;0;9
3152;"Gintarėlis (Didlaukio g. 35)";DRUGELIAI;4217329880;Taip;5;0;0;5
3153;"Gintarėlis (Didlaukio g. 35)";DRUGELIAI;7571352126;Taip;0;1;4;5
3154;"Gintarėlis (Didlaukio g. 35)";DRUGELIAI;9687974376;Taip;0;6;0;6
3155;"Gintarėlis (Didlaukio g. 35)";DRUGELIAI;8419453060;Taip;5;0;0;5
3156;"Gintarėlis (Didlaukio g. 35)";DRUGELIAI;7449437199;Ne;0;5;1;6
3157;"Gintarėlis (Didlaukio g. 35)";DRUGELIAI;2016067859;Taip;8;0;1;9
3158;"Gintarėlis (Didlaukio g. 35)";DRUGELIAI;9579497944;Taip;12;0;0;12
3159;"Gintarėlis (Didlaukio g. 35)";DRUGELIAI;3341850450;Taip;5;0;1;6
3160;"Gintarėlis (Didlaukio g. 35)";DRUGELIAI;1759218238;Ne;7;1;0;8
3161;"Gintarėlis (Didlaukio g. 35)";DRUGELIAI;1248017244;Taip;3;2;0;5
3162;"Gintarėlis (Didlaukio g. 35)";DRUGELIAI;2792618575;Taip;0;8;0;8
3163;"Gintarėlis (Didlaukio g. 35)";DRUGELIAI;8171192401;Taip;14;0;2;16
3164;"Gintarėlis (Didlaukio g. 35)";DRUGELIAI;7694587246;Taip;6;1;0;7
3165;"Gintarėlis (Didlaukio g. 35)";DRUGELIAI;4904966263;Taip;10;2;0;12
3166;"Gintarėlis (Didlaukio g. 35)";KAČIUKAI;5569843168;Taip;5;0;0;5
3167;"Gintarėlis (Didlaukio g. 35)";KAČIUKAI;3665764153;Ne;5;4;1;10
3168;"Gintarėlis (Didlaukio g. 35)";KAČIUKAI;9774056578;Ne;5;4;1;10
3169;"Gintarėlis (Didlaukio g. 35)";KAČIUKAI;2212296954;Taip;9;0;1;10
3170;"Gintarėlis (Didlaukio g. 35)";KAČIUKAI;3825700024;Taip;5;1;0;6
3171;"Gintarėlis (Didlaukio g. 35)";KAČIUKAI;9825811100;Taip;9;0;4;13
3172;"Gintarėlis (Didlaukio g. 35)";KAČIUKAI;7875981690;Taip;13;3;0;16
3173;"Gintarėlis (Didlaukio g. 35)";KAČIUKAI;2544338275;Taip;13;3;0;16
3174;"Gintarėlis (Didlaukio g. 35)";KAČIUKAI;9963329170;Taip;4;0;0;4
3175;"Gintarėlis (Didlaukio g. 35)";KAČIUKAI;7182964126;Taip;0;1;0;1
3176;"Gintarėlis (Didlaukio g. 35)";KAČIUKAI;4754929282;Taip;9;0;0;9
3177;"Gintarėlis (Didlaukio g. 35)";KAČIUKAI;5214984111;Taip;0;4;0;4
3178;"Gintarėlis (Didlaukio g. 35)";KAČIUKAI;1011749698;Taip;8;2;2;12
3179;"Gintarėlis (Didlaukio g. 35)";KAČIUKAI;8261770154;Taip;0;13;0;13
3180;"Gintarėlis (Didlaukio g. 35)";KAČIUKAI;7061545258;Taip;9;0;0;9
3181;"Gintarėlis (Didlaukio g. 35)";KAČIUKAI;5436695400;Ne;7;2;3;12
3182;"Gintarėlis (Didlaukio g. 35)";KAČIUKAI;5921751507;Taip;0;2;0;2
3183;"Gintarėlis (Didlaukio g. 35)";KAČIUKAI;9450900915;Taip;7;0;3;10
3184;"Gintarėlis (Didlaukio g. 35)";KAČIUKAI;5153948767;Taip;9;3;0;12
3185;"Gintarėlis (Didlaukio g. 35)";KAČIUKAI;3814485627;Taip;9;2;0;11
3186;"Gintarėlis (Didlaukio g. 35)";KAČIUKAI;1571260478;Ne;8;2;2;12
3187;"Gintarėlis (Didlaukio g. 35)";KAČIUKAI;9244715396;Taip;15;2;0;17
3188;"Gintarėlis (Didlaukio g. 35)";KAČIUKAI;3015327416;Taip;15;1;0;16
3189;"Gintarėlis (Didlaukio g. 35)";KIŠKUČIAI;3921015919;Ne;0;2;0;2
3190;"Gintarėlis (Didlaukio g. 35)";KIŠKUČIAI;2814569415;Ne;4;4;3;11
3191;"Gintarėlis (Didlaukio g. 35)";KIŠKUČIAI;7143014339;Taip;5;1;0;6
3192;"Gintarėlis (Didlaukio g. 35)";KIŠKUČIAI;5796729245;Taip;0;4;0;4
3193;"Gintarėlis (Didlaukio g. 35)";KIŠKUČIAI;9915887420;Taip;0;2;0;2
3194;"Gintarėlis (Didlaukio g. 35)";KIŠKUČIAI;8287685690;Taip;0;5;0;5
3195;"Gintarėlis (Didlaukio g. 35)";KIŠKUČIAI;7815317644;Taip;0;2;0;2
3196;"Gintarėlis (Didlaukio g. 35)";KIŠKUČIAI;2165332442;Taip;0;1;0;1
3197;"Gintarėlis (Didlaukio g. 35)";KIŠKUČIAI;6914904213;Taip;10;0;0;10
3198;"Gintarėlis (Didlaukio g. 35)";KIŠKUČIAI;1696337909;Taip;10;0;0;10
3199;"Gintarėlis (Didlaukio g. 35)";KIŠKUČIAI;6862629244;Taip;10;4;0;14
3200;"Gintarėlis (Didlaukio g. 35)";KIŠKUČIAI;3398936974;Ne;6;1;0;7
3201;"Gintarėlis (Didlaukio g. 35)";KIŠKUČIAI;1918879534;Taip;17;0;0;17
3202;"Gintarėlis (Didlaukio g. 35)";KIŠKUČIAI;7509100750;Taip;0;4;0;4
3203;"Gintarėlis (Didlaukio g. 35)";KIŠKUČIAI;6991746305;Taip;0;1;0;1
3204;"Gintarėlis (Didlaukio g. 35)";KIŠKUČIAI;3792697409;Taip;10;0;2;12
3205;"Gintarėlis (Didlaukio g. 35)";KIŠKUČIAI;6239242631;Taip;18;0;0;18
3206;"Gintarėlis (Didlaukio g. 35)";KIŠKUČIAI;4623909811;Taip;10;0;0;10
3207;"Gintarėlis (Didlaukio g. 35)";KIŠKUČIAI;3357866319;Taip;0;5;1;6
3208;"Gintarėlis (Didlaukio g. 35)";KIŠKUČIAI;8704248985;Taip;0;11;0;11
3209;"Gintarėlis (Didlaukio g. 35)";KIŠKUČIAI;5355691986;Taip;0;3;0;3
3210;"Gintarėlis (Didlaukio g. 35)";KIŠKUČIAI;5919205817;Taip;5;1;0;6
3211;"Gintarėlis (Didlaukio g. 35)";VYTURIUKAI;5834772263;Taip;0;6;0;6
3212;"Gintarėlis (Didlaukio g. 35)";VYTURIUKAI;9533972547;Taip;9;0;9;18
3213;"Gintarėlis (Didlaukio g. 35)";VYTURIUKAI;4915783145;Taip;0;0;6;6
3214;"Gintarėlis (Didlaukio g. 35)";BORUŽĖLĖS;6402043654;Taip;11;2;0;13
3215;"Gintarėlis (Didlaukio g. 35)";BORUŽĖLĖS;6558614008;Taip;9;1;0;10
3216;"Gintarėlis (Didlaukio g. 35)";BORUŽĖLĖS;4348245746;Taip;9;0;0;9
3217;"Gintarėlis (Didlaukio g. 35)";BORUŽĖLĖS;3091731769;Taip;15;0;0;15
3218;"Gintarėlis (Didlaukio g. 35)";BORUŽĖLĖS;6484966941;Taip;10;3;4;17
3219;"Gintarėlis (Didlaukio g. 35)";BORUŽĖLĖS;9004590065;Taip;22;0;0;22
3220;"Gintarėlis (Didlaukio g. 35)";BORUŽĖLĖS;2624469768;Taip;15;0;0;15
3221;"Gintarėlis (Didlaukio g. 35)";BORUŽĖLĖS;8784796186;Ne;10;3;1;14
3222;"Gintarėlis (Didlaukio g. 35)";BORUŽĖLĖS;3538300416;Taip;9;0;0;9
3223;"Gintarėlis (Didlaukio g. 35)";BORUŽĖLĖS;8516817506;Taip;18;0;0;18
3224;"Gintarėlis (Didlaukio g. 35)";BORUŽĖLĖS;3235154374;Taip;0;22;0;22
3225;"Gintarėlis (Didlaukio g. 35)";BORUŽĖLĖS;4809352525;Taip;6;1;0;7
3226;"Gintarėlis (Didlaukio g. 35)";BORUŽĖLĖS;7059730814;Taip;10;0;0;10
3227;"Gintarėlis (Didlaukio g. 35)";BORUŽĖLĖS;9179216093;Taip;4;1;0;5
3228;"Gintarėlis (Didlaukio g. 35)";BORUŽĖLĖS;9970786396;Taip;9;1;0;10
3229;"Gintarėlis (Didlaukio g. 35)";BORUŽĖLĖS;7118758040;Taip;5;3;0;8
3230;"Gintarėlis (Didlaukio g. 35)";BORUŽĖLĖS;9622824643;Taip;12;0;1;13
3231;"Gintarėlis (Didlaukio g. 35)";BORUŽĖLĖS;9476258741;Taip;1;2;2;5
3232;"Gintarėlis (Didlaukio g. 35)";BORUŽĖLĖS;1400817076;Taip;9;0;0;9
3233;"Gintarėlis (Didlaukio g. 35)";BORUŽĖLĖS;1371258551;Taip;10;1;0;11
3234;"Gintarėlis (Didlaukio g. 35)";BORUŽĖLĖS;4334349824;Taip;8;2;0;10
3235;"Gintarėlis (Didlaukio g. 35)";BORUŽĖLĖS;8410642485;Taip;12;0;0;12
3236;"Gintarėlis (Didlaukio g. 35)";BORUŽĖLĖS;9501012756;Taip;8;2;0;10
3237;"Gintarėlis (Didlaukio g. 35)";EŽIUKAI;4676321193;Taip;10;1;0;11
3238;"Gintarėlis (Didlaukio g. 35)";EŽIUKAI;4487346983;Taip;10;1;0;11
3239;"Gintarėlis (Didlaukio g. 35)";EŽIUKAI;2263102527;Taip;10;1;0;11
3240;"Gintarėlis (Didlaukio g. 35)";EŽIUKAI;7919771693;Taip;6;0;0;6
3241;"Gintarėlis (Didlaukio g. 35)";EŽIUKAI;9040480798;Taip;4;0;0;4
3242;"Gintarėlis (Didlaukio g. 35)";EŽIUKAI;8055928882;Taip;0;8;0;8
3243;"Gintarėlis (Didlaukio g. 35)";EŽIUKAI;5024727902;Taip;5;3;1;9
3244;"Gintarėlis (Didlaukio g. 35)";EŽIUKAI;2088008759;Ne;0;1;0;1
3245;"Gintarėlis (Didlaukio g. 35)";EŽIUKAI;6457288028;Taip;0;1;0;1
3246;"Gintarėlis (Didlaukio g. 35)";EŽIUKAI;4660854883;Taip;0;5;0;5
3247;"Gintarėlis (Didlaukio g. 35)";EŽIUKAI;94354056029;Taip;0;4;0;4
3248;"Gintarėlis (Didlaukio g. 35)";EŽIUKAI;1002155392;Taip;0;2;2;4
3249;"Gintarėlis (Didlaukio g. 35)";EŽIUKAI;9130659549;Taip;0;2;2;4
3250;"Gintarėlis (Didlaukio g. 35)";EŽIUKAI;2036488789;Taip;23;0;0;23
3251;"Gintarėlis (Didlaukio g. 35)";EŽIUKAI;7644607132;Taip;5;2;0;7
3252;"Gintarėlis (Didlaukio g. 35)";EŽIUKAI;78359050717;Taip;3;0;0;3
3253;"Gintarėlis (Didlaukio g. 35)";EŽIUKAI;7192722296;Taip;2;2;0;4
3254;"Gintarėlis (Didlaukio g. 35)";EŽIUKAI;2970527490;Ne;5;2;0;7
3255;"Gintarėlis (Didlaukio g. 35)";EŽIUKAI;1028456578;Taip;0;0;1;1
3256;"Gintarėlis (Didlaukio g. 35)";EŽIUKAI;1066741732;Taip;13;1;0;14
3257;"Gintarėlis (Didlaukio g. 35)";EŽIUKAI;9917367735;Taip;0;0;4;4
3258;"Gintarėlis (Didlaukio g. 35)";EŽIUKAI;4514340634;Ne;0;2;1;3
3259;"Gintarėlis (Didlaukio g. 35)";VIŠČIUKAI;1981825456;Taip;0;1;0;1
3260;"Gintarėlis (Didlaukio g. 35)";VIŠČIUKAI;3973889495;Taip;11;0;0;11
3261;"Gintarėlis (Didlaukio g. 35)";VIŠČIUKAI;4749559606;Taip;20;0;0;20
3262;"Gintarėlis (Didlaukio g. 35)";VIŠČIUKAI;4458703839;Ne;20;0;0;20
3263;"Gintarėlis (Didlaukio g. 35)";VIŠČIUKAI;2178808286;Taip;22;0;0;22
3264;"Gintarėlis (Didlaukio g. 35)";VIŠČIUKAI;9073499040;Taip;15;3;0;18
3265;"Gintarėlis (Didlaukio g. 35)";VIŠČIUKAI;6547060300;Taip;0;4;0;4
3266;"Gintarėlis (Didlaukio g. 35)";VIŠČIUKAI;5930354746;Taip;8;4;0;12
3267;"Gintarėlis (Didlaukio g. 35)";VIŠČIUKAI;4535071342;Taip;17;3;0;20
3268;"Gintarėlis (Didlaukio g. 35)";VIŠČIUKAI;8448725884;Taip;17;3;0;20
3269;"Gintarėlis (Didlaukio g. 35)";VIŠČIUKAI;6251670953;Taip;9;7;0;16
3270;"Gintarėlis (Didlaukio g. 35)";VIŠČIUKAI;8805356168;Taip;19;3;0;22
3271;"Gintarėlis (Didlaukio g. 35)";VIŠČIUKAI;4751066825;Taip;5;3;5;13
3272;"Gintarėlis (Didlaukio g. 35)";VIŠČIUKAI;1039098192;Taip;16;3;0;19
3273;"Gintarėlis (Didlaukio g. 35)";VIŠČIUKAI;6042885133;Taip;14;2;1;17
3274;"Gintarėlis (Didlaukio g. 35)";VIŠČIUKAI;7418672923;Taip;7;0;0;7
3275;"Gintarėlis (Didlaukio g. 35)";VIŠČIUKAI;7562170082;Taip;11;5;0;16
3276;"Gintarėlis (Didlaukio g. 35)";VIŠČIUKAI;1367305617;Taip;17;1;0;18
3277;"Gintarėlis (Didlaukio g. 35)";VIŠČIUKAI;6711773127;Taip;5;7;0;12
3278;"Gintarėlis (Didlaukio g. 35)";VIŠČIUKAI;7537009709;Ne;10;1;0;11
3279;"Gintarėlis (Didlaukio g. 35)";VIŠČIUKAI;9191264261;Taip;18;0;0;18
3280;"Gintarėlis (Didlaukio g. 35)";VIŠČIUKAI;2920734274;Taip;5;0;3;8
3281;"Gintarėlis (Didlaukio g. 35)";VIŠČIUKAI;3232990779;Taip;13;2;0;15
3282;"Gintarėlis (Didlaukio g. 35)";"SAULĖS ZUIKUČIAI";4278770021;Taip;9;1;0;10
3283;"Gintarėlis (Didlaukio g. 35)";"SAULĖS ZUIKUČIAI";9915228593;Taip;0;4;1;5
3284;"Gintarėlis (Didlaukio g. 35)";"SAULĖS ZUIKUČIAI";2499727321;Taip;12;2;0;14
3285;"Gintarėlis (Didlaukio g. 35)";"SAULĖS ZUIKUČIAI";2949035147;Taip;14;1;0;15
3286;"Gintarėlis (Didlaukio g. 35)";"SAULĖS ZUIKUČIAI";3839660368;Ne;0;4;2;6
3287;"Gintarėlis (Didlaukio g. 35)";"SAULĖS ZUIKUČIAI";5991638696;Taip;0;4;1;5
3288;"Gintarėlis (Didlaukio g. 35)";"SAULĖS ZUIKUČIAI";6563281778;Taip;0;4;16;20
3289;"Gintarėlis (Didlaukio g. 35)";"SAULĖS ZUIKUČIAI";6133476137;Taip;27;1;0;28
3290;"Gintarėlis (Didlaukio g. 35)";"SAULĖS ZUIKUČIAI";6751822184;Taip;6;4;7;17
3291;"Gintarėlis (Didlaukio g. 35)";"SAULĖS ZUIKUČIAI";8721340357;Taip;11;0;3;14
3292;"Gintarėlis (Didlaukio g. 35)";"SAULĖS ZUIKUČIAI";3876016666;Taip;4;0;1;5
3293;"Gintarėlis (Didlaukio g. 35)";"SAULĖS ZUIKUČIAI";8403881160;Taip;10;3;0;13
3294;"Gintarėlis (Didlaukio g. 35)";"SAULĖS ZUIKUČIAI";5336654560;Taip;15;1;0;16
3295;"Gintarėlis (Didlaukio g. 35)";"SAULĖS ZUIKUČIAI";3732252177;Taip;15;1;0;16
3296;"Gintarėlis (Didlaukio g. 35)";"SAULĖS ZUIKUČIAI";4087751760;Taip;6;0;1;7
3297;"Gintarėlis (Didlaukio g. 35)";"SAULĖS ZUIKUČIAI";4462515146;Taip;18;0;0;18
3298;"Gintarėlis (Didlaukio g. 35)";"SAULĖS ZUIKUČIAI";6138593853;Taip;7;2;0;9
3299;"Gintarėlis (Didlaukio g. 35)";"SAULĖS ZUIKUČIAI";5338409090;Taip;10;1;0;11
3300;"Gintarėlis (Didlaukio g. 35)";"SAULĖS ZUIKUČIAI";7004430575;Taip;12;2;0;14
3301;"Gintarėlis (Didlaukio g. 35)";"SAULĖS ZUIKUČIAI";5509394003;Taip;14;0;2;16
3302;"Gintarėlis (Didlaukio g. 35)";"SAULĖS ZUIKUČIAI";1482227839;Taip;10;2;0;12
3303;"Gintarėlis (Didlaukio g. 35)";Pabiručiai;8286814809;Ne;4;5;0;9
3304;"Gintarėlis (Didlaukio g. 35)";Pabiručiai;4757160835;Taip;0;0;5;5
3305;"Gintarėlis (Didlaukio g. 35)";Pabiručiai;1158055621;Taip;9;0;0;9
3306;"Gintarėlis (Didlaukio g. 35)";Pabiručiai;1474802737;Taip;5;3;3;11
3307;"Gintarėlis (Didlaukio g. 35)";Pabiručiai;6578588403;Taip;9;0;0;9
3308;"Gintarėlis (Didlaukio g. 35)";Pabiručiai;2488622623;Taip;4;0;0;4
3309;"Gintarėlis (Didlaukio g. 35)";Šypsenėlės;3575375401;Taip;13;2;5;20
3310;"Gintarėlis (Didlaukio g. 35)";Šypsenėlės;3575375401;Taip;13;2;5;20
3311;"Gintarėlis (Didlaukio g. 35)";Šypsenėlės;3575375401;Taip;13;2;5;20
3312;"Gintarėlis (Didlaukio g. 35)";Šypsenėlės;9020619501;Taip;10;0;0;10
3313;"Gintarėlis (Didlaukio g. 35)";Šypsenėlės;2904118045;Taip;22;0;0;22
3314;"Gintarėlis (Didlaukio g. 35)";Šypsenėlės;5120761293;Taip;0;1;0;1
3315;"Gintarėlis (Didlaukio g. 35)";Šypsenėlės;9413836091;Taip;0;3;12;15
3316;"Gintarėlis (Didlaukio g. 35)";Šypsenėlės;7337543180;Taip;11;0;0;11
3317;"Gintarėlis (Didlaukio g. 35)";Šypsenėlės;7337543180;Taip;11;0;0;11
3318;"Gintarėlis (Didlaukio g. 35)";Šypsenėlės;7337543180;Taip;11;0;0;11
3319;"Gintarėlis (Didlaukio g. 35)";Šypsenėlės;1567290856;Taip;3;0;7;10
3320;"Gintarėlis (Didlaukio g. 35)";Šypsenėlės;7661638176;Taip;0;1;0;1
3321;"Gintarėlis (Didlaukio g. 35)";Šypsenėlės;9477018713;Taip;10;0;0;10
3322;"Gintarėlis (Didlaukio g. 35)";Šypsenėlės;9477018713;Taip;10;0;0;10
3323;"Gintarėlis (Didlaukio g. 35)";Šypsenėlės;9477018713;Taip;10;0;0;10
3324;"Gintarėlis (Didlaukio g. 35)";Šypsenėlės;3088663209;Taip;0;2;0;2
3325;"Gintarėlis (Didlaukio g. 35)";Šypsenėlės;3794027499;Taip;6;1;0;7
3326;"Gintarėlis (Didlaukio g. 35)";Šypsenėlės;7813187438;Taip;8;2;0;10
3327;"Gintarėlis (Didlaukio g. 35)";Šypsenėlės;6561070982;Taip;5;2;0;7
3328;"Gintarėlis (Didlaukio g. 35)";Šypsenėlės;2203238888;Taip;0;3;0;3
3329;"Gintarėlis (Didlaukio g. 35)";Šypsenėlės;3484172382;Taip;0;3;0;3
3330;"Gintarėlis (Didlaukio g. 35)";Šypsenėlės;2256002308;Taip;0;2;3;5
3331;"Gintarėlis (Didlaukio g. 35)";Šypsenėlės;6607854244;Taip;4;2;0;6
3332;"Gintarėlis (Didlaukio g. 35)";Šypsenėlės;3987801707;Taip;3;2;0;5
3333;"Gintarėlis (Didlaukio g. 35)";Šypsenėlės;7123016029;Ne;0;2;0;2
3334;"Gintarėlis (Didlaukio g. 35)";Šypsenėlės;5717123412;Ne;3;8;0;11
3335;"Gintarėlis (Didlaukio g. 35)";Šypsenėlės;1480486900;Ne;3;2;4;9
3336;"Gintarėlis (Didlaukio g. 35)";Smalsučiai;7486822380;Taip;0;2;3;5
3337;"Gintarėlis (Didlaukio g. 35)";Smalsučiai;8387819754;Taip;7;0;0;7
3338;"Gintarėlis (Didlaukio g. 35)";Smalsučiai;1875958358;Taip;5;0;0;5
3339;"Gintarėlis (Didlaukio g. 35)";Smalsučiai;8292698645;Taip;6;3;0;9
3340;"Gintarėlis (Didlaukio g. 35)";Smalsučiai;5748677965;Taip;5;0;1;6
3341;"Gintarėlis (Didlaukio g. 35)";Smalsučiai;1876292168;Taip;11;6;0;17
3342;"Gintarėlis (Didlaukio g. 35)";Smalsučiai;9980747501;Taip;3;0;0;3
3343;"Gintarėlis (Didlaukio g. 35)";Smalsučiai;8754068506;Ne;12;2;0;14
3344;"Gintarėlis (Didlaukio g. 35)";Smalsučiai;8677500463;Taip;7;0;0;7
3345;"Gintarėlis (Didlaukio g. 35)";Smalsučiai;7690748176;Taip;12;0;1;13
3346;"Gintarėlis (Didlaukio g. 35)";Smalsučiai;8355089218;Taip;12;0;0;12
3347;"Gintarėlis (Didlaukio g. 35)";Kodėlčiukai;7976989629;Taip;2;0;6;8
3348;"Gintarėlis (Didlaukio g. 35)";Kodėlčiukai;8982034601;Taip;3;0;0;3
3349;"Gintarėlis (Didlaukio g. 35)";Kodėlčiukai;2234295991;Taip;0;4;0;4
3350;"Gintarėlis (Didlaukio g. 35)";Kodėlčiukai;6545866812;Ne;9;2;3;14
3351;"Gintarėlis (Didlaukio g. 35)";Kodėlčiukai;5467958458;Taip;4;1;0;5
3352;"Gintarėlis (Didlaukio g. 35)";Kodėlčiukai;5824210469;Taip;8;0;2;10
3353;"Gintarėlis (Didlaukio g. 35)";Kodėlčiukai;5202442681;Taip;5;0;0;5
3354;"Gintarėlis (Didlaukio g. 35)";Gintariukai;5103780852;Taip;0;0;3;3
3355;"Gintarėlis (Didlaukio g. 35)";Gintariukai;5109775795;Taip;9;0;0;9
3356;"Gintarėlis (Didlaukio g. 35)";Gintariukai;2809388552;Ne;7;0;0;7
3357;"Gintarėlis (Didlaukio g. 35)";Gintariukai;9374716095;Taip;8;0;2;10
3358;"Gintarėlis (Didlaukio g. 35)";Gintariukai;8815001033;Ne;4;1;0;5
3359;"Gintarėlis (Didlaukio g. 35)";Gintariukai;9787141660;Taip;0;0;1;1
3360;Giraitė;Aviliukas;4292730355;Taip;11;0;1;12
3361;Giraitė;Aviliukas;7001163828;Taip;13;0;3;16
3362;Giraitė;Aviliukas;5456658087;Ne;8;0;0;8
3363;Giraitė;Aviliukas;6159650070;Taip;5;1;1;7
3364;Giraitė;Aviliukas;5275912609;Taip;9;5;15;29
3365;Giraitė;Aviliukas;4758750245;Taip;15;0;0;15
3366;Giraitė;Aviliukas;2219854347;Taip;18;0;0;18
3367;Giraitė;Aviliukas;6315990604;Ne;22;0;0;22
3368;Giraitė;Aviliukas;2338867192;Taip;3;0;0;3
3369;Giraitė;Aviliukas;3719285343;Taip;17;1;1;19
3370;Giraitė;Aviliukas;3085107071;Ne;9;0;2;11
3371;Giraitė;Aviliukas;7807844145;Taip;3;0;0;3
3372;Giraitė;Aviliukas;3757900478;Taip;13;0;0;13
3373;Giraitė;Aviliukas;7876457529;Taip;19;0;0;19
3374;Giraitė;Aviliukas;3992069614;Taip;8;0;2;10
3375;Giraitė;Aviliukas;6121586335;Taip;8;0;11;19
3376;Giraitė;Aviliukas;4440444700;Taip;9;0;0;9
3377;Giraitė;Aviliukas;6296485105;Taip;18;0;0;18
3378;Giraitė;Aviliukas;5356944812;Ne;18;0;0;18
3379;Giraitė;Aviliukas;4554565631;Ne;12;2;2;16
3380;Giraitė;Aviliukas;2340866110;Taip;0;0;12;12
3381;Giraitė;LapiukaI;6141730004;Taip;13;0;0;13
3382;Giraitė;LapiukaI;6325909670;Taip;14;1;0;15
3383;Giraitė;LapiukaI;7831526566;Taip;0;0;3;3
3384;Giraitė;LapiukaI;2740656695;Taip;0;8;0;8
3385;Giraitė;LapiukaI;5030697729;Taip;5;3;0;8
3386;Giraitė;LapiukaI;1921430434;Taip;23;0;0;23
3387;Giraitė;LapiukaI;5006156109;Ne;0;2;0;2
3388;Giraitė;LapiukaI;4663343304;Taip;19;0;0;19
3389;Giraitė;LapiukaI;5382004098;Taip;7;0;0;7
3390;Giraitė;LapiukaI;4811513778;Ne;11;1;1;13
3391;Giraitė;LapiukaI;4296449093;Ne;3;0;0;3
3392;Giraitė;LapiukaI;1974159110;Taip;8;1;5;14
3393;Giraitė;LapiukaI;5532639133;Taip;16;0;1;17
3394;Giraitė;LapiukaI;4076402180;Taip;8;0;0;8
3395;Giraitė;LapiukaI;5902161665;Taip;0;7;0;7
3396;Giraitė;LapiukaI;4955786826;Ne;0;6;0;6
3397;Giraitė;LapiukaI;4260343903;Taip;1;0;1;2
3398;Giraitė;LapiukaI;9088123796;Taip;7;0;0;7
3399;Giraitė;LapiukaI;7772177095;Taip;3;1;0;4
3400;Giraitė;LapiukaI;8492822889;Ne;19;0;0;19
3401;Giraitė;LapiukaI;2880342138;Taip;3;0;0;3
3402;Giraitė;Voveriukai;7354834895;Taip;5;3;0;8
3403;Giraitė;Voveriukai;6265908751;Taip;0;1;0;1
3404;Giraitė;Voveriukai;4822168634;Taip;0;0;2;2
3405;Giraitė;Voveriukai;2074303013;Taip;0;0;1;1
3406;Giraitė;Voveriukai;2088867630;Taip;0;1;0;1
3407;Giraitė;Voveriukai;3875214088;Taip;7;6;0;13
3408;Giraitė;Voveriukai;5202562049;Taip;0;4;0;4
3409;Giraitė;Voveriukai;7441871219;Taip;1;1;1;3
3410;Giraitė;Voveriukai;7481895278;Taip;5;0;0;5
3411;Giraitė;Voveriukai;3607198556;Taip;0;8;4;12
3412;Giraitė;Voveriukai;1945918102;Ne;10;8;0;18
3413;Giraitė;Voveriukai;8799195526;Taip;0;4;0;4
3414;Giraitė;Voveriukai;6225092500;Taip;3;0;0;3
3415;Giraitė;Voveriukai;4137699629;Taip;5;0;0;5
3416;Giraitė;Voveriukai;4932174149;Ne;4;0;0;4
3417;Giraitė;Voveriukai;3896789232;Taip;0;0;2;2
3418;Giraitė;Voveriukai;7919088987;Taip;6;2;0;8
3419;Giraitė;Voveriukai;5616242311;Taip;10;1;0;11
3420;Giraitė;Voveriukai;7739516049;Taip;7;0;0;7
3421;Giraitė;Voveriukai;4773517160;Taip;7;0;3;10
3422;Giraitė;Voveriukai;2177856916;Taip;0;2;0;2
3423;Giraitė;Grybukai;2990968206;Taip;11;0;0;11
3424;Giraitė;Grybukai;1312761239;Taip;0;2;0;2
3425;Giraitė;Grybukai;5721669627;Taip;7;3;0;10
3426;Giraitė;Grybukai;5892950503;Taip;0;7;0;7
3427;Giraitė;Grybukai;4839351300;Taip;3;3;0;6
3428;Giraitė;Grybukai;9495968363;Taip;10;0;0;10
3429;Giraitė;Grybukai;1253151830;Taip;10;0;0;10
3430;Giraitė;Grybukai;4336519836;Taip;15;1;0;16
3431;Giraitė;Grybukai;6836412890;Taip;9;0;0;9
3432;Giraitė;Grybukai;9224845723;Taip;0;2;0;2
3433;Giraitė;Grybukai;9882372025;Taip;7;0;1;8
3434;Giraitė;Grybukai;9918028862;Taip;1;2;0;3
3435;Giraitė;Grybukai;5167002022;Taip;19;3;0;22
3436;Giraitė;Grybukai;4785524898;Taip;0;3;0;3
3437;Giraitė;Grybukai;8596389737;Taip;10;0;2;12
3438;Giraitė;Grybukai;1111614295;Taip;1;5;0;6
3439;Giraitė;Grybukai;5029839281;Ne;8;1;0;9
3440;Giraitė;Grybukai;8869728241;Taip;3;0;1;4
3441;Giraitė;Grybukai;3683700626;Taip;3;1;0;4
3442;Giraitė;Grybukai;9026736929;Taip;10;1;0;11
3443;Giraitė;Riešutėliai;5365264259;Taip;10;0;2;12
3444;Giraitė;Riešutėliai;7179656901;Ne;12;0;0;12
3445;Giraitė;Riešutėliai;3158451613;Taip;4;0;0;4
3446;Giraitė;Riešutėliai;7423115504;Taip;0;0;7;7
3447;Giraitė;Riešutėliai;7580600719;Taip;9;0;0;9
3448;Giraitė;Riešutėliai;6838184704;Taip;17;1;0;18
3449;Giraitė;Riešutėliai;5161383686;Taip;11;2;1;14
3450;Giraitė;Riešutėliai;5148257412;Taip;5;4;0;9
3451;Giraitė;Riešutėliai;7566944002;Taip;7;1;0;8
3452;Giraitė;Riešutėliai;3839432744;Taip;5;0;1;6
3453;Giraitė;Riešutėliai;7803047658;Taip;11;0;0;11
3454;Giraitė;Riešutėliai;7113991095;Taip;3;0;0;3
3455;Giraitė;Riešutėliai;9144465313;Taip;13;0;0;13
3456;Giraitė;Riešutėliai;6288016799;Taip;10;0;0;10
3457;Giraitė;Riešutėliai;3278871662;Taip;22;0;0;22
3458;Giraitė;Riešutėliai;4168934880;Taip;7;4;0;11
3459;Giraitė;Riešutėliai;6337090583;Taip;3;0;7;10
3460;Giraitė;Riešutėliai;3843211767;Taip;15;0;1;16
3461;Giraitė;Meškiukai;27501094616;Taip;10;2;0;12
3462;Giraitė;Meškiukai;2513312448;Taip;0;5;0;5
3463;Giraitė;Meškiukai;5367392810;Taip;9;0;0;9
3464;Giraitė;Meškiukai;1608876140;Taip;0;2;1;3
3465;Giraitė;Meškiukai;5461837332;Taip;0;2;1;3
3466;Giraitė;Meškiukai;1355594003;Ne;10;3;0;13
3467;Giraitė;Meškiukai;1560868105;Taip;11;3;0;14
3468;Giraitė;Meškiukai;1050699551;Taip;4;3;4;11
3469;Giraitė;Meškiukai;1876815077;Taip;2;2;0;4
3470;Giraitė;Meškiukai;1063628206;Taip;6;0;0;6
3471;Giraitė;Meškiukai;1318214394;Taip;0;1;5;6
3472;Giraitė;Meškiukai;9195735923;Taip;20;0;0;20
3473;Giraitė;Meškiukai;65251975467;Taip;2;0;0;2
3474;Giraitė;Meškiukai;1704154980;Taip;0;0;5;5
3475;Giraitė;Meškiukai;1819657811;Taip;0;4;0;4
3476;Giraitė;Meškiukai;1512384599;Taip;1;1;0;2
3477;Giraitė;Meškiukai;2571892050;Taip;0;3;10;13
3478;Giraitė;Meškiukai;6156715234;Taip;6;0;0;6
3479;Giraitė;Meškiukai;1594965200;Taip;8;0;8;16
3480;Giraitė;Meškiukai;9723242940;Taip;4;1;0;5
3481;Giraitė;Meškiukai;5726182600;Ne;6;2;1;9
3482;Giraitė;Meškiukai;1772790396;Ne;0;1;1;2
3483;Giraitė;Meškiukai;2551280794;Taip;0;13;0;13
3484;Giraitė;Uogelės;8908602761;Taip;5;0;0;5
3485;Giraitė;Uogelės;4717851198;Taip;0;0;2;2
3486;Giraitė;Uogelės;1729871315;Taip;18;1;0;19
3487;Giraitė;Uogelės;9503157590;Taip;18;0;0;18
3488;Giraitė;Uogelės;4317544803;Taip;10;0;1;11
3489;Giraitė;Uogelės;9927102264;Taip;0;4;2;6
3490;Giraitė;Uogelės;4121361794;Taip;0;0;1;1
3491;Giraitė;Uogelės;4843415587;Taip;8;2;0;10
3492;Giraitė;Uogelės;5471577047;Taip;6;2;0;8
3493;Giraitė;Uogelės;2732715332;Taip;17;0;0;17
3494;Giraitė;Uogelės;2307307454;Taip;11;1;0;12
3495;Giraitė;Uogelės;2102237550;Taip;7;0;0;7
3496;Giraitė;Uogelės;6065010363;Taip;12;1;0;13
3497;Giraitė;Uogelės;5255040944;Taip;8;0;2;10
3498;Giraitė;Uogelės;7094750784;Ne;0;3;0;3
3499;Giraitė;Uogelės;1583733838;Taip;0;4;0;4
3500;Giraitė;Uogelės;1356340471;Taip;7;3;0;10
3501;Giraitė;Uogelės;7377939409;Ne;24;0;0;24
3502;Giraitė;Uogelės;4288937528;Taip;8;0;2;10
3503;Giraitė;Uogelės;6293111179;Taip;9;5;0;14
3504;Giraitė;Uogelės;7390702355;Taip;0;2;0;2
3505;Giraitė;Šaltinėlis;5876711899;Taip;4;0;0;4
3506;Giraitė;Šaltinėlis;8427713392;Ne;12;0;0;12
3507;Giraitė;Šaltinėlis;3612494313;Taip;0;0;3;3
3508;Giraitė;Šaltinėlis;2076989836;Taip;0;0;4;4
3509;Giraitė;Šaltinėlis;9589760939;Taip;12;0;0;12
3510;Giraitė;Šaltinėlis;4500393769;Taip;10;1;0;11
3511;Giraitė;Šaltinėlis;3144724475;Ne;4;0;3;7
3512;Giraitė;Šaltinėlis;5525538498;Taip;12;0;4;16
3513;Giraitė;Šaltinėlis;4681342624;Taip;13;0;5;18
3514;Giraitė;Šaltinėlis;4431964254;Taip;0;0;3;3
3515;Giraitė;Šaltinėlis;4946664007;Taip;17;0;1;18
3516;Giraitė;Šaltinėlis;1170698327;Taip;11;0;0;11
3517;Giraitė;Šaltinėlis;6865072274;Taip;24;0;1;25
3518;Giraitė;Šaltinėlis;3108521607;Taip;8;0;2;10
3519;Giraitė;Šaltinėlis;8139743188;Ne;4;0;0;4
3520;Giraitė;Šaltinėlis;2867735227;Ne;1;0;4;5
3521;Giraitė;Šaltinėlis;9669849051;Taip;22;0;0;22
3522;Giraitė;Boružėlės;6378362980;Taip;9;0;0;9
3523;Giraitė;Boružėlės;8612554184;Taip;22;0;0;22
3524;Giraitė;Boružėlės;1436302175;Taip;7;0;0;7
3525;Giraitė;Boružėlės;2064019596;Taip;5;1;1;7
3526;Giraitė;Boružėlės;3346193393;Taip;11;0;1;12
3527;Giraitė;Boružėlės;7260229442;Taip;6;0;0;6
3528;Giraitė;Boružėlės;1126576745;Taip;9;0;0;9
3529;Giraitė;Boružėlės;1772997796;Taip;3;0;0;3
3530;Giraitė;Boružėlės;9386943162;Taip;22;0;0;22
3531;Giraitė;Boružėlės;4749790368;Taip;12;0;1;13
3532;Giraitė;Boružėlės;3039445733;Taip;5;0;1;6
3533;Giraitė;Boružėlės;4719547384;Taip;16;0;0;16
3534;Giraitė;Boružėlės;4008393576;Taip;7;2;0;9
3535;Giraitė;Boružėlės;9766107773;Taip;19;0;0;19
3536;Giraitė;Gandriukai;4680913596;Taip;11;0;0;11
3537;Giraitė;Gandriukai;7384795349;Taip;6;0;0;6
3538;Giraitė;Gandriukai;3643426944;Taip;0;0;1;1
3539;Giraitė;Gandriukai;8525380061;Taip;0;8;1;9
3540;Giraitė;Gandriukai;4851987149;Ne;2;0;0;2
3541;Giraitė;Gandriukai;2205108811;Taip;21;3;2;26
3542;Giraitė;Gandriukai;7008670489;Taip;5;1;0;6
3543;Giraitė;Gandriukai;6277788515;Taip;2;0;3;5
3544;Giraitė;Gandriukai;7767820565;Ne;11;0;0;11
3545;Giraitė;Gandriukai;8819218663;Taip;0;0;5;5
3546;Giraitė;Gandriukai;7269074498;Taip;6;3;0;9
3547;Giraitė;Gandriukai;1490748887;Ne;17;0;0;17
3548;Giraitė;Gandriukai;7789414361;Taip;21;1;0;22
3549;Giraitė;Gandriukai;9850432917;Taip;27;0;0;27
3550;Giraitė;Gandriukai;2313273738;Taip;0;5;0;5
3551;Giraitė;Gandriukai;9625436756;Taip;4;0;0;4
3552;Giraitė;Gandriukai;8101302584;Taip;23;0;0;23
3553;Giraitė;Gandriukai;9307640828;Ne;17;0;0;17
3554;Giraitė;Gandriukai;3027761044;Taip;0;1;1;2
3555;Giraitė;Gandriukai;1125863541;Taip;0;0;2;2
3556;Giraitė;Gandriukai;4371263826;Taip;19;1;0;20
3557;Giraitė;ŽVIRBLIUKAI;6715354865;Taip;5;0;2;7
3558;Giraitė;ŽVIRBLIUKAI;8461725999;Taip;9;0;0;9
3559;Giraitė;ŽVIRBLIUKAI;7395332578;Ne;19;0;0;19
3560;Giraitė;ŽVIRBLIUKAI;5086296808;Taip;3;11;1;15
3561;Giraitė;ŽVIRBLIUKAI;9669916418;Taip;17;0;0;17
3562;Giraitė;ŽVIRBLIUKAI;3481695682;Taip;5;0;0;5
3563;Giraitė;ŽVIRBLIUKAI;7551981095;Taip;5;0;1;6
3564;Giraitė;ŽVIRBLIUKAI;7678134658;Taip;4;0;3;7
3565;Giraitė;ŽVIRBLIUKAI;9471560738;Taip;6;0;0;6
3566;Giraitė;ŽVIRBLIUKAI;7230351549;Ne;20;0;0;20
3567;Giraitė;ŽVIRBLIUKAI;9728453316;Taip;4;0;0;4
3568;Giraitė;ŽVIRBLIUKAI;9114364139;Taip;10;3;0;13
3569;Giraitė;ŽVIRBLIUKAI;9392127689;Taip;13;0;0;13
3570;Giraitė;ŽVIRBLIUKAI;2416162886;Taip;2;0;2;4
3571;Giraitė;ŽVIRBLIUKAI;7543605905;Taip;5;14;2;21
3572;Giraitė;ŽVIRBLIUKAI;4233170371;Taip;18;0;1;19
3573;Giraitė;ŽVIRBLIUKAI;8871979627;Ne;0;0;5;5
3574;Giraitė;ŽVIRBLIUKAI;3214528809;Taip;8;0;0;8
3575;Giraitė;ŽVIRBLIUKAI;4450822125;Taip;0;0;1;1
3576;Giraitė;ŽVIRBLIUKAI;6474975269;Taip;0;0;2;2
3577;Giraitė;Kiškeliai;5870376620;Taip;6;0;0;6
3578;Giraitė;Kiškeliai;1227555563;Taip;17;0;2;19
3579;Giraitė;Kiškeliai;3613828494;Taip;8;0;4;12
3580;Giraitė;Kiškeliai;5447466102;Taip;5;4;5;14
3581;Giraitė;Kiškeliai;2686885139;Ne;4;0;0;4
3582;Giraitė;Kiškeliai;9764802294;Taip;13;0;0;13
3583;Giraitė;Kiškeliai;5574589536;Taip;9;0;1;10
3584;Giraitė;Kiškeliai;2726766768;Ne;14;0;2;16
3585;Giraitė;Kiškeliai;6565165993;Ne;4;0;1;5
3586;Giraitė;Kiškeliai;1456726379;Ne;12;0;2;14
3587;Giraitė;Kiškeliai;7392324344;Taip;16;0;0;16
3588;Giraitė;Kiškeliai;7744101334;Ne;3;0;2;5
3589;Giraitė;Kiškeliai;9751078590;Taip;0;0;3;3
3590;Gudrutis;Gandriukų;2197278086;Taip;12;5;0;17
3591;Gudrutis;Gandriukų;6358318238;Taip;0;2;9;11
3592;Gudrutis;Gandriukų;7942601528;Taip;8;0;0;8
3593;Gudrutis;Gandriukų;1701035039;Taip;0;2;1;3
3594;Gudrutis;Gandriukų;4844838728;Taip;15;2;0;17
3595;Gudrutis;Gandriukų;1685531183;Taip;13;0;0;13
3596;Gudrutis;Gandriukų;9253468183;Taip;12;2;0;14
3597;Gudrutis;Gandriukų;1051407930;Taip;4;0;1;5
3598;Gudrutis;Gandriukų;7755882832;Taip;5;0;0;5
3599;Gudrutis;Gandriukų;2487363252;Taip;3;0;7;10
3600;Gudrutis;Gandriukų;7663746093;Ne;11;0;1;12
3601;Gudrutis;Gandriukų;1012579870;Taip;10;2;1;13
3602;Gudrutis;Gandriukų;8512130106;Taip;10;2;1;13
3603;Gudrutis;Gandriukų;3919786807;Taip;0;1;6;7
3604;Gudrutis;Gandriukų;2630768189;Taip;0;0;15;15
3605;Gudrutis;Gandriukų;8165828215;Taip;8;2;0;10
3606;Gudrutis;Gandriukų;1485530468;Taip;21;0;0;21
3607;Gudrutis;Gandriukų;5508723821;Taip;13;1;0;14
3608;Gudrutis;Gandriukų;9044566825;Ne;7;2;2;11
3609;Gudrutis;Gandriukų;8774935740;Taip;0;0;12;12
3610;Gudrutis;Gandriukų;9297898193;Taip;10;3;0;13
3611;Gudrutis;Gandriukų;9784116399;Ne;17;1;0;18
3612;Gudrutis;"Saulės zuikučių";7934673005;Taip;17;0;1;18
3613;Gudrutis;"Saulės zuikučių";2199222671;Taip;0;16;0;16
3614;Gudrutis;"Saulės zuikučių";1587454709;Taip;0;4;0;4
3615;Gudrutis;"Saulės zuikučių";1670550212;Taip;14;1;0;15
3616;Gudrutis;"Saulės zuikučių";5241856014;Taip;1;0;3;4
3617;Gudrutis;"Saulės zuikučių";1225698076;Taip;0;0;3;3
3618;Gudrutis;"Saulės zuikučių";8500911420;Ne;0;2;2;4
3619;Gudrutis;"Saulės zuikučių";5408444872;Taip;6;0;7;13
3620;Gudrutis;"Saulės zuikučių";5728436444;Taip;2;1;0;3
3621;Gudrutis;"Saulės zuikučių";9041133527;Taip;0;6;0;6
3622;Gudrutis;"Saulės zuikučių";8621229735;Taip;8;8;0;16
3623;Gudrutis;"Saulės zuikučių";8240340213;Taip;0;3;0;3
3624;Gudrutis;"Saulės zuikučių";9697445037;Taip;0;2;0;2
3625;Gudrutis;"Saulės zuikučių";6846653547;Taip;3;0;0;3
3626;Gudrutis;"Saulės zuikučių";3281890659;Taip;25;5;0;30
3627;Gudrutis;"Saulės zuikučių";2291393238;Taip;14;0;0;14
3628;Gudrutis;"Saulės zuikučių";9752360809;Taip;0;0;4;4
3629;Gudrutis;"Saulės zuikučių";5585248878;Ne;4;2;0;6
3630;Gudrutis;"Saulės zuikučių";1384696362;Taip;8;0;3;11
3631;Gudrutis;"Saulės zuikučių";2666772437;Taip;4;0;0;4
3632;Gudrutis;"Saulės zuikučių";2994309084;Ne;6;3;0;9
3633;Gudrutis;"Saulės zuikučių";3743529726;Ne;0;0;5;5
3634;Gudrutis;Pelėdžiukų;2293472716;Taip;0;1;5;6
3635;Gudrutis;Pelėdžiukų;6835038962;Ne;0;0;11;11
3636;Gudrutis;Pelėdžiukų;6731806925;Taip;0;0;1;1
3637;Gudrutis;Pelėdžiukų;2118727861;Taip;21;0;0;21
3638;Gudrutis;Pelėdžiukų;9701111916;Ne;0;0;15;15
3639;Gudrutis;Pelėdžiukų;1725920873;Taip;6;0;4;10
3640;Gudrutis;Pelėdžiukų;1901358996;Taip;1;0;3;4
3641;Gudrutis;Pelėdžiukų;7664517480;Taip;17;0;0;17
3642;Gudrutis;Pelėdžiukų;9847597133;Taip;3;8;0;11
3643;Gudrutis;Pelėdžiukų;6198012431;Taip;0;3;0;3
3644;Gudrutis;Pelėdžiukų;3646335609;Taip;0;0;8;8
3645;Gudrutis;Pelėdžiukų;7871991275;Taip;5;0;2;7
3646;Gudrutis;Pelėdžiukų;5580618896;Taip;5;0;2;7
3647;Gudrutis;Pelėdžiukų;3625838131;Taip;13;3;0;16
3648;Gudrutis;Pelėdžiukų;2337493193;Taip;0;8;5;13
3649;Gudrutis;Pelėdžiukų;2408038213;Taip;2;1;3;6
3650;Gudrutis;Pelėdžiukų;2764843216;Taip;0;2;0;2
3651;Gudrutis;Pelėdžiukų;7955353991;Taip;0;6;0;6
3652;Gudrutis;BITUČIŲ;4193661251;Taip;14;3;0;17
3653;Gudrutis;BITUČIŲ;7443277768;Taip;14;2;1;17
3654;Gudrutis;BITUČIŲ;9797417587;Taip;0;3;0;3
3655;Gudrutis;BITUČIŲ;5574287734;Ne;0;0;3;3
3656;Gudrutis;BITUČIŲ;2431077357;Taip;0;3;0;3
3657;Gudrutis;BITUČIŲ;7116979528;Ne;2;0;0;2
3658;Gudrutis;BITUČIŲ;1228190677;Taip;6;3;6;15
3659;Gudrutis;BITUČIŲ;6700254479;Taip;0;3;10;13
3660;Gudrutis;BITUČIŲ;1693306014;Taip;0;3;5;8
3661;Gudrutis;BITUČIŲ;8398961969;Taip;0;3;2;5
3662;Gudrutis;BITUČIŲ;2074151024;Taip;0;3;1;4
3663;Gudrutis;BITUČIŲ;1991658503;Taip;0;3;0;3
3664;Gudrutis;BITUČIŲ;2592224860;Taip;10;5;0;15
3665;Gudrutis;BITUČIŲ;9841172472;Taip;14;0;0;14
3666;Gudrutis;BITUČIŲ;3359028602;Taip;2;3;0;5
3667;Gudrutis;BITUČIŲ;4945755164;Taip;10;3;0;13
3668;Gudrutis;BITUČIŲ;6443631536;Taip;0;2;2;4
3669;Gudrutis;BITUČIŲ;3363824185;Ne;13;0;0;13
3670;Gudrutis;BITUČIŲ;7773150642;Taip;0;3;2;5
3671;Gudrutis;BITUČIŲ;6198012431;Taip;0;1;0;1
3672;Gudrutis;Boružėlių;2497248749;Taip;14;0;0;14
3673;Gudrutis;Boružėlių;6284712576;Taip;10;0;0;10
3674;Gudrutis;Boružėlių;9096764346;Taip;3;3;0;6
3675;Gudrutis;Boružėlių;5306281458;Taip;0;0;14;14
3676;Gudrutis;Boružėlių;8783180638;Taip;0;0;14;14
3677;Gudrutis;Boružėlių;8525851058;Taip;15;0;2;17
3678;Gudrutis;Boružėlių;8080976400;Taip;16;0;1;17
3679;Gudrutis;Boružėlių;9808350750;Taip;4;0;0;4
3680;Gudrutis;Boružėlių;6101410750;Taip;12;0;0;12
3681;Gudrutis;Boružėlių;5710348070;Taip;0;0;18;18
3682;Gudrutis;Boružėlių;8843761360;Taip;0;0;18;18
3683;Gudrutis;Boružėlių;5590297232;Taip;10;0;3;13
3684;Gudrutis;Boružėlių;2145834885;Taip;0;0;11;11
3685;Gudrutis;Boružėlių;2827279258;Taip;9;8;0;17
3686;Gudrutis;Boružėlių;5093267385;Taip;6;4;3;13
3687;Gudrutis;Boružėlių;1364145110;Taip;9;0;0;9
3688;Gudrutis;Boružėlių;1737001982;Taip;14;1;2;17
3689;Gudrutis;Boružėlių;9200644104;Taip;10;0;0;10
3690;Gudrutis;Boružėlių;3797656483;Taip;10;0;0;10
3691;Gudrutis;Drugeliai;7930414623;Taip;13;0;3;16
3692;Gudrutis;Drugeliai;6458053920;Taip;5;0;0;5
3693;Gudrutis;Drugeliai;5498218329;Taip;12;5;0;17
3694;Gudrutis;Drugeliai;4600814480;Taip;12;0;1;13
3695;Gudrutis;Drugeliai;9454206104;Taip;5;2;1;8
3696;Gudrutis;Drugeliai;5054363773;Taip;0;5;2;7
3697;Gudrutis;Drugeliai;7531077386;Taip;0;8;0;8
3698;Gudrutis;Drugeliai;5931281687;Taip;16;2;0;18
3699;Gudrutis;Drugeliai;3264829331;Taip;5;0;4;9
3700;Gudrutis;Drugeliai;7143849852;Ne;14;0;0;14
3701;Gudrutis;Drugeliai;3760014407;Taip;4;0;0;4
3702;Gudrutis;Drugeliai;1588396018;Taip;4;0;0;4
3703;Gudrutis;Drugeliai;3316297441;Taip;15;0;0;15
3704;Gudrutis;Drugeliai;6307643172;Taip;5;0;1;6
3705;Gudrutis;Drugeliai;2256458624;Taip;6;0;0;6
3706;Gudrutis;Drugeliai;2278368966;Taip;4;0;7;11
3707;Gudrutis;Drugeliai;5911423362;Taip;5;0;0;5
3708;Gudrutis;Drugeliai;3000289515;Taip;0;0;2;2
3709;Gudrutis;Drugeliai;2784392885;Taip;0;13;9;22
3710;Gudrutis;Drugeliai;1170008457;Taip;5;0;0;5
3711;Jovarėlis;KIŠKUČIAI;1853016838;Ne;7;0;0;7
3712;Jovarėlis;KIŠKUČIAI;8970192705;Taip;18;0;0;18
3713;Jovarėlis;DRUGELIAI;9115511153;Taip;10;0;0;10
3714;Jovarėlis;DRUGELIAI;2143481971;Ne;7;0;0;7
3715;Jovarėlis;DRUGELIAI;7579261984;Taip;10;0;0;10
3716;Jovarėlis;DRUGELIAI;5619816900;Ne;7;0;0;7
3717;Jovarėlis;VOVERIUKAI;5673849822;Ne;14;0;0;14
3718;Jovarėlis;VOVERIUKAI;9329253682;Taip;12;0;0;12
3719;Jovarėlis;VOVERIUKAI;4781108005;Taip;10;0;0;10
3720;Jovarėlis;VOVERIUKAI;5114794241;Taip;11;0;0;11
3721;Jovarėlis;VOVERIUKAI;8423578580;Taip;7;0;0;7
3722;Jovarėlis;VOVERIUKAI;5162335126;Taip;11;0;0;11
3723;Jovarėlis;VOVERIUKAI;8200193975;Taip;7;0;0;7
3724;Jovarėlis;BITUTĖS;3349703664;Taip;8;0;0;8
3725;Jovarėlis;NYKŠTUKAI;5454098417;Ne;7;0;0;7
3726;Jovarėlis;NYKŠTUKAI;1313937710;Taip;3;0;0;3
3727;Jovarėlis;NYKŠTUKAI;7194183817;Taip;19;0;0;19
3728;Jovarėlis;BORUŽĖLĖS;9366125740;Taip;7;0;0;7
3729;Jovarėlis;BORUŽĖLĖS;1222366115;Taip;5;0;0;5
3730;Jovarėlis;BORUŽĖLĖS;6249596318;Taip;8;0;0;8
3731;Jovarėlis;BORUŽĖLĖS;6303503283;Taip;7;0;0;7
3732;Jovarėlis;ŽIRNIUKAI;2353652196;Taip;5;0;0;5
3733;Jovarėlis;ŽIRNIUKAI;5138609373;Taip;3;0;0;3
3734;Jovarėlis;MEŠKUČIAI;6551379627;Taip;9;0;0;9
3735;Jovarėlis;MEŠKUČIAI;1054238143;Taip;4;0;0;4
3736;Jovarėlis;MEŠKUČIAI;8285597164;Taip;3;0;0;3
3737;Jovarėlis;MEŠKUČIAI;1991693486;Taip;5;0;0;5
3738;Jovarėlis;OBUOLIUKAI;7992965177;Taip;1;0;0;1
3739;Jovarėlis;SKRUZDĖLIUKAI;1038855467;Taip;8;0;0;8
3740;Jovarėlis;KATINĖLIAI;4546573044;Taip;12;0;0;12
3741;Jovarėlis;PELĖDŽIUKAI;2723487680;Taip;15;0;0;15
3742;Jovarėlis;PELĖDŽIUKAI;7293104590;Taip;9;0;0;9
3743;Jovarėlis;PELĖDŽIUKAI;4773542772;Taip;11;0;0;11
3744;Jovarėlis;PELĖDŽIUKAI;6406866195;Taip;3;0;0;3
3745;Jurginėlis;Ąžuoliukai;7309052653;Taip;0;22;0;22
3746;Jurginėlis;Ąžuoliukai;2501462080;Taip;5;0;0;5
3747;Jurginėlis;Ąžuoliukai;8571054905;Taip;13;0;0;13
3748;Jurginėlis;Ąžuoliukai;8969526123;Taip;12;0;1;13
3749;Jurginėlis;Ąžuoliukai;6168508647;Taip;16;0;0;16
3750;Jurginėlis;Ąžuoliukai;5861832676;Taip;0;0;1;1
3751;Jurginėlis;Ąžuoliukai;3933113321;Taip;11;7;0;18
3752;Jurginėlis;Ąžuoliukai;5861418459;Taip;19;5;0;24
3753;Jurginėlis;Ąžuoliukai;5869170503;Taip;0;0;8;8
3754;Jurginėlis;Ąžuoliukai;3562210465;Taip;3;3;2;8
3755;Jurginėlis;Ąžuoliukai;6202225321;Taip;0;1;1;2
3756;Jurginėlis;Ąžuoliukai;7081618073;Taip;13;0;0;13
3757;Jurginėlis;Ąžuoliukai;6851855147;Taip;2;1;2;5
3758;Jurginėlis;Ąžuoliukai;9029587175;Taip;4;0;1;5
3759;Jurginėlis;Ąžuoliukai;9889620429;Taip;0;0;1;1
3760;Jurginėlis;Ąžuoliukai;3324811458;Taip;4;2;0;6
3761;Jurginėlis;Ąžuoliukai;6153432639;Taip;9;0;0;9
3762;Jurginėlis;Ąžuoliukai;9850874714;Taip;4;0;1;5
3763;Jurginėlis;Ąžuoliukai;8174251359;Ne;0;3;0;3
3764;Jurginėlis;Ąžuoliukai;2447025385;Taip;24;0;1;25
3765;Jurginėlis;Ąžuoliukai;5313627252;Taip;5;0;3;8
3766;Jurginėlis;Žiogeliai;8159210242;Taip;3;12;0;15
3767;Jurginėlis;Žiogeliai;9934831745;Ne;7;0;0;7
3768;Jurginėlis;Žiogeliai;7251598691;Taip;5;5;0;10
3769;Jurginėlis;Žiogeliai;3083045137;Taip;17;0;0;17
3770;Jurginėlis;Žiogeliai;6906225772;Ne;12;1;0;13
3771;Jurginėlis;Žiogeliai;7010130915;Taip;9;0;1;10
3772;Jurginėlis;Žiogeliai;7907096012;Taip;5;4;0;9
3773;Jurginėlis;Žiogeliai;7250246853;Taip;0;15;0;15
3774;Jurginėlis;Žiogeliai;5160581631;Ne;9;2;0;11
3775;Jurginėlis;Žiogeliai;6438669072;Taip;22;0;0;22
3776;Jurginėlis;Žiogeliai;5037980414;Ne;0;1;0;1
3777;Jurginėlis;Žiogeliai;7300018733;Taip;7;5;0;12
3778;Jurginėlis;Žiogeliai;4674128568;Taip;4;9;0;13
3779;Jurginėlis;Žiogeliai;9305884152;Ne;15;2;0;17
3780;Jurginėlis;Žiogeliai;9716328349;Taip;0;22;0;22
3781;Jurginėlis;Žiogeliai;4441183185;Taip;5;3;0;8
3782;Jurginėlis;Žiogeliai;4502564783;Taip;14;0;0;14
3783;Jurginėlis;Žiogeliai;1937927553;Ne;8;0;0;8
3784;Jurginėlis;Žiogeliai;7527178332;Taip;11;0;0;11
3785;Jurginėlis;Žiogeliai;4682125116;Taip;6;10;0;16
3786;Jurginėlis;Žiogeliai;3920971621;Taip;16;1;0;17
3787;Jurginėlis;Pelėdžiukų;9882919290;Taip;4;0;0;4
3788;Jurginėlis;Pelėdžiukų;5984893389;Taip;0;6;0;6
3789;Jurginėlis;Pelėdžiukų;3079495897;Ne;0;7;0;7
3790;Jurginėlis;Pelėdžiukų;8727844649;Taip;14;1;5;20
3791;Jurginėlis;Pelėdžiukų;1455749921;Taip;19;5;0;24
3792;Jurginėlis;Pelėdžiukų;7809274980;Taip;3;1;0;4
3793;Jurginėlis;Pelėdžiukų;2417314519;Taip;5;3;1;9
3794;Jurginėlis;Pelėdžiukų;6968528293;Taip;0;4;0;4
3795;Jurginėlis;Pelėdžiukų;4292932046;Taip;2;0;0;2
3796;Jurginėlis;Pelėdžiukų;9507571301;Taip;5;2;0;7
3797;Jurginėlis;Pelėdžiukų;8779807396;Taip;0;1;1;2
3798;Jurginėlis;Pelėdžiukų;8443412187;Taip;4;0;0;4
3799;Jurginėlis;Pelėdžiukų;4967548277;Taip;21;5;0;26
3800;Jurginėlis;Pelėdžiukų;2925253653;Taip;15;0;0;15
3801;Jurginėlis;Pelėdžiukų;1340689348;Ne;5;5;0;10
3802;Jurginėlis;Pelėdžiukų;2221708420;Taip;5;2;4;11
3803;Jurginėlis;Pelėdžiukų;6181547354;Taip;0;22;0;22
3804;Jurginėlis;Pelėdžiukų;2490875633;Taip;7;7;0;14
3805;Jurginėlis;Pelėdžiukų;9760394658;Ne;7;0;8;15
3806;Jurginėlis;Pelėdžiukų;3786379532;Ne;14;1;1;16
3807;Jurginėlis;Boružėlių;4295285885;Ne;0;2;0;2
3808;Jurginėlis;Boružėlių;8920304044;Taip;0;8;0;8
3809;Jurginėlis;Boružėlių;2171115974;Ne;9;1;6;16
3810;Jurginėlis;Boružėlių;3027573572;Taip;20;3;0;23
3811;Jurginėlis;Boružėlių;8338173095;Ne;5;0;0;5
3812;Jurginėlis;Boružėlių;1758862051;Taip;0;3;0;3
3813;Jurginėlis;Boružėlių;1467200002;Ne;19;6;0;25
3814;Jurginėlis;Boružėlių;4851923549;Taip;2;0;1;3
3815;Jurginėlis;Boružėlių;6111863896;Taip;6;14;0;20
3816;Jurginėlis;Boružėlių;1701720412;Taip;11;0;0;11
3817;Jurginėlis;Boružėlių;1563317396;Taip;0;10;0;10
3818;Jurginėlis;Boružėlių;47243459592;Taip;9;1;0;10
3819;Jurginėlis;Boružėlių;8784076886;Taip;7;2;1;10
3820;Jurginėlis;Boružėlių;2446630485;Taip;8;2;0;10
3821;Jurginėlis;Boružėlių;1829089083;Taip;5;2;0;7
3822;Jurginėlis;Boružėlių;1361108271;Ne;5;1;0;6
3823;Jurginėlis;Boružėlių;5386710069;Ne;6;11;0;17
3824;Jurginėlis;Boružėlių;8972814655;Taip;11;3;1;15
3825;Jurginėlis;Boružėlių;4852619394;Ne;22;3;0;25
3826;Jurginėlis;Boružėlių;7753784918;Taip;0;22;0;22
3827;Jurginėlis;Bitučių;9589394406;Ne;0;0;1;1
3828;Jurginėlis;Bitučių;3708774681;Taip;10;1;5;16
3829;Jurginėlis;Bitučių;6413324051;Taip;10;4;0;14
3830;Jurginėlis;Bitučių;2639125463;Taip;4;0;0;4
3831;Jurginėlis;Bitučių;1787311340;Taip;5;4;0;9
3832;Jurginėlis;Bitučių;7297672386;Taip;5;1;0;6
3833;Jurginėlis;Bitučių;1586599624;Taip;8;1;3;12
3834;Jurginėlis;Bitučių;2710889915;Taip;0;3;0;3
3835;Jurginėlis;Bitučių;1983924909;Taip;0;3;0;3
3836;Jurginėlis;Bitučių;1175441410;Taip;10;2;0;12
3837;Jurginėlis;Bitučių;1082593212;Taip;11;3;0;14
3838;Jurginėlis;Bitučių;4806248290;Taip;0;0;1;1
3839;Jurginėlis;Bitučių;903039398;Taip;0;1;0;1
3840;Jurginėlis;Bitučių;9646318532;Taip;6;1;0;7
3841;Jurginėlis;Bitučių;8227660508;Taip;17;1;0;18
3842;Jurginėlis;Bitučių;77480957625;Taip;0;3;1;4
3843;Jurginėlis;Bitučių;1547101731;Taip;0;1;0;1
3844;Jurginėlis;Bitučių;2624313807;Ne;11;0;0;11
3845;Jurginėlis;Bitučių;5892180334;Taip;12;1;0;13
3846;Jurginėlis;Bitučių;3018576350;Ne;14;1;1;16
3847;Jurginėlis;Skruzdeliukų;1351306981;Taip;2;0;0;2
3848;Jurginėlis;Skruzdeliukų;9146039217;Taip;8;0;0;8
3849;Jurginėlis;Skruzdeliukų;3558752347;Taip;0;8;0;8
3850;Jurginėlis;Skruzdeliukų;5734506036;Ne;19;0;0;19
3851;Jurginėlis;Skruzdeliukų;3699180485;Taip;11;2;0;13
3852;Jurginėlis;Skruzdeliukų;1634502874;Ne;13;0;0;13
3853;Jurginėlis;Skruzdeliukų;1763849354;Taip;16;0;0;16
3854;Jurginėlis;Skruzdeliukų;4944292549;Taip;9;3;0;12
3855;Jurginėlis;Skruzdeliukų;9506129699;Taip;15;0;0;15
3856;Jurginėlis;Skruzdeliukų;9550110246;Ne;11;0;0;11
3857;Jurginėlis;Skruzdeliukų;3822916547;Taip;22;0;0;22
3858;Jurginėlis;Skruzdeliukų;3541542063;Taip;18;0;0;18
3859;Jurginėlis;Skruzdeliukų;1204999684;Taip;11;1;0;12
3860;Jurginėlis;Skruzdeliukų;9937405742;Taip;15;0;0;15
3861;Jurginėlis;Skruzdeliukų;1726968598;Taip;0;17;0;17
3862;Jurginėlis;Skruzdeliukų;2332714713;Taip;22;0;0;22
3863;Jurginėlis;Skruzdeliukų;9961083854;Taip;0;7;0;7
3864;Jurginėlis;Skruzdeliukų;6542567172;Ne;0;14;0;14
3865;Jurginėlis;Drugelių;2025403481;Taip;0;0;2;2
3866;Jurginėlis;Drugelių;9065349248;Taip;14;0;1;15
3867;Jurginėlis;Drugelių;8341951659;Taip;10;6;0;16
3868;Jurginėlis;Drugelių;7795042485;Taip;12;0;2;14
3869;Jurginėlis;Drugelių;5138832895;Taip;18;0;0;18
3870;Jurginėlis;Drugelių;5751977493;Taip;12;0;0;12
3871;Jurginėlis;Drugelių;3466562781;Taip;0;8;0;8
3872;Jurginėlis;Drugelių;6068645621;Taip;7;7;0;14
3873;Jurginėlis;Drugelių;4276237094;Taip;26;0;0;26
3874;Jurginėlis;Drugelių;2689492215;Taip;10;0;4;14
3875;Jurginėlis;Drugelių;3527520303;Taip;9;0;0;9
3876;Jurginėlis;Drugelių;9736737788;Taip;8;0;0;8
3877;Jurginėlis;Drugelių;1208882528;Taip;6;0;0;6
3878;Jurginėlis;Drugelių;5874949368;Taip;20;0;0;20
3879;Jurginėlis;Drugelių;7349309693;Taip;0;8;0;8
3880;Jurginėlis;Drugelių;3063084253;Taip;11;0;1;12
3881;Jurginėlis;Drugelių;7409019574;Taip;0;16;0;16
3882;Jurginėlis;Drugelių;5928303681;Taip;0;29;0;29
3883;Jurginėlis;Žibučių;4979618298;Taip;4;0;0;4
3884;Jurginėlis;Žibučių;6636147085;Taip;10;1;0;11
3885;Jurginėlis;Žibučių;1438159631;Taip;5;3;0;8
3886;Jurginėlis;Žibučių;1336429135;Taip;7;3;0;10
3887;Jurginėlis;Žibučių;6948834218;Taip;22;1;3;26
3888;Jurginėlis;Žibučių;7721612113;Taip;10;2;0;12
3889;Jurginėlis;Žibučių;6988386438;Taip;10;0;0;10
3890;Jurginėlis;Žibučių;8111158692;Taip;11;0;0;11
3891;Jurginėlis;Žibučių;5936508522;Taip;13;7;0;20
3892;Jurginėlis;Žibučių;6717892969;Taip;14;0;0;14
3893;Jurginėlis;Žibučių;7977676733;Taip;14;0;0;14
3894;Jurginėlis;Žibučių;7530846375;Ne;11;0;0;11
3895;Jurginėlis;Žibučių;3899526893;Taip;4;0;0;4
3896;Jurginėlis;Žibučių;3861311860;Taip;19;0;0;19
3897;Jurginėlis;Žibučių;1263601087;Taip;8;2;0;10
3898;Jurginėlis;Žibučių;5549766339;Taip;10;5;0;15
3899;Jurginėlis;Žibučių;4429780802;Taip;0;11;0;11
3900;Jurginėlis;Žibučių;8968718021;Taip;10;0;1;11
3901;Jurginėlis;Žibučių;2782553941;Taip;11;0;3;14
3902;Jurginėlis;Žibučių;6259461257;Taip;9;0;0;9
3903;Jurginėlis;Žibučių;7252041334;Taip;12;1;0;13
3904;Jurginėlis;Zuikučių;5958832413;Taip;10;5;0;15
3905;Jurginėlis;Zuikučių;4432849717;Taip;10;9;0;19
3906;Jurginėlis;Zuikučių;6587382160;Taip;10;2;7;19
3907;Jurginėlis;Zuikučių;8097652962;Taip;3;3;0;6
3908;Jurginėlis;Zuikučių;4763313715;Ne;23;0;0;23
3909;Jurginėlis;Zuikučių;6671759364;Taip;22;3;0;25
3910;Jurginėlis;Zuikučių;6197396872;Taip;6;0;0;6
3911;Jurginėlis;Zuikučių;8937404520;Taip;4;1;5;10
3912;Jurginėlis;Zuikučių;2820249307;Ne;3;0;8;11
3913;Jurginėlis;Zuikučių;8823175066;Taip;13;1;0;14
3914;Jurginėlis;Zuikučių;8161347781;Taip;5;18;0;23
3915;Jurginėlis;Zuikučių;7283697595;Taip;5;0;2;7
3916;Jurginėlis;Zuikučių;4113264904;Taip;10;0;2;12
3917;Jurginėlis;Zuikučių;8117563141;Taip;5;0;4;9
3918;Jurginėlis;Zuikučių;5652597514;Taip;12;0;6;18
3919;Jurginėlis;Zuikučių;6341896288;Taip;19;0;1;20
3920;Jurginėlis;Zuikučių;4180071775;Taip;10;0;0;10
3921;Jurginėlis;Viščiukų;7193314762;Taip;8;0;6;14
3922;Jurginėlis;Viščiukų;6306274502;Taip;9;0;6;15
3923;Jurginėlis;Viščiukų;4506484183;Taip;0;10;0;10
3924;Jurginėlis;Viščiukų;5474358669;Taip;0;33;0;33
3925;Jurginėlis;Viščiukų;3741447134;Taip;4;0;0;4
3926;Jurginėlis;Viščiukų;2595002682;Taip;11;0;0;11
3927;Jurginėlis;Viščiukų;5866358319;Taip;13;0;0;13
3928;Jurginėlis;Viščiukų;4648875524;Taip;13;1;0;14
3929;Jurginėlis;Viščiukų;1598578487;Taip;10;4;4;18
3930;Jurginėlis;Viščiukų;4644476606;Taip;13;0;1;14
3931;Jurginėlis;Viščiukų;3230200231;Taip;10;4;0;14
3932;Jurginėlis;Viščiukų;7636442845;Taip;5;0;10;15
3933;Jurginėlis;Viščiukų;1286603999;Taip;9;0;1;10
3934;Jurginėlis;Viščiukų;4617952912;Taip;20;0;0;20
3935;Jurginėlis;Viščiukų;9603380131;Taip;0;33;0;33
3936;Jurginėlis;Meškiukų;8844614653;Taip;9;1;1;11
3937;Jurginėlis;Meškiukų;1303323955;Taip;16;0;0;16
3938;Jurginėlis;Meškiukų;4466955830;Taip;14;1;4;19
3939;Jurginėlis;Meškiukų;6932501634;Taip;10;0;0;10
3940;Jurginėlis;Meškiukų;2248773321;Taip;0;0;4;4
3941;Jurginėlis;Meškiukų;3675820817;Taip;16;1;2;19
3942;Jurginėlis;Meškiukų;6285599044;Taip;13;1;6;20
3943;Jurginėlis;Meškiukų;5043815909;Taip;3;2;0;5
3944;Jurginėlis;Meškiukų;9901171406;Taip;13;0;0;13
3945;Jurginėlis;Meškiukų;2982526236;Taip;11;1;0;12
3946;Jurginėlis;Meškiukų;4233910766;Taip;16;0;0;16
3947;Jurginėlis;Meškiukų;1537710974;Taip;12;8;0;20
3948;Jurginėlis;Meškiukų;6594025023;Taip;18;3;0;21
3949;Jurginėlis;Meškiukų;6648657850;Taip;12;1;0;13
3950;Jurginėlis;Meškiukų;6856023398;Taip;11;0;3;14
3951;Jurginėlis;Meškiukų;6124147401;Taip;4;0;7;11
3952;Jurginėlis;Gandriukų;8017976529;Taip;13;1;0;14
3953;Jurginėlis;Gandriukų;3530906368;Ne;7;1;5;13
3954;Jurginėlis;Gandriukų;6806704355;Taip;20;0;1;21
3955;Jurginėlis;Gandriukų;9288380246;Taip;20;0;0;20
3956;Jurginėlis;Gandriukų;2548920722;Taip;18;4;0;22
3957;Jurginėlis;Gandriukų;7288921301;Taip;19;3;0;22
3958;Jurginėlis;Gandriukų;4827340942;Taip;13;11;0;24
3959;Jurginėlis;Gandriukų;4463258777;Taip;0;2;0;2
3960;Jurginėlis;Gandriukų;1414888906;Taip;10;0;0;10
3961;Jurginėlis;Gandriukų;2225892248;Taip;12;0;7;19
3962;Jurginėlis;Gandriukų;6579565337;Taip;0;0;4;4
3963;Jurginėlis;Gandriukų;7990015623;Taip;9;5;2;16
3964;Jurginėlis;Gandriukų;4158502752;Taip;16;0;0;16
3965;Jurginėlis;Gandriukų;2214809186;Taip;10;0;1;11
3966;Jurginėlis;Gandriukų;3284464951;Taip;11;22;0;33
3967;Jurginėlis;Gandriukų;2263818210;Taip;5;8;0;13
3968;Jurginėlis;Gandriukų;3091019969;Taip;14;0;0;14
3969;Jurginėlis;Gandriukų;2837099502;Taip;0;0;4;4
3970;Jurginėlis;Gandriukų;3462969423;Taip;11;8;0;19
3971;Jurginėlis;Gandriukų;7486778826;Taip;23;3;0;26
3972;Jurginėlis;Gandriukų;5242359650;Ne;0;8;0;8
3973;Jurginėlis;Gandriukų;8144038013;Taip;5;10;0;15
3974;Karuselė;PAGRANDUKAS;1621482372;Taip;4;10;0;14
3975;Karuselė;PAGRANDUKAS;3330374479;Taip;9;3;0;12
3976;Karuselė;PAGRANDUKAS;6183785840;Taip;10;5;0;15
3977;Karuselė;PAGRANDUKAS;3984262482;Taip;9;8;0;17
3978;Karuselė;PAGRANDUKAS;9130534156;Taip;13;0;1;14
3979;Karuselė;PAGRANDUKAS;3660843696;Taip;0;6;1;7
3980;Karuselė;PAGRANDUKAS;5132581245;Taip;10;8;0;18
3981;Karuselė;PAGRANDUKAS;2412418335;Taip;10;3;0;13
3982;Karuselė;PAGRANDUKAS;7393434659;Taip;12;0;1;13
3983;Karuselė;PAGRANDUKAS;5695697634;Taip;0;8;0;8
3984;Karuselė;PAGRANDUKAS;7013765804;Taip;10;8;0;18
3985;Karuselė;PAGRANDUKAS;3429495073;Taip;11;0;0;11
3986;Karuselė;PAGRANDUKAS;6252613489;Taip;10;9;0;19
3987;Karuselė;PAGRANDUKAS;5595950213;Taip;17;0;0;17
3988;Karuselė;PAGRANDUKAS;6004882312;Taip;7;6;0;13
3989;Karuselė;PAGRANDUKAS;6856800484;Taip;12;3;0;15
3990;Karuselė;PAGRANDUKAS;5028265234;Taip;8;4;0;12
3991;Karuselė;PAGRANDUKAS;3972815393;Taip;10;4;0;14
3992;Karuselė;PAGRANDUKAS;8157193503;Ne;11;6;0;17
3993;Karuselė;PAGRANDUKAS;8656806219;Taip;9;3;0;12
3994;Karuselė;PAGRANDUKAS;9651192437;Taip;12;0;0;12
3995;Karuselė;NYKŠTUKAS;4966362343;Taip;0;6;0;6
3996;Karuselė;NYKŠTUKAS;9997776739;Taip;12;0;0;12
3997;Karuselė;NYKŠTUKAS;4445214427;Taip;4;12;0;16
3998;Karuselė;NYKŠTUKAS;5216815933;Taip;0;2;0;2
3999;Karuselė;NYKŠTUKAS;7817417459;Taip;0;1;0;1
4000;Karuselė;NYKŠTUKAS;9654804545;Taip;6;9;0;15
4001;Karuselė;NYKŠTUKAS;6581798125;Taip;0;1;0;1
4002;Karuselė;NYKŠTUKAS;1486577955;Ne;13;2;0;15
4003;Karuselė;NYKŠTUKAS;5697305819;Taip;1;2;1;4
4004;Karuselė;NYKŠTUKAS;8007341411;Taip;0;4;0;4
4005;Karuselė;NYKŠTUKAS;9243932017;Taip;6;2;0;8
4006;Karuselė;NYKŠTUKAS;5986973796;Taip;3;1;0;4
4007;Karuselė;NYKŠTUKAS;4856589410;Taip;3;1;0;4
4008;Karuselė;NYKŠTUKAS;9999461542;Taip;1;1;0;2
4009;Karuselė;NYKŠTUKAS;9385698812;Taip;13;0;0;13
4010;Karuselė;NYKŠTUKAS;5328762735;Taip;22;0;0;22
4011;Karuselė;BITUTĖ;1593728369;Taip;9;1;0;10
4012;Karuselė;BITUTĖ;6417699445;Taip;0;3;0;3
4013;Karuselė;BITUTĖ;2426822679;Taip;0;1;0;1
4014;Karuselė;BITUTĖ;1205498782;Taip;0;11;0;11
4015;Karuselė;BITUTĖ;7824913364;Ne;0;5;0;5
4016;Karuselė;BITUTĖ;5960946826;Taip;0;3;3;6
4017;Karuselė;BITUTĖ;8175498192;Taip;0;3;10;13
4018;Karuselė;BITUTĖ;5951045233;Taip;0;5;2;7
4019;Karuselė;BITUTĖ;1487641646;Taip;0;2;0;2
4020;Karuselė;BITUTĖ;6692345915;Taip;0;1;0;1
4021;Karuselė;BITUTĖ;1211005513;Taip;0;5;0;5
4022;Karuselė;BITUTĖ;2160071272;Taip;0;3;0;3
4023;Karuselė;BITUTĖ;1691769088;Taip;0;5;0;5
4024;Karuselė;BITUTĖ;7167895711;Taip;14;0;0;14
4025;Karuselė;BITUTĖ;3116403256;Taip;0;7;0;7
4026;Karuselė;BITUTĖ;7977133699;Taip;0;7;0;7
4027;Karuselė;BITUTĖ;6165548450;Taip;0;1;0;1
4028;Karuselė;BITUTĖ;1204919995;Ne;0;3;19;22
4029;Karuselė;BITUTĖ;4435125556;Taip;0;1;0;1
4030;Karuselė;BITUTĖ;3049506194;Taip;9;2;4;15
4031;Karuselė;BORUŽĖLĖ;1705790474;Taip;4;2;2;8
4032;Karuselė;BORUŽĖLĖ;8608177987;Taip;0;1;0;1
4033;Karuselė;BORUŽĖLĖ;1311907441;Ne;3;2;0;5
4034;Karuselė;BORUŽĖLĖ;6313010762;Taip;9;0;0;9
4035;Karuselė;BORUŽĖLĖ;5859827168;Taip;15;0;0;15
4036;Karuselė;BORUŽĖLĖ;37349219339;Taip;8;1;0;9
4037;Karuselė;BORUŽĖLĖ;6811862463;Taip;0;8;0;8
4038;Karuselė;BORUŽĖLĖ;5471989295;Taip;10;0;0;10
4039;Karuselė;BORUŽĖLĖ;9753876554;Taip;0;0;2;2
4040;Karuselė;BORUŽĖLĖ;8717484092;Taip;11;5;0;16
4041;Karuselė;BORUŽĖLĖ;1994682683;Taip;0;1;2;3
4042;Karuselė;BORUŽĖLĖ;5632697184;Taip;3;2;5;10
4043;Karuselė;BORUŽĖLĖ;2247913568;Taip;0;2;0;2
4044;Karuselė;BORUŽĖLĖ;4262640017;Taip;0;3;0;3
4045;Karuselė;BORUŽĖLĖ;4845558814;Ne;17;10;0;27
4046;Karuselė;BORUŽĖLĖ;8406462155;Taip;2;1;0;3
4047;Karuselė;BORUŽĖLĖ;6495631086;Taip;0;4;0;4
4048;Karuselė;BORUŽĖLĖ;3389843421;Taip;9;1;0;10
4049;Karuselė;BORUŽĖLĖ;4818655110;Taip;4;1;0;5
4050;Karuselė;UOGELĖ;9805481603;Taip;0;4;0;4
4051;Karuselė;UOGELĖ;8182071103;Taip;0;2;0;2
4052;Karuselė;UOGELĖ;9992989896;Taip;0;6;0;6
4053;Karuselė;UOGELĖ;2084276906;Ne;9;1;0;10
4054;Karuselė;UOGELĖ;8665314366;Taip;0;13;0;13
4055;Karuselė;UOGELĖ;8316147204;Taip;2;3;0;5
4056;Karuselė;UOGELĖ;5504719953;Taip;9;12;0;21
4057;Karuselė;UOGELĖ;5919009583;Taip;22;0;0;22
4058;Karuselė;UOGELĖ;4199597984;Taip;0;7;0;7
4059;Karuselė;UOGELĖ;2383023280;Taip;0;6;0;6
4060;Karuselė;UOGELĖ;1575408822;Taip;11;8;0;19
4061;Karuselė;UOGELĖ;3917113787;Taip;0;2;0;2
4062;Karuselė;UOGELĖ;3615957761;Taip;21;1;0;22
4063;Karuselė;UOGELĖ;1891147022;Taip;0;5;0;5
4064;Karuselė;UOGELĖ;9389017016;Taip;5;3;1;9
4065;Karuselė;UOGELĖ;3872322338;Ne;0;1;3;4
4066;Karuselė;UOGELĖ;3963576314;Taip;0;9;5;14
4067;Karuselė;GINTARĖLIS;3773170060;Taip;0;3;0;3
4068;Karuselė;GINTARĖLIS;3904453423;Taip;8;0;0;8
4069;Karuselė;GINTARĖLIS;7489136297;Taip;0;5;0;5
4070;Karuselė;GINTARĖLIS;3534074990;Taip;13;6;5;24
4071;Karuselė;GINTARĖLIS;7540323186;Taip;21;0;0;21
4072;Karuselė;GINTARĖLIS;1019322763;Taip;11;0;0;11
4073;Karuselė;GINTARĖLIS;8481143199;Taip;9;0;3;12
4074;Karuselė;GINTARĖLIS;8409412605;Taip;7;0;1;8
4075;Karuselė;GINTARĖLIS;3136606610;Taip;9;8;0;17
4076;Karuselė;GINTARĖLIS;7599328323;Taip;0;3;0;3
4077;Karuselė;GINTARĖLIS;2688863117;Taip;4;3;0;7
4078;Karuselė;GINTARĖLIS;7439791054;Taip;13;0;0;13
4079;Karuselė;GINTARĖLIS;3696384277;Taip;11;1;0;12
4080;Karuselė;GINTARĖLIS;2945027875;Taip;9;0;1;10
4081;Karuselė;GINTARĖLIS;8855096080;Taip;0;7;1;8
4082;Karuselė;GINTARĖLIS;9116238924;Taip;2;1;0;3
4083;Karuselė;GINTARĖLIS;6433987745;Ne;9;0;4;13
4084;Karuselė;GINTARĖLIS;9763326660;Taip;0;1;0;1
4085;Karuselė;GINTARĖLIS;9479962436;Taip;3;0;0;3
4086;Karuselė;GINTARĖLIS;6232570825;Taip;7;0;0;7
4087;Karuselė;GINTARĖLIS;3460470459;Taip;9;1;0;10
4088;Karuselė;SAULUTĖ;5627583683;Taip;9;0;0;9
4089;Karuselė;SAULUTĖ;2242659064;Taip;8;5;0;13
4090;Karuselė;SAULUTĖ;5704218177;Taip;10;3;0;13
4091;Karuselė;SAULUTĖ;5146709341;Taip;0;1;0;1
4092;Karuselė;SAULUTĖ;9996567374;Taip;0;2;0;2
4093;Karuselė;SAULUTĖ;8331985564;Taip;3;3;1;7
4094;Karuselė;SAULUTĖ;9400171357;Taip;0;1;0;1
4095;Karuselė;SAULUTĖ;5766390337;Taip;0;6;0;6
4096;Karuselė;SAULUTĖ;4879654321;Taip;0;9;3;12
4097;Karuselė;SAULUTĖ;5803808409;Taip;0;4;0;4
4098;Karuselė;SAULUTĖ;2269840705;Taip;5;0;0;5
4099;Karuselė;SAULUTĖ;3149575456;Ne;5;3;0;8
4100;Karuselė;SAULUTĖ;5640656442;Taip;17;0;0;17
4101;Karuselė;SAULUTĖ;9451789237;Taip;7;5;0;12
4102;Karuselė;SAULUTĖ;9450841251;Ne;9;2;2;13
4103;Karuselė;SAULUTĖ;6338379641;Taip;12;3;0;15
4104;Karuselė;SAULUTĖ;8830559511;Taip;6;1;7;14
4105;Karuselė;SAULUTĖ;3228100488;Taip;12;0;4;16
4106;Karuselė;TIGRIUKAS;8946147763;Taip;0;4;0;4
4107;Karuselė;TIGRIUKAS;8076851284;Taip;0;1;0;1
4108;Karuselė;TIGRIUKAS;4426462711;Taip;0;0;1;1
4109;Karuselė;TIGRIUKAS;9484773068;Taip;17;0;0;17
4110;Karuselė;TIGRIUKAS;8678437720;Ne;10;3;0;13
4111;Karuselė;TIGRIUKAS;1698478530;Taip;0;7;0;7
4112;Karuselė;TIGRIUKAS;9561892809;Taip;20;0;0;20
4113;Karuselė;TIGRIUKAS;9726299722;Taip;4;6;0;10
4114;Karuselė;TIGRIUKAS;1576201225;Taip;20;1;1;22
4115;Karuselė;TIGRIUKAS;9344514262;Taip;19;0;0;19
4116;Karuselė;TIGRIUKAS;9065247151;Taip;15;0;1;16
4117;Karuselė;TIGRIUKAS;7131255599;Taip;22;0;0;22
4118;Karuselė;TIGRIUKAS;4180604225;Taip;22;0;0;22
4119;Karuselė;TIGRIUKAS;2397938004;Taip;9;3;0;12
4120;Karuselė;TIGRIUKAS;3605966015;Taip;5;4;0;9
4121;Karuselė;TIGRIUKAS;9633656827;Taip;4;0;0;4
4122;Karuselė;TIGRIUKAS;9252093125;Taip;8;5;0;13
4123;Karuselė;TIGRIUKAS;9736020767;Taip;4;0;3;7
4124;Karuselė;TIGRIUKAS;5176597751;Taip;0;1;0;1
4125;Karuselė;TIGRIUKAS;6656808100;Taip;16;1;0;17
4126;Karuselė;VAIVORYKŠTĖ;1289442716;Taip;12;0;1;13
4127;Karuselė;VAIVORYKŠTĖ;9855242602;Taip;9;8;0;17
4128;Karuselė;VAIVORYKŠTĖ;6546648346;Taip;0;5;0;5
4129;Karuselė;VAIVORYKŠTĖ;8063412271;Taip;9;3;0;12
4130;Karuselė;VAIVORYKŠTĖ;9408843254;Taip;12;0;0;12
4131;Karuselė;VAIVORYKŠTĖ;3514315636;Taip;5;0;4;9
4132;Karuselė;VAIVORYKŠTĖ;8085919723;Taip;5;0;4;9
4133;Karuselė;VAIVORYKŠTĖ;5444753290;Taip;0;19;0;19
4134;Karuselė;VAIVORYKŠTĖ;1581504806;Taip;22;0;0;22
4135;Karuselė;VAIVORYKŠTĖ;2215367063;Taip;20;5;0;25
4136;Karuselė;VAIVORYKŠTĖ;6424622497;Taip;11;4;0;15
4137;Karuselė;VAIVORYKŠTĖ;5855430678;Taip;8;3;0;11
4138;Karuselė;VAIVORYKŠTĖ;5128774216;Taip;14;8;0;22
4139;Karuselė;VAIVORYKŠTĖ;1604997207;Ne;7;3;0;10
4140;Karuselė;VAIVORYKŠTĖ;2757263085;Taip;5;5;0;10
4141;Karuselė;VAIVORYKŠTĖ;4110024673;Taip;4;10;0;14
4142;Karuselė;VAIVORYKŠTĖ;6444553698;Ne;3;0;3;6
4143;Karuselė;VAIVORYKŠTĖ;9400856559;Taip;18;2;0;20
4144;Karuselė;VAIVORYKŠTĖ;1083786182;Taip;16;4;0;20
4145;Karuselė;VAIVORYKŠTĖ;5998868204;Taip;14;4;0;18
4146;Karuselė;VAIVORYKŠTĖ;6734936247;Taip;11;6;0;17
4147;Karuselė;VAIVORYKŠTĖ;3082636224;Taip;6;1;3;10
4148;Karuselė;"AUKSINĖ ŽUVELĖ";2993499990;Taip;13;0;9;22
4149;Karuselė;"AUKSINĖ ŽUVELĖ";3622914118;Taip;0;1;0;1
4150;Karuselė;"AUKSINĖ ŽUVELĖ";8671884362;Taip;3;6;0;9
4151;Karuselė;"AUKSINĖ ŽUVELĖ";6341570221;Taip;6;0;1;7
4152;Karuselė;"AUKSINĖ ŽUVELĖ";2135332292;Taip;7;6;0;13
4153;Karuselė;"AUKSINĖ ŽUVELĖ";8441520423;Taip;6;0;8;14
4154;Karuselė;"AUKSINĖ ŽUVELĖ";9463553056;Taip;0;13;0;13
4155;Karuselė;"AUKSINĖ ŽUVELĖ";4566201460;Taip;4;0;3;7
4156;Karuselė;"AUKSINĖ ŽUVELĖ";3551143062;Taip;6;4;0;10
4157;Karuselė;"AUKSINĖ ŽUVELĖ";8257771271;Taip;0;6;0;6
4158;Karuselė;"AUKSINĖ ŽUVELĖ";7749015193;Taip;9;9;0;18
4159;Karuselė;"AUKSINĖ ŽUVELĖ";1008205490;Taip;8;0;12;20
4160;Karuselė;"AUKSINĖ ŽUVELĖ";3075592618;Taip;4;0;1;5
4161;Karuselė;"AUKSINĖ ŽUVELĖ";2450390957;Taip;12;9;0;21
4162;Karuselė;"AUKSINĖ ŽUVELĖ";4871960780;Taip;17;0;0;17
4163;Karuselė;"AUKSINĖ ŽUVELĖ";8848085495;Ne;11;8;0;19
4164;Karuselė;RAMUNĖ;8362740639;Taip;17;0;0;17
4165;Karuselė;RAMUNĖ;4302662341;Taip;19;1;0;20
4166;Karuselė;RAMUNĖ;9415377698;Taip;3;6;0;9
4167;Karuselė;RAMUNĖ;8474027736;Taip;15;0;0;15
4168;Karuselė;RAMUNĖ;9394220081;Ne;14;3;0;17
4169;Karuselė;RAMUNĖ;7535451590;Taip;10;7;0;17
4170;Karuselė;RAMUNĖ;4865727149;Taip;23;2;0;25
4171;Karuselė;RAMUNĖ;2842034472;Taip;18;2;0;20
4172;Karuselė;RAMUNĖ;8531556390;Taip;0;5;0;5
4173;Karuselė;RAMUNĖ;8952114853;Ne;15;6;0;21
4174;Karuselė;RAMUNĖ;4757820179;Taip;0;3;2;5
4175;Karuselė;RAMUNĖ;9649615834;Taip;7;5;1;13
4176;Karuselė;RAMUNĖ;3885475525;Taip;22;0;0;22
4177;Karuselė;RAMUNĖ;6678283260;Taip;16;0;0;16
4178;Karuselė;RAMUNĖ;4196250786;Ne;18;0;0;18
4179;Karuselė;RAMUNĖ;2260731421;Taip;7;3;1;11
4180;Karuselė;VILKELIS;1412890120;Taip;0;10;0;10
4181;Karuselė;VILKELIS;4951249625;Taip;7;0;1;8
4182;Karuselė;VILKELIS;5135054911;Taip;5;0;0;5
4183;Karuselė;VILKELIS;4130693235;Taip;22;0;0;22
4184;Karuselė;VILKELIS;9340167973;Taip;5;4;0;9
4185;Karuselė;VILKELIS;9985033530;Taip;8;0;2;10
4186;Karuselė;VILKELIS;6826455161;Taip;0;2;3;5
4187;Karuselė;VILKELIS;3661917922;Taip;0;0;5;5
4188;Karuselė;VILKELIS;4211688032;Taip;5;3;0;8
4189;Karuselė;VILKELIS;2727440190;Taip;0;0;4;4
4190;Karuselė;VILKELIS;9304912028;Ne;0;1;4;5
4191;Karuselė;VILKELIS;5802996641;Taip;0;1;2;3
4192;Karuselė;VILKELIS;2306922755;Taip;0;3;4;7
4193;Karuselė;VILKELIS;4103816990;Taip;0;0;3;3
4194;Karuselė;VILKELIS;4325959483;Taip;0;9;0;9
4195;Karuselė;VILKELIS;3271464159;Taip;8;5;0;13
4196;Karuselė;VILKELIS;6062361348;Ne;0;4;0;4
4197;Karuselė;VILKELIS;7501323454;Taip;4;0;11;15
4198;Karuselė;VILKELIS;3968719760;Taip;0;2;0;2
4199;Karuselė;VILKELIS;6785226197;Ne;4;1;1;6
4200;Kaštonas;NYKŠTUKAI;7703842464;Taip;9;3;0;12
4201;Kaštonas;NYKŠTUKAI;1262404954;Taip;11;1;0;12
4202;Kaštonas;NYKŠTUKAI;6254250706;Taip;11;1;0;12
4203;Kaštonas;NYKŠTUKAI;8867446698;Taip;0;2;2;4
4204;Kaštonas;NYKŠTUKAI;8775608339;Taip;0;4;0;4
4205;Kaštonas;NYKŠTUKAI;6613837801;Ne;3;0;0;3
4206;Kaštonas;NYKŠTUKAI;6934262510;Taip;0;10;0;10
4207;Kaštonas;NYKŠTUKAI;6589898580;Taip;7;2;0;9
4208;Kaštonas;NYKŠTUKAI;4824511567;Ne;13;1;0;14
4209;Kaštonas;NYKŠTUKAI;4384907654;Taip;5;8;0;13
4210;Kaštonas;NYKŠTUKAI;3961661158;Taip;0;8;0;8
4211;Kaštonas;NYKŠTUKAI;8318869054;Taip;14;3;0;17
4212;Kaštonas;NYKŠTUKAI;2434765663;Taip;6;4;0;10
4213;Kaštonas;NYKŠTUKAI;2178971789;Taip;15;1;0;16
4214;Kaštonas;NYKŠTUKAI;4444087861;Taip;16;0;0;16
4215;Kaštonas;NYKŠTUKAI;9379171183;Taip;7;0;0;7
4216;Kaštonas;NYKŠTUKAI;9014726465;Taip;5;9;0;14
4217;Kaštonas;NYKŠTUKAI;2361839733;Taip;17;0;0;17
4218;Kaštonas;NYKŠTUKAI;3383390078;Taip;9;6;0;15
4219;Kaštonas;DRUGELIAI;8486955652;Taip;3;6;0;9
4220;Kaštonas;DRUGELIAI;2106924435;Taip;5;7;0;12
4221;Kaštonas;DRUGELIAI;8483888152;Taip;0;1;0;1
4222;Kaštonas;DRUGELIAI;7408901858;Taip;0;1;0;1
4223;Kaštonas;DRUGELIAI;8582453109;Taip;7;6;0;13
4224;Kaštonas;DRUGELIAI;2832688622;Ne;0;11;0;11
4225;Kaštonas;DRUGELIAI;9061158412;Ne;0;11;0;11
4226;Kaštonas;DRUGELIAI;9168456496;Taip;0;2;0;2
4227;Kaštonas;DRUGELIAI;5884427036;Taip;0;3;12;15
4228;Kaštonas;DRUGELIAI;1141693073;Taip;6;0;0;6
4229;Kaštonas;DRUGELIAI;6251564828;Taip;10;0;0;10
4230;Kaštonas;DRUGELIAI;5969052108;Taip;9;3;1;13
4231;Kaštonas;DRUGELIAI;8166925991;Taip;0;13;0;13
4232;Kaštonas;DRUGELIAI;4215759647;Taip;0;7;0;7
4233;Kaštonas;DRUGELIAI;6114301692;Taip;0;3;1;4
4234;Kaštonas;DRUGELIAI;5307755844;Taip;0;3;0;3
4235;Kaštonas;DRUGELIAI;9985164505;Taip;3;5;0;8
4236;Kaštonas;DRUGELIAI;2417951642;Taip;0;1;0;1
4237;Kaštonas;DRUGELIAI;8257643251;Taip;9;5;0;14
4238;Kaštonas;KIŠKUČIAI;2020612346;Taip;0;8;0;8
4239;Kaštonas;KIŠKUČIAI;6585977073;Taip;9;3;0;12
4240;Kaštonas;KIŠKUČIAI;1761520786;Taip;13;0;0;13
4241;Kaštonas;KIŠKUČIAI;9298372326;Ne;11;1;0;12
4242;Kaštonas;KIŠKUČIAI;9778140363;Ne;4;7;0;11
4243;Kaštonas;KIŠKUČIAI;8250964197;Taip;0;12;0;12
4244;Kaštonas;KIŠKUČIAI;7290414209;Taip;0;13;0;13
4245;Kaštonas;KIŠKUČIAI;9356018629;Taip;20;1;0;21
4246;Kaštonas;KIŠKUČIAI;5659508302;Taip;1;0;0;1
4247;Kaštonas;KIŠKUČIAI;4115242811;Taip;5;11;0;16
4248;Kaštonas;KIŠKUČIAI;6051760219;Taip;6;0;0;6
4249;Kaštonas;KIŠKUČIAI;1684641447;Taip;9;2;0;11
4250;Kaštonas;KIŠKUČIAI;1207372235;Ne;0;12;0;12
4251;Kaštonas;KIŠKUČIAI;4570064071;Taip;8;0;0;8
4252;Kaštonas;KIŠKUČIAI;4020980625;Taip;5;0;0;5
4253;Kaštonas;KIŠKUČIAI;2898327157;Taip;4;0;0;4
4254;Kaštonas;KIŠKUČIAI;9320223622;Taip;0;18;0;18
4255;Kaštonas;KIŠKUČIAI;3544696101;Taip;5;3;0;8
4256;Kaštonas;BITUTĖS;7946379086;Taip;0;0;4;4
4257;Kaštonas;BITUTĖS;9285927858;Taip;9;8;0;17
4258;Kaštonas;BITUTĖS;5328263421;Taip;6;0;0;6
4259;Kaštonas;BITUTĖS;9903176616;Taip;12;2;3;17
4260;Kaštonas;BITUTĖS;4033866425;Taip;0;7;0;7
4261;Kaštonas;BITUTĖS;8275673303;Taip;11;1;0;12
4262;Kaštonas;BITUTĖS;1614180834;Taip;3;0;10;13
4263;Kaštonas;BITUTĖS;6711295699;Taip;6;4;0;10
4264;Kaštonas;BITUTĖS;2877124424;Taip;15;4;0;19
4265;Kaštonas;BITUTĖS;1031628633;Taip;14;2;0;16
4266;Kaštonas;BITUTĖS;4551111709;Taip;14;2;0;16
4267;Kaštonas;BITUTĖS;7508357392;Taip;7;3;0;10
4268;Kaštonas;BITUTĖS;8906976150;Taip;5;6;0;11
4269;Kaštonas;BITUTĖS;8151333699;Taip;9;2;0;11
4270;Kaštonas;BITUTĖS;3649329598;Taip;0;18;0;18
4271;Kaštonas;BITUTĖS;8214699601;Taip;4;5;0;9
4272;Kaštonas;BITUTĖS;8152577445;Taip;3;0;3;6
4273;Kaštonas;BITUTĖS;7291448857;Ne;6;5;0;11
4274;Kaštonas;BITUTĖS;4837002666;Taip;12;0;3;15
4275;Kaštonas;BITUTĖS;2701042709;Taip;22;0;0;22
4276;Kaštonas;BITUTĖS;6175014441;Taip;0;0;1;1
4277;Kaštonas;BITUTĖS;1748975865;Taip;0;9;0;9
4278;Kaštonas;MEŠKIUKAI;7956422880;Taip;5;6;0;11
4279;Kaštonas;MEŠKIUKAI;3554337770;Taip;8;0;0;8
4280;Kaštonas;MEŠKIUKAI;7911007041;Ne;0;10;0;10
4281;Kaštonas;MEŠKIUKAI;2125410714;Taip;6;6;0;12
4282;Kaštonas;MEŠKIUKAI;6289073634;Taip;15;0;0;15
4283;Kaštonas;MEŠKIUKAI;7553024183;Taip;9;5;0;14
4284;Kaštonas;MEŠKIUKAI;4616084852;Taip;4;5;0;9
4285;Kaštonas;MEŠKIUKAI;1801371129;Taip;1;0;2;3
4286;Kaštonas;MEŠKIUKAI;5157500600;Ne;5;1;3;9
4287;Kaštonas;MEŠKIUKAI;6606094891;Taip;22;0;0;22
4288;Kaštonas;MEŠKIUKAI;1364391105;Taip;22;0;0;22
4289;Kaštonas;MEŠKIUKAI;6967725663;Taip;0;14;0;14
4290;Kaštonas;MEŠKIUKAI;5153948802;Ne;2;1;0;3
4291;Kaštonas;MEŠKIUKAI;4308169582;Ne;2;7;0;9
4292;Kaštonas;MEŠKIUKAI;8797584508;Taip;9;0;0;9
4293;Kaštonas;MEŠKIUKAI;9965517774;Taip;5;13;0;18
4294;Kaštonas;MEŠKIUKAI;7138581709;Taip;5;13;0;18
4295;Kaštonas;MEŠKIUKAI;8446233414;Taip;12;5;0;17
4296;Kaštonas;MEŠKIUKAI;1196590128;Taip;12;1;2;15
4297;Kaštonas;BORUŽĖLĖS;1501441973;Ne;11;1;0;12
4298;Kaštonas;BORUŽĖLĖS;1612086010;Taip;16;0;1;17
4299;Kaštonas;BORUŽĖLĖS;9034859988;Taip;14;1;0;15
4300;Kaštonas;BORUŽĖLĖS;9249007247;Taip;11;11;0;22
4301;Kaštonas;BORUŽĖLĖS;2057499534;Taip;7;1;3;11
4302;Kaštonas;BORUŽĖLĖS;6896372095;Taip;12;1;0;13
4303;Kaštonas;BORUŽĖLĖS;1976138680;Ne;0;3;0;3
4304;Kaštonas;BORUŽĖLĖS;9807554365;Taip;0;12;0;12
4305;Kaštonas;BORUŽĖLĖS;4708114402;Taip;1;0;0;1
4306;Kaštonas;BORUŽĖLĖS;7992154554;Taip;0;1;1;2
4307;Kaštonas;BORUŽĖLĖS;4641535612;Taip;1;11;0;12
4308;Kaštonas;BORUŽĖLĖS;7383219978;Taip;0;5;0;5
4309;Kaštonas;BORUŽĖLĖS;3251132542;Taip;2;2;0;4
4310;Kaštonas;BORUŽĖLĖS;6425908247;Taip;13;0;0;13
4311;Kaštonas;BORUŽĖLĖS;3860613494;Taip;13;0;0;13
4312;Kaštonas;BORUŽĖLĖS;9317649996;Taip;9;1;0;10
4313;Kaštonas;BORUŽĖLĖS;5948707303;Taip;19;0;1;20
4314;Kaštonas;BORUŽĖLĖS;7698074598;Taip;10;2;7;19
4315;Kaštonas;BORUŽĖLĖS;6749679348;Taip;9;0;0;9
4316;Kaštonas;BORUŽĖLĖS;5060824071;Taip;0;2;0;2
4317;"Krivūlė (Lydos g. 5)";SPINDULIUKAI;1937803301;Taip;0;0;4;4
4318;"Krivūlė (Lydos g. 5)";SPINDULIUKAI;9865192795;Taip;0;0;2;2
4319;"Krivūlė (Lydos g. 5)";SPINDULIUKAI;3913058095;Taip;0;0;2;2
4320;"Krivūlė (Lydos g. 5)";SPINDULIUKAI;1840809151;Taip;6;0;4;10
4321;"Krivūlė (Lydos g. 5)";SPINDULIUKAI;7335245963;Taip;0;0;2;2
4322;"Krivūlė (Lydos g. 5)";SPINDULIUKAI;5802739148;Taip;0;3;5;8
4323;"Krivūlė (Lydos g. 5)";SPINDULIUKAI;5667934115;Taip;0;1;0;1
4324;"Krivūlė (Lydos g. 5)";SPINDULIUKAI;8348288864;Taip;0;0;10;10
4325;"Krivūlė (Lydos g. 5)";SPINDULIUKAI;7155162698;Taip;10;1;6;17
4326;"Krivūlė (Lydos g. 5)";SPINDULIUKAI;1151179495;Taip;0;0;2;2
4327;"Krivūlė (Lydos g. 5)";SPINDULIUKAI;9320613086;Taip;19;0;0;19
4328;"Krivūlė (Lydos g. 5)";SPINDULIUKAI;6632875947;Taip;0;0;12;12
4329;"Krivūlė (Lydos g. 5)";SPINDULIUKAI;4750075323;Taip;5;0;2;7
4330;"Krivūlė (Lydos g. 5)";SPINDULIUKAI;3852793979;Taip;10;12;0;22
4331;"Krivūlė (Lydos g. 5)";SPINDULIUKAI;3184820008;Taip;11;0;4;15
4332;"Krivūlė (Lydos g. 5)";SPINDULIUKAI;7149268223;Taip;0;0;11;11
4333;"Krivūlė (Lydos g. 5)";BORUŽĖLĖS;3605506478;Taip;8;0;0;8
4334;"Krivūlė (Lydos g. 5)";BORUŽĖLĖS;4896656209;Taip;8;0;0;8
4335;"Krivūlė (Lydos g. 5)";BORUŽĖLĖS;4845515196;Taip;0;2;1;3
4336;"Krivūlė (Lydos g. 5)";BORUŽĖLĖS;5676562063;Taip;0;0;1;1
4337;"Krivūlė (Lydos g. 5)";BORUŽĖLĖS;6935969502;Taip;4;0;1;5
4338;"Krivūlė (Lydos g. 5)";BORUŽĖLĖS;4972360440;Taip;14;0;0;14
4339;"Krivūlė (Lydos g. 5)";BORUŽĖLĖS;7318064702;Taip;0;0;5;5
4340;"Krivūlė (Lydos g. 5)";BORUŽĖLĖS;3912620138;Ne;4;0;8;12
4341;"Krivūlė (Lydos g. 5)";BORUŽĖLĖS;3246787504;Ne;5;0;4;9
4342;"Krivūlė (Lydos g. 5)";BORUŽĖLĖS;5531566792;Taip;0;0;1;1
4343;"Krivūlė (Lydos g. 5)";BORUŽĖLĖS;2386053480;Ne;3;0;16;19
4344;"Krivūlė (Lydos g. 5)";BORUŽĖLĖS;8586287004;Taip;3;0;1;4
4345;"Krivūlė (Lydos g. 5)";BORUŽĖLĖS;4540069843;Ne;0;0;2;2
4346;"Krivūlė (Lydos g. 5)";BORUŽĖLĖS;4297876008;Taip;8;0;0;8
4347;"Krivūlė (Lydos g. 5)";BORUŽĖLĖS;2138125571;Taip;0;0;3;3
4348;"Krivūlė (Lydos g. 5)";BORUŽĖLĖS;4177660973;Taip;0;5;0;5
4349;"Krivūlė (Lydos g. 5)";BORUŽĖLĖS;2711010212;Taip;9;0;0;9
4350;"Krivūlė (Lydos g. 5)";BORUŽĖLĖS;4025821636;Taip;4;0;0;4
4351;"Krivūlė (Lydos g. 5)";BORUŽĖLĖS;7781918674;Taip;4;1;0;5
4352;"Krivūlė (Lydos g. 5)";BORUŽĖLĖS;1987255206;Taip;9;0;3;12
4353;"Krivūlė (Lydos g. 5)";BORUŽĖLĖS;7025398689;Taip;19;0;3;22
4354;"Krivūlė (Lydos g. 5)";DRUGELIŲ;5818988913;Taip;0;2;0;2
4355;"Krivūlė (Lydos g. 5)";DRUGELIŲ;7873123757;Taip;0;13;1;14
4356;"Krivūlė (Lydos g. 5)";DRUGELIŲ;19674882649;Taip;0;3;0;3
4357;"Krivūlė (Lydos g. 5)";DRUGELIŲ;2903062788;Taip;2;0;0;2
4358;"Krivūlė (Lydos g. 5)";DRUGELIŲ;10005041572;Taip;5;1;0;6
4359;"Krivūlė (Lydos g. 5)";DRUGELIŲ;37502093836;Taip;0;0;1;1
4360;"Krivūlė (Lydos g. 5)";DRUGELIŲ;83840444975;Taip;0;0;1;1
4361;"Krivūlė (Lydos g. 5)";DRUGELIŲ;2654066358;Taip;5;0;0;5
4362;"Krivūlė (Lydos g. 5)";DRUGELIŲ;2109315338;Taip;0;0;8;8
4363;"Krivūlė (Lydos g. 5)";DRUGELIŲ;6861483854;Taip;15;0;2;17
4364;"Krivūlė (Lydos g. 5)";DRUGELIŲ;1515185307;Taip;6;2;1;9
4365;"Krivūlė (Lydos g. 5)";DRUGELIŲ;9267414141;Taip;5;1;2;8
4366;"Krivūlė (Lydos g. 5)";DRUGELIŲ;1217856292;Taip;5;0;0;5
4367;"Krivūlė (Lydos g. 5)";DRUGELIŲ;9311270695;Taip;7;0;0;7
4368;"Krivūlė (Lydos g. 5)";DRUGELIŲ;73760357378;Taip;8;2;1;11
4369;"Krivūlė (Lydos g. 5)";DRUGELIŲ;6753080815;Taip;9;1;3;13
4370;"Krivūlė (Lydos g. 5)";DRUGELIŲ;4261133734;Taip;7;2;2;11
4371;"Krivūlė (Lydos g. 5)";DRUGELIŲ;6429160371;Taip;5;0;1;6
4372;"Krivūlė (Lydos g. 5)";DRUGELIŲ;3924127476;Taip;0;4;0;4
4373;"Krivūlė (Lydos g. 5)";"BITUTĖS (VALDOFRO)";18486357195;Taip;15;3;0;18
4374;"Krivūlė (Lydos g. 5)";"BITUTĖS (VALDOFRO)";3769812444;Taip;12;4;0;16
4375;"Krivūlė (Lydos g. 5)";"BITUTĖS (VALDOFRO)";5128760019;Taip;12;3;0;15
4376;"Krivūlė (Lydos g. 5)";"BITUTĖS (VALDOFRO)";7789248863;Taip;4;1;2;7
4377;"Krivūlė (Lydos g. 5)";"BITUTĖS (VALDOFRO)";2647149927;Taip;5;4;2;11
4378;"Krivūlė (Lydos g. 5)";"BITUTĖS (VALDOFRO)";5113297248;Taip;0;1;21;22
4379;"Krivūlė (Lydos g. 5)";"BITUTĖS (VALDOFRO)";9632352765;Taip;5;4;1;10
4380;"Krivūlė (Lydos g. 5)";"BITUTĖS (VALDOFRO)";7848471009;Ne;0;0;3;3
4381;"Krivūlė (Lydos g. 5)";"BITUTĖS (VALDOFRO)";5405660104;Taip;0;3;4;7
4382;"Krivūlė (Lydos g. 5)";"BITUTĖS (VALDOFRO)";8834855616;Taip;0;4;0;4
4383;"Krivūlė (Lydos g. 5)";"BITUTĖS (VALDOFRO)";3655576855;Taip;11;1;1;13
4384;"Krivūlė (Lydos g. 5)";"BITUTĖS (VALDOFRO)";1561180871;Taip;3;14;0;17
4385;"Krivūlė (Lydos g. 5)";"BITUTĖS (VALDOFRO)";9702372816;Taip;0;0;12;12
4386;"Krivūlė (Lydos g. 5)";"BITUTĖS (VALDOFRO)";4619224314;Taip;0;22;0;22
4387;"Krivūlė (Lydos g. 5)";"BITUTĖS (VALDOFRO)";8105688948;Ne;8;0;0;8
4388;"Krivūlė (Lydos g. 5)";"BITUTĖS (VALDOFRO)";1932209134;Taip;8;0;3;11
4389;"Krivūlė (Lydos g. 5)";"BITUTĖS (VALDOFRO)";7768827505;Taip;0;0;9;9
4390;"Krivūlė (Lydos g. 5)";"BITUTĖS (VALDOFRO)";7714519095;Taip;0;0;12;12
4391;"Krivūlė (Lydos g. 5)";"BITUTĖS (VALDOFRO)";9409899522;Taip;0;2;3;5
4392;"Krivūlė (Lydos g. 5)";"BITUTĖS (VALDOFRO)";6365743037;Taip;0;3;6;9
4393;"Krivūlė (Lydos g. 5)";"BITUTĖS (VALDOFRO)";6217494808;Taip;0;6;1;7
4394;"Krivūlė (Lydos g. 5)";"BITUTĖS (VALDOFRO)";8748668583;Ne;11;0;0;11
4395;"Krivūlė (Lydos g. 5)";EŽIUKAI;8042185027;Taip;0;0;2;2
4396;"Krivūlė (Lydos g. 5)";EŽIUKAI;1256819206;Taip;0;0;5;5
4397;"Krivūlė (Lydos g. 5)";EŽIUKAI;3616024832;Taip;2;0;3;5
4398;"Krivūlė (Lydos g. 5)";EŽIUKAI;7242596817;Ne;0;0;5;5
4399;"Krivūlė (Lydos g. 5)";EŽIUKAI;5664892835;Taip;0;0;1;1
4400;"Krivūlė (Lydos g. 5)";EŽIUKAI;8399607572;Taip;0;0;1;1
4401;"Krivūlė (Lydos g. 5)";EŽIUKAI;5369083173;Taip;18;0;0;18
4402;"Krivūlė (Lydos g. 5)";EŽIUKAI;9051038248;Taip;0;0;8;8
4403;"Krivūlė (Lydos g. 5)";EŽIUKAI;3144577262;Taip;14;0;1;15
4404;"Krivūlė (Lydos g. 5)";EŽIUKAI;1898389557;Taip;7;0;1;8
4405;"Krivūlė (Lydos g. 5)";EŽIUKAI;2607716072;Taip;20;0;1;21
4406;"Krivūlė (Lydos g. 5)";EŽIUKAI;6830712749;Ne;0;0;4;4
4407;"Krivūlė (Lydos g. 5)";EŽIUKAI;3836712448;Taip;8;0;0;8
4408;"Krivūlė (Lydos g. 5)";EŽIUKAI;8873132189;Taip;0;0;7;7
4409;"Krivūlė (Lydos g. 5)";EŽIUKAI;2430372719;Taip;0;0;2;2
4410;"Krivūlė (Lydos g. 5)";EŽIUKAI;1622229289;Taip;17;1;0;18
4411;"Krivūlė (Lydos g. 5)";EŽIUKAI;2157856704;Taip;7;1;0;8
4412;"Krivūlė (Lydos g. 5)";NYKŠTUKAI;9820383193;Taip;0;0;3;3
4413;"Krivūlė (Lydos g. 5)";NYKŠTUKAI;2742783991;Taip;9;1;0;10
4414;"Krivūlė (Lydos g. 5)";NYKŠTUKAI;9401810791;Taip;20;0;0;20
4415;"Krivūlė (Lydos g. 5)";NYKŠTUKAI;8713384668;Taip;19;0;3;22
4416;"Krivūlė (Lydos g. 5)";NYKŠTUKAI;9678890051;Taip;15;0;0;15
4417;"Krivūlė (Lydos g. 5)";NYKŠTUKAI;9553953446;Taip;6;0;1;7
4418;"Krivūlė (Lydos g. 5)";NYKŠTUKAI;5268832682;Taip;6;0;0;6
4419;"Krivūlė (Lydos g. 5)";NYKŠTUKAI;8767554721;Taip;0;1;4;5
4420;"Krivūlė (Lydos g. 5)";NYKŠTUKAI;9529242858;Taip;15;0;0;15
4421;"Krivūlė (Lydos g. 5)";NYKŠTUKAI;8898023612;Taip;0;0;5;5
4422;"Krivūlė (Lydos g. 5)";NYKŠTUKAI;5768244312;Taip;5;1;0;6
4423;"Krivūlė (Lydos g. 5)";NYKŠTUKAI;5870153336;Taip;0;0;14;14
4424;"Krivūlė (Lydos g. 5)";NYKŠTUKAI;7540940063;Taip;5;1;4;10
4425;"Krivūlė (Lydos g. 5)";NYKŠTUKAI;7262017017;Taip;9;0;3;12
4426;"Krivūlė (Lydos g. 5)";NYKŠTUKAI;9773092651;Taip;3;0;7;10
4427;"Krivūlė (Lydos g. 5)";NYKŠTUKAI;6548893885;Taip;14;3;0;17
4428;"Krivūlė (Lydos g. 5)";NYKŠTUKAI;8674468359;Taip;0;22;0;22
4429;"Krivūlė (Lydos g. 5)";NYKŠTUKAI;8047735389;Taip;5;0;0;5
4430;Kodėlčiukas;Saulutės;6517880481;Taip;6;0;1;7
4431;Kodėlčiukas;Saulutės;1725624698;Taip;6;0;0;6
4432;Kodėlčiukas;Saulutės;8393893311;Taip;0;0;4;4
4433;Kodėlčiukas;Saulutės;7509476161;Taip;3;6;0;9
4434;Kodėlčiukas;Saulutės;7327247516;Ne;6;0;1;7
4435;Kodėlčiukas;Saulutės;1645680526;Taip;0;7;0;7
4436;Kodėlčiukas;Saulutės;8992265000;Taip;8;0;1;9
4437;Kodėlčiukas;Saulutės;6285018663;Taip;12;1;0;13
4438;Kodėlčiukas;Saulutės;1033969800;Taip;0;2;1;3
4439;Kodėlčiukas;Saulutės;2433094435;Ne;4;2;0;6
4440;Kodėlčiukas;Saulutės;9042404309;Taip;0;0;9;9
4441;Kodėlčiukas;Saulutės;9476376350;Ne;4;0;0;4
4442;Kodėlčiukas;Saulutės;7611485881;Taip;12;1;0;13
4443;Kodėlčiukas;Saulutės;7561763602;Taip;8;0;0;8
4444;Kodėlčiukas;Saulutės;2289687766;Taip;4;0;3;7
4445;Kodėlčiukas;Saulutės;6476445296;Taip;6;0;0;6
4446;Kodėlčiukas;Saulutės;1992569595;Ne;16;0;3;19
4447;Kodėlčiukas;Saulutės;9527296531;Taip;0;0;10;10
4448;Kodėlčiukas;Saulutės;8070400563;Taip;0;0;3;3
4449;Kodėlčiukas;Saulutės;8447045958;Taip;7;0;1;8
4450;Kodėlčiukas;Saulutės;2542104903;Taip;6;2;0;8
4451;Kodėlčiukas;Nežiniukai;6045564826;Taip;14;0;0;14
4452;Kodėlčiukas;Nežiniukai;7971932716;Taip;6;0;0;6
4453;Kodėlčiukas;Nežiniukai;7282579315;Taip;3;0;2;5
4454;Kodėlčiukas;Nežiniukai;6905424567;Ne;5;5;2;12
4455;Kodėlčiukas;Nežiniukai;5443377251;Ne;4;2;1;7
4456;Kodėlčiukas;Nežiniukai;3150006441;Taip;5;0;0;5
4457;Kodėlčiukas;Nežiniukai;7626940433;Taip;0;6;0;6
4458;Kodėlčiukas;Nežiniukai;9803206596;Taip;21;0;1;22
4459;Kodėlčiukas;Nežiniukai;4917910801;Ne;4;2;0;6
4460;Kodėlčiukas;Nežiniukai;3473981974;Taip;0;0;7;7
4461;Kodėlčiukas;Nežiniukai;4038168647;Taip;9;1;0;10
4462;Kodėlčiukas;Nežiniukai;8378295683;Taip;8;0;6;14
4463;Kodėlčiukas;Nežiniukai;6000831611;Taip;5;1;1;7
4464;Kodėlčiukas;Nežiniukai;7286497455;Taip;20;1;0;21
4465;Kodėlčiukas;Nežiniukai;1603752483;Taip;9;0;8;17
4466;Kodėlčiukas;Nežiniukai;6074758814;Ne;0;12;0;12
4467;Kodėlčiukas;Nežiniukai;1699358514;Ne;2;3;0;5
4468;Kodėlčiukas;Nežiniukai;1302383608;Taip;0;0;9;9
4469;Kodėlčiukas;Nežiniukai;1160612316;Taip;17;0;3;20
4470;Kodėlčiukas;Nežiniukai;3470151604;Taip;0;0;3;3
4471;Kodėlčiukas;Nežiniukai;5729391456;Taip;9;0;2;11
4472;Kodėlčiukas;Gintarėliai;2560864315;Taip;0;1;3;4
4473;Kodėlčiukas;Gintarėliai;58406224468;Taip;0;1;6;7
4474;Kodėlčiukas;Gintarėliai;20084022099;Taip;10;0;0;10
4475;Kodėlčiukas;Gintarėliai;9686497547;Taip;14;0;0;14
4476;Kodėlčiukas;Gintarėliai;4884104023;Taip;0;1;2;3
4477;Kodėlčiukas;Gintarėliai;1632458573;Taip;12;1;0;13
4478;Kodėlčiukas;Gintarėliai;9332136116;Taip;12;1;0;13
4479;Kodėlčiukas;Gintarėliai;8219424737;Taip;6;1;2;9
4480;Kodėlčiukas;Gintarėliai;4849314647;Taip;4;0;1;5
4481;Kodėlčiukas;Gintarėliai;5202375085;Taip;2;0;1;3
4482;Kodėlčiukas;Gintarėliai;3758606327;Taip;7;0;2;9
4483;Kodėlčiukas;Gintarėliai;5093139270;Ne;14;1;2;17
4484;Kodėlčiukas;Gintarėliai;4738357524;Taip;0;20;0;20
4485;Kodėlčiukas;Gintarėliai;8873629130;Ne;8;0;1;9
4486;Kodėlčiukas;Gintarėliai;1190408818;Taip;0;1;12;13
4487;Kodėlčiukas;Gintarėliai;2162480212;Taip;4;0;0;4
4488;Kodėlčiukas;Gintarėliai;6764015170;Taip;4;7;0;11
4489;Kodėlčiukas;Gintarėliai;6248137523;Taip;0;2;5;7
4490;Kodėlčiukas;Gintarėliai;8606551477;Taip;10;0;0;10
4491;Kodėlčiukas;Šnekučiai;1844016431;Taip;8;3;0;11
4492;Kodėlčiukas;Šnekučiai;1550915654;Taip;0;0;2;2
4493;Kodėlčiukas;Šnekučiai;1935757837;Taip;0;8;0;8
4494;Kodėlčiukas;Šnekučiai;41123326737;Taip;3;0;0;3
4495;Kodėlčiukas;Šnekučiai;8114859362;Taip;0;13;0;13
4496;Kodėlčiukas;Šnekučiai;1666743304;Ne;4;3;0;7
4497;Kodėlčiukas;Šnekučiai;1432342305;Taip;0;0;5;5
4498;Kodėlčiukas;Šnekučiai;9178209049;Ne;12;1;0;13
4499;Kodėlčiukas;Šnekučiai;5988863934;Taip;5;2;0;7
4500;Kodėlčiukas;Šnekučiai;76164689333;Taip;6;0;1;7
4501;Kodėlčiukas;Šnekučiai;5386820408;Taip;0;9;0;9
4502;Kodėlčiukas;Šnekučiai;6194726931;Taip;10;4;0;14
4503;Kodėlčiukas;Šnekučiai;5782600824;Ne;5;0;0;5
4504;Kodėlčiukas;Šnekučiai;7074381835;Taip;1;3;0;4
4505;Kodėlčiukas;Šnekučiai;2988674717;Ne;31;1;0;32
4506;Kodėlčiukas;Šnekučiai;1834696935;Ne;0;0;1;1
4507;Kodėlčiukas;Šnekučiai;4273202718;Taip;12;0;0;12
4508;Kodėlčiukas;Šnekučiai;2244326972;Taip;2;0;6;8
4509;Kodėlčiukas;Šnekučiai;6761903865;Ne;7;0;1;8
4510;Kodėlčiukas;Šnekučiai;3778271049;Taip;10;8;0;18
4511;Kodėlčiukas;Šnekučiai;7647582987;Ne;4;0;3;7
4512;Kodėlčiukas;Šnekučiai;7510273691;Taip;9;1;0;10
4513;Kodėlčiukas;Pabiručiai;9278139998;Taip;0;5;0;5
4514;Kodėlčiukas;Pabiručiai;6008027505;Taip;0;2;2;4
4515;Kodėlčiukas;Pabiručiai;5894631257;Ne;7;0;0;7
4516;Kodėlčiukas;Pabiručiai;6065858518;Taip;5;0;0;5
4517;Kodėlčiukas;Pabiručiai;8586746296;Taip;3;4;0;7
4518;Kodėlčiukas;Pabiručiai;9480926599;Ne;9;0;0;9
4519;Kodėlčiukas;Pabiručiai;9511144369;Taip;0;5;3;8
4520;Kodėlčiukas;Pabiručiai;7246943802;Taip;11;0;4;15
4521;Kodėlčiukas;Pabiručiai;8189938439;Taip;7;0;0;7
4522;Kodėlčiukas;Pabiručiai;5587200800;Taip;10;0;2;12
4523;Kodėlčiukas;Pabiručiai;1433623973;Taip;2;0;3;5
4524;Kodėlčiukas;Pabiručiai;1087808091;Ne;2;3;0;5
4525;Kodėlčiukas;Pabiručiai;7570122834;Taip;0;1;0;1
4526;Kodėlčiukas;Pabiručiai;5359866071;Taip;10;0;0;10
4527;Kodėlčiukas;Pabiručiai;5801430256;Taip;0;7;0;7
4528;Kodėlčiukas;Pabiručiai;7455949617;Taip;9;0;0;9
4529;Kodėlčiukas;Pabiručiai;1039982141;Taip;14;1;0;15
4530;Kodėlčiukas;Pabiručiai;4507928289;Taip;4;0;0;4
4531;Kodėlčiukas;Pabiručiai;9830842598;Ne;5;0;1;6
4532;Kodėlčiukas;Pabiručiai;8291672306;Taip;0;0;3;3
4533;Kodėlčiukas;Pabiručiai;3882838712;Ne;0;0;4;4
4534;Kodėlčiukas;Pabiručiai;8635107742;Taip;5;0;0;5
4535;Kodėlčiukas;Smalsučiai;7630180473;Ne;11;2;3;16
4536;Kodėlčiukas;Smalsučiai;8140940288;Taip;23;0;0;23
4537;Kodėlčiukas;Smalsučiai;7246243975;Taip;6;0;0;6
4538;Kodėlčiukas;Smalsučiai;1600501494;Ne;4;0;0;4
4539;Kodėlčiukas;Smalsučiai;3880019350;Taip;0;1;2;3
4540;Kodėlčiukas;Smalsučiai;4818678923;Taip;5;1;3;9
4541;Kodėlčiukas;Smalsučiai;9589692031;Taip;8;0;2;10
4542;Kodėlčiukas;Smalsučiai;1906128091;Ne;1;0;1;2
4543;Kodėlčiukas;Smalsučiai;8302606312;Taip;1;4;0;5
4544;Kodėlčiukas;Smalsučiai;9460792167;Taip;10;0;0;10
4545;Kodėlčiukas;Smalsučiai;7324303899;Taip;6;0;3;9
4546;Kodėlčiukas;Smalsučiai;9794875862;Taip;0;1;6;7
4547;Kodėlčiukas;Smalsučiai;9528997865;Taip;0;10;3;13
4548;Kodėlčiukas;Smalsučiai;1919722425;Taip;0;1;0;1
4549;Kodėlčiukas;Smalsučiai;8879977943;Taip;4;0;0;4
4550;Kodėlčiukas;Smalsučiai;8647609373;Taip;8;9;0;17
4551;Kodėlčiukas;Smalsučiai;2062878300;Taip;10;1;3;14
4552;Kodėlčiukas;Smalsučiai;6950802941;Taip;21;0;0;21
4553;Kodėlčiukas;Smalsučiai;1233880820;Ne;9;0;0;9
4554;Kodėlčiukas;Giliukai;9754425363;Taip;0;2;1;3
4555;Kodėlčiukas;Giliukai;5587782917;Taip;11;0;0;11
4556;Kodėlčiukas;Giliukai;8100861190;Taip;0;12;0;12
4557;Kodėlčiukas;Giliukai;7639341503;Ne;0;1;0;1
4558;Kodėlčiukas;Giliukai;8017465692;Taip;6;0;0;6
4559;Kodėlčiukas;Giliukai;7937365710;Ne;10;0;0;10
4560;Kodėlčiukas;Giliukai;1937181137;Taip;8;0;0;8
4561;Kodėlčiukas;Giliukai;9733831323;Taip;0;0;2;2
4562;Kodėlčiukas;Giliukai;7007386353;Taip;7;6;0;13
4563;Kodėlčiukas;Giliukai;9721353724;Taip;21;0;0;21
4564;Kodėlčiukas;Giliukai;2943146610;Ne;9;0;1;10
4565;Kodėlčiukas;Giliukai;5573845415;Ne;0;0;2;2
4566;Kodėlčiukas;Giliukai;2122779530;Taip;10;2;2;14
4567;Kodėlčiukas;Giliukai;8785157050;Taip;5;16;0;21
4568;Kodėlčiukas;Giliukai;5770748359;Taip;0;6;0;6
4569;Kodėlčiukas;Giliukai;9992204262;Taip;0;0;1;1
4570;Kodėlčiukas;Giliukai;6643473339;Taip;0;7;0;7
4571;Kodėlčiukas;Giliukai;8107869258;Ne;0;0;2;2
4572;Kodėlčiukas;Giliukai;5909222351;Taip;19;0;0;19
4573;Kodėlčiukas;Giliukai;3130715310;Taip;0;8;0;8
4574;Kodėlčiukas;Giliukai;3686259290;Taip;2;0;5;7
4575;Kodėlčiukas;Gudručiai;1191430672;Taip;16;0;0;16
4576;Kodėlčiukas;Gudručiai;6988515253;Taip;8;9;0;17
4577;Kodėlčiukas;Gudručiai;3385551650;Taip;0;0;6;6
4578;Kodėlčiukas;Gudručiai;7318908956;Taip;0;3;0;3
4579;Kodėlčiukas;Gudručiai;9865803714;Taip;8;0;0;8
4580;Kodėlčiukas;Gudručiai;7430239198;Taip;0;0;1;1
4581;Kodėlčiukas;Gudručiai;8400610717;Taip;15;0;1;16
4582;Kodėlčiukas;Gudručiai;7116594055;Taip;0;0;8;8
4583;Kodėlčiukas;Gudručiai;7326475644;Taip;10;0;1;11
4584;Kodėlčiukas;Gudručiai;1801366890;Taip;7;0;1;8
4585;Kodėlčiukas;Gudručiai;9483378853;Taip;7;10;0;17
4586;Kodėlčiukas;Gudručiai;8890987483;Ne;0;0;8;8
4587;Kodėlčiukas;Gudručiai;4687333060;Taip;0;2;0;2
4588;Kodėlčiukas;Gudručiai;4543838852;Taip;3;0;0;3
4589;Kodėlčiukas;Gudručiai;2987907651;Taip;8;3;0;11
4590;Kodėlčiukas;Gudručiai;9028856983;Taip;11;0;1;12
4591;Kodėlčiukas;Gudručiai;1588132166;Taip;10;0;0;10
4592;Kodėlčiukas;Gudručiai;6014084915;Taip;0;8;4;12
4593;Kodėlčiukas;Gudručiai;3068084704;Taip;13;2;0;15
4594;Kodėlčiukas;Gudručiai;6985788287;Taip;0;0;1;1
4595;Kodėlčiukas;Gudručiai;3427610168;Taip;15;0;0;15
4596;Kodėlčiukas;Žirniukai;2402290604;Taip;15;0;0;15
4597;Kodėlčiukas;Žirniukai;6522019070;Ne;11;0;0;11
4598;Kodėlčiukas;Žirniukai;1050905569;Taip;0;0;5;5
4599;Kodėlčiukas;Žirniukai;3053949510;Taip;10;0;3;13
4600;Kodėlčiukas;Žirniukai;5325660102;Taip;0;1;7;8
4601;Kodėlčiukas;Žirniukai;8429572505;Taip;13;0;0;13
4602;Kodėlčiukas;Žirniukai;4321485862;Taip;22;0;0;22
4603;Kodėlčiukas;Žirniukai;1550287298;Taip;16;0;0;16
4604;Kodėlčiukas;Žirniukai;9045733092;Taip;17;0;0;17
4605;Kodėlčiukas;Žirniukai;4341694264;Taip;0;0;9;9
4606;Kodėlčiukas;Žirniukai;4597473929;Taip;17;0;0;17
4607;Kodėlčiukas;Žirniukai;9702236745;Taip;14;0;1;15
4608;Kodėlčiukas;Žirniukai;7189930025;Taip;8;0;1;9
4609;Kodėlčiukas;Žirniukai;2002468844;Taip;11;0;3;14
4610;Kodėlčiukas;Žirniukai;4187856743;Taip;10;0;2;12
4611;Kodėlčiukas;Žirniukai;1656161309;Ne;9;0;0;9
4612;Kodėlčiukas;Katinėliai;4730433849;Taip;6;0;6;12
4613;Kodėlčiukas;Katinėliai;6474867237;Taip;8;0;4;12
4614;Kodėlčiukas;Katinėliai;4995538090;Ne;3;0;7;10
4615;Kodėlčiukas;Katinėliai;8045906704;Taip;15;0;1;16
4616;Kodėlčiukas;Katinėliai;7306085848;Taip;0;1;3;4
4617;Kodėlčiukas;Katinėliai;6576466300;Taip;17;0;0;17
4618;Kodėlčiukas;Katinėliai;5650077893;Taip;20;1;0;21
4619;Kodėlčiukas;Katinėliai;3239314295;Taip;17;0;5;22
4620;Kodėlčiukas;Katinėliai;9221561862;Taip;14;0;0;14
4621;Kodėlčiukas;Katinėliai;2147517344;Taip;9;1;0;10
4622;Kodėlčiukas;Katinėliai;2119041584;Taip;5;3;0;8
4623;Kodėlčiukas;Katinėliai;9826174805;Taip;3;0;5;8
4624;Kodėlčiukas;Katinėliai;2291665527;Taip;0;0;2;2
4625;Kodėlčiukas;Katinėliai;1570599010;Taip;17;0;0;17
4626;Kodėlčiukas;Katinėliai;9670055064;Taip;9;0;0;9
4627;Kodėlčiukas;Katinėliai;4727546035;Taip;0;9;0;9
4628;Kodėlčiukas;Nykštukai;6670171992;Taip;10;0;0;10
4629;Kodėlčiukas;Nykštukai;6935233288;Taip;29;0;0;29
4630;Kodėlčiukas;Nykštukai;8823086730;Taip;18;0;0;18
4631;Kodėlčiukas;Nykštukai;7686420784;Taip;9;0;0;9
4632;Kodėlčiukas;Nykštukai;8348024909;Ne;10;0;0;10
4633;Kodėlčiukas;Nykštukai;8759498015;Ne;0;0;5;5
4634;Kodėlčiukas;Nykštukai;9418778626;Taip;8;0;0;8
4635;Kodėlčiukas;Nykštukai;8911944991;Ne;18;10;0;28
4636;Kodėlčiukas;Nykštukai;2465920649;Taip;18;0;0;18
4637;Kodėlčiukas;Nykštukai;4293763647;Taip;5;0;0;5
4638;Kodėlčiukas;Nykštukai;3878358193;Taip;9;0;3;12
4639;Kodėlčiukas;Nykštukai;6097922310;Ne;10;0;0;10
4640;Kodėlčiukas;Nykštukai;1835522972;Taip;6;0;0;6
4641;Kodėlčiukas;Nykštukai;4986413731;Taip;12;0;0;12
4642;Kodėlčiukas;Nykštukai;2802895479;Taip;7;7;0;14
4643;Kodėlčiukas;Nykštukai;9914565606;Taip;17;0;3;20
4644;Kodėlčiukas;Nykštukai;2543628770;Taip;0;0;5;5
4645;Kodėlčiukas;ŽIOGELIAI;8769409404;Ne;16;0;2;18
4646;Kodėlčiukas;ŽIOGELIAI;6745245907;Taip;21;0;2;23
4647;Kodėlčiukas;ŽIOGELIAI;9055399463;Taip;6;0;2;8
4648;Kodėlčiukas;ŽIOGELIAI;4672108384;Taip;13;0;1;14
4649;Kodėlčiukas;ŽIOGELIAI;2081199093;Taip;22;0;0;22
4650;Kodėlčiukas;ŽIOGELIAI;4779994281;Taip;5;1;0;6
4651;Kodėlčiukas;ŽIOGELIAI;5115939251;Taip;0;0;7;7
4652;Kodėlčiukas;ŽIOGELIAI;3223461282;Taip;7;0;6;13
4653;Kodėlčiukas;ŽIOGELIAI;3603781385;Taip;21;0;0;21
4654;Kodėlčiukas;ŽIOGELIAI;6749972956;Taip;13;0;2;15
4655;Kodėlčiukas;ŽIOGELIAI;2189949450;Taip;14;0;0;14
4656;Kodėlčiukas;ŽIOGELIAI;7497358286;Taip;19;0;3;22
4657;Kodėlčiukas;ŽIOGELIAI;4089558399;Taip;19;0;0;19
4658;Kodėlčiukas;ŽIOGELIAI;6843492891;Taip;7;0;0;7
4659;Kodėlčiukas;ŽIOGELIAI;2933909503;Taip;13;0;0;13
4660;Kodėlčiukas;ŽIOGELIAI;4969181023;Taip;7;0;1;8
4661;Kodėlčiukas;BITUTĖS;2313607716;Taip;4;0;2;6
4662;Kodėlčiukas;BITUTĖS;2438891967;Taip;12;0;0;12
4663;Kodėlčiukas;BITUTĖS;8829986201;Taip;3;0;3;6
4664;Kodėlčiukas;BITUTĖS;8144034996;Ne;0;0;6;6
4665;Kodėlčiukas;BITUTĖS;3156788328;Taip;5;0;0;5
4666;Kodėlčiukas;BITUTĖS;7910205296;Taip;0;0;8;8
4667;Kodėlčiukas;BITUTĖS;9736751250;Taip;13;0;2;15
4668;Kodėlčiukas;BITUTĖS;8037386529;Ne;10;3;0;13
4669;Kodėlčiukas;BITUTĖS;1047209628;Taip;13;0;3;16
4670;Kodėlčiukas;BITUTĖS;5068611716;Ne;11;0;2;13
4671;Kodėlčiukas;BITUTĖS;8932472612;Taip;5;0;1;6
4672;Kodėlčiukas;BITUTĖS;7186835214;Taip;8;0;3;11
4673;Kodėlčiukas;BITUTĖS;4529565626;Taip;8;0;3;11
4674;Kodėlčiukas;BITUTĖS;7227149646;Taip;0;0;9;9
4675;Kodėlčiukas;BITUTĖS;1568628843;Taip;0;17;0;17
4676;Kodėlčiukas;BITUTĖS;9209671311;Ne;18;0;0;18
4677;Kodėlčiukas;BITUTĖS;6726383331;Ne;18;0;0;18
4678;Kodėlčiukas;BITUTĖS;7464963101;Ne;8;0;9;17
4679;Kodėlčiukas;BITUTĖS;1197049907;Ne;4;0;2;6
4680;Kodėlčiukas;VYŠNIUKAI;7705057116;Taip;10;0;0;10
4681;Kodėlčiukas;VYŠNIUKAI;7643398934;Taip;0;1;12;13
4682;Kodėlčiukas;VYŠNIUKAI;8799798070;Taip;9;0;4;13
4683;Kodėlčiukas;VYŠNIUKAI;7119815662;Taip;10;8;0;18
4684;Kodėlčiukas;VYŠNIUKAI;9398732476;Taip;16;0;4;20
4685;Kodėlčiukas;VYŠNIUKAI;2720748563;Ne;14;0;0;14
4686;Kodėlčiukas;VYŠNIUKAI;2871111867;Taip;24;0;0;24
4687;Kodėlčiukas;VYŠNIUKAI;9914322177;Taip;12;0;0;12
4688;Kodėlčiukas;VYŠNIUKAI;1925590099;Taip;10;0;0;10
4689;Kodėlčiukas;VYŠNIUKAI;7242653444;Taip;2;0;3;5
4690;Kodėlčiukas;VYŠNIUKAI;2298734536;Taip;6;10;0;16
4691;Kodėlčiukas;VYŠNIUKAI;6261333618;Taip;7;0;0;7
4692;Kodėlčiukas;VYŠNIUKAI;2549153581;Taip;13;1;3;17
4693;Kodėlčiukas;VYŠNIUKAI;1808211253;Taip;9;1;0;10
4694;Kodėlčiukas;VYŠNIUKAI;5178305435;Ne;10;0;0;10
4695;Kodėlčiukas;VYŠNIUKAI;5061852590;Taip;18;0;0;18
4696;Kodėlčiukas;VYŠNIUKAI;4782931414;Taip;18;0;0;18
4697;Kodėlčiukas;VYŠNIUKAI;1803320085;Taip;16;0;0;16
4698;Kodėlčiukas;VYŠNIUKAI;3938536446;Taip;0;0;8;8
4699;Kodėlčiukas;VYŠNIUKAI;5752818911;Ne;0;13;0;13
4700;Kodėlčiukas;BORUŽĖLĖS;9109362006;Taip;10;0;0;10
4701;Kodėlčiukas;BORUŽĖLĖS;9169500252;Taip;7;3;0;10
4702;Kodėlčiukas;BORUŽĖLĖS;9724373368;Taip;0;12;0;12
4703;Kodėlčiukas;BORUŽĖLĖS;5075801618;Taip;6;0;2;8
4704;Kodėlčiukas;BORUŽĖLĖS;2819860331;Taip;4;0;4;8
4705;Kodėlčiukas;BORUŽĖLĖS;4941186694;Taip;13;0;2;15
4706;Kodėlčiukas;BORUŽĖLĖS;4866089623;Taip;13;1;0;14
4707;Kodėlčiukas;BORUŽĖLĖS;5952121209;Taip;9;6;0;15
4708;Kodėlčiukas;BORUŽĖLĖS;4230906452;Taip;10;0;0;10
4709;Kodėlčiukas;BORUŽĖLĖS;6505671642;Ne;9;0;0;9
4710;Kodėlčiukas;BORUŽĖLĖS;9208137169;Ne;0;1;6;7
4711;Kodėlčiukas;BORUŽĖLĖS;5876187643;Ne;21;0;0;21
4712;Kodėlčiukas;BORUŽĖLĖS;1206798597;Taip;3;9;0;12
4713;Kodėlčiukas;BORUŽĖLĖS;6587593805;Taip;10;0;1;11
4714;Kodėlčiukas;BORUŽĖLĖS;1827752731;Taip;17;1;1;19
4715;Kodėlčiukas;BORUŽĖLĖS;1005178052;Taip;28;0;0;28
4716;Kodėlčiukas;BORUŽĖLĖS;9252478832;Taip;7;0;0;7
4717;Kodėlčiukas;BORUŽĖLĖS;1889809198;Taip;11;0;0;11
4718;Kodėlčiukas;BORUŽĖLĖS;4490196764;Taip;0;4;0;4
4719;Kodėlčiukas;BORUŽĖLĖS;1074477043;Taip;15;3;0;18
4720;Kodėlčiukas;BORUŽĖLĖS;2351468626;Taip;0;2;0;2
4721;Kodėlčiukas;BORUŽĖLĖS;3403889915;Taip;15;4;0;19
4722;Kodėlčiukas;VYTURĖLIAI;6714818379;Taip;0;9;0;9
4723;Kodėlčiukas;VYTURĖLIAI;4218096561;Taip;9;3;0;12
4724;Kodėlčiukas;VYTURĖLIAI;4514764005;Taip;1;1;0;2
4725;Kodėlčiukas;VYTURĖLIAI;2169307879;Taip;17;0;0;17
4726;Kodėlčiukas;VYTURĖLIAI;2448536092;Taip;0;1;2;3
4727;Kodėlčiukas;VYTURĖLIAI;4585226357;Taip;0;0;13;13
4728;Kodėlčiukas;VYTURĖLIAI;4884233329;Taip;5;0;4;9
4729;Kodėlčiukas;VYTURĖLIAI;8263945732;Taip;14;0;0;14
4730;Kodėlčiukas;VYTURĖLIAI;7612531087;Taip;14;0;0;14
4731;Kodėlčiukas;VYTURĖLIAI;4937929385;Taip;8;0;0;8
4732;Kodėlčiukas;VYTURĖLIAI;2904858964;Taip;17;1;0;18
4733;Kodėlčiukas;VYTURĖLIAI;3413659259;Taip;9;2;0;11
4734;Kodėlčiukas;VYTURĖLIAI;9673271313;Taip;5;0;2;7
4735;Kodėlčiukas;VYTURĖLIAI;5710301153;Taip;0;0;10;10
4736;Kodėlčiukas;VYTURĖLIAI;1746835627;Taip;9;0;1;10
4737;Kodėlčiukas;VYTURĖLIAI;5474125905;Taip;13;2;0;15
4738;Kodėlčiukas;VYTURĖLIAI;2298099102;Taip;12;1;0;13
4739;Kodėlčiukas;VYTURĖLIAI;8427457478;Taip;0;14;0;14
4740;Kodėlčiukas;VYTURĖLIAI;5181211722;Taip;16;0;0;16
4741;Kodėlčiukas;VYTURĖLIAI;3472862544;Ne;17;0;0;17
4742;Kodėlčiukas;VYTURĖLIAI;5921714669;Taip;21;3;0;24
4743;Kodėlčiukas;VYTURĖLIAI;7778188733;Taip;8;0;1;9
4744;Kodėlčiukas;DRUGELIAI;4165123345;Taip;0;0;2;2
4745;Kodėlčiukas;DRUGELIAI;5772071707;Taip;10;3;0;13
4746;Kodėlčiukas;DRUGELIAI;1149682376;Taip;0;1;1;2
4747;Kodėlčiukas;DRUGELIAI;7587203481;Taip;0;0;3;3
4748;Kodėlčiukas;DRUGELIAI;2353960861;Taip;8;1;0;9
4749;Kodėlčiukas;DRUGELIAI;6103959702;Taip;5;0;1;6
4750;Kodėlčiukas;DRUGELIAI;3267687337;Taip;10;3;0;13
4751;Kodėlčiukas;DRUGELIAI;5505788210;Taip;5;0;1;6
4752;Kodėlčiukas;DRUGELIAI;5577154148;Taip;6;2;0;8
4753;Kodėlčiukas;DRUGELIAI;8547039654;Taip;0;0;5;5
4754;Kodėlčiukas;DRUGELIAI;4202423480;Taip;5;0;0;5
4755;Kodėlčiukas;DRUGELIAI;9979034031;Taip;0;4;0;4
4756;Kodėlčiukas;DRUGELIAI;3240221130;Ne;6;0;0;6
4757;Kodėlčiukas;DRUGELIAI;7714816675;Taip;12;0;0;12
4758;Kodėlčiukas;DRUGELIAI;9139424911;Taip;3;8;1;12
4759;Kodėlčiukas;DRUGELIAI;9664432781;Taip;7;0;0;7
4760;Kodėlčiukas;DRUGELIAI;5197946954;Taip;11;0;0;11
4761;Kodėlčiukas;DRUGELIAI;8315176054;Taip;0;1;6;7
4762;Kodėlčiukas;DRUGELIAI;3651073383;Taip;10;0;0;10
4763;Kodėlčiukas;DRUGELIAI;3854719881;Taip;3;0;5;8
4764;Kodėlčiukas;DRUGELIAI;7908217415;Taip;11;0;6;17
4765;Kodėlčiukas;OBUOLIUKAI;8784531004;Taip;3;3;0;6
4766;Kodėlčiukas;OBUOLIUKAI;1289342844;Taip;10;4;0;14
4767;Kodėlčiukas;OBUOLIUKAI;7318196860;Taip;0;1;1;2
4768;Kodėlčiukas;OBUOLIUKAI;8208448849;Taip;9;0;0;9
4769;Kodėlčiukas;OBUOLIUKAI;1683506414;Taip;10;0;1;11
4770;Kodėlčiukas;OBUOLIUKAI;3315862631;Taip;6;5;0;11
4771;Kodėlčiukas;OBUOLIUKAI;5896726125;Taip;8;0;3;11
4772;Kodėlčiukas;OBUOLIUKAI;3168418461;Taip;5;2;2;9
4773;Kodėlčiukas;OBUOLIUKAI;9645987751;Taip;12;4;0;16
4774;Kodėlčiukas;OBUOLIUKAI;5860975805;Taip;0;0;4;4
4775;Kodėlčiukas;OBUOLIUKAI;8782155591;Taip;9;0;2;11
4776;Kodėlčiukas;OBUOLIUKAI;8104220950;Taip;0;15;0;15
4777;Kodėlčiukas;OBUOLIUKAI;2005453189;Taip;7;3;0;10
4778;Kodėlčiukas;OBUOLIUKAI;1180399735;Taip;14;0;1;15
4779;Kodėlčiukas;OBUOLIUKAI;5173730926;Taip;13;2;1;16
4780;Kodėlčiukas;OBUOLIUKAI;3442449482;Ne;8;0;1;9
4781;Kodėlčiukas;OBUOLIUKAI;7946010973;Taip;0;11;0;11
4782;Kodėlčiukas;OBUOLIUKAI;5342852235;Taip;14;0;1;15
4783;Kodėlčiukas;OBUOLIUKAI;8563412043;Ne;7;0;1;8
4784;Kodėlčiukas;OBUOLIUKAI;4026784012;Taip;10;9;0;19
4785;Kodėlčiukas;OBUOLIUKAI;2114176689;Ne;0;22;0;22
4786;Kodėlčiukas;OBUOLIUKAI;3033687110;Ne;7;1;2;10
4787;Kurpaitė;Viščiukų;4657523142;Taip;8;3;0;11
4788;Kurpaitė;Viščiukų;2157581956;Taip;0;21;0;21
4789;Kurpaitė;Viščiukų;3481813493;Taip;0;2;0;2
4790;Kurpaitė;Viščiukų;8402747029;Taip;0;6;0;6
4791;Kurpaitė;Viščiukų;4687182527;Taip;9;0;0;9
4792;Kurpaitė;Viščiukų;2373582223;Taip;0;22;0;22
4793;Kurpaitė;Viščiukų;7194351335;Taip;17;0;0;17
4794;Kurpaitė;Viščiukų;5701318496;Taip;15;2;0;17
4795;Kurpaitė;Viščiukų;2744439309;Ne;8;7;0;15
4796;Kurpaitė;Viščiukų;5923694769;Taip;4;0;0;4
4797;Kurpaitė;Viščiukų;5557028481;Taip;5;5;0;10
4798;Kurpaitė;Viščiukų;5447826458;Taip;0;16;0;16
4799;Kurpaitė;Viščiukų;9825971721;Taip;6;0;0;6
4800;Kurpaitė;Viščiukų;2867842844;Taip;23;4;0;27
4801;Kurpaitė;Viščiukų;6859316204;Taip;10;0;0;10
4802;Kurpaitė;Gėlyčių;9922582884;Ne;7;1;0;8
4803;Kurpaitė;Gėlyčių;6466518987;Ne;4;12;0;16
4804;Kurpaitė;Gėlyčių;9769835612;Taip;10;0;0;10
4805;Kurpaitė;Gėlyčių;7703075096;Taip;0;3;0;3
4806;Kurpaitė;Gėlyčių;5745448950;Taip;22;0;0;22
4807;Kurpaitė;Gėlyčių;5952306163;Taip;0;2;0;2
4808;Kurpaitė;Gėlyčių;3989274600;Taip;5;4;0;9
4809;Kurpaitė;Gėlyčių;3139272175;Taip;0;11;0;11
4810;Kurpaitė;Gėlyčių;4769611100;Taip;0;3;0;3
4811;Kurpaitė;Gėlyčių;4426311033;Taip;10;0;0;10
4812;Kurpaitė;Gėlyčių;1927773278;Taip;17;1;0;18
4813;Kurpaitė;Gėlyčių;9221882007;Taip;10;2;0;12
4814;Kurpaitė;Gėlyčių;3456815576;Taip;0;12;0;12
4815;Kurpaitė;Gėlyčių;8361612709;Taip;0;12;0;12
4816;Kurpaitė;Gėlyčių;4754807319;Taip;0;5;0;5
4817;Kurpaitė;Gėlyčių;4607835570;Taip;2;1;0;3
4818;Kurpaitė;Gėlyčių;1964193512;Ne;0;4;0;4
4819;Kurpaitė;Gėlyčių;2629958613;Taip;5;0;0;5
4820;Kurpaitė;Gėlyčių;2629958613;Taip;5;0;0;5
4821;Kurpaitė;Drugelių;5844470373;Taip;14;0;0;14
4822;Kurpaitė;Drugelių;5609161523;Taip;8;1;0;9
4823;Kurpaitė;Drugelių;3003517700;Taip;0;7;0;7
4824;Kurpaitė;Drugelių;9915241987;Taip;0;5;0;5
4825;Kurpaitė;Drugelių;9200404698;Ne;0;6;0;6
4826;Kurpaitė;Drugelių;5064875626;Taip;6;0;0;6
4827;Kurpaitė;Drugelių;3502355847;Taip;10;0;0;10
4828;Kurpaitė;Drugelių;4592795281;Taip;0;17;0;17
4829;Kurpaitė;Drugelių;9480290430;Taip;0;4;0;4
4830;Kurpaitė;Drugelių;8868415451;Taip;7;3;0;10
4831;Kurpaitė;Drugelių;2290343066;Taip;0;11;0;11
4832;Kurpaitė;Drugelių;4188925256;Taip;5;4;0;9
4833;Kurpaitė;Drugelių;1273426668;Taip;0;11;0;11
4834;Kurpaitė;Drugelių;5220314051;Taip;8;0;0;8
4835;Kurpaitė;Drugelių;1413326858;Ne;23;0;0;23
4836;Kurpaitė;Drugelių;3634641300;Taip;0;8;0;8
4837;Kurpaitė;Drugelių;4602268315;Taip;5;0;0;5
4838;Kurpaitė;Drugelių;8592478282;Ne;0;7;0;7
4839;Kurpaitė;Drugelių;6568580994;Taip;0;15;0;15
4840;Kurpaitė;Pelyčių;4964063637;Taip;10;0;0;10
4841;Kurpaitė;Pelyčių;7546409044;Taip;0;16;0;16
4842;Kurpaitė;Pelyčių;7249931704;Taip;0;3;0;3
4843;Kurpaitė;Pelyčių;1218040871;Taip;6;9;0;15
4844;Kurpaitė;Pelyčių;1209441106;Taip;0;1;0;1
4845;Kurpaitė;Pelyčių;1505783589;Taip;0;8;0;8
4846;Kurpaitė;Pelyčių;4519369081;Taip;7;0;0;7
4847;Kurpaitė;Pelyčių;2359555461;Taip;7;5;0;12
4848;Kurpaitė;Pelyčių;65434834152;Taip;0;7;0;7
4849;Kurpaitė;Pelyčių;9063294667;Taip;0;7;0;7
4850;Kurpaitė;Pelyčių;4312062240;Ne;6;3;0;9
4851;Kurpaitė;Pelyčių;2827617670;Taip;5;7;0;12
4852;Kurpaitė;Pelyčių;1457318954;Taip;0;1;0;1
4853;Kurpaitė;Pelyčių;7897713994;Taip;0;12;0;12
4854;Kurpaitė;Pelyčių;4168882748;Taip;4;14;0;18
4855;Kurpaitė;Pelyčių;72710210157;Taip;2;4;1;7
4856;Kurpaitė;Pelyčių;1094620507;Taip;0;4;1;5
4857;Kurpaitė;Pelyčių;58127430940;Taip;0;13;0;13
4858;Kurpaitė;Pelyčių;2116580903;Taip;0;8;0;8
4859;Kurpaitė;Pelyčių;24410351286;Taip;0;15;0;15
4860;"Kūlverstukas (Suvalkų g. 6)";Saulutės;7449993309;Taip;0;4;9;13
4861;"Kūlverstukas (Suvalkų g. 6)";Saulutės;2450625415;Taip;9;0;1;10
4862;"Kūlverstukas (Suvalkų g. 6)";Saulutės;2101490038;Taip;9;0;1;10
4863;"Kūlverstukas (Suvalkų g. 6)";Saulutės;9096819614;Taip;5;2;0;7
4864;"Kūlverstukas (Suvalkų g. 6)";Saulutės;7118949795;Ne;0;0;5;5
4865;"Kūlverstukas (Suvalkų g. 6)";Saulutės;4173514390;Taip;0;0;4;4
4866;"Kūlverstukas (Suvalkų g. 6)";Saulutės;2762230590;Taip;3;0;0;3
4867;"Kūlverstukas (Suvalkų g. 6)";Saulutės;5103259175;Taip;3;0;5;8
4868;"Kūlverstukas (Suvalkų g. 6)";Saulutės;9167460438;Taip;10;6;0;16
4869;"Kūlverstukas (Suvalkų g. 6)";Saulutės;8319255735;Taip;0;0;7;7
4870;"Kūlverstukas (Suvalkų g. 6)";Saulutės;4846324136;Ne;5;9;1;15
4871;"Kūlverstukas (Suvalkų g. 6)";Saulutės;7505926208;Taip;10;3;0;13
4872;"Kūlverstukas (Suvalkų g. 6)";Saulutės;1014630718;Taip;10;3;0;13
4873;"Kūlverstukas (Suvalkų g. 6)";Saulutės;1795306946;Ne;9;0;5;14
4874;"Kūlverstukas (Suvalkų g. 6)";Saulutės;1898905623;Taip;10;2;0;12
4875;"Kūlverstukas (Suvalkų g. 6)";Saulutės;5340239466;Taip;10;0;0;10
4876;"Kūlverstukas (Suvalkų g. 6)";Saulutės;3448880105;Taip;0;0;13;13
4877;"Kūlverstukas (Suvalkų g. 6)";Saulutės;8294873714;Taip;7;3;0;10
4878;"Kūlverstukas (Suvalkų g. 6)";Saulutės;7970898546;Ne;10;0;0;10
4879;"Kūlverstukas (Suvalkų g. 6)";Saulutės;4532151103;Taip;17;0;0;17
4880;"Kūlverstukas (Suvalkų g. 6)";Saulutės;8353856412;Ne;15;0;0;15
4881;"Kūlverstukas (Suvalkų g. 6)";Peledžiukai;5488011852;Taip;13;0;3;16
4882;"Kūlverstukas (Suvalkų g. 6)";Peledžiukai;3937419139;Taip;6;1;0;7
4883;"Kūlverstukas (Suvalkų g. 6)";Peledžiukai;6975324309;Taip;0;1;6;7
4884;"Kūlverstukas (Suvalkų g. 6)";Peledžiukai;1452422691;Ne;12;0;0;12
4885;"Kūlverstukas (Suvalkų g. 6)";Peledžiukai;5372936730;Ne;12;1;0;13
4886;"Kūlverstukas (Suvalkų g. 6)";Peledžiukai;4396230034;Taip;5;8;3;16
4887;"Kūlverstukas (Suvalkų g. 6)";Peledžiukai;7359354944;Ne;0;0;1;1
4888;"Kūlverstukas (Suvalkų g. 6)";Peledžiukai;8853848991;Taip;0;3;0;3
4889;"Kūlverstukas (Suvalkų g. 6)";Peledžiukai;6287636806;Taip;7;4;4;15
4890;"Kūlverstukas (Suvalkų g. 6)";Peledžiukai;4073233921;Taip;6;0;1;7
4891;"Kūlverstukas (Suvalkų g. 6)";Peledžiukai;8092104136;Taip;9;0;6;15
4892;"Kūlverstukas (Suvalkų g. 6)";Peledžiukai;3238807604;Taip;0;4;2;6
4893;"Kūlverstukas (Suvalkų g. 6)";Peledžiukai;1932066021;Taip;6;0;1;7
4894;"Kūlverstukas (Suvalkų g. 6)";Peledžiukai;9655585527;Taip;10;4;0;14
4895;"Kūlverstukas (Suvalkų g. 6)";Peledžiukai;5488852698;Taip;8;0;0;8
4896;"Kūlverstukas (Suvalkų g. 6)";Peledžiukai;7480593611;Ne;0;0;3;3
4897;"Kūlverstukas (Suvalkų g. 6)";Peledžiukai;5345423038;Ne;0;7;0;7
4898;"Kūlverstukas (Suvalkų g. 6)";Peledžiukai;3270176280;Taip;10;5;0;15
4899;"Kūlverstukas (Suvalkų g. 6)";Peledžiukai;4285624305;Taip;6;1;1;8
4900;"Kūlverstukas (Suvalkų g. 6)";Peledžiukai;4173514390;Taip;6;0;0;6
4901;"Kūlverstukas (Suvalkų g. 6)";Gelytės;3811616695;Taip;0;3;19;22
4902;"Kūlverstukas (Suvalkų g. 6)";Gelytės;3162808486;Taip;3;0;0;3
4903;"Kūlverstukas (Suvalkų g. 6)";Gelytės;8346712630;Taip;6;0;1;7
4904;"Kūlverstukas (Suvalkų g. 6)";Gelytės;1939668692;Ne;9;2;3;14
4905;"Kūlverstukas (Suvalkų g. 6)";Gelytės;4651091340;Taip;0;22;0;22
4906;"Kūlverstukas (Suvalkų g. 6)";Gelytės;7112217569;Ne;6;1;3;10
4907;"Kūlverstukas (Suvalkų g. 6)";Gelytės;5391554530;Taip;12;5;1;18
4908;"Kūlverstukas (Suvalkų g. 6)";Gelytės;8701405518;Taip;9;9;1;19
4909;"Kūlverstukas (Suvalkų g. 6)";Gelytės;4111966910;Taip;8;1;0;9
4910;"Kūlverstukas (Suvalkų g. 6)";Gelytės;8964753108;Taip;15;2;0;17
4911;"Kūlverstukas (Suvalkų g. 6)";Gelytės;2389231051;Taip;11;2;0;13
4912;"Kūlverstukas (Suvalkų g. 6)";Gelytės;1067182820;Taip;0;0;6;6
4913;"Kūlverstukas (Suvalkų g. 6)";Gelytės;2316978273;Taip;0;22;0;22
4914;"Kūlverstukas (Suvalkų g. 6)";Gelytės;1967837561;Taip;0;1;0;1
4915;"Kūlverstukas (Suvalkų g. 6)";Gelytės;8333084277;Taip;6;1;1;8
4916;"Kūlverstukas (Suvalkų g. 6)";Gelytės;6710735721;Taip;0;2;4;6
4917;"Kūlverstukas (Suvalkų g. 6)";Gelytės;8618967238;Taip;14;3;0;17
4918;"Kūlverstukas (Suvalkų g. 6)";Bitutės;9777005699;Taip;0;0;7;7
4919;"Kūlverstukas (Suvalkų g. 6)";Bitutės;8599785196;Taip;20;0;0;20
4920;"Kūlverstukas (Suvalkų g. 6)";Bitutės;2082087440;Taip;0;9;0;9
4921;"Kūlverstukas (Suvalkų g. 6)";Bitutės;9976311692;Taip;7;9;0;16
4922;"Kūlverstukas (Suvalkų g. 6)";Bitutės;6319075079;Taip;9;0;0;9
4923;"Kūlverstukas (Suvalkų g. 6)";Bitutės;1062604474;Taip;3;0;0;3
4924;"Kūlverstukas (Suvalkų g. 6)";Bitutės;3712773480;Taip;14;1;0;15
4925;"Kūlverstukas (Suvalkų g. 6)";Bitutės;1985177751;Taip;15;3;4;22
4926;"Kūlverstukas (Suvalkų g. 6)";Bitutės;2924333435;Taip;11;0;0;11
4927;"Kūlverstukas (Suvalkų g. 6)";Bitutės;9787833724;Taip;6;0;1;7
4928;"Kūlverstukas (Suvalkų g. 6)";Bitutės;6916013898;Taip;1;0;1;2
4929;"Kūlverstukas (Suvalkų g. 6)";Bitutės;4694784301;Taip;0;0;3;3
4930;Lakštingala;Saulutės;2156571482;Ne;15;1;1;17
4931;Lakštingala;Saulutės;4651600682;Taip;9;0;0;9
4932;Lakštingala;Saulutės;2084960114;Ne;0;0;13;13
4933;Lakštingala;Saulutės;3911509979;Taip;10;0;0;10
4934;Lakštingala;Saulutės;1598639284;Taip;0;2;0;2
4935;Lakštingala;Saulutės;3723986383;Taip;6;5;0;11
4936;Lakštingala;Saulutės;1243254166;Ne;16;1;0;17
4937;Lakštingala;Saulutės;9628476764;Ne;14;0;0;14
4938;Lakštingala;Saulutės;4344553248;Taip;8;0;3;11
4939;Lakštingala;Saulutės;6567480562;Taip;6;0;0;6
4940;Lakštingala;Saulutės;9495341480;Taip;0;2;0;2
4941;Lakštingala;Saulutės;2543779273;Taip;15;0;0;15
4942;Lakštingala;Saulutės;2093953744;Taip;3;1;0;4
4943;Lakštingala;Saulutės;1074616528;Taip;12;0;0;12
4944;Lakštingala;Saulutės;2626498928;Taip;4;0;0;4
4945;Lakštingala;Saulutės;9441296489;Ne;12;0;0;12
4946;Lakštingala;Saulutės;6369696598;Taip;9;1;0;10
4947;Lakštingala;Saulutės;3618452008;Taip;4;0;0;4
4948;Lakštingala;Saulutės;9297542026;Taip;16;3;0;19
4949;Lakštingala;Saulutės;9899997020;Taip;0;0;14;14
4950;Lakštingala;Saulutės;8130468345;Taip;5;3;0;8
4951;Lakštingala;Nykštukai;9725851433;Taip;13;0;2;15
4952;Lakštingala;Nykštukai;8217315818;Ne;6;7;0;13
4953;Lakštingala;Nykštukai;2769474812;Ne;0;0;14;14
4954;Lakštingala;Nykštukai;9879064676;Taip;0;10;0;10
4955;Lakštingala;Nykštukai;2941128360;Ne;4;0;1;5
4956;Lakštingala;Nykštukai;9912622093;Taip;3;0;5;8
4957;Lakštingala;Nykštukai;3509165175;Ne;12;0;0;12
4958;Lakštingala;Nykštukai;3993759015;Taip;20;3;0;23
4959;Lakštingala;Nykštukai;5445945319;Taip;0;14;0;14
4960;Lakštingala;Nykštukai;6332498461;Taip;0;0;1;1
4961;Lakštingala;Nykštukai;1655202909;Taip;7;5;2;14
4962;Lakštingala;Nykštukai;6009631424;Taip;4;3;0;7
4963;Lakštingala;Nykštukai;5162605666;Taip;3;3;0;6
4964;Lakštingala;Nykštukai;2073818724;Taip;13;0;2;15
4965;Lakštingala;Nykštukai;7994475429;Taip;0;5;1;6
4966;Lakštingala;Nykštukai;1863034132;Taip;0;0;22;22
4967;Lakštingala;Nykštukai;6292331193;Taip;4;0;2;6
4968;Lakštingala;Nykštukai;9489982241;Taip;0;1;0;1
4969;Lakštingala;Nykštukai;4032030375;Taip;0;11;0;11
4970;Lakštingala;Nykštukai;2652305131;Taip;6;8;0;14
4971;Lakštingala;Nykštukai;7963839249;Taip;6;3;0;9
4972;Lakštingala;Nykštukai;9375002191;Taip;0;5;0;5
4973;Lakštingala;Nykštukai;4179366572;Taip;5;0;14;19
4974;Lakštingala;Nykštukai;4857448665;Taip;10;0;0;10
4975;Lakštingala;Bitutės;8890852891;Taip;5;3;0;8
4976;Lakštingala;Bitutės;5851957031;Ne;0;1;14;15
4977;Lakštingala;Bitutės;7918688955;Taip;13;0;3;16
4978;Lakštingala;Bitutės;9395512638;Taip;0;0;3;3
4979;Lakštingala;Bitutės;1832608585;Taip;0;6;3;9
4980;Lakštingala;Bitutės;9958821769;Taip;2;0;0;2
4981;Lakštingala;Bitutės;7953724873;Taip;0;2;5;7
4982;Lakštingala;Bitutės;7900597697;Taip;11;1;0;12
4983;Lakštingala;Bitutės;8470575927;Taip;0;0;2;2
4984;Lakštingala;Bitutės;9497327995;Taip;0;0;6;6
4985;Lakštingala;Bitutės;1411121466;Taip;5;0;0;5
4986;Lakštingala;Bitutės;8944088082;Taip;5;1;0;6
4987;Lakštingala;Bitutės;9897713625;Taip;1;3;1;5
4988;Lakštingala;Bitutės;2104150466;Taip;5;0;3;8
4989;Lakštingala;Bitutės;70798601578;Taip;0;6;3;9
4990;Lakštingala;Bitutės;1265027238;Taip;9;0;1;10
4991;Lakštingala;Bitutės;1736130324;Taip;1;2;3;6
4992;Lakštingala;Bitutės;2039579203;Taip;0;2;3;5
4993;Lakštingala;Bitutės;5672932116;Ne;7;0;1;8
4994;Lakštingala;Bitutės;5598711072;Taip;1;0;8;9
4995;Lakštingala;Bitutės;9346986726;Taip;0;2;2;4
4996;Lakštingala;Bitutės;3872205876;Taip;8;5;0;13
4997;Lakštingala;Bitutės;5920907667;Taip;1;0;12;13
4998;Lakštingala;Bitutės;8679582358;Taip;10;0;3;13
4999;Lakštingala;Bitutės;2266870318;Ne;9;1;3;13
5000;Lakštingala;Pūkeliai;9774836470;Taip;1;0;0;1
5001;Lakštingala;Pūkeliai;1958696382;Ne;7;0;1;8
5002;Lakštingala;Pūkeliai;4542992319;Taip;10;0;0;10
5003;Lakštingala;Pūkeliai;2593030897;Taip;0;0;6;6
5004;Lakštingala;Pūkeliai;6908873466;Taip;0;1;0;1
5005;Lakštingala;Pūkeliai;7929034243;Taip;0;11;0;11
5006;Lakštingala;Pūkeliai;5854794141;Taip;5;4;0;9
5007;Lakštingala;Pūkeliai;2130192341;Taip;9;3;0;12
5008;Lakštingala;Pūkeliai;8165998647;Taip;22;0;0;22
5009;Lakštingala;Pūkeliai;1458348357;Taip;13;0;0;13
5010;Lakštingala;Pūkeliai;4465752871;Taip;7;0;0;7
5011;Lakštingala;Pūkeliai;5379344261;Taip;0;0;1;1
5012;Lakštingala;Pūkeliai;4722328994;Taip;7;0;0;7
5013;Lakštingala;Pūkeliai;7272454093;Taip;0;1;3;4
5014;Lakštingala;Pūkeliai;1587899391;Taip;3;0;2;5
5015;Lakštingala;Pūkeliai;6234559044;Taip;6;0;2;8
5016;Lakštingala;Pūkeliai;5727308039;Taip;3;1;0;4
5017;Lakštingala;Pūkeliai;5051773825;Taip;4;0;0;4
5018;Lakštingala;Pūkeliai;9390342572;Taip;0;0;1;1
5019;Lakštingala;Pūkeliai;5949665703;Taip;15;0;0;15
5020;Lakštingala;Pūkeliai;6565318145;Taip;7;3;0;10
5021;Lakštingala;Pūkeliai;4384468922;Taip;0;0;10;10
5022;Lakštingala;Pūkeliai;2423761155;Taip;6;0;3;9
5023;Lakštingala;Pūkeliai;8171357606;Taip;2;13;0;15
5024;Lakštingala;Aitvariukai;1474796466;Taip;3;0;4;7
5025;Lakštingala;Aitvariukai;4546036762;Taip;8;0;1;9
5026;Lakštingala;Aitvariukai;6219896499;Taip;3;0;0;3
5027;Lakštingala;Aitvariukai;1248909711;Taip;4;0;1;5
5028;Lakštingala;Aitvariukai;9676872125;Taip;4;1;0;5
5029;Lakštingala;Aitvariukai;9083753159;Taip;3;0;2;5
5030;Lakštingala;Aitvariukai;7879280198;Taip;9;7;0;16
5031;Lakštingala;Aitvariukai;4403673558;Taip;4;6;0;10
5032;Lakštingala;Aitvariukai;5693413287;Ne;12;0;0;12
5033;Lakštingala;Aitvariukai;7240426529;Ne;10;0;0;10
5034;Lakštingala;Aitvariukai;8558000223;Taip;5;0;0;5
5035;Lakštingala;Aitvariukai;5244646855;Taip;3;0;0;3
5036;Lakštingala;Aitvariukai;5602079341;Ne;15;0;0;15
5037;Lakštingala;Aitvariukai;7404386777;Taip;3;0;0;3
5038;Lakštingala;Aitvariukai;3166474163;Taip;4;3;0;7
5039;Lakštingala;Aitvariukai;8609822839;Taip;8;10;0;18
5040;Lakštingala;Aitvariukai;6180443056;Taip;14;0;0;14
5041;Lakštingala;Aitvariukai;3113050690;Ne;2;0;0;2
5042;Lakštingala;Boružiukai;9795993812;Taip;4;7;0;11
5043;Lakštingala;Boružiukai;9004336424;Ne;0;15;0;15
5044;Lakštingala;Boružiukai;8820053026;Taip;0;1;0;1
5045;Lakštingala;Boružiukai;2072883878;Taip;0;0;7;7
5046;Lakštingala;Boružiukai;4811759034;Taip;0;4;2;6
5047;Lakštingala;Boružiukai;1898853302;Taip;0;4;1;5
5048;Lakštingala;Boružiukai;7443563000;Taip;0;0;7;7
5049;Lakštingala;Boružiukai;4818524423;Taip;15;3;1;19
5050;Lakštingala;Boružiukai;1444534032;Taip;0;2;0;2
5051;Lakštingala;Boružiukai;9724531753;Taip;0;5;0;5
5052;Lakštingala;Boružiukai;1783776913;Taip;0;1;0;1
5053;Lakštingala;Boružiukai;1106475925;Ne;0;0;2;2
5054;Lakštingala;Boružiukai;1667277983;Taip;0;2;0;2
5055;Lakštingala;Boružiukai;6947565845;Taip;0;4;0;4
5056;Lakštingala;Boružiukai;3009692491;Taip;8;0;0;8
5057;Lakštingala;Boružiukai;1800927281;Ne;5;5;0;10
5058;Lakštingala;Boružiukai;9998322501;Taip;4;2;5;11
5059;Lakštingala;Boružiukai;8284565948;Ne;13;9;0;22
5060;Lakštingala;Boružiukai;2423651716;Taip;0;1;0;1
5061;Lakštingala;Boružiukai;9445476887;Ne;4;2;0;6
5062;Lakštingala;Boružiukai;8899572475;Taip;3;3;3;9
5063;Lakštingala;Boružiukai;9492056071;Ne;4;3;0;7
5064;Lakštingala;Žiogeliai;5048686136;Taip;11;1;0;12
5065;Lakštingala;Žiogeliai;8404025659;Taip;10;0;12;22
5066;Lakštingala;Žiogeliai;4113993067;Ne;0;10;0;10
5067;Lakštingala;Žiogeliai;6981178960;Taip;13;1;2;16
5068;Lakštingala;Žiogeliai;3908175786;Taip;32;0;0;32
5069;Lakštingala;Žiogeliai;9860169528;Taip;9;0;1;10
5070;Lakštingala;Žiogeliai;4935753482;Taip;8;0;4;12
5071;Lakštingala;Žiogeliai;3439681068;Taip;3;0;1;4
5072;Lakštingala;Žiogeliai;3766986041;Taip;8;0;11;19
5073;Lakštingala;Žiogeliai;1974950823;Taip;9;0;1;10
5074;Lakštingala;Žiogeliai;6561743084;Taip;0;0;1;1
5075;Lakštingala;Žiogeliai;1226908540;Taip;0;0;15;15
5076;Lakštingala;Žiogeliai;3951057865;Taip;6;0;7;13
5077;Lakštingala;Žiogeliai;1494530289;Taip;18;0;0;18
5078;Lakštingala;Žiogeliai;7661973162;Taip;9;0;0;9
5079;Lakštingala;Žiogeliai;7104398627;Taip;6;3;0;9
5080;Lakštingala;Žiogeliai;7361353346;Taip;0;8;1;9
5081;Lakštingala;Žiogeliai;4790291839;Taip;9;1;0;10
5082;Lakštingala;Žiogeliai;8351970017;Taip;11;1;1;13
5083;Lakštingala;Žiogeliai;8333832673;Ne;6;3;0;9
5084;Lakštingala;Žiogeliai;6872095965;Taip;0;7;1;8
5085;Lakštingala;SPINDULIUKAI;4365413054;Taip;0;0;14;14
5086;Lakštingala;SPINDULIUKAI;9762500668;Taip;4;1;6;11
5087;Lakštingala;SPINDULIUKAI;7640007392;Taip;0;14;0;14
5088;Lakštingala;SPINDULIUKAI;4784677514;Taip;5;1;5;11
5089;Lakštingala;SPINDULIUKAI;1619201521;Taip;0;1;1;2
5090;Lakštingala;SPINDULIUKAI;2022621678;Taip;0;0;6;6
5091;Lakštingala;SPINDULIUKAI;8429523368;Taip;10;1;0;11
5092;Lakštingala;SPINDULIUKAI;6668075753;Taip;0;3;8;11
5093;Lakštingala;SPINDULIUKAI;9081653166;Taip;0;5;0;5
5094;Lakštingala;SPINDULIUKAI;6780591792;Taip;3;0;0;3
5095;Lakštingala;SPINDULIUKAI;4698879435;Taip;0;0;6;6
5096;Lakštingala;SPINDULIUKAI;8722490845;Taip;0;0;2;2
5097;Lakštingala;SPINDULIUKAI;1220858944;Taip;0;2;0;2
5098;Lakštingala;SPINDULIUKAI;3823860988;Taip;0;0;3;3
5099;Lakštingala;SPINDULIUKAI;7141840160;Taip;8;3;0;11
5100;Lakštingala;SPINDULIUKAI;3282771613;Taip;10;6;0;16
5101;Lakštingala;SPINDULIUKAI;2795341401;Taip;8;0;1;9
5102;Lakštingala;SPINDULIUKAI;5815240975;Taip;1;0;4;5
5103;Lakštingala;SPINDULIUKAI;9052256710;Taip;0;3;0;3
5104;Lakštingala;SPINDULIUKAI;1633544390;Taip;0;0;5;5
5105;Lakštingala;Pėledžiukai;3520592784;Taip;5;0;0;5
5106;Lakštingala;Pėledžiukai;5258588961;Taip;3;0;1;4
5107;Lakštingala;Pėledžiukai;6135103377;Taip;0;1;0;1
5108;Lakštingala;Pėledžiukai;4774354751;Ne;5;1;10;16
5109;Lakštingala;Pėledžiukai;3369263112;Taip;0;1;17;18
5110;Lakštingala;Pėledžiukai;8375506323;Ne;0;2;0;2
5111;Lakštingala;Pėledžiukai;2738882466;Taip;0;0;1;1
5112;Lakštingala;Pėledžiukai;8717764626;Taip;9;0;0;9
5113;Lakštingala;Pėledžiukai;8075192528;Taip;13;1;0;14
5114;Lakštingala;Pėledžiukai;3766779594;Ne;4;0;0;4
5115;Lakštingala;Pėledžiukai;4270513515;Taip;7;0;0;7
5116;Lakštingala;Pėledžiukai;2514377385;Taip;7;0;2;9
5117;Lakštingala;Pėledžiukai;6161860331;Taip;12;0;0;12
5118;Lakštingala;Pėledžiukai;6866935290;Taip;5;1;10;16
5119;Lakštingala;Pėledžiukai;8787118512;Ne;9;1;0;10
5120;Lakštingala;Pėledžiukai;6805882038;Ne;9;0;0;9
5121;Lakštingala;Pėledžiukai;7139669240;Taip;0;3;15;18
5122;Lakštingala;Pėledžiukai;9502994399;Taip;0;0;6;6
5123;Lakštingala;Pėledžiukai;9431022632;Taip;15;0;0;15
5124;Lakštingala;Pėledžiukai;9856189053;Taip;8;3;1;12
5125;Lakštingala;Pėledžiukai;5391954600;Taip;0;3;0;3
5126;Lakštingala;Pėledžiukai;4608719006;Ne;0;8;2;10
5127;Lakštingala;Katinėliai;8861428074;Taip;10;0;0;10
5128;Lakštingala;Katinėliai;2346497467;Taip;8;0;3;11
5129;Lakštingala;Katinėliai;9894103692;Taip;10;2;2;14
5130;Lakštingala;Katinėliai;8800538473;Taip;24;0;0;24
5131;Lakštingala;Katinėliai;9093654437;Ne;21;0;2;23
5132;Lakštingala;Katinėliai;6011421835;Taip;22;0;0;22
5133;Lakštingala;Katinėliai;2673030043;Taip;23;0;1;24
5134;Lakštingala;Katinėliai;2010478542;Taip;8;0;7;15
5135;Lakštingala;Katinėliai;1371422364;Taip;15;0;0;15
5136;Lakštingala;Katinėliai;6285766353;Taip;13;0;0;13
5137;Lakštingala;Katinėliai;3877448215;Taip;7;0;0;7
5138;Lakštingala;Katinėliai;6148942052;Taip;0;22;0;22
5139;Lakštingala;Katinėliai;7623917384;Taip;0;22;0;22
5140;Lakštingala;Katinėliai;1903292595;Taip;19;1;0;20
5141;Lakštingala;Katinėliai;6764453371;Taip;9;0;0;9
5142;Lakštingala;Katinėliai;4184814075;Taip;2;0;0;2
5143;Lakštingala;Deimantėliai;8310446552;Taip;22;0;0;22
5144;Lakštingala;Deimantėliai;8063735934;Taip;11;1;0;12
5145;Lakštingala;Deimantėliai;7396235662;Taip;9;1;1;11
5146;Lakštingala;Deimantėliai;3863174791;Ne;10;0;0;10
5147;Lakštingala;Deimantėliai;2969366008;Taip;18;0;0;18
5148;Lakštingala;Deimantėliai;9800669350;Taip;18;0;0;18
5149;Lakštingala;Deimantėliai;4725848201;Taip;13;0;0;13
5150;Lakštingala;Deimantėliai;6930466455;Taip;8;1;1;10
5151;Lakštingala;Deimantėliai;2165808562;Taip;0;0;18;18
5152;Lakštingala;Deimantėliai;3352073562;Ne;0;0;19;19
5153;Lakštingala;Deimantėliai;5539054769;Taip;9;1;0;10
5154;Lakštingala;Deimantėliai;8421786788;Taip;12;0;0;12
5155;Lakštingala;Deimantėliai;6974936332;Taip;19;1;0;20
5156;Lakštingala;Deimantėliai;8764728846;Taip;8;4;0;12
5157;Lakštingala;Deimantėliai;8663938939;Taip;17;0;0;17
5158;Lakštingala;Deimantėliai;5165517709;Taip;10;0;0;10
5159;Lakštingala;Deimantėliai;5965026791;Taip;22;0;0;22
5160;Lakštingala;KIŠKUČIAI;6520436055;Taip;4;9;1;14
5161;Lakštingala;KIŠKUČIAI;3208321841;Taip;3;1;8;12
5162;Lakštingala;KIŠKUČIAI;5464460112;Taip;5;1;1;7
5163;Lakštingala;KIŠKUČIAI;6970022417;Taip;9;0;1;10
5164;Lakštingala;KIŠKUČIAI;5730122965;Taip;9;5;2;16
5165;Lakštingala;KIŠKUČIAI;4140403601;Ne;8;0;1;9
5166;Lakštingala;KIŠKUČIAI;5119365443;Taip;12;0;1;13
5167;Lakštingala;KIŠKUČIAI;6689018476;Taip;17;0;0;17
5168;Lakštingala;KIŠKUČIAI;7017047366;Taip;4;0;5;9
5169;Lakštingala;KIŠKUČIAI;9539081376;Taip;0;0;18;18
5170;Lakštingala;KIŠKUČIAI;4854843534;Taip;13;0;0;13
5171;Lakštingala;KIŠKUČIAI;9162902701;Taip;0;0;21;21
5172;Lakštingala;KIŠKUČIAI;5455119187;Taip;8;0;0;8
5173;Lakštingala;KIŠKUČIAI;1113674539;Taip;9;1;1;11
5174;Lakštingala;KIŠKUČIAI;4370431439;Taip;8;1;4;13
5175;Lakštingala;KIŠKUČIAI;1898108870;Taip;22;0;0;22
5176;Lakštingala;KIŠKUČIAI;6652822827;Taip;3;0;0;3
5177;Lakštingala;KIŠKUČIAI;2998581623;Taip;24;1;3;28
5178;Lakštingala;KIŠKUČIAI;8414220381;Taip;6;1;3;10
5179;Lakštingala;KIŠKUČIAI;7817830649;Taip;0;11;6;17
5180;Lašelis;VIŠČIUKAI;6477439886;Taip;25;0;0;25
5181;Lašelis;VIŠČIUKAI;6912802425;Taip;14;0;0;14
5182;Lašelis;VIŠČIUKAI;6857428142;Taip;15;1;0;16
5183;Lašelis;VIŠČIUKAI;5759317067;Ne;13;2;0;15
5184;Lašelis;VIŠČIUKAI;9884946783;Taip;18;0;1;19
5185;Lašelis;VIŠČIUKAI;1367955273;Ne;0;17;0;17
5186;Lašelis;VIŠČIUKAI;2702582486;Taip;10;1;0;11
5187;Lašelis;VIŠČIUKAI;2824852871;Taip;14;4;0;18
5188;Lašelis;VIŠČIUKAI;1517104634;Taip;1;8;0;9
5189;Lašelis;VIŠČIUKAI;1294930990;Taip;4;4;0;8
5190;Lašelis;VIŠČIUKAI;9440665009;Ne;7;0;0;7
5191;Lašelis;VIŠČIUKAI;2121080776;Taip;18;0;0;18
5192;Lašelis;VIŠČIUKAI;3003679103;Taip;12;0;2;14
5193;Lašelis;VIŠČIUKAI;4427263877;Taip;12;0;5;17
5194;Lašelis;VIŠČIUKAI;1168408482;Taip;14;0;0;14
5195;Lašelis;VIŠČIUKAI;4748156580;Taip;13;0;5;18
5196;Lašelis;VIŠČIUKAI;4860925464;Ne;13;0;1;14
5197;Lašelis;ŠYPSENA;7137348151;Taip;0;0;3;3
5198;Lašelis;ŠYPSENA;1808067249;Ne;6;6;0;12
5199;Lašelis;ŠYPSENA;4933598046;Taip;8;0;9;17
5200;Lašelis;ŠYPSENA;1060784180;Taip;0;6;0;6
5201;Lašelis;ŠYPSENA;2509469243;Taip;15;1;1;17
5202;Lašelis;ŠYPSENA;4832223461;Taip;29;0;1;30
5203;Lašelis;ŠYPSENA;5416590600;Taip;14;1;1;16
5204;Lašelis;ŠYPSENA;1490179832;Ne;10;12;3;25
5205;Lašelis;ŠYPSENA;6836452490;Taip;8;0;3;11
5206;Lašelis;ŠYPSENA;1983312896;Taip;0;9;0;9
5207;Lašelis;ŠYPSENA;1279052767;Ne;9;3;0;12
5208;Lašelis;ŠYPSENA;8906479495;Taip;8;0;7;15
5209;Lašelis;ŠYPSENA;2593126568;Taip;16;0;4;20
5210;Lašelis;ŠYPSENA;3995905195;Taip;0;22;0;22
5211;Lašelis;ŠYPSENA;6137626795;Taip;11;0;0;11
5212;Lašelis;ŠYPSENA;1635921119;Ne;8;13;0;21
5213;Lašelis;ŠYPSENA;9664015801;Taip;6;4;0;10
5214;Lašelis;ŠYPSENA;2210915728;Ne;6;0;0;6
5215;Lašelis;ŠYPSENA;2306501498;Taip;9;0;0;9
5216;Lašelis;ŠYPSENA;2606193652;Ne;17;0;1;18
5217;Lašelis;ŠYPSENA;9434932943;Taip;11;6;0;17
5218;Lašelis;NYKŠTUKAI;4508779926;Taip;4;9;5;18
5219;Lašelis;NYKŠTUKAI;5931015581;Taip;11;0;0;11
5220;Lašelis;NYKŠTUKAI;1175045927;Ne;4;8;0;12
5221;Lašelis;NYKŠTUKAI;8132517365;Taip;3;6;0;9
5222;Lašelis;NYKŠTUKAI;1244168190;Taip;12;3;0;15
5223;Lašelis;NYKŠTUKAI;4566547120;Taip;0;5;0;5
5224;Lašelis;NYKŠTUKAI;1035888733;Taip;5;3;0;8
5225;Lašelis;NYKŠTUKAI;1926439959;Taip;8;3;4;15
5226;Lašelis;NYKŠTUKAI;8318512396;Taip;0;3;0;3
5227;Lašelis;NYKŠTUKAI;2886967297;Taip;0;4;0;4
5228;Lašelis;NYKŠTUKAI;3805049682;Taip;14;3;0;17
5229;Lašelis;NYKŠTUKAI;2401058384;Ne;8;2;0;10
5230;Lašelis;NYKŠTUKAI;1042560186;Taip;0;8;0;8
5231;Lašelis;NYKŠTUKAI;8814796010;Taip;8;3;0;11
5232;Lašelis;NYKŠTUKAI;2223293390;Taip;23;0;0;23
5233;Lašelis;NYKŠTUKAI;3675606390;Taip;0;22;0;22
5234;Lašelis;NYKŠTUKAI;9647340725;Ne;17;0;0;17
5235;Lašelis;SAULUTĖ;1460027521;Ne;1;0;0;1
5236;Lašelis;SAULUTĖ;3144718477;Taip;0;6;0;6
5237;Lašelis;SAULUTĖ;1777442316;Ne;0;8;0;8
5238;Lašelis;SAULUTĖ;7998812497;Ne;0;5;0;5
5239;Lašelis;SAULUTĖ;6669130831;Taip;0;0;1;1
5240;Lašelis;SAULUTĖ;7351939034;Taip;0;0;5;5
5241;Lašelis;SAULUTĖ;3239288878;Taip;10;1;1;12
5242;Lašelis;SAULUTĖ;6829438486;Taip;17;8;0;25
5243;Lašelis;SAULUTĖ;6080664872;Taip;4;5;3;12
5244;Lašelis;SAULUTĖ;2204859014;Taip;0;3;0;3
5245;Lašelis;SAULUTĖ;1515920896;Taip;0;0;1;1
5246;Lašelis;SAULUTĖ;1085400709;Taip;0;8;6;14
5247;Lašelis;SAULUTĖ;1646912457;Taip;5;2;0;7
5248;Lašelis;SAULUTĖ;1816377082;Ne;0;0;1;1
5249;Lašelis;SAULUTĖ;2034007263;Ne;8;0;2;10
5250;Lašelis;SAULUTĖ;3495676199;Taip;8;0;0;8
5251;Lašelis;SAULUTĖ;5731394231;Taip;3;5;2;10
5252;Lašelis;SAULUTĖ;1085950130;Taip;3;1;0;4
5253;Lašelis;BORUŽĖLĖS;1343964112;Taip;11;0;0;11
5254;Lašelis;BORUŽĖLĖS;7502668870;Taip;11;2;0;13
5255;Lašelis;BORUŽĖLĖS;1511922965;Taip;13;0;0;13
5256;Lašelis;BORUŽĖLĖS;5634517740;Ne;17;0;0;17
5257;Lašelis;BORUŽĖLĖS;7418586100;Taip;18;0;0;18
5258;Lašelis;BORUŽĖLĖS;1429188137;Taip;4;0;0;4
5259;Lašelis;BORUŽĖLĖS;8394290574;Taip;11;0;0;11
5260;Lašelis;BORUŽĖLĖS;7811809908;Taip;18;0;0;18
5261;Lašelis;BORUŽĖLĖS;4893073148;Taip;10;0;0;10
5262;Lašelis;BORUŽĖLĖS;4113842551;Taip;17;1;0;18
5263;Lašelis;BORUŽĖLĖS;1882188961;Ne;12;0;0;12
5264;Lašelis;BORUŽĖLĖS;6317716501;Taip;18;0;1;19
5265;Lašelis;BORUŽĖLĖS;8905080707;Taip;0;5;0;5
5266;Lašelis;BORUŽĖLĖS;2991487552;Taip;12;0;3;15
5267;Lašelis;BORUŽĖLĖS;2210081848;Taip;13;0;0;13
5268;Lašelis;BORUŽĖLĖS;1131591230;Taip;28;0;0;28
5269;Lašelis;BORUŽĖLĖS;4051058266;Taip;9;5;0;14
5270;Lašelis;BORUŽĖLĖS;7784416134;Taip;9;5;0;14
5271;Lašelis;SKRUZDELIUKAI;8212250478;Taip;6;6;0;12
5272;Lašelis;SKRUZDELIUKAI;8571325340;Taip;6;0;4;10
5273;Lašelis;SKRUZDELIUKAI;5000188106;Ne;6;6;0;12
5274;Lašelis;SKRUZDELIUKAI;6203027620;Taip;4;0;3;7
5275;Lašelis;SKRUZDELIUKAI;9954809499;Ne;13;0;0;13
5276;Lašelis;SKRUZDELIUKAI;6770694679;Ne;7;0;0;7
5277;Lašelis;SKRUZDELIUKAI;6158377421;Ne;0;9;0;9
5278;Lašelis;SKRUZDELIUKAI;3130271837;Taip;3;7;0;10
5279;Lašelis;SKRUZDELIUKAI;2871149756;Taip;22;0;0;22
5280;Lašelis;SKRUZDELIUKAI;7920615797;Ne;10;0;0;10
5281;Lašelis;SKRUZDELIUKAI;3146611814;Ne;0;8;0;8
5282;Lašelis;SKRUZDELIUKAI;7619426839;Ne;11;5;0;16
5283;Lašelis;SKRUZDELIUKAI;8718481664;Taip;14;1;0;15
5284;Lazdynėlis;BITUTĖS;4881322530;Taip;16;0;0;16
5285;Lazdynėlis;BITUTĖS;1748260780;Taip;9;10;0;19
5286;Lazdynėlis;BITUTĖS;4462819848;Taip;7;1;0;8
5287;Lazdynėlis;BITUTĖS;1574847460;Taip;10;0;0;10
5288;Lazdynėlis;BITUTĖS;5030400578;Taip;0;2;0;2
5289;Lazdynėlis;BITUTĖS;8159928299;Taip;5;0;3;8
5290;Lazdynėlis;BITUTĖS;9761942869;Taip;5;0;0;5
5291;Lazdynėlis;BITUTĖS;7911328294;Taip;0;0;5;5
5292;Lazdynėlis;BITUTĖS;1450181711;Taip;8;0;0;8
5293;Lazdynėlis;BITUTĖS;2044188250;Taip;8;0;1;9
5294;Lazdynėlis;BITUTĖS;4142277927;Taip;3;0;0;3
5295;Lazdynėlis;BITUTĖS;2032759165;Ne;7;0;0;7
5296;Lazdynėlis;BITUTĖS;2586187455;Taip;10;4;5;19
5297;Lazdynėlis;BITUTĖS;2013752858;Taip;0;12;5;17
5298;Lazdynėlis;BITUTĖS;4545757725;Taip;5;1;1;7
5299;Lazdynėlis;BITUTĖS;5562900372;Taip;0;22;0;22
5300;Lazdynėlis;BITUTĖS;3650483589;Ne;3;0;1;4
5301;Lazdynėlis;BITUTĖS;6963058612;Taip;8;0;0;8
5302;Lazdynėlis;BITUTĖS;6920441303;Taip;7;0;1;8
5303;Lazdynėlis;BITUTĖS;4153294595;Taip;5;2;0;7
5304;Lazdynėlis;BITUTĖS;7910561870;Taip;0;22;0;22
5305;Lazdynėlis;BITUTĖS;4809829190;Taip;0;0;3;3
5306;Lazdynėlis;EŽIUKAI;1039874409;Taip;0;1;1;2
5307;Lazdynėlis;EŽIUKAI;9362249595;Taip;5;1;0;6
5308;Lazdynėlis;EŽIUKAI;7135087818;Taip;8;1;3;12
5309;Lazdynėlis;EŽIUKAI;6814362584;Taip;8;1;4;13
5310;Lazdynėlis;EŽIUKAI;9219327706;Taip;0;3;1;4
5311;Lazdynėlis;EŽIUKAI;8229454863;Taip;10;0;0;10
5312;Lazdynėlis;EŽIUKAI;4747688220;Taip;11;0;0;11
5313;Lazdynėlis;EŽIUKAI;1312649234;Taip;0;1;2;3
5314;Lazdynėlis;EŽIUKAI;3097254722;Taip;0;1;2;3
5315;Lazdynėlis;EŽIUKAI;3040417651;Taip;11;0;0;11
5316;Lazdynėlis;EŽIUKAI;2354549025;Taip;1;0;0;1
5317;Lazdynėlis;EŽIUKAI;5407785006;Taip;0;0;2;2
5318;Lazdynėlis;EŽIUKAI;7208223612;Taip;0;1;5;6
5319;Lazdynėlis;EŽIUKAI;8627994583;Ne;0;22;0;22
5320;Lazdynėlis;EŽIUKAI;4293473176;Taip;6;1;0;7
5321;Lazdynėlis;EŽIUKAI;2723284353;Taip;4;1;2;7
5322;Lazdynėlis;EŽIUKAI;6008610525;Taip;18;1;0;19
5323;Lazdynėlis;EŽIUKAI;3879017767;Taip;10;0;0;10
5324;Lazdynėlis;EŽIUKAI;4031719765;Taip;0;12;0;12
5325;Lazdynėlis;BORUŽIUKAI;8337458289;Taip;0;22;0;22
5326;Lazdynėlis;BORUŽIUKAI;2592852361;Taip;12;15;0;27
5327;Lazdynėlis;BORUŽIUKAI;7692056055;Taip;15;1;0;16
5328;Lazdynėlis;BORUŽIUKAI;6394994841;Ne;15;0;0;15
5329;Lazdynėlis;BORUŽIUKAI;2009941344;Ne;15;3;0;18
5330;Lazdynėlis;BORUŽIUKAI;1653216959;Taip;4;1;0;5
5331;Lazdynėlis;BORUŽIUKAI;4190852647;Taip;18;0;0;18
5332;Lazdynėlis;BORUŽIUKAI;2058909635;Taip;9;2;0;11
5333;Lazdynėlis;BORUŽIUKAI;3105363578;Taip;0;22;0;22
5334;Lazdynėlis;BORUŽIUKAI;5622254334;Taip;22;0;0;22
5335;Lazdynėlis;BORUŽIUKAI;7587041613;Taip;13;1;0;14
5336;Lazdynėlis;BORUŽIUKAI;2380881303;Taip;17;0;0;17
5337;Lazdynėlis;BORUŽIUKAI;2632078843;Taip;19;3;0;22
5338;Lazdynėlis;BORUŽIUKAI;5756228709;Taip;9;0;0;9
5339;Lazdynėlis;BORUŽIUKAI;6824473598;Taip;0;1;0;1
5340;Lazdynėlis;BORUŽIUKAI;1707231039;Taip;0;22;0;22
5341;Lazdynėlis;BORUŽIUKAI;6413861274;Taip;9;0;0;9
5342;Lazdynėlis;BORUŽIUKAI;8030743153;Taip;7;0;0;7
5343;Lazdynėlis;BORUŽIUKAI;4642875037;Taip;3;6;0;9
5344;Lazdynėlis;BORUŽIUKAI;1722503577;Taip;5;1;0;6
5345;Lazdynėlis;BORUŽIUKAI;4595080695;Taip;4;18;0;22
5346;Lazdynėlis;BORUŽIUKAI;4958640516;Taip;0;22;0;22
5347;Lazdynėlis;BORUŽIUKAI;3351966091;Taip;0;22;0;22
5348;Lazdynėlis;BORUŽIUKAI;9548866880;Taip;7;0;0;7
5349;Lazdynėlis;KAČIUKAI;5888646355;Taip;5;2;0;7
5350;Lazdynėlis;KAČIUKAI;3678422730;Taip;0;0;4;4
5351;Lazdynėlis;KAČIUKAI;5708643953;Taip;0;3;0;3
5352;Lazdynėlis;KAČIUKAI;8295967906;Taip;3;1;2;6
5353;Lazdynėlis;KAČIUKAI;7076664657;Taip;6;2;0;8
5354;Lazdynėlis;KAČIUKAI;7864896721;Ne;6;0;0;6
5355;Lazdynėlis;KAČIUKAI;1424382629;Taip;10;1;0;11
5356;Lazdynėlis;KAČIUKAI;6787228086;Taip;0;0;6;6
5357;Lazdynėlis;KAČIUKAI;7313399153;Taip;5;1;0;6
5358;Lazdynėlis;KAČIUKAI;4842228703;Taip;3;0;2;5
5359;Lazdynėlis;KAČIUKAI;6542840562;Taip;5;1;0;6
5360;Lazdynėlis;KAČIUKAI;1265404063;Taip;9;0;0;9
5361;Lazdynėlis;KAČIUKAI;6086766393;Taip;10;0;0;10
5362;Lazdynėlis;KAČIUKAI;5301460250;Taip;0;0;1;1
5363;Lazdynėlis;KAČIUKAI;2958520599;Taip;0;0;1;1
5364;Lazdynėlis;KAČIUKAI;73057057862;Taip;13;3;0;16
5365;Lazdynėlis;KAČIUKAI;7455989945;Taip;0;2;5;7
5366;Lazdynėlis;KAČIUKAI;1817075429;Taip;13;1;0;14
5367;Lazdynėlis;KAČIUKAI;5030460904;Ne;0;1;0;1
5368;Lazdynėlis;KAČIUKAI;2164717183;Taip;0;3;5;8
5369;Lazdynėlis;KAČIUKAI;5504180016;Ne;0;7;0;7
5370;Lazdynėlis;KAČIUKAI;5031826548;Taip;0;4;5;9
5371;Lazdynėlis;KAČIUKAI;7237629135;Taip;6;3;3;12
5372;Lazdynėlis;KAČIUKAI;6657174602;Taip;8;3;2;13
5373;Lazdynėlis;VOVERIUKAI;6994408527;Taip;5;1;0;6
5374;Lazdynėlis;VOVERIUKAI;5051632567;Ne;11;0;0;11
5375;Lazdynėlis;VOVERIUKAI;6276697479;Taip;6;2;0;8
5376;Lazdynėlis;VOVERIUKAI;1335000592;Taip;4;1;0;5
5377;Lazdynėlis;VOVERIUKAI;2514035189;Taip;6;0;8;14
5378;Lazdynėlis;VOVERIUKAI;9477491360;Taip;0;6;0;6
5379;Lazdynėlis;VOVERIUKAI;5256157552;Ne;12;3;0;15
5380;Lazdynėlis;VOVERIUKAI;5889772626;Ne;0;1;0;1
5381;Lazdynėlis;VOVERIUKAI;6559543013;Taip;5;0;5;10
5382;Lazdynėlis;VOVERIUKAI;9231049001;Taip;4;0;0;4
5383;Lazdynėlis;VOVERIUKAI;9886856760;Taip;13;1;1;15
5384;Lazdynėlis;VOVERIUKAI;2998606948;Taip;4;0;0;4
5385;Lazdynėlis;VOVERIUKAI;6164180360;Taip;4;2;1;7
5386;Lazdynėlis;VOVERIUKAI;6415858184;Taip;0;0;13;13
5387;Lazdynėlis;VOVERIUKAI;5796381191;Ne;8;3;0;11
5388;Lazdynėlis;VOVERIUKAI;3062408541;Taip;10;4;0;14
5389;Lazdynėlis;VOVERIUKAI;5557752248;Taip;0;2;0;2
5390;Lazdynėlis;VOVERIUKAI;3779983775;Ne;16;0;0;16
5391;Lazdynėlis;VOVERIUKAI;4550819172;Taip;4;1;0;5
5392;Lazdynėlis;VOVERIUKAI;4771173060;Taip;18;0;0;18
5393;Lazdynėlis;VOVERIUKAI;8314002741;Taip;3;4;2;9
5394;Lazdynėlis;VOVERIUKAI;3365726271;Taip;14;2;0;16
5395;Lazdynėlis;VOVERIUKAI;1355954767;Taip;9;1;0;10
5396;Lazdynėlis;VOVERIUKAI;7941793866;Ne;0;6;2;8
5397;Lazdynėlis;RIEŠUTĖLIAI;3086059608;Ne;9;1;0;10
5398;Lazdynėlis;RIEŠUTĖLIAI;9693153118;Taip;7;1;0;8
5399;Lazdynėlis;RIEŠUTĖLIAI;6056618348;Taip;0;22;0;22
5400;Lazdynėlis;RIEŠUTĖLIAI;2478218103;Taip;6;1;0;7
5401;Lazdynėlis;RIEŠUTĖLIAI;5987500024;Taip;6;0;0;6
5402;Lazdynėlis;RIEŠUTĖLIAI;2453740823;Ne;15;2;0;17
5403;Lazdynėlis;RIEŠUTĖLIAI;4552505857;Taip;0;3;4;7
5404;Lazdynėlis;RIEŠUTĖLIAI;7545621720;Taip;10;0;0;10
5405;Lazdynėlis;RIEŠUTĖLIAI;9810842975;Taip;5;0;0;5
5406;Lazdynėlis;RIEŠUTĖLIAI;8179584161;Taip;0;1;7;8
5407;Lazdynėlis;RIEŠUTĖLIAI;3239107488;Ne;9;5;0;14
5408;Lazdynėlis;RIEŠUTĖLIAI;4055450300;Taip;9;1;0;10
5409;Lazdynėlis;RIEŠUTĖLIAI;8942906327;Taip;7;0;4;11
5410;Lazdynėlis;RIEŠUTĖLIAI;3362193379;Taip;0;4;5;9
5411;Lazdynėlis;RIEŠUTĖLIAI;9582702244;Taip;9;0;0;9
5412;Lazdynėlis;RIEŠUTĖLIAI;3062924645;Taip;0;1;3;4
5413;Lazdynėlis;RIEŠUTĖLIAI;3667994076;Taip;0;21;0;21
5414;Lazdynėlis;RIEŠUTĖLIAI;7523052754;Taip;0;5;1;6
5415;Lazdynėlis;RIEŠUTĖLIAI;1668899344;Taip;9;1;0;10
5416;Lazdynėlis;RIEŠUTĖLIAI;4092363029;Taip;10;0;0;10
5417;Lazdynėlis;RIEŠUTĖLIAI;3250913116;Ne;9;4;0;13
5418;Lazdynėlis;RIEŠUTĖLIAI;8529192130;Taip;6;3;0;9
5419;Lazdynėlis;RIEŠUTĖLIAI;7719697394;Ne;14;3;0;17
5420;Lazdynėlis;ANČIUKAI;9519409694;Taip;5;0;0;5
5421;Lazdynėlis;ANČIUKAI;2526260625;Taip;6;0;0;6
5422;Lazdynėlis;ANČIUKAI;8340712398;Taip;0;1;0;1
5423;Lazdynėlis;ANČIUKAI;6031442797;Taip;15;11;0;26
5424;Lazdynėlis;ANČIUKAI;7552873109;Taip;20;1;0;21
5425;Lazdynėlis;ANČIUKAI;7655218276;Taip;6;2;0;8
5426;Lazdynėlis;ANČIUKAI;7561833526;Taip;0;3;1;4
5427;Lazdynėlis;ANČIUKAI;6817162699;Taip;16;1;0;17
5428;Lazdynėlis;ANČIUKAI;2294873565;Taip;13;0;0;13
5429;Lazdynėlis;ANČIUKAI;1499729462;Taip;9;1;0;10
5430;Lazdynėlis;ANČIUKAI;4745610579;Taip;4;1;0;5
5431;Lazdynėlis;ANČIUKAI;2911152510;Taip;0;1;2;3
5432;Lazdynėlis;ANČIUKAI;2933025284;Taip;18;0;1;19
5433;Lazdynėlis;ANČIUKAI;5832624944;Taip;0;0;2;2
5434;Lazdynėlis;ANČIUKAI;1168433014;Taip;4;0;3;7
5435;Lazdynėlis;ANČIUKAI;3764854654;Ne;0;18;0;18
5436;Lazdynėlis;ANČIUKAI;1961540377;Taip;3;15;0;18
5437;Lazdynėlis;GUDRUČIAI;4928593615;Taip;0;1;5;6
5438;Lazdynėlis;GUDRUČIAI;6684940385;Taip;4;3;0;7
5439;Lazdynėlis;GUDRUČIAI;9187681789;Ne;0;0;1;1
5440;Lazdynėlis;GUDRUČIAI;6307407620;Taip;3;1;0;4
5441;Lazdynėlis;GUDRUČIAI;158059657;Taip;0;0;3;3
5442;Lazdynėlis;GUDRUČIAI;2587142646;Taip;6;0;2;8
5443;Lazdynėlis;GUDRUČIAI;3902772678;Taip;0;3;0;3
5444;Lazdynėlis;GUDRUČIAI;8822378464;Taip;10;0;0;10
5445;Lazdynėlis;GUDRUČIAI;2603427970;Taip;0;22;0;22
5446;Lazdynėlis;GUDRUČIAI;7965433882;Taip;0;1;0;1
5447;Lazdynėlis;GUDRUČIAI;6863715428;Taip;0;2;3;5
5448;Lazdynėlis;GUDRUČIAI;4779025603;Taip;0;1;10;11
5449;Lazdynėlis;GUDRUČIAI;44510351979;Taip;0;1;1;2
5450;Lazdynėlis;GUDRUČIAI;3043350186;Taip;0;1;0;1
5451;Lazdynėlis;GUDRUČIAI;5182241318;Taip;0;1;2;3
5452;Lazdynėlis;GUDRUČIAI;8008332680;Ne;0;1;2;3
5453;Lazdynėlis;MEŠKIUKAI;4094713096;Taip;0;14;2;16
5454;Lazdynėlis;MEŠKIUKAI;4267469349;Taip;6;0;2;8
5455;Lazdynėlis;MEŠKIUKAI;5354852979;Taip;0;22;0;22
5456;Lazdynėlis;MEŠKIUKAI;3427972329;Taip;3;0;0;3
5457;Lazdynėlis;MEŠKIUKAI;6941986839;Taip;0;0;4;4
5458;Lazdynėlis;MEŠKIUKAI;3697808826;Taip;8;0;4;12
5459;Lazdynėlis;MEŠKIUKAI;2812633983;Taip;0;0;2;2
5460;Lazdynėlis;MEŠKIUKAI;9590507486;Taip;14;0;1;15
5461;Lazdynėlis;MEŠKIUKAI;1488371861;Taip;8;0;0;8
5462;Lazdynėlis;MEŠKIUKAI;5982766841;Taip;0;22;0;22
5463;Lazdynėlis;MEŠKIUKAI;1984546310;Taip;0;18;0;18
5464;Lazdynėlis;MEŠKIUKAI;4408660083;Taip;0;22;0;22
5465;Lazdynėlis;MEŠKIUKAI;9930553716;Ne;9;0;0;9
5466;Lazdynėlis;MEŠKIUKAI;6831456807;Taip;13;0;0;13
5467;Lazdynėlis;MEŠKIUKAI;4795464133;Ne;0;1;0;1
5468;Lazdynėlis;MEŠKIUKAI;8567304224;Taip;13;0;0;13
5469;Lazdynėlis;MEŠKIUKAI;4366502064;Taip;10;3;0;13
5470;Lazdynėlis;MEŠKIUKAI;1331380925;Taip;0;22;0;22
5471;Liepsnelė;Ramunėlės;6566895135;Taip;8;0;0;8
5472;Liepsnelė;Ramunėlės;6993441738;Taip;6;0;0;6
5473;Liepsnelė;Ramunėlės;6294010142;Taip;22;0;0;22
5474;Liepsnelė;Ramunėlės;2522846125;Taip;11;0;0;11
5475;Liepsnelė;Ramunėlės;5037883064;Taip;4;0;0;4
5476;Liepsnelė;Ramunėlės;8260124614;Taip;6;0;0;6
5477;Liepsnelė;Ramunėlės;9389749006;Taip;3;0;0;3
5478;Liepsnelė;Ramunėlės;3467086136;Taip;5;0;0;5
5479;Liepsnelė;Ramunėlės;5448328929;Taip;7;0;0;7
5480;Liepsnelė;Ramunėlės;9350715010;Taip;17;0;0;17
5481;Liepsnelė;Ramunėlės;1214516126;Taip;13;0;0;13
5482;Liepsnelė;Ramunėlės;3982153133;Taip;8;0;0;8
5483;Liepsnelė;Zuikučiai;2968672487;Ne;11;0;0;11
5484;Liepsnelė;Zuikučiai;4798353152;Taip;10;0;0;10
5485;Liepsnelė;Zuikučiai;8082265078;Taip;9;0;0;9
5486;Liepsnelė;Zuikučiai;1132758499;Taip;8;0;0;8
5487;Liepsnelė;Zuikučiai;9463386166;Taip;13;0;0;13
5488;Liepsnelė;Zuikučiai;3774949481;Taip;12;0;0;12
5489;Liepsnelė;Nykštukai;2495718547;Ne;5;0;0;5
5490;Liepsnelė;Nykštukai;3654667879;Taip;9;0;0;9
5491;Liepsnelė;Nykštukai;9993335478;Taip;18;0;0;18
5492;Liepsnelė;Nykštukai;6417648753;Taip;5;0;0;5
5493;Liepsnelė;Nykštukai;4088586188;Taip;10;0;0;10
5494;Liepsnelė;Nykštukai;8189699392;Ne;23;0;0;23
5495;Liepsnelė;Nykštukai;5909672361;Ne;16;0;0;16
5496;Liepsnelė;Nykštukai;3484222564;Taip;20;0;0;20
5497;Liepsnelė;Nykštukai;1554586649;Taip;6;0;0;6
5498;Liepsnelė;Žvirbliukai;5682528849;Taip;9;0;0;9
5499;Liepsnelė;Žvirbliukai;7385890984;Ne;5;0;0;5
5500;Liepsnelė;Žvirbliukai;8080492986;Taip;19;0;0;19
5501;Liepsnelė;Žvirbliukai;7735063486;Taip;22;0;0;22
5502;Liepsnelė;Žvirbliukai;4234425668;Taip;10;0;0;10
5503;Liepsnelė;Žvirbliukai;4852738818;Taip;16;0;0;16
5504;Liepsnelė;Žvirbliukai;7555183487;Taip;10;0;0;10
5505;Liepsnelė;Žvirbliukai;1625321820;Taip;8;0;0;8
5506;Liepsnelė;Žvirbliukai;3382354753;Taip;22;0;0;22
5507;Liepsnelė;Žvirbliukai;2080374597;Ne;10;0;0;10
5508;Liepsnelė;Meškiukai;4171233039;Taip;4;0;0;4
5509;Liepsnelė;Meškiukai;4211555762;Taip;6;0;0;6
5510;Liepsnelė;Meškiukai;5875960368;Taip;20;0;0;20
5511;Liepsnelė;Meškiukai;5138923652;Taip;10;0;0;10
5512;Liepsnelė;Meškiukai;8357286679;Taip;8;0;0;8
5513;Liepsnelė;Meškiukai;8427041924;Ne;10;0;0;10
5514;Liepsnelė;Meškiukai;8445080480;Taip;5;0;0;5
5515;Liepsnelė;Meškiukai;7007685622;Taip;21;0;0;21
5516;Liepsnelė;Meškiukai;1860301365;Taip;22;0;0;22
5517;Liepsnelė;Meškiukai;7925446594;Taip;6;0;0;6
5518;Liepsnelė;Meškiukai;3138135710;Taip;5;0;0;5
5519;Liepsnelė;Meškiukai;4080298620;Taip;14;0;0;14
5520;Liepsnelė;Meškiukai;6568963048;Taip;7;0;0;7
5521;Liepsnelė;Meškiukai;4850013650;Taip;5;0;0;5
5522;Liepsnelė;SAULUTĖ;1055874233;Taip;7;0;0;7
5523;Liepsnelė;SAULUTĖ;7853574888;Taip;10;0;0;10
5524;Liepsnelė;SAULUTĖ;9864646484;Taip;18;0;0;18
5525;Liepsnelė;SAULUTĖ;9086156869;Ne;1;0;0;1
5526;Liepsnelė;SAULUTĖ;7650975542;Taip;12;0;0;12
5527;Liepsnelė;SAULUTĖ;8598242099;Taip;7;0;0;7
5528;Liepsnelė;Varpeliai;5083693582;Taip;12;0;0;12
5529;Liepsnelė;Varpeliai;1487219062;Taip;19;0;0;19
5530;Liepsnelė;Varpeliai;1360169458;Taip;15;0;0;15
5531;Liepsnelė;Varpeliai;7241069517;Taip;3;0;0;3
5532;Liepsnelė;"NAUJA NYKŠTUKAI";9963290362;Ne;8;0;0;8
5533;Liepsnelė;"NAUJA NYKŠTUKAI";1924079984;Taip;3;0;0;3
5534;Liepsnelė;"NAUJA NYKŠTUKAI";1620856143;Ne;10;0;0;10
5535;"Lokiuko giraitė";Bitutės;4804487551;Taip;15;0;0;15
5536;"Lokiuko giraitė";Bitutės;5548132297;Ne;22;0;0;22
5537;"Lokiuko giraitė";Bitutės;6834477708;Ne;18;0;0;18
5538;"Lokiuko giraitė";Geniukų;6095929896;Taip;14;0;0;14
5539;"Lokiuko giraitė";Geniukų;3295296911;Taip;11;0;0;11
5540;"Lokiuko giraitė";Geniukų;6762124292;Ne;8;0;0;8
5541;"Lokiuko giraitė";Geniukų;9035040416;Taip;10;0;0;10
5542;"Lokiuko giraitė";Geniukų;6544942054;Taip;19;0;0;19
5543;"Lokiuko giraitė";Drugelių;9228196983;Taip;17;0;0;17
5544;"Lokiuko giraitė";Drugelių;5268222221;Taip;5;0;0;5
5545;"Lokiuko giraitė";Drugelių;5529404234;Taip;5;0;0;5
5546;"Lokiuko giraitė";Drugelių;8091538511;Taip;13;0;0;13
5547;"Lokiuko giraitė";Gandriukų;5287134614;Taip;11;0;0;11
5548;"Lokiuko giraitė";Gandriukų;3862009155;Taip;10;0;0;10
5549;"Lokiuko giraitė";Gandriukų;9589770383;Taip;6;0;0;6
5550;"Lokiuko giraitė";Gandriukų;3773650976;Taip;3;0;0;3
5551;"Lokiuko giraitė";Gandriukų;9951647177;Taip;4;0;0;4
5552;"Lokiuko giraitė";Gandriukų;3692414822;Taip;12;0;0;12
5553;"Lokiuko giraitė";Gandriukų;5672634750;Taip;10;0;0;10
5554;"Lokiuko giraitė";Gandriukų;2027726779;Taip;10;0;0;10
5555;"Lokiuko giraitė";Gandriukų;3050198522;Taip;10;0;0;10
5556;"Lokiuko giraitė";Žiogelių;3716890704;Taip;5;0;0;5
5557;"Lokiuko giraitė";Žiogelių;2577866452;Taip;9;0;0;9
5558;"Lokiuko giraitė";Žiogelių;1281994869;Taip;10;0;0;10
5559;"Lokiuko giraitė";Peliukų;5323186441;Taip;4;0;0;4
5560;"Lokiuko giraitė";Peliukų;8141761199;Taip;10;0;0;10
5561;"Lokiuko giraitė";Žvirbliukai;1993739216;Taip;15;0;0;15
5562;"Lokiuko giraitė";Voveriukų;9445369270;Taip;10;0;0;10
5563;"Lokiuko giraitė";Voveriukų;8074894811;Taip;12;0;0;12
5564;"Lokiuko giraitė";Voveriukų;4550595516;Taip;6;0;0;6
5565;"Lokiuko giraitė";Voveriukų;9054344922;Taip;15;0;0;15
5566;"Lokiuko giraitė";Voveriukų;1409081793;Taip;11;0;0;11
5567;"Lokiuko giraitė";PELĖDŽIUKŲ;3994376859;Ne;10;0;0;10
5568;"Lokiuko giraitė";PELĖDŽIUKŲ;8987725075;Taip;30;0;0;30
5569;"Lokiuko giraitė";PELĖDŽIUKŲ;5470393268;Taip;15;0;0;15
5570;"Lokiuko giraitė";PELĖDŽIUKŲ;8657413379;Taip;20;0;0;20
5571;"Lokiuko giraitė";KIŠKUČIŲ;6290161180;Taip;15;0;0;15
5572;"Lokiuko giraitė";KIŠKUČIŲ;2397347368;Taip;7;0;0;7
5573;"Lokiuko giraitė";KIŠKUČIŲ;7009062808;Taip;8;0;0;8
5574;"Lokiuko giraitė";KIŠKUČIŲ;3639606607;Taip;5;0;0;5
5575;"Lokiuko giraitė";KIŠKUČIŲ;9258315961;Taip;21;0;0;21
5576;"Lokiuko giraitė";KIŠKUČIŲ;5831978563;Taip;6;0;0;6
5577;"Lokiuko giraitė";KIŠKUČIŲ;1524540555;Taip;6;0;0;6
5578;"Lokiuko giraitė";KIŠKUČIŲ;3554824146;Taip;6;0;0;6
5579;"Lokiuko giraitė";BORUŽĖLIŲ;4090198854;Taip;9;0;0;9
5580;"Lokiuko giraitė";BORUŽĖLIŲ;1467027124;Taip;5;0;0;5
5581;"Lokiuko giraitė";BORUŽĖLIŲ;3704421499;Taip;5;0;0;5
5582;"Lokiuko giraitė";BORUŽĖLIŲ;5859480264;Taip;10;0;0;10
5583;"Lokiuko giraitė";BORUŽĖLIŲ;5496859463;Taip;10;0;0;10
5584;"Lokiuko giraitė";BORUŽĖLIŲ;4546969048;Taip;10;0;0;10
5585;"Lokiuko giraitė";BORUŽĖLIŲ;1480506168;Ne;3;0;0;3
5586;"Lokiuko giraitė";BORUŽĖLIŲ;3670756949;Taip;16;0;0;16
5587;"Lokiuko giraitė";BORUŽĖLIŲ;2908267390;Ne;5;0;0;5
5588;"Lokiuko giraitė";EŽIUKŲ;1477397504;Taip;18;0;0;18
5589;"Lokiuko giraitė";EŽIUKŲ;8075543297;Taip;10;0;0;10
5590;"Lokiuko giraitė";EŽIUKŲ;7003220350;Taip;6;0;0;6
5591;"Lokiuko giraitė";EŽIUKŲ;2120529003;Taip;12;0;0;12
5592;"Lokiuko giraitė";EŽIUKŲ;3948450076;Ne;6;0;0;6
5593;"Lokiuko giraitė";EŽIUKŲ;5528253378;Taip;14;0;0;14
5594;"Lokiuko giraitė";EŽIUKŲ;4719679127;Taip;26;0;0;26
5595;Markučiai;Žirniukų;3525681034;Taip;11;4;3;18
5596;Markučiai;Žirniukų;7312533881;Taip;11;4;4;19
5597;Markučiai;Žirniukų;8679791696;Taip;6;0;7;13
5598;Markučiai;Žirniukų;5269411010;Taip;18;0;0;18
5599;Markučiai;Žirniukų;5250815223;Taip;5;0;1;6
5600;Markučiai;Žirniukų;8934965409;Taip;6;1;2;9
5601;Markučiai;Žirniukų;8360526946;Taip;10;12;1;23
5602;Markučiai;Žirniukų;7244815252;Taip;7;0;0;7
5603;Markučiai;Žirniukų;2096169972;Taip;6;0;11;17
5604;Markučiai;Žirniukų;3073404128;Taip;10;2;0;12
5605;Markučiai;Žirniukų;6674351628;Ne;9;0;0;9
5606;Markučiai;Žirniukų;5614488534;Ne;7;6;1;14
5607;Markučiai;Žirniukų;2367999201;Ne;8;0;14;22
5608;Markučiai;Žirniukų;4242575616;Taip;3;1;4;8
5609;Markučiai;Žirniukų;4223653505;Taip;0;0;12;12
5610;Markučiai;Žirniukų;2099285475;Taip;12;1;12;25
5611;Markučiai;Žirniukų;2344252204;Ne;20;1;7;28
5612;Markučiai;Žirniukų;9576412366;Taip;16;0;0;16
5613;Markučiai;Žirniukų;1395241501;Taip;15;0;5;20
5614;Markučiai;Žirniukų;2526619144;Taip;5;0;0;5
5615;Markučiai;Nykštukų;7507551844;Taip;0;2;2;4
5616;Markučiai;Nykštukų;9545967631;Taip;0;1;0;1
5617;Markučiai;Nykštukų;6121911851;Taip;0;0;3;3
5618;Markučiai;Nykštukų;6898055631;Ne;5;1;3;9
5619;Markučiai;Nykštukų;3378749042;Taip;0;1;3;4
5620;Markučiai;Nykštukų;1884388847;Taip;0;1;0;1
5621;Markučiai;Nykštukų;4485929800;Taip;0;0;2;2
5622;Markučiai;Nykštukų;5183244346;Taip;0;4;0;4
5623;Markučiai;Nykštukų;7624913025;Taip;9;9;0;18
5624;Markučiai;Nykštukų;4679710493;Taip;4;5;1;10
5625;Markučiai;Nykštukų;2994895532;Taip;13;1;1;15
5626;Markučiai;Nykštukų;4846899377;Taip;0;0;3;3
5627;Markučiai;Nykštukų;4150956779;Taip;0;1;0;1
5628;Markučiai;Nykštukų;4920107818;Taip;0;10;0;10
5629;Markučiai;Nykštukų;7680126946;Taip;0;0;4;4
5630;Markučiai;Nykštukų;4222017733;Taip;3;0;0;3
5631;Markučiai;Nykštukų;3414015064;Ne;2;0;0;2
5632;Markučiai;Nykštukų;7642401516;Taip;3;0;3;6
5633;Markučiai;Nykštukų;8055783293;Ne;11;0;5;16
5634;Markučiai;Pelėdžiukų;9180404247;Ne;5;3;0;8
5635;Markučiai;Pelėdžiukų;3386071459;Taip;10;2;1;13
5636;Markučiai;Pelėdžiukų;4653663237;Taip;18;0;0;18
5637;Markučiai;Pelėdžiukų;5727655114;Taip;5;2;0;7
5638;Markučiai;Pelėdžiukų;6740434675;Taip;5;0;4;9
5639;Markučiai;Pelėdžiukų;6707310242;Taip;14;0;2;16
5640;Markučiai;Pelėdžiukų;7947287013;Taip;15;1;0;16
5641;Markučiai;Pelėdžiukų;2543313198;Taip;10;1;1;12
5642;Markučiai;Pelėdžiukų;4418580273;Taip;0;0;2;2
5643;Markučiai;Pelėdžiukų;5522654429;Taip;15;1;3;19
5644;Markučiai;Pelėdžiukų;9219710045;Ne;4;0;0;4
5645;Markučiai;Pelėdžiukų;7539605426;Taip;10;0;0;10
5646;Markučiai;Pelėdžiukų;8888538915;Taip;27;0;1;28
5647;Markučiai;Pelėdžiukų;1623728091;Taip;0;0;3;3
5648;Markučiai;Pelėdžiukų;1799946177;Taip;9;0;0;9
5649;Markučiai;Pelėdžiukų;7809719827;Ne;6;0;0;6
5650;Markučiai;Pelėdžiukų;4860961508;Taip;7;1;2;10
5651;Markučiai;Pelėdžiukų;6260010822;Taip;4;13;0;17
5652;Markučiai;Pelėdžiukų;6569807889;Taip;12;3;0;15
5653;Markučiai;Boružėlių;1171899107;Taip;0;3;0;3
5654;Markučiai;Boružėlių;8078777204;Ne;0;3;5;8
5655;Markučiai;Boružėlių;8244065962;Taip;0;2;10;12
5656;Markučiai;Boružėlių;5902165968;Taip;8;0;1;9
5657;Markučiai;Boružėlių;5981692282;Taip;5;7;0;12
5658;Markučiai;Boružėlių;3739566642;Taip;18;2;0;20
5659;Markučiai;Boružėlių;6868394315;Taip;0;3;0;3
5660;Markučiai;Boružėlių;7634475536;Ne;5;0;5;10
5661;Markučiai;Boružėlių;5663147778;Taip;0;1;7;8
5662;Markučiai;Boružėlių;8271830626;Taip;9;1;1;11
5663;Markučiai;Boružėlių;8046320044;Ne;14;0;3;17
5664;Markučiai;Boružėlių;3315824027;Taip;0;11;13;24
5665;Markučiai;Boružėlių;2060024771;Taip;3;0;13;16
5666;Markučiai;Boružėlių;2539486337;Taip;5;6;0;11
5667;Markučiai;Boružėlių;5562960498;Ne;5;2;6;13
5668;Markučiai;Boružėlių;3296423510;Taip;0;3;6;9
5669;Markučiai;Bitučių;1720541082;Taip;6;0;0;6
5670;Markučiai;Bitučių;8792524832;Taip;3;5;0;8
5671;Markučiai;Bitučių;9518247571;Taip;6;1;8;15
5672;Markučiai;Bitučių;4836298058;Ne;5;0;4;9
5673;Markučiai;Bitučių;9027071539;Taip;9;1;0;10
5674;Markučiai;Bitučių;8748794886;Taip;13;0;1;14
5675;Markučiai;Bitučių;7387460586;Taip;0;1;0;1
5676;Markučiai;Bitučių;8950442843;Taip;17;0;3;20
5677;Markučiai;Bitučių;2840564082;Taip;0;2;0;2
5678;Markučiai;Bitučių;3926993383;Taip;0;6;4;10
5679;Markučiai;Bitučių;6530101961;Taip;12;0;3;15
5680;Markučiai;Bitučių;1908302738;Taip;4;6;11;21
5681;Markučiai;Bitučių;7056367646;Taip;15;1;2;18
5682;Markučiai;Bitučių;2049497686;Taip;0;6;2;8
5683;Markučiai;Bitučių;8541042547;Taip;0;0;7;7
5684;Markučiai;Bitučių;1447116821;Taip;0;0;7;7
5685;Markučiai;Bitučių;2931958829;Taip;0;3;8;11
5686;Markučiai;Drugelių;2288910885;Taip;0;0;8;8
5687;Markučiai;Drugelių;3544565354;Taip;5;0;3;8
5688;Markučiai;Drugelių;6992161129;Taip;3;0;3;6
5689;Markučiai;Drugelių;5024860112;Taip;0;1;8;9
5690;Markučiai;Drugelių;9412129807;Taip;5;7;2;14
5691;Markučiai;Drugelių;6979218594;Taip;9;0;4;13
5692;Markučiai;Drugelių;3491734422;Taip;0;0;10;10
5693;Markučiai;Drugelių;3491734422;Taip;0;0;10;10
5694;Markučiai;Drugelių;3491734422;Taip;0;0;10;10
5695;Markučiai;Drugelių;3832641521;Taip;0;0;2;2
5696;Markučiai;Drugelių;4520724770;Taip;16;0;4;20
5697;Markučiai;Drugelių;8050852518;Ne;0;0;1;1
5698;Markučiai;Drugelių;9391866085;Taip;0;15;11;26
5699;Markučiai;Drugelių;9073616238;Taip;0;0;1;1
5700;Markučiai;Drugelių;4918717178;Taip;18;0;3;21
5701;Markučiai;Drugelių;2967726802;Ne;13;0;8;21
5702;Markučiai;Drugelių;6684544229;Ne;4;0;8;12
5703;Markučiai;Drugelių;3487571241;Taip;5;0;0;5
5704;Markučiai;Skruzdėliukų;5566529492;Taip;5;3;1;9
5705;Markučiai;Skruzdėliukų;8105747904;Ne;0;7;3;10
5706;Markučiai;Skruzdėliukų;6617799980;Taip;0;11;0;11
5707;Markučiai;Skruzdėliukų;4369408254;Taip;7;0;2;9
5708;Markučiai;Skruzdėliukų;7580249913;Taip;14;0;1;15
5709;Markučiai;Skruzdėliukų;2246646548;Taip;27;0;0;27
5710;Markučiai;Skruzdėliukų;9921530582;Taip;8;0;1;9
5711;Markučiai;Skruzdėliukų;6759427415;Taip;6;0;0;6
5712;Markučiai;Skruzdėliukų;4820576711;Taip;24;0;0;24
5713;Markučiai;Skruzdėliukų;1527620947;Taip;2;20;0;22
5714;Markučiai;Skruzdėliukų;8774323234;Taip;4;0;0;4
5715;Markučiai;Skruzdėliukų;7881183912;Taip;15;0;0;15
5716;Markučiai;Skruzdėliukų;9338996275;Taip;17;0;0;17
5717;Markučiai;Skruzdėliukų;5180034556;Taip;3;0;0;3
5718;Markučiai;Skruzdėliukų;4383128686;Taip;8;0;1;9
5719;Markučiai;ZUIKUČIŲ;82320812575;Taip;0;1;0;1
5720;Markučiai;ZUIKUČIŲ;4861535057;Taip;0;2;0;2
5721;Markučiai;ZUIKUČIŲ;11751635395;Taip;0;8;0;8
5722;Markučiai;ZUIKUČIŲ;1184908076;Taip;0;1;4;5
5723;Markučiai;ZUIKUČIŲ;7729045227;Taip;18;1;0;19
5724;Markučiai;ZUIKUČIŲ;8061880631;Taip;0;1;0;1
5725;Markučiai;ZUIKUČIŲ;1392582514;Taip;0;7;0;7
5726;Markučiai;ZUIKUČIŲ;7691410556;Taip;10;6;0;16
5727;Markučiai;ZUIKUČIŲ;6453095915;Taip;0;1;0;1
5728;Markučiai;ZUIKUČIŲ;6808291628;Taip;0;10;0;10
5729;Markučiai;ZUIKUČIŲ;5387571295;Taip;0;1;2;3
5730;Markučiai;ZUIKUČIŲ;3794643964;Taip;8;3;0;11
5731;Markučiai;ZUIKUČIŲ;91228262895;Taip;18;1;2;21
5732;Markučiai;ZUIKUČIŲ;5749873170;Taip;0;1;1;2
5733;Markučiai;ZUIKUČIŲ;8605357678;Taip;0;1;0;1
5734;Markučiai;ZUIKUČIŲ;6055058096;Taip;1;2;0;3
5735;Markučiai;ZUIKUČIŲ;1956224017;Taip;0;0;6;6
5736;Markučiai;ŽIOGELIŲ;3163226803;Taip;18;1;0;19
5737;Markučiai;ŽIOGELIŲ;1244026489;Taip;0;7;0;7
5738;Markučiai;ŽIOGELIŲ;76025616287;Ne;0;11;0;11
5739;Markučiai;ŽIOGELIŲ;54892037118;Taip;0;2;5;7
5740;Markučiai;ŽIOGELIŲ;1054802708;Taip;0;0;2;2
5741;Markučiai;ŽIOGELIŲ;67074776419;Taip;0;1;0;1
5742;Markučiai;ŽIOGELIŲ;1007919702;Taip;0;6;0;6
5743;Markučiai;ŽIOGELIŲ;1923521405;Taip;0;10;0;10
5744;Markučiai;ŽIOGELIŲ;1164386108;Taip;0;10;0;10
5745;Markučiai;ŽIOGELIŲ;7850311496;Ne;0;5;0;5
5746;Markučiai;ŽIOGELIŲ;2169583290;Ne;0;6;0;6
5747;Markučiai;ŽIOGELIŲ;3340385503;Ne;16;5;2;23
5748;Markučiai;ŽIOGELIŲ;23267867195;Taip;11;0;0;11
5749;Markučiai;ŽIOGELIŲ;7481923902;Taip;0;2;1;3
5750;Markučiai;ŽIOGELIŲ;4324776209;Ne;0;1;2;3
5751;Markučiai;Ežiukių;1827829954;Taip;6;5;0;11
5752;Markučiai;Ežiukių;4925856706;Taip;0;9;0;9
5753;Markučiai;Ežiukių;6570638672;Taip;0;10;0;10
5754;Markučiai;Ežiukių;5975331223;Ne;0;8;0;8
5755;Markučiai;Ežiukių;2687320408;Taip;4;3;1;8
5756;Markučiai;Ežiukių;8990923872;Taip;0;19;0;19
5757;Markučiai;Ežiukių;5246980173;Taip;7;0;0;7
5758;Markučiai;Ežiukių;6308368050;Taip;11;1;1;13
5759;Markučiai;Ežiukių;4249158803;Taip;7;1;1;9
5760;Markučiai;Ežiukių;5958705106;Taip;5;11;2;18
5761;Markučiai;Ežiukių;1769984489;Taip;0;1;0;1
5762;Markučiai;Ežiukių;7791500322;Taip;0;1;6;7
5763;Markučiai;Ežiukių;9059302464;Taip;9;1;1;11
5764;Markučiai;Ežiukių;2962530721;Taip;0;3;0;3
5765;Markučiai;Ežiukių;6574037877;Taip;5;0;1;6
5766;Markučiai;Ežiukių;5752762229;Taip;0;1;0;1
5767;Markučiai;Ežiukių;4383421917;Taip;0;4;1;5
5768;Markučiai;Ežiukių;9789274040;Ne;0;14;0;14
5769;Mažylis;"4 PRIEŠMOKYKLINĖ GR.";9411559447;Taip;5;0;12;17
5770;Mažylis;"4 PRIEŠMOKYKLINĖ GR.";4503734408;Taip;5;0;12;17
5771;Mažylis;"4 PRIEŠMOKYKLINĖ GR.";8352202912;Taip;0;0;1;1
5772;Mažylis;"4 PRIEŠMOKYKLINĖ GR.";38277640135;Taip;8;1;1;10
5773;Mažylis;"4 PRIEŠMOKYKLINĖ GR.";1663347167;Taip;10;2;4;16
5774;Mažylis;"4 PRIEŠMOKYKLINĖ GR.";6854350717;Taip;0;0;16;16
5775;Mažylis;"4 PRIEŠMOKYKLINĖ GR.";6920129837;Taip;10;0;1;11
5776;Mažylis;"4 PRIEŠMOKYKLINĖ GR.";4104052524;Ne;14;0;4;18
5777;Mažylis;"4 PRIEŠMOKYKLINĖ GR.";1460572347;Taip;0;0;8;8
5778;Mažylis;"4 PRIEŠMOKYKLINĖ GR.";3860760654;Taip;0;0;6;6
5779;Mažylis;"4 PRIEŠMOKYKLINĖ GR.";7185347381;Taip;5;0;1;6
5780;Mažylis;"4 PRIEŠMOKYKLINĖ GR.";3344476309;Taip;0;0;7;7
5781;Mažylis;"4 PRIEŠMOKYKLINĖ GR.";6851169340;Taip;6;0;3;9
5782;Mažylis;"4 PRIEŠMOKYKLINĖ GR.";3217527771;Taip;0;1;0;1
5783;Mažylis;"4 PRIEŠMOKYKLINĖ GR.";7416381505;Taip;0;0;5;5
5784;Mažylis;"4 PRIEŠMOKYKLINĖ GR.";1514640197;Taip;0;0;3;3
5785;Mažylis;"4 PRIEŠMOKYKLINĖ GR.";1002832487;Taip;5;0;3;8
5786;Mažylis;"4 PRIEŠMOKYKLINĖ GR.";9608529135;Taip;0;0;11;11
5787;Mažylis;"4 PRIEŠMOKYKLINĖ GR.";4645411379;Taip;0;0;4;4
5788;Mažylis;"3 DARŽELIO GR.";3081814579;Taip;0;0;12;12
5789;Mažylis;"3 DARŽELIO GR.";6100650710;Taip;0;0;1;1
5790;Mažylis;"3 DARŽELIO GR.";9401388775;Taip;0;0;7;7
5791;Mažylis;"3 DARŽELIO GR.";4817146074;Taip;5;1;0;6
5792;Mažylis;"3 DARŽELIO GR.";6809320247;Taip;0;0;3;3
5793;Mažylis;"3 DARŽELIO GR.";7652390515;Taip;0;0;4;4
5794;Mažylis;"3 DARŽELIO GR.";8639480781;Taip;0;2;3;5
5795;Mažylis;"3 DARŽELIO GR.";9341935211;Ne;22;0;0;22
5796;Mažylis;"3 DARŽELIO GR.";2989562406;Ne;18;0;0;18
5797;Mažylis;"3 DARŽELIO GR.";1151737098;Taip;10;0;4;14
5798;Mažylis;"3 DARŽELIO GR.";7642914458;Taip;8;3;0;11
5799;Mažylis;"3 DARŽELIO GR.";5938312001;Ne;5;0;4;9
5800;Mažylis;"3 DARŽELIO GR.";2119733659;Taip;5;0;0;5
5801;Mažylis;"3 DARŽELIO GR.";3126627913;Taip;0;0;6;6
5802;Mažylis;"3 DARŽELIO GR.";6904083734;Taip;4;5;2;11
5803;Mažylis;"3 DARŽELIO GR.";2319506343;Taip;14;0;0;14
5804;Mažylis;"3 DARŽELIO GR.";9416161833;Taip;5;0;0;5
5805;Mažylis;"3 DARŽELIO GR.";9807376076;Ne;10;0;0;10
5806;Mažylis;"6 DARŽELIO GR.";5388105083;Ne;0;0;13;13
5807;Mažylis;"6 DARŽELIO GR.";8589124394;Taip;0;0;5;5
5808;Mažylis;"6 DARŽELIO GR.";3641990617;Taip;11;0;0;11
5809;Mažylis;"6 DARŽELIO GR.";1892136590;Taip;0;1;2;3
5810;Mažylis;"6 DARŽELIO GR.";9479398581;Taip;0;1;0;1
5811;Mažylis;"6 DARŽELIO GR.";1381828313;Taip;6;0;1;7
5812;Mažylis;"6 DARŽELIO GR.";7725286603;Taip;10;2;2;14
5813;Mažylis;"6 DARŽELIO GR.";7754956214;Taip;6;0;2;8
5814;Mažylis;"6 DARŽELIO GR.";3615636349;Taip;8;0;1;9
5815;Mažylis;"6 DARŽELIO GR.";9894955253;Taip;0;0;6;6
5816;Mažylis;"6 DARŽELIO GR.";3400122626;Taip;8;3;1;12
5817;Mažylis;"6 DARŽELIO GR.";6270840529;Ne;0;0;18;18
5818;Mažylis;"6 DARŽELIO GR.";4100492642;Ne;0;0;18;18
5819;Mažylis;"6 DARŽELIO GR.";5569913242;Taip;0;0;4;4
5820;Mažylis;"6 DARŽELIO GR.";7841955949;Taip;0;0;5;5
5821;Mažylis;"6 DARŽELIO GR.";6492768766;Ne;14;0;2;16
5822;Mažylis;"6 DARŽELIO GR.";6423910850;Taip;4;0;1;5
5823;Mažylis;"6 DARŽELIO GR.";1555305826;Taip;6;0;4;10
5824;Mažylis;"6 DARŽELIO GR.";5977423702;Taip;0;0;10;10
5825;Mažylis;"6 DARŽELIO GR.";9562863405;Taip;5;0;0;5
5826;Mažylis;"6 DARŽELIO GR.";5990843024;Taip;0;0;13;13
5827;Mažylis;"6 DARŽELIO GR.";9981751097;Taip;21;0;1;22
5828;Mažylis;"1 NAUJA (LOPŠELIS)";4985161657;Taip;9;0;0;9
5829;Mažylis;"1 NAUJA (LOPŠELIS)";5297935198;Taip;18;2;0;20
5830;Mažylis;"1 NAUJA (LOPŠELIS)";1993916098;Taip;5;0;1;6
5831;Mažylis;"1 NAUJA (LOPŠELIS)";4309902086;Taip;0;5;0;5
5832;Mažylis;"1 NAUJA (LOPŠELIS)";5727207294;Taip;0;0;2;2
5833;Mažylis;"1 NAUJA (LOPŠELIS)";3064367996;Taip;5;7;0;12
5834;Mažylis;"1 NAUJA (LOPŠELIS)";2110320072;Taip;4;0;0;4
5835;Mažylis;"1 NAUJA (LOPŠELIS)";7810360699;Taip;0;0;15;15
5836;Mažylis;"1 NAUJA (LOPŠELIS)";3911343193;Taip;0;0;5;5
5837;Mažylis;"1 NAUJA (LOPŠELIS)";5225388496;Taip;0;2;0;2
5838;Mažylis;"1 NAUJA (LOPŠELIS)";8259994523;Taip;6;0;2;8
5839;Mažylis;"1 NAUJA (LOPŠELIS)";6500577246;Taip;5;3;0;8
5840;Mažylis;"1 NAUJA (LOPŠELIS)";3098913589;Taip;17;0;0;17
5841;Mažylis;"1 NAUJA (LOPŠELIS)";4201114033;Taip;5;0;1;6
5842;Mažylis;"1 NAUJA (LOPŠELIS)";9025867358;Taip;14;0;0;14
5843;Mažylis;"1 NAUJA (LOPŠELIS)";8871998701;Taip;0;0;9;9
5844;Mažylis;"1 NAUJA (LOPŠELIS)";4347489809;Taip;3;0;0;3
5845;Mažylis;"5 DARŽELIO GR.";2935175014;Taip;6;0;14;20
5846;Mažylis;"5 DARŽELIO GR.";2979849055;Taip;0;5;0;5
5847;Mažylis;"5 DARŽELIO GR.";6162880220;Taip;10;1;2;13
5848;Mažylis;"5 DARŽELIO GR.";1762105763;Taip;10;0;0;10
5849;Mažylis;"5 DARŽELIO GR.";2672500259;Ne;0;0;5;5
5850;Mažylis;"5 DARŽELIO GR.";8135596731;Taip;5;0;0;5
5851;Mažylis;"5 DARŽELIO GR.";8866980930;Taip;10;1;0;11
5852;Mažylis;"5 DARŽELIO GR.";2704741847;Ne;8;1;0;9
5853;Mažylis;"5 DARŽELIO GR.";3327673298;Taip;8;3;0;11
5854;Mažylis;"5 DARŽELIO GR.";4280547746;Taip;8;0;1;9
5855;Mažylis;"5 DARŽELIO GR.";9447747294;Ne;10;0;11;21
5856;Mažylis;"5 DARŽELIO GR.";4542742002;Taip;0;0;1;1
5857;Mažylis;"5 DARŽELIO GR.";2126108232;Taip;3;2;0;5
5858;Mažylis;"5 DARŽELIO GR.";4553092508;Ne;0;0;3;3
5859;Mažylis;"5 DARŽELIO GR.";8297427176;Taip;0;3;2;5
5860;Mažylis;"5 DARŽELIO GR.";6009637985;Taip;0;0;3;3
5861;Mažylis;"5 DARŽELIO GR.";5870983755;Taip;0;3;5;8
5862;Mažylis;"5 DARŽELIO GR.";8999239172;Taip;0;0;9;9
5863;Mažylis;"5 DARŽELIO GR.";3365026025;Taip;0;0;6;6
5864;Mažylis;"DARŽELIS 2 GR.";2795618410;Taip;0;1;7;8
5865;Mažylis;"DARŽELIS 2 GR.";9727982334;Ne;11;0;4;15
5866;Mažylis;"DARŽELIS 2 GR.";8655053217;Taip;8;0;0;8
5867;Mažylis;"DARŽELIS 2 GR.";7414398772;Taip;9;0;0;9
5868;Mažylis;"DARŽELIS 2 GR.";1058725505;Taip;23;2;0;25
5869;Mažylis;"DARŽELIS 2 GR.";1219174313;Taip;10;0;3;13
5870;Mažylis;"DARŽELIS 2 GR.";9111101357;Taip;4;0;12;16
5871;Mažylis;"DARŽELIS 2 GR.";1533948576;Taip;0;0;3;3
5872;Mažylis;"DARŽELIS 2 GR.";6728351360;Ne;0;2;0;2
5873;Mažylis;"DARŽELIS 2 GR.";6272047137;Taip;4;3;0;7
5874;Mažylis;"DARŽELIS 2 GR.";7255856938;Ne;10;0;7;17
5875;Mažylis;"DARŽELIS 2 GR.";4987487972;Taip;22;0;0;22
5876;Mažylis;"DARŽELIS 2 GR.";9555408203;Ne;13;0;3;16
5877;Mažylis;"DARŽELIS 2 GR.";5165268747;Taip;0;0;5;5
5878;Mažylis;"DARŽELIS 2 GR.";2425437724;Taip;5;0;10;15
5879;Mažylis;"DARŽELIS 2 GR.";2723677422;Taip;4;0;2;6
5880;Mažylis;"DARŽELIS 2 GR.";9875575387;Ne;4;0;1;5
5881;Mažylis;"DARŽELIS 2 GR.";5658868407;Taip;0;0;6;6
5882;Mažylis;"DARŽELIS 2 GR.";5137132420;Taip;4;0;1;5
5883;Medynėlis;BITUTĖS;6238256156;Ne;0;6;0;6
5884;Medynėlis;BITUTĖS;8711567312;Taip;4;0;2;6
5885;Medynėlis;BITUTĖS;2993705115;Taip;0;4;15;19
5886;Medynėlis;BITUTĖS;1504612730;Ne;15;0;0;15
5887;Medynėlis;BITUTĖS;5522261530;Taip;18;1;0;19
5888;Medynėlis;BITUTĖS;6576401514;Taip;9;0;0;9
5889;Medynėlis;BITUTĖS;4107846958;Ne;2;5;1;8
5890;Medynėlis;BITUTĖS;7296044569;Taip;7;1;0;8
5891;Medynėlis;BITUTĖS;4418330478;Taip;16;0;2;18
5892;Medynėlis;BITUTĖS;6074296305;Taip;0;0;4;4
5893;Medynėlis;BITUTĖS;6815521895;Ne;10;3;0;13
5894;Medynėlis;BITUTĖS;4374464298;Taip;4;0;2;6
5895;Medynėlis;BITUTĖS;8107171123;Ne;20;1;0;21
5896;Medynėlis;BITUTĖS;4545707752;Taip;11;2;3;16
5897;Medynėlis;BITUTĖS;4419503239;Taip;0;0;2;2
5898;Medynėlis;BITUTĖS;7870261906;Taip;15;2;0;17
5899;Medynėlis;BITUTĖS;6466874318;Ne;22;2;0;24
5900;Medynėlis;BITUTĖS;2798305000;Taip;4;1;1;6
5901;Medynėlis;BITUTĖS;5440233814;Ne;6;0;1;7
5902;Medynėlis;BITUTĖS;4598267411;Ne;22;0;0;22
5903;Medynėlis;BITUTĖS;5194220650;Taip;8;0;1;9
5904;Medynėlis;BITUTĖS;4243521511;Taip;6;0;0;6
5905;Medynėlis;DRUGELIAI;8987139302;Taip;12;0;0;12
5906;Medynėlis;DRUGELIAI;7886801955;Taip;16;0;0;16
5907;Medynėlis;DRUGELIAI;6127747445;Ne;0;1;0;1
5908;Medynėlis;DRUGELIAI;33981260502;Taip;8;3;1;12
5909;Medynėlis;DRUGELIAI;4581683292;Taip;6;4;0;10
5910;Medynėlis;DRUGELIAI;7633674694;Taip;9;1;0;10
5911;Medynėlis;DRUGELIAI;6343851636;Taip;7;2;0;9
5912;Medynėlis;DRUGELIAI;8948133343;Taip;8;1;0;9
5913;Medynėlis;DRUGELIAI;9413309043;Taip;7;3;0;10
5914;Medynėlis;DRUGELIAI;3773215372;Taip;15;2;0;17
5915;Medynėlis;DRUGELIAI;1795479738;Taip;23;5;0;28
5916;Medynėlis;DRUGELIAI;4024866819;Taip;8;5;0;13
5917;Medynėlis;DRUGELIAI;7244497661;Taip;7;1;0;8
5918;Medynėlis;DRUGELIAI;8775219704;Taip;0;3;0;3
5919;Medynėlis;DRUGELIAI;5269927048;Taip;10;0;0;10
5920;Medynėlis;DRUGELIAI;1827495325;Taip;5;0;0;5
5921;Medynėlis;DRUGELIAI;2540325264;Ne;0;16;0;16
5922;Medynėlis;DRUGELIAI;3870665108;Ne;0;5;0;5
5923;Medynėlis;DRUGELIAI;9670396828;Taip;10;4;0;14
5924;Medynėlis;DRUGELIAI;5551121950;Taip;7;3;0;10
5925;Medynėlis;DRUGELIAI;2627421550;Taip;0;2;0;2
5926;Medynėlis;DRUGELIAI;2794274146;Taip;11;1;0;12
5927;Medynėlis;SKRUZDĖLIUKAI;4783894465;Taip;11;0;3;14
5928;Medynėlis;SKRUZDĖLIUKAI;3905440176;Ne;5;1;0;6
5929;Medynėlis;SKRUZDĖLIUKAI;1142044361;Taip;9;2;0;11
5930;Medynėlis;SKRUZDĖLIUKAI;8719860414;Ne;12;0;1;13
5931;Medynėlis;SKRUZDĖLIUKAI;6802308420;Taip;9;1;0;10
5932;Medynėlis;SKRUZDĖLIUKAI;4645171858;Ne;11;1;0;12
5933;Medynėlis;SKRUZDĖLIUKAI;3947494044;Taip;13;3;0;16
5934;Medynėlis;SKRUZDĖLIUKAI;3295727210;Taip;19;3;0;22
5935;Medynėlis;SKRUZDĖLIUKAI;8441629302;Taip;14;1;0;15
5936;Medynėlis;SKRUZDĖLIUKAI;3761140697;Taip;13;0;0;13
5937;Medynėlis;SKRUZDĖLIUKAI;5330900656;Taip;16;0;1;17
5938;Medynėlis;SKRUZDĖLIUKAI;4897227188;Taip;9;2;4;15
5939;Medynėlis;SKRUZDĖLIUKAI;2339692406;Taip;2;0;5;7
5940;Medynėlis;SKRUZDĖLIUKAI;2433997383;Taip;23;0;0;23
5941;Medynėlis;SKRUZDĖLIUKAI;9705185906;Taip;4;0;2;6
5942;Medynėlis;SKRUZDĖLIUKAI;9873696787;Ne;19;0;0;19
5943;Medynėlis;SKRUZDĖLIUKAI;2218838971;Taip;15;0;0;15
5944;Medynėlis;VOVERIUKAI;6107849795;Taip;14;0;0;14
5945;Medynėlis;VOVERIUKAI;6826790492;Taip;9;1;0;10
5946;Medynėlis;VOVERIUKAI;2627655353;Taip;10;3;1;14
5947;Medynėlis;VOVERIUKAI;5267128750;Taip;7;1;0;8
5948;Medynėlis;VOVERIUKAI;7638618099;Taip;17;0;2;19
5949;Medynėlis;VOVERIUKAI;4488439037;Taip;7;1;0;8
5950;Medynėlis;VOVERIUKAI;4100792567;Taip;0;0;4;4
5951;Medynėlis;VOVERIUKAI;6101613567;Taip;0;0;4;4
5952;Medynėlis;VOVERIUKAI;1056744101;Taip;15;1;4;20
5953;Medynėlis;VOVERIUKAI;6485314750;Taip;13;6;0;19
5954;Medynėlis;VOVERIUKAI;7455041214;Ne;0;0;6;6
5955;Medynėlis;VOVERIUKAI;2234994999;Taip;8;2;0;10
5956;Medynėlis;VOVERIUKAI;3761845905;Taip;0;0;9;9
5957;Medynėlis;VOVERIUKAI;9825580191;Taip;10;3;0;13
5958;Medynėlis;VOVERIUKAI;3554823424;Taip;5;1;0;6
5959;Medynėlis;VOVERIUKAI;7272017225;Taip;0;13;0;13
5960;Medynėlis;VOVERIUKAI;4092824377;Taip;14;1;0;15
5961;Medynėlis;VOVERIUKAI;1475701065;Taip;14;3;0;17
5962;Medynėlis;VOVERIUKAI;3674134340;Taip;15;0;0;15
5963;Medynėlis;VOVERIUKAI;5028189785;Taip;13;0;0;13
5964;Medynėlis;VOVERIUKAI;3235523199;Taip;9;0;0;9
5965;Medynėlis;VOVERIUKAI;2784942324;Ne;7;1;1;9
5966;Medynėlis;MEŠKIUKAI;2086963376;Taip;5;0;0;5
5967;Medynėlis;MEŠKIUKAI;7740591575;Ne;9;1;0;10
5968;Medynėlis;MEŠKIUKAI;9304002459;Taip;0;0;2;2
5969;Medynėlis;MEŠKIUKAI;5586407412;Taip;5;1;8;14
5970;Medynėlis;MEŠKIUKAI;90556319090;Taip;6;1;0;7
5971;Medynėlis;MEŠKIUKAI;2834559432;Taip;12;0;0;12
5972;Medynėlis;MEŠKIUKAI;9800678364;Taip;3;1;7;11
5973;Medynėlis;MEŠKIUKAI;2057309788;Ne;4;0;1;5
5974;Medynėlis;MEŠKIUKAI;5982453884;Taip;12;0;0;12
5975;Medynėlis;MEŠKIUKAI;2310200034;Taip;0;1;0;1
5976;Medynėlis;MEŠKIUKAI;1750775033;Ne;9;1;0;10
5977;Medynėlis;MEŠKIUKAI;8441104709;Taip;8;0;2;10
5978;Medynėlis;MEŠKIUKAI;9123873119;Taip;0;1;3;4
5979;Medynėlis;MEŠKIUKAI;1237589979;Taip;11;0;0;11
5980;Medynėlis;MEŠKIUKAI;1820113382;Taip;7;3;0;10
5981;Medynėlis;MEŠKIUKAI;6406459222;Ne;5;1;4;10
5982;Medynėlis;MEŠKIUKAI;1173510831;Ne;5;1;0;6
5983;Medynėlis;MEŠKIUKAI;4985243068;Taip;21;1;0;22
5984;Medynėlis;MEŠKIUKAI;7108619017;Taip;0;11;3;14
5985;Medynėlis;MEŠKIUKAI;6999562417;Taip;19;4;4;27
5986;Medynėlis;MEŠKIUKAI;7140184593;Taip;22;0;0;22
5987;Medynėlis;MEŠKIUKAI;3141225891;Taip;6;0;5;11
5988;Medynėlis;PELĖDŽIUKAI;2932544910;Taip;0;0;2;2
5989;Medynėlis;PELĖDŽIUKAI;9079900803;Taip;12;0;0;12
5990;Medynėlis;PELĖDŽIUKAI;5571641847;Taip;21;0;0;21
5991;Medynėlis;PELĖDŽIUKAI;2103255454;Taip;0;7;0;7
5992;Medynėlis;PELĖDŽIUKAI;9355165862;Taip;4;1;2;7
5993;Medynėlis;PELĖDŽIUKAI;9184868565;Taip;15;0;0;15
5994;Medynėlis;PELĖDŽIUKAI;6706028300;Taip;0;3;0;3
5995;Medynėlis;PELĖDŽIUKAI;6955467123;Taip;6;0;1;7
5996;Medynėlis;PELĖDŽIUKAI;6073797962;Ne;13;3;0;16
5997;Medynėlis;PELĖDŽIUKAI;5785463517;Taip;5;0;1;6
5998;Medynėlis;PELĖDŽIUKAI;4222917765;Taip;9;0;0;9
5999;Medynėlis;PELĖDŽIUKAI;1621499650;Taip;9;0;0;9
6000;Medynėlis;PELĖDŽIUKAI;6681155625;Ne;7;1;0;8
6001;Medynėlis;PELĖDŽIUKAI;9438854582;Taip;18;0;1;19
6002;Medynėlis;PELĖDŽIUKAI;1901805808;Taip;0;1;3;4
6003;Medynėlis;PELĖDŽIUKAI;5784691118;Taip;0;1;3;4
6004;Medynėlis;PELĖDŽIUKAI;3856908872;Taip;5;0;0;5
6005;Medynėlis;PELĖDŽIUKAI;4468967036;Taip;6;1;1;8
6006;Medynėlis;BORUŽIUKAI;3787172254;Ne;19;0;3;22
6007;Medynėlis;BORUŽIUKAI;7232396755;Taip;6;3;0;9
6008;Medynėlis;BORUŽIUKAI;7651663404;Taip;17;0;0;17
6009;Medynėlis;BORUŽIUKAI;1463263793;Taip;0;9;0;9
6010;Medynėlis;BORUŽIUKAI;1406029765;Taip;4;1;0;5
6011;Medynėlis;BORUŽIUKAI;9764215406;Taip;0;3;1;4
6012;Medynėlis;BORUŽIUKAI;8271170887;Taip;0;1;0;1
6013;Medynėlis;BORUŽIUKAI;5532880670;Taip;0;3;3;6
6014;Medynėlis;BORUŽIUKAI;1525185037;Taip;4;4;0;8
6015;Medynėlis;BORUŽIUKAI;1333848517;Taip;8;0;2;10
6016;Medynėlis;BORUŽIUKAI;9919108302;Taip;6;5;0;11
6017;Medynėlis;BORUŽIUKAI;1162859552;Ne;0;15;0;15
6018;Medynėlis;BORUŽIUKAI;6032067904;Taip;7;1;0;8
6019;Medynėlis;BORUŽIUKAI;4315717555;Taip;0;3;1;4
6020;Medynėlis;BORUŽIUKAI;8276864168;Ne;10;3;1;14
6021;Medynėlis;BORUŽIUKAI;5544663829;Taip;3;6;0;9
6022;Medynėlis;BORUŽIUKAI;2701448160;Ne;0;1;0;1
6023;Medynėlis;BORUŽIUKAI;1658457155;Taip;23;3;0;26
6024;Medynėlis;BORUŽIUKAI;8074251036;Taip;19;3;0;22
6025;Medynėlis;BORUŽIUKAI;5158507933;Taip;15;0;0;15
6026;Medynėlis;BORUŽIUKAI;7501831333;Taip;5;2;0;7
6027;Medynėlis;BORUŽIUKAI;2097758483;Taip;21;1;0;22
6028;Medynėlis;BORUŽIUKAI;4267654911;Taip;8;0;0;8
6029;Medynėlis;EŽIUKAI;9729505759;Taip;21;1;0;22
6030;Medynėlis;EŽIUKAI;8125271445;Taip;0;16;0;16
6031;Medynėlis;EŽIUKAI;9847006679;Taip;10;0;1;11
6032;Medynėlis;EŽIUKAI;7317307957;Taip;10;0;9;19
6033;Medynėlis;EŽIUKAI;7860869675;Taip;17;0;1;18
6034;Medynėlis;EŽIUKAI;4471168173;Taip;12;1;3;16
6035;Medynėlis;EŽIUKAI;1062269215;Taip;0;6;4;10
6036;Medynėlis;EŽIUKAI;5197757730;Ne;3;1;0;4
6037;Medynėlis;EŽIUKAI;5333502849;Taip;6;1;2;9
6038;Medynėlis;EŽIUKAI;6536626390;Taip;16;0;3;19
6039;Medynėlis;EŽIUKAI;8953622684;Taip;15;0;0;15
6040;Medynėlis;EŽIUKAI;3230747109;Taip;11;0;2;13
6041;Medynėlis;EŽIUKAI;9175884049;Taip;0;0;2;2
6042;Medynėlis;EŽIUKAI;8609650186;Taip;8;0;0;8
6043;Medynėlis;EŽIUKAI;6826409129;Taip;3;0;1;4
6044;Medynėlis;EŽIUKAI;2929100410;Taip;17;0;0;17
6045;Medynėlis;EŽIUKAI;6359536923;Ne;9;0;0;9
6046;Medynėlis;EŽIUKAI;2676262920;Taip;0;0;6;6
6047;Medynėlis;EŽIUKAI;5339084041;Ne;9;1;2;12
6048;Medynėlis;EŽIUKAI;5766492584;Taip;0;0;1;1
6049;Medynėlis;EŽIUKAI;6561927001;Taip;8;1;0;9
6050;Medynėlis;EŽIUKAI;8838774666;Taip;22;0;0;22
6051;Medynėlis;EŽIUKAI;6349817783;Taip;19;0;0;19
6052;Medynėlis;ZUIKUČIAI;6614028601;Taip;0;0;2;2
6053;Medynėlis;ZUIKUČIAI;8439619837;Taip;8;0;2;10
6054;Medynėlis;ZUIKUČIAI;5389909872;Taip;0;9;0;9
6055;Medynėlis;ZUIKUČIAI;9352391583;Taip;0;1;4;5
6056;Medynėlis;ZUIKUČIAI;4941353702;Taip;11;4;0;15
6057;Medynėlis;ZUIKUČIAI;4040542730;Taip;22;0;0;22
6058;Medynėlis;ZUIKUČIAI;6989524053;Taip;0;0;4;4
6059;Medynėlis;ZUIKUČIAI;9774213537;Taip;12;1;0;13
6060;Medynėlis;ZUIKUČIAI;7129951535;Taip;4;0;0;4
6061;Medynėlis;ZUIKUČIAI;9977590259;Taip;10;2;3;15
6062;Medynėlis;ZUIKUČIAI;7170801214;Taip;14;0;0;14
6063;Medynėlis;ZUIKUČIAI;9373849916;Taip;19;0;0;19
6064;Medynėlis;ZUIKUČIAI;6462589513;Taip;3;1;0;4
6065;Medynėlis;ZUIKUČIAI;4204366008;Taip;5;2;0;7
6066;Medynėlis;ZUIKUČIAI;6569938649;Ne;10;0;0;10
6067;Medynėlis;ZUIKUČIAI;3480190692;Ne;4;14;1;19
6068;Medynėlis;ZUIKUČIAI;5581973770;Taip;0;0;8;8
6069;Medynėlis;KAČIUKAI;8275097931;Taip;21;1;0;22
6070;Medynėlis;KAČIUKAI;5302122600;Taip;21;0;0;21
6071;Medynėlis;KAČIUKAI;6609111216;Taip;13;0;2;15
6072;Medynėlis;KAČIUKAI;6624835214;Taip;17;1;0;18
6073;Medynėlis;KAČIUKAI;2160081492;Taip;10;7;0;17
6074;Medynėlis;KAČIUKAI;4035587227;Taip;14;0;0;14
6075;Medynėlis;KAČIUKAI;8162771849;Taip;5;0;4;9
6076;Medynėlis;KAČIUKAI;9725019515;Ne;14;0;0;14
6077;Medynėlis;KAČIUKAI;3185760752;Taip;16;0;0;16
6078;Medynėlis;KAČIUKAI;5610660982;Taip;10;0;3;13
6079;Medynėlis;KAČIUKAI;6282113738;Taip;13;0;0;13
6080;Medynėlis;KAČIUKAI;4153545500;Taip;10;1;0;11
6081;Medynėlis;KAČIUKAI;8299034970;Taip;13;0;0;13
6082;Medynėlis;KAČIUKAI;7675101600;Ne;6;3;0;9
6083;Medynėlis;KAČIUKAI;1668143166;Taip;9;2;6;17
6084;Medynėlis;KAČIUKAI;4010058673;Taip;10;0;2;12
6085;Medynėlis;KAČIUKAI;6502531749;Ne;8;0;2;10
6086;Medynėlis;KAČIUKAI;9076139419;Taip;15;0;0;15
6087;Medynėlis;KAČIUKAI;1608019909;Taip;9;4;0;13
6088;Medynėlis;KAČIUKAI;1026253778;Ne;9;0;1;10
6089;Medynėlis;KAČIUKAI;1404831377;Ne;14;0;0;14
6090;Medynėlis;KAČIUKAI;2523474347;Taip;10;4;0;14
6091;Medynėlis;PELIUKAI;6622963662;Taip;5;0;1;6
6092;Medynėlis;PELIUKAI;3638155321;Taip;10;1;0;11
6093;Medynėlis;PELIUKAI;9290099536;Ne;10;1;5;16
6094;Medynėlis;PELIUKAI;1500986498;Ne;3;1;2;6
6095;Medynėlis;PELIUKAI;6924524346;Taip;1;0;0;1
6096;Medynėlis;PELIUKAI;2379829985;Taip;10;1;1;12
6097;Medynėlis;PELIUKAI;6926408544;Taip;5;0;1;6
6098;Medynėlis;PELIUKAI;5391199861;Ne;22;0;0;22
6099;Medynėlis;PELIUKAI;9485498942;Taip;0;1;0;1
6100;Medynėlis;PELIUKAI;6095795724;Taip;17;0;0;17
6101;Medynėlis;PELIUKAI;7914358405;Taip;7;0;4;11
6102;Medynėlis;PELIUKAI;7695626630;Taip;5;4;4;13
6103;Medynėlis;PELIUKAI;3538656650;Taip;13;8;0;21
6104;Medynėlis;PELIUKAI;6993176904;Taip;6;0;0;6
6105;Medynėlis;PELIUKAI;2877881247;Taip;21;1;0;22
6106;Medynėlis;PELIUKAI;4145591997;Taip;19;0;0;19
6107;Medynėlis;PELIUKAI;8382537735;Taip;10;0;1;11
6108;Medynėlis;PELIUKAI;7268418306;Taip;10;0;2;12
6109;Medynėlis;PELIUKAI;6470879334;Ne;9;1;1;11
6110;Medynėlis;PELIUKAI;2816510180;Taip;10;0;1;11
6111;Medynėlis;PELIUKAI;3709984586;Taip;8;1;0;9
6112;Medynėlis;ANČIUKAI;9857514451;Taip;22;0;0;22
6113;Medynėlis;ANČIUKAI;6730475188;Taip;9;0;0;9
6114;Medynėlis;ANČIUKAI;6824842361;Taip;8;0;0;8
6115;Medynėlis;ANČIUKAI;5677747582;Taip;10;0;1;11
6116;Medynėlis;ANČIUKAI;4498233742;Taip;4;0;0;4
6117;Medynėlis;ANČIUKAI;5269794415;Taip;0;0;4;4
6118;Medynėlis;ANČIUKAI;5049081242;Taip;9;0;3;12
6119;Medynėlis;ANČIUKAI;4910857912;Taip;0;6;0;6
6120;Medynėlis;ANČIUKAI;4817353132;Taip;5;0;0;5
6121;Medynėlis;ANČIUKAI;7613699868;Ne;20;0;0;20
6122;Medynėlis;ANČIUKAI;9336656351;Taip;9;0;0;9
6123;Medynėlis;ANČIUKAI;7085226543;Taip;22;0;0;22
6124;Medynėlis;ANČIUKAI;1283602655;Taip;19;0;0;19
6125;Medynėlis;ANČIUKAI;3556203620;Taip;16;0;3;19
6126;Medynėlis;ANČIUKAI;2896713695;Taip;0;0;4;4
6127;Medynėlis;ANČIUKAI;8887092965;Taip;16;0;6;22
6128;Medynėlis;ANČIUKAI;4626655069;Taip;17;0;0;17
6129;Medynėlis;ANČIUKAI;5456045449;Taip;7;2;0;9
6130;Medynėlis;ANČIUKAI;8667441678;Taip;7;2;0;9
6131;Medynėlis;ANČIUKAI;6896823412;Taip;5;0;1;6
6132;Medynėlis;ANČIUKAI;6641009653;Taip;20;0;0;20
6133;Medynėlis;STIRNIUKAI;8542591286;Taip;5;0;0;5
6134;Molinukas;NYKŠTUKAI;6353165459;Taip;5;0;0;5
6135;Molinukas;NYKŠTUKAI;5876669121;Taip;4;2;3;9
6136;Molinukas;NYKŠTUKAI;6087698882;Taip;0;2;0;2
6137;Molinukas;NYKŠTUKAI;2211909678;Taip;18;1;0;19
6138;Molinukas;NYKŠTUKAI;2348120316;Taip;0;7;0;7
6139;Molinukas;NYKŠTUKAI;8053608348;Taip;5;1;2;8
6140;Molinukas;NYKŠTUKAI;6014990150;Taip;0;3;0;3
6141;Molinukas;NYKŠTUKAI;7623051674;Taip;10;3;0;13
6142;Molinukas;NYKŠTUKAI;9448910819;Taip;9;0;0;9
6143;Molinukas;NYKŠTUKAI;1651650182;Ne;0;1;4;5
6144;Molinukas;NYKŠTUKAI;5580968328;Taip;19;0;0;19
6145;Molinukas;NYKŠTUKAI;8536615996;Taip;4;0;0;4
6146;Molinukas;NYKŠTUKAI;7602239077;Taip;6;8;0;14
6147;Molinukas;NYKŠTUKAI;1849018608;Taip;0;1;1;2
6148;Molinukas;NYKŠTUKAI;4171978721;Ne;11;1;3;15
6149;Molinukas;NYKŠTUKAI;8260101075;Taip;0;0;2;2
6150;Molinukas;NYKŠTUKAI;9293819449;Taip;0;1;6;7
6151;Molinukas;NYKŠTUKAI;9244598883;Taip;6;0;0;6
6152;Molinukas;NYKŠTUKAI;5525772579;Taip;0;6;1;7
6153;Molinukas;NYKŠTUKAI;4475594896;Taip;20;7;2;29
6154;Molinukas;NYKŠTUKAI;7248705010;Taip;12;3;0;15
6155;Molinukas;NYKŠTUKAI;4101644021;Taip;11;5;0;16
6156;Molinukas;NYKŠTUKAI;6681397435;Taip;10;0;12;22
6157;Molinukas;ZUIKUČIŲ;9203375647;Taip;10;3;0;13
6158;Molinukas;ZUIKUČIŲ;2982968605;Taip;3;7;0;10
6159;Molinukas;ZUIKUČIŲ;8479427729;Ne;11;1;0;12
6160;Molinukas;ZUIKUČIŲ;4225457772;Taip;9;0;0;9
6161;Molinukas;ZUIKUČIŲ;8114735116;Taip;0;4;0;4
6162;Molinukas;ZUIKUČIŲ;5597119459;Taip;12;1;0;13
6163;Molinukas;ZUIKUČIŲ;8582985479;Taip;22;0;0;22
6164;Molinukas;ZUIKUČIŲ;8490020853;Taip;22;0;0;22
6165;Molinukas;ZUIKUČIŲ;2651732418;Taip;19;0;0;19
6166;Molinukas;ZUIKUČIŲ;8988478990;Taip;0;5;1;6
6167;Molinukas;ZUIKUČIŲ;1059002689;Taip;10;5;2;17
6168;Molinukas;ZUIKUČIŲ;5302191209;Taip;22;0;0;22
6169;Molinukas;ZUIKUČIŲ;1605039166;Taip;11;0;0;11
6170;Molinukas;ZUIKUČIŲ;6804127471;Taip;11;0;0;11
6171;Molinukas;ZUIKUČIŲ;2878262979;Taip;4;1;0;5
6172;Molinukas;ZUIKUČIŲ;7441251480;Taip;8;1;0;9
6173;Molinukas;ZUIKUČIŲ;4733315902;Taip;19;0;0;19
6174;Molinukas;ZUIKUČIŲ;2595941277;Taip;7;0;1;8
6175;Molinukas;ZUIKUČIŲ;2706981559;Taip;9;2;0;11
6176;Molinukas;ZUIKUČIŲ;6638634402;Taip;14;0;0;14
6177;Molinukas;ZUIKUČIŲ;3516132254;Taip;18;0;0;18
6178;Molinukas;ZUIKUČIŲ;4718396549;Ne;22;0;0;22
6179;Molinukas;ZUIKUČIŲ;3577613732;Taip;14;0;3;17
6180;Molinukas;ZUIKUČIŲ;9972204424;Taip;10;1;0;11
6181;Molinukas;ZUIKUČIŲ;3419958136;Taip;5;0;0;5
6182;Molinukas;SRAIGIUKŲ;8416644024;Taip;6;0;4;10
6183;Molinukas;SRAIGIUKŲ;1686122652;Taip;0;1;0;1
6184;Molinukas;SRAIGIUKŲ;9948685221;Taip;3;1;9;13
6185;Molinukas;SRAIGIUKŲ;6326031969;Taip;0;1;1;2
6186;Molinukas;SRAIGIUKŲ;8393217418;Taip;0;2;0;2
6187;Molinukas;SRAIGIUKŲ;1469884686;Taip;0;1;1;2
6188;Molinukas;SRAIGIUKŲ;1856269656;Taip;0;1;5;6
6189;Molinukas;SRAIGIUKŲ;4766547534;Taip;5;0;0;5
6190;Molinukas;SRAIGIUKŲ;7377137582;Taip;7;0;3;10
6191;Molinukas;SRAIGIUKŲ;6084682084;Taip;0;4;0;4
6192;Molinukas;SRAIGIUKŲ;8913137310;Ne;6;3;7;16
6193;Molinukas;SRAIGIUKŲ;5387818175;Taip;0;5;0;5
6194;Molinukas;SRAIGIUKŲ;1138255845;Taip;10;6;0;16
6195;Molinukas;SRAIGIUKŲ;8604288346;Ne;14;2;2;18
6196;Molinukas;SRAIGIUKŲ;4806350914;Taip;10;1;3;14
6197;Molinukas;SRAIGIUKŲ;8617979245;Taip;12;0;1;13
6198;Molinukas;SRAIGIUKŲ;2757744826;Taip;10;1;7;18
6199;Molinukas;SRAIGIUKŲ;4534279257;Taip;3;2;0;5
6200;Molinukas;SRAIGIUKŲ;4918181437;Taip;4;0;3;7
6201;Molinukas;SRAIGIUKŲ;7451224160;Taip;3;2;0;5
6202;Molinukas;SRAIGIUKŲ;8688180482;Taip;0;1;3;4
6203;Molinukas;SRAIGIUKŲ;3917187380;Taip;0;0;1;1
6204;Molinukas;VOVERIUKAI;3469196411;Taip;4;0;0;4
6205;Molinukas;VOVERIUKAI;4583155940;Taip;0;0;4;4
6206;Molinukas;VOVERIUKAI;8541456847;Taip;0;13;2;15
6207;Molinukas;VOVERIUKAI;2286586693;Ne;1;1;2;4
6208;Molinukas;VOVERIUKAI;9413396859;Taip;4;0;0;4
6209;Molinukas;VOVERIUKAI;6898958282;Taip;9;0;0;9
6210;Molinukas;VOVERIUKAI;4000190261;Taip;2;0;0;2
6211;Molinukas;VOVERIUKAI;5685582215;Taip;3;3;1;7
6212;Molinukas;VOVERIUKAI;2356814145;Taip;4;0;1;5
6213;Molinukas;VOVERIUKAI;7446607510;Taip;6;9;0;15
6214;Molinukas;VOVERIUKAI;9667704959;Ne;10;1;9;20
6215;Molinukas;VOVERIUKAI;8516451290;Taip;3;0;0;3
6216;Molinukas;VOVERIUKAI;3030169626;Taip;0;1;8;9
6217;Molinukas;VOVERIUKAI;3207373459;Taip;11;0;5;16
6218;Molinukas;VOVERIUKAI;1865748733;Ne;15;0;0;15
6219;Molinukas;VOVERIUKAI;4209143136;Taip;0;1;2;3
6220;Molinukas;VOVERIUKAI;5648861702;Taip;0;1;2;3
6221;Molinukas;VOVERIUKAI;4957226547;Taip;9;2;0;11
6222;Molinukas;VOVERIUKAI;8865966572;Taip;13;0;0;13
6223;Molinukas;VOVERIUKAI;4950808381;Taip;9;9;0;18
6224;Molinukas;VOVERIUKAI;7378643086;Taip;0;1;0;1
6225;Molinukas;VOVERIUKAI;2779700726;Ne;14;0;3;17
6226;Molinukas;VOVERIUKAI;6832647220;Taip;3;0;9;12
6227;Molinukas;VOVERIUKAI;9318837973;Taip;4;0;1;5
6228;Molinukas;VOVERIUKAI;8247270556;Taip;8;0;0;8
6229;Molinukas;ŽVIRBLIUKŲ;2935945686;Taip;9;1;5;15
6230;Molinukas;ŽVIRBLIUKŲ;7825545164;Taip;11;0;0;11
6231;Molinukas;ŽVIRBLIUKŲ;6190443233;Taip;11;0;3;14
6232;Molinukas;ŽVIRBLIUKŲ;1831078544;Ne;19;0;4;23
6233;Molinukas;ŽVIRBLIUKŲ;6531106368;Taip;8;0;7;15
6234;Molinukas;ŽVIRBLIUKŲ;4122429163;Taip;9;2;0;11
6235;Molinukas;ŽVIRBLIUKŲ;8660958288;Taip;13;0;1;14
6236;Molinukas;ŽVIRBLIUKŲ;2862680065;Taip;22;0;0;22
6237;Molinukas;ŽVIRBLIUKŲ;3382913312;Taip;9;0;6;15
6238;Molinukas;ŽVIRBLIUKŲ;3331982964;Taip;4;0;0;4
6239;Molinukas;ŽVIRBLIUKŲ;2448588784;Taip;21;1;0;22
6240;Molinukas;ŽVIRBLIUKŲ;2842168450;Taip;17;1;0;18
6241;Molinukas;KAČIUKŲ;4992887072;Taip;4;0;1;5
6242;Molinukas;KAČIUKŲ;1907287249;Taip;0;0;2;2
6243;Molinukas;KAČIUKŲ;1292778118;Taip;17;0;0;17
6244;Molinukas;KAČIUKŲ;8769667823;Taip;9;1;1;11
6245;Molinukas;KAČIUKŲ;8313486714;Taip;16;1;0;17
6246;Molinukas;KAČIUKŲ;3043679624;Taip;12;0;8;20
6247;Molinukas;KAČIUKŲ;2030429825;Taip;9;3;2;14
6248;Molinukas;KAČIUKŲ;4974513900;Taip;0;7;0;7
6249;Molinukas;KAČIUKŲ;1826463800;Taip;0;3;1;4
6250;Molinukas;KAČIUKŲ;6947938890;Taip;22;0;0;22
6251;Molinukas;KAČIUKŲ;1970929144;Taip;14;3;0;17
6252;Molinukas;KAČIUKŲ;3510936830;Taip;10;0;6;16
6253;Molinukas;KAČIUKŲ;8608465121;Taip;0;0;19;19
6254;Molinukas;KAČIUKŲ;1651103318;Taip;4;0;1;5
6255;Molinukas;KAČIUKŲ;8973341322;Taip;14;0;1;15
6256;"Naminukas (Smėlio g. 13)";Drugeliai;6776805494;Taip;7;4;0;11
6257;"Naminukas (Smėlio g. 13)";Drugeliai;2395070574;Taip;8;2;0;10
6258;"Naminukas (Smėlio g. 13)";Drugeliai;5534073614;Taip;0;1;0;1
6259;"Naminukas (Smėlio g. 13)";Drugeliai;2132345627;Taip;9;0;0;9
6260;"Naminukas (Smėlio g. 13)";Drugeliai;1302119260;Ne;0;5;2;7
6261;"Naminukas (Smėlio g. 13)";Drugeliai;2864905392;Taip;12;5;0;17
6262;"Naminukas (Smėlio g. 13)";Drugeliai;7406775925;Taip;7;1;0;8
6263;"Naminukas (Smėlio g. 13)";Drugeliai;1333462200;Taip;0;0;7;7
6264;"Naminukas (Smėlio g. 13)";Drugeliai;5468218968;Taip;9;0;0;9
6265;"Naminukas (Smėlio g. 13)";Drugeliai;5713661641;Taip;10;0;0;10
6266;"Naminukas (Smėlio g. 13)";Drugeliai;6581925461;Taip;5;7;0;12
6267;"Naminukas (Smėlio g. 13)";Drugeliai;3320805432;Taip;1;2;0;3
6268;"Naminukas (Smėlio g. 13)";Drugeliai;9689866363;Taip;7;0;1;8
6269;"Naminukas (Smėlio g. 13)";Drugeliai;2198493034;Taip;14;1;0;15
6270;"Naminukas (Smėlio g. 13)";Drugeliai;8141324449;Taip;8;0;3;11
6271;"Naminukas (Smėlio g. 13)";Drugeliai;8564586014;Taip;13;0;0;13
6272;"Naminukas (Smėlio g. 13)";Drugeliai;3236525642;Taip;5;4;0;9
6273;"Naminukas (Smėlio g. 13)";Drugeliai;7347998152;Taip;0;5;0;5
6274;"Naminukas (Smėlio g. 13)";Drugeliai;7272465847;Taip;20;0;1;21
6275;"Naminukas (Smėlio g. 13)";Bitutės;4419568254;Taip;6;1;0;7
6276;"Naminukas (Smėlio g. 13)";Bitutės;1956749138;Taip;4;1;4;9
6277;"Naminukas (Smėlio g. 13)";Bitutės;6503569633;Ne;5;0;7;12
6278;"Naminukas (Smėlio g. 13)";Bitutės;3192885665;Taip;8;1;2;11
6279;"Naminukas (Smėlio g. 13)";Bitutės;9530232649;Taip;5;0;9;14
6280;"Naminukas (Smėlio g. 13)";Bitutės;8131328042;Taip;7;4;2;13
6281;"Naminukas (Smėlio g. 13)";Bitutės;7888950723;Taip;4;0;3;7
6282;"Naminukas (Smėlio g. 13)";Bitutės;1710002948;Taip;6;0;0;6
6283;"Naminukas (Smėlio g. 13)";Bitutės;3994190066;Taip;0;3;2;5
6284;"Naminukas (Smėlio g. 13)";Bitutės;5195078101;Taip;8;0;0;8
6285;"Naminukas (Smėlio g. 13)";Bitutės;9541388086;Taip;0;4;2;6
6286;"Naminukas (Smėlio g. 13)";Bitutės;2424412518;Taip;4;3;10;17
6287;"Naminukas (Smėlio g. 13)";Bitutės;41538301616;Taip;0;7;2;9
6288;"Naminukas (Smėlio g. 13)";Bitutės;5493709688;Taip;5;1;11;17
6289;"Naminukas (Smėlio g. 13)";Bitutės;2769848640;Taip;0;0;6;6
6290;"Naminukas (Smėlio g. 13)";Bitutės;9821244713;Ne;14;3;0;17
6291;"Naminukas (Smėlio g. 13)";Bitutės;7847923107;Taip;14;0;0;14
6292;"Naminukas (Smėlio g. 13)";Bitutės;1480152104;Taip;3;0;1;4
6293;"Naminukas (Smėlio g. 13)";Bitutės;4331408714;Taip;4;1;0;5
6294;"Naminukas (Smėlio g. 13)";Paukšteliai;3501921619;Taip;7;1;0;8
6295;"Naminukas (Smėlio g. 13)";Paukšteliai;7297661383;Taip;7;0;0;7
6296;"Naminukas (Smėlio g. 13)";Paukšteliai;5056487802;Taip;14;0;0;14
6297;"Naminukas (Smėlio g. 13)";Paukšteliai;3438010199;Taip;7;0;4;11
6298;"Naminukas (Smėlio g. 13)";Paukšteliai;4998565160;Taip;7;7;0;14
6299;"Naminukas (Smėlio g. 13)";Paukšteliai;9405784626;Taip;8;1;5;14
6300;"Naminukas (Smėlio g. 13)";Paukšteliai;2583886896;Taip;11;0;0;11
6301;"Naminukas (Smėlio g. 13)";Paukšteliai;4778385421;Taip;6;5;0;11
6302;"Naminukas (Smėlio g. 13)";Paukšteliai;6178500478;Taip;7;1;2;10
6303;"Naminukas (Smėlio g. 13)";Paukšteliai;9440685520;Taip;7;0;0;7
6304;"Naminukas (Smėlio g. 13)";Paukšteliai;1406418130;Taip;5;0;2;7
6305;"Naminukas (Smėlio g. 13)";Paukšteliai;9891722891;Taip;10;3;0;13
6306;"Naminukas (Smėlio g. 13)";Paukšteliai;2012656186;Ne;6;0;4;10
6307;"Naminukas (Smėlio g. 13)";Paukšteliai;8470716196;Taip;4;0;1;5
6308;"Naminukas (Smėlio g. 13)";Paukšteliai;3727828033;Ne;8;4;0;12
6309;"Naminukas (Smėlio g. 13)";Paukšteliai;9657786543;Ne;10;2;0;12
6310;"Naminukas (Smėlio g. 13)";Paukšteliai;2652538212;Ne;11;0;0;11
6311;"Naminukas (Smėlio g. 13)";"NYKŠTUKAI ";5849662446;Taip;14;6;0;20
6312;"Naminukas (Smėlio g. 13)";"NYKŠTUKAI ";7646186458;Taip;11;0;0;11
6313;"Naminukas (Smėlio g. 13)";"NYKŠTUKAI ";5519447152;Taip;18;0;0;18
6314;"Naminukas (Smėlio g. 13)";"NYKŠTUKAI ";5741698937;Taip;9;1;1;11
6315;"Naminukas (Smėlio g. 13)";"NYKŠTUKAI ";1286329245;Taip;4;12;0;16
6316;"Naminukas (Smėlio g. 13)";"NYKŠTUKAI ";7717132979;Taip;7;5;0;12
6317;"Naminukas (Smėlio g. 13)";"NYKŠTUKAI ";3355811632;Taip;0;0;3;3
6318;"Naminukas (Smėlio g. 13)";"NYKŠTUKAI ";1618802271;Taip;11;0;0;11
6319;"Naminukas (Smėlio g. 13)";"NYKŠTUKAI ";1591540165;Taip;7;0;10;17
6320;"Naminukas (Smėlio g. 13)";"NYKŠTUKAI ";9537360943;Taip;9;0;0;9
6321;"Naminukas (Smėlio g. 13)";"NYKŠTUKAI ";1118193598;Ne;12;0;0;12
6322;"Naminukas (Smėlio g. 13)";"NYKŠTUKAI ";8102805098;Taip;0;0;8;8
6323;"Naminukas (Smėlio g. 13)";"NYKŠTUKAI ";3996950390;Taip;9;0;2;11
6324;"Naminukas (Smėlio g. 13)";"NYKŠTUKAI ";9357758815;Taip;9;0;1;10
6325;"Naminukas (Smėlio g. 13)";"NYKŠTUKAI ";5280419144;Taip;12;0;0;12
6326;Nykštukas;SMAGURIAI;8120626738;Taip;11;4;0;15
6327;Nykštukas;SMAGURIAI;9842748132;Ne;12;2;0;14
6328;Nykštukas;SMAGURIAI;4830484167;Taip;15;2;0;17
6329;Nykštukas;SMAGURIAI;1902253981;Taip;13;5;0;18
6330;Nykštukas;SMAGURIAI;4949895196;Taip;10;0;0;10
6331;Nykštukas;SMAGURIAI;9713859038;Ne;10;0;0;10
6332;Nykštukas;SMAGURIAI;7954996421;Taip;0;5;0;5
6333;Nykštukas;SMAGURIAI;4771072061;Taip;10;0;0;10
6334;Nykštukas;SMAGURIAI;6139988523;Taip;9;0;0;9
6335;Nykštukas;SMAGURIAI;5190754451;Taip;15;0;0;15
6336;Nykštukas;SMAGURIAI;8310484267;Taip;17;0;0;17
6337;Nykštukas;SMAGURIAI;1707956308;Ne;13;3;0;16
6338;Nykštukas;SMAGURIAI;8635571067;Taip;10;3;0;13
6339;Nykštukas;SMAGURIAI;9326131725;Taip;14;3;0;17
6340;Nykštukas;SMAGURIAI;2000207070;Taip;9;2;0;11
6341;Nykštukas;SMAGURIAI;2826079911;Taip;14;2;0;16
6342;Nykštukas;SMAGURIAI;7911842707;Taip;13;4;0;17
6343;Nykštukas;SMAGURIAI;6102907953;Taip;14;1;0;15
6344;Nykštukas;SMAGURIAI;7529677915;Taip;0;8;0;8
6345;Nykštukas;SMAGURIAI;4994727422;Ne;0;9;0;9
6346;Nykštukas;SMAGURIAI;3007541327;Taip;8;14;0;22
6347;Nykštukas;SMAGURIAI;3370000872;Taip;0;2;0;2
6348;Nykštukas;SMALSIUKAI;5121027981;Taip;15;1;0;16
6349;Nykštukas;SMALSIUKAI;6958596223;Taip;0;2;0;2
6350;Nykštukas;SMALSIUKAI;3002966681;Ne;4;1;0;5
6351;Nykštukas;SMALSIUKAI;4612171029;Ne;0;5;0;5
6352;Nykštukas;SMALSIUKAI;3120577264;Taip;4;6;0;10
6353;Nykštukas;SMALSIUKAI;1386798219;Taip;0;1;0;1
6354;Nykštukas;SMALSIUKAI;3852057722;Ne;0;1;0;1
6355;Nykštukas;SMALSIUKAI;2696384135;Ne;9;1;0;10
6356;Nykštukas;SMALSIUKAI;9532956150;Taip;4;3;0;7
6357;Nykštukas;SMALSIUKAI;3273579005;Ne;0;3;0;3
6358;Nykštukas;SMALSIUKAI;3985610575;Taip;0;7;0;7
6359;Nykštukas;SMALSIUKAI;8948554271;Ne;2;0;0;2
6360;Nykštukas;SMALSIUKAI;1102555964;Ne;0;3;0;3
6361;Nykštukas;SMALSIUKAI;4331906712;Taip;4;1;0;5
6362;Nykštukas;SMALSIUKAI;6112448299;Ne;0;4;0;4
6363;Nykštukas;SMALSIUKAI;1930357859;Taip;5;0;0;5
6364;Nykštukas;SMALSIUKAI;9100510105;Ne;4;2;0;6
6365;Nykštukas;SMALSIUKAI;2143857296;Ne;7;1;0;8
6366;Nykštukas;SMALSIUKAI;9779645295;Ne;4;0;0;4
6367;Nykštukas;SMALSIUKAI;2571249434;Ne;0;8;0;8
6368;Nykštukas;SMALSIUKAI;3694497590;Taip;8;1;0;9
6369;Nykštukas;AITVARIUKAI;6923345088;Taip;14;2;0;16
6370;Nykštukas;AITVARIUKAI;8580777381;Taip;4;0;0;4
6371;Nykštukas;AITVARIUKAI;9216544103;Taip;10;8;0;18
6372;Nykštukas;AITVARIUKAI;9319066179;Taip;12;8;0;20
6373;Nykštukas;AITVARIUKAI;2177539882;Taip;4;3;3;10
6374;Nykštukas;AITVARIUKAI;9595654681;Taip;12;0;0;12
6375;Nykštukas;AITVARIUKAI;9894698453;Taip;0;12;0;12
6376;Nykštukas;AITVARIUKAI;6351178752;Taip;0;0;1;1
6377;Nykštukas;AITVARIUKAI;2232317366;Taip;12;1;0;13
6378;Nykštukas;AITVARIUKAI;7332769878;Ne;5;2;0;7
6379;Nykštukas;AITVARIUKAI;7896338372;Taip;7;2;0;9
6380;Nykštukas;AITVARIUKAI;2208319289;Taip;9;6;0;15
6381;Nykštukas;AITVARIUKAI;5285669371;Taip;0;9;0;9
6382;Nykštukas;AITVARIUKAI;8548820023;Taip;10;4;0;14
6383;Nykštukas;AITVARIUKAI;9545178064;Taip;3;0;0;3
6384;Nykštukas;AITVARIUKAI;3561627809;Taip;4;1;0;5
6385;Nykštukas;AITVARIUKAI;5972246871;Ne;8;3;0;11
6386;Nykštukas;AITVARIUKAI;5538446312;Ne;8;0;3;11
6387;Nykštukas;AITVARIUKAI;4822304386;Taip;0;0;1;1
6388;Nykštukas;AITVARIUKAI;4177690371;Taip;15;0;0;15
6389;Nykštukas;AITVARIUKAI;5292127770;Taip;5;5;3;13
6390;Nykštukas;DAINORĖLIAI;7526936193;Ne;5;1;10;16
6391;Nykštukas;DAINORĖLIAI;7730918105;Ne;23;0;0;23
6392;Nykštukas;DAINORĖLIAI;8475127245;Taip;2;3;5;10
6393;Nykštukas;DAINORĖLIAI;5434220008;Taip;14;0;0;14
6394;Nykštukas;DAINORĖLIAI;1122600949;Taip;9;1;1;11
6395;Nykštukas;DAINORĖLIAI;3853935568;Taip;1;0;8;9
6396;Nykštukas;DAINORĖLIAI;9776630115;Taip;0;8;0;8
6397;Nykštukas;DAINORĖLIAI;5291104224;Taip;5;0;0;5
6398;Nykštukas;DAINORĖLIAI;9524639831;Ne;5;3;0;8
6399;Nykštukas;DAINORĖLIAI;3367348573;Taip;0;15;0;15
6400;Nykštukas;DAINORĖLIAI;5961945345;Taip;30;0;0;30
6401;Nykštukas;DAINORĖLIAI;6561696818;Taip;12;0;0;12
6402;Nykštukas;DAINORĖLIAI;1283453188;Taip;8;0;0;8
6403;Nykštukas;DAINORĖLIAI;1167614164;Taip;5;4;1;10
6404;Nykštukas;DAINORĖLIAI;7473124310;Taip;6;0;0;6
6405;Nykštukas;DAINORĖLIAI;1174618721;Taip;13;8;0;21
6406;Nykštukas;DAINORĖLIAI;8681884252;Taip;0;8;0;8
6407;Nykštukas;DAINORĖLIAI;5255726742;Taip;0;1;0;1
6408;Nykštukas;DAINORĖLIAI;9027355399;Taip;9;4;0;13
6409;Nykštukas;DAINORĖLIAI;4893494144;Taip;0;8;0;8
6410;Nykštukas;DAINORĖLIAI;8318089070;Taip;11;0;0;11
6411;Nykštukas;DAINORĖLIAI;2727074729;Taip;0;8;4;12
6412;Nykštukas;POKŠTUKAI;7382271765;Ne;0;9;0;9
6413;Nykštukas;POKŠTUKAI;1655428422;Taip;13;0;0;13
6414;Nykštukas;POKŠTUKAI;2649916049;Taip;22;0;0;22
6415;Nykštukas;POKŠTUKAI;1796016501;Taip;19;3;0;22
6416;Nykštukas;POKŠTUKAI;5958711585;Ne;0;3;0;3
6417;Nykštukas;POKŠTUKAI;3999004312;Taip;16;0;0;16
6418;Nykštukas;POKŠTUKAI;6719999304;Taip;9;7;0;16
6419;Nykštukas;POKŠTUKAI;8148163137;Taip;3;5;0;8
6420;Nykštukas;POKŠTUKAI;8708184278;Taip;0;3;0;3
6421;Nykštukas;POKŠTUKAI;5699671696;Taip;4;0;0;4
6422;Nykštukas;POKŠTUKAI;3843163586;Taip;3;2;0;5
6423;Nykštukas;POKŠTUKAI;1316018865;Taip;8;0;0;8
6424;Nykštukas;POKŠTUKAI;3507649457;Taip;5;0;0;5
6425;Nykštukas;POKŠTUKAI;3428031037;Taip;5;0;0;5
6426;Nykštukas;POKŠTUKAI;4508625009;Taip;5;6;0;11
6427;Nykštukas;POKŠTUKAI;6698622575;Taip;0;6;0;6
6428;Nykštukas;POKŠTUKAI;2982662650;Taip;4;4;0;8
6429;Nykštukas;POKŠTUKAI;2627736026;Taip;10;6;0;16
6430;Nykštukas;POKŠTUKAI;4401103119;Taip;11;7;0;18
6431;Nykštukas;POKŠTUKAI;5287713634;Taip;0;2;0;2
6432;Nykštukas;KODĖLČIUKAI;8168579152;Taip;14;3;0;17
6433;Nykštukas;KODĖLČIUKAI;9285820767;Taip;15;0;1;16
6434;Nykštukas;KODĖLČIUKAI;2685400939;Ne;10;6;0;16
6435;Nykštukas;KODĖLČIUKAI;3278960733;Ne;7;3;4;14
6436;Nykštukas;KODĖLČIUKAI;5934979528;Taip;9;0;3;12
6437;Nykštukas;KODĖLČIUKAI;3760617860;Ne;15;1;0;16
6438;Nykštukas;KODĖLČIUKAI;8042479133;Taip;11;0;1;12
6439;Nykštukas;KODĖLČIUKAI;6999380958;Taip;8;0;0;8
6440;Nykštukas;KODĖLČIUKAI;6794885966;Taip;9;0;0;9
6441;Nykštukas;KODĖLČIUKAI;7616459970;Taip;6;1;3;10
6442;Nykštukas;KODĖLČIUKAI;2623254163;Taip;22;0;0;22
6443;Nykštukas;KODĖLČIUKAI;9296449928;Taip;9;0;4;13
6444;Nykštukas;KODĖLČIUKAI;2992219360;Taip;0;0;22;22
6445;Nykštukas;KODĖLČIUKAI;8804969886;Taip;10;0;0;10
6446;Nykštukas;KODĖLČIUKAI;3552386621;Taip;9;3;0;12
6447;Nykštukas;KODĖLČIUKAI;3990260342;Taip;11;0;0;11
6448;Nykštukas;KODĖLČIUKAI;2692551262;Ne;5;1;0;6
6449;Nykštukas;PASAKORIAI;2661110617;Taip;17;1;0;18
6450;Nykštukas;PASAKORIAI;3040001373;Taip;3;0;0;3
6451;Nykštukas;PASAKORIAI;1855278809;Taip;0;1;0;1
6452;Nykštukas;PASAKORIAI;8640715657;Taip;7;6;0;13
6453;Nykštukas;PASAKORIAI;5504584349;Taip;10;0;1;11
6454;Nykštukas;PASAKORIAI;7990462246;Taip;4;3;0;7
6455;Nykštukas;PASAKORIAI;9413198245;Taip;3;0;0;3
6456;Nykštukas;PASAKORIAI;2518342041;Taip;0;4;0;4
6457;Nykštukas;PASAKORIAI;7828733135;Taip;12;0;0;12
6458;Nykštukas;PASAKORIAI;4480184458;Taip;3;0;2;5
6459;Nykštukas;PASAKORIAI;4090494707;Taip;4;0;1;5
6460;Nykštukas;PASAKORIAI;3026598985;Taip;10;0;0;10
6461;Nykštukas;PASAKORIAI;9714310539;Taip;10;5;0;15
6462;Nykštukas;PASAKORIAI;4795301170;Taip;11;0;0;11
6463;Nykštukas;PASAKORIAI;1579064341;Taip;12;0;1;13
6464;Nykštukas;PASAKORIAI;4992654449;Taip;11;0;1;12
6465;Nykštukas;PASAKORIAI;5337728911;Taip;5;2;0;7
6466;Nykštukas;PASAKORIAI;9509051946;Ne;1;4;0;5
6467;Nykštukas;PASAKORIAI;2231375994;Taip;11;3;0;14
6468;Nykštukas;PASAKORIAI;8371081106;Taip;8;8;0;16
6469;Nykštukas;PASAKORIAI;3496434361;Taip;9;3;0;12
6470;Nykštukas;GUDRUČIAI;9871410323;Taip;5;1;0;6
6471;Nykštukas;GUDRUČIAI;4559818614;Taip;0;8;0;8
6472;Nykštukas;GUDRUČIAI;9250827058;Ne;5;1;0;6
6473;Nykštukas;GUDRUČIAI;7447202642;Taip;13;0;0;13
6474;Nykštukas;GUDRUČIAI;1714708754;Taip;0;1;5;6
6475;Nykštukas;GUDRUČIAI;5157799354;Taip;7;0;0;7
6476;Nykštukas;GUDRUČIAI;4325369395;Taip;14;0;1;15
6477;Nykštukas;GUDRUČIAI;6630804505;Taip;5;4;0;9
6478;Nykštukas;GUDRUČIAI;8363202198;Ne;10;3;0;13
6479;Nykštukas;GUDRUČIAI;7326535810;Taip;13;3;0;16
6480;Nykštukas;GUDRUČIAI;9712596180;Ne;9;0;0;9
6481;Nykštukas;GUDRUČIAI;9941937734;Taip;5;3;0;8
6482;Nykštukas;GUDRUČIAI;2494482185;Taip;4;0;0;4
6483;Nykštukas;GUDRUČIAI;3619459404;Taip;0;1;6;7
6484;Nykštukas;GUDRUČIAI;1934596739;Ne;8;0;0;8
6485;Nykštukas;GUDRUČIAI;7604740418;Taip;10;1;0;11
6486;Nykštukas;GUDRUČIAI;2970293467;Taip;9;8;0;17
6487;Nykštukas;GUDRUČIAI;2881323571;Ne;11;3;0;14
6488;Nykštukas;GUDRUČIAI;9437700329;Taip;18;2;0;20
6489;Nykštukas;GUDRUČIAI;2872277381;Taip;14;0;0;14
6490;Nykštukas;GUDRUČIAI;9940519259;Ne;10;0;0;10
6491;Nykštukas;NAMINUKAI;7456007276;Taip;11;0;0;11
6492;Nykštukas;NAMINUKAI;7176519994;Taip;8;0;0;8
6493;Nykštukas;NAMINUKAI;2440574056;Taip;10;0;0;10
6494;Nykštukas;NAMINUKAI;4064016871;Taip;0;9;0;9
6495;Nykštukas;NAMINUKAI;9054070492;Taip;1;1;5;7
6496;Nykštukas;NAMINUKAI;6519078450;Taip;8;1;0;9
6497;Nykštukas;NAMINUKAI;4925214655;Taip;3;0;0;3
6498;Nykštukas;NAMINUKAI;5032283848;Taip;11;0;3;14
6499;Nykštukas;NAMINUKAI;7494444468;Taip;24;0;0;24
6500;Nykštukas;NAMINUKAI;3925958632;Taip;24;0;0;24
6501;Nykštukas;NAMINUKAI;6338717583;Taip;9;6;0;15
6502;Nykštukas;NAMINUKAI;7976689381;Taip;9;1;2;12
6503;Nykštukas;NAMINUKAI;9686815141;Taip;13;4;0;17
6504;Nykštukas;NAMINUKAI;9575291096;Taip;4;8;0;12
6505;Nykštukas;NAMINUKAI;4503830456;Ne;11;0;0;11
6506;Nykštukas;NAMINUKAI;4040123876;Taip;0;11;0;11
6507;Nykštukas;NAMINUKAI;1088633575;Taip;16;1;0;17
6508;Nykštukas;NAMINUKAI;5088668786;Taip;5;13;0;18
6509;Nykštukas;NAMINUKAI;8874850019;Taip;11;1;0;12
6510;Nykštukas;NAMINUKAI;1510338621;Taip;14;3;0;17
6511;Nykštukas;NAMINUKAI;9067774103;Ne;22;0;0;22
6512;Nykštukas;NAMINUKAI;3405633312;Ne;1;2;3;6
6513;Nykštukas;KŪLVERSTUKAI;8827094160;Ne;7;3;0;10
6514;Nykštukas;KŪLVERSTUKAI;7320458031;Taip;11;1;0;12
6515;Nykštukas;KŪLVERSTUKAI;6786896381;Taip;8;0;0;8
6516;Nykštukas;KŪLVERSTUKAI;6883272732;Ne;3;0;2;5
6517;Nykštukas;KŪLVERSTUKAI;8919778025;Taip;22;0;0;22
6518;Nykštukas;KŪLVERSTUKAI;6337924089;Taip;10;0;1;11
6519;Nykštukas;KŪLVERSTUKAI;4323166473;Taip;7;3;0;10
6520;Nykštukas;KŪLVERSTUKAI;2748970206;Taip;17;0;1;18
6521;Nykštukas;KŪLVERSTUKAI;4490310109;Ne;0;10;0;10
6522;Nykštukas;KŪLVERSTUKAI;2947976429;Taip;18;0;0;18
6523;Nykštukas;KŪLVERSTUKAI;1102203704;Taip;4;0;1;5
6524;Nykštukas;KŪLVERSTUKAI;2763268154;Ne;0;1;2;3
6525;Nykštukas;TREPSIUKAI;2052451745;Taip;5;0;0;5
6526;Nykštukas;TREPSIUKAI;4955003100;Taip;22;0;0;22
6527;Nykštukas;TREPSIUKAI;5103512898;Ne;11;0;1;12
6528;Nykštukas;TREPSIUKAI;7603500691;Taip;9;0;0;9
6529;Nykštukas;TREPSIUKAI;7266550834;Taip;14;0;0;14
6530;Nykštukas;TREPSIUKAI;6563871327;Taip;15;0;0;15
6531;Nykštukas;TREPSIUKAI;5085577592;Taip;4;0;0;4
6532;Nykštukas;TREPSIUKAI;8819485547;Taip;18;0;0;18
6533;Nykštukas;TREPSIUKAI;5281616311;Taip;9;0;0;9
6534;Nykštukas;TREPSIUKAI;5718555692;Taip;10;0;0;10
6535;Nykštukas;TREPSIUKAI;4499337321;Taip;14;0;0;14
6536;Nykštukas;TREPSIUKAI;4622095064;Ne;10;0;0;10
6537;Nykštukas;TREPSIUKAI;8667489439;Taip;7;0;1;8
6538;Nykštukas;TREPSIUKAI;5010715255;Taip;8;0;0;8
6539;Nykštukas;TREPSIUKAI;8047072198;Taip;15;0;0;15
6540;Nykštukas;TREPSIUKAI;9790322329;Taip;18;1;0;19
6541;Nykštukas;TREPSIUKAI;8695794490;Taip;13;0;0;13
6542;Nykštukas;ŽIRNIUKAI;9661862689;Taip;21;0;0;21
6543;Nykštukas;ŽIRNIUKAI;1594734231;Taip;1;0;0;1
6544;Nykštukas;ŽIRNIUKAI;1671340074;Ne;16;0;0;16
6545;Nykštukas;ŽIRNIUKAI;3339707558;Taip;0;3;0;3
6546;Nykštukas;ŽIRNIUKAI;7908029688;Taip;0;1;0;1
6547;Nykštukas;ŽIRNIUKAI;7299329150;Taip;7;0;5;12
6548;Nykštukas;ŽIRNIUKAI;9174636607;Taip;0;1;0;1
6549;Nykštukas;ŽIRNIUKAI;1218443707;Ne;3;1;0;4
6550;Nykštukas;ŽIRNIUKAI;7535385367;Ne;0;0;1;1
6551;Nykštukas;ŽIRNIUKAI;6709760898;Ne;8;0;0;8
6552;Nykštukas;ŽIRNIUKAI;2670682135;Ne;1;1;0;2
6553;Nykštukas;ŽIRNIUKAI;1366524995;Taip;6;0;0;6
6554;Nykštukas;ŽIRNIUKAI;2800783215;Taip;0;22;0;22
6555;Nykštukas;ŽIRNIUKAI;2620150024;Taip;1;3;18;22
6556;Nykštukas;ŽIRNIUKAI;3032028847;Ne;14;3;0;17
6557;Nykštukas;ŽIRNIUKAI;4144437365;Taip;15;1;0;16
6558;Nykštukas;ŽIRNIUKAI;6884714823;Taip;0;10;0;10
6559;Nykštukas;ŽIRNIUKAI;1616644404;Taip;4;2;1;7
6560;Nykštukas;ŽIRNIUKAI;9270615518;Taip;5;2;0;7
6561;Nykštukas;ŽIRNIUKAI;2078586374;Taip;6;0;0;6
6562;Ozas;Smalsučiai;2641398988;Taip;7;2;0;9
6563;Ozas;Smalsučiai;9227939420;Ne;4;0;0;4
6564;Ozas;Smalsučiai;87218067796;Taip;32;1;0;33
6565;Ozas;Smalsučiai;4397034031;Taip;4;4;1;9
6566;Ozas;Smalsučiai;1974320330;Taip;4;2;0;6
6567;Ozas;Smalsučiai;1173284700;Taip;10;0;0;10
6568;Ozas;Smalsučiai;67987032400;Taip;5;0;0;5
6569;Ozas;Smalsučiai;71695973592;Ne;5;1;2;8
6570;Ozas;Smalsučiai;57069047630;Ne;5;1;9;15
6571;Ozas;Smalsučiai;3326395879;Taip;0;1;0;1
6572;Ozas;Smalsučiai;5150746885;Taip;9;7;0;16
6573;Ozas;Smalsučiai;1893257809;Taip;0;0;1;1
6574;Ozas;Smalsučiai;6540803077;Taip;9;1;0;10
6575;Ozas;Smalsučiai;8072802467;Taip;8;0;0;8
6576;Ozas;Smalsučiai;1248092034;Ne;1;1;2;4
6577;Ozas;Smalsučiai;43381497677;Taip;10;1;1;12
6578;Ozas;Smalsučiai;7351651916;Taip;4;0;0;4
6579;Ozas;Smalsučiai;3286170280;Taip;7;1;0;8
6580;Ozas;Smalsučiai;9521048381;Taip;15;1;1;17
6581;Ozas;Smalsučiai;2053832360;Taip;4;0;4;8
6582;Ozas;Smalsučiai;9905575489;Taip;4;0;0;4
6583;Ozas;Smalsučiai;5342394742;Taip;7;1;0;8
6584;Ozas;Drugeliai;7802699257;Taip;0;0;2;2
6585;Ozas;Drugeliai;6668470892;Ne;0;1;4;5
6586;Ozas;Drugeliai;2302999759;Taip;0;2;0;2
6587;Ozas;Drugeliai;8088330187;Taip;0;12;0;12
6588;Ozas;Drugeliai;9073973849;Taip;8;1;3;12
6589;Ozas;Drugeliai;9322806566;Taip;9;5;0;14
6590;Ozas;Drugeliai;2676747542;Taip;0;1;21;22
6591;Ozas;Drugeliai;2812687451;Taip;18;1;0;19
6592;Ozas;Drugeliai;4726019355;Taip;12;1;0;13
6593;Ozas;Drugeliai;9987863302;Taip;4;8;0;12
6594;Ozas;Drugeliai;2980799420;Taip;20;1;0;21
6595;Ozas;Drugeliai;1793692289;Ne;10;0;0;10
6596;Ozas;Drugeliai;8318380547;Taip;7;5;0;12
6597;Ozas;Drugeliai;4884054504;Ne;7;0;0;7
6598;Ozas;Drugeliai;43660054250;Taip;0;19;0;19
6599;Ozas;Drugeliai;15262583232;Taip;6;9;0;15
6600;Ozas;Drugeliai;1103685699;Taip;6;4;0;10
6601;Ozas;Drugeliai;1335655483;Taip;11;1;1;13
6602;Ozas;Drugeliai;4207160323;Taip;21;1;0;22
6603;Ozas;Drugeliai;1837947633;Taip;4;0;0;4
6604;Ozas;Boružėlės;1348960421;Ne;0;3;9;12
6605;Ozas;Boružėlės;1375643969;Ne;0;1;8;9
6606;Ozas;Boružėlės;63852147122;Taip;4;1;2;7
6607;Ozas;Boružėlės;8190314087;Taip;16;1;0;17
6608;Ozas;Boružėlės;3803998816;Taip;8;1;0;9
6609;Ozas;Boružėlės;1212358423;Taip;15;0;0;15
6610;Ozas;Boružėlės;7615907271;Ne;6;3;0;9
6611;Ozas;Boružėlės;1560342499;Taip;7;2;0;9
6612;Ozas;Boružėlės;8529654920;Taip;3;3;0;6
6613;Ozas;Boružėlės;2527574646;Taip;12;5;0;17
6614;Ozas;Boružėlės;9773251894;Ne;0;1;3;4
6615;Ozas;Boružėlės;36523514229;Taip;0;6;0;6
6616;Ozas;Boružėlės;1367050160;Ne;9;1;0;10
6617;Ozas;Boružėlės;2678629892;Taip;0;1;7;8
6618;Ozas;Boružėlės;1826499734;Taip;8;2;1;11
6619;Ozas;Boružėlės;6432357144;Taip;5;3;3;11
6620;Ozas;Boružėlės;1498656201;Taip;0;9;0;9
6621;Ozas;Boružėlės;9130645878;Taip;3;3;9;15
6622;Ozas;Boružėlės;60194872867;Taip;4;3;0;7
6623;Ozas;Boružėlės;7172573921;Taip;12;2;0;14
6624;Ozas;Boružėlės;1109113859;Taip;8;0;0;8
6625;Ozas;Boružėlės;1682529482;Taip;4;3;0;7
6626;Ozas;Boružėlės;68364031736;Taip;3;2;0;5
6627;Ozas;Žiogeliai;7461521320;Taip;4;5;0;9
6628;Ozas;Žiogeliai;6257625501;Taip;8;1;0;9
6629;Ozas;Žiogeliai;7402290524;Taip;10;0;0;10
6630;Ozas;Žiogeliai;1562277866;Taip;4;0;3;7
6631;Ozas;Žiogeliai;4571583671;Taip;4;1;1;6
6632;Ozas;Žiogeliai;5682027094;Taip;0;8;14;22
6633;Ozas;Žiogeliai;4966355020;Taip;9;0;1;10
6634;Ozas;Žiogeliai;3770045761;Taip;4;0;0;4
6635;Ozas;Žiogeliai;9324647606;Ne;18;1;0;19
6636;Ozas;Žiogeliai;9392526836;Taip;4;1;0;5
6637;Ozas;Žiogeliai;4942550213;Taip;14;0;0;14
6638;Ozas;Žiogeliai;8676986286;Taip;16;0;0;16
6639;Ozas;Žiogeliai;2345112767;Taip;5;2;0;7
6640;Ozas;Žiogeliai;5420952391;Taip;13;4;0;17
6641;Ozas;Žiogeliai;9929822317;Ne;6;0;0;6
6642;Ozas;Žiogeliai;2837228320;Taip;4;0;0;4
6643;Ozas;Žiogeliai;5156383727;Taip;0;8;0;8
6644;Ozas;Žiogeliai;2617258206;Ne;8;6;1;15
6645;Ozas;Žiogeliai;9768754737;Ne;0;9;0;9
6646;Ozas;Žiogeliai;7264789334;Taip;5;0;0;5
6647;Ozas;Bitutės;4220780257;Taip;15;1;2;18
6648;Ozas;Bitutės;1161776624;Taip;15;1;0;16
6649;Ozas;Bitutės;4227555342;Taip;2;0;1;3
6650;Ozas;Bitutės;7499756171;Taip;0;18;0;18
6651;Ozas;Bitutės;2705294874;Taip;7;0;2;9
6652;Ozas;Bitutės;2369544599;Taip;5;2;0;7
6653;Ozas;Bitutės;3329391600;Taip;5;1;1;7
6654;Ozas;Bitutės;4254601638;Taip;4;0;1;5
6655;Ozas;Bitutės;4699369567;Taip;0;0;1;1
6656;Ozas;Bitutės;8304671844;Ne;15;4;0;19
6657;Ozas;Bitutės;5968428143;Ne;5;3;1;9
6658;Ozas;Bitutės;9772085405;Taip;0;2;0;2
6659;Ozas;Bitutės;7051699003;Ne;0;1;6;7
6660;Ozas;Bitutės;5383877034;Taip;0;4;7;11
6661;Ozas;Bitutės;1117208248;Taip;15;1;4;20
6662;Ozas;Bitutės;6811181735;Taip;18;1;0;19
6663;Ozas;Bitutės;8622621570;Taip;12;0;0;12
6664;Ozas;Bitutės;4260123123;Taip;8;0;1;9
6665;Ozas;Bitutės;7494307084;Taip;14;4;0;18
6666;Ozas;Bitutės;1895519949;Taip;6;0;1;7
6667;Ozas;Aitvarėliai;1144679735;Taip;15;0;0;15
6668;Ozas;Aitvarėliai;2773182934;Taip;0;0;1;1
6669;Ozas;Aitvarėliai;4357737538;Taip;4;0;1;5
6670;Ozas;Aitvarėliai;1045890394;Taip;12;2;1;15
6671;Ozas;Aitvarėliai;7686706482;Taip;7;3;0;10
6672;Ozas;Aitvarėliai;2395567376;Taip;6;0;3;9
6673;Ozas;Aitvarėliai;2922370952;Taip;3;0;0;3
6674;Ozas;Aitvarėliai;5383739203;Taip;3;1;0;4
6675;Ozas;Aitvarėliai;4583818638;Taip;14;0;0;14
6676;Ozas;Aitvarėliai;1543683077;Taip;8;0;0;8
6677;Ozas;Aitvarėliai;2165291778;Taip;11;6;0;17
6678;Ozas;Aitvarėliai;8754244281;Taip;22;0;0;22
6679;Ozas;Aitvarėliai;6646671212;Taip;10;0;1;11
6680;Ozas;Aitvarėliai;9443843603;Taip;12;1;0;13
6681;Ozas;Aitvarėliai;3238019756;Taip;9;8;0;17
6682;Ozas;Aitvarėliai;8987796218;Taip;17;5;0;22
6683;Ozas;Aitvarėliai;2544858937;Taip;13;1;0;14
6684;Ozas;Aitvarėliai;3783477511;Ne;11;8;0;19
6685;Ozas;Aitvarėliai;6778987483;Ne;0;5;7;12
6686;Ozas;Aitvarėliai;4891451748;Ne;0;7;0;7
6687;Ozas;Aitvarėliai;7009893338;Ne;5;0;2;7
6688;Ozas;Voveraitės;8178298861;Taip;0;0;10;10
6689;Ozas;Voveraitės;6263062055;Taip;22;0;0;22
6690;Ozas;Voveraitės;9195536968;Taip;7;8;8;23
6691;Ozas;Voveraitės;2991511872;Taip;14;1;0;15
6692;Ozas;Voveraitės;5016547315;Taip;11;0;0;11
6693;Ozas;Voveraitės;1564826076;Taip;10;4;1;15
6694;Ozas;Voveraitės;2511477658;Taip;10;8;1;19
6695;Ozas;Voveraitės;1240233169;Taip;6;6;0;12
6696;Ozas;Voveraitės;6088757991;Taip;9;2;1;12
6697;Ozas;Voveraitės;5822871838;Taip;4;2;3;9
6698;Ozas;Voveraitės;2635045515;Taip;10;2;1;13
6699;Ozas;Voveraitės;6499549095;Taip;4;1;0;5
6700;Ozas;Voveraitės;6666591428;Taip;10;5;0;15
6701;Ozas;Voveraitės;2297650260;Taip;14;2;0;16
6702;Ozas;Voveraitės;7908028909;Taip;10;1;0;11
6703;Ozas;Voveraitės;9762737217;Taip;8;4;2;14
6704;Ozas;Voveraitės;7421484648;Ne;13;0;9;22
6705;Ozas;Voveraitės;1997125531;Taip;10;2;2;14
6706;Ozas;Voveraitės;6053885086;Taip;1;1;0;2
6707;Ozas;Voveraitės;7978092840;Taip;0;1;3;4
6708;Ozas;Voveraitės;5751808248;Ne;10;0;1;11
6709;Ozas;Voveraitės;4556076744;Taip;6;2;7;15
6710;Ozas;Voveraitės;8503041003;Taip;0;0;5;5
6711;Ozas;Kodelčiukai;8743467101;Taip;4;2;0;6
6712;Ozas;Kodelčiukai;2964318343;Taip;0;1;0;1
6713;Ozas;Kodelčiukai;8696127374;Taip;4;1;0;5
6714;Ozas;Kodelčiukai;3704303636;Taip;7;2;0;9
6715;Ozas;Kodelčiukai;2573702751;Taip;4;0;0;4
6716;Ozas;Kodelčiukai;3412369198;Taip;15;3;0;18
6717;Ozas;Kodelčiukai;2951875705;Taip;3;2;0;5
6718;Ozas;Kodelčiukai;7305274617;Taip;14;3;0;17
6719;Ozas;Kodelčiukai;9306887706;Taip;22;0;0;22
6720;Ozas;Kodelčiukai;9084187344;Taip;12;1;0;13
6721;Ozas;Kodelčiukai;1348751454;Taip;16;0;0;16
6722;Ozas;Kodelčiukai;9322080266;Taip;16;1;0;17
6723;Ozas;Kodelčiukai;6809992664;Taip;18;0;0;18
6724;Ozas;Kodelčiukai;4516291572;Ne;19;1;0;20
6725;Ozas;Kodelčiukai;4287719751;Taip;7;5;0;12
6726;Ozas;Kodelčiukai;9620747099;Taip;14;0;0;14
6727;Ozas;Kodelčiukai;5216695220;Taip;8;0;0;8
6728;Ozas;Kodelčiukai;8779047802;Taip;9;0;0;9
6729;Ozas;Kodelčiukai;6783755555;Taip;4;4;0;8
6730;Ozas;Kodelčiukai;8222112564;Ne;9;5;0;14
6731;Ozas;Pelėdžiukai;4640897674;Taip;0;1;0;1
6732;Ozas;Pelėdžiukai;9277208213;Taip;9;0;1;10
6733;Ozas;Pelėdžiukai;2281337233;Taip;7;0;1;8
6734;Ozas;Pelėdžiukai;8040293681;Ne;4;0;5;9
6735;Ozas;Pelėdžiukai;1856258542;Taip;1;0;0;1
6736;Ozas;Pelėdžiukai;5922569280;Taip;7;0;2;9
6737;Ozas;Pelėdžiukai;7640409923;Taip;4;4;0;8
6738;Ozas;Pelėdžiukai;4601869799;Taip;0;1;2;3
6739;Ozas;Pelėdžiukai;5958055645;Ne;13;0;1;14
6740;Ozas;Pelėdžiukai;7125754645;Taip;10;3;1;14
6741;Ozas;Pelėdžiukai;2824133388;Taip;15;0;0;15
6742;Ozas;Pelėdžiukai;2637531106;Taip;0;0;1;1
6743;Ozas;Pelėdžiukai;7287989663;Taip;0;0;3;3
6744;Ozas;Pelėdžiukai;6819000895;Taip;13;0;0;13
6745;Ozas;Pelėdžiukai;5950860889;Taip;7;0;1;8
6746;Ozas;Pelėdžiukai;4886045470;Taip;13;0;0;13
6747;Ozas;Pelėdžiukai;3212050416;Taip;6;5;3;14
6748;Ozas;Pelėdžiukai;3725141591;Taip;6;0;0;6
6749;Ozas;Pelėdžiukai;3711403511;Taip;14;0;4;18
6750;Ozas;Pelėdžiukai;5392929222;Taip;22;0;0;22
6751;Ozas;Pelėdžiukai;7038928164;Ne;13;0;0;13
6752;Ozas;Pelėdžiukai;8131525146;Taip;18;0;0;18
6753;Ozas;"Kačiukai ";4857216527;Taip;3;0;0;3
6754;Ozas;"Kačiukai ";7776754188;Taip;11;0;5;16
6755;Ozas;"Kačiukai ";5097380041;Ne;4;0;0;4
6756;Ozas;"Kačiukai ";2522810593;Taip;10;0;0;10
6757;Ozas;"Kačiukai ";3109261153;Taip;5;1;1;7
6758;Ozas;"Kačiukai ";9781398468;Taip;18;0;4;22
6759;Ozas;"Kačiukai ";8488500486;Taip;3;0;0;3
6760;Ozas;"Kačiukai ";7803356246;Taip;0;0;16;16
6761;Ozas;"Kačiukai ";2512535949;Ne;15;0;0;15
6762;Ozas;"Kačiukai ";4595986358;Taip;0;1;2;3
6763;Ozas;"Kačiukai ";5421245991;Taip;0;0;1;1
6764;Ozas;"Kačiukai ";9781527964;Taip;14;3;0;17
6765;Ozas;"Kačiukai ";6456146804;Taip;5;0;0;5
6766;Ozas;"Kačiukai ";4514798132;Taip;0;8;4;12
6767;Ozas;"Kačiukai ";9655492678;Taip;0;0;10;10
6768;Ozas;"Kačiukai ";2729524188;Taip;7;0;0;7
6769;Ozas;Ančiukų;3037323341;Taip;0;12;0;12
6770;Ozas;Ančiukų;2869987587;Taip;9;0;4;13
6771;Ozas;Ančiukų;5926100815;Taip;14;0;2;16
6772;Ozas;Ančiukų;2248812743;Taip;0;0;6;6
6773;Ozas;Ančiukų;2454569369;Taip;7;1;1;9
6774;Ozas;Ančiukų;3133776891;Taip;9;1;0;10
6775;Ozas;Ančiukų;2139224651;Taip;9;1;4;14
6776;Ozas;Ančiukų;8713970306;Taip;9;0;3;12
6777;Ozas;Ančiukų;2819545359;Taip;14;0;0;14
6778;Ozas;Ančiukų;1803782282;Taip;9;0;0;9
6779;Ozas;Ančiukų;5172367556;Taip;5;6;0;11
6780;Ozas;Ančiukų;5677543279;Taip;13;0;1;14
6781;Ozas;Ančiukų;8923372952;Taip;0;0;3;3
6782;Ozas;Ančiukų;7617839839;Taip;9;5;0;14
6783;Ozas;Ančiukų;9506090620;Taip;7;5;2;14
6784;Ozas;Nykškukų;3139289643;Taip;1;2;0;3
6785;Ozas;Nykškukų;7585213159;Taip;12;0;0;12
6786;Ozas;Nykškukų;6392066805;Taip;3;0;1;4
6787;Ozas;Nykškukų;6346123124;Taip;13;0;7;20
6788;Ozas;Nykškukų;3902722274;Ne;1;0;0;1
6789;Ozas;Nykškukų;7922667688;Taip;0;0;7;7
6790;Ozas;Nykškukų;8781771299;Taip;3;0;0;3
6791;Ozas;Nykškukų;3817138493;Taip;22;0;0;22
6792;Ozas;Nykškukų;8371368881;Taip;4;0;0;4
6793;Ozas;Nykškukų;4994121247;Taip;0;2;1;3
6794;Ozas;Nykškukų;6315443248;Taip;1;7;0;8
6795;Ozas;Nykškukų;6318419889;Ne;16;0;1;17
6796;Ozas;Nykškukų;6186850614;Taip;19;0;0;19
6797;Ozas;Nykškukų;5182160089;Taip;12;0;2;14
6798;Ozas;Nykškukų;1536889312;Taip;5;5;0;10
6799;Pabiručiai;Voveriukų;4539246865;Taip;0;0;3;3
6800;Pabiručiai;Voveriukų;1498738549;Taip;11;0;0;11
6801;Pabiručiai;Voveriukų;2349337471;Taip;0;2;0;2
6802;Pabiručiai;Voveriukų;9564303781;Taip;0;0;4;4
6803;Pabiručiai;Voveriukų;4312364951;Taip;9;3;0;12
6804;Pabiručiai;Voveriukų;3756731363;Ne;8;0;5;13
6805;Pabiručiai;Voveriukų;7985360502;Taip;3;0;0;3
6806;Pabiručiai;Voveriukų;3936426174;Taip;0;0;3;3
6807;Pabiručiai;Voveriukų;4069564285;Taip;0;10;0;10
6808;Pabiručiai;Voveriukų;7403996266;Ne;17;0;0;17
6809;Pabiručiai;Voveriukų;7278334800;Taip;6;1;0;7
6810;Pabiručiai;Voveriukų;9468698553;Taip;0;0;1;1
6811;Pabiručiai;Voveriukų;5232678556;Ne;8;1;0;9
6812;Pabiručiai;Voveriukų;7066037017;Taip;5;3;0;8
6813;Pabiručiai;Voveriukų;5549851164;Taip;0;5;0;5
6814;Pabiručiai;Voveriukų;4040533883;Taip;0;7;0;7
6815;Pabiručiai;Voveriukų;2514312233;Taip;0;6;0;6
6816;Pabiručiai;Voveriukų;7606274875;Taip;0;6;0;6
6817;Pabiručiai;Voveriukų;9356327400;Taip;0;0;2;2
6818;Pabiručiai;Voveriukų;4813206044;Taip;8;6;0;14
6819;Pabiručiai;Voveriukų;7846758352;Taip;0;2;0;2
6820;Pabiručiai;Boružiukų;6401188653;Taip;0;4;0;4
6821;Pabiručiai;Boružiukų;1673473814;Taip;10;2;0;12
6822;Pabiručiai;Boružiukų;5686769648;Taip;0;10;0;10
6823;Pabiručiai;Boružiukų;7524993271;Ne;5;3;3;11
6824;Pabiručiai;Boružiukų;5708597471;Taip;5;1;0;6
6825;Pabiručiai;Boružiukų;7046122545;Taip;0;8;0;8
6826;Pabiručiai;Boružiukų;3096466200;Taip;0;9;0;9
6827;Pabiručiai;Boružiukų;4301904533;Taip;0;2;0;2
6828;Pabiručiai;Boružiukų;8175565139;Taip;5;0;0;5
6829;Pabiručiai;Boružiukų;8236964683;Taip;2;6;0;8
6830;Pabiručiai;Boružiukų;1240057541;Taip;0;5;0;5
6831;Pabiručiai;Boružiukų;1671027282;Ne;9;4;0;13
6832;Pabiručiai;Boružiukų;3759350345;Taip;0;2;0;2
6833;Pabiručiai;Boružiukų;3151360288;Taip;5;3;0;8
6834;Pabiručiai;Boružiukų;9299393363;Taip;15;7;0;22
6835;Pabiručiai;Boružiukų;1484291546;Taip;4;1;0;5
6836;Pabiručiai;Boružiukų;2771769336;Taip;10;2;0;12
6837;Pabiručiai;Boružiukų;2607840684;Taip;11;3;0;14
6838;Pabiručiai;Boružiukų;4681771534;Taip;0;3;0;3
6839;Pabiručiai;Boružiukų;7050339198;Taip;18;1;0;19
6840;Pabiručiai;Katinėlių;8284711578;Ne;10;1;0;11
6841;Pabiručiai;Katinėlių;8710389714;Taip;5;0;0;5
6842;Pabiručiai;Katinėlių;1670938208;Taip;10;1;2;13
6843;Pabiručiai;Katinėlių;3756365293;Taip;5;1;0;6
6844;Pabiručiai;Katinėlių;6283372742;Taip;7;1;0;8
6845;Pabiručiai;Katinėlių;4205107384;Taip;4;0;2;6
6846;Pabiručiai;Katinėlių;4501176225;Taip;0;11;0;11
6847;Pabiručiai;Katinėlių;1749155319;Ne;7;3;1;11
6848;Pabiručiai;Katinėlių;2572570925;Taip;5;0;0;5
6849;Pabiručiai;Katinėlių;34883375155;Taip;8;1;0;9
6850;Pabiručiai;Katinėlių;8306688649;Taip;4;1;1;6
6851;Pabiručiai;Katinėlių;1705085006;Taip;9;0;0;9
6852;Pabiručiai;Katinėlių;58112415466;Ne;14;1;2;17
6853;Pabiručiai;Katinėlių;42877891797;Taip;5;4;0;9
6854;Pabiručiai;Katinėlių;6285940478;Taip;0;3;3;6
6855;Pabiručiai;Katinėlių;1122183123;Taip;0;1;6;7
6856;Pabiručiai;Žiogelių;6548776238;Taip;0;1;21;22
6857;Pabiručiai;Žiogelių;3272576627;Taip;10;1;1;12
6858;Pabiručiai;Žiogelių;5522447437;Taip;0;0;2;2
6859;Pabiručiai;Žiogelių;3585198013;Taip;0;3;0;3
6860;Pabiručiai;Žiogelių;7974345478;Taip;7;2;0;9
6861;Pabiručiai;Žiogelių;3206962828;Ne;10;1;2;13
6862;Pabiručiai;Žiogelių;3355875364;Taip;0;2;0;2
6863;Pabiručiai;Žiogelių;5311762824;Taip;4;1;4;9
6864;Pabiručiai;Žiogelių;1587905929;Taip;3;1;13;17
6865;Pabiručiai;Žiogelių;7085036701;Taip;0;9;0;9
6866;Pabiručiai;Žiogelių;8367889753;Taip;0;1;0;1
6867;Pabiručiai;Žiogelių;8736658575;Taip;0;11;0;11
6868;Pabiručiai;Žiogelių;8106446562;Taip;11;5;0;16
6869;Pabiručiai;Žiogelių;8421025940;Taip;3;1;2;6
6870;Pabiručiai;Žiogelių;1311650644;Taip;0;3;0;3
6871;Pabiručiai;Žiogelių;3028063887;Taip;15;1;0;16
6872;Pabiručiai;Smalsiukai;2869383175;Taip;6;6;0;12
6873;Pabiručiai;Smalsiukai;7677235214;Taip;15;0;1;16
6874;Pabiručiai;Smalsiukai;9676561758;Ne;0;10;0;10
6875;Pabiručiai;Smalsiukai;7632969321;Ne;0;12;0;12
6876;Pabiručiai;Smalsiukai;7090116276;Taip;11;0;2;13
6877;Pabiručiai;Smalsiukai;4408666547;Taip;3;3;0;6
6878;Pabiručiai;Smalsiukai;9093137227;Taip;14;0;0;14
6879;Pabiručiai;Smalsiukai;6935913132;Ne;15;1;0;16
6880;Pabiručiai;Smalsiukai;1344711015;Taip;15;1;0;16
6881;Pabiručiai;Smalsiukai;7663581089;Taip;0;2;0;2
6882;Pabiručiai;Smalsiukai;7248314871;Taip;4;0;0;4
6883;Pabiručiai;Smalsiukai;9610623364;Taip;13;0;0;13
6884;Pabiručiai;Smalsiukai;8897462614;Taip;11;1;0;12
6885;Pabiručiai;Smalsiukai;2332338995;Taip;20;0;0;20
6886;Pabiručiai;Smalsiukai;4258226042;Ne;0;11;0;11
6887;Pabiručiai;Smalsiukai;3511851810;Taip;3;2;0;5
6888;Pabiručiai;Smalsiukai;6686039601;Taip;19;2;2;23
6889;Pabiručiai;Smalsiukai;5420231066;Taip;0;1;1;2
6890;Pabiručiai;Smalsiukai;8840885039;Taip;10;3;0;13
6891;Pabiručiai;Smalsiukai;9779260044;Taip;10;0;0;10
6892;Pabiručiai;Smalsiukai;2771891999;Taip;8;0;0;8
6893;Pabiručiai;Smalsiukai;7295052694;Ne;0;9;0;9
6894;Pabiručiai;Kiškučiai;3368607302;Taip;10;3;0;13
6895;Pabiručiai;Kiškučiai;9589005897;Taip;0;17;0;17
6896;Pabiručiai;Kiškučiai;6648966721;Taip;12;0;0;12
6897;Pabiručiai;Kiškučiai;9353062804;Taip;8;6;0;14
6898;Pabiručiai;Kiškučiai;1582754284;Taip;5;0;0;5
6899;Pabiručiai;Kiškučiai;4462744848;Ne;0;14;0;14
6900;Pabiručiai;Kiškučiai;5621183663;Taip;5;1;0;6
6901;Pabiručiai;Kiškučiai;5497318373;Taip;0;1;0;1
6902;Pabiručiai;Kiškučiai;1515270273;Taip;0;1;0;1
6903;Pabiručiai;Kiškučiai;2688728915;Taip;10;12;0;22
6904;Pabiručiai;Kiškučiai;5166525832;Taip;13;0;0;13
6905;Pabiručiai;Kiškučiai;8409455566;Taip;0;8;0;8
6906;Pabiručiai;Kiškučiai;5346249456;Taip;0;3;0;3
6907;Pabiručiai;Kiškučiai;5717534175;Taip;0;12;0;12
6908;Pabiručiai;Kiškučiai;3408518493;Taip;0;7;0;7
6909;Pabiručiai;Kiškučiai;7653129291;Taip;0;2;0;2
6910;Pabiručiai;Kiškučiai;7073230645;Taip;7;2;0;9
6911;Pabiručiai;Kiškučiai;8820585407;Taip;0;4;0;4
6912;Pabiručiai;Kiškučiai;7572077461;Taip;15;4;0;19
6913;Pabiručiai;Kiškučiai;5767879226;Taip;4;2;0;6
6914;Pabiručiai;"Pėledžiukai ";9834824219;Taip;0;17;0;17
6915;Pabiručiai;"Pėledžiukai ";6831569546;Taip;16;0;0;16
6916;Pabiručiai;"Pėledžiukai ";1683369842;Ne;6;0;0;6
6917;Pabiručiai;"Pėledžiukai ";7478484190;Taip;6;0;0;6
6918;Pabiručiai;"Pėledžiukai ";7961879916;Taip;0;3;0;3
6919;Pabiručiai;"Pėledžiukai ";9050994322;Taip;21;2;0;23
6920;Pabiručiai;"Pėledžiukai ";1049154287;Taip;6;0;0;6
6921;Pabiručiai;"Pėledžiukai ";6697518151;Taip;27;2;0;29
6922;Pabiručiai;"Pėledžiukai ";2596301235;Taip;22;1;2;25
6923;Pabiručiai;"Pėledžiukai ";4333645528;Taip;9;1;0;10
6924;Pabiručiai;"Pėledžiukai ";6289025538;Taip;5;10;0;15
6925;Pabiručiai;"Pėledžiukai ";2812291058;Taip;0;0;2;2
6926;Pabiručiai;"Pėledžiukai ";2343561322;Taip;5;0;0;5
6927;Pabiručiai;"Pėledžiukai ";3674583662;Taip;8;1;0;9
6928;Pabiručiai;"Pėledžiukai ";8268101318;Taip;0;7;0;7
6929;Pabiručiai;"Pėledžiukai ";2147165934;Taip;14;0;0;14
6930;Pabiručiai;"Pėledžiukai ";7385149524;Taip;13;1;0;14
6931;Pabiručiai;"Pėledžiukai ";7203091216;Taip;9;0;0;9
6932;Pabiručiai;"Pėledžiukai ";3224195892;Ne;17;0;0;17
6933;Pabiručiai;"Kodelčiūkai ";5950654594;Taip;0;5;0;5
6934;Pabiručiai;"Kodelčiūkai ";8775727677;Taip;0;0;3;3
6935;Pabiručiai;"Kodelčiūkai ";4317656984;Taip;17;0;0;17
6936;Pabiručiai;"Kodelčiūkai ";2295503584;Ne;9;11;0;20
6937;Pabiručiai;"Kodelčiūkai ";4595458527;Taip;7;0;0;7
6938;Pabiručiai;"Kodelčiūkai ";8716879106;Taip;10;1;0;11
6939;Pabiručiai;"Kodelčiūkai ";9067653417;Taip;21;0;3;24
6940;Pabiručiai;"Kodelčiūkai ";5247780866;Taip;15;0;0;15
6941;Pabiručiai;"Kodelčiūkai ";3433419710;Taip;16;0;2;18
6942;Pabiručiai;"Kodelčiūkai ";6386335808;Taip;8;0;9;17
6943;Pabiručiai;"Kodelčiūkai ";5010271037;Taip;6;1;0;7
6944;Pabiručiai;"Kodelčiūkai ";9538339883;Ne;11;0;0;11
6945;Pabiručiai;"Kodelčiūkai ";8149732126;Taip;0;0;6;6
6946;Pabiručiai;"Kodelčiūkai ";7289131864;Taip;6;3;0;9
6947;Pabiručiai;"Kodelčiūkai ";6209553290;Ne;22;0;0;22
6948;Pabiručiai;"Kodelčiūkai ";5913022147;Ne;12;0;2;14
6949;Pabiručiai;"Kodelčiūkai ";3748657353;Ne;3;0;0;3
6950;Pabiručiai;"Kodelčiūkai ";3497466298;Taip;12;3;0;15
6951;Pabiručiai;"Kodelčiūkai ";8179285338;Taip;8;4;0;12
6952;Pabiručiai;"Kodelčiūkai ";1234230729;Ne;8;0;2;10
6953;Pabiručiai;"Peliukų ";3702521810;Taip;15;0;0;15
6954;Pabiručiai;"Peliukų ";4894380231;Taip;13;0;3;16
6955;Pabiručiai;"Peliukų ";1947729077;Taip;15;0;0;15
6956;Pabiručiai;"Peliukų ";6678717039;Taip;10;6;0;16
6957;Pabiručiai;"Peliukų ";7182565608;Taip;24;2;0;26
6958;Pabiručiai;"Peliukų ";1776325000;Taip;22;0;0;22
6959;Pabiručiai;"Peliukų ";1099080685;Taip;0;12;0;12
6960;Pabiručiai;"Peliukų ";9890225918;Taip;0;0;7;7
6961;Pabiručiai;"Peliukų ";7644854044;Taip;13;0;0;13
6962;Pabiručiai;"Peliukų ";3826505104;Taip;7;0;1;8
6963;Pabiručiai;"Peliukų ";1971996148;Taip;5;0;0;5
6964;Pabiručiai;"Peliukų ";4852287574;Taip;8;0;0;8
6965;Pabiručiai;"Peliukų ";1206012259;Taip;0;8;0;8
6966;Pabiručiai;"Peliukų ";9790360371;Taip;6;0;0;6
6967;Pabiručiai;"Peliukų ";7980170279;Taip;11;3;0;14
6968;Pabiručiai;"Peliukų ";9806520732;Taip;17;11;0;28
6969;Pabiručiai;"Peliukų ";5923385276;Taip;0;1;0;1
6970;Pabiručiai;"Viščiukų ";8254676845;Ne;11;5;0;16
6971;Pabiručiai;"Viščiukų ";6742744014;Taip;0;4;0;4
6972;Pabiručiai;"Viščiukų ";7339565412;Ne;14;0;0;14
6973;Pabiručiai;"Viščiukų ";4880717493;Taip;19;0;0;19
6974;Pabiručiai;"Viščiukų ";1138743823;Taip;8;2;0;10
6975;Pabiručiai;"Viščiukų ";3011601512;Taip;22;0;0;22
6976;Pabiručiai;"Viščiukų ";7798837336;Taip;12;0;0;12
6977;Pabiručiai;"Viščiukų ";7914642744;Taip;20;0;0;20
6978;Pabiručiai;"Viščiukų ";5737214746;Taip;12;1;0;13
6979;Pabiručiai;"Viščiukų ";2141365015;Ne;22;0;1;23
6980;Pabiručiai;"Viščiukų ";6361966325;Taip;12;0;0;12
6981;Pabiručiai;"Viščiukų ";6508093808;Ne;6;0;0;6
6982;Pabiručiai;"Viščiukų ";8649685325;Taip;9;0;0;9
6983;Pabiručiai;"Viščiukų ";4929129093;Ne;0;12;0;12
6984;Pabiručiai;"Drugelių ";6014791534;Taip;0;14;0;14
6985;Pabiručiai;"Drugelių ";9890868992;Ne;12;0;0;12
6986;Pabiručiai;"Drugelių ";3491721002;Ne;8;0;3;11
6987;Pabiručiai;"Drugelių ";2556330147;Taip;7;9;0;16
6988;Pabiručiai;"Drugelių ";3004152898;Taip;19;0;0;19
6989;Pabiručiai;"Drugelių ";5050966784;Taip;12;1;0;13
6990;Pabiručiai;"Drugelių ";5019580409;Taip;23;0;0;23
6991;Pabiručiai;"Drugelių ";3531292373;Taip;0;7;0;7
6992;Pabiručiai;"Drugelių ";7561916887;Taip;5;0;5;10
6993;Pabiručiai;"Drugelių ";8668524776;Taip;0;5;0;5
6994;Pabiručiai;"Drugelių ";9878655387;Taip;13;0;0;13
6995;Pabiručiai;"Drugelių ";4876140467;Taip;16;4;0;20
6996;Pabiručiai;"Drugelių ";6481162347;Taip;15;0;0;15
6997;Pabiručiai;"Drugelių ";4012537474;Taip;7;0;0;7
6998;Pabiručiai;"Drugelių ";4701982784;Taip;12;0;0;12
6999;Pabiručiai;"Drugelių ";5147367745;Taip;19;0;0;19
7000;Pabiručiai;ŽIRNIUKŲ;5704073222;Ne;12;4;0;16
7001;Pabiručiai;ŽIRNIUKŲ;1247522345;Taip;0;0;3;3
7002;Pabiručiai;ŽIRNIUKŲ;1852744763;Taip;0;0;14;14
7003;Pabiručiai;ŽIRNIUKŲ;6513943228;Ne;15;0;0;15
7004;Pabiručiai;ŽIRNIUKŲ;2794484633;Ne;5;1;0;6
7005;Pabiručiai;ŽIRNIUKŲ;8870657682;Ne;4;0;0;4
7006;Pabiručiai;ŽIRNIUKŲ;4096412988;Taip;0;2;0;2
7007;Pabiručiai;ŽIRNIUKŲ;8092886420;Ne;8;8;0;16
7008;Pabiručiai;ŽIRNIUKŲ;7873575929;Ne;14;5;0;19
7009;Pabiručiai;ŽIRNIUKŲ;5862643827;Ne;0;2;1;3
7010;Pabiručiai;ŽIRNIUKŲ;5184688482;Taip;18;0;1;19
7011;Pabiručiai;ŽIRNIUKŲ;4755427277;Taip;10;0;0;10
7012;Pabiručiai;ŽIRNIUKŲ;9507212682;Taip;8;0;0;8
7013;Pabiručiai;ŽIRNIUKŲ;9651695086;Taip;0;0;7;7
7014;Pabiručiai;ŽIRNIUKŲ;5899880680;Taip;18;0;1;19
7015;Pagrandukas;Saulytės;6915087488;Taip;7;4;0;11
7016;Pagrandukas;Saulytės;7605508460;Taip;3;8;0;11
7017;Pagrandukas;Saulytės;6349387692;Taip;7;0;0;7
7018;Pagrandukas;Saulytės;8186092469;Taip;0;7;0;7
7019;Pagrandukas;Saulytės;2934300533;Taip;17;0;0;17
7020;Pagrandukas;Saulytės;1548697124;Taip;9;1;0;10
7021;Pagrandukas;Saulytės;6711830251;Taip;22;0;0;22
7022;Pagrandukas;Saulytės;7146697128;Taip;10;0;0;10
7023;Pagrandukas;Saulytės;3157676207;Taip;3;5;0;8
7024;Pagrandukas;Saulytės;7511097160;Taip;0;17;0;17
7025;Pagrandukas;Saulytės;3783160018;Taip;12;0;0;12
7026;Pagrandukas;Saulytės;7454863899;Taip;5;0;0;5
7027;Pagrandukas;Saulytės;5560372136;Taip;0;1;0;1
7028;Pagrandukas;Saulytės;1766912463;Taip;5;9;0;14
7029;Pagrandukas;Saulytės;9849054467;Taip;3;14;0;17
7030;Pagrandukas;Saulytės;8024910647;Taip;5;4;0;9
7031;Pagrandukas;Saulytės;8481502330;Taip;0;5;0;5
7032;Pagrandukas;Saulytės;7160305478;Ne;4;5;0;9
7033;Pagrandukas;Saulytės;3008997793;Ne;0;10;0;10
7034;Pagrandukas;Saulytės;6388805960;Taip;5;0;13;18
7035;Pagrandukas;Saulytės;3050207849;Taip;0;3;0;3
7036;Pagrandukas;Saulytės;8836178193;Taip;7;1;0;8
7037;Pagrandukas;Saulytės;7157549179;Taip;12;0;0;12
7038;Pagrandukas;Zuikučiai;7834436515;Taip;0;3;0;3
7039;Pagrandukas;Zuikučiai;7435609306;Ne;10;0;0;10
7040;Pagrandukas;Zuikučiai;5903416384;Taip;10;3;3;16
7041;Pagrandukas;Zuikučiai;2439891231;Taip;6;2;1;9
7042;Pagrandukas;Zuikučiai;6710887776;Taip;6;2;1;9
7043;Pagrandukas;Zuikučiai;7665811353;Taip;5;0;0;5
7044;Pagrandukas;Zuikučiai;2711590019;Taip;0;0;1;1
7045;Pagrandukas;Zuikučiai;6449029299;Taip;0;0;3;3
7046;Pagrandukas;Zuikučiai;1405820070;Taip;7;1;0;8
7047;Pagrandukas;Zuikučiai;1054107640;Taip;0;11;0;11
7048;Pagrandukas;Zuikučiai;1885539883;Taip;0;3;0;3
7049;Pagrandukas;Zuikučiai;1795582354;Taip;19;1;0;20
7050;Pagrandukas;Zuikučiai;2822538227;Taip;0;3;1;4
7051;Pagrandukas;Zuikučiai;1587839122;Taip;19;0;0;19
7052;Pagrandukas;Zuikučiai;2101505576;Taip;0;0;10;10
7053;Pagrandukas;Zuikučiai;6765346578;Taip;5;0;1;6
7054;Pagrandukas;Zuikučiai;5922595170;Taip;12;0;0;12
7055;Pagrandukas;Zuikučiai;5030928303;Taip;3;9;0;12
7056;Pagrandukas;Zuikučiai;9139212151;Taip;0;3;6;9
7057;Pagrandukas;Zuikučiai;8643993939;Taip;0;4;0;4
7058;Pagrandukas;Zuikučiai;5021106231;Taip;7;0;0;7
7059;Pagrandukas;Zuikučiai;3494047045;Ne;0;5;0;5
7060;Pagrandukas;Boružėlių;3888408459;Ne;1;1;1;3
7061;Pagrandukas;Boružėlių;3398225200;Taip;0;6;0;6
7062;Pagrandukas;Boružėlių;5752454925;Taip;10;3;0;13
7063;Pagrandukas;Boružėlių;3587941684;Taip;3;4;3;10
7064;Pagrandukas;Boružėlių;5946007985;Ne;7;2;0;9
7065;Pagrandukas;Boružėlių;7770852445;Ne;5;2;0;7
7066;Pagrandukas;Boružėlių;6304701617;Taip;3;0;0;3
7067;Pagrandukas;Boružėlių;3953844737;Taip;0;5;0;5
7068;Pagrandukas;Boružėlių;7064391685;Taip;0;0;1;1
7069;Pagrandukas;Boružėlių;5640182548;Taip;0;4;0;4
7070;Pagrandukas;Boružėlių;1403569615;Taip;2;2;0;4
7071;Pagrandukas;Boružėlių;1998073387;Ne;0;2;0;2
7072;Pagrandukas;Boružėlių;5511396314;Taip;9;7;0;16
7073;Pagrandukas;Boružėlių;5648658237;Taip;0;7;0;7
7074;Pagrandukas;Boružėlių;9651789217;Ne;0;4;0;4
7075;Pagrandukas;Boružėlių;6911951786;Ne;0;9;0;9
7076;Pagrandukas;Boružėlių;2926077771;Ne;0;9;0;9
7077;Pagrandukas;Boružėlių;2361829423;Taip;0;1;1;2
7078;Pagrandukas;Boružėlių;8286183393;Taip;0;3;0;3
7079;Pagrandukas;Boružėlių;2549704540;Taip;9;1;0;10
7080;Pagrandukas;Boružėlių;9790803767;Ne;3;2;0;5
7081;Pagrandukas;Boružėlių;7043125057;Ne;9;2;0;11
7082;Pagrandukas;Bitutės;6044667668;Ne;13;1;0;14
7083;Pagrandukas;Bitutės;6315627367;Taip;4;0;0;4
7084;Pagrandukas;Bitutės;8529974367;Taip;22;0;0;22
7085;Pagrandukas;Bitutės;1938604743;Taip;0;3;0;3
7086;Pagrandukas;Bitutės;4079711515;Taip;7;8;0;15
7087;Pagrandukas;Bitutės;8625382465;Taip;0;0;1;1
7088;Pagrandukas;Bitutės;9188382746;Taip;5;0;14;19
7089;Pagrandukas;Bitutės;4603185679;Taip;5;0;0;5
7090;Pagrandukas;Bitutės;5613442667;Taip;7;0;1;8
7091;Pagrandukas;Bitutės;2923517578;Taip;4;17;0;21
7092;Pagrandukas;Bitutės;4322675634;Taip;0;3;0;3
7093;Pagrandukas;Bitutės;3875062228;Taip;0;1;3;4
7094;Pagrandukas;Bitutės;4405567649;Taip;3;2;0;5
7095;Pagrandukas;Bitutės;1583104760;Taip;9;1;0;10
7096;Pagrandukas;Bitutės;5649084353;Taip;9;2;0;11
7097;Pagrandukas;Bitutės;8719834064;Taip;5;3;5;13
7098;Pagrandukas;Bitutės;5821945401;Taip;0;0;15;15
7099;Pagrandukas;Bitutės;7675694987;Taip;7;1;4;12
7100;Pagrandukas;Bitutės;3709131197;Taip;0;2;0;2
7101;Pagrandukas;Bitutės;2098182423;Taip;4;1;0;5
7102;Pagrandukas;Bitutės;8280877177;Ne;0;1;7;8
7103;Pagrandukas;Bitutės;2764732768;Taip;5;0;0;5
7104;Pagrandukas;Pelėdžiukai;1714449109;Taip;10;2;0;12
7105;Pagrandukas;Pelėdžiukai;3160109801;Taip;7;3;1;11
7106;Pagrandukas;Pelėdžiukai;7764147734;Taip;1;2;0;3
7107;Pagrandukas;Pelėdžiukai;8633116370;Taip;1;2;0;3
7108;Pagrandukas;Pelėdžiukai;2877401332;Taip;6;1;0;7
7109;Pagrandukas;Pelėdžiukai;8167118045;Taip;15;0;0;15
7110;Pagrandukas;Pelėdžiukai;3390664086;Taip;3;4;3;10
7111;Pagrandukas;Pelėdžiukai;1733723373;Taip;11;0;0;11
7112;Pagrandukas;Pelėdžiukai;6011346969;Taip;12;0;0;12
7113;Pagrandukas;Pelėdžiukai;1077792535;Taip;5;3;0;8
7114;Pagrandukas;Pelėdžiukai;9583471280;Taip;5;3;0;8
7115;Pagrandukas;Pelėdžiukai;2481532396;Taip;9;2;0;11
7116;Pagrandukas;Pelėdžiukai;4398016119;Ne;7;0;0;7
7117;Pagrandukas;Pelėdžiukai;2640777376;Taip;11;0;0;11
7118;Pagrandukas;Pelėdžiukai;4910151924;Taip;9;2;1;12
7119;Pagrandukas;Pelėdžiukai;9431513632;Taip;4;1;0;5
7120;Pagrandukas;Pelėdžiukai;1977974235;Taip;18;0;0;18
7121;Pagrandukas;Pelėdžiukai;7238694532;Taip;0;5;1;6
7122;Pagrandukas;ŠYPSENĖLIŲ;4627387596;Taip;7;0;1;8
7123;Pagrandukas;ŠYPSENĖLIŲ;7173561328;Taip;5;0;0;5
7124;Pagrandukas;ŠYPSENĖLIŲ;1101989969;Taip;0;5;0;5
7125;Pagrandukas;ŠYPSENĖLIŲ;5701479990;Taip;22;0;0;22
7126;Pagrandukas;ŠYPSENĖLIŲ;6248684084;Taip;6;0;2;8
7127;Pagrandukas;ŠYPSENĖLIŲ;2904880156;Taip;7;0;0;7
7128;Pagrandukas;ŠYPSENĖLIŲ;5173633710;Taip;0;0;2;2
7129;Pagrandukas;ŠYPSENĖLIŲ;6057078416;Taip;0;0;3;3
7130;Pagrandukas;ŠYPSENĖLIŲ;1855833141;Taip;2;0;1;3
7131;Pagrandukas;ŠYPSENĖLIŲ;8475724797;Taip;2;0;1;3
7132;Pagrandukas;ŠYPSENĖLIŲ;5272914210;Taip;12;0;0;12
7133;Pagrandukas;ŠYPSENĖLIŲ;4094086585;Taip;12;1;0;13
7134;Pagrandukas;ŠYPSENĖLIŲ;6306635507;Taip;0;0;2;2
7135;Pagrandukas;ŠYPSENĖLIŲ;5060059491;Taip;0;0;1;1
7136;Pakalnutė;Pagrandukai;7475119623;Taip;0;2;0;2
7137;Pakalnutė;Pagrandukai;9677810607;Taip;0;22;0;22
7138;Pakalnutė;Pagrandukai;2015778005;Taip;5;0;0;5
7139;Pakalnutė;Pagrandukai;5275833872;Taip;9;4;0;13
7140;Pakalnutė;Pagrandukai;5943686565;Taip;5;0;0;5
7141;Pakalnutė;Pagrandukai;2296079246;Taip;28;0;0;28
7142;Pakalnutė;Pagrandukai;9313588621;Taip;15;0;1;16
7143;Pakalnutė;Pagrandukai;7962849592;Taip;4;1;0;5
7144;Pakalnutė;Pagrandukai;3794283102;Taip;10;0;0;10
7145;Pakalnutė;Pagrandukai;3070652992;Taip;5;3;0;8
7146;Pakalnutė;Pagrandukai;7477188659;Taip;5;2;0;7
7147;Pakalnutė;Pagrandukai;8522585063;Taip;0;3;1;4
7148;Pakalnutė;Pagrandukai;4390444128;Taip;3;0;0;3
7149;Pakalnutė;Pagrandukai;2642359967;Taip;9;1;0;10
7150;Pakalnutė;Pagrandukai;1614993691;Taip;10;0;0;10
7151;Pakalnutė;Pagrandukai;7417131378;Taip;7;0;1;8
7152;Pakalnutė;Pagrandukai;6396963609;Taip;18;0;0;18
7153;Pakalnutė;Pagrandukai;6708041407;Taip;5;0;2;7
7154;Pakalnutė;Pagrandukai;1883500676;Taip;5;3;0;8
7155;Pakalnutė;"Pelėdžiukų ";7110858765;Ne;5;0;1;6
7156;Pakalnutė;"Pelėdžiukų ";8553182620;Taip;15;0;2;17
7157;Pakalnutė;"Pelėdžiukų ";3840499737;Ne;20;0;1;21
7158;Pakalnutė;"Pelėdžiukų ";4523766424;Taip;10;0;4;14
7159;Pakalnutė;"Pelėdžiukų ";6577255841;Taip;0;22;0;22
7160;Pakalnutė;"Pelėdžiukų ";7151877991;Ne;0;0;6;6
7161;Pakalnutė;"Pelėdžiukų ";2992768162;Ne;12;3;0;15
7162;Pakalnutė;"Pelėdžiukų ";9505524183;Taip;17;0;0;17
7163;Pakalnutė;"Pelėdžiukų ";8823232039;Taip;7;0;1;8
7164;Pakalnutė;"Pelėdžiukų ";8900756351;Taip;3;0;0;3
7165;Pakalnutė;"Pelėdžiukų ";2035060922;Taip;0;0;2;2
7166;Pakalnutė;"Pelėdžiukų ";7325137583;Taip;0;0;1;1
7167;Pakalnutė;"Pelėdžiukų ";4220368864;Taip;3;0;1;4
7168;Pakalnutė;"Pelėdžiukų ";1330092247;Taip;3;8;2;13
7169;Pakalnutė;"Pelėdžiukų ";3267680599;Ne;16;0;0;16
7170;Pakalnutė;"Pelėdžiukų ";4452372238;Taip;7;0;1;8
7171;Pakalnutė;"Pelėdžiukų ";4353883274;Ne;5;0;1;6
7172;Pakalnutė;Ežiukai;5058727058;Taip;7;1;0;8
7173;Pakalnutė;Ežiukai;4052166895;Taip;8;0;0;8
7174;Pakalnutė;Ežiukai;1070172991;Ne;0;1;0;1
7175;Pakalnutė;Ežiukai;9323200833;Taip;9;3;0;12
7176;Pakalnutė;Ežiukai;9781993614;Taip;9;0;0;9
7177;Pakalnutė;Ežiukai;9256219647;Taip;0;1;0;1
7178;Pakalnutė;Ežiukai;7853479591;Taip;10;0;2;12
7179;Pakalnutė;Ežiukai;4317305712;Taip;7;0;0;7
7180;Pakalnutė;Ežiukai;7734657452;Taip;10;2;0;12
7181;Pakalnutė;Ežiukai;8081932074;Taip;17;0;0;17
7182;Pakalnutė;Ežiukai;9706455707;Taip;8;0;1;9
7183;Pakalnutė;Ežiukai;7881545979;Ne;8;4;0;12
7184;Pakalnutė;Ežiukai;8080989574;Taip;0;9;0;9
7185;Pakalnutė;Ežiukai;5911381706;Taip;18;2;1;21
7186;Pakalnutė;Ežiukai;2755412687;Taip;25;0;2;27
7187;Pakalnutė;Ežiukai;8236718590;Taip;0;7;2;9
7188;Pakalnutė;Skruzdėliukų;4033813807;Taip;19;3;0;22
7189;Pakalnutė;Skruzdėliukų;7503936754;Taip;7;0;0;7
7190;Pakalnutė;Skruzdėliukų;5409476517;Taip;10;11;0;21
7191;Pakalnutė;Skruzdėliukų;2670302354;Taip;13;0;0;13
7192;Pakalnutė;Skruzdėliukų;7105369111;Taip;19;0;0;19
7193;Pakalnutė;Skruzdėliukų;6944726166;Taip;18;0;0;18
7194;Pakalnutė;Skruzdėliukų;1195872320;Taip;15;3;0;18
7195;Pakalnutė;Skruzdėliukų;3211633472;Ne;0;2;0;2
7196;Pakalnutė;Skruzdėliukų;4423348418;Taip;9;2;0;11
7197;Pakalnutė;Skruzdėliukų;6055727963;Ne;5;3;0;8
7198;Pakalnutė;Skruzdėliukų;5619262190;Taip;12;0;0;12
7199;Pakalnutė;Skruzdėliukų;3215438452;Taip;9;0;0;9
7200;Pakalnutė;Skruzdėliukų;9681515221;Taip;12;0;0;12
7201;Pakalnutė;Skruzdėliukų;8496839980;Taip;10;3;0;13
7202;Pakalnutė;Skruzdėliukų;9336711927;Ne;12;3;0;15
7203;Pakalnutė;Skruzdėliukų;5356902834;Taip;8;1;0;9
7204;Pakalnutė;Skruzdėliukų;3288449407;Taip;10;0;0;10
7205;Pakalnutė;Skruzdėliukų;1540045675;Taip;9;0;0;9
7206;Pakalnutė;Bitučių;2993145079;Ne;9;3;0;12
7207;Pakalnutė;Bitučių;8461220770;Taip;0;1;0;1
7208;Pakalnutė;Bitučių;2367683002;Taip;5;1;0;6
7209;Pakalnutė;Bitučių;2765220889;Taip;7;6;0;13
7210;Pakalnutė;Bitučių;9445909071;Taip;10;1;0;11
7211;Pakalnutė;Bitučių;5532458706;Taip;17;0;0;17
7212;Pakalnutė;Bitučių;7526989580;Taip;7;3;0;10
7213;Pakalnutė;Bitučių;3306334576;Taip;11;0;0;11
7214;Pakalnutė;Bitučių;2095540372;Taip;7;0;0;7
7215;Pakalnutė;Bitučių;5342592825;Taip;9;0;0;9
7216;Pakalnutė;Bitučių;2932205226;Taip;8;0;0;8
7217;Pakalnutė;Bitučių;5464143742;Taip;19;2;0;21
7218;Pakalnutė;Bitučių;6351193702;Taip;6;1;0;7
7219;Pakalnutė;Bitučių;2070744110;Taip;6;1;0;7
7220;Pakalnutė;Bitučių;3965390135;Taip;5;6;0;11
7221;Pakalnutė;Bitučių;5355198213;Taip;10;5;0;15
7222;Pakalnutė;Bitučių;4533467194;Ne;0;5;0;5
7223;Pakalnutė;Bitučių;3583094831;Taip;0;3;0;3
7224;Pakalnutė;Boružiukų;5120176374;Ne;11;3;0;14
7225;Pakalnutė;Boružiukų;6798939288;Taip;11;5;0;16
7226;Pakalnutė;Boružiukų;7357431226;Taip;0;4;0;4
7227;Pakalnutė;Boružiukų;4934095931;Taip;0;3;0;3
7228;Pakalnutė;Boružiukų;5039000154;Taip;0;2;0;2
7229;Pakalnutė;Boružiukų;6575909478;Ne;9;3;2;14
7230;Pakalnutė;Boružiukų;2835611316;Taip;16;0;0;16
7231;Pakalnutė;Boružiukų;7672252382;Ne;3;1;0;4
7232;Pakalnutė;Boružiukų;4950195858;Taip;10;3;0;13
7233;Pakalnutė;Boružiukų;4927086034;Taip;15;0;0;15
7234;Pakalnutė;Boružiukų;6557165567;Taip;18;3;1;22
7235;Pakalnutė;Boružiukų;3677709759;Taip;0;3;4;7
7236;Pakalnutė;Boružiukų;2597900983;Taip;4;6;0;10
7237;Pakalnutė;Boružiukų;1340022702;Taip;8;4;0;12
7238;Pakalnutė;Boružiukų;6228196996;Taip;33;0;0;33
7239;Pakalnutė;Boružiukų;7563201788;Taip;4;0;0;4
7240;Pakalnutė;Meškiukų;2666441234;Taip;17;0;0;17
7241;Pakalnutė;Meškiukų;4256222944;Ne;17;4;0;21
7242;Pakalnutė;Meškiukų;2101821362;Taip;6;7;0;13
7243;Pakalnutė;Meškiukų;4069910346;Ne;9;0;3;12
7244;Pakalnutė;Meškiukų;4313652059;Ne;4;6;0;10
7245;Pakalnutė;Meškiukų;7084798190;Taip;0;10;0;10
7246;Pakalnutė;Meškiukų;3693337607;Taip;17;0;0;17
7247;Pakalnutė;Meškiukų;2923698853;Taip;9;9;0;18
7248;Pakalnutė;Meškiukų;1369906621;Taip;5;0;0;5
7249;Pakalnutė;Nykštukai;9918277117;Taip;6;0;0;6
7250;Pakalnutė;Nykštukai;6633585181;Taip;15;0;3;18
7251;Pakalnutė;Nykštukai;3870628774;Taip;0;1;1;2
7252;Pakalnutė;Nykštukai;8324219868;Ne;0;22;0;22
7253;Pakalnutė;Nykštukai;1864990681;Taip;0;1;1;2
7254;Pakalnutė;Nykštukai;1236187157;Taip;4;1;0;5
7255;Pakalnutė;Nykštukai;2063766287;Taip;0;7;0;7
7256;Pakalnutė;Nykštukai;6528913736;Ne;0;4;0;4
7257;Pakalnutė;Nykštukai;8217779439;Taip;10;1;0;11
7258;Pakalnutė;Nykštukai;6206296685;Taip;0;22;0;22
7259;Pakalnutė;Nykštukai;8855237588;Ne;14;2;0;16
7260;Pakalnutė;Nykštukai;1561411767;Taip;4;0;2;6
7261;Pakalnutė;Nykštukai;9443826616;Taip;12;0;1;13
7262;Pakalnutė;Nykštukai;2578170222;Taip;7;2;4;13
7263;Pakalnutė;Nykštukai;3967515235;Taip;9;0;0;9
7264;Pakalnutė;Nykštukai;5377715404;Taip;6;0;2;8
7265;Pakalnutė;Nykštukai;3938091521;Taip;17;0;0;17
7266;Pakalnutė;Nykštukai;4971065032;Taip;16;0;0;16
7267;Pakalnutė;"Zuikučių ";1198230323;Taip;0;4;3;7
7268;Pakalnutė;"Zuikučių ";3609982613;Taip;0;3;0;3
7269;Pakalnutė;"Zuikučių ";5958653847;Taip;6;4;0;10
7270;Pakalnutė;"Zuikučių ";1147843795;Taip;5;0;0;5
7271;Pakalnutė;"Zuikučių ";3555822605;Taip;0;1;0;1
7272;Pakalnutė;"Zuikučių ";1583462733;Ne;2;1;1;4
7273;Pakalnutė;"Zuikučių ";6377564215;Taip;14;3;1;18
7274;Pakalnutė;"Zuikučių ";8813262660;Taip;14;0;0;14
7275;Pakalnutė;"Zuikučių ";7949588551;Taip;8;0;1;9
7276;Pakalnutė;"Zuikučių ";81578522887;Taip;0;1;0;1
7277;Pakalnutė;"Zuikučių ";2002555659;Ne;5;0;3;8
7278;Pakalnutė;"Zuikučių ";4681267749;Ne;13;2;0;15
7279;Pakalnutė;"Zuikučių ";6884488772;Taip;10;3;3;16
7280;Pakalnutė;"Zuikučių ";9934596750;Taip;1;0;0;1
7281;Pakalnutė;"Zuikučių ";5912904296;Taip;3;2;0;5
7282;Pakalnutė;"Drugelių ";5441477374;Ne;5;7;0;12
7283;Pakalnutė;"Drugelių ";7369661890;Taip;10;0;0;10
7284;Pakalnutė;"Drugelių ";5135811550;Taip;3;0;0;3
7285;Pakalnutė;"Drugelių ";7766653114;Taip;16;0;1;17
7286;Pakalnutė;"Drugelių ";7709684372;Taip;28;0;0;28
7287;Pakalnutė;"Drugelių ";9620000116;Taip;7;5;0;12
7288;Pakalnutė;"Drugelių ";5502444590;Taip;8;0;0;8
7289;Pakalnutė;"Drugelių ";3730712580;Taip;0;0;3;3
7290;Pakalnutė;"Drugelių ";1824418095;Ne;5;0;0;5
7291;Pakalnutė;"Drugelių ";9461133636;Taip;12;3;0;15
7292;Pakalnutė;"Drugelių ";4220406978;Ne;4;0;2;6
7293;Pakalnutė;"Drugelių ";5069038636;Taip;0;0;9;9
7294;Pakalnutė;"Drugelių ";7047587606;Taip;6;9;0;15
7295;Pakalnutė;"Drugelių ";2653667596;Taip;0;7;0;7
7296;Pakalnutė;"Drugelių ";2197533802;Taip;0;0;3;3
7297;Pakalnutė;"Drugelių ";1791607977;Taip;0;1;0;1
7298;Pakalnutė;"Drugelių ";4127500142;Taip;13;0;1;14
7299;Pakalnutė;"Drugelių ";9295709508;Ne;11;0;6;17
7300;Pakalnutė;"Drugelių ";6924023022;Taip;11;0;1;12
7301;Pakalnutė;Žvirbliukų;7421275778;Taip;10;0;0;10
7302;Pakalnutė;Žvirbliukų;8329725085;Taip;0;0;3;3
7303;Pakalnutė;Žvirbliukų;3190067149;Ne;8;8;0;16
7304;Pakalnutė;Žvirbliukų;8010667913;Taip;20;0;1;21
7305;Pakalnutė;Žvirbliukų;1662773049;Taip;5;2;1;8
7306;Pakalnutė;Žvirbliukų;5531209454;Taip;17;0;5;22
7307;Pakalnutė;Žvirbliukų;3342793992;Taip;4;0;1;5
7308;Pakalnutė;Žvirbliukų;7258417347;Ne;13;0;0;13
7309;Pakalnutė;Žvirbliukų;4961361687;Taip;6;0;0;6
7310;Pakalnutė;Žvirbliukų;5878352514;Taip;13;6;0;19
7311;Pakalnutė;Žvirbliukų;5685361033;Ne;11;2;1;14
7312;Pakalnutė;Žvirbliukų;7782295402;Taip;6;5;0;11
7313;Pakalnutė;Žvirbliukų;7547661599;Ne;17;0;0;17
7314;Pakalnutė;Žvirbliukų;4469974699;Taip;6;6;0;12
7315;Pakalnutė;Žvirbliukų;6159955311;Taip;11;0;0;11
7316;Pakalnutė;Žvirbliukų;3903972025;Taip;16;0;0;16
7317;Panerių;Rūtelė;3438863665;Taip;0;0;2;2
7318;Panerių;Rūtelė;4689913361;Ne;8;0;2;10
7319;Panerių;Rūtelė;2195332401;Taip;7;0;3;10
7320;Panerių;Rūtelė;2571561865;Ne;5;12;0;17
7321;Panerių;Rūtelė;6908487075;Ne;9;0;4;13
7322;Panerių;Rūtelė;2643410976;Ne;0;0;22;22
7323;Panerių;Rūtelė;8771264170;Ne;0;0;9;9
7324;Panerių;Rūtelė;3346395516;Taip;5;1;0;6
7325;Panerių;Rūtelė;7805429137;Taip;11;0;4;15
7326;Panerių;Rūtelė;9268618414;Taip;15;0;0;15
7327;Panerių;Rūtelė;6411372006;Taip;23;2;0;25
7328;Panerių;Rūtelė;1419817211;Ne;9;3;0;12
7329;Panerių;Rūtelė;2333355325;Taip;0;5;0;5
7330;Panerių;Rūtelė;4867297993;Taip;5;0;0;5
7331;Panerių;Rūtelė;2235123048;Ne;13;0;4;17
7332;Panerių;Rūtelė;9631684972;Taip;0;0;2;2
7333;Panerių;Rūtelė;3190117304;Taip;0;10;0;10
7334;Panerių;Rūtelė;8693113275;Taip;22;0;0;22
7335;Panerių;Rūtelė;6468190149;Taip;1;0;2;3
7336;Panerių;Rūtelė;9630302749;Taip;14;0;1;15
7337;Panerių;Rūtelė;3057714143;Taip;3;0;0;3
7338;Panerių;Gėlytės;3550194241;Taip;0;0;1;1
7339;Panerių;Gėlytės;8514805919;Taip;0;1;4;5
7340;Panerių;Gėlytės;1339256258;Taip;8;0;0;8
7341;Panerių;Gėlytės;9729731866;Taip;0;6;0;6
7342;Panerių;Gėlytės;6583134855;Taip;7;0;1;8
7343;Panerių;Gėlytės;3948776877;Taip;0;0;5;5
7344;Panerių;Gėlytės;2751334281;Taip;4;1;2;7
7345;Panerių;Gėlytės;9432171719;Taip;10;7;0;17
7346;Panerių;Gėlytės;5452996791;Taip;9;1;0;10
7347;Panerių;Gėlytės;1717129076;Ne;24;0;2;26
7348;Panerių;Gėlytės;2035822976;Taip;10;0;0;10
7349;Panerių;Gėlytės;8447920373;Taip;23;0;0;23
7350;Panerių;Gėlytės;4161189870;Taip;10;5;4;19
7351;Panerių;Gėlytės;9004310393;Ne;11;0;1;12
7352;Panerių;Gėlytės;3112608087;Ne;15;0;0;15
7353;Panerių;Gėlytės;5100874548;Taip;4;0;0;4
7354;Panerių;Gėlytės;9955613696;Taip;4;0;0;4
7355;Panerių;Gėlytės;3882802840;Taip;9;5;0;14
7356;Panerių;Gėlytės;6304387432;Taip;8;1;11;20
7357;Panerių;Gėlytės;7166964095;Taip;20;0;1;21
7358;Panerių;Gėlytės;8109366029;Ne;0;0;4;4
7359;Panerių;Boružė;7657860513;Ne;14;5;0;19
7360;Panerių;Boružė;9014387764;Taip;0;4;0;4
7361;Panerių;Boružė;4369979548;Taip;9;0;1;10
7362;Panerių;Boružė;3273655606;Ne;22;0;0;22
7363;Panerių;Boružė;8067240250;Ne;19;0;5;24
7364;Panerių;Boružė;3526636673;Taip;10;0;1;11
7365;Panerių;Boružė;8407995549;Taip;0;9;0;9
7366;Panerių;Boružė;3502494751;Taip;8;1;7;16
7367;Panerių;Boružė;6653710644;Ne;0;8;0;8
7368;Panerių;Boružė;7227118885;Ne;4;0;0;4
7369;Panerių;Boružė;9288515724;Ne;22;0;0;22
7370;Panerių;Boružė;7976634590;Ne;14;0;0;14
7371;Panerių;Boružė;4716214117;Taip;21;0;0;21
7372;Panerių;Boružė;4957564440;Taip;6;0;0;6
7373;Panerių;Boružė;1985780685;Ne;9;0;3;12
7374;Papartis;ZUIKUČIAI;8874222586;Taip;3;0;6;9
7375;Papartis;ZUIKUČIAI;2446379598;Taip;2;0;0;2
7376;Papartis;ZUIKUČIAI;3054883426;Taip;8;0;0;8
7377;Papartis;ZUIKUČIAI;1191546794;Taip;6;0;1;7
7378;Papartis;ZUIKUČIAI;7619963429;Taip;14;0;0;14
7379;Papartis;ZUIKUČIAI;8958880558;Taip;3;3;0;6
7380;Papartis;ZUIKUČIAI;4380030213;Ne;16;0;1;17
7381;Papartis;ZUIKUČIAI;4906248064;Taip;2;0;2;4
7382;Papartis;ZUIKUČIAI;8447326505;Taip;4;1;0;5
7383;Papartis;ZUIKUČIAI;1919362027;Taip;9;0;0;9
7384;Papartis;ZUIKUČIAI;4640068595;Taip;7;0;0;7
7385;Papartis;ZUIKUČIAI;5361925390;Ne;2;0;0;2
7386;Papartis;ZUIKUČIAI;5796928317;Taip;9;2;0;11
7387;Papartis;ZUIKUČIAI;6266095782;Taip;8;0;0;8
7388;Papartis;ZUIKUČIAI;5786648402;Taip;5;0;0;5
7389;Papartis;ZUIKUČIAI;5776038830;Taip;6;3;1;10
7390;Papartis;ZUIKUČIAI;5579899922;Taip;10;0;3;13
7391;Papartis;ZUIKUČIAI;9358310527;Taip;10;5;0;15
7392;Papartis;ZUIKUČIAI;5363926529;Ne;4;5;0;9
7393;Papartis;ZUIKUČIAI;1722192450;Taip;7;1;0;8
7394;Papartis;DRUGELIAI;8005876431;Taip;13;0;0;13
7395;Papartis;DRUGELIAI;6664178454;Ne;8;0;0;8
7396;Papartis;DRUGELIAI;2432516496;Taip;18;1;0;19
7397;Papartis;DRUGELIAI;7742769931;Taip;10;0;0;10
7398;Papartis;DRUGELIAI;8305560946;Ne;0;0;10;10
7399;Papartis;DRUGELIAI;4778327620;Taip;0;9;0;9
7400;Papartis;DRUGELIAI;7331682622;Taip;13;0;9;22
7401;Papartis;DRUGELIAI;2824078830;Taip;17;0;0;17
7402;Papartis;DRUGELIAI;8782882575;Taip;0;5;0;5
7403;Papartis;DRUGELIAI;1405767603;Taip;0;1;0;1
7404;Papartis;DRUGELIAI;6435625940;Taip;9;2;1;12
7405;Papartis;DRUGELIAI;7187797639;Taip;7;0;3;10
7406;Papartis;DRUGELIAI;3411472740;Taip;13;9;0;22
7407;Papartis;DRUGELIAI;3209105694;Taip;4;0;0;4
7408;Papartis;DRUGELIAI;8277830926;Taip;3;5;1;9
7409;Papartis;DRUGELIAI;1759982543;Taip;0;1;2;3
7410;Papartis;DRUGELIAI;4689046394;Taip;6;2;0;8
7411;Papartis;DRUGELIAI;5430993785;Taip;10;0;0;10
7412;Papartis;ŽVIRBLIUKAI;7590170146;Taip;0;2;8;10
7413;Papartis;ŽVIRBLIUKAI;42803013754;Taip;0;1;5;6
7414;Papartis;ŽVIRBLIUKAI;3408756311;Taip;0;3;3;6
7415;Papartis;ŽVIRBLIUKAI;4935694347;Taip;1;4;3;8
7416;Papartis;ŽVIRBLIUKAI;7067369268;Ne;14;1;2;17
7417;Papartis;ŽVIRBLIUKAI;1836914270;Taip;0;1;4;5
7418;Papartis;ŽVIRBLIUKAI;4508053349;Taip;0;1;0;1
7419;Papartis;ŽVIRBLIUKAI;2778629398;Taip;5;0;9;14
7420;Papartis;ŽVIRBLIUKAI;2535412635;Taip;7;11;4;22
7421;Papartis;ŽVIRBLIUKAI;7102350653;Taip;0;1;4;5
7422;Papartis;ŽVIRBLIUKAI;1205854439;Taip;14;2;4;20
7423;Papartis;ŽVIRBLIUKAI;1672028156;Taip;0;2;7;9
7424;Papartis;ŽVIRBLIUKAI;8148483438;Taip;0;3;0;3
7425;Papartis;ŽVIRBLIUKAI;3295731801;Taip;7;1;8;16
7426;Papartis;ŽVIRBLIUKAI;6797687614;Taip;12;1;2;15
7427;Papartis;ŽVIRBLIUKAI;3475745012;Taip;7;2;14;23
7428;Papartis;ŽVIRBLIUKAI;4634683589;Taip;0;1;8;9
7429;Papartis;ŽVIRBLIUKAI;3267416367;Taip;6;0;0;6
7430;Papartis;ŽVIRBLIUKAI;3243869451;Taip;7;0;3;10
7431;Papartis;ŽVIRBLIUKAI;5265293240;Taip;0;5;5;10
7432;Papartis;ŽVIRBLIUKAI;9134335737;Taip;0;5;5;10
7433;Papartis;ŽVIRBLIUKAI;7387281720;Taip;0;9;0;9
7434;Papartis;PELĖDŽIUKAI;7606939822;Taip;0;2;3;5
7435;Papartis;PELĖDŽIUKAI;2447926422;Taip;9;8;0;17
7436;Papartis;PELĖDŽIUKAI;4346817695;Taip;0;1;3;4
7437;Papartis;PELĖDŽIUKAI;1527263538;Taip;0;1;0;1
7438;Papartis;PELĖDŽIUKAI;1219140467;Taip;6;2;3;11
7439;Papartis;PELĖDŽIUKAI;5410369044;Ne;8;9;0;17
7440;Papartis;PELĖDŽIUKAI;1065128993;Taip;0;2;2;4
7441;Papartis;PELĖDŽIUKAI;6126912448;Taip;0;4;0;4
7442;Papartis;PELĖDŽIUKAI;8952917454;Ne;0;1;2;3
7443;Papartis;PELĖDŽIUKAI;3182457453;Taip;13;0;0;13
7444;Papartis;PELĖDŽIUKAI;5675537250;Taip;2;1;0;3
7445;Papartis;PELĖDŽIUKAI;72182866449;Taip;2;1;0;3
7446;Papartis;PELĖDŽIUKAI;4992305227;Taip;2;1;0;3
7447;Papartis;PELĖDŽIUKAI;7703070601;Ne;0;2;4;6
7448;Papartis;PELĖDŽIUKAI;7902130389;Taip;0;1;1;2
7449;Papartis;PELĖDŽIUKAI;1974159967;Taip;8;1;0;9
7450;Papartis;PELĖDŽIUKAI;5732853976;Taip;19;0;0;19
7451;Papartis;PELĖDŽIUKAI;1554777403;Ne;0;1;0;1
7452;Papartis;PELĖDŽIUKAI;3107106078;Taip;2;1;6;9
7453;Papartis;SAULUTĖS;2669085057;Ne;13;0;1;14
7454;Papartis;SAULUTĖS;6585372451;Taip;4;1;5;10
7455;Papartis;SAULUTĖS;6734567714;Taip;0;4;0;4
7456;Papartis;SAULUTĖS;4570512336;Ne;0;0;7;7
7457;Papartis;SAULUTĖS;3539507686;Taip;0;1;0;1
7458;Papartis;SAULUTĖS;6977513472;Taip;0;2;0;2
7459;Papartis;SAULUTĖS;5070767260;Taip;0;1;0;1
7460;Papartis;SAULUTĖS;9380951144;Taip;11;0;6;17
7461;Papartis;SAULUTĖS;4016297254;Taip;29;0;3;32
7462;Papartis;SAULUTĖS;5323875279;Taip;0;3;0;3
7463;Papartis;SAULUTĖS;5465955537;Taip;3;0;4;7
7464;Papartis;SAULUTĖS;2812347963;Taip;9;0;1;10
7465;Papartis;SAULUTĖS;8420752169;Taip;0;0;9;9
7466;Papartis;SAULUTĖS;6346776139;Taip;18;0;0;18
7467;Papartis;SAULUTĖS;1352401881;Taip;0;5;0;5
7468;Papartis;SAULUTĖS;3685642787;Taip;5;0;1;6
7469;Papartis;SAULUTĖS;6136213985;Taip;8;0;0;8
7470;Papartis;SAULUTĖS;7107692314;Taip;8;0;0;8
7471;Papartis;GANDRIUKAI;4878190663;Taip;4;0;1;5
7472;Papartis;GANDRIUKAI;9900023788;Taip;8;0;0;8
7473;Papartis;GANDRIUKAI;8946678515;Taip;3;0;3;6
7474;Papartis;GANDRIUKAI;2783708905;Taip;0;0;3;3
7475;Papartis;GANDRIUKAI;6883101103;Taip;0;3;0;3
7476;Papartis;GANDRIUKAI;2868899342;Taip;4;2;0;6
7477;Papartis;GANDRIUKAI;7768672610;Taip;4;1;0;5
7478;Papartis;GANDRIUKAI;9384670351;Taip;0;5;0;5
7479;Papartis;GANDRIUKAI;9968072478;Taip;0;0;7;7
7480;Papartis;GANDRIUKAI;2215846642;Taip;2;1;1;4
7481;Papartis;GANDRIUKAI;3320524073;Taip;0;1;1;2
7482;Papartis;GANDRIUKAI;9704930584;Taip;0;2;0;2
7483;Papartis;GANDRIUKAI;9804863902;Taip;0;2;1;3
7484;Papartis;GANDRIUKAI;9072635586;Ne;2;8;0;10
7485;Papartis;GANDRIUKAI;7859096984;Taip;0;4;0;4
7486;Papartis;GANDRIUKAI;7252265838;Ne;5;1;2;8
7487;Papartis;GANDRIUKAI;9978625382;Taip;13;0;1;14
7488;Papartis;GANDRIUKAI;5883751305;Ne;4;2;0;6
7489;Papartis;GANDRIUKAI;4509843536;Taip;22;0;0;22
7490;Papartis;GANDRIUKAI;8768526171;Taip;12;0;1;13
7491;Papartis;AITVARELIAI;8891856856;Taip;0;4;0;4
7492;Papartis;AITVARELIAI;6889782462;Ne;3;0;5;8
7493;Papartis;AITVARELIAI;5736456872;Taip;0;3;0;3
7494;Papartis;AITVARELIAI;3040269026;Taip;0;3;0;3
7495;Papartis;AITVARELIAI;8532558577;Taip;0;4;3;7
7496;Papartis;AITVARELIAI;4918854899;Taip;0;5;2;7
7497;Papartis;AITVARELIAI;5252947502;Taip;0;6;0;6
7498;Papartis;AITVARELIAI;1916222143;Taip;0;1;0;1
7499;Papartis;AITVARELIAI;7803854703;Taip;0;8;0;8
7500;Papartis;AITVARELIAI;6416605464;Taip;3;0;1;4
7501;Papartis;AITVARELIAI;7504793827;Ne;3;0;9;12
7502;Papartis;AITVARELIAI;7156767639;Taip;18;1;0;19
7503;Papartis;AITVARELIAI;8626682787;Taip;0;0;7;7
7504;Papartis;AITVARELIAI;2116140075;Taip;0;2;0;2
7505;Papartis;AITVARELIAI;3896803048;Taip;3;0;0;3
7506;Papartis;AITVARELIAI;4138926711;Ne;12;0;4;16
7507;Papartis;AITVARELIAI;8989172483;Taip;0;0;25;25
7508;Papartis;AITVARELIAI;9384475270;Taip;0;5;0;5
7509;Papartis;SMALSUČIAI;7856148436;Taip;3;1;1;5
7510;Papartis;SMALSUČIAI;5383936595;Taip;9;0;1;10
7511;Papartis;SMALSUČIAI;1698871014;Taip;0;3;0;3
7512;Papartis;SMALSUČIAI;6274608449;Taip;14;1;0;15
7513;Papartis;SMALSUČIAI;6664773988;Taip;0;2;0;2
7514;Papartis;SMALSUČIAI;8875490564;Taip;2;0;0;2
7515;Papartis;SMALSUČIAI;4500675679;Taip;5;0;0;5
7516;Papartis;SMALSUČIAI;7203919287;Taip;12;4;0;16
7517;Papartis;SMALSUČIAI;1486770896;Ne;0;1;0;1
7518;Papartis;SMALSUČIAI;5132031416;Taip;19;0;0;19
7519;Papartis;SMALSUČIAI;3395306653;Taip;0;10;0;10
7520;Papartis;SMALSUČIAI;5964232886;Taip;6;0;0;6
7521;Papartis;SMALSUČIAI;7149853209;Taip;16;0;0;16
7522;Papartis;SMALSUČIAI;4483401826;Taip;1;0;0;1
7523;Papartis;SMALSUČIAI;1616537800;Taip;5;5;0;10
7524;Papartis;"ŽIRNIUKAI ";8897061283;Taip;9;0;0;9
7525;Papartis;"ŽIRNIUKAI ";3310893254;Taip;10;0;0;10
7526;Papartis;"ŽIRNIUKAI ";1073755384;Taip;13;0;1;14
7527;Papartis;"ŽIRNIUKAI ";7647225316;Taip;8;7;0;15
7528;Papartis;"ŽIRNIUKAI ";1210592579;Taip;7;2;0;9
7529;Papartis;"ŽIRNIUKAI ";1519815331;Taip;8;2;9;19
7530;Papartis;"ŽIRNIUKAI ";4158525314;Taip;22;0;0;22
7531;Papartis;"ŽIRNIUKAI ";4978398085;Taip;25;3;0;28
7532;Papartis;"ŽIRNIUKAI ";9746397380;Taip;5;0;1;6
7533;Papartis;"ŽIRNIUKAI ";4952279543;Taip;4;10;0;14
7534;Papartis;"ŽIRNIUKAI ";5276806556;Taip;7;0;0;7
7535;Papartis;"ŽIRNIUKAI ";2521609574;Ne;3;1;2;6
7536;Papartis;"ŽIRNIUKAI ";7617558492;Taip;0;1;13;14
7537;Papartis;"ŽIRNIUKAI ";8412962815;Ne;17;0;0;17
7538;Papartis;"ŽIRNIUKAI ";1267981238;Taip;0;15;7;22
7539;Papartis;"ŽIRNIUKAI ";2772758899;Taip;23;1;0;24
7540;Papartis;"ŽIRNIUKAI ";1183123161;Ne;3;0;1;4
7541;Papartis;"ŽIRNIUKAI ";1150772988;Ne;4;2;0;6
7542;Papartis;"ŽIRNIUKAI ";9518392031;Taip;0;0;5;5
7543;Papartis;"ŽIRNIUKAI ";6615368741;Ne;10;1;1;12
7544;Papartis;"ŽIRNIUKAI ";7108606229;Ne;9;0;2;11
7545;Papartis;"ŽIRNIUKAI ";1614261572;Taip;6;2;0;8
7546;Papartis;"ŽIRNIUKAI ";8834463589;Taip;11;2;0;13
7547;Papartis;BORUŽĖLĖS;3576856223;Taip;3;2;0;5
7548;Papartis;BORUŽĖLĖS;7492923318;Ne;8;1;0;9
7549;Papartis;BORUŽĖLĖS;1157298413;Taip;9;0;0;9
7550;Papartis;BORUŽĖLĖS;1159418157;Taip;9;0;0;9
7551;Papartis;BORUŽĖLĖS;3490370261;Taip;8;0;0;8
7552;Papartis;BORUŽĖLĖS;3107245976;Ne;9;1;0;10
7553;Papartis;BORUŽĖLĖS;1381195839;Taip;7;0;0;7
7554;Papartis;BORUŽĖLĖS;6107558090;Taip;9;1;0;10
7555;Papartis;BORUŽĖLĖS;6776383676;Taip;4;9;0;13
7556;Papartis;BORUŽĖLĖS;9838432144;Taip;0;6;0;6
7557;Papartis;BORUŽĖLĖS;9884399306;Taip;0;4;0;4
7558;Papartis;BORUŽĖLĖS;1511111597;Taip;8;0;0;8
7559;Papartis;BORUŽĖLĖS;8055310718;Taip;14;0;0;14
7560;Papartis;BORUŽĖLĖS;5259754395;Taip;0;8;0;8
7561;Papartis;BORUŽĖLĖS;5959006739;Taip;8;1;0;9
7562;Papartis;VARPELIAI;7260304487;Taip;9;0;4;13
7563;Papartis;VARPELIAI;9581159294;Taip;21;0;3;24
7564;Papartis;VARPELIAI;2956950308;Taip;4;9;0;13
7565;Papartis;VARPELIAI;6710049689;Taip;15;0;3;18
7566;Papartis;VARPELIAI;2777359899;Taip;12;0;0;12
7567;Papartis;VARPELIAI;1993893368;Taip;13;1;0;14
7568;Papartis;VARPELIAI;3345085436;Taip;0;10;4;14
7569;Papartis;VARPELIAI;7189999679;Taip;17;3;0;20
7570;Papartis;VARPELIAI;4256878733;Ne;16;0;2;18
7571;Papartis;VARPELIAI;8443731277;Taip;11;0;0;11
7572;Papartis;VARPELIAI;3419374226;Taip;0;0;16;16
7573;Papartis;VARPELIAI;2600724041;Taip;15;0;1;16
7574;Papartis;VARPELIAI;2053568874;Taip;12;5;1;18
7575;Papartis;VARPELIAI;3173271837;Taip;5;0;2;7
7576;Papartis;VARPELIAI;4952700737;Taip;17;0;1;18
7577;Papartis;VARPELIAI;6146264193;Ne;13;0;1;14
7578;Papartis;VARPELIAI;8642079824;Taip;12;0;0;12
7579;Papartis;VARPELIAI;2421158534;Taip;7;0;0;7
7580;Papartis;VARPELIAI;8872914372;Taip;13;0;3;16
7581;Papartis;NYKŠTUKAI;1566011843;Ne;5;0;2;7
7582;Papartis;NYKŠTUKAI;5652769035;Taip;3;6;0;9
7583;Papartis;NYKŠTUKAI;5942160584;Taip;9;0;0;9
7584;Papartis;NYKŠTUKAI;9922091482;Taip;10;0;0;10
7585;Papartis;NYKŠTUKAI;1680412204;Ne;5;0;0;5
7586;Papartis;NYKŠTUKAI;9285319899;Taip;19;0;1;20
7587;Papartis;NYKŠTUKAI;9502229005;Taip;3;0;1;4
7588;Papartis;NYKŠTUKAI;6949120693;Taip;0;6;2;8
7589;Papartis;NYKŠTUKAI;6794076631;Ne;12;2;3;17
7590;Papartis;NYKŠTUKAI;5957889361;Taip;7;1;0;8
7591;Papartis;NYKŠTUKAI;5608868738;Ne;0;9;0;9
7592;Papartis;NYKŠTUKAI;4203241118;Taip;5;0;0;5
7593;Papartis;NYKŠTUKAI;4806652727;Taip;0;0;10;10
7594;Papartis;NYKŠTUKAI;9939850340;Taip;0;1;0;1
7595;Papartis;NYKŠTUKAI;3324647852;Taip;12;1;3;16
7596;Papartis;NYKŠTUKAI;6423401656;Taip;5;0;0;5
7597;Papartis;NYKŠTUKAI;8932290803;Taip;12;1;0;13
7598;Papartis;NYKŠTUKAI;5652560002;Taip;5;3;2;10
7599;Papartis;NYKŠTUKAI;1559196767;Ne;8;0;3;11
7600;Papartis;NYKŠTUKAI;6360881137;Taip;9;2;4;15
7601;Papartis;NYKŠTUKAI;6941978169;Taip;6;0;1;7
7602;Papartis;NYKŠTUKAI;7080578299;Taip;10;0;3;13
7603;Pasaka;Drugelių;5438303030;Taip;0;1;0;1
7604;Pasaka;Drugelių;5665758011;Taip;0;7;0;7
7605;Pasaka;Drugelių;3092993659;Taip;0;1;0;1
7606;Pasaka;Drugelių;5027755073;Ne;5;2;0;7
7607;Pasaka;Drugelių;1300996831;Taip;5;1;0;6
7608;Pasaka;Drugelių;1313576071;Ne;0;2;0;2
7609;Pasaka;Drugelių;7040953491;Taip;5;3;1;9
7610;Pasaka;Drugelių;7455544922;Taip;7;8;0;15
7611;Pasaka;Drugelių;8963465320;Taip;0;1;0;1
7612;Pasaka;Drugelių;4743331873;Taip;0;16;0;16
7613;Pasaka;Drugelių;4345680164;Taip;0;1;0;1
7614;Pasaka;Drugelių;1583090840;Taip;0;3;3;6
7615;Pasaka;Drugelių;2774371800;Taip;10;3;3;16
7616;Pasaka;Drugelių;5547931812;Ne;6;2;2;10
7617;Pasaka;Drugelių;7685589423;Taip;0;2;0;2
7618;Pasaka;Drugelių;3088081091;Taip;0;1;0;1
7619;Pasaka;Drugelių;9060396476;Taip;7;0;0;7
7620;Pasaka;Drugelių;7078492847;Taip;3;3;3;9
7621;Pasaka;Nykštukų;7546205285;Taip;3;8;0;11
7622;Pasaka;Nykštukų;5687494160;Taip;4;2;0;6
7623;Pasaka;Nykštukų;3151916774;Taip;9;3;0;12
7624;Pasaka;Nykštukų;4773893970;Taip;0;3;2;5
7625;Pasaka;Nykštukų;4082752808;Taip;13;0;0;13
7626;Pasaka;Nykštukų;6788771605;Taip;0;6;0;6
7627;Pasaka;Nykštukų;5412931969;Taip;5;0;0;5
7628;Pasaka;Nykštukų;1813068555;Taip;8;0;0;8
7629;Pasaka;Nykštukų;9567521319;Taip;17;0;0;17
7630;Pasaka;Nykštukų;8400549247;Taip;7;0;0;7
7631;Pasaka;Nykštukų;6326056771;Taip;10;3;0;13
7632;Pasaka;Nykštukų;4175157894;Taip;10;0;1;11
7633;Pasaka;Nykštukų;5768958388;Taip;7;0;0;7
7634;Pasaka;Nykštukų;2797217440;Taip;0;2;1;3
7635;Pasaka;Nykštukų;7292437626;Taip;4;1;0;5
7636;Pasaka;Montesori;16974081144;Taip;13;3;1;17
7637;Pasaka;Montesori;1514381003;Taip;0;1;0;1
7638;Pasaka;Montesori;5812041166;Taip;9;0;0;9
7639;Pasaka;Montesori;7837662446;Taip;14;0;4;18
7640;Pasaka;Montesori;5240642967;Ne;4;0;0;4
7641;Pasaka;Montesori;3047931231;Ne;4;0;4;8
7642;Pasaka;Montesori;3195380938;Taip;0;0;2;2
7643;Pasaka;Montesori;6625690696;Taip;3;0;0;3
7644;Pasaka;Montesori;4548601585;Ne;4;6;0;10
7645;Pasaka;Montesori;7887326763;Taip;7;2;2;11
7646;Pasaka;Montesori;4366930715;Taip;0;0;1;1
7647;Pasaka;Montesori;9850592463;Taip;12;1;0;13
7648;Pasaka;Montesori;2995831258;Taip;6;1;6;13
7649;Pasaka;Montesori;1216568014;Taip;0;2;2;4
7650;Pasaka;Montesori;6248810027;Ne;2;0;6;8
7651;Pasaka;Montesori;3620395122;Taip;8;0;0;8
7652;Pasaka;Montesori;5689164477;Taip;4;0;2;6
7653;Pasaka;Montesori;6484610418;Taip;0;0;4;4
7654;Pasaka;Montesori;8873248505;Taip;0;10;11;21
7655;Pasaka;Žirniukų;9867183480;Taip;7;0;0;7
7656;Pasaka;Žirniukų;3783869856;Taip;5;0;0;5
7657;Pasaka;Žirniukų;2815348652;Taip;0;0;1;1
7658;Pasaka;Žirniukų;5651025350;Taip;8;1;0;9
7659;Pasaka;Žirniukų;2422958320;Taip;9;1;0;10
7660;Pasaka;Žirniukų;9136524816;Taip;0;0;3;3
7661;Pasaka;Žirniukų;9766432049;Taip;15;0;0;15
7662;Pasaka;Žirniukų;6668421711;Taip;5;0;0;5
7663;Pasaka;Žirniukų;6387972576;Taip;0;0;1;1
7664;Pasaka;Žirniukų;4948174745;Taip;22;0;0;22
7665;Pasaka;Žirniukų;2144975281;Taip;8;0;1;9
7666;Pasaka;Žirniukų;4629119214;Taip;0;0;3;3
7667;Pasaka;Žirniukų;2086919906;Taip;22;0;0;22
7668;Pasaka;Žirniukų;8519108324;Taip;6;1;0;7
7669;Pasaka;Žirniukų;9950979894;Taip;0;0;3;3
7670;Pasaka;Žirniukų;9654507441;Taip;7;0;4;11
7671;Pasaka;Žirniukų;9654507441;Taip;7;0;4;11
7672;Pasaka;Žirniukų;9654507441;Taip;7;0;4;11
7673;Pasaka;Žirniukų;5921553817;Taip;0;0;3;3
7674;Pasaka;Žirniukų;2569560383;Taip;9;0;0;9
7675;Pasaka;"Voveriukų ";3606141216;Taip;22;2;0;24
7676;Pasaka;"Voveriukų ";5217688848;Taip;22;2;0;24
7677;Pasaka;"Voveriukų ";4171004263;Taip;10;2;0;12
7678;Pasaka;"Voveriukų ";8504575043;Taip;6;0;3;9
7679;Pasaka;"Voveriukų ";1488711275;Taip;0;1;0;1
7680;Pasaka;"Voveriukų ";2854919649;Taip;5;0;2;7
7681;Pasaka;"Voveriukų ";1950145441;Taip;19;0;3;22
7682;Pasaka;"Voveriukų ";4466963221;Taip;5;1;0;6
7683;Pasaka;"Voveriukų ";9588247759;Ne;0;2;7;9
7684;Pasaka;"Voveriukų ";3536862796;Ne;5;0;0;5
7685;Pasaka;"Voveriukų ";8899289832;Ne;6;0;0;6
7686;Pasaka;"Voveriukų ";4915357646;Taip;5;0;3;8
7687;Pasaka;"Voveriukų ";7176272684;Taip;7;11;0;18
7688;Pasaka;"Voveriukų ";9687385445;Ne;4;1;0;5
7689;Pasaka;"Voveriukų ";4799036184;Taip;0;0;17;17
7690;Pasaka;"Voveriukų ";6684234474;Ne;18;0;8;26
7691;Pasaka;"Voveriukų ";9003508760;Taip;0;15;0;15
7692;Pasaka;"Voveriukų ";6925961600;Taip;8;0;0;8
7693;Pasaka;"Voveriukų ";1745181416;Taip;0;0;14;14
7694;Pasaka;"Voveriukų ";9780490338;Taip;4;9;0;13
7695;Pasaka;"Voveriukų ";6315362421;Taip;6;0;1;7
7696;Pasaka;"Voveriukų ";6315362421;Taip;6;0;1;7
7697;Pasaka;"VALDOFRO 12";7010681103;Taip;0;5;1;6
7698;Pasaka;"VALDOFRO 12";4680456848;Taip;0;1;0;1
7699;Pasaka;"VALDOFRO 12";5141156728;Taip;3;0;0;3
7700;Pasaka;"VALDOFRO 12";2268625523;Taip;14;0;3;17
7701;Pasaka;"VALDOFRO 12";8701112181;Taip;6;0;1;7
7702;Pasaka;"VALDOFRO 12";1305541319;Taip;0;4;4;8
7703;Pasaka;"VALDOFRO 12";7682903999;Taip;6;0;1;7
7704;Pasaka;"VALDOFRO 12";4325198579;Ne;0;1;9;10
7705;Pasaka;"VALDOFRO 12";6448940090;Taip;10;1;1;12
7706;Pasaka;"VALDOFRO 12";8411025450;Taip;10;1;0;11
7707;Pasaka;"VALDOFRO 12";3840053722;Ne;0;7;1;8
7708;Pasaka;"VALDOFRO 12";8995205555;Taip;10;1;1;12
7709;Pasaka;"VALDOFRO 12";8912822936;Taip;0;0;1;1
7710;Pasaka;"VALDOFRO 12";4301573328;Taip;0;0;5;5
7711;Pasaka;"VALDOFRO 12";5244582148;Ne;12;0;1;13
7712;Pasaka;"VALDOFRO 12";9065016148;Taip;0;0;5;5
7713;Pasaka;"VALDOFRO 12";9809498406;Taip;0;2;9;11
7714;Pasaka;"VALDOFRO 12";5040348350;Taip;0;14;5;19
7715;Pasaka;"VALDORFO 2";71365777764;Taip;0;1;0;1
7716;Pasaka;"VALDORFO 2";77904202630;Taip;0;1;1;2
7717;Pasaka;"VALDORFO 2";4752117533;Taip;0;3;0;3
7718;Pasaka;"VALDORFO 2";7950962252;Taip;3;0;0;3
7719;Pasaka;"VALDORFO 2";8590385693;Taip;0;0;13;13
7720;Pasaka;"VALDORFO 2";4620573687;Taip;7;3;0;10
7721;Pasaka;"VALDORFO 2";4825373152;Taip;6;1;0;7
7722;Pasaka;"VALDORFO 2";9462745431;Taip;0;0;13;13
7723;Pasaka;"VALDORFO 2";5399148997;Taip;6;3;0;9
7724;Pasaka;"VALDORFO 2";1799326151;Taip;2;1;3;6
7725;Pasaka;"VALDORFO 2";2273629510;Taip;2;1;3;6
7726;Pasaka;"VALDORFO 2";5903270845;Taip;0;3;12;15
7727;Pasaka;"VALDORFO 2";3778182691;Taip;7;3;0;10
7728;Pasaka;"VALDORFO 2";5742479853;Taip;7;0;2;9
7729;Pasaka;"VALDORFO 2";3049361712;Taip;0;1;3;4
7730;Pasaka;"VALDORFO 2";6497042042;Taip;5;0;0;5
7731;Pasaka;"VALDORFO 2";9150761761;Taip;15;0;0;15
7732;Pasaka;"VALDORFO 2";9821858308;Taip;9;0;0;9
7733;Pasaka;"VALDORFO 2";1648043715;Taip;7;0;8;15
7734;Pasaka;"VALDORFO 2";8855436141;Taip;0;0;2;2
7735;Pasaka;Gudručiai;6253266504;Taip;8;0;0;8
7736;Pasaka;Gudručiai;4137222204;Taip;8;0;0;8
7737;Pasaka;Gudručiai;7103485358;Taip;0;1;0;1
7738;Pasaka;Gudručiai;7648503006;Taip;6;0;0;6
7739;Pasaka;Gudručiai;2400455036;Taip;5;3;0;8
7740;Pasaka;Gudručiai;9722435751;Taip;0;2;0;2
7741;Pasaka;Gudručiai;73703706115;Taip;4;1;4;9
7742;Pasaka;Gudručiai;79170702319;Taip;4;1;0;5
7743;Pasaka;Gudručiai;5965121999;Taip;0;0;6;6
7744;Pasaka;Gudručiai;7286419663;Taip;0;0;2;2
7745;Pasaka;Gudručiai;5973028582;Taip;6;3;1;10
7746;Pasaka;Gudručiai;2788679885;Taip;7;1;0;8
7747;Pasaka;Gudručiai;7445696309;Taip;0;1;0;1
7748;Pasaka;Gudručiai;1565873178;Taip;0;1;0;1
7749;Pasaka;Gudručiai;2697014098;Taip;11;1;0;12
7750;Pasaka;Gudručiai;5651452381;Taip;10;1;0;11
7751;Pasaka;Gudručiai;6441884677;Taip;9;1;0;10
7752;Pasaka;Gudručiai;2018620389;Taip;11;1;2;14
7753;Pasaka;Gudručiai;2671403814;Taip;3;0;4;7
7754;Pasaka;Gudručiai;42548487389;Taip;0;0;3;3
7755;Pasaka;Gudručiai;8448558788;Taip;0;0;3;3
7756;Pasaka;Bitelių;5351364328;Taip;0;3;15;18
7757;Pasaka;Bitelių;4635912654;Taip;0;3;15;18
7758;Pasaka;Bitelių;7248640367;Ne;9;1;0;10
7759;Pasaka;Bitelių;8277245475;Ne;1;0;5;6
7760;Pasaka;Bitelių;6868519179;Taip;8;0;0;8
7761;Pasaka;Bitelių;6759415053;Taip;6;0;2;8
7762;Pasaka;Bitelių;5723970763;Taip;0;2;2;4
7763;Pasaka;Bitelių;9136521759;Taip;12;0;0;12
7764;Pasaka;Bitelių;2638182985;Taip;0;1;1;2
7765;Pasaka;Bitelių;3367346582;Taip;0;5;11;16
7766;Pasaka;Bitelių;3351338617;Taip;0;2;0;2
7767;Pasaka;Bitelių;5371046207;Taip;3;0;0;3
7768;Pasaka;Bitelių;1335408890;Taip;4;0;0;4
7769;Pasaka;Bitelių;6139825302;Taip;5;3;2;10
7770;Pasaka;Bitelių;4970812899;Taip;0;1;0;1
7771;Pasaka;Bitelių;8873115041;Taip;0;0;3;3
7772;Pasaka;Bitelių;1720511696;Taip;11;0;0;11
7773;Pasaka;Bitelių;2963373430;Ne;4;0;0;4
7774;Pasaka;"Pabiručių ";4846146925;Taip;0;0;2;2
7775;Pasaka;"Pabiručių ";9770811826;Taip;0;0;2;2
7776;Pasaka;"Pabiručių ";5230621839;Taip;15;0;0;15
7777;Pasaka;"Pabiručių ";9471447977;Ne;0;0;2;2
7778;Pasaka;"Pabiručių ";7751618911;Taip;4;1;0;5
7779;Pasaka;"Pabiručių ";7696383564;Taip;8;0;2;10
7780;Pasaka;"Pabiručių ";3796844193;Taip;14;0;2;16
7781;Pasaka;"Pabiručių ";4910817298;Taip;3;0;1;4
7782;Pasaka;"Pabiručių ";4222952044;Taip;18;0;0;18
7783;Pasaka;"Pabiručių ";4994426702;Taip;8;0;0;8
7784;Pasaka;"Pabiručių ";8289010515;Taip;8;0;0;8
7785;Pasaka;"Pabiručių ";5111195289;Taip;17;0;1;18
7786;Pasaka;"Pabiručių ";6182223896;Taip;17;0;1;18
7787;Pasaka;"Pabiručių ";8558563996;Taip;3;0;0;3
7788;Pasaka;"Pabiručių ";3557547656;Taip;4;10;8;22
7789;Pasaka;Šnekučių;1512874567;Taip;3;1;0;4
7790;Pasaka;Šnekučių;1793176485;Taip;7;1;0;8
7791;Pasaka;Šnekučių;4296539838;Taip;4;0;3;7
7792;Pasaka;Šnekučių;1590306118;Taip;15;2;0;17
7793;Pasaka;Šnekučių;6795580569;Taip;5;0;0;5
7794;Pasaka;Šnekučių;3240292756;Taip;0;2;1;3
7795;Pasaka;Šnekučių;4215568107;Taip;4;1;0;5
7796;Pasaka;Šnekučių;8365256755;Taip;5;1;0;6
7797;Pasaka;Šnekučių;1562771242;Taip;0;10;0;10
7798;Pasaka;Šnekučių;4816441219;Taip;0;11;0;11
7799;Pasaka;Šnekučių;1795497567;Taip;11;2;0;13
7800;Pasaka;Šnekučių;8347051587;Taip;5;0;0;5
7801;Pasaka;Šnekučių;8841669113;Taip;0;1;6;7
7802;Pasaka;Šnekučių;4975045894;Taip;5;0;2;7
7803;Pasaka;Šnekučių;3588073618;Taip;8;2;1;11
7804;Pasaka;Šnekučių;1194745876;Taip;5;1;0;6
7805;Pasaka;Šnekučių;1749821746;Taip;10;0;1;11
7806;Pasaka;Šnekučių;1723076060;Taip;9;1;2;12
7807;Pasaka;Šnekučių;8475365713;Ne;5;2;4;11
7808;Pasaka;Šnekučių;5656511105;Taip;9;0;1;10
7809;Pasaka;"KIŠKUČIŲ (Žirmūnų g. 92)";7311929329;Taip;5;0;0;5
7810;Pasaka;"KIŠKUČIŲ (Žirmūnų g. 92)";5134067973;Taip;5;0;0;5
7811;Pasaka;"KIŠKUČIŲ (Žirmūnų g. 92)";6950137606;Taip;8;0;0;8
7812;Pasaka;"KIŠKUČIŲ (Žirmūnų g. 92)";2575986215;Taip;9;0;0;9
7813;Pasaka;"KIŠKUČIŲ (Žirmūnų g. 92)";4924664211;Taip;5;0;0;5
7814;Pasaka;"EŽIUKŲ (Žirmūnų g. 92)";8866484797;Ne;8;0;0;8
7815;Pasaka;"EŽIUKŲ (Žirmūnų g. 92)";6280303158;Taip;0;0;1;1
7816;Paslaptis;MONTIKI;4683384309;Taip;10;2;0;12
7817;Paslaptis;MONTIKI;9929877115;Taip;10;3;0;13
7818;Paslaptis;MONTIKI;6860366087;Ne;15;0;0;15
7819;Paslaptis;MONTIKI;9445405671;Taip;0;0;14;14
7820;Paslaptis;MONTIKI;3572102816;Taip;18;0;0;18
7821;Paslaptis;MONTIKI;2927014406;Ne;13;1;0;14
7822;Paslaptis;MONTIKI;8453213193;Taip;6;0;0;6
7823;Paslaptis;MONTIKI;7053452493;Taip;17;0;0;17
7824;Paslaptis;MONTIKI;8909545951;Taip;11;1;0;12
7825;Paslaptis;MONTIKI;3963816472;Taip;4;0;4;8
7826;Paslaptis;MONTIKI;5809630456;Taip;8;1;2;11
7827;Paslaptis;MONTIKI;6764142182;Taip;20;0;0;20
7828;Paslaptis;MONTIKI;9299390190;Taip;4;0;0;4
7829;Paslaptis;MONTIKI;9497654214;Taip;11;0;4;15
7830;Paslaptis;MONTIKI;1080710834;Taip;8;0;0;8
7831;Paslaptis;MONTIKI;5480407965;Taip;9;1;0;10
7832;Paslaptis;FRUTIKI;9100003209;Ne;10;8;0;18
7833;Paslaptis;FRUTIKI;3984799090;Taip;9;0;0;9
7834;Paslaptis;FRUTIKI;5886364670;Taip;10;0;0;10
7835;Paslaptis;FRUTIKI;5406800599;Taip;15;2;0;17
7836;Paslaptis;FRUTIKI;2675089401;Taip;4;1;0;5
7837;Paslaptis;FRUTIKI;1557783684;Taip;17;1;0;18
7838;Paslaptis;FRUTIKI;8895770223;Taip;4;2;1;7
7839;Paslaptis;FRUTIKI;5206529350;Taip;0;6;0;6
7840;Paslaptis;FRUTIKI;2105441745;Taip;18;0;0;18
7841;Paslaptis;FRUTIKI;6686352764;Taip;14;0;1;15
7842;Paslaptis;FRUTIKI;5456011928;Taip;0;4;0;4
7843;Paslaptis;FRUTIKI;8717111488;Taip;9;3;0;12
7844;Paslaptis;FRUTIKI;5756338103;Taip;3;2;0;5
7845;Paslaptis;FRUTIKI;5646806136;Taip;0;1;3;4
7846;Paslaptis;FRUTIKI;6098345982;Ne;9;0;0;9
7847;Paslaptis;FRUTIKI;4810686225;Taip;5;1;0;6
7848;Paslaptis;FRUTIKI;8296575784;Ne;8;5;0;13
7849;Paslaptis;FRUTIKI;1754621741;Ne;17;0;0;17
7850;Paslaptis;FRUTIKI;7638521198;Taip;9;1;0;10
7851;Paslaptis;KALAMBURIKI;1029321312;Taip;4;2;0;6
7852;Paslaptis;KALAMBURIKI;3093280943;Taip;0;2;2;4
7853;Paslaptis;KALAMBURIKI;9559318660;Taip;0;1;0;1
7854;Paslaptis;KALAMBURIKI;2705751628;Taip;3;0;2;5
7855;Paslaptis;KALAMBURIKI;2879752620;Taip;0;11;0;11
7856;Paslaptis;KALAMBURIKI;8280740387;Taip;0;3;4;7
7857;Paslaptis;KALAMBURIKI;5852939221;Taip;5;2;0;7
7858;Paslaptis;KALAMBURIKI;2693910134;Ne;0;2;0;2
7859;Paslaptis;KALAMBURIKI;2891547963;Taip;9;3;0;12
7860;Paslaptis;KALAMBURIKI;3104525540;Ne;0;0;8;8
7861;Paslaptis;KALAMBURIKI;1186681520;Taip;8;0;0;8
7862;Paslaptis;KALAMBURIKI;3415869190;Taip;18;0;0;18
7863;Paslaptis;KALAMBURIKI;1983773762;Taip;0;3;0;3
7864;Paslaptis;KALAMBURIKI;5557019619;Taip;0;3;0;3
7865;Paslaptis;KALAMBURIKI;3549998192;Taip;1;1;6;8
7866;Paslaptis;KALAMBURIKI;1782398974;Taip;0;5;0;5
7867;Paslaptis;KALAMBURIKI;8146824196;Taip;0;0;6;6
7868;Paslaptis;KALAMBURIKI;3398729758;Taip;0;9;0;9
7869;Paslaptis;KALAMBURIKI;8083478190;Taip;0;0;16;16
7870;Paslaptis;KALAMBURIKI;2089780119;Taip;0;16;0;16
7871;Pasakaitė;Vieversėlių;7685647972;Taip;15;0;2;17
7872;Pasakaitė;Vieversėlių;6459145539;Taip;0;3;0;3
7873;Pasakaitė;Vieversėlių;2194313054;Taip;0;8;0;8
7874;Pasakaitė;Vieversėlių;9587489514;Taip;0;0;1;1
7875;Pasakaitė;Vieversėlių;3444442287;Taip;14;0;8;22
7876;Pasakaitė;Vieversėlių;5485965486;Taip;7;2;0;9
7877;Pasakaitė;Vieversėlių;2563725297;Taip;0;0;1;1
7878;Pasakaitė;Vieversėlių;2849753418;Taip;0;1;5;6
7879;Pasakaitė;Vieversėlių;8043493934;Ne;10;0;0;10
7880;Pasakaitė;Vieversėlių;7963057831;Taip;0;3;0;3
7881;Pasakaitė;Vieversėlių;9543991684;Taip;2;10;0;12
7882;Pasakaitė;Vieversėlių;3680596008;Taip;0;1;0;1
7883;Pasakaitė;Vieversėlių;4882856664;Taip;4;2;3;9
7884;Pasakaitė;Vieversėlių;5953162958;Ne;3;0;4;7
7885;Pasakaitė;Vieversėlių;1060914693;Taip;12;0;3;15
7886;Pasakaitė;Vieversėlių;7761162338;Ne;13;5;0;18
7887;Pasakaitė;Vieversėlių;9018830962;Taip;20;5;0;25
7888;Pasakaitė;Vieversėlių;6736879757;Ne;30;0;0;30
7889;Pasakaitė;Vieversėlių;4191875802;Taip;0;0;16;16
7890;Pasakaitė;Vieversėlių;5020801150;Taip;8;0;1;9
7891;Pasakaitė;Spindulėlių;4758073190;Taip;3;0;0;3
7892;Pasakaitė;Spindulėlių;6714500298;Taip;4;1;0;5
7893;Pasakaitė;Spindulėlių;1697755753;Taip;0;4;0;4
7894;Pasakaitė;Spindulėlių;1056358241;Taip;0;7;0;7
7895;Pasakaitė;Spindulėlių;8105641645;Taip;0;2;0;2
7896;Pasakaitė;Spindulėlių;5791927811;Taip;11;11;0;22
7897;Pasakaitė;Spindulėlių;5094404397;Taip;11;11;0;22
7898;Pasakaitė;Spindulėlių;9870015737;Ne;10;4;0;14
7899;Pasakaitė;Spindulėlių;1449037968;Ne;17;1;0;18
7900;Pasakaitė;Spindulėlių;7474100735;Taip;9;0;0;9
7901;Pasakaitė;Spindulėlių;6015360076;Taip;0;11;0;11
7902;Pasakaitė;Spindulėlių;2733800758;Taip;0;0;1;1
7903;Pasakaitė;Spindulėlių;6256000265;Taip;0;1;0;1
7904;Pasakaitė;Spindulėlių;2891089579;Taip;0;1;0;1
7905;Pasakaitė;Spindulėlių;3652896053;Taip;9;0;0;9
7906;Pasakaitė;Spindulėlių;7265623955;Taip;3;1;0;4
7907;Pasakaitė;Spindulėlių;1564611671;Taip;10;3;0;13
7908;Pasakaitė;Spindulėlių;3283593388;Taip;9;0;0;9
7909;Pasakaitė;Spindulėlių;2652882309;Ne;6;1;0;7
7910;Pasakaitė;Spindulėlių;4268438476;Taip;10;1;0;11
7911;Pasakaitė;Pasagėlių;2810892060;Ne;10;0;0;10
7912;Pasakaitė;Pasagėlių;9895144528;Taip;16;0;2;18
7913;Pasakaitė;Pasagėlių;6609127382;Ne;0;3;0;3
7914;Pasakaitė;Pasagėlių;9409907631;Taip;9;3;1;13
7915;Pasakaitė;Pasagėlių;5589440439;Taip;13;0;1;14
7916;Pasakaitė;Pasagėlių;5959875562;Taip;12;0;0;12
7917;Pasakaitė;Pasagėlių;3355268509;Taip;6;3;0;9
7918;Pasakaitė;Pasagėlių;1959599606;Taip;0;13;0;13
7919;Pasakaitė;Pasagėlių;7440327561;Taip;10;0;0;10
7920;Pasakaitė;Pasagėlių;6325408070;Ne;12;0;0;12
7921;Pasakaitė;Pasagėlių;9238905834;Taip;4;10;0;14
7922;Pasakaitė;Pasagėlių;5970146724;Ne;0;0;17;17
7923;Pasakaitė;Pasagėlių;4826492004;Taip;0;7;0;7
7924;Pasakaitė;Pasagėlių;7666033916;Taip;0;2;0;2
7925;Pasakaitė;Pasagėlių;5540251866;Taip;0;3;0;3
7926;Pasakaitė;Pasagėlių;7219080600;Ne;9;4;0;13
7927;Pasakaitė;Pasagėlių;8264189678;Taip;0;1;2;3
7928;Pasakaitė;Pasagėlių;2341175137;Taip;13;2;0;15
7929;Pasakaitė;Pasagėlių;8905681529;Taip;8;0;0;8
7930;Pasakaitė;Pasagėlių;8165055476;Taip;0;0;2;2
7931;Pasakaitė;Pasagėlių;7360801624;Taip;26;3;0;29
7932;Pasakaitė;Pasagėlių;5617173998;Taip;7;1;0;8
7933;Pasakaitė;Pasagėlių;5034077389;Taip;0;3;2;5
7934;Pasakaitė;Švyturėlių;7702359586;Taip;11;5;0;16
7935;Pasakaitė;Švyturėlių;6847782430;Taip;29;1;0;30
7936;Pasakaitė;Švyturėlių;1533259056;Taip;6;1;3;10
7937;Pasakaitė;Švyturėlių;4728731352;Taip;15;0;0;15
7938;Pasakaitė;Švyturėlių;2404448954;Taip;10;0;0;10
7939;Pasakaitė;Švyturėlių;9821617981;Taip;5;1;4;10
7940;Pasakaitė;Švyturėlių;1619513932;Taip;7;1;0;8
7941;Pasakaitė;Švyturėlių;1184513606;Taip;7;0;2;9
7942;Pasakaitė;Švyturėlių;2751828639;Taip;13;0;0;13
7943;Pasakaitė;Švyturėlių;4864779439;Ne;12;0;0;12
7944;Pasakaitė;Švyturėlių;8223662339;Taip;7;1;3;11
7945;Pasakaitė;Švyturėlių;3710143250;Taip;0;0;2;2
7946;Pasakaitė;Švyturėlių;2329827275;Taip;0;0;11;11
7947;Pasakaitė;Švyturėlių;2933474317;Taip;13;0;0;13
7948;Pasakaitė;Švyturėlių;5498393070;Ne;0;0;3;3
7949;Pasakaitė;Švyturėlių;9012098645;Ne;0;0;5;5
7950;Pasakaitė;Švyturėlių;4604843442;Taip;4;3;0;7
7951;Pasakaitė;Švyturėlių;3417077517;Taip;0;0;5;5
7952;Pasakaitė;Švyturėlių;1793453325;Taip;13;1;0;14
7953;Pasakaitė;Švyturėlių;1384552110;Taip;4;0;0;4
7954;Pasakaitė;Švyturėlių;4694818333;Taip;6;1;3;10
7955;Pasakaitė;Kodėlčiukų;8662488739;Taip;7;0;0;7
7956;Pasakaitė;Kodėlčiukų;9972985920;Taip;17;4;0;21
7957;Pasakaitė;Kodėlčiukų;5699688792;Taip;22;0;0;22
7958;Pasakaitė;Kodėlčiukų;9441990175;Taip;13;0;9;22
7959;Pasakaitė;Kodėlčiukų;1588525307;Taip;1;0;0;1
7960;Pasakaitė;Kodėlčiukų;4485053261;Taip;7;2;0;9
7961;Pasakaitė;Kodėlčiukų;9351971114;Taip;6;0;2;8
7962;Pasakaitė;Kodėlčiukų;2303884875;Taip;4;0;1;5
7963;Pasakaitė;Kodėlčiukų;9543262464;Taip;4;2;0;6
7964;Pasakaitė;Kodėlčiukų;4878562841;Taip;4;0;1;5
7965;Pasakaitė;Kodėlčiukų;2994653871;Taip;9;0;0;9
7966;Pasakaitė;Kodėlčiukų;4328440534;Taip;6;0;4;10
7967;Pasakaitė;Kodėlčiukų;4881361200;Ne;25;0;1;26
7968;Pasakaitė;Kodėlčiukų;2389832646;Taip;0;17;0;17
7969;Pasakaitė;Kodėlčiukų;7138417196;Taip;17;0;0;17
7970;Pasakaitė;Kodėlčiukų;5581264184;Taip;0;7;0;7
7971;Pasakaitė;Kodėlčiukų;8037316673;Ne;17;0;0;17
7972;Pasakaitė;Kodėlčiukų;5732009054;Taip;9;2;0;11
7973;Pasakaitė;Kodėlčiukų;2407824666;Taip;21;0;0;21
7974;Pasakaitė;Kodėlčiukų;6755983130;Taip;15;0;4;19
7975;Pasakaitė;Kodėlčiukų;2476010561;Taip;12;3;0;15
7976;Pasakaitė;Kodėlčiukų;3925034196;Taip;16;0;0;16
7977;Pasakaitė;Gudručių;6568538767;Ne;9;1;0;10
7978;Pasakaitė;Gudručių;1523034176;Taip;0;1;1;2
7979;Pasakaitė;Gudručių;5369558652;Taip;9;3;0;12
7980;Pasakaitė;Gudručių;1019010454;Taip;8;1;0;9
7981;Pasakaitė;Gudručių;4703375416;Taip;0;1;2;3
7982;Pasakaitė;Gudručių;1707428977;Taip;0;1;9;10
7983;Pasakaitė;Gudručių;9680682204;Taip;7;0;0;7
7984;Pasakaitė;Gudručių;3345955615;Taip;0;1;5;6
7985;Pasakaitė;Gudručių;1791015854;Taip;9;1;1;11
7986;Pasakaitė;Gudručių;39853246609;Taip;16;1;0;17
7987;Pasakaitė;Gudručių;4959175420;Taip;7;2;0;9
7988;Pasakaitė;Gudručių;6839399035;Taip;8;1;0;9
7989;Pasakaitė;Gudručių;3778906698;Taip;0;0;2;2
7990;Pasakaitė;Gudručių;1940545723;Taip;11;1;0;12
7991;Pasakaitė;Gudručių;9506178305;Taip;8;4;6;18
7992;Pasakaitė;Gudručių;1809383469;Taip;10;1;0;11
7993;Pasakaitė;Gudručių;1592521766;Taip;8;0;0;8
7994;Pasakaitė;Gudručių;4008826950;Taip;9;1;2;12
7995;Pasakaitė;Gudručių;9031690002;Taip;3;1;3;7
7996;Pasakaitė;Gudručių;2742595829;Taip;0;5;0;5
7997;Pasakaitė;Gudručių;1513903341;Taip;5;12;0;17
7998;Pasakaitė;Gudručių;8390366303;Taip;12;1;2;15
7999;Pasakaitė;Gudručių;3231283338;Taip;9;0;0;9
8000;Pasakaitė;Čiulbonėlių;4680949976;Taip;0;10;0;10
8001;Pasakaitė;Čiulbonėlių;7152349570;Taip;0;16;0;16
8002;Pasakaitė;Čiulbonėlių;1458338379;Taip;19;2;0;21
8003;Pasakaitė;Čiulbonėlių;7526264241;Taip;7;3;0;10
8004;Pasakaitė;Čiulbonėlių;3541877287;Taip;3;1;0;4
8005;Pasakaitė;Čiulbonėlių;4974486850;Ne;7;3;2;12
8006;Pasakaitė;Čiulbonėlių;7607522887;Taip;5;11;0;16
8007;Pasakaitė;Čiulbonėlių;3606601644;Taip;7;2;0;9
8008;Pasakaitė;Čiulbonėlių;5313360864;Taip;9;0;0;9
8009;Pasakaitė;Čiulbonėlių;3579498202;Taip;0;2;0;2
8010;Pasakaitė;Čiulbonėlių;7790937149;Taip;16;1;0;17
8011;Pasakaitė;Čiulbonėlių;3400305768;Taip;12;1;2;15
8012;Pasakaitė;Čiulbonėlių;3165658822;Taip;0;5;0;5
8013;Pasakaitė;Čiulbonėlių;83018133588;Taip;0;0;1;1
8014;Pasakaitė;Čiulbonėlių;4013900094;Taip;0;1;0;1
8015;Pasakaitė;Čiulbonėlių;61230317080;Ne;0;7;0;7
8016;Pasakaitė;Čiulbonėlių;8466086339;Taip;14;4;0;18
8017;Pasakaitė;Čiulbonėlių;3259688782;Taip;2;0;0;2
8018;Pasakaitė;Čiulbonėlių;5467179333;Taip;10;1;0;11
8019;Pasakaitė;Čiulbonėlių;1740419218;Taip;5;5;0;10
8020;Pasakaitė;Čiulbonėlių;8469043564;Taip;6;1;5;12
8021;Pasakaitė;"Verpstelių ";7621306769;Taip;0;12;0;12
8022;Pasakaitė;"Verpstelių ";4946855684;Taip;12;4;0;16
8023;Pasakaitė;"Verpstelių ";5556362727;Ne;0;0;6;6
8024;Pasakaitė;"Verpstelių ";7451624229;Ne;0;0;2;2
8025;Pasakaitė;"Verpstelių ";7759051761;Taip;6;8;0;14
8026;Pasakaitė;"Verpstelių ";8315840473;Taip;10;0;1;11
8027;Pasakaitė;"Verpstelių ";1744216870;Taip;0;5;0;5
8028;Pasakaitė;"Verpstelių ";1425166722;Ne;7;0;4;11
8029;Pasakaitė;"Verpstelių ";7813221735;Taip;5;15;1;21
8030;Pasakaitė;"Verpstelių ";9166649594;Taip;5;1;1;7
8031;Pasakaitė;"Verpstelių ";4246461594;Taip;7;0;21;28
8032;Pasakaitė;"Verpstelių ";1963102227;Taip;21;3;1;25
8033;Pasakaitė;"Verpstelių ";8267725352;Taip;14;5;1;20
8034;Pasakaitė;"Verpstelių ";8562284745;Taip;18;2;0;20
8035;Pasakaitė;"Verpstelių ";1041405418;Taip;7;17;0;24
8036;Pasakaitė;"Verpstelių ";7976921380;Taip;11;2;0;13
8037;Pasakaitė;"Verpstelių ";2505815026;Taip;22;0;8;30
8038;Pasakaitė;"Verpstelių ";5413457806;Taip;14;0;0;14
8039;Pasakaitė;"Verpstelių ";1115383380;Taip;13;0;1;14
8040;Pasakaitė;"Verpstelių ";2714905466;Taip;0;0;14;14
8041;Pasakaitė;"Verpstelių ";9226989209;Taip;10;5;0;15
8042;Pasakaitė;"Verpstelių ";8927014508;Taip;7;0;2;9
8043;Pasakaitė;Smalsučiai;7539851375;Taip;10;0;0;10
8044;Pasakaitė;Smalsučiai;9114337491;Taip;12;0;1;13
8045;Pasakaitė;Smalsučiai;2278658674;Taip;12;0;0;12
8046;Pasakaitė;Smalsučiai;7557414266;Taip;4;2;0;6
8047;Pasakaitė;Smalsučiai;6522727154;Taip;13;1;1;15
8048;Pasakaitė;Smalsučiai;8711237946;Taip;17;0;0;17
8049;Pasakaitė;Smalsučiai;1122248122;Taip;22;0;0;22
8050;Pasakaitė;Smalsučiai;9982451343;Taip;15;2;0;17
8051;Pasakaitė;Smalsučiai;4977052991;Taip;3;11;0;14
8052;Pasakaitė;Smalsučiai;7604996145;Taip;22;0;0;22
8053;Pasakaitė;Smalsučiai;4144569088;Taip;8;0;0;8
8054;Pasakaitė;Smalsučiai;4307883488;Taip;0;7;0;7
8055;Pasakaitė;Smalsučiai;2546550685;Taip;13;0;0;13
8056;Pasakaitė;Smalsučiai;7994712153;Taip;12;0;4;16
8057;Pasakaitė;"Čiauškučiai ";7399335037;Ne;7;3;0;10
8058;Pasakaitė;"Čiauškučiai ";4098119950;Taip;4;4;0;8
8059;Pasakaitė;"Čiauškučiai ";9512782063;Taip;8;0;0;8
8060;Pasakaitė;"Čiauškučiai ";6229020982;Taip;10;1;0;11
8061;Pasakaitė;"Čiauškučiai ";5279719152;Taip;9;3;0;12
8062;Pasakaitė;"Čiauškučiai ";6160327808;Taip;8;0;0;8
8063;Pasakaitė;"Čiauškučiai ";4898974534;Taip;9;0;0;9
8064;Pasakaitė;"Čiauškučiai ";3691817711;Taip;9;7;0;16
8065;Pasakaitė;"Čiauškučiai ";3659371923;Taip;7;0;0;7
8066;Pasakaitė;"Čiauškučiai ";7885958426;Taip;8;0;0;8
8067;Pasakaitė;"Čiauškučiai ";2902368705;Taip;0;18;0;18
8068;Pasakaitė;"Čiauškučiai ";2041179927;Taip;14;0;0;14
8069;Pasakaitė;"Čiauškučiai ";6745120294;Taip;11;2;0;13
8070;Pasakaitė;"Čiauškučiai ";4120765793;Taip;10;0;0;10
8071;Pasakaitė;Pabiručiai;5180059311;Taip;13;6;2;21
8072;Pasakaitė;Pabiručiai;5162170061;Taip;10;0;0;10
8073;Pasakaitė;Pabiručiai;8478538959;Taip;0;0;11;11
8074;Pasakaitė;Pabiručiai;6795204239;Taip;9;0;5;14
8075;Pasakaitė;Pabiručiai;5058070480;Taip;13;3;2;18
8076;Pasakaitė;Pabiručiai;1453976284;Ne;0;3;19;22
8077;Pasakaitė;Pabiručiai;8559244062;Ne;19;0;3;22
8078;Pasakaitė;Pabiručiai;9790988677;Taip;6;12;0;18
8079;Pasakaitė;Pabiručiai;5439936572;Taip;12;10;0;22
8080;Pasakaitė;Pabiručiai;4316883215;Taip;15;0;0;15
8081;Pasakaitė;Pabiručiai;6682010485;Taip;8;3;4;15
8082;Pasakaitė;Pabiručiai;3466308130;Taip;22;0;0;22
8083;Pasakaitė;Pabiručiai;9402238675;Taip;10;0;0;10
8084;Pasakaitė;Pabiručiai;9311649698;Taip;9;0;0;9
8085;Pasakaitė;Pabiručiai;5499373802;Taip;17;0;1;18
8086;Pasakaitė;Linksmučiai;7965916747;Taip;18;0;0;18
8087;Pasakaitė;Linksmučiai;1279728451;Taip;17;0;0;17
8088;Pasakaitė;Linksmučiai;2584717150;Taip;13;0;1;14
8089;Pasakaitė;Linksmučiai;4397797616;Taip;20;0;1;21
8090;Pasakaitė;Linksmučiai;4659277297;Taip;8;0;1;9
8091;Pasakaitė;Linksmučiai;8381083251;Taip;8;0;0;8
8092;Pasakaitė;Linksmučiai;8252123824;Taip;15;0;0;15
8093;Pasakaitė;Linksmučiai;4444725869;Ne;7;0;1;8
8094;Pasakaitė;Linksmučiai;2801785334;Ne;22;0;0;22
8095;Pasakaitė;Linksmučiai;4369400507;Ne;0;0;5;5
8096;Pasakaitė;Linksmučiai;9606533767;Taip;5;5;2;12
8097;Pasakaitė;Linksmučiai;2899659479;Taip;21;0;0;21
8098;Pasakaitė;Linksmučiai;8160163060;Taip;7;0;7;14
8099;Pasakaitė;Linksmučiai;8350808883;Taip;13;0;0;13
8100;Pasakaitė;Linksmučiai;5745073940;Taip;13;0;1;14
8101;Pelėda;KIŠKUČIAI;5022388487;Taip;7;0;0;7
8102;Pelėda;KIŠKUČIAI;4683105330;Taip;21;0;0;21
8103;Pelėda;PELIUKAI;5817759212;Taip;9;0;0;9
8104;Pelėda;PELIUKAI;2401684712;Taip;13;0;0;13
8105;Pelėda;PELIUKAI;3826393044;Taip;11;0;0;11
8106;Pelėda;GUDRUČIAI;1170566784;Ne;10;0;0;10
8107;Pelėda;ŽIRNIUKAI;8383892842;Taip;11;0;0;11
8108;Pelėda;ŽIRNIUKAI;4561020945;Taip;10;0;0;10
8109;Pelėda;KODĖLČIUKAI;3071845347;Taip;5;0;0;5
8110;Pelėda;KODĖLČIUKAI;6142353763;Taip;11;0;0;11
8111;Pelėda;KODĖLČIUKAI;5942764642;Taip;9;0;0;9
8112;Pelėda;KODĖLČIUKAI;4273955889;Taip;5;0;0;5
8113;Pelėda;ĄŽUOLIUKAI;5274805168;Ne;8;0;0;8
8114;Pelėda;ĄŽUOLIUKAI;7135083783;Taip;15;0;0;15
8115;Pelėda;ĄŽUOLIUKAI;2035408478;Taip;16;0;0;16
8116;Pelėda;NYKŠTUKAI;1025126999;Taip;10;0;0;10
8117;Pelėda;NYKŠTUKAI;3656600059;Taip;5;0;0;5
8118;Pelėda;NYKŠTUKAI;9405028368;Taip;5;0;0;5
8119;Pelėda;BORUŽIUKŲ;5888109663;Taip;5;0;0;5
8120;Pelėda;BORUŽIUKŲ;2600073553;Taip;23;0;0;23
8121;Pelėda;BORUŽIUKŲ;8768572308;Taip;9;0;0;9
8122;Pelėda;DRUGELIAI;6304939435;Taip;10;0;0;10
8123;Pelėda;DRUGELIAI;7008368113;Taip;10;0;0;10
8124;Pelėda;OBUOLIUKAI;4593471819;Taip;5;0;0;5
8125;Pelėda;OBUOLIUKAI;2671545779;Taip;4;0;0;4
8126;Pelėda;BITUTĖS;4412199233;Taip;13;0;0;13
8127;Pelėda;BITUTĖS;9748236454;Taip;11;0;0;11
8128;Pelėda;SMALSUČIAI;9243579706;Taip;13;0;0;13
8129;Pelėda;SMALSUČIAI;9464415942;Taip;2;0;0;2
8130;Pelėda;SMALSUČIAI;5245555064;Taip;7;0;0;7
8131;Pelėda;SMALSUČIAI;7629444214;Taip;8;0;0;8
8132;Pelėda;SMALSUČIAI;1962928106;Taip;4;0;0;4
8133;Pelėda;SMALSUČIAI;4486503894;Taip;11;0;0;11
8134;Pelėda;"NAUJA DARŽELIS";3783477511;Ne;10;0;0;10
8135;Pelenė;Varpelis;2647876561;Taip;21;5;0;26
8136;Pelenė;Varpelis;8807342148;Taip;8;1;0;9
8137;Pelenė;Varpelis;5697826755;Taip;0;0;1;1
8138;Pelenė;Varpelis;4004975235;Taip;22;0;0;22
8139;Pelenė;Varpelis;8790613872;Taip;22;0;0;22
8140;Pelenė;Varpelis;2487632125;Taip;8;0;7;15
8141;Pelenė;Varpelis;5228983908;Taip;5;0;1;6
8142;Pelenė;Varpelis;3174009848;Taip;7;0;3;10
8143;Pelenė;Varpelis;6524101295;Taip;0;0;7;7
8144;Pelenė;Varpelis;8038559319;Taip;0;3;1;4
8145;Pelenė;Varpelis;7578318198;Taip;10;6;0;16
8146;Pelenė;Varpelis;1080017906;Taip;18;0;0;18
8147;Pelenė;Varpelis;4777496709;Taip;6;0;4;10
8148;Pelenė;Varpelis;9447223913;Taip;0;1;13;14
8149;Pelenė;Varpelis;6894978459;Taip;20;1;0;21
8150;Pelenė;Varpelis;4321705575;Taip;0;4;0;4
8151;Pelenė;Varpelis;2103177773;Taip;1;0;1;2
8152;Pelenė;Varpelis;6864263698;Taip;20;0;0;20
8153;Pelenė;Varpelis;4521556853;Taip;0;0;6;6
8154;Pelenė;Saulutės;7880284433;Taip;4;0;0;4
8155;Pelenė;Saulutės;1468658102;Taip;8;0;11;19
8156;Pelenė;Saulutės;1775717256;Ne;0;1;2;3
8157;Pelenė;Saulutės;4315677064;Ne;0;4;0;4
8158;Pelenė;Saulutės;7587887488;Ne;5;4;0;9
8159;Pelenė;Saulutės;5389865440;Taip;5;0;1;6
8160;Pelenė;Saulutės;8716395810;Ne;0;1;0;1
8161;Pelenė;Saulutės;6191899254;Taip;5;3;0;8
8162;Pelenė;Saulutės;6481466282;Taip;0;5;0;5
8163;Pelenė;Saulutės;6707167720;Taip;0;0;2;2
8164;Pelenė;Saulutės;8466974910;Taip;0;1;0;1
8165;Pelenė;Saulutės;2393964666;Taip;0;14;0;14
8166;Pelenė;Saulutės;5780697554;Taip;0;5;0;5
8167;Pelenė;Saulutės;4989239822;Taip;4;0;0;4
8168;Pelenė;Saulutės;6221703608;Taip;10;0;0;10
8169;Pelenė;Saulutės;1278011268;Taip;0;4;0;4
8170;Pelenė;Saulutės;2426412323;Taip;0;3;0;3
8171;Pelenė;Saulutės;6267178572;Taip;0;8;0;8
8172;Pelenė;Raktelis;9195113444;Taip;0;6;0;6
8173;Pelenė;Raktelis;9075193730;Taip;0;0;1;1
8174;Pelenė;Raktelis;4591637887;Taip;0;8;0;8
8175;Pelenė;Raktelis;7088493729;Taip;0;0;1;1
8176;Pelenė;Raktelis;4090532624;Ne;4;8;2;14
8177;Pelenė;Raktelis;8123162647;Taip;0;4;0;4
8178;Pelenė;Raktelis;3573543545;Ne;0;10;0;10
8179;Pelenė;Raktelis;7659625628;Taip;8;0;4;12
8180;Pelenė;Raktelis;6375060159;Taip;0;5;0;5
8181;Pelenė;Raktelis;2210314952;Taip;0;7;0;7
8182;Pelenė;Raktelis;6419661741;Taip;0;4;0;4
8183;Pelenė;Raktelis;4089199552;Taip;10;1;2;13
8184;Pelenė;Raktelis;6038229659;Taip;4;5;4;13
8185;Pelenė;Raktelis;1060619471;Taip;9;0;0;9
8186;Pelenė;Raktelis;5749399210;Taip;6;5;1;12
8187;Pelenė;Raktelis;4448592497;Taip;6;0;0;6
8188;Pelenė;Raktelis;5333802902;Taip;8;7;0;15
8189;Pelenė;Raktelis;8517226350;Taip;6;2;0;8
8190;Pelenė;Raktelis;1049199372;Taip;0;8;0;8
8191;Pelenė;Raktelis;2241816838;Taip;0;0;3;3
8192;Pelenė;Raktelis;5063098703;Taip;0;14;0;14
8193;Pelenė;Raktelis;6007163187;Taip;0;0;1;1
8194;Pelenė;Žvaigždutės;9473901831;Taip;0;8;1;9
8195;Pelenė;Žvaigždutės;2476080951;Taip;5;0;1;6
8196;Pelenė;Žvaigždutės;5587759166;Taip;3;0;0;3
8197;Pelenė;Žvaigždutės;5548367924;Taip;3;0;19;22
8198;Pelenė;Žvaigždutės;5031778158;Taip;0;13;0;13
8199;Pelenė;Žvaigždutės;4056676361;Taip;0;0;5;5
8200;Pelenė;Žvaigždutės;6014571367;Ne;0;3;1;4
8201;Pelenė;Žvaigždutės;4602503400;Taip;3;0;1;4
8202;Pelenė;Žvaigždutės;2555464779;Taip;19;0;0;19
8203;Pelenė;Žvaigždutės;9530531472;Ne;12;0;2;14
8204;Pelenė;Žvaigždutės;2040256240;Taip;0;0;3;3
8205;Pelenė;Žvaigždutės;4870187198;Taip;0;2;2;4
8206;Pelenė;Žvaigždutės;7640768043;Taip;22;0;0;22
8207;Pelenė;Žvaigždutės;5894429453;Taip;11;0;0;11
8208;Pelenė;Žvaigždutės;4737217659;Ne;0;0;6;6
8209;Pelenė;Žvaigždutės;4109516555;Taip;6;13;0;19
8210;Pelenė;Žvaigždutės;5357701072;Taip;0;0;10;10
8211;Pelenė;Nykštukas;4541391191;Ne;0;3;0;3
8212;Pelenė;Nykštukas;9584503078;Ne;5;1;2;8
8213;Pelenė;Nykštukas;8770771520;Ne;0;3;1;4
8214;Pelenė;Nykštukas;10457480694;Taip;0;1;4;5
8215;Pelenė;Nykštukas;7254981715;Taip;0;11;0;11
8216;Pelenė;Nykštukas;6579504852;Taip;0;11;0;11
8217;Pelenė;Nykštukas;6021833025;Taip;0;7;0;7
8218;Pelenė;Nykštukas;1978481168;Taip;9;5;0;14
8219;Pelenė;Nykštukas;3596386480;Taip;0;2;0;2
8220;Pelenė;Nykštukas;7205437280;Taip;10;0;1;11
8221;Pelenė;Nykštukas;3385568839;Ne;0;3;2;5
8222;Pelenė;Nykštukas;7589978427;Taip;0;4;0;4
8223;Pelenė;Nykštukas;3189305906;Taip;0;10;0;10
8224;Pelenė;Nykštukas;1750366978;Taip;0;3;6;9
8225;Pelenė;Nykštukas;2092775878;Taip;4;5;0;9
8226;Pelenė;Nykštukas;1142014148;Ne;5;2;0;7
8227;Pelenė;Nykštukas;1605794833;Taip;0;5;0;5
8228;Pelenė;Nykštukas;9063588699;Taip;0;9;0;9
8229;Pelenė;Nykštukas;9621197758;Taip;0;3;0;3
8230;Pelenė;Nykštukas;3296147024;Taip;0;8;0;8
8231;Pelenė;Žirniukai;8529178313;Taip;10;0;6;16
8232;Pelenė;Žirniukai;9601582419;Taip;15;0;0;15
8233;Pelenė;Žirniukai;7399112026;Taip;0;0;9;9
8234;Pelenė;Žirniukai;2443906444;Ne;9;0;0;9
8235;Pelenė;Žirniukai;5922348478;Taip;9;3;1;13
8236;Pelenė;Žirniukai;1313425695;Taip;8;3;0;11
8237;Pelenė;Žirniukai;5211115955;Taip;15;0;2;17
8238;Pelenė;Žirniukai;1595627222;Taip;5;14;0;19
8239;Pelenė;Žirniukai;2438266396;Taip;0;13;0;13
8240;Pelenė;Žirniukai;2590035984;Taip;0;9;0;9
8241;Pelenė;Žirniukai;3863839750;Taip;11;2;0;13
8242;Pelenė;Žirniukai;5686182866;Ne;0;0;4;4
8243;Pelenė;Žirniukai;7383544475;Taip;0;20;0;20
8244;Pelenė;Žirniukai;2270989478;Taip;0;20;0;20
8245;Pelenė;Žirniukai;8617997163;Taip;19;1;5;25
8246;Pelenė;Žirniukai;7959433937;Taip;9;0;2;11
8247;Pelenė;Žirniukai;4703442187;Ne;6;9;1;16
8248;Pelenė;Lašeliai;7017031073;Taip;9;0;0;9
8249;Pelenė;Lašeliai;9018211726;Taip;0;2;4;6
8250;Pelenė;Lašeliai;9313153383;Taip;0;20;0;20
8251;Pelenė;Lašeliai;5836118223;Taip;9;3;1;13
8252;Pelenė;Lašeliai;6316640679;Taip;0;3;12;15
8253;Pelenė;Lašeliai;1711603372;Taip;9;9;0;18
8254;Pelenė;Lašeliai;1944933777;Taip;0;18;0;18
8255;Pelenė;Lašeliai;2303618074;Taip;0;0;4;4
8256;Pelenė;Lašeliai;6167965418;Taip;16;0;0;16
8257;Pelenė;Lašeliai;2765650058;Taip;16;0;0;16
8258;Pelenė;Lašeliai;8841183816;Taip;9;3;0;12
8259;Pelenė;Lašeliai;4431474395;Taip;9;5;0;14
8260;Pelenė;Lašeliai;9097123374;Taip;9;6;0;15
8261;Pelenė;Lašeliai;9162252512;Ne;9;5;8;22
8262;Pelenė;Lašeliai;4695104609;Taip;0;11;0;11
8263;Pelenė;Lašeliai;7148956863;Taip;8;9;0;17
8264;Pelenė;Lašeliai;3663288138;Taip;7;3;0;10
8265;Pelenė;Lašeliai;4148108151;Taip;0;7;0;7
8266;Pelenė;Lašeliai;1303066945;Taip;10;2;0;12
8267;Pelenė;Lašeliai;3563882751;Ne;6;16;0;22
8268;Pelenė;Grūdelis;4624325473;Ne;0;13;0;13
8269;Pelenė;Grūdelis;1868951268;Taip;3;1;0;4
8270;Pelenė;Grūdelis;1902314385;Taip;0;1;4;5
8271;Pelenė;Grūdelis;1140030742;Taip;0;3;0;3
8272;Pelenė;Grūdelis;69721118552;Taip;3;1;5;9
8273;Pelenė;Grūdelis;1336431888;Ne;0;7;2;9
8274;Pelenė;Grūdelis;6632188229;Taip;19;9;0;28
8275;Pelenė;Grūdelis;5356756237;Taip;0;0;6;6
8276;Pelenė;Grūdelis;39705461573;Ne;0;4;0;4
8277;Pelenė;Grūdelis;2154553741;Taip;0;1;0;1
8278;Pelenė;Grūdelis;3497915398;Taip;0;1;0;1
8279;Pelenė;Grūdelis;8598498275;Taip;0;12;0;12
8280;Pelenė;Grūdelis;8404317146;Taip;0;1;3;4
8281;Pelenė;Grūdelis;4307283949;Taip;4;1;0;5
8282;Pelenė;Grūdelis;9009271610;Ne;0;10;0;10
8283;Pelenė;Grūdelis;1710249888;Taip;0;1;2;3
8284;Pelenė;Grūdelis;5325176433;Taip;0;12;0;12
8285;Pelenė;Grūdelis;1114786936;Taip;12;1;0;13
8286;Pelenė;Grūdelis;1245955282;Taip;0;5;0;5
8287;Pelenė;Grūdelis;6790396551;Ne;0;1;5;6
8288;Pelenė;Braškytė;7602432318;Taip;0;8;0;8
8289;Pelenė;Braškytė;2689903631;Taip;3;15;0;18
8290;Pelenė;Braškytė;4982869687;Taip;5;0;0;5
8291;Pelenė;Braškytė;3499827987;Ne;0;8;0;8
8292;Pelenė;Braškytė;8165766331;Taip;14;3;0;17
8293;Pelenė;Braškytė;1384382692;Taip;11;3;0;14
8294;Pelenė;Braškytė;5944620142;Taip;6;2;1;9
8295;Pelenė;Braškytė;4734502322;Taip;12;0;4;16
8296;Pelenė;Braškytė;8504675439;Taip;0;15;0;15
8297;Pelenė;Braškytė;2407328091;Ne;0;2;0;2
8298;Pelenė;Braškytė;8861981715;Taip;10;3;0;13
8299;Pelenė;Braškytė;6306403720;Taip;22;0;0;22
8300;Pelenė;Braškytė;9490816122;Taip;5;0;0;5
8301;Pelenė;Braškytė;2096373376;Taip;0;18;0;18
8302;Pelenė;Boružėlės;4961852594;Taip;0;0;2;2
8303;Pelenė;Boružėlės;1975574464;Taip;13;0;5;18
8304;Pelenė;Boružėlės;5024793693;Taip;8;0;0;8
8305;Pelenė;Boružėlės;6567413229;Ne;0;0;3;3
8306;Pelenė;Boružėlės;6231387335;Taip;0;20;0;20
8307;Pelenė;Boružėlės;3700618977;Taip;21;0;0;21
8308;Pelenė;Boružėlės;5872711862;Taip;0;3;0;3
8309;Pelenė;Boružėlės;6081335781;Taip;0;5;0;5
8310;Pelenė;Boružėlės;3060502977;Taip;8;0;1;9
8311;Pelenė;Boružėlės;1268615831;Taip;8;0;2;10
8312;Pelenė;Boružėlės;4396011355;Taip;4;0;0;4
8313;Pelenė;Boružėlės;6304818782;Taip;4;3;0;7
8314;Pelenė;Boružėlės;8718308575;Taip;0;22;0;22
8315;Pelenė;Boružėlės;5743530682;Ne;5;0;0;5
8316;Pelenė;Boružėlės;6867256280;Taip;0;0;1;1
8317;Pelenė;Boružėlės;7341814322;Ne;0;0;1;1
8318;Pelenė;Saldainiukai;5028095861;Ne;12;0;0;12
8319;Pelenė;Saldainiukai;9505945890;Taip;8;3;1;12
8320;Pelenė;Saldainiukai;8202196292;Taip;0;5;0;5
8321;Pelenė;Saldainiukai;5066227318;Taip;9;0;0;9
8322;Pelenė;Saldainiukai;4305733824;Taip;0;4;5;9
8323;Pelenė;Saldainiukai;2986690431;Taip;9;0;0;9
8324;Pelenė;Saldainiukai;4051874126;Taip;0;11;0;11
8325;Pelenė;Saldainiukai;4660385383;Taip;8;0;1;9
8326;Pelenė;Saldainiukai;8862429244;Taip;12;0;3;15
8327;Pelenė;Saldainiukai;9969975097;Ne;0;4;2;6
8328;Pelenė;Saldainiukai;5762403752;Taip;12;4;0;16
8329;Pelenė;Saldainiukai;5926700157;Taip;7;0;0;7
8330;Pelenė;Saldainiukai;8961082265;Taip;0;8;0;8
8331;Pelenė;Saldainiukai;2882716674;Taip;0;0;2;2
8332;Pelenė;Saldainiukai;4859437855;Taip;0;0;18;18
8333;Pelenė;Saldainiukai;4023923887;Taip;13;0;1;14
8334;Pelenė;Drugeliai;2540405047;Taip;0;0;7;7
8335;Pelenė;Drugeliai;3603352172;Taip;22;0;0;22
8336;Pelenė;Drugeliai;5084452088;Ne;0;7;0;7
8337;Pelenė;Drugeliai;9218868317;Taip;0;0;5;5
8338;Pelenė;Drugeliai;2628676128;Taip;0;0;3;3
8339;Pelenė;Drugeliai;6834792589;Taip;8;0;0;8
8340;Pelenė;Drugeliai;1048899958;Taip;3;0;1;4
8341;Pelenė;Drugeliai;3327213856;Taip;8;0;0;8
8342;Pelenė;Drugeliai;6252972353;Taip;21;0;0;21
8343;Pelenė;Drugeliai;1584256570;Taip;10;1;0;11
8344;Pelenė;Drugeliai;3205331614;Taip;0;1;2;3
8345;Pelenė;Drugeliai;5631629419;Ne;0;17;0;17
8346;Pelenė;Drugeliai;2163737781;Taip;0;15;0;15
8347;Pelenė;Drugeliai;9004080625;Ne;9;0;5;14
8348;Pelenė;Drugeliai;7565331966;Taip;0;17;0;17
8349;Pelenė;Drugeliai;5074054534;Taip;0;3;0;3
8350;Pelenė;Drugeliai;8194354176;Ne;0;0;1;1
8351;Pelenė;Drugeliai;5579900958;Taip;3;1;2;6
8352;Pipiras;EŽIUKAI;1876870081;Taip;11;3;0;14
8353;Pipiras;EŽIUKAI;9275905384;Taip;7;7;0;14
8354;Pipiras;EŽIUKAI;41585818819;Taip;0;6;0;6
8355;Pipiras;EŽIUKAI;6153579332;Taip;7;1;0;8
8356;Pipiras;EŽIUKAI;1391958633;Taip;0;4;0;4
8357;Pipiras;EŽIUKAI;5637557921;Taip;2;0;0;2
8358;Pipiras;EŽIUKAI;7799786844;Taip;10;3;0;13
8359;Pipiras;EŽIUKAI;5014457985;Taip;22;0;0;22
8360;Pipiras;EŽIUKAI;1050430252;Ne;2;2;0;4
8361;Pipiras;EŽIUKAI;1904376366;Taip;0;7;0;7
8362;Pipiras;EŽIUKAI;3008358842;Ne;8;3;0;11
8363;Pipiras;EŽIUKAI;2024777430;Taip;9;1;0;10
8364;Pipiras;EŽIUKAI;2402351134;Taip;19;3;0;22
8365;Pipiras;EŽIUKAI;2255644686;Taip;0;5;4;9
8366;Pipiras;EŽIUKAI;7736031786;Taip;0;5;5;10
8367;Pipiras;EŽIUKAI;4959823035;Taip;17;1;0;18
8368;Pipiras;EŽIUKAI;1128674099;Taip;0;5;2;7
8369;Pipiras;EŽIUKAI;6339186940;Taip;0;4;0;4
8370;Pipiras;EŽIUKAI;3422170541;Taip;19;3;0;22
8371;Pipiras;EŽIUKAI;3314276870;Taip;0;15;0;15
8372;Pipiras;EŽIUKAI;7784343130;Ne;10;4;0;14
8373;Pipiras;BITUTĖS;3851239592;Taip;22;0;0;22
8374;Pipiras;BITUTĖS;1645482584;Taip;16;0;0;16
8375;Pipiras;BITUTĖS;7891664385;Taip;0;17;0;17
8376;Pipiras;BITUTĖS;9050423801;Taip;0;8;0;8
8377;Pipiras;BITUTĖS;3794537946;Taip;5;0;0;5
8378;Pipiras;BITUTĖS;5047070127;Taip;0;0;8;8
8379;Pipiras;BITUTĖS;2645772675;Taip;1;0;0;1
8380;Pipiras;BITUTĖS;9394456452;Taip;18;0;0;18
8381;Pipiras;BITUTĖS;9610070604;Taip;13;2;0;15
8382;Pipiras;BITUTĖS;7009194986;Taip;9;0;1;10
8383;Pipiras;BITUTĖS;6362968454;Taip;10;8;0;18
8384;Pipiras;BITUTĖS;6273958740;Taip;4;5;0;9
8385;Pipiras;BITUTĖS;2887703782;Ne;2;8;0;10
8386;Pipiras;BITUTĖS;9950318827;Taip;1;4;0;5
8387;Pipiras;BITUTĖS;9733577233;Taip;9;0;4;13
8388;Pipiras;NYKŠTUKAI;6696824728;Taip;11;1;0;12
8389;Pipiras;NYKŠTUKAI;2016718354;Taip;1;0;0;1
8390;Pipiras;NYKŠTUKAI;1169481984;Taip;6;0;5;11
8391;Pipiras;NYKŠTUKAI;4198534687;Taip;10;6;0;16
8392;Pipiras;NYKŠTUKAI;4458730479;Ne;10;1;0;11
8393;Pipiras;NYKŠTUKAI;4510888337;Ne;0;11;0;11
8394;Pipiras;NYKŠTUKAI;3980950261;Taip;22;0;0;22
8395;Pipiras;NYKŠTUKAI;7828638329;Taip;0;7;0;7
8396;Pipiras;NYKŠTUKAI;6775489564;Taip;0;0;16;16
8397;Pipiras;NYKŠTUKAI;8689174023;Taip;2;0;0;2
8398;Pipiras;NYKŠTUKAI;7747049622;Taip;5;3;0;8
8399;Pipiras;NYKŠTUKAI;9892201598;Taip;3;9;0;12
8400;Pipiras;NYKŠTUKAI;7371386368;Taip;8;2;1;11
8401;Pipiras;NYKŠTUKAI;1019753152;Taip;0;7;0;7
8402;Pipiras;NYKŠTUKAI;9499869533;Taip;3;1;0;4
8403;Pipiras;NYKŠTUKAI;5141447649;Taip;2;0;0;2
8404;Pipiras;NYKŠTUKAI;9877682150;Taip;0;3;0;3
8405;Pipiras;NYKŠTUKAI;9248925267;Taip;0;7;0;7
8406;Pipiras;NYKŠTUKAI;9711147855;Taip;0;0;6;6
8407;Pipiras;PELĖDŽIUKAI;6342044341;Ne;10;1;0;11
8408;Pipiras;PELĖDŽIUKAI;5725956659;Taip;15;0;0;15
8409;Pipiras;PELĖDŽIUKAI;3852848863;Taip;0;1;0;1
8410;Pipiras;PELĖDŽIUKAI;3882437376;Taip;2;0;0;2
8411;Pipiras;PELĖDŽIUKAI;9157870634;Taip;0;1;0;1
8412;Pipiras;PELĖDŽIUKAI;5235868332;Taip;7;3;0;10
8413;Pipiras;PELĖDŽIUKAI;3554786173;Taip;0;5;0;5
8414;Pipiras;PELĖDŽIUKAI;1034182352;Taip;3;2;0;5
8415;Pipiras;PELĖDŽIUKAI;2075041950;Taip;0;3;0;3
8416;Pipiras;PELĖDŽIUKAI;6792777396;Taip;10;3;0;13
8417;Pipiras;PELĖDŽIUKAI;6780333972;Taip;0;2;0;2
8418;Pipiras;PELĖDŽIUKAI;7934365114;Taip;0;5;0;5
8419;Pipiras;PELĖDŽIUKAI;6523189501;Taip;10;12;0;22
8420;Pipiras;PELĖDŽIUKAI;7161727352;Ne;0;6;0;6
8421;Pipiras;PELĖDŽIUKAI;9770780973;Taip;15;0;0;15
8422;Pipiras;PELĖDŽIUKAI;5845498558;Taip;4;1;0;5
8423;Pipiras;PELĖDŽIUKAI;9840040112;Ne;14;1;0;15
8424;Pipiras;PELĖDŽIUKAI;1784839485;Taip;9;4;0;13
8425;Pipiras;PELĖDŽIUKAI;3775916247;Ne;0;4;0;4
8426;Pipiras;PELĖDŽIUKAI;7350131214;Taip;16;2;0;18
8427;Pipiras;DRUGELIAI;5908707752;Ne;0;0;2;2
8428;Pipiras;DRUGELIAI;1957338631;Ne;0;4;0;4
8429;Pipiras;DRUGELIAI;5856735452;Taip;10;2;0;12
8430;Pipiras;DRUGELIAI;2267192782;Taip;1;10;0;11
8431;Pipiras;DRUGELIAI;1045583136;Taip;3;1;0;4
8432;Pipiras;DRUGELIAI;1711168196;Taip;5;0;0;5
8433;Pipiras;DRUGELIAI;7425654504;Taip;0;7;0;7
8434;Pipiras;DRUGELIAI;9479697733;Taip;0;1;2;3
8435;Pipiras;DRUGELIAI;4017042461;Taip;10;5;0;15
8436;Pipiras;DRUGELIAI;4725221169;Taip;11;6;0;17
8437;Pipiras;DRUGELIAI;5059203266;Taip;5;0;0;5
8438;Pipiras;DRUGELIAI;8140314304;Taip;1;2;1;4
8439;Pipiras;DRUGELIAI;8422419380;Taip;4;3;0;7
8440;Pipiras;DRUGELIAI;6791495556;Taip;0;2;0;2
8441;Pipiras;DRUGELIAI;4811029230;Taip;10;0;6;16
8442;Pipiras;DRUGELIAI;6363349541;Taip;0;2;0;2
8443;Pipiras;DRUGELIAI;6685567970;Taip;0;4;1;5
8444;Pipiras;DRUGELIAI;1353114929;Taip;8;5;0;13
8445;Pipiras;DRUGELIAI;4426479971;Ne;18;0;0;18
8446;Pipiras;GĖLYTĖS;9670710691;Taip;15;0;2;17
8447;Pipiras;GĖLYTĖS;8965139441;Taip;4;1;0;5
8448;Pipiras;GĖLYTĖS;2095794125;Taip;5;0;0;5
8449;Pipiras;GĖLYTĖS;4945164161;Taip;12;5;0;17
8450;Pipiras;GĖLYTĖS;7362002646;Taip;9;1;0;10
8451;Pipiras;GĖLYTĖS;5150723052;Taip;7;0;1;8
8452;Pipiras;GĖLYTĖS;3755824911;Ne;8;2;1;11
8453;Pipiras;GĖLYTĖS;4559954910;Taip;0;14;0;14
8454;Pipiras;GĖLYTĖS;7157187063;Taip;0;19;0;19
8455;Pipiras;GĖLYTĖS;4021613243;Taip;8;7;0;15
8456;Pipiras;GĖLYTĖS;1611488078;Taip;0;2;8;10
8457;Pipiras;GĖLYTĖS;4236597883;Taip;14;0;2;16
8458;Pipiras;GĖLYTĖS;4289497197;Taip;0;2;0;2
8459;Pipiras;GĖLYTĖS;2474548836;Taip;0;4;2;6
8460;Pipiras;GĖLYTĖS;8553422709;Taip;13;0;0;13
8461;Pipiras;GĖLYTĖS;5738334591;Taip;0;18;0;18
8462;Pipiras;GĖLYTĖS;6428525902;Taip;8;1;0;9
8463;Pipiras;GĖLYTĖS;8354158722;Taip;5;7;0;12
8464;Pipiras;BORUŽĖLĖS;4707794599;Taip;5;0;0;5
8465;Pipiras;BORUŽĖLĖS;8673271201;Taip;6;0;0;6
8466;Pipiras;BORUŽĖLĖS;5968015502;Taip;9;1;0;10
8467;Pipiras;BORUŽĖLĖS;4086728233;Taip;9;3;0;12
8468;Pipiras;BORUŽĖLĖS;8508292428;Taip;3;1;0;4
8469;Pipiras;BORUŽĖLĖS;1210940213;Taip;8;3;0;11
8470;Pipiras;BORUŽĖLĖS;8260680662;Taip;8;5;0;13
8471;Pipiras;BORUŽĖLĖS;9097987789;Ne;0;14;0;14
8472;Pipiras;BORUŽĖLĖS;6310054093;Taip;9;0;0;9
8473;Pipiras;BORUŽĖLĖS;8959946514;Taip;17;0;0;17
8474;Pipiras;BORUŽĖLĖS;9396979045;Taip;18;0;0;18
8475;Pipiras;BORUŽĖLĖS;8443786510;Taip;6;2;0;8
8476;Pipiras;BORUŽĖLĖS;1146369304;Taip;0;18;0;18
8477;Pipiras;BORUŽĖLĖS;9970587185;Taip;7;0;1;8
8478;Pipiras;BORUŽĖLĖS;6034298583;Taip;0;8;0;8
8479;Pipiras;BORUŽĖLĖS;6344932171;Ne;14;3;0;17
8480;Pipiras;BORUŽĖLĖS;1550959705;Taip;9;2;0;11
8481;Pipiras;SKRUZDĖLIUKAI;7969837759;Taip;0;6;0;6
8482;Pipiras;SKRUZDĖLIUKAI;2483867901;Taip;7;2;0;9
8483;Pipiras;SKRUZDĖLIUKAI;1315372873;Taip;0;8;0;8
8484;Pipiras;SKRUZDĖLIUKAI;9372109848;Taip;5;0;2;7
8485;Pipiras;SKRUZDĖLIUKAI;8296425777;Taip;0;7;0;7
8486;Pipiras;SKRUZDĖLIUKAI;9968182443;Ne;6;3;0;9
8487;Pipiras;SKRUZDĖLIUKAI;2296702730;Taip;0;0;9;9
8488;Pipiras;SKRUZDĖLIUKAI;3768825314;Taip;4;0;3;7
8489;Pipiras;SKRUZDĖLIUKAI;5888429623;Ne;2;3;0;5
8490;Pipiras;SKRUZDĖLIUKAI;4309096743;Taip;5;0;1;6
8491;Pipiras;SKRUZDĖLIUKAI;8081343184;Taip;0;6;0;6
8492;Pipiras;SKRUZDĖLIUKAI;9852475056;Ne;21;0;0;21
8493;Pipiras;SKRUZDĖLIUKAI;6176818802;Taip;16;0;0;16
8494;Pipiras;SKRUZDĖLIUKAI;6570068615;Taip;4;2;0;6
8495;Pipiras;SKRUZDĖLIUKAI;1215623527;Taip;0;6;0;6
8496;Pipiras;SKRUZDĖLIUKAI;1998249512;Taip;9;0;1;10
8497;Pipiras;SKRUZDĖLIUKAI;9625933545;Taip;0;9;0;9
8498;Pipiras;SKRUZDĖLIUKAI;7211189491;Taip;0;5;0;5
8499;Pipiras;ŽVIRBLIUKŲ;6340323302;Taip;0;0;2;2
8500;Pipiras;ŽVIRBLIUKŲ;5445858240;Taip;5;0;0;5
8501;Pipiras;ŽVIRBLIUKŲ;1242260242;Taip;2;3;0;5
8502;Pipiras;ŽVIRBLIUKŲ;4266424785;Taip;0;0;5;5
8503;Pipiras;ŽVIRBLIUKŲ;3421769229;Taip;0;5;0;5
8504;Pipiras;ŽVIRBLIUKŲ;8520454289;Taip;0;3;0;3
8505;Pipiras;ŽVIRBLIUKŲ;5422547144;Taip;0;6;0;6
8506;Pipiras;ŽVIRBLIUKŲ;6136423200;Taip;11;8;0;19
8507;Pipiras;ŽVIRBLIUKŲ;6694920607;Ne;0;10;0;10
8508;Pipiras;ŽVIRBLIUKŲ;7912217889;Taip;6;4;0;10
8509;Pipiras;ŽVIRBLIUKŲ;3141822820;Taip;10;6;0;16
8510;Pipiras;ŽVIRBLIUKŲ;7870521230;Taip;4;3;8;15
8511;Pipiras;ŽVIRBLIUKŲ;4428216634;Taip;0;3;2;5
8512;Pipiras;ŽVIRBLIUKŲ;5502001191;Taip;0;0;1;1
8513;Pipiras;ŽVIRBLIUKŲ;5778300856;Taip;7;1;0;8
8514;Pipiras;ŽVIRBLIUKŲ;3888552150;Taip;6;2;1;9
8515;Pipiras;ŽVIRBLIUKŲ;2240865490;Taip;5;0;0;5
8516;Pipiras;ŽVIRBLIUKŲ;2044498561;Taip;6;0;0;6
8517;Pipiras;ŽVIRBLIUKŲ;7026118693;Taip;7;4;2;13
8518;Pipiras;ŽVIRBLIUKŲ;1391682850;Taip;0;0;1;1
8519;Pipiras;ŽVIRBLIUKŲ;87924002679;Taip;0;7;0;7
8520;Pipiras;ŽVIRBLIUKŲ;4496076326;Taip;10;0;0;10
8521;Pipiras;ZUIKUČIŲ;3641496225;Taip;0;6;0;6
8522;Pipiras;ZUIKUČIŲ;6925577945;Taip;10;0;0;10
8523;Pipiras;ZUIKUČIŲ;9639609431;Taip;4;2;0;6
8524;Pipiras;ZUIKUČIŲ;1682281017;Taip;0;12;0;12
8525;Pipiras;ZUIKUČIŲ;9665655075;Taip;0;8;0;8
8526;Pipiras;ZUIKUČIŲ;2159315426;Taip;22;0;0;22
8527;Pipiras;ZUIKUČIŲ;2599175140;Taip;5;2;1;8
8528;Pipiras;ZUIKUČIŲ;7200147039;Taip;9;0;0;9
8529;Pipiras;ZUIKUČIŲ;5035593032;Taip;4;0;0;4
8530;Pipiras;ZUIKUČIŲ;6361544649;Taip;0;1;0;1
8531;Pipiras;ZUIKUČIŲ;1079088070;Taip;3;0;0;3
8532;Pipiras;ZUIKUČIŲ;4743474665;Taip;4;8;0;12
8533;Pipiras;ZUIKUČIŲ;9422467047;Ne;13;0;0;13
8534;Pipiras;ZUIKUČIŲ;4991725638;Taip;17;0;0;17
8535;Pipiras;ZUIKUČIŲ;9552763906;Taip;6;0;2;8
8536;Pipiras;VARLIUKŲ;7446225835;Taip;16;2;1;19
8537;Pipiras;VARLIUKŲ;8800890503;Taip;7;0;0;7
8538;Pipiras;VARLIUKŲ;6184943213;Taip;11;2;0;13
8539;Pipiras;VARLIUKŲ;8028360748;Taip;0;5;0;5
8540;Pipiras;VARLIUKŲ;1238280105;Taip;2;2;1;5
8541;Pipiras;VARLIUKŲ;3299099535;Taip;3;2;2;7
8542;Pipiras;VARLIUKŲ;8364783015;Taip;0;0;22;22
8543;Pipiras;VARLIUKŲ;5502186385;Taip;12;0;0;12
8544;Pipiras;VARLIUKŲ;8707560610;Taip;3;0;0;3
8545;Pipiras;VARLIUKŲ;4940053409;Taip;13;0;0;13
8546;Pipiras;VARLIUKŲ;2588075386;Taip;6;2;0;8
8547;Pipiras;VARLIUKŲ;6666112357;Taip;14;0;0;14
8548;Pipiras;VARLIUKŲ;9473056714;Taip;7;13;0;20
8549;Pipiras;VARLIUKŲ;4282267631;Taip;7;0;0;7
8550;Pipiras;ŽIOGELIŲ;7510719254;Taip;10;0;3;13
8551;Pipiras;ŽIOGELIŲ;7802812858;Taip;0;11;0;11
8552;Pipiras;ŽIOGELIŲ;8697732892;Taip;17;1;0;18
8553;Pipiras;ŽIOGELIŲ;1466527534;Taip;10;2;0;12
8554;Pipiras;ŽIOGELIŲ;1172225661;Taip;5;2;0;7
8555;Pipiras;ŽIOGELIŲ;3825960148;Ne;11;2;1;14
8556;Pipiras;ŽIOGELIŲ;9747219629;Taip;4;12;0;16
8557;Pipiras;ŽIOGELIŲ;8445608419;Ne;0;0;1;1
8558;Pipiras;ŽIOGELIŲ;6602780166;Taip;0;0;2;2
8559;Pipiras;ŽIOGELIŲ;1074913909;Taip;0;0;22;22
8560;Pipiras;ŽIOGELIŲ;4229548366;Taip;10;0;3;13
8561;Pipiras;ŽIOGELIŲ;8666908143;Taip;5;4;0;9
8562;Pipiras;ŽIOGELIŲ;2784222529;Taip;10;0;0;10
8563;"Prie pasakų parko";ZUIKUČIAI;8493622886;Taip;19;0;0;19
8564;"Prie pasakų parko";ZUIKUČIAI;3998970024;Taip;1;8;0;9
8565;"Prie pasakų parko";ZUIKUČIAI;3907016976;Taip;8;0;8;16
8566;"Prie pasakų parko";ZUIKUČIAI;9770819792;Taip;17;0;0;17
8567;"Prie pasakų parko";ZUIKUČIAI;4904562817;Taip;2;0;0;2
8568;"Prie pasakų parko";ZUIKUČIAI;6662531456;Taip;15;0;2;17
8569;"Prie pasakų parko";ZUIKUČIAI;9659710840;Taip;10;10;0;20
8570;"Prie pasakų parko";ZUIKUČIAI;8781483295;Ne;10;0;1;11
8571;"Prie pasakų parko";ZUIKUČIAI;5394554484;Taip;13;0;0;13
8572;"Prie pasakų parko";ZUIKUČIAI;9707694441;Taip;11;1;0;12
8573;"Prie pasakų parko";ZUIKUČIAI;7220229641;Ne;2;5;0;7
8574;"Prie pasakų parko";ZUIKUČIAI;8616467675;Taip;16;0;0;16
8575;"Prie pasakų parko";ZUIKUČIAI;8215496569;Ne;4;0;0;4
8576;"Prie pasakų parko";ZUIKUČIAI;9742058853;Taip;9;0;0;9
8577;"Prie pasakų parko";PAUKŠČIUKŲ;4860316199;Ne;9;0;3;12
8578;"Prie pasakų parko";PAUKŠČIUKŲ;3907578461;Taip;9;0;1;10
8579;"Prie pasakų parko";PAUKŠČIUKŲ;7359935733;Taip;22;0;0;22
8580;"Prie pasakų parko";PAUKŠČIUKŲ;7330033315;Taip;22;0;3;25
8581;"Prie pasakų parko";PAUKŠČIUKŲ;9061639276;Taip;13;0;0;13
8582;"Prie pasakų parko";PAUKŠČIUKŲ;1476515947;Ne;26;1;0;27
8583;"Prie pasakų parko";PAUKŠČIUKŲ;6601363351;Ne;4;0;0;4
8584;"Prie pasakų parko";PAUKŠČIUKŲ;9784398441;Taip;19;0;0;19
8585;"Prie pasakų parko";PAUKŠČIUKŲ;4891232161;Taip;12;0;0;12
8586;"Prie pasakų parko";PAUKŠČIUKŲ;9550985822;Taip;13;0;0;13
8587;"Prie pasakų parko";PAUKŠČIUKŲ;5737517940;Taip;12;0;5;17
8588;"Prie pasakų parko";PAUKŠČIUKŲ;7693728136;Ne;21;0;0;21
8589;"Prie pasakų parko";PAUKŠČIUKŲ;2088585478;Taip;0;0;22;22
8590;"Prie pasakų parko";"LINKSMOJI ŠEIMYNĖLĖ (SPEC)";2820889357;Ne;17;2;0;19
8591;"Prie pasakų parko";"LINKSMOJI ŠEIMYNĖLĖ (SPEC)";29445903073;Taip;8;1;0;9
8592;"Prie pasakų parko";"LINKSMOJI ŠEIMYNĖLĖ (SPEC)";1549137154;Taip;0;1;2;3
8593;"Prie pasakų parko";"LINKSMOJI ŠEIMYNĖLĖ (SPEC)";6245610875;Taip;4;2;2;8
8594;"Prie pasakų parko";"LINKSMOJI ŠEIMYNĖLĖ (SPEC)";9469871636;Ne;12;2;1;15
8595;"Prie pasakų parko";"LINKSMOJI ŠEIMYNĖLĖ (SPEC)";5641148690;Taip;0;8;0;8
8596;"Prie pasakų parko";"LINKSMOJI ŠEIMYNĖLĖ (SPEC)";9594976173;Ne;2;0;1;3
8597;"Prie pasakų parko";"LINKSMOJI ŠEIMYNĖLĖ (SPEC)";1828638638;Taip;18;0;1;19
8598;"Prie pasakų parko";"LINKSMOJI ŠEIMYNĖLĖ (SPEC)";5356005675;Taip;4;3;4;11
8599;"Prie pasakų parko";"LINKSMOJI ŠEIMYNĖLĖ (SPEC)";9789977863;Taip;5;0;5;10
8600;"Prie pasakų parko";NYKŠTUKŲ;2287711014;Taip;0;0;8;8
8601;"Prie pasakų parko";NYKŠTUKŲ;6491435655;Taip;9;3;0;12
8602;"Prie pasakų parko";NYKŠTUKŲ;1743429440;Taip;5;2;0;7
8603;"Prie pasakų parko";NYKŠTUKŲ;1811994592;Taip;14;0;3;17
8604;"Prie pasakų parko";NYKŠTUKŲ;7739970115;Taip;9;0;0;9
8605;"Prie pasakų parko";NYKŠTUKŲ;6700916147;Taip;15;0;0;15
8606;"Prie pasakų parko";NYKŠTUKŲ;6733793491;Taip;24;0;1;25
8607;"Prie pasakų parko";NYKŠTUKŲ;2515928623;Taip;6;0;0;6
8608;"Prie pasakų parko";NYKŠTUKŲ;4726737519;Ne;7;0;0;7
8609;"Prie pasakų parko";NYKŠTUKŲ;1316127369;Taip;27;0;2;29
8610;"Prie pasakų parko";NYKŠTUKŲ;2654978735;Taip;0;0;22;22
8611;"Prie pasakų parko";NYKŠTUKŲ;2661900328;Taip;0;0;1;1
8612;"Prie pasakų parko";NYKŠTUKŲ;3202292611;Ne;0;0;1;1
8613;"Prie pasakų parko";NYKŠTUKŲ;4457827262;Taip;4;0;0;4
8614;"Prie pasakų parko";LAŠELIŲ;6865751947;Taip;0;0;11;11
8615;"Prie pasakų parko";LAŠELIŲ;1588062393;Taip;5;0;8;13
8616;"Prie pasakų parko";LAŠELIŲ;1278065349;Taip;8;0;3;11
8617;"Prie pasakų parko";LAŠELIŲ;8574432191;Ne;7;1;0;8
8618;"Prie pasakų parko";LAŠELIŲ;4181676762;Taip;0;3;2;5
8619;"Prie pasakų parko";LAŠELIŲ;4548803933;Taip;5;0;8;13
8620;"Prie pasakų parko";LAŠELIŲ;6250610187;Taip;0;9;0;9
8621;"Prie pasakų parko";LAŠELIŲ;9190379838;Taip;16;1;0;17
8622;"Prie pasakų parko";LAŠELIŲ;8189217660;Taip;10;3;0;13
8623;"Prie pasakų parko";LAŠELIŲ;8215830508;Ne;5;5;0;10
8624;"Prie pasakų parko";LAŠELIŲ;2216634402;Taip;9;0;1;10
8625;"Prie pasakų parko";LAŠELIŲ;8849417734;Taip;3;0;1;4
8626;"Prie pasakų parko";LAŠELIŲ;7545372781;Ne;0;1;3;4
8627;"Prie pasakų parko";LAŠELIŲ;2731544174;Taip;4;0;0;4
8628;"Prie pasakų parko";LAŠELIŲ;6361878877;Taip;1;0;0;1
8629;"Prie pasakų parko";LAŠELIŲ;5494350183;Taip;0;0;3;3
8630;"Prie pasakų parko";LAŠELIŲ;5102718403;Taip;0;0;8;8
8631;"Prie pasakų parko";"KAČIUKAI (SPEC)";6772736175;Taip;16;0;3;19
8632;"Prie pasakų parko";"KAČIUKAI (SPEC)";5847625697;Ne;8;0;8;16
8633;"Prie pasakų parko";"KAČIUKAI (SPEC)";2590693851;Taip;14;0;0;14
8634;"Prie pasakų parko";"KAČIUKAI (SPEC)";3949671257;Ne;14;0;0;14
8635;"Prie pasakų parko";"KAČIUKAI (SPEC)";2583331243;Taip;6;0;3;9
8636;"Prie pasakų parko";"KAČIUKAI (SPEC)";1370201372;Taip;4;0;2;6
8637;"Prie pasakų parko";"ŽVAIGŽDUTĖS  (SPEC)";7216751216;Taip;17;0;0;17
8638;"Prie pasakų parko";"ŽVAIGŽDUTĖS  (SPEC)";4037594669;Taip;22;0;0;22
8639;"Prie pasakų parko";"ŽVAIGŽDUTĖS  (SPEC)";9072312203;Taip;5;3;0;8
8640;"Prie pasakų parko";"ŽVAIGŽDUTĖS  (SPEC)";5006152810;Taip;4;0;0;4
8641;"Prie pasakų parko";"ŽVAIGŽDUTĖS  (SPEC)";6989235061;Taip;0;0;18;18
8642;"Prie pasakų parko";"ŽVAIGŽDUTĖS  (SPEC)";5009168398;Ne;6;0;0;6
8643;"Prie pasakų parko";"ŽVAIGŽDUTĖS  (SPEC)";6585504578;Taip;22;0;0;22
8644;"Prie pasakų parko";"ŽVAIGŽDUTĖS  (SPEC)";1621710265;Ne;8;0;3;11
8645;"Prie pasakų parko";"ŽVAIGŽDUTĖS  (SPEC)";8203595449;Taip;4;0;6;10
8646;"Prie pasakų parko";"ANČIUKAI (SPEC)";8339335908;Taip;4;0;0;4
8647;"Prie pasakų parko";"ANČIUKAI (SPEC)";6802898184;Taip;3;0;6;9
8648;"Prie pasakų parko";"ANČIUKAI (SPEC)";9529949992;Taip;9;0;0;9
8649;"Prie pasakų parko";"ANČIUKAI (SPEC)";6431918357;Taip;22;0;0;22
8650;"Prie pasakų parko";"ANČIUKAI (SPEC)";1190509858;Taip;22;0;0;22
8651;"Prie pasakų parko";"ANČIUKAI (SPEC)";4309482351;Taip;5;3;0;8
8652;"Prie pasakų parko";"ANČIUKAI (SPEC)";2263419475;Taip;0;0;5;5
8653;"Prie pasakų parko";"ANČIUKAI (SPEC)";7200571639;Taip;0;0;4;4
8654;"Prie pasakų parko";TIGRIUKAI;7858530013;Taip;0;8;0;8
8655;"Prie pasakų parko";TIGRIUKAI;3918269702;Taip;9;2;5;16
8656;"Prie pasakų parko";TIGRIUKAI;6446562388;Taip;17;8;0;25
8657;"Prie pasakų parko";TIGRIUKAI;2168919559;Taip;9;5;0;14
8658;"Prie pasakų parko";TIGRIUKAI;8899375521;Ne;22;0;0;22
8659;"Prie pasakų parko";TIGRIUKAI;2898016639;Ne;0;0;1;1
8660;"Prie pasakų parko";TIGRIUKAI;6561145380;Taip;9;0;1;10
8661;"Prie pasakų parko";TIGRIUKAI;9476448601;Taip;0;6;0;6
8662;"Prie pasakų parko";TIGRIUKAI;8029428034;Taip;11;0;0;11
8663;"Prie pasakų parko";TIGRIUKAI;8715851643;Taip;8;4;0;12
8664;"Prie pasakų parko";TIGRIUKAI;3617673265;Taip;0;0;8;8
8665;"Prie pasakų parko";TIGRIUKAI;1704679306;Taip;3;0;3;6
8666;"Prie pasakų parko";TIGRIUKAI;7776961789;Taip;3;0;3;6
8667;"Prie pasakų parko";TIGRIUKAI;8285260113;Taip;0;5;5;10
8668;"Prie pasakų parko";TIGRIUKAI;3373275644;Taip;5;5;0;10
8669;"Prie pasakų parko";TIGRIUKAI;5518041213;Taip;5;0;0;5
8670;"Prie pasakų parko";TIGRIUKAI;8738488104;Taip;5;0;1;6
8671;"Prie pasakų parko";TIGRIUKAI;8406002339;Taip;0;0;11;11
8672;"Prie pasakų parko";"EŽIUKŲ (SPEC)";7851357992;Taip;5;0;12;17
8673;"Prie pasakų parko";"EŽIUKŲ (SPEC)";7115825217;Taip;7;0;3;10
8674;"Prie pasakų parko";"EŽIUKŲ (SPEC)";2952868428;Taip;0;0;2;2
8675;"Prie pasakų parko";"EŽIUKŲ (SPEC)";5159105661;Taip;0;0;1;1
8676;"Prie pasakų parko";"EŽIUKŲ (SPEC)";5944113879;Ne;15;0;0;15
8677;"Prie pasakų parko";"EŽIUKŲ (SPEC)";4950143153;Ne;15;0;0;15
8678;"Prie pasakų parko";"EŽIUKŲ (SPEC)";4799789212;Ne;0;0;1;1
8679;"Prie pasakų parko";"EŽIUKŲ (SPEC)";5834070970;Taip;11;0;0;11
8680;"Prie pasakų parko";"BORUŽIUKŲ (SPEC)";9715586563;Ne;0;5;5;10
8681;"Prie pasakų parko";"BORUŽIUKŲ (SPEC)";28574450739;Taip;16;0;0;16
8682;"Prie pasakų parko";"BORUŽIUKŲ (SPEC)";6215345468;Ne;0;0;5;5
8683;"Prie pasakų parko";"BORUŽIUKŲ (SPEC)";7000191099;Taip;0;0;2;2
8684;"Prie pasakų parko";"BORUŽIUKŲ (SPEC)";2104412442;Ne;3;0;0;3
8685;"Prie pasakų parko";SAULYTĖS;6762267582;Taip;18;0;1;19
8686;"Prie pasakų parko";SAULYTĖS;7459673719;Ne;16;1;1;18
8687;"Prie pasakų parko";SAULYTĖS;4351705573;Taip;5;0;2;7
8688;"Prie pasakų parko";SAULYTĖS;7390391804;Taip;0;0;4;4
8689;"Prie pasakų parko";SAULYTĖS;8685140364;Ne;0;13;4;17
8690;"Prie pasakų parko";SAULYTĖS;6606867989;Taip;3;0;2;5
8691;"Prie pasakų parko";SAULYTĖS;2201317313;Taip;4;0;2;6
8692;"Prie pasakų parko";SAULYTĖS;3038164555;Taip;16;0;1;17
8693;"Prie pasakų parko";SAULYTĖS;4183640714;Taip;20;0;9;29
8694;"Prie pasakų parko";SAULYTĖS;1738732866;Ne;0;2;0;2
8695;"Pumpurėlis (Kalvarijų g. 186)";RAMUNĖLIŲ;7610949816;Taip;0;1;7;8
8696;"Pumpurėlis (Kalvarijų g. 186)";RAMUNĖLIŲ;6165833101;Taip;0;1;4;5
8697;"Pumpurėlis (Kalvarijų g. 186)";RAMUNĖLIŲ;6977710645;Taip;9;0;1;10
8698;"Pumpurėlis (Kalvarijų g. 186)";RAMUNĖLIŲ;9431295796;Taip;10;0;6;16
8699;"Pumpurėlis (Kalvarijų g. 186)";RAMUNĖLIŲ;1395380236;Ne;9;0;3;12
8700;"Pumpurėlis (Kalvarijų g. 186)";RAMUNĖLIŲ;9424449290;Taip;8;5;0;13
8701;"Pumpurėlis (Kalvarijų g. 186)";RAMUNĖLIŲ;6955168163;Taip;8;1;0;9
8702;"Pumpurėlis (Kalvarijų g. 186)";RAMUNĖLIŲ;5171198109;Taip;0;1;8;9
8703;"Pumpurėlis (Kalvarijų g. 186)";RAMUNĖLIŲ;9726028397;Taip;0;0;2;2
8704;"Pumpurėlis (Kalvarijų g. 186)";RAMUNĖLIŲ;7229289985;Ne;0;5;6;11
8705;"Pumpurėlis (Kalvarijų g. 186)";RAMUNĖLIŲ;2969734731;Taip;7;0;0;7
8706;"Pumpurėlis (Kalvarijų g. 186)";RAMUNĖLIŲ;7559071945;Taip;4;1;0;5
8707;"Pumpurėlis (Kalvarijų g. 186)";RAMUNĖLIŲ;6574415196;Taip;1;1;0;2
8708;"Pumpurėlis (Kalvarijų g. 186)";RAMUNĖLIŲ;3953103488;Taip;0;1;7;8
8709;"Pumpurėlis (Kalvarijų g. 186)";RAMUNĖLIŲ;6511527480;Taip;1;0;0;1
8710;"Pumpurėlis (Kalvarijų g. 186)";RAMUNĖLIŲ;3838705973;Taip;8;0;4;12
8711;"Pumpurėlis (Kalvarijų g. 186)";RAMUNĖLIŲ;6726875853;Taip;5;1;6;12
8712;"Pumpurėlis (Kalvarijų g. 186)";RAMUNĖLIŲ;8667762689;Taip;8;1;0;9
8713;"Pumpurėlis (Kalvarijų g. 186)";RAMUNĖLIŲ;3874188848;Taip;11;0;3;14
8714;"Pumpurėlis (Kalvarijų g. 186)";RAMUNĖLIŲ;7619709360;Ne;4;0;1;5
8715;"Pumpurėlis (Kalvarijų g. 186)";VARPELIŲ;3101133244;Taip;13;0;0;13
8716;"Pumpurėlis (Kalvarijų g. 186)";VARPELIŲ;3893768713;Taip;0;9;0;9
8717;"Pumpurėlis (Kalvarijų g. 186)";VARPELIŲ;5023658988;Taip;4;1;2;7
8718;"Pumpurėlis (Kalvarijų g. 186)";VARPELIŲ;2668855786;Taip;12;4;0;16
8719;"Pumpurėlis (Kalvarijų g. 186)";VARPELIŲ;8258560345;Taip;18;0;0;18
8720;"Pumpurėlis (Kalvarijų g. 186)";VARPELIŲ;9612924972;Taip;0;2;0;2
8721;"Pumpurėlis (Kalvarijų g. 186)";VARPELIŲ;9884099545;Taip;6;12;0;18
8722;"Pumpurėlis (Kalvarijų g. 186)";VARPELIŲ;3733509497;Taip;0;0;6;6
8723;"Pumpurėlis (Kalvarijų g. 186)";VARPELIŲ;4508966729;Taip;0;1;1;2
8724;"Pumpurėlis (Kalvarijų g. 186)";VARPELIŲ;9552913910;Taip;0;0;14;14
8725;"Pumpurėlis (Kalvarijų g. 186)";VARPELIŲ;5196733185;Taip;21;1;0;22
8726;"Pumpurėlis (Kalvarijų g. 186)";VARPELIŲ;4928495108;Taip;3;3;0;6
8727;"Pumpurėlis (Kalvarijų g. 186)";VARPELIŲ;8886730333;Taip;4;0;0;4
8728;"Pumpurėlis (Kalvarijų g. 186)";VARPELIŲ;2247300456;Taip;7;0;0;7
8729;"Pumpurėlis (Kalvarijų g. 186)";VARPELIŲ;5564680653;Taip;0;0;5;5
8730;"Pumpurėlis (Kalvarijų g. 186)";VARPELIŲ;1411232443;Taip;5;0;0;5
8731;"Pumpurėlis (Kalvarijų g. 186)";VARPELIŲ;8525537588;Ne;5;0;3;8
8732;"Pumpurėlis (Kalvarijų g. 186)";VARPELIŲ;2103139845;Taip;22;0;0;22
8733;"Pumpurėlis (Kalvarijų g. 186)";VARPELIŲ;6780042929;Taip;12;4;0;16
8734;"Pumpurėlis (Kalvarijų g. 186)";VARPELIŲ;7182107790;Ne;14;0;0;14
8735;"Pumpurėlis (Kalvarijų g. 186)";VARPELIŲ;4629544683;Taip;4;8;0;12
8736;"Pumpurėlis (Kalvarijų g. 186)";VARPELIŲ;9224879966;Taip;7;0;1;8
8737;"Pumpurėlis (Kalvarijų g. 186)";DRUGELIŲ;5928552565;Ne;14;0;0;14
8738;"Pumpurėlis (Kalvarijų g. 186)";DRUGELIŲ;5897036076;Taip;5;1;0;6
8739;"Pumpurėlis (Kalvarijų g. 186)";DRUGELIŲ;7055989095;Taip;0;19;0;19
8740;"Pumpurėlis (Kalvarijų g. 186)";DRUGELIŲ;7078621340;Taip;10;1;0;11
8741;"Pumpurėlis (Kalvarijų g. 186)";DRUGELIŲ;1538548768;Taip;13;0;1;14
8742;"Pumpurėlis (Kalvarijų g. 186)";DRUGELIŲ;2368226822;Taip;21;1;0;22
8743;"Pumpurėlis (Kalvarijų g. 186)";DRUGELIŲ;3088476130;Taip;9;0;2;11
8744;"Pumpurėlis (Kalvarijų g. 186)";DRUGELIŲ;9640790401;Taip;3;1;7;11
8745;"Pumpurėlis (Kalvarijų g. 186)";DRUGELIŲ;8320987208;Taip;9;0;0;9
8746;"Pumpurėlis (Kalvarijų g. 186)";DRUGELIŲ;7832408524;Taip;10;0;0;10
8747;"Pumpurėlis (Kalvarijų g. 186)";DRUGELIŲ;8644853849;Taip;14;1;3;18
8748;"Pumpurėlis (Kalvarijų g. 186)";DRUGELIŲ;9417688597;Taip;8;3;0;11
8749;"Pumpurėlis (Kalvarijų g. 186)";DRUGELIŲ;9032255874;Taip;7;1;9;17
8750;"Pumpurėlis (Kalvarijų g. 186)";DRUGELIŲ;9996789041;Taip;9;0;0;9
8751;"Pumpurėlis (Kalvarijų g. 186)";DRUGELIŲ;2684592319;Taip;16;0;0;16
8752;"Pumpurėlis (Kalvarijų g. 186)";DRUGELIŲ;5835115428;Taip;13;1;0;14
8753;"Pumpurėlis (Kalvarijų g. 186)";DRUGELIŲ;2132563531;Taip;11;1;0;12
8754;"Pumpurėlis (Kalvarijų g. 186)";DRUGELIŲ;4506063812;Taip;4;3;4;11
8755;"Pumpurėlis (Kalvarijų g. 186)";DRUGELIŲ;2165141865;Taip;10;0;3;13
8756;"Pumpurėlis (Kalvarijų g. 186)";DRUGELIŲ;8671697745;Ne;10;0;4;14
8757;"Pumpurėlis (Kalvarijų g. 186)";DRUGELIŲ;3187815703;Taip;10;0;1;11
8758;"Pumpurėlis (Kalvarijų g. 186)";KODĖLČIUKŲ;8214602054;Taip;19;0;1;20
8759;"Pumpurėlis (Kalvarijų g. 186)";KODĖLČIUKŲ;9654958302;Taip;11;1;0;12
8760;"Pumpurėlis (Kalvarijų g. 186)";KODĖLČIUKŲ;5564844211;Taip;10;0;2;12
8761;"Pumpurėlis (Kalvarijų g. 186)";KODĖLČIUKŲ;1215117598;Taip;12;3;0;15
8762;"Pumpurėlis (Kalvarijų g. 186)";KODĖLČIUKŲ;6978091765;Taip;9;0;0;9
8763;"Pumpurėlis (Kalvarijų g. 186)";KODĖLČIUKŲ;6433757421;Taip;3;0;5;8
8764;"Pumpurėlis (Kalvarijų g. 186)";KODĖLČIUKŲ;3328647987;Taip;3;1;1;5
8765;"Pumpurėlis (Kalvarijų g. 186)";KODĖLČIUKŲ;3748601124;Taip;15;0;0;15
8766;"Pumpurėlis (Kalvarijų g. 186)";KODĖLČIUKŲ;6004234378;Taip;13;3;1;17
8767;"Pumpurėlis (Kalvarijų g. 186)";KODĖLČIUKŲ;4196409137;Ne;15;0;0;15
8768;"Pumpurėlis (Kalvarijų g. 186)";KODĖLČIUKŲ;6117720533;Taip;19;0;0;19
8769;"Pumpurėlis (Kalvarijų g. 186)";KODĖLČIUKŲ;8070486897;Taip;14;0;2;16
8770;"Pumpurėlis (Kalvarijų g. 186)";KODĖLČIUKŲ;3534133061;Taip;8;0;0;8
8771;"Pumpurėlis (Kalvarijų g. 186)";KODĖLČIUKŲ;2611141763;Taip;7;0;0;7
8772;"Pumpurėlis (Kalvarijų g. 186)";KODĖLČIUKŲ;2307819108;Taip;5;8;0;13
8773;"Pumpurėlis (Kalvarijų g. 186)";KODĖLČIUKŲ;9650395309;Taip;0;9;0;9
8774;"Pumpurėlis (Kalvarijų g. 186)";KODĖLČIUKŲ;3563609848;Taip;10;0;0;10
8775;"Pumpurėlis (Kalvarijų g. 186)";KODĖLČIUKŲ;6702744879;Taip;12;0;0;12
8776;"Pumpurėlis (Kalvarijų g. 186)";KODĖLČIUKŲ;2890596967;Ne;10;0;3;13
8777;"Pumpurėlis (Kalvarijų g. 186)";KODĖLČIUKŲ;9839285886;Taip;0;15;0;15
8778;"Pumpurėlis (Kalvarijų g. 186)";LINELIS;1017483419;Taip;0;7;0;7
8779;"Pumpurėlis (Kalvarijų g. 186)";LINELIS;6957047759;Taip;0;7;0;7
8780;"Pumpurėlis (Kalvarijų g. 186)";LINELIS;1492810528;Taip;11;3;0;14
8781;"Pumpurėlis (Kalvarijų g. 186)";LINELIS;9138883172;Ne;9;1;0;10
8782;"Pumpurėlis (Kalvarijų g. 186)";LINELIS;1835168438;Taip;17;0;0;17
8783;"Pumpurėlis (Kalvarijų g. 186)";LINELIS;4344595328;Taip;0;8;0;8
8784;"Pumpurėlis (Kalvarijų g. 186)";LINELIS;1188314397;Taip;0;1;0;1
8785;"Pumpurėlis (Kalvarijų g. 186)";LINELIS;7566451857;Ne;0;7;0;7
8786;"Pumpurėlis (Kalvarijų g. 186)";LINELIS;9583257172;Taip;1;2;0;3
8787;"Pumpurėlis (Kalvarijų g. 186)";LINELIS;13952236905;Ne;8;1;0;9
8788;"Pumpurėlis (Kalvarijų g. 186)";LINELIS;7533555059;Taip;1;4;0;5
8789;"Pumpurėlis (Kalvarijų g. 186)";LINELIS;5615260965;Taip;0;3;0;3
8790;"Pumpurėlis (Kalvarijų g. 186)";LINELIS;6669327226;Taip;0;1;0;1
8791;"Pumpurėlis (Kalvarijų g. 186)";LINELIS;3298821054;Taip;6;3;0;9
8792;"Pumpurėlis (Kalvarijų g. 186)";LINELIS;8830261792;Taip;0;1;0;1
8793;"Pumpurėlis (Kalvarijų g. 186)";LINELIS;87061817106;Taip;0;3;0;3
8794;"Pumpurėlis (Kalvarijų g. 186)";LINELIS;8806961007;Taip;10;1;4;15
8795;"Pumpurėlis (Kalvarijų g. 186)";LINELIS;18928851032;Taip;2;1;0;3
8796;"Pumpurėlis (Kalvarijų g. 186)";LINELIS;8747439652;Taip;3;0;0;3
8797;"Pumpurėlis (Kalvarijų g. 186)";LINELIS;2629702959;Taip;1;10;0;11
8798;"Pumpurėlis (Kalvarijų g. 186)";LINELIS;5964953923;Taip;0;3;0;3
8799;"Pumpurėlis (Kalvarijų g. 186)";SAULUTĖS;3751769136;Taip;5;0;0;5
8800;"Pumpurėlis (Kalvarijų g. 186)";SAULUTĖS;5013491568;Taip;6;0;2;8
8801;"Pumpurėlis (Kalvarijų g. 186)";SAULUTĖS;7488342792;Taip;7;1;4;12
8802;"Pumpurėlis (Kalvarijų g. 186)";SAULUTĖS;6412442729;Taip;13;1;2;16
8803;"Pumpurėlis (Kalvarijų g. 186)";SAULUTĖS;2129779614;Ne;0;1;0;1
8804;"Pumpurėlis (Kalvarijų g. 186)";SAULUTĖS;1053338730;Taip;4;1;2;7
8805;"Pumpurėlis (Kalvarijų g. 186)";SAULUTĖS;7123915287;Taip;0;0;2;2
8806;"Pumpurėlis (Kalvarijų g. 186)";SAULUTĖS;83388662869;Taip;0;3;0;3
8807;"Pumpurėlis (Kalvarijų g. 186)";SAULUTĖS;1690424790;Taip;6;1;3;10
8808;"Pumpurėlis (Kalvarijų g. 186)";SAULUTĖS;1397924008;Ne;0;3;8;11
8809;"Pumpurėlis (Kalvarijų g. 186)";SAULUTĖS;6230500803;Taip;0;2;3;5
8810;"Pumpurėlis (Kalvarijų g. 186)";SAULUTĖS;1306102772;Taip;2;1;1;4
8811;"Pumpurėlis (Kalvarijų g. 186)";SAULUTĖS;1230058211;Ne;5;1;1;7
8812;"Pumpurėlis (Kalvarijų g. 186)";SAULUTĖS;25029630023;Taip;0;1;0;1
8813;"Pumpurėlis (Kalvarijų g. 186)";SAULUTĖS;6535398274;Ne;0;0;5;5
8814;"Pumpurėlis (Kalvarijų g. 186)";SAULUTĖS;8262886949;Taip;0;6;0;6
8815;"Pumpurėlis (Kalvarijų g. 186)";SAULUTĖS;1261919194;Taip;2;0;0;2
8816;"Pumpurėlis (Kalvarijų g. 186)";SAULUTĖS;9733380187;Taip;0;1;0;1
8817;"Pumpurėlis (Kalvarijų g. 186)";SAULUTĖS;2102427499;Ne;4;7;0;11
8818;"Pumpurėlis (Kalvarijų g. 186)";SAULUTĖS;1225377038;Ne;9;0;0;9
8819;"Pumpurėlis (Kalvarijų g. 186)";SAULUTĖS;9317495169;Taip;0;3;0;3
8820;"Pumpurėlis (Kalvarijų g. 186)";BITUTĖS;4419940231;Taip;6;9;0;15
8821;"Pumpurėlis (Kalvarijų g. 186)";BITUTĖS;4985045047;Taip;5;1;2;8
8822;"Pumpurėlis (Kalvarijų g. 186)";BITUTĖS;2651037375;Ne;0;0;6;6
8823;"Pumpurėlis (Kalvarijų g. 186)";BITUTĖS;1768239820;Taip;0;0;3;3
8824;"Pumpurėlis (Kalvarijų g. 186)";BITUTĖS;2566557351;Taip;10;2;2;14
8825;"Pumpurėlis (Kalvarijų g. 186)";BITUTĖS;4426697956;Taip;0;4;3;7
8826;"Pumpurėlis (Kalvarijų g. 186)";BITUTĖS;7363814444;Taip;5;8;0;13
8827;"Pumpurėlis (Kalvarijų g. 186)";BITUTĖS;3405169131;Taip;0;3;1;4
8828;"Pumpurėlis (Kalvarijų g. 186)";BITUTĖS;3951445693;Taip;11;0;2;13
8829;"Pumpurėlis (Kalvarijų g. 186)";BITUTĖS;9612924316;Taip;0;8;0;8
8830;"Pumpurėlis (Kalvarijų g. 186)";BITUTĖS;5194285627;Taip;5;0;0;5
8831;"Pumpurėlis (Kalvarijų g. 186)";BITUTĖS;8655389224;Taip;0;3;0;3
8832;"Pumpurėlis (Kalvarijų g. 186)";BITUTĖS;1674341906;Taip;5;6;0;11
8833;"Pumpurėlis (Kalvarijų g. 186)";BITUTĖS;3842632260;Taip;0;3;0;3
8834;"Pumpurėlis (Kalvarijų g. 186)";BITUTĖS;1933502038;Taip;9;0;0;9
8835;"Pumpurėlis (Kalvarijų g. 186)";BITUTĖS;2230191718;Taip;5;0;1;6
8836;"Pumpurėlis (Kalvarijų g. 186)";BITUTĖS;7062090879;Taip;13;0;4;17
8837;"Pumpurėlis (Kalvarijų g. 186)";BITUTĖS;9245739052;Ne;0;0;3;3
8838;"Pumpurėlis (Kalvarijų g. 186)";BITUTĖS;8470433743;Taip;0;0;20;20
8839;"Pumpurėlis (Kalvarijų g. 186)";BITUTĖS;6474918016;Ne;0;0;3;3
8840;"Pumpurėlis (Kalvarijų g. 186)";DOBILIUKAI;9179780392;Taip;4;0;0;4
8841;"Pumpurėlis (Kalvarijų g. 186)";DOBILIUKAI;1839505206;Taip;0;12;0;12
8842;"Pumpurėlis (Kalvarijų g. 186)";DOBILIUKAI;3970253545;Taip;7;0;2;9
8843;"Pumpurėlis (Kalvarijų g. 186)";DOBILIUKAI;1808734330;Taip;5;0;0;5
8844;"Pumpurėlis (Kalvarijų g. 186)";DOBILIUKAI;6968264923;Taip;10;3;0;13
8845;"Pumpurėlis (Kalvarijų g. 186)";DOBILIUKAI;2700017433;Taip;9;0;1;10
8846;"Pumpurėlis (Kalvarijų g. 186)";DOBILIUKAI;7038597556;Taip;9;9;0;18
8847;"Pumpurėlis (Kalvarijų g. 186)";DOBILIUKAI;4130539703;Taip;8;0;0;8
8848;"Pumpurėlis (Kalvarijų g. 186)";DOBILIUKAI;6307988067;Taip;0;1;0;1
8849;"Pumpurėlis (Kalvarijų g. 186)";DOBILIUKAI;3374174445;Taip;0;13;0;13
8850;"Pumpurėlis (Kalvarijų g. 186)";DOBILIUKAI;1961282282;Taip;13;0;0;13
8851;"Pumpurėlis (Kalvarijų g. 186)";DOBILIUKAI;7276322999;Taip;4;0;0;4
8852;"Pumpurėlis (Kalvarijų g. 186)";DOBILIUKAI;5587118874;Taip;4;0;1;5
8853;"Pumpurėlis (Kalvarijų g. 186)";DOBILIUKAI;9058493247;Taip;7;1;0;8
8854;"Pumpurėlis (Kalvarijų g. 186)";DOBILIUKAI;3214652626;Taip;5;0;0;5
8855;"Pumpurėlis (Kalvarijų g. 186)";DOBILIUKAI;2028068230;Taip;0;0;2;2
8856;"Pumpurėlis (Kalvarijų g. 186)";DOBILIUKAI;5444879430;Ne;9;0;3;12
8857;"Pumpurėlis (Kalvarijų g. 186)";DOBILIUKAI;7825190756;Ne;10;0;0;10
8858;"Pumpurėlis (Kalvarijų g. 186)";DOBILIUKAI;1438740562;Taip;4;0;0;4
8859;"Pumpurėlis (Kalvarijų g. 186)";DOBILIUKAI;9740660699;Ne;3;12;0;15
8860;"Pumpurėlis (Kalvarijų g. 186)";PUPYČIŲ;7652642088;Taip;4;0;4;8
8861;"Pumpurėlis (Kalvarijų g. 186)";PUPYČIŲ;9317274035;Taip;12;0;0;12
8862;"Pumpurėlis (Kalvarijų g. 186)";PUPYČIŲ;1555441484;Taip;12;0;0;12
8863;"Pumpurėlis (Kalvarijų g. 186)";PUPYČIŲ;9052267552;Taip;8;0;8;16
8864;"Pumpurėlis (Kalvarijų g. 186)";PUPYČIŲ;9372725707;Taip;5;0;0;5
8865;"Pumpurėlis (Kalvarijų g. 186)";PUPYČIŲ;4249039048;Taip;9;1;0;10
8866;"Pumpurėlis (Kalvarijų g. 186)";PUPYČIŲ;1082775039;Taip;10;0;0;10
8867;"Pumpurėlis (Kalvarijų g. 186)";PUPYČIŲ;6982600785;Taip;4;4;3;11
8868;"Pumpurėlis (Kalvarijų g. 186)";PUPYČIŲ;1667602636;Taip;8;0;3;11
8869;"Pumpurėlis (Kalvarijų g. 186)";PUPYČIŲ;8212403350;Taip;5;0;0;5
8870;"Pumpurėlis (Kalvarijų g. 186)";PUPYČIŲ;1448399754;Taip;2;0;3;5
8871;"Pumpurėlis (Kalvarijų g. 186)";PUPYČIŲ;6795405194;Taip;4;0;8;12
8872;"Pumpurėlis (Kalvarijų g. 186)";PUPYČIŲ;7443152469;Taip;8;0;14;22
8873;"Pumpurėlis (Kalvarijų g. 186)";PUPYČIŲ;9306426978;Taip;7;0;4;11
8874;"Pumpurėlis (Kalvarijų g. 186)";PUPYČIŲ;3259416263;Taip;12;0;5;17
8875;"Pumpurėlis (Kalvarijų g. 186)";PUPYČIŲ;6939412463;Ne;4;0;0;4
8876;"Pumpurėlis (Kalvarijų g. 186)";PUPYČIŲ;2715059752;Taip;0;0;8;8
8877;"Pumpurėlis (Kalvarijų g. 186)";PUPYČIŲ;8458676611;Taip;15;0;1;16
8878;"Pumpurėlis (Kalvarijų g. 186)";ŽIRNIUKŲ;9903981454;Taip;11;0;0;11
8879;"Pumpurėlis (Kalvarijų g. 186)";ŽIRNIUKŲ;3537534154;Taip;4;3;0;7
8880;"Pumpurėlis (Kalvarijų g. 186)";ŽIRNIUKŲ;1782842327;Taip;17;0;0;17
8881;"Pumpurėlis (Kalvarijų g. 186)";ŽIRNIUKŲ;9478685443;Taip;0;0;3;3
8882;"Pumpurėlis (Kalvarijų g. 186)";ŽIRNIUKŲ;6647331393;Taip;10;0;5;15
8883;"Pumpurėlis (Kalvarijų g. 186)";ŽIRNIUKŲ;3001331278;Taip;25;0;0;25
8884;"Pumpurėlis (Kalvarijų g. 186)";ŽIRNIUKŲ;9735493140;Taip;6;0;11;17
8885;"Pumpurėlis (Kalvarijų g. 186)";ŽIRNIUKŲ;3964441086;Taip;11;0;1;12
8886;"Pumpurėlis (Kalvarijų g. 186)";ŽIRNIUKŲ;8550119831;Ne;12;0;0;12
8887;"Pumpurėlis (Kalvarijų g. 186)";ŽIRNIUKŲ;4245270154;Taip;0;0;5;5
8888;"Pumpurėlis (Kalvarijų g. 186)";ŽIRNIUKŲ;6860128064;Taip;17;0;0;17
8889;"Pumpurėlis (Kalvarijų g. 186)";ŽIRNIUKŲ;2282966743;Taip;1;0;1;2
8890;"Pumpurėlis (Kalvarijų g. 186)";ŽIRNIUKŲ;5968577443;Taip;7;0;7;14
8891;"Pumpurėlis (Kalvarijų g. 186)";ŽIRNIUKŲ;8083674991;Taip;11;0;1;12
8892;"Pumpurėlis (Kalvarijų g. 186)";ŽIRNIUKŲ;9750242149;Ne;12;3;0;15
8893;"Pumpurėlis (Kalvarijų g. 186)";ŽIRNIUKŲ;5420222684;Taip;0;3;0;3
8894;"Pumpurėlis (Kalvarijų g. 186)";ŽIRNIUKŲ;4198532140;Taip;22;0;0;22
8895;"Pumpurėlis (Kalvarijų g. 186)";ŽIRNIUKŲ;6422203618;Taip;2;0;1;3
8896;"Pumpurėlis (Kalvarijų g. 186)";BORUŽĖLIŲ;2269864490;Taip;14;0;0;14
8897;"Pumpurėlis (Kalvarijų g. 186)";BORUŽĖLIŲ;6223338814;Ne;8;4;0;12
8898;"Pumpurėlis (Kalvarijų g. 186)";BORUŽĖLIŲ;5659508302;Taip;5;0;0;5
8899;"Pumpurėlis (Kalvarijų g. 186)";BORUŽĖLIŲ;5998858670;Ne;19;3;0;22
8900;"Pumpurėlis (Kalvarijų g. 186)";BORUŽĖLIŲ;7398363498;Taip;5;0;3;8
8901;"Pumpurėlis (Kalvarijų g. 186)";BORUŽĖLIŲ;5835545051;Taip;4;0;0;4
8902;"Pumpurėlis (Kalvarijų g. 186)";BORUŽĖLIŲ;4188020534;Taip;0;0;7;7
8903;"Pumpurėlis (Kalvarijų g. 186)";BORUŽĖLIŲ;6256781298;Taip;4;9;0;13
8904;"Pumpurėlis (Kalvarijų g. 186)";BORUŽĖLIŲ;9136771401;Taip;0;6;1;7
8905;"Pumpurėlis (Kalvarijų g. 186)";BORUŽĖLIŲ;7045349032;Taip;18;0;4;22
8906;"Pumpurėlis (Kalvarijų g. 186)";BORUŽĖLIŲ;1017838338;Taip;5;0;11;16
8907;"Pumpurėlis (Kalvarijų g. 186)";BORUŽĖLIŲ;1648249689;Taip;7;1;0;8
8908;"Pumpurėlis (Kalvarijų g. 186)";BORUŽĖLIŲ;7535098093;Taip;4;0;0;4
8909;"Pumpurėlis (Kalvarijų g. 186)";BORUŽĖLIŲ;7843280418;Ne;4;0;2;6
8910;"Pumpurėlis (Kalvarijų g. 186)";BORUŽĖLIŲ;3531862496;Ne;11;0;0;11
8911;"Pumpurėlis (Kalvarijų g. 186)";BORUŽĖLIŲ;1441993078;Ne;5;0;12;17
8912;"Pumpurėlis (Kalvarijų g. 186)";BORUŽĖLIŲ;2768082342;Ne;0;0;7;7
8913;"Pumpurėlis (Kalvarijų g. 186)";SMALSUČIŲ;6212212516;Ne;21;1;2;24
8914;"Pumpurėlis (Kalvarijų g. 186)";SMALSUČIŲ;6604801631;Taip;16;0;3;19
8915;"Pumpurėlis (Kalvarijų g. 186)";SMALSUČIŲ;6988369637;Taip;0;3;1;4
8916;"Pumpurėlis (Kalvarijų g. 186)";SMALSUČIŲ;9363610488;Taip;7;1;0;8
8917;"Pumpurėlis (Kalvarijų g. 186)";SMALSUČIŲ;8380689261;Taip;7;0;2;9
8918;"Pumpurėlis (Kalvarijų g. 186)";SMALSUČIŲ;6483338028;Taip;15;0;0;15
8919;"Pumpurėlis (Kalvarijų g. 186)";SMALSUČIŲ;3492977569;Taip;6;0;2;8
8920;"Pumpurėlis (Kalvarijų g. 186)";SMALSUČIŲ;6959214331;Taip;0;2;3;5
8921;"Pumpurėlis (Kalvarijų g. 186)";SMALSUČIŲ;3085309902;Taip;0;0;1;1
8922;"Pumpurėlis (Kalvarijų g. 186)";SMALSUČIŲ;4964949574;Taip;10;0;0;10
8923;"Pumpurėlis (Kalvarijų g. 186)";SMALSUČIŲ;2905797053;Taip;4;0;0;4
8924;"Pumpurėlis (Kalvarijų g. 186)";SMALSUČIŲ;2026021360;Taip;12;0;0;12
8925;"Pumpurėlis (Kalvarijų g. 186)";SMALSUČIŲ;3871151401;Ne;2;0;1;3
8926;"Pumpurėlis (Kalvarijų g. 186)";SMALSUČIŲ;6557857672;Taip;21;1;0;22
8927;"Pumpurėlis (Kalvarijų g. 186)";SMALSUČIŲ;5212827184;Taip;5;0;0;5
8928;"Pumpurėlis (Kalvarijų g. 186)";SMALSUČIŲ;6614797909;Taip;8;0;1;9
8929;"Pumpurėlis (Kalvarijų g. 186)";SMALSUČIŲ;7813696919;Ne;11;4;0;15
8930;"Pumpurėlis (Kalvarijų g. 186)";SMALSUČIŲ;5278250113;Ne;4;0;2;6
8931;"Pumpurėlis (Kalvarijų g. 186)";SMALSUČIŲ;5236515914;Ne;12;0;1;13
8932;"Pumpurėlis (Kalvarijų g. 186)";SMALSUČIŲ;5456922203;Taip;1;1;0;2
8933;Puriena;Ančiukų;1658720269;Taip;18;0;0;18
8934;Puriena;Ančiukų;6158842119;Taip;0;16;0;16
8935;Puriena;Ančiukų;3557013127;Taip;8;3;0;11
8936;Puriena;Ančiukų;4100466337;Taip;0;2;12;14
8937;Puriena;Ančiukų;9251058353;Taip;6;0;0;6
8938;Puriena;Ančiukų;3681811493;Taip;9;0;0;9
8939;Puriena;Ančiukų;4060087185;Ne;0;2;7;9
8940;Puriena;Ančiukų;6280465748;Taip;21;0;0;21
8941;Puriena;Ančiukų;3033562627;Taip;10;10;0;20
8942;Puriena;Ančiukų;5777076971;Taip;10;10;0;20
8943;Puriena;Ančiukų;8310231540;Taip;0;2;1;3
8944;Puriena;Ančiukų;4460575818;Taip;12;0;0;12
8945;Puriena;Ančiukų;8120597514;Taip;10;3;0;13
8946;Puriena;Ančiukų;7967288875;Taip;12;0;4;16
8947;Puriena;Ančiukų;5336923102;Taip;2;6;0;8
8948;Puriena;Ančiukų;1907429094;Taip;9;1;0;10
8949;Puriena;Ančiukų;4605662701;Taip;0;10;0;10
8950;Puriena;Ančiukų;1819876614;Taip;11;3;0;14
8951;Puriena;Ančiukų;4776745276;Taip;5;8;0;13
8952;Puriena;Ančiukų;6496291933;Taip;5;0;4;9
8953;Puriena;Ančiukų;7769252165;Taip;0;6;2;8
8954;Puriena;Ančiukų;2170025682;Taip;1;0;0;1
8955;Puriena;Ančiukų;3772941726;Taip;3;4;0;7
8956;Puriena;Ančiukų;1428098802;Taip;3;4;0;7
8957;Puriena;Drugeliai;2966464432;Taip;10;5;0;15
8958;Puriena;Drugeliai;4760827000;Taip;5;0;1;6
8959;Puriena;Drugeliai;4812271011;Taip;0;22;0;22
8960;Puriena;Drugeliai;1521955898;Taip;21;0;0;21
8961;Puriena;Drugeliai;8881337164;Taip;10;4;0;14
8962;Puriena;Drugeliai;6914613438;Taip;0;2;0;2
8963;Puriena;Drugeliai;8159342676;Taip;0;0;1;1
8964;Puriena;Drugeliai;1121312813;Ne;8;0;0;8
8965;Puriena;Drugeliai;2321753665;Taip;5;0;4;9
8966;Puriena;Drugeliai;7021756459;Taip;20;0;0;20
8967;Puriena;Drugeliai;1564155036;Ne;0;4;6;10
8968;Puriena;Drugeliai;9098291788;Taip;9;1;0;10
8969;Puriena;Drugeliai;6613654824;Taip;10;4;4;18
8970;Puriena;Drugeliai;3738277048;Ne;8;7;0;15
8971;Puriena;Drugeliai;7562458336;Taip;10;0;2;12
8972;Puriena;Drugeliai;3579008577;Taip;15;0;0;15
8973;Puriena;Drugeliai;4248701232;Ne;20;3;0;23
8974;Puriena;Drugeliai;7477278612;Taip;0;5;0;5
8975;Puriena;Drugeliai;9847768390;Taip;0;3;3;6
8976;Puriena;Drugeliai;1455237224;Ne;18;0;0;18
8977;Puriena;Drugeliai;6212693015;Taip;19;1;0;20
8978;Puriena;Drugeliai;5593526943;Ne;8;0;0;8
8979;Puriena;Pelėdžiukai;2013783668;Taip;0;1;0;1
8980;Puriena;Pelėdžiukai;8874823029;Taip;6;0;2;8
8981;Puriena;Pelėdžiukai;3149718901;Taip;9;2;1;12
8982;Puriena;Pelėdžiukai;9041388275;Taip;5;2;0;7
8983;Puriena;Pelėdžiukai;3175917649;Ne;15;0;0;15
8984;Puriena;Pelėdžiukai;5619637663;Taip;9;0;0;9
8985;Puriena;Pelėdžiukai;8061605125;Taip;18;0;0;18
8986;Puriena;Pelėdžiukai;2579402981;Taip;0;0;1;1
8987;Puriena;Pelėdžiukai;3671297035;Taip;13;0;0;13
8988;Puriena;Pelėdžiukai;2701942325;Taip;0;14;0;14
8989;Puriena;Pelėdžiukai;2267225709;Ne;9;0;0;9
8990;Puriena;Pelėdžiukai;6413337915;Taip;4;3;3;10
8991;Puriena;Pelėdžiukai;4858971990;Taip;0;4;4;8
8992;Puriena;Pelėdžiukai;1417566073;Ne;13;1;2;16
8993;Puriena;Pelėdžiukai;6463129806;Taip;14;0;1;15
8994;Puriena;Pelėdžiukai;4501239330;Taip;10;0;0;10
8995;Puriena;Pelėdžiukai;5341228269;Taip;11;11;0;22
8996;Puriena;Pelėdžiukai;6352605894;Ne;9;0;1;10
8997;Puriena;Pelėdžiukai;6786694796;Taip;20;0;4;24
8998;Puriena;Pelėdžiukai;8952508230;Taip;10;0;3;13
8999;Puriena;Pelėdžiukai;5080805225;Taip;9;0;0;9
9000;Puriena;Pelėdžiukai;1158768017;Taip;5;2;2;9
9001;Puriena;Voveriukai;3826282438;Taip;13;1;1;15
9002;Puriena;Voveriukai;9453994213;Taip;4;0;0;4
9003;Puriena;Voveriukai;8497070167;Taip;4;1;1;6
9004;Puriena;Voveriukai;4517020977;Ne;6;0;2;8
9005;Puriena;Voveriukai;4283608124;Taip;0;7;5;12
9006;Puriena;Voveriukai;8144488922;Taip;13;0;0;13
9007;Puriena;Voveriukai;8476986855;Taip;0;4;2;6
9008;Puriena;Voveriukai;3627403517;Taip;10;3;0;13
9009;Puriena;Voveriukai;8130975863;Taip;4;3;0;7
9010;Puriena;Voveriukai;2813562677;Taip;4;3;0;7
9011;Puriena;Voveriukai;7120683581;Taip;4;0;0;4
9012;Puriena;Voveriukai;4653085762;Taip;20;3;1;24
9013;Puriena;Voveriukai;3542374463;Taip;5;5;5;15
9014;Puriena;Voveriukai;1933733714;Taip;0;5;1;6
9015;Puriena;Voveriukai;6150437624;Taip;6;0;0;6
9016;Puriena;Voveriukai;8772936125;Taip;11;0;6;17
9017;Puriena;Voveriukai;6428413592;Ne;15;0;2;17
9018;Puriena;Voveriukai;8242140541;Taip;9;0;0;9
9019;Puriena;Voveriukai;4498919764;Taip;9;0;3;12
9020;Puriena;Voveriukai;9729644429;Ne;9;0;0;9
9021;Puriena;Voveriukai;6140294839;Taip;9;0;0;9
9022;Puriena;Voveriukai;3455291312;Taip;16;0;0;16
9023;Puriena;Voveriukai;7066959314;Taip;10;0;1;11
9024;Puriena;Bitučių;1621772702;Ne;0;2;3;5
9025;Puriena;Bitučių;9413672989;Ne;3;2;11;16
9026;Puriena;Bitučių;5224135638;Taip;19;0;2;21
9027;Puriena;Bitučių;1175665781;Taip;13;2;1;16
9028;Puriena;Bitučių;6853706997;Taip;10;4;0;14
9029;Puriena;Bitučių;9962011647;Taip;0;1;1;2
9030;Puriena;Bitučių;1339162214;Taip;8;2;0;10
9031;Puriena;Bitučių;9543884311;Ne;14;1;0;15
9032;Puriena;Bitučių;6656013805;Taip;0;0;1;1
9033;Puriena;Bitučių;8022809059;Taip;14;0;0;14
9034;Puriena;Bitučių;5395382717;Taip;0;5;0;5
9035;Puriena;Bitučių;8237149969;Taip;8;1;0;9
9036;Puriena;Bitučių;7481642656;Taip;0;22;0;22
9037;Puriena;Bitučių;8512814466;Taip;0;5;0;5
9038;Puriena;Bitučių;7622407056;Taip;0;5;0;5
9039;Puriena;Bitučių;4017644414;Taip;18;0;0;18
9040;Puriena;Bitučių;1295692895;Taip;10;0;2;12
9041;Puriena;Bitučių;8416003733;Taip;0;4;6;10
9042;Puriena;Bitučių;8199607793;Taip;0;2;1;3
9043;Puriena;Bitučių;9854244405;Taip;8;2;1;11
9044;Puriena;Bitučių;6780164845;Taip;1;0;6;7
9045;Puriena;Zylutės;7337038503;Taip;0;3;0;3
9046;Puriena;Zylutės;5891404983;Taip;13;0;0;13
9047;Puriena;Zylutės;63196502622;Ne;11;1;2;14
9048;Puriena;Zylutės;9239618299;Taip;6;12;0;18
9049;Puriena;Zylutės;2083071198;Taip;11;2;0;13
9050;Puriena;Zylutės;20286870431;Taip;19;3;0;22
9051;Puriena;Zylutės;8618298134;Taip;22;0;0;22
9052;Puriena;Zylutės;1748337587;Taip;20;0;3;23
9053;Puriena;Zylutės;1820719083;Taip;6;0;0;6
9054;Puriena;Zylutės;2089174669;Taip;14;1;2;17
9055;Puriena;Zylutės;11497629767;Taip;0;5;0;5
9056;Puriena;Zylutės;2146036332;Ne;3;0;0;3
9057;Puriena;Zylutės;2378865002;Taip;0;6;0;6
9058;Puriena;Zylutės;2131343339;Taip;10;0;0;10
9059;Puriena;Zylutės;8213725698;Taip;5;0;0;5
9060;Puriena;Zylutės;8707076857;Taip;0;1;2;3
9061;Puriena;Zylutės;48468411549;Taip;6;8;0;14
9062;Puriena;Zylutės;1703078658;Taip;7;8;4;19
9063;Puriena;Zylutės;1756611673;Taip;9;0;1;10
9064;Puriena;Zylutės;6416145396;Ne;14;1;0;15
9065;Puriena;Zylutės;3031725530;Ne;0;3;4;7
9066;Puriena;Zylutės;6813480086;Taip;17;2;0;19
9067;Puriena;Meškučių;6234132927;Taip;22;0;0;22
9068;Puriena;Meškučių;4563681164;Taip;5;0;0;5
9069;Puriena;Meškučių;3153330970;Taip;0;1;0;1
9070;Puriena;Meškučių;9500729561;Ne;0;3;4;7
9071;Puriena;Meškučių;5591189546;Taip;9;1;0;10
9072;Puriena;Meškučių;9748726934;Taip;0;0;3;3
9073;Puriena;Meškučių;5323549829;Taip;9;0;0;9
9074;Puriena;Meškučių;8359978283;Taip;0;0;3;3
9075;Puriena;Meškučių;2466609635;Taip;0;1;11;12
9076;Puriena;Meškučių;3309219271;Taip;0;6;0;6
9077;Puriena;Meškučių;9509041179;Taip;0;3;0;3
9078;Puriena;Meškučių;5176663365;Taip;0;3;0;3
9079;Puriena;Meškučių;9961074983;Taip;5;8;0;13
9080;Puriena;Meškučių;3011629747;Taip;10;0;0;10
9081;Puriena;Meškučių;2029981617;Taip;10;2;1;13
9082;Puriena;Meškučių;6185080390;Taip;18;2;0;20
9083;Puriena;Meškučių;3526684967;Taip;13;0;0;13
9084;Puriena;Meškučių;1513909923;Taip;12;0;4;16
9085;Puriena;Meškučių;7556975480;Taip;9;0;4;13
9086;Puriena;Meškučių;2711642252;Ne;8;0;0;8
9087;Puriena;Meškučių;8093664167;Ne;8;0;0;8
9088;Puriena;Nykštukų;1053386081;Taip;13;1;0;14
9089;Puriena;Nykštukų;5469827031;Ne;15;0;0;15
9090;Puriena;Nykštukų;7649596096;Ne;13;1;9;23
9091;Puriena;Nykštukų;2762325241;Ne;11;0;1;12
9092;Puriena;Nykštukų;9907142348;Taip;3;0;1;4
9093;Puriena;Nykštukų;9369786639;Taip;13;0;0;13
9094;Puriena;Nykštukų;4728991133;Taip;10;0;4;14
9095;Puriena;Nykštukų;2344061847;Taip;6;2;2;10
9096;Puriena;Nykštukų;3630564604;Taip;0;4;7;11
9097;Puriena;Nykštukų;9438604106;Taip;3;1;3;7
9098;Puriena;Nykštukų;9379314578;Taip;13;1;8;22
9099;Puriena;Nykštukų;4211784186;Ne;16;0;0;16
9100;Puriena;Nykštukų;1610219365;Ne;0;9;0;9
9101;Puriena;Nykštukų;2146727759;Taip;6;2;0;8
9102;Puriena;Nykštukų;1988826809;Taip;11;1;0;12
9103;Puriena;Nykštukų;6605817147;Taip;11;0;0;11
9104;Puriena;Nykštukų;6271951373;Taip;10;0;0;10
9105;Puriena;Nykštukų;7869104640;Taip;3;4;0;7
9106;Puriena;Ežiukai;6451492815;Taip;8;1;0;9
9107;Puriena;Ežiukai;6612468095;Ne;17;0;0;17
9108;Puriena;Ežiukai;7913847170;Taip;15;1;0;16
9109;Puriena;Ežiukai;8089081251;Taip;22;0;0;22
9110;Puriena;Ežiukai;2830409862;Ne;17;2;0;19
9111;Puriena;Ežiukai;5550321808;Taip;5;0;0;5
9112;Puriena;Ežiukai;8038573068;Taip;18;0;0;18
9113;Puriena;Ežiukai;2624283930;Taip;8;5;0;13
9114;Puriena;Ežiukai;6001659356;Taip;13;1;0;14
9115;Puriena;Ežiukai;5539708916;Ne;17;0;0;17
9116;Puriena;Ežiukai;7335537384;Taip;3;0;0;3
9117;Puriena;Ežiukai;3204824116;Taip;14;0;0;14
9118;Puriena;Ežiukai;4954787474;Ne;10;2;1;13
9119;Puriena;Ežiukai;7720549981;Ne;29;0;0;29
9120;Puriena;Ežiukai;5555076926;Taip;14;0;0;14
9121;Puriena;Ežiukai;2312297583;Taip;0;5;3;8
9122;Puriena;Ežiukai;3232981406;Taip;13;2;1;16
9123;Puriena;Ežiukai;9228372078;Taip;17;0;0;17
9124;Puriena;Ežiukai;5374864513;Taip;10;1;0;11
9125;Puriena;Ežiukai;1737249860;Taip;6;0;0;6
9126;Puriena;Ežiukai;4608801156;Taip;5;0;0;5
9127;Puriena;Ežiukai;6991740430;Taip;11;0;0;11
9128;Puriena;"Boružiukų ";9600515308;Taip;15;0;2;17
9129;Puriena;"Boružiukų ";7985332838;Taip;0;22;0;22
9130;Puriena;"Boružiukų ";9671916745;Taip;4;1;0;5
9131;Puriena;"Boružiukų ";8195902319;Taip;7;1;0;8
9132;Puriena;"Boružiukų ";4587892949;Taip;19;0;1;20
9133;Puriena;"Boružiukų ";9497287421;Taip;0;22;0;22
9134;Puriena;"Boružiukų ";2818282875;Taip;10;8;0;18
9135;Puriena;"Boružiukų ";3215364967;Taip;11;0;2;13
9136;Puriena;"Boružiukų ";7016498639;Taip;7;0;0;7
9137;Puriena;"Boružiukų ";5797970231;Ne;12;1;0;13
9138;Puriena;"Boružiukų ";3382737176;Taip;0;2;6;8
9139;Puriena;"Boružiukų ";8110665629;Taip;7;0;0;7
9140;Puriena;"Boružiukų ";4006267650;Ne;9;13;0;22
9141;Puriena;"Boružiukų ";3440488785;Taip;0;0;7;7
9142;Puriena;"Boružiukų ";4016228982;Taip;0;2;2;4
9143;Puriena;"Boružiukų ";1796123753;Taip;14;0;2;16
9144;Puriena;"Boružiukų ";5277351784;Taip;12;1;0;13
9145;Puriena;"Boružiukų ";9931397038;Taip;10;0;7;17
9146;Puriena;"Zuikučių ";3252190329;Taip;6;6;0;12
9147;Puriena;"Zuikučių ";9907972536;Taip;14;0;0;14
9148;Puriena;"Zuikučių ";4165800035;Taip;14;0;1;15
9149;Puriena;"Zuikučių ";7634536770;Taip;18;0;0;18
9150;Puriena;"Zuikučių ";9423229931;Taip;12;3;0;15
9151;Puriena;"Zuikučių ";8284860687;Taip;25;0;0;25
9152;Puriena;"Zuikučių ";9176303276;Taip;7;12;2;21
9153;Puriena;"Zuikučių ";6941251095;Taip;22;0;0;22
9154;Puriena;"Zuikučių ";4193710604;Taip;0;2;6;8
9155;Puriena;"Zuikučių ";8474426340;Taip;14;0;0;14
9156;Puriena;"Zuikučių ";6227990580;Taip;5;0;5;10
9157;Puriena;"Zuikučių ";2172109284;Taip;11;0;1;12
9158;Puriena;"Zuikučių ";8239919265;Ne;7;0;0;7
9159;Puriena;"Zuikučių ";3094722037;Taip;8;0;0;8
9160;Puriena;"Zuikučių ";6308393533;Taip;13;2;0;15
9161;Puriena;"Zuikučių ";5927216569;Taip;18;0;0;18
9162;Puriena;Skruzdėliukai;2203259310;Taip;0;3;0;3
9163;Puriena;Skruzdėliukai;8478901457;Taip;11;4;0;15
9164;Puriena;Skruzdėliukai;4647433927;Ne;0;11;22;33
9165;Puriena;Skruzdėliukai;5257713434;Ne;0;11;22;33
9166;Puriena;Skruzdėliukai;9106525954;Taip;4;3;0;7
9167;Puriena;Skruzdėliukai;11242620566;Taip;0;3;0;3
9168;Puriena;Skruzdėliukai;6285846517;Taip;5;6;0;11
9169;Puriena;Skruzdėliukai;6053657231;Taip;0;6;2;8
9170;Puriena;Skruzdėliukai;9139110598;Taip;5;1;0;6
9171;Puriena;Skruzdėliukai;5501308683;Taip;5;4;0;9
9172;Puriena;Skruzdėliukai;2663832596;Taip;7;1;0;8
9173;Puriena;Skruzdėliukai;6057477307;Taip;22;0;0;22
9174;Puriena;Skruzdėliukai;4966293604;Taip;0;3;5;8
9175;Puriena;Skruzdėliukai;92604925140;Taip;16;1;0;17
9176;Puriena;Skruzdėliukai;1381379515;Taip;10;2;0;12
9177;Puriena;Skruzdėliukai;1290962809;Taip;0;8;0;8
9178;Puriena;Skruzdėliukai;23746358787;Taip;3;1;0;4
9179;Puriena;Skruzdėliukai;1263637124;Taip;5;1;0;6
9180;Puriena;Skruzdėliukai;1290933817;Taip;10;6;0;16
9181;Puriena;Skruzdėliukai;8112003551;Taip;6;0;0;6
9182;Pušaitė;Kodėlčiukai;8702361596;Taip;10;0;1;11
9183;Pušaitė;Kodėlčiukai;3832434608;Taip;0;0;6;6
9184;Pušaitė;Kodėlčiukai;4838345510;Taip;5;1;3;9
9185;Pušaitė;Kodėlčiukai;7068451014;Taip;0;1;0;1
9186;Pušaitė;Kodėlčiukai;6275090953;Taip;5;0;0;5
9187;Pušaitė;Kodėlčiukai;8750774616;Taip;5;3;0;8
9188;Pušaitė;Kodėlčiukai;4198571222;Taip;10;0;0;10
9189;Pušaitė;Kodėlčiukai;4743105731;Taip;7;0;0;7
9190;Pušaitė;Kodėlčiukai;9391350218;Taip;4;3;0;7
9191;Pušaitė;Kodėlčiukai;2793941689;Taip;10;3;0;13
9192;Pušaitė;Kodėlčiukai;9364887123;Taip;5;3;0;8
9193;Pušaitė;Kodėlčiukai;4326967247;Taip;0;2;3;5
9194;Pušaitė;Kodėlčiukai;5922053969;Taip;5;0;3;8
9195;Pušaitė;Kodėlčiukai;4473930703;Taip;0;3;0;3
9196;Pušaitė;Kodėlčiukai;6775428321;Taip;10;3;0;13
9197;Pušaitė;Kodėlčiukai;4615270419;Taip;0;1;0;1
9198;Pušaitė;Kodėlčiukai;7117784038;Taip;9;12;1;22
9199;Pušaitė;Kodėlčiukai;2253477550;Taip;0;2;0;2
9200;Pušaitė;Kodėlčiukai;6186545163;Taip;7;1;0;8
9201;Pušaitė;Saulutės;4511258460;Taip;0;8;2;10
9202;Pušaitė;Saulutės;5422616450;Ne;10;0;2;12
9203;Pušaitė;Saulutės;7237345427;Ne;0;0;1;1
9204;Pušaitė;Saulutės;5819186055;Taip;7;0;2;9
9205;Pušaitė;Saulutės;8931688329;Taip;19;0;0;19
9206;Pušaitė;Saulutės;5981944481;Taip;8;0;0;8
9207;Pušaitė;Saulutės;2254269292;Taip;18;0;0;18
9208;Pušaitė;Saulutės;5306237557;Taip;20;0;0;20
9209;Pušaitė;Saulutės;4234318548;Taip;0;3;6;9
9210;Pušaitė;Saulutės;4883211957;Taip;0;22;0;22
9211;Pušaitė;Saulutės;1384820994;Taip;0;22;0;22
9212;Pušaitė;Saulutės;7480846917;Ne;2;0;0;2
9213;Pušaitė;Saulutės;8355083823;Taip;5;0;2;7
9214;Pušaitė;Saulutės;7291412329;Taip;0;0;3;3
9215;Pušaitė;Saulutės;2543188867;Ne;4;0;0;4
9216;Pušaitė;Saulutės;9577925438;Taip;8;0;0;8
9217;Pušaitė;Saulutės;8914668904;Taip;4;5;1;10
9218;Pušaitė;Zuikučiai;2115591523;Taip;0;9;4;13
9219;Pušaitė;Zuikučiai;8738827821;Taip;14;2;0;16
9220;Pušaitė;Zuikučiai;7477429922;Taip;4;4;0;8
9221;Pušaitė;Zuikučiai;6306133416;Taip;3;0;0;3
9222;Pušaitė;Zuikučiai;2099169654;Taip;5;0;0;5
9223;Pušaitė;Zuikučiai;6355379926;Taip;6;0;0;6
9224;Pušaitė;Zuikučiai;80743691769;Taip;3;0;0;3
9225;Pušaitė;Zuikučiai;1296700534;Taip;0;1;1;2
9226;Pušaitė;Zuikučiai;51500717235;Ne;5;9;1;15
9227;Pušaitė;Zuikučiai;2125574493;Taip;6;0;1;7
9228;Pušaitė;Zuikučiai;5398532705;Taip;0;2;10;12
9229;Pušaitė;Zuikučiai;4881689337;Taip;9;0;0;9
9230;Pušaitė;Zuikučiai;1295203136;Taip;9;3;1;13
9231;Pušaitė;Zuikučiai;2944418714;Taip;24;3;0;27
9232;Pušaitė;Zuikučiai;3813761666;Taip;22;3;5;30
9233;Pušaitė;Zuikučiai;4762094720;Taip;0;1;1;2
9234;Pušaitė;Zuikučiai;6600314608;Taip;8;0;0;8
9235;Pušaitė;Zuikučiai;2130767942;Taip;6;9;0;15
9236;Pušaitė;Zuikučiai;9179757395;Taip;14;0;4;18
9237;Pušaitė;Zuikučiai;8592426606;Taip;0;0;2;2
9238;Pušaitė;Zuikučiai;7251064118;Taip;0;2;4;6
9239;Pušaitė;Vėžliukai;1326581025;Taip;10;5;0;15
9240;Pušaitė;Vėžliukai;8135552679;Taip;0;3;0;3
9241;Pušaitė;Vėžliukai;5161142520;Taip;0;0;1;1
9242;Pušaitė;Vėžliukai;3485234259;Taip;9;3;0;12
9243;Pušaitė;Vėžliukai;3014867515;Taip;10;0;0;10
9244;Pušaitė;Vėžliukai;9414554800;Taip;6;1;0;7
9245;Pušaitė;Vėžliukai;9470667227;Taip;9;1;0;10
9246;Pušaitė;Vėžliukai;6739253961;Taip;0;9;0;9
9247;Pušaitė;Vėžliukai;3014180020;Ne;5;0;2;7
9248;Pušaitė;Vėžliukai;7890577174;Taip;0;6;0;6
9249;Pušaitė;Vėžliukai;5318602924;Taip;15;1;0;16
9250;Pušaitė;Vėžliukai;6794867560;Taip;0;4;1;5
9251;Pušaitė;Vėžliukai;5296435012;Taip;7;1;0;8
9252;Pušaitė;Vėžliukai;6833083982;Taip;5;0;2;7
9253;Pušaitė;Vėžliukai;5512786073;Taip;12;3;0;15
9254;Pušaitė;Vėžliukai;8399589954;Ne;0;3;0;3
9255;Pušaitė;Vėžliukai;4281125486;Taip;1;8;0;9
9256;Pušaitė;Vėžliukai;2777222076;Taip;5;4;1;10
9257;Pušaitė;Vėžliukai;8459530338;Taip;0;4;0;4
9258;Pušaitė;"Linksmieji nykštukai";9265357004;Taip;0;5;0;5
9259;Pušaitė;"Linksmieji nykštukai";3150144924;Taip;8;2;0;10
9260;Pušaitė;"Linksmieji nykštukai";7520393710;Taip;5;0;0;5
9261;Pušaitė;"Linksmieji nykštukai";4517181474;Taip;0;1;0;1
9262;Pušaitė;"Linksmieji nykštukai";9033615485;Ne;0;2;1;3
9263;Pušaitė;"Linksmieji nykštukai";3130824742;Taip;6;3;1;10
9264;Pušaitė;"Linksmieji nykštukai";4605161267;Taip;19;1;0;20
9265;Pušaitė;"Linksmieji nykštukai";1781601521;Taip;0;2;0;2
9266;Pušaitė;"Linksmieji nykštukai";1024996364;Taip;14;1;2;17
9267;Pušaitė;"Linksmieji nykštukai";4662871524;Taip;6;2;0;8
9268;Pušaitė;"Linksmieji nykštukai";8438652029;Taip;0;0;3;3
9269;Pušaitė;"Linksmieji nykštukai";6578483902;Taip;5;18;0;23
9270;Pušaitė;"Linksmieji nykštukai";3350461304;Taip;0;1;0;1
9271;Pušaitė;"Linksmieji nykštukai";9327636862;Taip;8;1;0;9
9272;Pušaitė;"Linksmieji nykštukai";4175909754;Taip;5;0;1;6
9273;Pušaitė;"Linksmieji nykštukai";3788392895;Taip;13;2;0;15
9274;Pušaitė;"Linksmieji nykštukai";3195191374;Taip;9;0;0;9
9275;Pušaitė;"Linksmieji nykštukai";9127444013;Taip;5;2;0;7
9276;Pušaitė;"Linksmieji nykštukai";5422784898;Taip;12;3;0;15
9277;Pušaitė;"Linksmieji nykštukai";5104111840;Taip;0;2;0;2
9278;Pušaitė;"Linksmieji nykštukai";9866431097;Taip;3;3;2;8
9279;Pušaitė;"Linksmieji nykštukai";4374232593;Taip;14;0;0;14
9280;Pušaitė;"Linksmieji nykštukai";8378313810;Taip;0;8;0;8
9281;Pušaitė;"Kačiukų trobelė";5415680731;Taip;4;0;0;4
9282;Pušaitė;"Kačiukų trobelė";7983115812;Taip;0;1;0;1
9283;Pušaitė;"Kačiukų trobelė";7614475216;Taip;0;0;5;5
9284;Pušaitė;"Kačiukų trobelė";1122112207;Taip;0;9;0;9
9285;Pušaitė;"Kačiukų trobelė";1635528919;Taip;0;0;5;5
9286;Pušaitė;"Kačiukų trobelė";2837439334;Taip;13;0;0;13
9287;Pušaitė;"Kačiukų trobelė";7014914682;Ne;0;6;0;6
9288;Pušaitė;"Kačiukų trobelė";1624587173;Taip;0;1;6;7
9289;Pušaitė;"Kačiukų trobelė";8793102437;Taip;9;8;0;17
9290;Pušaitė;"Kačiukų trobelė";9056933586;Taip;12;3;0;15
9291;Pušaitė;"Kačiukų trobelė";7898355721;Taip;5;0;0;5
9292;Pušaitė;"Kačiukų trobelė";6323180798;Taip;0;1;0;1
9293;Pušaitė;"Kačiukų trobelė";5191894075;Taip;7;0;0;7
9294;Pušaitė;"Kačiukų trobelė";1161519408;Ne;5;9;0;14
9295;Pušaitė;"Kačiukų trobelė";8822285103;Taip;15;1;0;16
9296;Pušaitė;"Kačiukų trobelė";9313564235;Taip;4;1;0;5
9297;Pušaitė;"Kačiukų trobelė";2865062081;Taip;10;1;0;11
9298;Pušaitė;"Kačiukų trobelė";2430891944;Taip;9;0;0;9
9299;Pušaitė;"Kačiukų trobelė";1978339054;Taip;15;1;0;16
9300;Pušaitė;"Kačiukų trobelė";6189116357;Taip;4;3;3;10
9301;Pušaitė;Ežiukai;2090143259;Ne;0;2;0;2
9302;Pušaitė;Ežiukai;2951618391;Taip;0;3;4;7
9303;Pušaitė;Ežiukai;9524002395;Taip;0;2;0;2
9304;Pušaitė;Ežiukai;1111143593;Taip;0;1;2;3
9305;Pušaitė;Ežiukai;5394378197;Taip;0;1;4;5
9306;Pušaitė;Ežiukai;15270671089;Taip;0;2;0;2
9307;Pušaitė;Ežiukai;69869396094;Taip;10;1;0;11
9308;Pušaitė;Ežiukai;3359574190;Taip;15;3;1;19
9309;Pušaitė;Ežiukai;1143122778;Taip;5;4;0;9
9310;Pušaitė;Ežiukai;9461292576;Taip;4;1;0;5
9311;Pušaitė;Ežiukai;5185787803;Taip;3;1;0;4
9312;Pušaitė;Ežiukai;4671293211;Taip;9;3;2;14
9313;Pušaitė;Ežiukai;4101326122;Taip;7;0;0;7
9314;Pušaitė;Ežiukai;8958364766;Ne;6;3;0;9
9315;Pušaitė;Ežiukai;2983890410;Taip;0;1;0;1
9316;Pušaitė;Ežiukai;7575143890;Taip;0;1;2;3
9317;Pušaitė;Ežiukai;7808186865;Ne;5;7;0;12
9318;Pušaitė;Ežiukai;4842783897;Taip;4;1;2;7
9319;Pušaitė;Ežiukai;5436168234;Taip;0;0;1;1
9320;Pušaitė;Ežiukai;8021494509;Taip;18;0;0;18
9321;Pušaitė;Ežiukai;2172342063;Taip;9;3;0;12
9322;Pušaitė;Ežiukai;8309000712;Taip;4;1;0;5
9323;Pušaitė;"Gudručių šalis";8763667682;Taip;5;0;3;8
9324;Pušaitė;"Gudručių šalis";2321256048;Taip;0;1;0;1
9325;Pušaitė;"Gudručių šalis";5488507646;Ne;8;0;0;8
9326;Pušaitė;"Gudručių šalis";1305526154;Ne;15;4;3;22
9327;Pušaitė;"Gudručių šalis";6205900423;Taip;0;22;0;22
9328;Pušaitė;"Gudručių šalis";2078734161;Taip;5;0;3;8
9329;Pušaitė;"Gudručių šalis";8790959900;Taip;1;2;0;3
9330;Pušaitė;"Gudručių šalis";2397106198;Taip;3;0;5;8
9331;Pušaitė;"Gudručių šalis";3694667637;Taip;15;0;0;15
9332;Pušaitė;"Gudručių šalis";8343949011;Taip;4;0;0;4
9333;Pušaitė;"Gudručių šalis";4101285889;Ne;10;0;9;19
9334;Pušaitė;"Gudručių šalis";3959838346;Taip;16;0;0;16
9335;Pušaitė;"Gudručių šalis";5563772495;Taip;0;0;6;6
9336;Pušaitė;"Gudručių šalis";6356263503;Taip;8;0;3;11
9337;Pušaitė;"Gudručių šalis";4626055123;Taip;0;1;1;2
9338;Pušaitė;"Gudručių šalis";2333176054;Taip;0;1;1;2
9339;Pušaitė;"Gudručių šalis";7066207306;Taip;0;8;1;9
9340;Pušaitė;"Gudručių šalis";4918124423;Taip;8;0;0;8
9341;Pušaitė;"Gudručių šalis";7992567219;Taip;1;0;3;4
9342;Pušaitė;"Gudručių šalis";1807432967;Taip;4;0;0;4
9343;Pušaitė;"Gudručių šalis";3380836598;Taip;11;0;0;11
9344;Pušaitė;"Lapučių mokyklėlė";9337726482;Taip;0;5;0;5
9345;Pušaitė;"Lapučių mokyklėlė";5139525557;Taip;5;0;0;5
9346;Pušaitė;"Lapučių mokyklėlė";2666541612;Taip;13;0;0;13
9347;Pušaitė;"Lapučių mokyklėlė";8343225451;Taip;8;5;0;13
9348;Pušaitė;"Lapučių mokyklėlė";8218991320;Taip;10;2;0;12
9349;Pušaitė;"Lapučių mokyklėlė";1994898058;Taip;0;22;0;22
9350;Pušaitė;"Lapučių mokyklėlė";8551426938;Taip;14;0;0;14
9351;Pušaitė;"Lapučių mokyklėlė";4444972517;Taip;19;0;0;19
9352;Pušaitė;"Lapučių mokyklėlė";7615253880;Taip;27;0;0;27
9353;Pušaitė;"Lapučių mokyklėlė";4508356130;Taip;9;3;0;12
9354;Pušaitė;"Lapučių mokyklėlė";4857214952;Taip;0;3;0;3
9355;Pušaitė;"Lapučių mokyklėlė";4138386134;Taip;7;0;0;7
9356;Pušaitė;"Lapučių mokyklėlė";4103149433;Taip;9;1;0;10
9357;Pušaitė;"Lapučių mokyklėlė";4747611989;Taip;4;2;2;8
9358;Pušaitė;"Lapučių mokyklėlė";3387165403;Taip;4;1;0;5
9359;Pušaitė;"Lapučių mokyklėlė";5281161835;Taip;0;0;3;3
9360;Pušaitė;"Lapučių mokyklėlė";5339878948;Ne;10;1;0;11
9361;Pušaitė;"Lapučių mokyklėlė";3610256789;Taip;14;5;10;29
9362;Pušaitė;"Lapučių mokyklėlė";6576647982;Taip;5;0;0;5
9363;Pušaitė;"Lapučių mokyklėlė";1395577340;Taip;10;2;0;12
9364;Pušaitė;"Lapučių mokyklėlė";1534764228;Taip;3;2;0;5
9365;Pušaitė;"Lapučių mokyklėlė";5328083339;Ne;6;2;0;8
9366;Pušaitė;"Lapučių mokyklėlė";3200968850;Taip;10;7;0;17
9367;Pušaitė;"VOVERIUKAI ";6767281906;Ne;0;6;0;6
9368;Pušaitė;"VOVERIUKAI ";3732377309;Ne;15;0;0;15
9369;Pušaitė;"VOVERIUKAI ";5270528758;Taip;7;0;0;7
9370;Pušaitė;"VOVERIUKAI ";4344634837;Taip;0;0;22;22
9371;Pušaitė;"VOVERIUKAI ";1665030028;Ne;11;0;3;14
9372;Pušaitė;"VOVERIUKAI ";5013833636;Taip;18;0;0;18
9373;Pušaitė;"VOVERIUKAI ";6742576615;Taip;0;4;0;4
9374;Pušaitė;"VOVERIUKAI ";6511940816;Taip;0;22;0;22
9375;Pušaitė;"VOVERIUKAI ";4818407739;Taip;5;22;0;27
9376;Pušaitė;"VOVERIUKAI ";8593282377;Ne;0;0;10;10
9377;Pušaitė;"VOVERIUKAI ";8876092901;Taip;7;0;0;7
9378;Pušaitė;"VOVERIUKAI ";4767321724;Taip;16;8;1;25
9379;Pušaitė;"VOVERIUKAI ";1542239525;Taip;12;0;0;12
9380;Pušaitė;"VOVERIUKAI ";4529006786;Taip;9;0;0;9
9381;Pušaitė;MEŠKUČIAI;5002710062;Taip;0;13;5;18
9382;Pušaitė;MEŠKUČIAI;9872317190;Taip;0;0;1;1
9383;Pušaitė;MEŠKUČIAI;3052743933;Taip;0;22;0;22
9384;Pušaitė;MEŠKUČIAI;3646346787;Taip;0;22;0;22
9385;Pušaitė;MEŠKUČIAI;6754402783;Taip;0;22;0;22
9386;Pušaitė;MEŠKUČIAI;9180309936;Ne;12;0;0;12
9387;Pušaitė;MEŠKUČIAI;4754791489;Taip;9;2;0;11
9388;Pušaitė;MEŠKUČIAI;2264047794;Taip;9;12;1;22
9389;Pušaitė;MEŠKUČIAI;4278699624;Taip;0;22;0;22
9390;Pušaitė;MEŠKUČIAI;8244793037;Taip;0;2;7;9
9391;Pušaitė;MEŠKUČIAI;3508664946;Taip;3;3;0;6
9392;Pušaitė;MEŠKUČIAI;3239486674;Taip;9;0;2;11
9393;Pušaitė;MEŠKUČIAI;9339706754;Taip;15;0;0;15
9394;Pušaitė;MEŠKUČIAI;2887576870;Taip;0;0;2;2
9395;Pušaitė;MEŠKUČIAI;7583243031;Taip;13;0;0;13
9396;Pušaitė;MEŠKUČIAI;9418440677;Taip;0;22;0;22
9397;Pušaitė;MEŠKUČIAI;4082173648;Taip;6;4;0;10
9398;Pušaitė;PELIUKAI;7103772753;Taip;9;0;3;12
9399;Pušaitė;PELIUKAI;9177861202;Ne;10;2;0;12
9400;Pušaitė;PELIUKAI;9164927041;Taip;0;22;0;22
9401;Pušaitė;PELIUKAI;2454348536;Taip;9;0;0;9
9402;Pušaitė;PELIUKAI;6645711171;Taip;18;2;0;20
9403;Pušaitė;PELIUKAI;9867041220;Taip;20;0;0;20
9404;Pušaitė;PELIUKAI;9031289300;Taip;2;0;0;2
9405;Pušaitė;PELIUKAI;7210529114;Taip;14;3;0;17
9406;Pušaitė;PELIUKAI;2758026755;Taip;6;3;0;9
9407;Pušaitė;PELIUKAI;6851908671;Taip;7;0;1;8
9408;Pušaitė;PELIUKAI;7737524017;Ne;22;0;0;22
9409;Pušaitė;PELIUKAI;2618038364;Taip;0;22;0;22
9410;Pušaitė;PELIUKAI;1180343204;Taip;9;4;0;13
9411;Pušaitė;PELIUKAI;1069369636;Taip;9;0;0;9
9412;Pušaitė;PELIUKAI;5112517007;Taip;5;22;0;27
9413;Pušaitė;PELIUKAI;9261546370;Taip;7;1;0;8
9414;Pušaitė;PELIUKAI;6059415475;Taip;6;0;1;7
9415;"Pušynėlis (Miglos g. 53)";PUMPURĖLIAI;5725602894;Taip;0;0;22;22
9416;"Pušynėlis (Miglos g. 53)";PUMPURĖLIAI;2718421498;Taip;6;0;1;7
9417;"Pušynėlis (Miglos g. 53)";PUMPURĖLIAI;3882064516;Taip;5;7;1;13
9418;"Pušynėlis (Miglos g. 53)";PUMPURĖLIAI;9081582524;Taip;5;7;1;13
9419;"Pušynėlis (Miglos g. 53)";PUMPURĖLIAI;7787646910;Taip;0;1;0;1
9420;"Pušynėlis (Miglos g. 53)";PUMPURĖLIAI;4526807309;Taip;0;1;10;11
9421;"Pušynėlis (Miglos g. 53)";PUMPURĖLIAI;5568838550;Taip;2;0;0;2
9422;"Pušynėlis (Miglos g. 53)";PUMPURĖLIAI;2744665477;Taip;22;0;0;22
9423;"Pušynėlis (Miglos g. 53)";PUMPURĖLIAI;2509111066;Taip;7;0;0;7
9424;"Pušynėlis (Miglos g. 53)";PUMPURĖLIAI;8902047615;Taip;0;9;0;9
9425;"Pušynėlis (Miglos g. 53)";PUMPURĖLIAI;3483639540;Taip;0;6;2;8
9426;"Pušynėlis (Miglos g. 53)";PUMPURĖLIAI;2861000826;Taip;10;0;0;10
9427;"Pušynėlis (Miglos g. 53)";PUMPURĖLIAI;8845728723;Taip;6;0;0;6
9428;"Pušynėlis (Miglos g. 53)";PUMPURĖLIAI;9883505094;Taip;22;0;2;24
9429;"Pušynėlis (Miglos g. 53)";PUMPURĖLIAI;7438923710;Taip;9;11;2;22
9430;"Pušynėlis (Miglos g. 53)";PUMPURĖLIAI;4962270317;Taip;9;0;0;9
9431;"Pušynėlis (Miglos g. 53)";PUMPURĖLIAI;8803766149;Taip;7;1;0;8
9432;"Pušynėlis (Miglos g. 53)";PUMPURĖLIAI;8462742834;Taip;0;11;0;11
9433;"Pušynėlis (Miglos g. 53)";PUMPURĖLIAI;6962705842;Taip;0;0;22;22
9434;"Pušynėlis (Miglos g. 53)";PUMPURĖLIAI;6110878898;Taip;5;0;4;9
9435;"Pušynėlis (Miglos g. 53)";SAULUTĖS;3483007385;Taip;10;2;0;12
9436;"Pušynėlis (Miglos g. 53)";SAULUTĖS;1891728904;Taip;0;6;0;6
9437;"Pušynėlis (Miglos g. 53)";SAULUTĖS;2508640229;Ne;3;0;3;6
9438;"Pušynėlis (Miglos g. 53)";SAULUTĖS;5236219294;Taip;0;0;12;12
9439;"Pušynėlis (Miglos g. 53)";SAULUTĖS;4052132379;Taip;9;0;1;10
9440;"Pušynėlis (Miglos g. 53)";SAULUTĖS;1102029570;Taip;4;0;0;4
9441;"Pušynėlis (Miglos g. 53)";SAULUTĖS;9483417104;Taip;11;0;0;11
9442;"Pušynėlis (Miglos g. 53)";SAULUTĖS;4052365035;Taip;0;0;1;1
9443;"Pušynėlis (Miglos g. 53)";SAULUTĖS;1164201286;Taip;0;14;0;14
9444;"Pušynėlis (Miglos g. 53)";SAULUTĖS;1251787066;Taip;11;0;1;12
9445;"Pušynėlis (Miglos g. 53)";SAULUTĖS;6709692748;Taip;5;1;0;6
9446;"Pušynėlis (Miglos g. 53)";SAULUTĖS;5318223378;Taip;4;0;6;10
9447;"Pušynėlis (Miglos g. 53)";SAULUTĖS;3100230874;Taip;0;22;0;22
9448;"Pušynėlis (Miglos g. 53)";SAULUTĖS;7896617995;Taip;0;4;11;15
9449;"Pušynėlis (Miglos g. 53)";SAULUTĖS;5897839636;Taip;0;2;0;2
9450;"Pušynėlis (Miglos g. 53)";SAULUTĖS;1034336110;Taip;10;8;0;18
9451;"Pušynėlis (Miglos g. 53)";SAULUTĖS;8799095053;Taip;8;1;0;9
9452;"Pušynėlis (Miglos g. 53)";SAULUTĖS;8451160808;Taip;9;0;0;9
9453;"Pušynėlis (Miglos g. 53)";SAULUTĖS;5501281051;Ne;0;0;7;7
9454;"Pušynėlis (Miglos g. 53)";PRIEŠMOKYKLINĖ;25261143142;Taip;16;1;0;17
9455;"Pušynėlis (Miglos g. 53)";PRIEŠMOKYKLINĖ;8742287326;Taip;1;1;1;3
9456;"Pušynėlis (Miglos g. 53)";PRIEŠMOKYKLINĖ;6549217377;Taip;4;0;1;5
9457;"Pušynėlis (Miglos g. 53)";PRIEŠMOKYKLINĖ;2012089695;Taip;0;3;0;3
9458;"Pušynėlis (Miglos g. 53)";PRIEŠMOKYKLINĖ;35538053975;Ne;0;7;0;7
9459;"Pušynėlis (Miglos g. 53)";PRIEŠMOKYKLINĖ;76597184985;Taip;0;1;0;1
9460;"Pušynėlis (Miglos g. 53)";PRIEŠMOKYKLINĖ;7729392498;Taip;7;2;1;10
9461;"Pušynėlis (Miglos g. 53)";PRIEŠMOKYKLINĖ;9192206804;Taip;0;1;0;1
9462;"Pušynėlis (Miglos g. 53)";PRIEŠMOKYKLINĖ;6077698697;Taip;0;4;1;5
9463;"Pušynėlis (Miglos g. 53)";PRIEŠMOKYKLINĖ;4668634909;Taip;1;2;0;3
9464;"Pušynėlis (Miglos g. 53)";PRIEŠMOKYKLINĖ;6560054869;Taip;0;5;0;5
9465;"Pušynėlis (Miglos g. 53)";PRIEŠMOKYKLINĖ;3037031809;Ne;0;3;0;3
9466;"Pušynėlis (Miglos g. 53)";PRIEŠMOKYKLINĖ;4030500100;Taip;0;10;0;10
9467;"Pušynėlis (Miglos g. 53)";PRIEŠMOKYKLINĖ;8172450090;Taip;0;10;0;10
9468;"Pušynėlis (Miglos g. 53)";PRIEŠMOKYKLINĖ;2793982816;Taip;8;0;0;8
9469;"Pušynėlis (Miglos g. 53)";PRIEŠMOKYKLINĖ;7046421581;Ne;9;3;0;12
9470;"Pušynėlis (Miglos g. 53)";PRIEŠMOKYKLINĖ;9466109315;Ne;0;2;0;2
9471;"Pušynėlis (Miglos g. 53)";PRIEŠMOKYKLINĖ;9154108688;Taip;3;0;4;7
9472;"Pušynėlis (Miglos g. 53)";PRIEŠMOKYKLINĖ;3510202379;Taip;0;0;4;4
9473;"Pušynėlis (Miglos g. 53)";PRIEŠMOKYKLINĖ;2765869141;Taip;5;3;1;9
9474;"Pušynėlis (Miglos g. 53)";"TREPSIUKAI (2018.09)";7732546085;Taip;3;0;0;3
9475;"Pušynėlis (Miglos g. 53)";"TREPSIUKAI (2018.09)";4449613959;Taip;0;0;22;22
9476;"Pušynėlis (Miglos g. 53)";"TREPSIUKAI (2018.09)";8933840402;Taip;8;0;0;8
9477;"Pušynėlis (Miglos g. 53)";"TREPSIUKAI (2018.09)";5488832089;Ne;9;3;0;12
9478;"Pušynėlis (Miglos g. 53)";"TREPSIUKAI (2018.09)";6414064067;Taip;8;4;0;12
9479;"Pušynėlis (Miglos g. 53)";"TREPSIUKAI (2018.09)";5670094788;Taip;5;0;3;8
9480;"Pušynėlis (Miglos g. 53)";"TREPSIUKAI (2018.09)";5264481173;Taip;5;3;0;8
9481;"Pušynėlis (Miglos g. 53)";"TREPSIUKAI (2018.09)";4468698630;Taip;7;0;0;7
9482;"Pušynėlis (Miglos g. 53)";"TREPSIUKAI (2018.09)";1240222214;Taip;4;0;0;4
9483;"Pušynėlis (Miglos g. 53)";"TREPSIUKAI (2018.09)";6318952845;Taip;3;0;1;4
9484;"Pušynėlis (Miglos g. 53)";"TREPSIUKAI (2018.09)";1508282873;Taip;12;0;0;12
9485;"Pušynėlis (Miglos g. 53)";"TREPSIUKAI (2018.09)";7745507151;Taip;5;0;5;10
9486;"Pušynėlis (Miglos g. 53)";"TREPSIUKAI (2018.09)";8372033449;Taip;0;6;0;6
9487;"Pušynėlis (Miglos g. 53)";"TREPSIUKAI (2018.09)";7964828070;Taip;0;0;22;22
9488;"Pušynėlis (Miglos g. 53)";"TREPSIUKAI (2018.09)";4603625624;Ne;2;0;0;2
9489;"Pušynėlis (Miglos g. 53)";"TREPSIUKAI (2018.09)";3682719098;Taip;1;0;1;2
9490;"Pušynėlis (Miglos g. 53)";"TREPSIUKAI (2018.09)";5038740377;Taip;4;0;0;4
9491;Raktelis;LAŠIUKAI;5031703240;Taip;0;1;0;1
9492;Raktelis;LAŠIUKAI;4671391106;Taip;0;1;0;1
9493;Raktelis;LAŠIUKAI;9313156299;Taip;12;0;0;12
9494;Raktelis;LAŠIUKAI;8117871963;Taip;0;13;0;13
9495;Raktelis;LAŠIUKAI;1192775994;Taip;4;2;0;6
9496;Raktelis;LAŠIUKAI;6854111162;Taip;5;4;0;9
9497;Raktelis;LAŠIUKAI;9230053040;Taip;15;5;0;20
9498;Raktelis;LAŠIUKAI;8410301417;Taip;0;1;0;1
9499;Raktelis;LAŠIUKAI;3713386556;Taip;6;5;2;13
9500;Raktelis;LAŠIUKAI;5818899732;Taip;4;0;0;4
9501;Raktelis;LAŠIUKAI;7487507324;Taip;0;4;0;4
9502;Raktelis;LAŠIUKAI;9584164290;Taip;9;4;0;13
9503;Raktelis;LAŠIUKAI;6049420030;Ne;9;7;0;16
9504;Raktelis;LAŠIUKAI;3345708690;Taip;0;3;0;3
9505;Raktelis;LAŠIUKAI;95104355224;Taip;19;0;0;19
9506;Raktelis;LAŠIUKAI;2303286473;Taip;4;8;0;12
9507;Raktelis;LAŠIUKAI;54221331553;Taip;7;3;0;10
9508;Raktelis;LAŠIUKAI;5802689482;Taip;13;5;0;18
9509;Raktelis;LAŠIUKAI;5000264125;Taip;15;1;0;16
9510;Raktelis;LAŠIUKAI;1457880868;Taip;8;4;0;12
9511;Raktelis;LAŠIUKAI;5711863758;Taip;12;3;0;15
9512;Raktelis;LAŠIUKAI;53034039807;Taip;4;9;0;13
9513;Raktelis;LAŠIUKAI;7248631013;Taip;0;3;0;3
9514;Raktelis;LAŠIUKAI;8559758812;Taip;3;9;0;12
9515;Raktelis;LAŠIUKAI;9210856228;Ne;6;0;0;6
9516;Raktelis;BITUTĖS;7265543701;Ne;9;5;0;14
9517;Raktelis;BITUTĖS;5627179884;Taip;8;2;1;11
9518;Raktelis;BITUTĖS;5405322552;Taip;22;0;0;22
9519;Raktelis;BITUTĖS;5492437864;Ne;6;5;0;11
9520;Raktelis;BITUTĖS;5218387088;Taip;18;0;0;18
9521;Raktelis;BITUTĖS;9139322116;Taip;17;1;1;19
9522;Raktelis;BITUTĖS;6929358401;Taip;13;5;0;18
9523;Raktelis;BITUTĖS;9965855682;Taip;11;3;0;14
9524;Raktelis;BITUTĖS;4319176525;Taip;2;1;0;3
9525;Raktelis;BITUTĖS;4317705126;Taip;9;0;1;10
9526;Raktelis;BITUTĖS;4187804340;Ne;0;0;3;3
9527;Raktelis;BITUTĖS;5820028619;Taip;5;6;0;11
9528;Raktelis;BITUTĖS;2652125338;Taip;0;0;7;7
9529;Raktelis;BITUTĖS;3821849812;Taip;15;1;0;16
9530;Raktelis;BITUTĖS;3308623522;Ne;21;3;0;24
9531;Raktelis;BITUTĖS;4059286631;Taip;12;0;0;12
9532;Raktelis;BITUTĖS;5913060415;Taip;10;3;1;14
9533;Raktelis;BITUTĖS;6974263764;Taip;0;6;0;6
9534;Raktelis;BITUTĖS;6932820066;Taip;10;2;0;12
9535;Raktelis;BITUTĖS;2410682193;Taip;14;0;2;16
9536;Raktelis;BITUTĖS;5705825231;Taip;9;0;1;10
9537;Raktelis;BITUTĖS;4615337759;Taip;14;3;0;17
9538;Raktelis;BITUTĖS;4962251215;Taip;0;10;0;10
9539;Raktelis;BITUTĖS;8282429202;Taip;10;1;0;11
9540;Raktelis;BORUŽĖLĖS;7068061170;Taip;22;0;0;22
9541;Raktelis;BORUŽĖLĖS;2361477092;Taip;20;5;0;25
9542;Raktelis;BORUŽĖLĖS;4226277600;Ne;15;3;0;18
9543;Raktelis;BORUŽĖLĖS;2599670832;Ne;12;2;1;15
9544;Raktelis;BORUŽĖLĖS;1757601091;Taip;9;5;0;14
9545;Raktelis;BORUŽĖLĖS;5865484633;Ne;6;3;0;9
9546;Raktelis;BORUŽĖLĖS;4529213150;Ne;14;1;0;15
9547;Raktelis;BORUŽĖLĖS;4936637343;Taip;5;2;0;7
9548;Raktelis;BORUŽĖLĖS;4333191842;Taip;0;3;7;10
9549;Raktelis;BORUŽĖLĖS;9529797517;Taip;4;0;0;4
9550;Raktelis;BORUŽĖLĖS;1618225282;Taip;0;0;4;4
9551;Raktelis;BORUŽĖLĖS;4442395100;Taip;12;4;0;16
9552;Raktelis;BORUŽĖLĖS;5150954686;Taip;22;0;0;22
9553;Raktelis;BORUŽĖLĖS;3490428062;Taip;8;4;0;12
9554;Raktelis;BORUŽĖLĖS;5404673733;Taip;5;0;1;6
9555;Raktelis;BORUŽĖLĖS;1314972335;Taip;4;11;0;15
9556;Raktelis;BORUŽĖLĖS;3343352568;Taip;12;3;1;16
9557;Raktelis;BORUŽĖLĖS;2698820718;Taip;13;3;0;16
9558;Raktelis;BORUŽĖLĖS;7990626447;Taip;0;5;0;5
9559;Raktelis;BORUŽĖLĖS;7459272209;Taip;9;0;0;9
9560;Raktelis;BORUŽĖLĖS;5046450478;Taip;9;3;0;12
9561;Raktelis;BORUŽĖLĖS;1141447274;Ne;15;0;0;15
9562;Raktelis;BORUŽĖLĖS;3456093273;Ne;18;4;0;22
9563;Raktelis;BORUŽĖLĖS;5576511314;Taip;10;0;3;13
9564;Raktelis;KAČIUKAI;5270430511;Taip;11;2;2;15
9565;Raktelis;KAČIUKAI;4622683599;Taip;4;5;0;9
9566;Raktelis;KAČIUKAI;8600632097;Taip;14;2;0;16
9567;Raktelis;KAČIUKAI;7630501672;Taip;19;1;0;20
9568;Raktelis;KAČIUKAI;6007823584;Taip;15;2;0;17
9569;Raktelis;KAČIUKAI;3733786043;Taip;12;3;0;15
9570;Raktelis;KAČIUKAI;8456082594;Taip;0;1;0;1
9571;Raktelis;KAČIUKAI;4676213966;Taip;8;0;0;8
9572;Raktelis;KAČIUKAI;4631375439;Taip;13;4;0;17
9573;Raktelis;KAČIUKAI;6265489540;Taip;9;0;0;9
9574;Raktelis;KAČIUKAI;4160091258;Ne;25;0;0;25
9575;Raktelis;KAČIUKAI;3775306030;Taip;4;5;0;9
9576;Raktelis;KAČIUKAI;6550851582;Taip;0;2;0;2
9577;Raktelis;KAČIUKAI;4009105487;Taip;10;0;1;11
9578;Raktelis;KAČIUKAI;1843086151;Ne;12;4;0;16
9579;Raktelis;KAČIUKAI;2295251060;Taip;1;1;0;2
9580;Raktelis;KAČIUKAI;1983808547;Taip;1;0;0;1
9581;Raktelis;KAČIUKAI;7260767942;Taip;17;2;0;19
9582;Raktelis;KAČIUKAI;6323223256;Taip;21;3;0;24
9583;Raktelis;KAČIUKAI;1123693990;Taip;10;3;0;13
9584;Raktelis;KAČIUKAI;4979657165;Taip;14;0;0;14
9585;Raktelis;KAČIUKAI;2700148968;Taip;4;0;2;6
9586;Raktelis;KIŠKUČIAI;9390692206;Taip;20;0;0;20
9587;Raktelis;KIŠKUČIAI;7847787737;Taip;6;2;0;8
9588;Raktelis;KIŠKUČIAI;7046291082;Taip;16;2;0;18
9589;Raktelis;KIŠKUČIAI;2278227649;Taip;16;3;0;19
9590;Raktelis;KIŠKUČIAI;8992797384;Taip;10;2;4;16
9591;Raktelis;KIŠKUČIAI;9803505110;Taip;18;2;0;20
9592;Raktelis;KIŠKUČIAI;6473692639;Taip;14;1;0;15
9593;Raktelis;KIŠKUČIAI;1668164327;Taip;14;1;0;15
9594;Raktelis;KIŠKUČIAI;6587878165;Taip;15;4;0;19
9595;Raktelis;KIŠKUČIAI;9169797346;Taip;23;2;2;27
9596;Raktelis;KIŠKUČIAI;2262854947;Taip;5;14;3;22
9597;Raktelis;KIŠKUČIAI;3493159224;Taip;15;0;0;15
9598;Raktelis;KIŠKUČIAI;1810732707;Taip;23;1;0;24
9599;Raktelis;KIŠKUČIAI;5293558630;Taip;16;0;6;22
9600;Raktelis;KIŠKUČIAI;7605822626;Taip;15;2;0;17
9601;Raktelis;NYKŠTUKAI;7865593006;Ne;5;0;0;5
9602;Raktelis;NYKŠTUKAI;4252867688;Taip;10;0;6;16
9603;Raktelis;NYKŠTUKAI;7058612493;Taip;7;0;0;7
9604;Raktelis;NYKŠTUKAI;8817859592;Taip;7;0;2;9
9605;Raktelis;NYKŠTUKAI;4578445282;Taip;20;5;0;25
9606;Raktelis;NYKŠTUKAI;3890474241;Taip;7;0;0;7
9607;Raktelis;NYKŠTUKAI;9164539135;Taip;8;5;0;13
9608;Raktelis;NYKŠTUKAI;4147382341;Taip;18;0;0;18
9609;Raktelis;NYKŠTUKAI;3968555691;Taip;3;13;0;16
9610;Raktelis;NYKŠTUKAI;2234892629;Taip;7;0;0;7
9611;Raktelis;NYKŠTUKAI;8507551381;Taip;13;0;0;13
9612;Raktelis;NYKŠTUKAI;4764915486;Taip;10;0;0;10
9613;Raktelis;NYKŠTUKAI;9114203596;Ne;8;5;0;13
9614;Raktelis;NYKŠTUKAI;2803146830;Taip;28;0;0;28
9615;Raktelis;NYKŠTUKAI;1002851704;Taip;23;0;0;23
9616;Raktelis;NYKŠTUKAI;7202523804;Taip;4;6;0;10
9617;Raktelis;NYKŠTUKAI;6718159439;Taip;9;7;0;16
9618;Raktelis;PELIUKAI;9599034285;Taip;9;1;0;10
9619;Raktelis;PELIUKAI;1604357851;Taip;25;2;0;27
9620;Raktelis;PELIUKAI;6393143566;Ne;17;0;0;17
9621;Raktelis;PELIUKAI;4014822452;Taip;5;8;0;13
9622;Raktelis;PELIUKAI;5758873229;Taip;10;2;0;12
9623;Raktelis;PELIUKAI;2141128125;Taip;19;0;0;19
9624;Raktelis;PELIUKAI;4502236264;Ne;9;4;0;13
9625;Raktelis;PELIUKAI;4834301832;Taip;6;0;0;6
9626;Raktelis;PELIUKAI;2754009962;Taip;5;0;0;5
9627;Raktelis;PELIUKAI;3311870918;Taip;10;1;0;11
9628;Raktelis;PELIUKAI;6826993779;Taip;10;1;0;11
9629;Raktelis;PELIUKAI;8698736569;Taip;10;8;0;18
9630;Raktelis;PELIUKAI;2044812301;Taip;17;2;0;19
9631;Raktelis;PELIUKAI;2301442262;Taip;7;0;3;10
9632;Raktelis;PELIUKAI;6853881405;Taip;3;4;4;11
9633;Raktelis;PELIUKAI;9983004779;Ne;21;1;0;22
9634;Raktelis;PELIUKAI;7389910330;Taip;15;0;0;15
9635;Raktelis;AGUONOS;6102196040;Taip;16;2;0;18
9636;Raktelis;AGUONOS;1622504968;Taip;9;0;0;9
9637;Raktelis;AGUONOS;6199212999;Taip;0;7;0;7
9638;Raktelis;AGUONOS;7334310944;Taip;3;3;0;6
9639;Raktelis;AGUONOS;6281687751;Ne;0;3;0;3
9640;Raktelis;AGUONOS;1975411457;Taip;22;0;0;22
9641;Raktelis;AGUONOS;6367875352;Ne;0;0;9;9
9642;Raktelis;AGUONOS;7170546710;Taip;11;8;0;19
9643;Raktelis;AGUONOS;4905982507;Taip;4;3;0;7
9644;Raktelis;AGUONOS;9779789133;Taip;16;2;0;18
9645;Raktelis;AGUONOS;9593639791;Taip;5;2;0;7
9646;Raktelis;AGUONOS;1392036584;Taip;0;11;0;11
9647;Raktelis;AGUONOS;6608224825;Taip;25;1;0;26
9648;Raktelis;AGUONOS;4658530212;Taip;14;3;0;17
9649;Raktelis;AGUONOS;4335378625;Ne;20;0;0;20
9650;Raktelis;AGUONOS;8873203690;Ne;18;3;1;22
9651;Raktelis;AGUONOS;9357757604;Ne;0;9;0;9
9652;Raktelis;AGUONOS;8459980712;Ne;5;6;0;11
9653;Raktelis;AGUONOS;7973137015;Taip;20;0;0;20
9654;Raktelis;AGUONOS;9591285702;Taip;11;3;0;14
9655;Raktelis;AGUONOS;8767785444;Taip;0;5;0;5
9656;Raktelis;AGUONOS;9355380341;Taip;10;0;0;10
9657;Raktelis;AGUONOS;3687735991;Taip;1;0;0;1
9658;Raktelis;AGUONOS;2289954824;Taip;0;0;1;1
9659;Raktelis;LAPIUKŲ;6894769625;Taip;9;3;0;12
9660;Raktelis;LAPIUKŲ;9048412613;Taip;3;0;0;3
9661;Raktelis;LAPIUKŲ;7142823740;Taip;0;11;0;11
9662;Raktelis;LAPIUKŲ;3395720463;Taip;11;5;0;16
9663;Raktelis;LAPIUKŲ;4167194960;Taip;7;8;0;15
9664;Raktelis;LAPIUKŲ;2809458453;Taip;19;5;0;24
9665;Raktelis;LAPIUKŲ;5487606214;Taip;0;3;0;3
9666;Raktelis;LAPIUKŲ;2967941870;Taip;3;0;0;3
9667;Raktelis;LAPIUKŲ;6892006495;Taip;8;12;0;20
9668;Raktelis;LAPIUKŲ;3884068578;Taip;7;2;0;9
9669;Raktelis;LAPIUKŲ;4755892641;Taip;6;10;0;16
9670;Raktelis;LAPIUKŲ;7440866459;Taip;3;5;0;8
9671;Raktelis;LAPIUKŲ;3517484891;Taip;17;4;0;21
9672;Raktelis;LAPIUKŲ;5688795147;Taip;6;2;0;8
9673;Raktelis;LAPIUKŲ;8035618134;Ne;0;8;1;9
9674;Raktelis;LAPIUKŲ;6822021176;Taip;20;0;0;20
9675;Raktelis;LAPIUKŲ;8146076115;Taip;7;1;0;8
9676;Raktelis;LAPIUKŲ;2731096860;Taip;0;10;0;10
9677;Raktelis;LAPIUKŲ;4353473162;Ne;14;0;0;14
9678;Raktelis;LAPIUKŲ;8700012974;Taip;6;0;0;6
9679;Raktelis;LAPIUKŲ;1263150004;Taip;7;2;0;9
9680;Raktelis;LAPIUKŲ;1445359221;Taip;4;0;0;4
9681;Raktelis;LAPIUKŲ;9497620710;Taip;6;0;0;6
9682;Raktelis;PELĖDŽIUKAI;5275588088;Taip;0;3;0;3
9683;Raktelis;PELĖDŽIUKAI;3602722744;Taip;4;0;0;4
9684;Raktelis;PELĖDŽIUKAI;54341630847;Taip;19;0;0;19
9685;Raktelis;PELĖDŽIUKAI;4583377785;Taip;0;11;0;11
9686;Raktelis;PELĖDŽIUKAI;8320696048;Taip;4;2;0;6
9687;Raktelis;PELĖDŽIUKAI;67304194087;Taip;1;4;0;5
9688;Raktelis;PELĖDŽIUKAI;2753402906;Taip;10;1;0;11
9689;Raktelis;PELĖDŽIUKAI;5768653399;Taip;0;3;1;4
9690;Raktelis;PELĖDŽIUKAI;7962509432;Taip;6;3;0;9
9691;Raktelis;PELĖDŽIUKAI;67972824332;Taip;5;0;0;5
9692;Raktelis;PELĖDŽIUKAI;9053427316;Taip;0;1;2;3
9693;Raktelis;PELĖDŽIUKAI;3423529085;Taip;0;2;0;2
9694;Raktelis;PELĖDŽIUKAI;9716191639;Taip;15;4;1;20
9695;Raktelis;PELĖDŽIUKAI;8869030487;Taip;8;0;0;8
9696;Raktelis;PELĖDŽIUKAI;1322912585;Taip;28;0;0;28
9697;Raktelis;PELĖDŽIUKAI;6877934219;Taip;20;0;0;20
9698;Raktelis;PELĖDŽIUKAI;9130613710;Ne;0;7;0;7
9699;Raktelis;PELĖDŽIUKAI;9151796053;Taip;8;0;0;8
9700;Raktelis;PELĖDŽIUKAI;2282754345;Ne;0;4;0;4
9701;Raktelis;PELĖDŽIUKAI;8207675881;Taip;0;11;0;11
9702;Raktelis;PELĖDŽIUKAI;5925441742;Taip;4;2;0;6
9703;Raktelis;PELĖDŽIUKAI;5082785025;Taip;0;0;4;4
9704;Raktelis;MEŠKIUKAI;6703168910;Taip;12;1;0;13
9705;Raktelis;MEŠKIUKAI;8851021346;Taip;10;0;0;10
9706;Raktelis;MEŠKIUKAI;4185763817;Taip;19;1;0;20
9707;Raktelis;MEŠKIUKAI;6685891017;Taip;5;3;0;8
9708;Raktelis;MEŠKIUKAI;3484991718;Taip;6;0;0;6
9709;Raktelis;MEŠKIUKAI;6855863189;Taip;15;3;0;18
9710;Raktelis;MEŠKIUKAI;1026592738;Taip;9;1;0;10
9711;Raktelis;MEŠKIUKAI;7900644404;Taip;22;0;0;22
9712;Raktelis;MEŠKIUKAI;5718804414;Taip;12;0;1;13
9713;Raktelis;MEŠKIUKAI;9718355271;Taip;16;0;0;16
9714;Raktelis;MEŠKIUKAI;2171952119;Taip;16;0;0;16
9715;Raktelis;MEŠKIUKAI;6358227532;Taip;12;4;0;16
9716;Raktelis;MEŠKIUKAI;8341026400;Taip;9;1;0;10
9717;Raktelis;MEŠKIUKAI;8608093349;Ne;12;4;0;16
9718;Rasa;Nykštukai;5176175108;Taip;7;3;0;10
9719;Rasa;Nykštukai;3979273111;Taip;0;8;0;8
9720;Rasa;Nykštukai;4847544355;Taip;0;4;0;4
9721;Rasa;Nykštukai;9723040721;Taip;4;5;0;9
9722;Rasa;Nykštukai;7004232909;Taip;7;5;0;12
9723;Rasa;Nykštukai;1223962374;Taip;0;0;14;14
9724;Rasa;Nykštukai;3200377629;Taip;12;3;0;15
9725;Rasa;Nykštukai;1336291828;Taip;0;15;0;15
9726;Rasa;Nykštukai;5861229664;Taip;0;3;0;3
9727;Rasa;Nykštukai;1386880644;Taip;5;3;1;9
9728;Rasa;Nykštukai;7228037580;Taip;3;3;0;6
9729;Rasa;Nykštukai;2093263887;Taip;0;0;5;5
9730;Rasa;Nykštukai;2540124793;Taip;14;1;0;15
9731;Rasa;Nykštukai;5363748728;Taip;5;1;0;6
9732;Rasa;Nykštukai;2977737634;Taip;0;3;0;3
9733;Rasa;Nykštukai;8310400946;Taip;12;3;0;15
9734;Rasa;Nykštukai;7520665472;Taip;0;18;0;18
9735;Rasa;Nykštukai;7534306402;Taip;22;3;0;25
9736;Rasa;Nykštukai;7326816081;Ne;0;11;7;18
9737;Rasa;Nykštukai;5864894208;Ne;0;10;8;18
9738;Rasa;Nykštukai;3755794133;Taip;9;1;0;10
9739;Rasa;Meškiukai;8378755600;Taip;4;5;0;9
9740;Rasa;Meškiukai;3073804713;Taip;0;0;4;4
9741;Rasa;Meškiukai;8740659600;Taip;0;22;0;22
9742;Rasa;Meškiukai;6874601830;Taip;13;9;0;22
9743;Rasa;Meškiukai;4127921417;Taip;0;7;1;8
9744;Rasa;Meškiukai;7357915584;Taip;0;10;0;10
9745;Rasa;Meškiukai;8314522373;Taip;0;13;0;13
9746;Rasa;Meškiukai;3548008659;Taip;0;22;0;22
9747;Rasa;Meškiukai;3773600344;Taip;13;0;3;16
9748;Rasa;Meškiukai;2371282781;Taip;13;0;3;16
9749;Rasa;Meškiukai;2555108465;Taip;0;3;2;5
9750;Rasa;Meškiukai;1992726664;Taip;0;2;0;2
9751;Rasa;Meškiukai;7843789214;Taip;3;0;0;3
9752;Rasa;Meškiukai;5165588335;Taip;3;1;0;4
9753;Rasa;Meškiukai;7637404588;Taip;4;0;0;4
9754;Rasa;Meškiukai;7502435359;Taip;9;0;0;9
9755;Rasa;Meškiukai;6853285570;Ne;8;1;0;9
9756;Rasa;Meškiukai;8674133653;Taip;0;22;0;22
9757;Rasa;Sauliukai;72772661373;Taip;0;1;0;1
9758;Rasa;Sauliukai;6879558965;Taip;6;3;0;9
9759;Rasa;Sauliukai;6356448094;Taip;22;0;0;22
9760;Rasa;Sauliukai;2683897055;Taip;9;4;0;13
9761;Rasa;Sauliukai;2982016133;Ne;7;5;0;12
9762;Rasa;Sauliukai;7534548604;Taip;7;0;0;7
9763;Rasa;Sauliukai;3567565920;Taip;10;1;0;11
9764;Rasa;Sauliukai;7565880116;Taip;12;1;0;13
9765;Rasa;Sauliukai;4790859112;Taip;11;3;0;14
9766;Rasa;Sauliukai;2110008545;Taip;10;0;0;10
9767;Rasa;Sauliukai;5932187584;Taip;8;1;0;9
9768;Rasa;Sauliukai;4837280374;Ne;18;0;0;18
9769;Rasa;Sauliukai;4260142706;Taip;0;2;0;2
9770;Rasa;Sauliukai;5145978804;Taip;6;16;0;22
9771;Rasa;Sauliukai;8818450386;Taip;8;1;0;9
9772;Rasa;Sauliukai;6734478649;Taip;5;4;0;9
9773;Rasa;Sauliukai;5606722133;Taip;0;2;0;2
9774;Rasa;Sauliukai;63673920646;Taip;8;3;0;11
9775;Rasa;Sauliukai;8953448462;Taip;7;1;0;8
9776;Rasa;Smalsučiai;5599182715;Taip;7;6;0;13
9777;Rasa;Smalsučiai;9648034081;Ne;3;2;0;5
9778;Rasa;Smalsučiai;2626361958;Taip;11;2;0;13
9779;Rasa;Smalsučiai;7065597550;Taip;0;3;1;4
9780;Rasa;Smalsučiai;2132535297;Taip;0;3;3;6
9781;Rasa;Smalsučiai;8866896989;Ne;0;17;0;17
9782;Rasa;Smalsučiai;9938280570;Taip;4;2;0;6
9783;Rasa;Smalsučiai;1690518970;Ne;0;4;4;8
9784;Rasa;Smalsučiai;3023088027;Ne;0;1;0;1
9785;Rasa;Smalsučiai;4758605343;Taip;0;7;0;7
9786;Rasa;Smalsučiai;3091012313;Taip;5;7;11;23
9787;Rasa;Smalsučiai;7558966891;Ne;27;0;0;27
9788;Rasa;Smalsučiai;6345614521;Taip;6;0;0;6
9789;Rasa;Smalsučiai;1651905746;Taip;5;3;0;8
9790;Rasa;Smalsučiai;1823276800;Taip;0;4;1;5
9791;Rasa;Smalsučiai;6773004268;Taip;13;8;3;24
9792;Rasa;Smalsučiai;1457384318;Taip;15;2;0;17
9793;Rasa;Smalsučiai;5325275053;Ne;9;6;2;17
9794;Rasa;Smalsučiai;2121070882;Taip;0;12;0;12
9795;Rasa;Smalsučiai;6704162447;Taip;0;7;3;10
9796;Rasa;Smalsučiai;4603188598;Taip;0;1;3;4
9797;Rasa;"Pelėdžiukai ";3387615841;Taip;8;3;0;11
9798;Rasa;"Pelėdžiukai ";8816116600;Taip;1;3;4;8
9799;Rasa;"Pelėdžiukai ";8455168346;Taip;6;0;0;6
9800;Rasa;"Pelėdžiukai ";9056416308;Taip;7;2;0;9
9801;Rasa;"Pelėdžiukai ";5141906920;Taip;12;0;0;12
9802;Rasa;"Pelėdžiukai ";3381468321;Taip;25;2;0;27
9803;Rasa;"Pelėdžiukai ";1261868339;Taip;12;1;1;14
9804;Rasa;"Pelėdžiukai ";6553479199;Taip;11;1;0;12
9805;Rasa;"Pelėdžiukai ";4947382314;Taip;13;1;4;18
9806;Rasa;"Pelėdžiukai ";2968464121;Taip;9;2;1;12
9807;Rasa;"Pelėdžiukai ";5816940902;Ne;11;0;0;11
9808;Rasa;"Pelėdžiukai ";4389917247;Taip;0;22;0;22
9809;Rasa;"Pelėdžiukai ";2123838514;Taip;18;1;1;20
9810;Rasa;"Pelėdžiukai ";1288177637;Taip;0;22;0;22
9811;Rasa;"Pelėdžiukai ";8403268732;Taip;10;1;0;11
9812;Rasa;"Pelėdžiukai ";4855210006;Taip;0;1;2;3
9813;Rasa;Katinėliai;5885520521;Taip;4;0;0;4
9814;Rasa;Katinėliai;5426981046;Taip;0;1;3;4
9815;Rasa;Katinėliai;3657956842;Ne;3;11;0;14
9816;Rasa;Katinėliai;6891623055;Ne;5;1;5;11
9817;Rasa;Katinėliai;9010812748;Taip;0;3;0;3
9818;Rasa;Katinėliai;7220007488;Taip;10;4;2;16
9819;Rasa;Katinėliai;8235869241;Taip;3;1;2;6
9820;Rasa;Katinėliai;4913483444;Taip;3;0;0;3
9821;Rasa;Katinėliai;4734775151;Ne;0;0;6;6
9822;Rasa;Katinėliai;9447346901;Ne;1;12;0;13
9823;Rasa;Katinėliai;3631124501;Taip;21;0;0;21
9824;Rasa;Katinėliai;9343039995;Ne;0;4;0;4
9825;Rasa;Katinėliai;4498966097;Taip;4;6;0;10
9826;Rasa;Katinėliai;3428261829;Taip;0;5;0;5
9827;Rasa;Katinėliai;2477057223;Taip;0;10;0;10
9828;Rasa;Katinėliai;9220749889;Taip;0;1;0;1
9829;Rasa;Ančiukai;6755131948;Taip;14;0;0;14
9830;Rasa;Ančiukai;1477018184;Taip;9;1;5;15
9831;Rasa;Ančiukai;4018241056;Taip;14;0;0;14
9832;Rasa;Ančiukai;1736903037;Taip;0;7;1;8
9833;Rasa;Ančiukai;4762348187;Taip;0;5;0;5
9834;Rasa;Ančiukai;7568880413;Taip;10;0;3;13
9835;Rasa;Ančiukai;8622210603;Taip;5;1;2;8
9836;Rasa;Ančiukai;1521328997;Taip;0;1;1;2
9837;Rasa;Ančiukai;9230334839;Ne;0;0;2;2
9838;Rasa;Ančiukai;8574946856;Taip;12;0;0;12
9839;Rasa;Ančiukai;6442933249;Taip;21;2;0;23
9840;Rasa;Ančiukai;4979105526;Ne;0;1;3;4
9841;Rasa;"Vyturiukai ";7028605422;Taip;5;1;3;9
9842;Rasa;"Vyturiukai ";9599510902;Taip;0;1;0;1
9843;Rasa;"Vyturiukai ";2800420481;Taip;15;0;0;15
9844;Rasa;"Vyturiukai ";5869253167;Taip;4;0;5;9
9845;Rasa;"Vyturiukai ";7037958994;Taip;0;1;0;1
9846;Rasa;"Vyturiukai ";8236785255;Taip;13;3;0;16
9847;Rasa;"Vyturiukai ";6887471189;Ne;0;1;4;5
9848;Rasa;"Vyturiukai ";4694111253;Taip;0;1;2;3
9849;Rasa;"Vyturiukai ";2347639286;Ne;0;1;5;6
9850;Rasa;"Vyturiukai ";1206005039;Taip;10;1;0;11
9851;Rasa;"Vyturiukai ";9788282861;Taip;5;2;1;8
9852;Rasa;"Vyturiukai ";2711923397;Ne;5;1;0;6
9853;Rasa;"Vyturiukai ";2769096357;Taip;22;0;0;22
9854;Rasa;"Vyturiukai ";6883073764;Taip;0;1;8;9
9855;Rasa;"Vyturiukai ";9706428782;Ne;7;4;2;13
9856;Rasa;"Vyturiukai ";7043271718;Ne;6;0;7;13
9857;Rasa;"Vyturiukai ";6575864256;Taip;12;0;2;14
9858;Rasa;Voveriukai;4111850024;Taip;21;1;0;22
9859;Rasa;Voveriukai;2190948879;Taip;0;17;0;17
9860;Rasa;Voveriukai;1978999728;Ne;10;0;1;11
9861;Rasa;Voveriukai;3546684695;Taip;6;3;0;9
9862;Rasa;Voveriukai;4010262461;Taip;8;0;1;9
9863;Rasa;Voveriukai;5740754301;Taip;6;0;0;6
9864;Rasa;Voveriukai;5977524939;Taip;13;0;1;14
9865;Rasa;Voveriukai;1592174114;Taip;23;0;0;23
9866;Rasa;Voveriukai;1564194649;Taip;0;0;3;3
9867;Rasa;Voveriukai;1764959761;Taip;0;0;1;1
9868;Rasa;Voveriukai;1765617605;Taip;18;0;0;18
9869;Rasa;Voveriukai;1733179752;Taip;4;6;0;10
9870;Rasa;Voveriukai;2895124729;Ne;13;3;0;16
9871;Rasa;Voveriukai;8469342353;Taip;15;0;0;15
9872;Rasa;Voveriukai;1679709767;Taip;4;3;0;7
9873;Rasa;Voveriukai;5622110823;Ne;0;4;0;4
9874;Rasa;Voveriukai;6221754830;Taip;10;4;0;14
9875;Rasa;Voveriukai;7218250981;Taip;0;15;7;22
9876;Rasa;"DRUGELIAI ";6621628020;Taip;19;0;0;19
9877;Rasa;"DRUGELIAI ";9959160342;Taip;19;0;0;19
9878;Rasa;"DRUGELIAI ";5761013588;Taip;0;22;0;22
9879;Rasa;"DRUGELIAI ";7220103314;Taip;17;0;0;17
9880;Rasa;"DRUGELIAI ";5517138335;Taip;9;0;4;13
9881;Rasa;"DRUGELIAI ";9506388242;Taip;13;4;1;18
9882;Rasa;"DRUGELIAI ";4188303400;Taip;12;0;0;12
9883;Rasa;"DRUGELIAI ";5483943978;Taip;9;1;2;12
9884;Rasa;"DRUGELIAI ";7251815682;Taip;14;0;0;14
9885;Rasa;"DRUGELIAI ";8702962863;Taip;4;0;1;5
9886;Rasa;"DRUGELIAI ";6291089659;Taip;0;0;5;5
9887;Rasa;"DRUGELIAI ";4183378344;Ne;7;0;4;11
9888;Rasa;"DRUGELIAI ";6314411900;Ne;7;0;5;12
9889;Rasa;Zuikučiai;7265752821;Taip;18;0;4;22
9890;Rasa;Zuikučiai;2804115700;Ne;22;0;0;22
9891;Rasa;Zuikučiai;8841534992;Taip;10;1;0;11
9892;Rasa;Zuikučiai;8027532547;Taip;15;7;4;26
9893;Rasa;Zuikučiai;3470054190;Taip;10;0;0;10
9894;Rasa;Zuikučiai;8180141204;Taip;0;10;0;10
9895;Rasa;Zuikučiai;7253736220;Taip;15;1;0;16
9896;Rasa;Zuikučiai;4940758709;Taip;9;4;0;13
9897;Rasa;Zuikučiai;7091899236;Taip;23;2;0;25
9898;Rasa;Zuikučiai;6574998939;Taip;5;6;0;11
9899;Rasa;Zuikučiai;7556723960;Taip;24;1;2;27
9900;Rasa;Zuikučiai;4212798846;Taip;11;3;0;14
9901;Rasa;Zuikučiai;7585566403;Taip;5;2;0;7
9902;Rasa;Zuikučiai;6505001743;Taip;13;9;0;22
9903;Rasa;Zuikučiai;6780996150;Taip;14;0;0;14
9904;Rasa;Zuikučiai;8159411349;Taip;15;1;1;17
9905;Rasa;Zuikučiai;8992548689;Taip;9;0;0;9
9906;Rasa;Širdelė;8424049317;Taip;3;2;1;6
9907;Rasa;Širdelė;8236464670;Taip;7;1;0;8
9908;Rasa;Širdelė;6976298054;Taip;0;4;0;4
9909;Rasa;Širdelė;3668598028;Taip;0;1;0;1
9910;Rasa;Širdelė;2333938367;Taip;5;0;0;5
9911;Rasa;Širdelė;5719253028;Taip;3;2;1;6
9912;Rasa;Širdelė;9140875020;Ne;13;1;0;14
9913;Rasa;Širdelė;5710220699;Taip;5;3;0;8
9914;Rasa;Širdelė;4694382836;Taip;5;1;0;6
9915;Rasa;Širdelė;1796573723;Taip;4;5;0;9
9916;Rasa;Širdelė;3535655117;Taip;7;2;0;9
9917;Rasa;Širdelė;2830296197;Taip;7;0;0;7
9918;Rasa;Širdelė;4361959446;Taip;6;2;6;14
9919;Rasa;Širdelė;3215464914;Taip;8;0;0;8
9920;Rasa;Širdelė;5523764310;Taip;7;0;6;13
9921;Rasa;Širdelė;6760723624;Taip;6;0;1;7
9922;Rasa;Širdelė;6606982242;Taip;0;1;2;3
9923;Rasa;Širdelė;1447258806;Taip;9;0;0;9
9924;Rasa;Širdelė;1627996663;Taip;5;9;0;14
9925;Rugelis;Kiškučiai;2548567224;Taip;9;0;0;9
9926;Rugelis;Kiškučiai;4873953024;Taip;9;0;0;9
9927;Rugelis;Kiškučiai;4730122115;Taip;10;0;0;10
9928;Rugelis;Kiškučiai;4861369279;Taip;15;0;0;15
9929;Rugelis;Kiškučiai;9245749946;Taip;12;0;0;12
9930;Rugelis;Kiškučiai;4927838136;Taip;15;0;0;15
9931;Rugelis;Kiškučiai;7406503311;Taip;4;0;0;4
9932;Rugelis;Nykštukai;4070891287;Taip;7;0;0;7
9933;Rugelis;Saulutės;6287778607;Taip;14;0;0;14
9934;Rugelis;Saulutės;9106734166;Ne;5;0;0;5
9935;Rugelis;Saulutės;8425090839;Taip;2;0;0;2
9936;Rugelis;Drugeliai;3688023203;Taip;17;0;0;17
9937;Rugelis;Drugeliai;1666217075;Taip;10;0;0;10
9938;Rugelis;Drugeliai;9237710137;Taip;10;0;0;10
9939;Rugelis;Drugeliai;7690463984;Ne;15;0;0;15
9940;Rugelis;Drugeliai;6240217969;Taip;19;0;0;19
9941;Rugelis;Drugeliai;4425775068;Taip;10;0;0;10
9942;Rugelis;Ežiukai;3919777248;Taip;6;0;0;6
9943;Rugelis;Bitutės;2120280305;Taip;10;0;0;10
9944;Rugelis;Bitutės;8529645041;Taip;8;0;0;8
9945;Rugelis;Bitutės;8560266148;Taip;8;0;0;8
9946;Rugelis;Bitutės;6305217730;Taip;10;0;0;10
9947;Rugelis;Bitutės;1062670266;Taip;15;0;0;15
9948;Rugelis;Bitutės;6172087627;Ne;4;0;0;4
9949;Rugelis;Bitutės;9003539316;Ne;5;0;0;5
9950;Rugelis;Bitutės;7385030387;Taip;10;0;0;10
9951;Rugelis;Bitutės;8411522319;Taip;18;0;0;18
9952;Rugelis;Žirniukai;9780302551;Taip;5;0;0;5
9953;Rugelis;Žirniukai;8183416965;Taip;13;0;0;13
9954;Rugelis;Žirniukai;4074302113;Taip;6;0;0;6
9955;Rugelis;Žirniukai;9046350820;Ne;10;0;0;10
9956;Rugelis;Žvirbliukai;8985532015;Taip;19;0;0;19
9957;Rugelis;Žvirbliukai;5387358344;Taip;15;0;0;15
9958;Rugelis;Žvirbliukai;4582173664;Taip;7;0;0;7
9959;Rugelis;Žvirbliukai;2459950313;Ne;7;0;0;7
9960;Rugelis;Žvirbliukai;4799504037;Taip;18;0;0;18
9961;Rugelis;Ramunėlės;5223662752;Taip;5;0;0;5
9962;Rugelis;Ramunėlės;2123347374;Taip;10;0;0;10
9963;Rugelis;Ramunėlės;4679095043;Taip;15;0;0;15
9964;Rugelis;Ramunėlės;8612141785;Taip;13;0;0;13
9965;Rugelis;Ramunėlės;5117109538;Taip;10;0;0;10
9966;Rugelis;Ramunėlės;6433636135;Ne;8;0;0;8
9967;Rugelis;Pipirai;1484215269;Taip;20;0;0;20
9968;Rugelis;Pipirai;3219628162;Taip;15;0;0;15
9969;Rugelis;Pipirai;6925066762;Taip;10;0;0;10
9970;Rugelis;Meškučiai;8451655848;Taip;6;0;0;6
9971;Rugelis;Meškučiai;4096255107;Taip;16;0;0;16
9972;Rugelis;Meškučiai;3821798373;Taip;5;0;0;5
9973;Rugelis;Boružėlės;2380283719;Taip;13;0;0;13
9974;Rugelis;Boružėlės;5964946032;Taip;12;0;0;12
9975;Rugelis;Boružėlės;1121258767;Taip;15;0;0;15
9976;Rugelis;Boružėlės;2498056977;Taip;5;0;0;5
9977;Rugelis;Boružėlės;9286992729;Taip;15;0;0;15
9978;Riešutėlis;Viščiukų;7666200219;Taip;0;22;0;22
9979;Riešutėlis;Viščiukų;7071757771;Taip;11;0;0;11
9980;Riešutėlis;Viščiukų;6626441225;Taip;17;0;0;17
9981;Riešutėlis;Viščiukų;5013456470;Ne;13;0;0;13
9982;Riešutėlis;Viščiukų;6906373822;Taip;28;0;0;28
9983;Riešutėlis;Viščiukų;4636191548;Taip;9;0;0;9
9984;Riešutėlis;Viščiukų;2734001106;Taip;3;0;4;7
9985;Riešutėlis;Viščiukų;2493171003;Taip;10;0;7;17
9986;Riešutėlis;Viščiukų;5133625078;Taip;5;5;1;11
9987;Riešutėlis;Viščiukų;2235912189;Taip;1;0;6;7
9988;Riešutėlis;Viščiukų;9864636983;Taip;11;0;0;11
9989;Riešutėlis;Viščiukų;4429903561;Taip;14;14;0;28
9990;Riešutėlis;Viščiukų;5317904812;Taip;4;0;2;6
9991;Riešutėlis;Viščiukų;8235524536;Taip;18;1;0;19
9992;Riešutėlis;Viščiukų;7795124495;Taip;5;22;0;27
9993;Riešutėlis;Viščiukų;2832538856;Taip;0;22;0;22
9994;Riešutėlis;Viščiukų;3730909181;Taip;14;0;0;14
9995;Riešutėlis;Viščiukų;4426750525;Taip;10;0;4;14
9996;Riešutėlis;Viščiukų;9341748384;Taip;10;2;1;13
9997;Riešutėlis;"Riešutėliai ";3800733442;Ne;17;1;0;18
9998;Riešutėlis;"Riešutėliai ";2117939721;Taip;0;0;3;3
9999;Riešutėlis;"Riešutėliai ";1343776985;Taip;3;0;0;3
10000;Riešutėlis;"Riešutėliai ";5915019363;Taip;10;10;0;20
10001;Riešutėlis;"Riešutėliai ";2207907790;Taip;8;0;0;8
10002;Riešutėlis;"Riešutėliai ";9699503472;Taip;15;0;4;19
10003;Riešutėlis;"Riešutėliai ";2098369052;Taip;22;0;0;22
10004;Riešutėlis;"Riešutėliai ";1426700414;Taip;6;0;6;12
10005;Riešutėlis;"Riešutėliai ";8539906445;Taip;7;1;0;8
10006;Riešutėlis;"Riešutėliai ";2301247729;Taip;14;2;0;16
10007;Riešutėlis;"Riešutėliai ";3602707130;Taip;6;2;0;8
10008;Riešutėlis;"Riešutėliai ";8991963843;Taip;7;0;0;7
10009;Riešutėlis;"Riešutėliai ";9318640304;Taip;12;0;1;13
10010;Riešutėlis;"Riešutėliai ";4293402095;Ne;14;0;4;18
10011;Riešutėlis;"Riešutėliai ";8917451081;Taip;7;2;0;9
10012;Riešutėlis;"Riešutėliai ";4698338374;Taip;19;2;0;21
10013;Riešutėlis;"Riešutėliai ";3345064565;Taip;11;0;0;11
10014;Riešutėlis;"Riešutėliai ";2560507294;Taip;4;1;1;6
10015;Riešutėlis;"Riešutėliai ";9078282526;Taip;11;0;0;11
10016;Riešutėlis;"Riešutėliai ";6762306583;Taip;6;4;0;10
10017;Riešutėlis;Ežiukai;7030346495;Taip;9;12;0;21
10018;Riešutėlis;Ežiukai;9750713954;Taip;8;0;0;8
10019;Riešutėlis;Ežiukai;7601776182;Taip;0;2;0;2
10020;Riešutėlis;Ežiukai;7381623086;Ne;4;1;2;7
10021;Riešutėlis;Ežiukai;9964688413;Taip;6;0;2;8
10022;Riešutėlis;Ežiukai;1548585448;Taip;3;1;1;5
10023;Riešutėlis;Ežiukai;8954127616;Ne;18;1;3;22
10024;Riešutėlis;Ežiukai;2092933906;Taip;10;11;0;21
10025;Riešutėlis;Ežiukai;6813024366;Taip;16;1;0;17
10026;Riešutėlis;Ežiukai;7913381005;Ne;0;5;0;5
10027;Riešutėlis;Ežiukai;3460145784;Taip;0;7;0;7
10028;Riešutėlis;Ežiukai;8480059272;Taip;18;2;0;20
10029;Riešutėlis;Ežiukai;5728858361;Taip;0;2;4;6
10030;Riešutėlis;Ežiukai;5327627748;Taip;0;7;0;7
10031;Riešutėlis;Ežiukai;6259158270;Taip;0;0;1;1
10032;Riešutėlis;Ežiukai;6194259707;Taip;8;3;0;11
10033;Riešutėlis;Ežiukai;2837471235;Taip;5;11;0;16
10034;Riešutėlis;Ežiukai;2699984170;Taip;10;4;0;14
10035;Riešutėlis;Ežiukai;7050440691;Taip;4;1;3;8
10036;Riešutėlis;Ežiukai;8066712255;Ne;3;0;1;4
10037;Riešutėlis;Ežiukai;3577669231;Taip;22;0;0;22
10038;Riešutėlis;Ežiukai;9670912357;Ne;15;0;0;15
10039;Riešutėlis;Ežiukai;1818130297;Taip;8;1;0;9
10040;Riešutėlis;Ežiukai;6284614328;Ne;8;1;0;9
10041;Riešutėlis;Pelėdžiukai;1705599429;Taip;26;1;2;29
10042;Riešutėlis;Pelėdžiukai;4116506453;Taip;15;0;0;15
10043;Riešutėlis;Pelėdžiukai;2467739101;Taip;14;0;0;14
10044;Riešutėlis;Pelėdžiukai;2587460110;Taip;27;0;0;27
10045;Riešutėlis;Pelėdžiukai;6147780439;Taip;15;1;0;16
10046;Riešutėlis;Pelėdžiukai;3287685792;Taip;5;0;9;14
10047;Riešutėlis;Pelėdžiukai;1811701628;Taip;12;0;0;12
10048;Riešutėlis;Pelėdžiukai;5183264581;Taip;6;2;1;9
10049;Riešutėlis;Pelėdžiukai;4866613045;Taip;10;3;0;13
10050;Riešutėlis;Pelėdžiukai;6121386391;Taip;29;0;0;29
10051;Riešutėlis;Pelėdžiukai;4448024452;Taip;8;0;0;8
10052;Riešutėlis;Pelėdžiukai;3251066115;Taip;7;3;0;10
10053;Riešutėlis;Pelėdžiukai;4808684145;Taip;6;1;0;7
10054;Riešutėlis;Pelėdžiukai;4897581681;Taip;22;0;0;22
10055;Riešutėlis;Pelėdžiukai;7256075146;Taip;12;5;0;17
10056;Riešutėlis;Pelėdžiukai;5443448616;Taip;18;3;0;21
10057;Riešutėlis;Pelėdžiukai;9598824163;Taip;12;0;0;12
10058;Riešutėlis;Pelėdžiukai;8839482370;Taip;17;0;0;17
10059;Riešutėlis;Pelėdžiukai;4692384639;Ne;6;0;2;8
10060;Riešutėlis;Meškiukai;5537309549;Taip;4;3;1;8
10061;Riešutėlis;Meškiukai;1091941952;Taip;4;2;0;6
10062;Riešutėlis;Meškiukai;8271632629;Taip;10;1;2;13
10063;Riešutėlis;Meškiukai;4898775561;Taip;0;5;1;6
10064;Riešutėlis;Meškiukai;2097580659;Taip;5;2;0;7
10065;Riešutėlis;Meškiukai;8313605541;Taip;0;1;1;2
10066;Riešutėlis;Meškiukai;7987368969;Taip;0;11;0;11
10067;Riešutėlis;Meškiukai;65873300738;Taip;0;3;0;3
10068;Riešutėlis;Meškiukai;26781529460;Taip;6;1;1;8
10069;Riešutėlis;Meškiukai;1936519033;Ne;6;3;1;10
10070;Riešutėlis;Meškiukai;4131218911;Taip;6;7;0;13
10071;Riešutėlis;Meškiukai;4276034784;Taip;0;3;0;3
10072;Riešutėlis;Meškiukai;5097410462;Taip;6;1;0;7
10073;Riešutėlis;Meškiukai;4344185375;Taip;0;2;0;2
10074;Riešutėlis;Meškiukai;6594928740;Ne;3;1;2;6
10075;Riešutėlis;Meškiukai;1623681835;Taip;0;1;0;1
10076;Riešutėlis;Meškiukai;2566084613;Taip;0;1;1;2
10077;Riešutėlis;Meškiukai;1640383686;Taip;17;1;0;18
10078;Riešutėlis;Meškiukai;8087180983;Taip;17;1;0;18
10079;Riešutėlis;Meškiukai;16561622902;Taip;3;3;1;7
10080;Riešutėlis;Meškiukai;2611705234;Ne;7;0;0;7
10081;Riešutėlis;Meškiukai;4404544549;Ne;11;4;1;16
10082;Riešutėlis;Meškiukai;1455509576;Taip;10;1;0;11
10083;Riešutėlis;Meškiukai;1709857621;Taip;6;2;1;9
10084;Riešutėlis;Kiškučiai;9297835044;Ne;13;0;0;13
10085;Riešutėlis;Kiškučiai;9086474785;Taip;6;1;0;7
10086;Riešutėlis;Kiškučiai;3363757821;Ne;25;1;0;26
10087;Riešutėlis;Kiškučiai;2581250615;Taip;4;0;2;6
10088;Riešutėlis;Kiškučiai;8445984114;Ne;15;2;2;19
10089;Riešutėlis;Kiškučiai;5266946070;Taip;3;0;1;4
10090;Riešutėlis;Kiškučiai;9357375649;Taip;9;6;0;15
10091;Riešutėlis;Kiškučiai;9548551553;Taip;12;0;0;12
10092;Riešutėlis;Kiškučiai;9500744921;Ne;16;0;0;16
10093;Riešutėlis;Kiškučiai;4851336076;Taip;1;10;0;11
10094;Riešutėlis;Kiškučiai;6705754238;Taip;0;11;6;17
10095;Riešutėlis;Kiškučiai;1111543507;Ne;5;1;0;6
10096;Riešutėlis;Kiškučiai;9964105252;Ne;7;1;0;8
10097;Riešutėlis;Kiškučiai;6693197006;Taip;19;0;0;19
10098;Riešutėlis;Kiškučiai;5846061115;Taip;4;4;0;8
10099;Riešutėlis;Kiškučiai;2618556733;Taip;22;0;0;22
10100;Riešutėlis;Kiškučiai;2674972275;Taip;22;0;0;22
10101;Riešutėlis;Kiškučiai;9995814717;Taip;11;0;0;11
10102;Riešutėlis;Kiškučiai;5738764214;Taip;0;0;2;2
10103;Riešutėlis;Voveriukų;5995176001;Taip;0;9;0;9
10104;Riešutėlis;Voveriukų;5598052531;Ne;10;1;0;11
10105;Riešutėlis;Voveriukų;8751571852;Taip;10;0;0;10
10106;Riešutėlis;Voveriukų;5282039544;Taip;4;1;0;5
10107;Riešutėlis;Voveriukų;6303767779;Taip;4;0;0;4
10108;Riešutėlis;Voveriukų;6405116059;Taip;1;0;2;3
10109;Riešutėlis;Voveriukų;2430518637;Taip;11;1;0;12
10110;Riešutėlis;Voveriukų;1457008581;Taip;12;1;0;13
10111;Riešutėlis;Voveriukų;1638021880;Ne;10;3;0;13
10112;Riešutėlis;Voveriukų;7225365172;Taip;9;1;0;10
10113;Riešutėlis;Voveriukų;8750531305;Taip;7;3;0;10
10114;Riešutėlis;Voveriukų;5479780116;Taip;9;6;0;15
10115;Riešutėlis;Voveriukų;9839084885;Taip;3;3;0;6
10116;Riešutėlis;Voveriukų;4451419273;Ne;22;0;0;22
10117;Riešutėlis;Voveriukų;8018914251;Taip;0;2;0;2
10118;Riešutėlis;Voveriukų;9040123535;Taip;0;3;0;3
10119;Riešutėlis;Voveriukų;6928558714;Taip;5;0;0;5
10120;Riešutėlis;Voveriukų;3970874098;Taip;0;1;0;1
10121;Riešutėlis;Voveriukų;8012201566;Taip;10;0;0;10
10122;Riešutėlis;Voveriukų;7198434243;Taip;0;1;0;1
10123;Riešutėlis;Voveriukų;4581184004;Taip;5;1;2;8
10124;Riešutėlis;Voveriukų;9023304543;Taip;0;3;0;3
10125;Riešutėlis;Saulutės;4004669930;Taip;0;2;8;10
10126;Riešutėlis;Saulutės;7177632315;Ne;0;2;4;6
10127;Riešutėlis;Saulutės;6721758785;Taip;0;11;3;14
10128;Riešutėlis;Saulutės;3694146893;Taip;4;1;0;5
10129;Riešutėlis;Saulutės;1748151109;Taip;5;0;0;5
10130;Riešutėlis;Saulutės;8504832383;Taip;9;0;0;9
10131;Riešutėlis;Saulutės;6292679662;Taip;0;2;2;4
10132;Riešutėlis;Saulutės;8738716660;Taip;0;3;5;8
10133;Riešutėlis;Saulutės;4828635362;Taip;16;1;0;17
10134;Riešutėlis;Saulutės;6635909614;Taip;3;3;0;6
10135;Riešutėlis;Saulutės;1196740726;Taip;6;3;1;10
10136;Riešutėlis;Saulutės;8415858895;Taip;4;1;1;6
10137;Riešutėlis;Saulutės;4498718519;Ne;0;15;0;15
10138;Riešutėlis;Saulutės;5753609922;Taip;13;2;0;15
10139;Riešutėlis;Saulutės;1860995033;Taip;0;10;12;22
10140;Riešutėlis;Saulutės;5013754772;Taip;5;0;0;5
10141;Riešutėlis;Saulutės;6468871352;Taip;4;0;1;5
10142;Riešutėlis;Saulutės;7154361660;Taip;9;6;0;15
10143;Riešutėlis;Saulutės;8677172126;Taip;0;0;4;4
10144;Riešutėlis;Saulutės;2395391926;Taip;0;6;4;10
10145;Riešutėlis;Saulutės;2572642260;Taip;0;2;3;5
10146;Riešutėlis;Saulutės;3544780386;Taip;9;0;0;9
10147;Riešutėlis;"Boruželės ";4118652467;Ne;0;22;0;22
10148;Riešutėlis;"Boruželės ";5662911204;Taip;0;22;0;22
10149;Riešutėlis;"Boruželės ";7663823906;Taip;19;2;0;21
10150;Riešutėlis;"Boruželės ";5336618381;Taip;4;1;0;5
10151;Riešutėlis;"Boruželės ";7327578507;Taip;10;2;0;12
10152;Riešutėlis;"Boruželės ";6368610810;Taip;13;2;0;15
10153;Riešutėlis;"Boruželės ";7313602281;Taip;5;0;0;5
10154;Riešutėlis;"Boruželės ";9815988800;Taip;7;1;0;8
10155;Riešutėlis;"Boruželės ";9296178632;Taip;0;6;0;6
10156;Riešutėlis;"Boruželės ";6681930005;Taip;14;0;0;14
10157;Riešutėlis;"Boruželės ";2352984379;Taip;13;5;0;18
10158;Riešutėlis;"Boruželės ";3152100512;Taip;3;0;1;4
10159;Riešutėlis;"Boruželės ";2238641969;Taip;5;9;0;14
10160;Riešutėlis;"Boruželės ";6217500325;Taip;0;22;0;22
10161;Riešutėlis;"Boruželės ";1058206787;Taip;3;0;3;6
10162;Riešutėlis;"Boruželės ";9198289423;Taip;12;0;0;12
10163;Riešutėlis;"Boruželės ";1282121190;Taip;6;2;0;8
10164;Riešutėlis;"Boruželės ";7259198785;Ne;5;0;1;6
10165;Riešutėlis;"Boruželės ";2875416610;Taip;13;4;0;17
10166;Riešutėlis;"Bitutės ";8498902448;Taip;0;2;1;3
10167;Riešutėlis;"Bitutės ";2498093110;Ne;10;5;0;15
10168;Riešutėlis;"Bitutės ";2459494071;Taip;8;0;0;8
10169;Riešutėlis;"Bitutės ";3931422170;Taip;8;0;2;10
10170;Riešutėlis;"Bitutės ";8265627960;Taip;7;0;0;7
10171;Riešutėlis;"Bitutės ";4591910912;Taip;9;0;0;9
10172;Riešutėlis;"Bitutės ";9285782325;Taip;10;4;1;15
10173;Riešutėlis;"Bitutės ";7473054556;Taip;3;2;4;9
10174;Riešutėlis;"Bitutės ";8996456595;Taip;4;3;3;10
10175;Riešutėlis;"Bitutės ";3475897400;Taip;5;0;0;5
10176;Riešutėlis;"Bitutės ";3592271009;Ne;16;1;1;18
10177;Riešutėlis;"Bitutės ";6815804556;Taip;4;6;0;10
10178;Riešutėlis;"Bitutės ";1626888090;Taip;1;2;3;6
10179;Riešutėlis;"Bitutės ";3348517050;Taip;5;0;0;5
10180;Riešutėlis;"Bitutės ";4358354602;Taip;3;7;0;10
10181;Riešutėlis;Drugelių;8266735624;Taip;0;1;0;1
10182;Riešutėlis;Drugelių;4776231497;Taip;0;1;0;1
10183;Riešutėlis;Drugelių;8578903763;Taip;6;2;0;8
10184;Riešutėlis;Drugelių;7769079730;Taip;0;2;1;3
10185;Riešutėlis;Drugelių;4221375847;Ne;0;4;3;7
10186;Riešutėlis;Drugelių;1942944625;Taip;4;3;0;7
10187;Riešutėlis;Drugelių;8845709386;Taip;0;13;0;13
10188;Riešutėlis;Drugelių;8128352818;Taip;6;0;0;6
10189;Riešutėlis;Drugelių;8352146446;Ne;18;0;0;18
10190;Riešutėlis;Drugelių;8180618419;Taip;0;1;0;1
10191;Riešutėlis;Drugelių;5412882446;Taip;13;0;1;14
10192;Riešutėlis;Drugelių;8020533200;Taip;0;7;0;7
10193;Riešutėlis;Drugelių;1164273595;Taip;3;6;0;9
10194;Riešutėlis;Drugelių;8918753084;Taip;0;6;1;7
10195;Riešutėlis;Drugelių;3836374000;Taip;0;4;0;4
10196;Riešutėlis;Drugelių;8016820352;Taip;4;1;0;5
10197;Riešutėlis;Drugelių;3975091711;Taip;8;6;0;14
10198;Riešutėlis;Drugelių;3071643137;Taip;2;0;0;2
10199;Riešutėlis;Drugelių;2599147931;Taip;10;1;0;11
10200;Riešutėlis;Drugelių;3151689985;Taip;8;0;0;8
10201;Riešutėlis;Drugelių;4845447863;Taip;11;0;0;11
10202;Riešutėlis;Nykštukų;1858791074;Taip;12;1;0;13
10203;Riešutėlis;Nykštukų;1006119133;Taip;0;4;0;4
10204;Riešutėlis;Nykštukų;3759837057;Taip;0;14;8;22
10205;Riešutėlis;Nykštukų;4740516426;Ne;15;0;1;16
10206;Riešutėlis;Nykštukų;3150141050;Taip;0;3;0;3
10207;Riešutėlis;Nykštukų;6580050526;Taip;8;0;0;8
10208;Riešutėlis;Nykštukų;4810919435;Taip;0;0;13;13
10209;Riešutėlis;Nykštukų;2736824231;Taip;3;0;0;3
10210;Riešutėlis;Nykštukų;2378301886;Taip;9;0;1;10
10211;Riešutėlis;Nykštukų;2483793992;Taip;3;0;0;3
10212;Riešutėlis;Nykštukų;5262881964;Taip;0;0;1;1
10213;Riešutėlis;Nykštukų;4328166135;Taip;7;1;2;10
10214;Riešutėlis;Nykštukų;9052991215;Taip;11;1;0;12
10215;Riešutėlis;Nykštukų;6582898708;Ne;3;0;0;3
10216;Riešutėlis;Nykštukų;6318150385;Taip;0;0;2;2
10217;Riešutėlis;Nykštukų;4042719626;Ne;10;0;0;10
10218;Riešutėlis;Nykštukų;5078051087;Taip;7;1;3;11
10219;Riešutėlis;Nykštukų;3249196007;Taip;10;0;3;13
10220;Rytas;Geniukų;6094775155;Taip;10;0;0;10
10221;Rytas;Geniukų;4435466932;Taip;14;0;0;14
10222;Rytas;Geniukų;2920533714;Taip;6;0;0;6
10223;Rytas;Geniukų;4715624133;Taip;9;0;0;9
10224;Rytas;Geniukų;4319176891;Taip;5;0;0;5
10225;Rytas;Svirpliukų;1667124077;Taip;5;0;0;5
10226;Rytas;Svirpliukų;1481377422;Taip;8;0;0;8
10227;Rytas;Svirpliukų;8036117292;Taip;9;0;0;9
10228;Rytas;Svirpliukų;1633549221;Taip;4;0;0;4
10229;Rytas;Svirpliukų;7088145969;Taip;10;0;0;10
10230;Rytas;Svirpliukų;5975704054;Taip;8;0;0;8
10231;Rytas;Svirpliukų;8633375369;Taip;13;0;0;13
10232;Rytas;Svirpliukų;8000993383;Taip;24;0;0;24
10233;Rytas;Svirpliukų;4720782276;Taip;15;0;0;15
10234;Rytas;Bitučių;8391277346;Ne;2;0;0;2
10235;Rytas;Bitučių;7925669598;Ne;9;0;0;9
10236;Rytas;Bitučių;3258169798;Taip;7;0;0;7
10237;Rytas;Bitučių;6916037552;Taip;22;0;0;22
10238;Rytas;Bitučių;6707662533;Taip;17;0;0;17
10239;Rytas;Boružėlių;9765188299;Taip;5;0;0;5
10240;Rytas;Boružėlių;6659424011;Taip;5;0;0;5
10241;Rytas;Boružėlių;7668747890;Ne;7;0;0;7
10242;Rytas;Boružėlių;9742476588;Ne;5;0;0;5
10243;Rytas;Drugelių;4149901322;Taip;2;0;0;2
10244;Rytas;Drugelių;5696751368;Taip;10;0;0;10
10245;Rytas;Drugelių;12832347269;Taip;4;0;0;4
10246;Rytas;Drugelių;6901439310;Taip;4;0;0;4
10247;Rytas;Drugelių;16308059025;Taip;6;0;0;6
10248;Rytas;Drugelių;4700273160;Taip;12;0;0;12
10249;Rytas;Drugelių;4971244488;Taip;13;0;0;13
10250;Rytas;Ežiukų;9579385117;Taip;8;0;0;8
10251;Rytas;Ežiukų;6718433511;Taip;9;0;0;9
10252;Rytas;Ežiukų;5237693162;Taip;13;0;0;13
10253;Rytas;Ežiukų;6120494681;Ne;10;0;0;10
10254;Rytas;Ežiukų;1746144722;Taip;13;0;0;13
10255;Rytas;Ežiukų;6498701256;Taip;17;0;0;17
10256;Rytas;Ežiukų;4317475484;Taip;12;0;0;12
10257;Rytas;Ežiukų;5650761566;Taip;8;0;0;8
10258;Rytas;Ežiukų;7319064033;Taip;8;0;0;8
10259;Rytas;Ežiukų;3477809583;Taip;8;0;0;8
10260;Rytas;Žirniukų;1404583064;Taip;12;0;0;12
10261;Rytas;Žirniukų;7491809175;Taip;18;0;0;18
10262;Rytas;Skruzdeliukų;9989457634;Taip;5;0;0;5
10263;Rytas;Skruzdeliukų;9877419148;Taip;5;0;0;5
10264;Rytas;Skruzdeliukų;1354041961;Taip;5;0;0;5
10265;Rytas;Skruzdeliukų;5646044889;Taip;15;0;0;15
10266;Rytas;Skruzdeliukų;3491483644;Ne;5;0;0;5
10267;Rytas;Pelėdžiukų;1184059976;Ne;9;0;0;9
10268;Rytas;Pelėdžiukų;1103411068;Ne;17;0;0;17
10269;Rytas;Pelėdžiukų;1102827295;Taip;15;0;0;15
10270;Rytas;Pelėdžiukų;4840168929;Taip;1;0;0;1
10271;Rytas;Pelėdžiukų;6545610327;Taip;10;0;0;10
10272;Rytas;Vyturėlių;3361675377;Taip;5;0;0;5
10273;Rytas;Vyturėlių;8085853877;Ne;5;0;0;5
10274;Rytas;Vyturėlių;5277075222;Taip;3;0;0;3
10275;Rytas;Vyturėlių;4860015531;Ne;3;0;0;3
10276;Rytas;Aitvarų;6051461683;Taip;8;0;0;8
10277;Rytas;Aitvarų;1632925219;Taip;15;0;0;15
10278;Rytas;Aitvarų;8986683830;Taip;10;0;0;10
10279;Rytas;Voveriukų;7250807043;Ne;15;0;0;15
10280;Rytas;Voveriukų;2956282831;Taip;9;0;0;9
10281;Rytas;Voveriukų;9619045618;Taip;10;0;0;10
10282;Rytas;Voveriukų;3618566807;Ne;4;0;0;4
10283;Rytas;Voveriukų;5410353706;Taip;28;0;0;28
10284;Rytas;NAUJA;9950569499;Taip;5;0;0;5
10285;Ramunėlė;SAULUTĖS;3852734401;Taip;4;2;0;6
10286;Ramunėlė;SAULUTĖS;1192743154;Taip;0;11;0;11
10287;Ramunėlė;SAULUTĖS;5714771643;Taip;3;2;0;5
10288;Ramunėlė;SAULUTĖS;1483391590;Taip;3;3;1;7
10289;Ramunėlė;SAULUTĖS;4209191105;Taip;3;2;0;5
10290;Ramunėlė;SAULUTĖS;9927068798;Taip;17;0;0;17
10291;Ramunėlė;SAULUTĖS;8929122197;Taip;0;3;0;3
10292;Ramunėlė;SAULUTĖS;7219400182;Taip;0;7;0;7
10293;Ramunėlė;SAULUTĖS;3779769727;Taip;0;12;0;12
10294;Ramunėlė;SAULUTĖS;5605444408;Taip;0;4;0;4
10295;Ramunėlė;SAULUTĖS;8912978935;Taip;6;3;0;9
10296;Ramunėlė;SAULUTĖS;1618282165;Taip;11;0;0;11
10297;Ramunėlė;SAULUTĖS;9533155706;Taip;19;0;0;19
10298;Ramunėlė;SAULUTĖS;6595858698;Taip;0;1;0;1
10299;Ramunėlė;SAULUTĖS;3109623760;Taip;13;0;2;15
10300;Ramunėlė;SAULUTĖS;2697757513;Taip;15;0;1;16
10301;Ramunėlė;ŽIBUTĖ;4715809064;Taip;5;0;0;5
10302;Ramunėlė;ŽIBUTĖ;5315953299;Taip;5;0;0;5
10303;Ramunėlė;ŽIBUTĖ;2173425836;Taip;0;1;0;1
10304;Ramunėlė;ŽIBUTĖ;2686455030;Taip;5;0;0;5
10305;Ramunėlė;ŽIBUTĖ;5650659504;Taip;5;8;0;13
10306;Ramunėlė;ŽIBUTĖ;6627399830;Taip;5;13;1;19
10307;Ramunėlė;ŽIBUTĖ;8726443989;Taip;0;3;0;3
10308;Ramunėlė;ŽIBUTĖ;5801760033;Taip;14;2;0;16
10309;Ramunėlė;ŽIBUTĖ;6389008823;Taip;6;8;0;14
10310;Ramunėlė;ŽIBUTĖ;9136437288;Taip;5;7;0;12
10311;Ramunėlė;ŽIBUTĖ;6040461460;Taip;5;5;0;10
10312;Ramunėlė;ŽIBUTĖ;7010828978;Taip;0;9;0;9
10313;Ramunėlė;ŽIBUTĖ;3879563193;Taip;4;11;0;15
10314;Ramunėlė;ŽIBUTĖ;2591052434;Taip;0;5;0;5
10315;Ramunėlė;ŽIBUTĖ;2446375037;Taip;15;4;0;19
10316;Ramunėlė;ŽIBUTĖ;1671759939;Taip;10;2;2;14
10317;Ramunėlė;ŽIBUTĖ;6606802660;Taip;0;3;0;3
10318;Ramunėlė;ŽIBUTĖ;5304803880;Taip;3;1;0;4
10319;Ramunėlė;ŽIBUTĖ;3525444906;Taip;0;15;0;15
10320;Ramunėlė;ŽIBUTĖ;8055844166;Taip;0;12;0;12
10321;Ramunėlė;ŽIRNIUKAI;8942483792;Taip;10;0;5;15
10322;Ramunėlė;ŽIRNIUKAI;9994445948;Taip;5;2;0;7
10323;Ramunėlė;ŽIRNIUKAI;6674467484;Taip;0;23;0;23
10324;Ramunėlė;ŽIRNIUKAI;7593855877;Taip;3;4;9;16
10325;Ramunėlė;ŽIRNIUKAI;2177200537;Taip;1;4;0;5
10326;Ramunėlė;ŽIRNIUKAI;7026935746;Taip;0;2;0;2
10327;Ramunėlė;ŽIRNIUKAI;5581693652;Ne;0;3;1;4
10328;Ramunėlė;ŽIRNIUKAI;4269170508;Taip;15;0;6;21
10329;Ramunėlė;ŽIRNIUKAI;7263195574;Taip;0;0;7;7
10330;Ramunėlė;ŽIRNIUKAI;4076525701;Taip;0;0;5;5
10331;Ramunėlė;ŽIRNIUKAI;4139935502;Taip;19;0;0;19
10332;Ramunėlė;ŽIRNIUKAI;1833069020;Taip;15;5;4;24
10333;Ramunėlė;ŽIRNIUKAI;4875011312;Taip;9;1;0;10
10334;Ramunėlė;ŽIRNIUKAI;4084046207;Taip;16;2;3;21
10335;Ramunėlė;ŽIRNIUKAI;2276657044;Taip;0;0;2;2
10336;Ramunėlė;ŽIRNIUKAI;5017020616;Taip;10;2;0;12
10337;Ramunėlė;ŽIRNIUKAI;6458458913;Taip;0;3;0;3
10338;Ramunėlė;ŽIRNIUKAI;6225605784;Taip;11;2;0;13
10339;Ramunėlė;ŽIRNIUKAI;4805808663;Ne;0;8;0;8
10340;Ramunėlė;BITUTĖS;8098492540;Ne;0;11;0;11
10341;Ramunėlė;BITUTĖS;6329943991;Taip;5;2;21;28
10342;Ramunėlė;BITUTĖS;7307307882;Taip;11;17;0;28
10343;Ramunėlė;BITUTĖS;2225787182;Taip;3;8;0;11
10344;Ramunėlė;BITUTĖS;6166192468;Taip;0;9;0;9
10345;Ramunėlė;BITUTĖS;5865482869;Taip;3;13;0;16
10346;Ramunėlė;BITUTĖS;8940763540;Ne;5;6;0;11
10347;Ramunėlė;BITUTĖS;6843262303;Taip;5;0;1;6
10348;Ramunėlė;BITUTĖS;7692958269;Taip;15;0;6;21
10349;Ramunėlė;BITUTĖS;8086994543;Taip;14;0;0;14
10350;Ramunėlė;BITUTĖS;5822045625;Taip;8;0;1;9
10351;Ramunėlė;BITUTĖS;9789690425;Taip;26;1;0;27
10352;Ramunėlė;BITUTĖS;1182350830;Taip;10;0;1;11
10353;Ramunėlė;BITUTĖS;6342801407;Taip;21;0;0;21
10354;Ramunėlė;BITUTĖS;4022818032;Taip;5;10;0;15
10355;Ramunėlė;BITUTĖS;7220407572;Taip;19;0;0;19
10356;Ramunėlė;BITUTĖS;1916520056;Taip;0;21;0;21
10357;Ramunėlė;BITUTĖS;2245564567;Taip;0;2;2;4
10358;Ramunėlė;BITUTĖS;6870110390;Taip;0;1;0;1
10359;Ramunėlė;BITUTĖS;6892481929;Taip;0;15;0;15
10360;Ramunėlė;BITUTĖS;2558296296;Taip;22;0;6;28
10361;Ramunėlė;BITUTĖS;6881228078;Taip;10;3;0;13
10362;Ramunėlė;DRUGELIAI;9584620339;Taip;10;1;2;13
10363;Ramunėlė;DRUGELIAI;6930505887;Taip;9;4;0;13
10364;Ramunėlė;DRUGELIAI;8402889872;Taip;10;5;1;16
10365;Ramunėlė;DRUGELIAI;7228065409;Taip;9;9;0;18
10366;Ramunėlė;DRUGELIAI;5170325023;Taip;5;1;4;10
10367;Ramunėlė;DRUGELIAI;3617897977;Taip;8;6;1;15
10368;Ramunėlė;DRUGELIAI;8768539595;Taip;0;13;0;13
10369;Ramunėlė;DRUGELIAI;7955507702;Taip;7;1;4;12
10370;Ramunėlė;DRUGELIAI;1078618047;Taip;3;21;0;24
10371;Ramunėlė;DRUGELIAI;9984243153;Taip;15;2;0;17
10372;Ramunėlė;DRUGELIAI;1199673371;Taip;6;3;2;11
10373;Ramunėlė;DRUGELIAI;4392309015;Taip;10;0;4;14
10374;Ramunėlė;DRUGELIAI;5049415445;Taip;15;0;13;28
10375;Ramunėlė;DRUGELIAI;8460527225;Taip;10;3;0;13
10376;Ramunėlė;DRUGELIAI;1800967823;Taip;4;1;1;6
10377;Ramunėlė;DRUGELIAI;8205893352;Ne;14;4;0;18
10378;Ramunėlė;DRUGELIAI;6809164145;Taip;13;0;0;13
10379;Ramunėlė;DRUGELIAI;6837877393;Ne;15;3;1;19
10380;Ramunėlė;NEUŽMIRŠTUOLĖS;1797997937;Taip;8;0;1;9
10381;Ramunėlė;NEUŽMIRŠTUOLĖS;9326288662;Taip;7;2;0;9
10382;Ramunėlė;NEUŽMIRŠTUOLĖS;9928703066;Taip;14;1;0;15
10383;Ramunėlė;NEUŽMIRŠTUOLĖS;4756689520;Ne;13;12;1;26
10384;Ramunėlė;NEUŽMIRŠTUOLĖS;2070729684;Taip;0;15;0;15
10385;Ramunėlė;NEUŽMIRŠTUOLĖS;4329292281;Ne;15;0;0;15
10386;Ramunėlė;NEUŽMIRŠTUOLĖS;6613469006;Taip;7;16;0;23
10387;Ramunėlė;NEUŽMIRŠTUOLĖS;3742982547;Taip;10;2;0;12
10388;Ramunėlė;NEUŽMIRŠTUOLĖS;3106987206;Taip;5;0;1;6
10389;Ramunėlė;NEUŽMIRŠTUOLĖS;2281370785;Taip;7;1;0;8
10390;Ramunėlė;NEUŽMIRŠTUOLĖS;8643188779;Taip;33;0;0;33
10391;Ramunėlė;NEUŽMIRŠTUOLĖS;9012749913;Taip;7;8;0;15
10392;Ramunėlė;NEUŽMIRŠTUOLĖS;1728034615;Taip;13;3;0;16
10393;Ramunėlė;NEUŽMIRŠTUOLĖS;1579527330;Taip;0;29;0;29
10394;Ramunėlė;NEUŽMIRŠTUOLĖS;7519551613;Taip;10;10;0;20
10395;Ramunėlė;NEUŽMIRŠTUOLĖS;2880352109;Taip;27;0;0;27
10396;Ramunėlė;NEUŽMIRŠTUOLĖS;3949246652;Taip;13;0;2;15
10397;Ramunėlė;NEUŽMIRŠTUOLĖS;3045477012;Taip;12;6;0;18
10398;Ramunėlė;NEUŽMIRŠTUOLĖS;5267145991;Ne;12;10;0;22
10399;Ramunėlė;NEUŽMIRŠTUOLĖS;1181787182;Ne;13;1;0;14
10400;Ramunėlė;NEUŽMIRŠTUOLĖS;7388319344;Taip;0;31;0;31
10401;Ramunėlė;OBUOLIUKAI;3683181174;Taip;11;1;0;12
10402;Ramunėlė;OBUOLIUKAI;7364976547;Ne;17;2;2;21
10403;Ramunėlė;OBUOLIUKAI;6156792400;Taip;0;18;0;18
10404;Ramunėlė;OBUOLIUKAI;4233978236;Taip;15;6;0;21
10405;Ramunėlė;OBUOLIUKAI;2983986428;Taip;0;26;0;26
10406;Ramunėlė;OBUOLIUKAI;5548358138;Taip;5;3;0;8
10407;Ramunėlė;OBUOLIUKAI;2427399083;Ne;0;5;5;10
10408;Ramunėlė;OBUOLIUKAI;2422656007;Taip;0;14;6;20
10409;Ramunėlė;OBUOLIUKAI;7829765488;Ne;16;0;0;16
10410;Ramunėlė;OBUOLIUKAI;8623311748;Taip;5;2;1;8
10411;Ramunėlė;OBUOLIUKAI;6849205606;Taip;5;1;1;7
10412;Ramunėlė;OBUOLIUKAI;6604244856;Taip;11;3;6;20
10413;Ramunėlė;OBUOLIUKAI;8617271247;Taip;21;4;0;25
10414;Ramunėlė;OBUOLIUKAI;6413888803;Taip;11;4;1;16
10415;Ramunėlė;OBUOLIUKAI;5610672420;Ne;19;2;3;24
10416;Ramunėlė;OBUOLIUKAI;4400154355;Taip;8;0;5;13
10417;Ramunėlė;OBUOLIUKAI;7250951221;Taip;1;4;5;10
10418;Ramunėlė;OBUOLIUKAI;3802924434;Taip;14;4;1;19
10419;Ramunėlė;OBUOLIUKAI;6981729247;Ne;15;3;3;21
10420;Ramunėlė;SAULĖGRĄŽA;7836959157;Taip;4;0;0;4
10421;Ramunėlė;SAULĖGRĄŽA;2458101652;Taip;0;0;15;15
10422;Ramunėlė;SAULĖGRĄŽA;9663304288;Taip;15;0;1;16
10423;Ramunėlė;SAULĖGRĄŽA;5398069413;Taip;17;0;0;17
10424;Ramunėlė;SAULĖGRĄŽA;7873462803;Taip;10;0;8;18
10425;Ramunėlė;SAULĖGRĄŽA;3793779715;Taip;0;0;8;8
10426;Ramunėlė;SAULĖGRĄŽA;6775947111;Taip;0;0;31;31
10427;Ramunėlė;SAULĖGRĄŽA;1102946363;Taip;17;0;1;18
10428;Ramunėlė;SAULĖGRĄŽA;3603956795;Taip;8;4;0;12
10429;Ramunėlė;SAULĖGRĄŽA;4902056654;Taip;8;4;0;12
10430;Ramunėlė;SAULĖGRĄŽA;7563892184;Taip;8;4;0;12
10431;Ramunėlė;SAULĖGRĄŽA;3801952385;Taip;9;6;0;15
10432;Ramunėlė;SAULĖGRĄŽA;9120142666;Taip;11;0;0;11
10433;Ramunėlė;SAULĖGRĄŽA;6942789511;Taip;11;0;0;11
10434;Ramunėlė;SAULĖGRĄŽA;6226329879;Taip;0;29;0;29
10435;Ramunėlė;SAULĖGRĄŽA;2415377154;Taip;0;5;14;19
10436;Ramunėlė;SAULĖGRĄŽA;9076692864;Taip;5;0;0;5
10437;Ramunėlė;BORUŽĖLĖS;7825538259;Taip;15;3;0;18
10438;Ramunėlė;BORUŽĖLĖS;8496322672;Taip;12;1;3;16
10439;Ramunėlė;BORUŽĖLĖS;6695672297;Taip;3;1;0;4
10440;Ramunėlė;BORUŽĖLĖS;7295041630;Taip;0;9;0;9
10441;Ramunėlė;BORUŽĖLĖS;58028743912;Taip;14;3;0;17
10442;Ramunėlė;BORUŽĖLĖS;7750405604;Taip;3;1;0;4
10443;Ramunėlė;BORUŽĖLĖS;1216101539;Taip;9;9;0;18
10444;Ramunėlė;BORUŽĖLĖS;2499280049;Taip;3;1;0;4
10445;Ramunėlė;BORUŽĖLĖS;4677819736;Taip;0;1;9;10
10446;Ramunėlė;BORUŽĖLĖS;4349250416;Taip;0;5;7;12
10447;Ramunėlė;BORUŽĖLĖS;1303053333;Taip;10;2;2;14
10448;Ramunėlė;BORUŽĖLĖS;3554787356;Taip;26;0;1;27
10449;Ramunėlė;BORUŽĖLĖS;6310921755;Taip;0;8;0;8
10450;Ramunėlė;BORUŽĖLĖS;3685786758;Taip;0;7;0;7
10451;Ramunėlė;BORUŽĖLĖS;6837072361;Taip;0;7;6;13
10452;Ramunėlė;BORUŽĖLĖS;1534723406;Ne;0;5;2;7
10453;Ramunėlė;BORUŽĖLĖS;8323020864;Taip;0;1;8;9
10454;Ramunėlė;BORUŽĖLĖS;10704826206;Taip;10;2;1;13
10455;Ramunėlė;BORUŽĖLĖS;3065727741;Taip;7;0;6;13
10456;Ramunėlė;BORUŽĖLĖS;9924675250;Taip;0;4;3;7
10457;Ramunėlė;BORUŽĖLĖS;6251432968;Ne;6;4;0;10
10458;Ramunėlė;NYKŠTUKAS;3166386231;Taip;10;2;0;12
10459;Ramunėlė;NYKŠTUKAS;8045080504;Ne;8;0;0;8
10460;Ramunėlė;NYKŠTUKAS;7955197522;Taip;14;1;0;15
10461;Ramunėlė;NYKŠTUKAS;6983139076;Taip;13;0;0;13
10462;Ramunėlė;NYKŠTUKAS;7639613472;Taip;0;24;0;24
10463;Ramunėlė;NYKŠTUKAS;4642590173;Taip;6;8;0;14
10464;Ramunėlė;NYKŠTUKAS;9549605315;Taip;7;0;0;7
10465;Ramunėlė;NYKŠTUKAS;4491147309;Taip;4;0;11;15
10466;Ramunėlė;NYKŠTUKAS;4040520907;Taip;0;18;0;18
10467;Ramunėlė;NYKŠTUKAS;7542328641;Taip;8;1;0;9
10468;Ramunėlė;NYKŠTUKAS;1277413234;Taip;12;9;0;21
10469;Ramunėlė;NYKŠTUKAS;1215510902;Taip;16;0;0;16
10470;Ramunėlė;NYKŠTUKAS;8218201930;Taip;8;21;0;29
10471;Ramunėlė;NYKŠTUKAS;2760710235;Taip;4;0;0;4
10472;Ramunėlė;NYKŠTUKAS;5573083546;Taip;25;0;0;25
10473;Ramunėlė;NYKŠTUKAS;4376812983;Taip;11;0;0;11
10474;Ramunėlė;NYKŠTUKAS;1802650607;Taip;10;0;0;10
10475;Ramunėlė;UOGELĖ;6294697776;Taip;31;1;0;32
10476;Ramunėlė;UOGELĖ;7005354909;Taip;0;4;0;4
10477;Ramunėlė;UOGELĖ;5665429647;Taip;0;4;6;10
10478;Ramunėlė;UOGELĖ;9180197156;Taip;5;3;2;10
10479;Ramunėlė;UOGELĖ;5108864184;Taip;5;3;2;10
10480;Ramunėlė;UOGELĖ;4321527067;Taip;9;2;0;11
10481;Ramunėlė;UOGELĖ;2202879286;Taip;0;1;0;1
10482;Ramunėlė;UOGELĖ;7896711579;Taip;0;10;7;17
10483;Ramunėlė;UOGELĖ;5726947811;Taip;0;2;4;6
10484;Ramunėlė;UOGELĖ;4171905362;Taip;0;3;0;3
10485;Ramunėlė;UOGELĖ;1729152997;Taip;15;5;0;20
10486;Ramunėlė;UOGELĖ;8764042799;Taip;8;3;0;11
10487;Ramunėlė;UOGELĖ;7926168752;Ne;13;0;4;17
10488;Ramunėlė;UOGELĖ;5498856861;Taip;21;0;0;21
10489;Ramunėlė;UOGELĖ;3024065664;Taip;0;20;0;20
10490;Ramunėlė;UOGELĖ;1666033483;Taip;21;1;0;22
10491;Ramunėlė;UOGELĖ;9994601365;Taip;18;0;1;19
10492;Ramunėlė;UOGELĖ;2620747378;Taip;4;0;2;6
10493;Ramunėlė;VARPELIAI;1159457001;Taip;20;3;0;23
10494;Ramunėlė;VARPELIAI;6606966969;Taip;10;0;0;10
10495;Ramunėlė;VARPELIAI;9292235402;Ne;14;0;2;16
10496;Ramunėlė;VARPELIAI;1811931985;Taip;9;9;0;18
10497;Ramunėlė;VARPELIAI;1818513881;Taip;6;3;8;17
10498;Ramunėlė;VARPELIAI;4581826404;Taip;0;0;5;5
10499;Ramunėlė;VARPELIAI;8310875815;Taip;20;1;0;21
10500;Ramunėlė;VARPELIAI;1491688322;Taip;16;3;0;19
10501;Ramunėlė;VARPELIAI;5703289545;Taip;11;0;1;12
10502;Ramunėlė;VARPELIAI;9934852622;Taip;5;0;0;5
10503;Ramunėlė;VARPELIAI;4968998913;Taip;19;0;0;19
10504;Ramunėlė;VARPELIAI;3996453947;Taip;12;4;0;16
10505;Ramunėlė;VARPELIAI;3461269451;Taip;1;8;0;9
10506;Ramunėlė;VARPELIAI;3474578046;Taip;20;2;0;22
10507;Ramunėlė;VARPELIAI;7544671346;Taip;9;4;0;13
10508;Ramunėlė;VARPELIAI;5544992493;Taip;12;4;0;16
10509;Ramunėlė;VARPELIAI;6433856416;Taip;0;10;0;10
10510;Ramunėlė;VARPELIAI;3542912372;Taip;29;1;0;30
10511;Ramunėlė;VARPELIAI;3735308599;Taip;17;2;0;19
10512;Ramunėlė;VARPELIAI;3272747656;Taip;19;0;0;19
10513;Ramunėlė;VARPELIAI;6347893013;Taip;7;0;0;7
10514;Rūta;SMALSUČIAI;6285841968;Taip;3;0;1;4
10515;Rūta;SMALSUČIAI;7649756034;Taip;11;0;3;14
10516;Rūta;SMALSUČIAI;5899860543;Ne;0;12;0;12
10517;Rūta;SMALSUČIAI;1346124133;Taip;7;0;0;7
10518;Rūta;SMALSUČIAI;4728904136;Taip;5;2;0;7
10519;Rūta;SMALSUČIAI;9791861646;Taip;0;0;3;3
10520;Rūta;SMALSUČIAI;2928803089;Taip;0;5;0;5
10521;Rūta;SMALSUČIAI;8378318357;Taip;0;3;0;3
10522;Rūta;SMALSUČIAI;1951202550;Taip;6;0;1;7
10523;Rūta;SMALSUČIAI;4962272621;Taip;2;0;0;2
10524;Rūta;SMALSUČIAI;9603105651;Ne;0;0;17;17
10525;Rūta;SMALSUČIAI;9911151238;Taip;6;0;1;7
10526;Rūta;SMALSUČIAI;3843325181;Ne;0;0;7;7
10527;Rūta;SMALSUČIAI;6316768460;Taip;0;0;11;11
10528;Rūta;SMALSUČIAI;8182243701;Taip;0;10;0;10
10529;Rūta;SMALSUČIAI;9386595365;Taip;0;0;6;6
10530;Rūta;SMALSUČIAI;7680605199;Taip;19;3;0;22
10531;Rūta;SMALSUČIAI;6075632046;Taip;0;12;0;12
10532;Rūta;SMALSUČIAI;1035527190;Ne;1;0;12;13
10533;Rūta;KŪLVERSTUKAI;4423305209;Taip;0;3;0;3
10534;Rūta;KŪLVERSTUKAI;9736567509;Taip;0;3;3;6
10535;Rūta;KŪLVERSTUKAI;7222494215;Taip;4;4;0;8
10536;Rūta;KŪLVERSTUKAI;7519931138;Taip;1;3;6;10
10537;Rūta;KŪLVERSTUKAI;4880804625;Ne;5;2;2;9
10538;Rūta;KŪLVERSTUKAI;3055345528;Taip;0;1;3;4
10539;Rūta;KŪLVERSTUKAI;3499727608;Taip;5;9;0;14
10540;Rūta;KŪLVERSTUKAI;9765301038;Taip;5;9;0;14
10541;Rūta;KŪLVERSTUKAI;9638495757;Taip;10;0;0;10
10542;Rūta;KŪLVERSTUKAI;1962172243;Taip;12;3;0;15
10543;Rūta;KŪLVERSTUKAI;8605070655;Taip;1;2;5;8
10544;Rūta;KŪLVERSTUKAI;7553844890;Taip;0;12;0;12
10545;Rūta;KŪLVERSTUKAI;3964922552;Taip;10;2;4;16
10546;Rūta;KŪLVERSTUKAI;8395765508;Taip;3;0;3;6
10547;Rūta;KŪLVERSTUKAI;9400586178;Taip;0;3;5;8
10548;Rūta;KŪLVERSTUKAI;3956912957;Taip;13;1;0;14
10549;Rūta;KŪLVERSTUKAI;2890569107;Taip;1;2;0;3
10550;Rūta;KŪLVERSTUKAI;2474991135;Taip;6;10;0;16
10551;Rūta;KŪLVERSTUKAI;1216786487;Taip;9;4;0;13
10552;Rūta;KŪLVERSTUKAI;9245618776;Taip;0;16;0;16
10553;Rūta;KŪLVERSTUKAI;5109138407;Taip;9;0;3;12
10554;Rūta;KŪLVERSTUKAI;6096664609;Ne;0;0;7;7
10555;Rūta;KODĖLČIUKAI;5962981130;Taip;5;0;3;8
10556;Rūta;KODĖLČIUKAI;4347678781;Taip;0;0;2;2
10557;Rūta;KODĖLČIUKAI;3736279705;Taip;6;0;3;9
10558;Rūta;KODĖLČIUKAI;8416455711;Taip;0;5;0;5
10559;Rūta;KODĖLČIUKAI;8668510009;Taip;5;0;1;6
10560;Rūta;KODĖLČIUKAI;2547849837;Taip;2;0;1;3
10561;Rūta;KODĖLČIUKAI;9501101073;Taip;14;1;0;15
10562;Rūta;KODĖLČIUKAI;8883578144;Taip;3;0;1;4
10563;Rūta;KODĖLČIUKAI;4546082355;Taip;0;6;0;6
10564;Rūta;KODĖLČIUKAI;1000645885;Taip;12;0;0;12
10565;Rūta;KODĖLČIUKAI;5766392854;Taip;0;8;0;8
10566;Rūta;KODĖLČIUKAI;4656138649;Taip;0;0;1;1
10567;Rūta;KODĖLČIUKAI;1605412505;Taip;8;0;0;8
10568;Rūta;KODĖLČIUKAI;2492891254;Taip;14;0;0;14
10569;Rūta;BORUŽĖLĖS;7712500278;Ne;0;0;6;6
10570;Rūta;BORUŽĖLĖS;3898579878;Taip;3;0;3;6
10571;Rūta;BORUŽĖLĖS;8945868791;Taip;4;0;7;11
10572;Rūta;BORUŽĖLĖS;8023404173;Taip;12;0;4;16
10573;Rūta;BORUŽĖLĖS;3348066709;Taip;0;0;4;4
10574;Rūta;BORUŽĖLĖS;4279367893;Taip;6;0;1;7
10575;Rūta;BORUŽĖLĖS;5141290453;Taip;0;3;0;3
10576;Rūta;BORUŽĖLĖS;7006165453;Taip;5;0;0;5
10577;Rūta;BORUŽĖLĖS;6587625933;Taip;5;0;0;5
10578;Rūta;BORUŽĖLĖS;8303314520;Taip;9;5;0;14
10579;Rūta;BORUŽĖLĖS;3470052541;Taip;8;0;4;12
10580;Rūta;BORUŽĖLĖS;2625691851;Taip;0;0;6;6
10581;Rūta;BORUŽĖLĖS;1804222979;Taip;10;0;2;12
10582;Rūta;BORUŽĖLĖS;5624054621;Taip;5;0;1;6
10583;Rūta;VYTURĖLIAI;1967141665;Taip;3;0;2;5
10584;Rūta;VYTURĖLIAI;3873876608;Taip;5;8;0;13
10585;Rūta;VYTURĖLIAI;8851591109;Ne;0;0;4;4
10586;Rūta;VYTURĖLIAI;1180144866;Taip;2;2;0;4
10587;Rūta;VYTURĖLIAI;3478456813;Taip;0;2;0;2
10588;Rūta;VYTURĖLIAI;1276704331;Taip;0;1;4;5
10589;Rūta;VYTURĖLIAI;6207902435;Taip;4;2;0;6
10590;Rūta;VYTURĖLIAI;8889388348;Taip;1;0;0;1
10591;Rūta;VYTURĖLIAI;4363571135;Taip;4;2;0;6
10592;Rūta;VYTURĖLIAI;6006094035;Taip;5;0;0;5
10593;Rūta;VYTURĖLIAI;1521231573;Taip;0;1;0;1
10594;Rūta;VYTURĖLIAI;7552644990;Ne;0;8;1;9
10595;Rūta;VYTURĖLIAI;8673942478;Ne;0;5;0;5
10596;Rūta;VYTURĖLIAI;4754142240;Taip;10;1;0;11
10597;Rūta;VYTURĖLIAI;6136733410;Taip;2;2;0;4
10598;Rūta;VYTURĖLIAI;1565896222;Taip;0;1;0;1
10599;Rūta;VYTURĖLIAI;8704594038;Taip;1;0;0;1
10600;Rūta;VYTURĖLIAI;7631229177;Taip;7;0;0;7
10601;Rūta;"PABIRUČIAI (LOGOPEDINĖ)";6221528830;Taip;0;2;4;6
10602;Rūta;"PABIRUČIAI (LOGOPEDINĖ)";4911219947;Taip;0;0;1;1
10603;Rūta;"PABIRUČIAI (LOGOPEDINĖ)";8763382361;Taip;0;3;12;15
10604;Rūta;"PABIRUČIAI (LOGOPEDINĖ)";9171781646;Taip;0;0;1;1
10605;Rūta;"PABIRUČIAI (LOGOPEDINĖ)";5871960113;Taip;0;0;1;1
10606;Rūta;"PABIRUČIAI (LOGOPEDINĖ)";5211104903;Taip;0;0;1;1
10607;Rūta;"PABIRUČIAI (LOGOPEDINĖ)";1029871210;Taip;0;0;3;3
10608;Rūta;"PABIRUČIAI (LOGOPEDINĖ)";3814794448;Ne;5;0;1;6
10609;Rūta;GUDRUČIAI;4044349935;Taip;7;0;0;7
10610;Rūta;GUDRUČIAI;3998791775;Taip;14;0;0;14
10611;Rūta;GUDRUČIAI;3043164521;Taip;0;1;0;1
10612;Rūta;GUDRUČIAI;3462986405;Taip;3;7;4;14
10613;Rūta;GUDRUČIAI;8548089843;Taip;4;0;6;10
10614;Rūta;GUDRUČIAI;4293920701;Taip;6;1;6;13
10615;Rūta;GUDRUČIAI;4473591998;Taip;6;3;0;9
10616;Rūta;GUDRUČIAI;9419809946;Taip;7;1;0;8
10617;Rūta;GUDRUČIAI;9589117921;Taip;8;0;0;8
10618;Rūta;GUDRUČIAI;3044976169;Taip;0;0;1;1
10619;Rūta;GUDRUČIAI;2546023973;Taip;8;0;1;9
10620;Rūta;GUDRUČIAI;8273644943;Taip;0;2;1;3
10621;Rūta;GUDRUČIAI;8963959004;Taip;11;0;0;11
10622;Rūta;GUDRUČIAI;3454881685;Taip;0;3;5;8
10623;Rūta;GUDRUČIAI;1811055786;Taip;1;4;10;15
10624;Rūta;GUDRUČIAI;1510268514;Taip;15;1;0;16
10625;Rūta;GUDRUČIAI;6814051598;Taip;10;2;0;12
10626;Rūta;GUDRUČIAI;2702537976;Taip;10;1;0;11
10627;Rūta;GUDRUČIAI;2772130413;Taip;0;7;0;7
10628;Rūta;GUDRUČIAI;1623968580;Taip;7;0;2;9
10629;Rūta;GUDRUČIAI;8592528906;Ne;7;0;0;7
10630;Rūta;GUDRUČIAI;1182222976;Taip;22;0;1;23
10631;Rūta;SEKLYTĖLĖ;4823677957;Taip;9;3;0;12
10632;Rūta;SEKLYTĖLĖ;1301573542;Taip;1;0;0;1
10633;Rūta;SEKLYTĖLĖ;5009619812;Taip;8;0;0;8
10634;Rūta;SEKLYTĖLĖ;3567273206;Taip;16;0;0;16
10635;Rūta;SEKLYTĖLĖ;1671913833;Taip;0;5;0;5
10636;Rūta;SEKLYTĖLĖ;1186493111;Taip;17;3;0;20
10637;Rūta;SEKLYTĖLĖ;9675482322;Taip;9;2;0;11
10638;Rūta;SEKLYTĖLĖ;3820689725;Taip;0;22;0;22
10639;Rūta;SEKLYTĖLĖ;1415664888;Taip;0;6;0;6
10640;Rūta;SEKLYTĖLĖ;4426456302;Taip;8;2;0;10
10641;Rūta;SEKLYTĖLĖ;5114985659;Taip;0;1;0;1
10642;Rūta;SEKLYTĖLĖ;4282074540;Ne;9;3;0;12
10643;Rūta;SEKLYTĖLĖ;8607455403;Taip;0;3;0;3
10644;Rūta;SEKLYTĖLĖ;4168356825;Taip;0;0;2;2
10645;Rūta;SEKLYTĖLĖ;9569447586;Taip;0;4;0;4
10646;Rūta;SEKLYTĖLĖ;2677062861;Ne;10;0;0;10
10647;Rūta;SEKLYTĖLĖ;1390207547;Taip;0;4;0;4
10648;Rūta;SEKLYTĖLĖ;32004750783;Taip;8;3;0;11
10649;Rūta;SEKLYTĖLĖ;5866619097;Taip;1;1;0;2
10650;Rūta;"VARPELIAI (LOGOPEDINĖ)";3055294324;Taip;0;0;15;15
10651;Rūta;"VARPELIAI (LOGOPEDINĖ)";3810636967;Taip;0;2;1;3
10652;Rūta;"VARPELIAI (LOGOPEDINĖ)";8992775168;Taip;0;1;2;3
10653;Rūta;"VARPELIAI (LOGOPEDINĖ)";8026402652;Ne;0;1;3;4
10654;Rūta;"VARPELIAI (LOGOPEDINĖ)";2584812163;Ne;2;2;1;5
10655;Rūta;"VARPELIAI (LOGOPEDINĖ)";6032985748;Taip;4;11;0;15
10656;Rūta;"VARPELIAI (LOGOPEDINĖ)";6891385410;Taip;0;1;1;2
10657;Rūta;"VARPELIAI (LOGOPEDINĖ)";4858914868;Taip;21;1;0;22
10658;Rūta;KIŠKUČIŲ;2601011765;Taip;0;0;11;11
10659;Rūta;KIŠKUČIŲ;5579794648;Taip;0;18;0;18
10660;Rūta;KIŠKUČIŲ;4165080541;Taip;5;3;2;10
10661;Rūta;KIŠKUČIŲ;3877807687;Taip;0;0;16;16
10662;Rūta;KIŠKUČIŲ;9429856388;Taip;4;0;4;8
10663;Rūta;KIŠKUČIŲ;8483916287;Taip;15;0;0;15
10664;Rūta;KIŠKUČIŲ;7724451685;Taip;10;3;0;13
10665;Rūta;KIŠKUČIŲ;8138816581;Taip;5;0;17;22
10666;Rūta;KIŠKUČIŲ;2733932207;Ne;14;1;0;15
10667;Rūta;KIŠKUČIŲ;5902965224;Taip;0;1;2;3
10668;Rūta;KIŠKUČIŲ;9471291067;Taip;5;3;0;8
10669;Rūta;KIŠKUČIŲ;8012225409;Taip;0;0;4;4
10670;Rūta;KIŠKUČIŲ;1290867375;Taip;0;5;0;5
10671;Rūta;KIŠKUČIŲ;2084935094;Taip;0;0;1;1
10672;Rūta;KIŠKUČIŲ;6088978998;Taip;0;0;13;13
10673;Rūta;KIŠKUČIŲ;8320791295;Taip;12;1;0;13
10674;Rūta;KIŠKUČIŲ;3109709043;Taip;13;0;9;22
10675;Rūta;KIŠKUČIŲ;2830990163;Ne;0;0;1;1
10676;Rūta;ŽVIRBLIUKAI;3352007694;Ne;1;2;3;6
10677;Rūta;ŽVIRBLIUKAI;9243332756;Taip;14;1;0;15
10678;Rūta;ŽVIRBLIUKAI;1059126758;Taip;0;19;0;19
10679;Rūta;ŽVIRBLIUKAI;6417693659;Taip;3;1;15;19
10680;Rūta;ŽVIRBLIUKAI;4090915728;Taip;0;10;0;10
10681;Rūta;ŽVIRBLIUKAI;4466522924;Taip;21;3;3;27
10682;Rūta;ŽVIRBLIUKAI;7905893575;Taip;15;3;5;23
10683;Rūta;ŽVIRBLIUKAI;4436482805;Taip;0;13;0;13
10684;Rūta;ŽVIRBLIUKAI;1260386759;Taip;11;1;0;12
10685;Rūta;ŽVIRBLIUKAI;8935780480;Taip;0;3;1;4
10686;Rūta;ŽVIRBLIUKAI;4208678278;Taip;8;1;0;9
10687;Rūta;ŽVIRBLIUKAI;6044060646;Taip;10;1;0;11
10688;Rūta;ŽVIRBLIUKAI;9220661972;Taip;4;0;0;4
10689;Rūta;ŽVIRBLIUKAI;5109026000;Taip;2;0;0;2
10690;Rūta;ŽVIRBLIUKAI;3081348981;Taip;0;5;0;5
10691;Rūta;ŽVIRBLIUKAI;4776631890;Taip;13;0;1;14
10692;Rūta;ŽVIRBLIUKAI;4440148328;Taip;14;0;0;14
10693;Rūta;ŽVIRBLIUKAI;1671179652;Taip;5;1;5;11
10694;Rūta;ŽVIRBLIUKAI;1152453609;Taip;5;2;0;7
10695;Rūta;ŽVIRBLIUKAI;9012256437;Taip;12;0;0;12
10696;Rūta;SAULUTĖS;6869693434;Taip;0;0;2;2
10697;Rūta;SAULUTĖS;6585842434;Taip;0;0;4;4
10698;Rūta;SAULUTĖS;6620957022;Taip;9;0;0;9
10699;Rūta;SAULUTĖS;8806743371;Taip;5;0;0;5
10700;Rūta;SAULUTĖS;8320521011;Taip;0;0;10;10
10701;Rūta;SAULUTĖS;2263820829;Taip;0;0;2;2
10702;Rūta;SAULUTĖS;2391120026;Taip;7;0;0;7
10703;Rūta;SAULUTĖS;3765741047;Taip;0;0;9;9
10704;Rūta;SAULUTĖS;7762509383;Taip;12;0;0;12
10705;Rūta;SAULUTĖS;2685515977;Ne;20;0;0;20
10706;Rūta;SAULUTĖS;5512946296;Taip;9;0;0;9
10707;Rūta;SAULUTĖS;9308127402;Taip;0;0;17;17
10708;Rūta;SAULUTĖS;7422059414;Taip;11;2;0;13
10709;Rūta;SAULUTĖS;6186413364;Taip;1;0;0;1
10710;Rūta;SAULUTĖS;8571905994;Ne;2;2;0;4
10711;Rūta;SAULUTĖS;8479424939;Taip;22;0;0;22
10712;Rūta;SAULUTĖS;9014433476;Taip;4;11;0;15
10713;Rūta;SAULUTĖS;1207463357;Taip;9;0;1;10
10714;Sadutė;Kiškučiai;6645848193;Taip;10;5;0;15
10715;Sadutė;Kiškučiai;1589424708;Taip;6;5;3;14
10716;Sadutė;Kiškučiai;5992865266;Taip;14;0;0;14
10717;Sadutė;Kiškučiai;3568132830;Taip;0;22;0;22
10718;Sadutė;Kiškučiai;2340908210;Taip;4;10;8;22
10719;Sadutė;Kiškučiai;2087489114;Taip;18;0;0;18
10720;Sadutė;Kiškučiai;6652070415;Taip;3;0;11;14
10721;Sadutė;Kiškučiai;4360361866;Ne;0;0;3;3
10722;Sadutė;Kiškučiai;2139177648;Taip;7;0;0;7
10723;Sadutė;Kiškučiai;6493110772;Taip;12;0;0;12
10724;Sadutė;Kiškučiai;8397295024;Taip;0;1;0;1
10725;Sadutė;Kiškučiai;4075714061;Taip;10;0;0;10
10726;Sadutė;Kiškučiai;3285448692;Taip;3;2;6;11
10727;Sadutė;Kiškučiai;2845125335;Taip;10;1;0;11
10728;Sadutė;Kiškučiai;4135398332;Taip;0;7;0;7
10729;Sadutė;Kiškučiai;3954151590;Taip;10;0;0;10
10730;Sadutė;Kiškučiai;5326000400;Taip;0;22;0;22
10731;Sadutė;Kiškučiai;1860645542;Taip;0;1;4;5
10732;Sadutė;Kiškučiai;2472471722;Taip;0;0;1;1
10733;Sadutė;Boružėlės;9115304973;Taip;0;3;2;5
10734;Sadutė;Boružėlės;8442967732;Taip;3;1;0;4
10735;Sadutė;Boružėlės;1273355194;Taip;6;0;0;6
10736;Sadutė;Boružėlės;3119547420;Taip;8;0;0;8
10737;Sadutė;Boružėlės;8987528237;Taip;0;1;4;5
10738;Sadutė;Boružėlės;6994383907;Taip;1;0;1;2
10739;Sadutė;Boružėlės;8914509685;Taip;5;1;0;6
10740;Sadutė;Boružėlės;7242188081;Taip;10;0;3;13
10741;Sadutė;Boružėlės;3244211391;Taip;10;0;3;13
10742;Sadutė;Boružėlės;3875265137;Taip;0;1;4;5
10743;Sadutė;Boružėlės;5992119777;Taip;7;1;1;9
10744;Sadutė;Boružėlės;5682745869;Taip;0;0;4;4
10745;Sadutė;Boružėlės;7072437339;Taip;0;3;0;3
10746;Sadutė;Boružėlės;5579040052;Ne;14;0;0;14
10747;Sadutė;Boružėlės;3362830536;Taip;10;1;0;11
10748;Sadutė;Boružėlės;5395676303;Taip;0;4;0;4
10749;Sadutė;Boružėlės;1923014145;Taip;5;1;5;11
10750;Sadutė;Boružėlės;5698462283;Taip;0;0;4;4
10751;Sadutė;Boružėlės;3845369333;Taip;4;0;2;6
10752;Sadutė;Boružėlės;8200891038;Taip;0;0;2;2
10753;Sadutė;Boružėlės;4696990344;Ne;14;0;0;14
10754;Sadutė;Bitutės;1759479328;Taip;0;4;2;6
10755;Sadutė;Bitutės;1975767401;Taip;0;3;0;3
10756;Sadutė;Bitutės;4245873513;Taip;12;1;0;13
10757;Sadutė;Bitutės;1873928395;Taip;6;0;2;8
10758;Sadutė;Bitutės;5866461096;Taip;0;3;1;4
10759;Sadutė;Bitutės;4883934480;Taip;5;0;0;5
10760;Sadutė;Bitutės;7097653016;Taip;0;10;0;10
10761;Sadutė;Bitutės;4479315578;Taip;6;3;0;9
10762;Sadutė;Bitutės;2020766695;Taip;0;22;0;22
10763;Sadutė;Bitutės;5011320850;Taip;4;0;2;6
10764;Sadutė;Bitutės;4161502667;Ne;0;3;6;9
10765;Sadutė;Bitutės;5973513916;Taip;0;6;0;6
10766;Sadutė;Bitutės;5169694660;Taip;5;0;0;5
10767;Sadutė;Bitutės;3361904803;Taip;10;3;3;16
10768;Sadutė;Bitutės;1231048342;Taip;0;14;0;14
10769;Sadutė;Bitutės;2355177889;Taip;0;0;2;2
10770;Sadutė;Bitutės;8556086501;Taip;4;3;0;7
10771;Sadutė;Bitutės;6066145909;Taip;22;0;0;22
10772;Sadutė;Bitutės;5142566738;Taip;6;2;4;12
10773;Sadutė;Bitutės;8662375739;Taip;0;22;0;22
10774;Sadutė;Bitutės;9692905987;Taip;8;0;0;8
10775;Sadutė;Bitutės;9107727583;Taip;9;3;1;13
10776;Sadutė;Bitutės;6138604955;Ne;10;0;0;10
10777;Sadutė;Drugeliai;9090754149;Taip;0;1;0;1
10778;Sadutė;Drugeliai;1552350084;Taip;5;1;0;6
10779;Sadutė;Drugeliai;7910380894;Ne;0;2;0;2
10780;Sadutė;Drugeliai;2467800545;Taip;1;0;1;2
10781;Sadutė;Drugeliai;4402558234;Taip;0;5;2;7
10782;Sadutė;Drugeliai;1782594187;Taip;0;4;0;4
10783;Sadutė;Drugeliai;5816844295;Taip;0;2;0;2
10784;Sadutė;Drugeliai;8803249656;Taip;7;2;0;9
10785;Sadutė;Drugeliai;4901634532;Taip;0;3;0;3
10786;Sadutė;Drugeliai;6196282159;Taip;15;0;0;15
10787;Sadutė;Drugeliai;5139219626;Taip;0;5;0;5
10788;Sadutė;Drugeliai;1735450955;Taip;0;3;0;3
10789;Sadutė;Drugeliai;2064784580;Taip;0;3;0;3
10790;Sadutė;Drugeliai;7731164484;Taip;0;0;2;2
10791;Sadutė;Drugeliai;6124376554;Taip;0;0;5;5
10792;Sadutė;Drugeliai;36769610742;Taip;5;3;3;11
10793;Sadutė;Drugeliai;4623727349;Taip;8;2;1;11
10794;Sadutė;Drugeliai;7940706717;Taip;2;1;2;5
10795;Sadutė;Drugeliai;3457375001;Ne;3;3;3;9
10796;Sadutė;Pėledžiukai;9136727429;Taip;13;0;0;13
10797;Sadutė;Pėledžiukai;5616756293;Taip;19;0;1;20
10798;Sadutė;Pėledžiukai;2705458480;Taip;0;21;1;22
10799;Sadutė;Pėledžiukai;6314488650;Ne;0;0;6;6
10800;Sadutė;Pėledžiukai;6126235707;Taip;21;0;1;22
10801;Sadutė;Pėledžiukai;1537482438;Taip;4;0;0;4
10802;Sadutė;Pėledžiukai;6716550703;Taip;8;0;0;8
10803;Sadutė;Pėledžiukai;7730645448;Ne;3;0;0;3
10804;Sadutė;Pėledžiukai;7551299839;Taip;7;0;1;8
10805;Sadutė;Pėledžiukai;8914706717;Taip;0;0;6;6
10806;Sadutė;Pėledžiukai;6379705269;Taip;13;0;0;13
10807;Sadutė;Pėledžiukai;5385678913;Taip;9;3;0;12
10808;Sadutė;Pėledžiukai;2055127699;Taip;25;0;0;25
10809;Sadutė;Pėledžiukai;2747256989;Taip;6;0;0;6
10810;Sadutė;Pėledžiukai;3277826759;Taip;6;0;0;6
10811;Sadutė;Pėledžiukai;4791750087;Taip;6;0;0;6
10812;Sadutė;Kačiukų;1507052440;Taip;0;14;0;14
10813;Sadutė;Kačiukų;1903961488;Taip;0;5;4;9
10814;Sadutė;Kačiukų;2890916313;Taip;0;3;12;15
10815;Sadutė;Kačiukų;2733633163;Taip;0;1;0;1
10816;Sadutė;Kačiukų;3993181500;Taip;0;3;2;5
10817;Sadutė;Kačiukų;8835627470;Taip;1;2;5;8
10818;Sadutė;Kačiukų;2532626934;Taip;0;1;1;2
10819;Sadutė;Kačiukų;6253351299;Taip;0;4;0;4
10820;Sadutė;Kačiukų;2426974464;Taip;6;2;3;11
10821;Sadutė;Kačiukų;5438448926;Taip;0;0;3;3
10822;Sadutė;Kačiukų;8974374101;Taip;0;3;6;9
10823;Sadutė;Kačiukų;4401870028;Taip;6;3;0;9
10824;Sadutė;Kačiukų;8714168144;Taip;1;0;0;1
10825;Sadutė;Kačiukų;3927044011;Ne;5;5;0;10
10826;Sadutė;Kačiukų;8770727233;Taip;0;3;2;5
10827;Sadutė;Kačiukų;8556218971;Taip;12;0;0;12
10828;Sadutė;Kačiukų;5267093203;Taip;21;3;4;28
10829;Sadutė;Kačiukų;5614758320;Taip;0;29;0;29
10830;Sadutė;Kačiukų;2194387139;Taip;0;0;3;3
10831;Sakalėlis;GIRINUKŲ;9566176151;Taip;15;0;0;15
10832;Sakalėlis;GIRINUKŲ;8606714134;Taip;8;0;0;8
10833;Sakalėlis;GIRINUKŲ;5405669698;Taip;10;2;1;13
10834;Sakalėlis;GIRINUKŲ;2474164013;Taip;0;1;4;5
10835;Sakalėlis;GIRINUKŲ;9493905856;Ne;9;0;0;9
10836;Sakalėlis;GIRINUKŲ;5496044442;Taip;5;0;0;5
10837;Sakalėlis;GIRINUKŲ;3418702674;Taip;0;0;5;5
10838;Sakalėlis;GIRINUKŲ;3748865437;Taip;7;0;1;8
10839;Sakalėlis;GIRINUKŲ;6700169944;Taip;3;0;0;3
10840;Sakalėlis;GIRINUKŲ;3333037807;Taip;14;3;0;17
10841;Sakalėlis;GIRINUKŲ;8667155756;Taip;0;1;6;7
10842;Sakalėlis;GIRINUKŲ;4596727938;Taip;3;0;0;3
10843;Sakalėlis;GIRINUKŲ;8790189865;Taip;0;3;0;3
10844;Sakalėlis;GIRINUKŲ;4458071075;Taip;7;0;0;7
10845;Sakalėlis;GIRINUKŲ;4209146744;Taip;0;8;0;8
10846;Sakalėlis;GIRINUKŲ;2780141413;Taip;0;7;0;7
10847;Sakalėlis;GIRINUKŲ;1347171934;Taip;0;1;0;1
10848;Sakalėlis;GIRINUKŲ;9250470549;Ne;0;2;0;2
10849;Sakalėlis;GIRINUKŲ;3691879468;Taip;5;0;3;8
10850;Sakalėlis;VYTURIUKŲ;3680732318;Taip;6;8;0;14
10851;Sakalėlis;VYTURIUKŲ;4862004373;Taip;0;3;0;3
10852;Sakalėlis;VYTURIUKŲ;6579827280;Taip;0;3;0;3
10853;Sakalėlis;VYTURIUKŲ;8381310908;Taip;6;0;0;6
10854;Sakalėlis;VYTURIUKŲ;6840368824;Taip;9;0;1;10
10855;Sakalėlis;VYTURIUKŲ;1742362136;Taip;5;0;0;5
10856;Sakalėlis;VYTURIUKŲ;5795250727;Taip;0;3;5;8
10857;Sakalėlis;VYTURIUKŲ;2985239904;Taip;5;1;0;6
10858;Sakalėlis;VYTURIUKŲ;3351218789;Ne;5;0;0;5
10859;Sakalėlis;VYTURIUKŲ;9120873899;Ne;14;0;3;17
10860;Sakalėlis;VYTURIUKŲ;4136266629;Taip;0;0;12;12
10861;Sakalėlis;VYTURIUKŲ;5991029760;Ne;9;0;2;11
10862;Sakalėlis;VYTURIUKŲ;6378711142;Ne;9;0;0;9
10863;Sakalėlis;VYTURIUKŲ;1736303381;Taip;0;1;6;7
10864;Sakalėlis;VYTURIUKŲ;7280513854;Taip;0;0;3;3
10865;Sakalėlis;DRUGELIŲ;8095359035;Taip;16;0;6;22
10866;Sakalėlis;DRUGELIŲ;6515519140;Ne;9;0;0;9
10867;Sakalėlis;DRUGELIŲ;7706606275;Taip;11;0;0;11
10868;Sakalėlis;DRUGELIŲ;5911341542;Taip;8;3;1;12
10869;Sakalėlis;DRUGELIŲ;9272347788;Taip;13;0;0;13
10870;Sakalėlis;DRUGELIŲ;9416737436;Taip;7;0;0;7
10871;Sakalėlis;DRUGELIŲ;8331612396;Taip;10;0;5;15
10872;Sakalėlis;DRUGELIŲ;2898006208;Taip;0;0;6;6
10873;Sakalėlis;DRUGELIŲ;7542322748;Taip;22;0;0;22
10874;Sakalėlis;DRUGELIŲ;4918228191;Taip;8;0;0;8
10875;Sakalėlis;DRUGELIŲ;1201086815;Taip;0;7;0;7
10876;Sakalėlis;DRUGELIŲ;3934295338;Taip;12;2;1;15
10877;Sakalėlis;DRUGELIŲ;1117800518;Taip;10;0;1;11
10878;Sakalėlis;DRUGELIŲ;2515169899;Taip;5;1;2;8
10879;Sakalėlis;DRUGELIŲ;8160589611;Taip;12;3;0;15
10880;Sakalėlis;DRUGELIŲ;9836193857;Taip;8;0;0;8
10881;Sakalėlis;DRUGELIŲ;4004006771;Taip;9;1;0;10
10882;Sakalėlis;DRUGELIŲ;1833573491;Taip;9;0;1;10
10883;Sakalėlis;DRUGELIŲ;8713298648;Taip;0;10;0;10
10884;Sakalėlis;DRUGELIŲ;2889638745;Taip;8;0;1;9
10885;Sakalėlis;DRUGELIŲ;3329244758;Taip;4;0;3;7
10886;Sakalėlis;DRUGELIŲ;7540098033;Taip;12;1;0;13
10887;Sakalėlis;GENIUKŲ;4763858893;Taip;0;1;6;7
10888;Sakalėlis;GENIUKŲ;3337299648;Taip;4;1;1;6
10889;Sakalėlis;GENIUKŲ;9830907922;Taip;0;2;0;2
10890;Sakalėlis;GENIUKŲ;43677485606;Taip;15;2;3;20
10891;Sakalėlis;GENIUKŲ;8649226611;Taip;2;0;0;2
10892;Sakalėlis;GENIUKŲ;5717022080;Taip;5;1;2;8
10893;Sakalėlis;GENIUKŲ;4515180509;Taip;0;0;3;3
10894;Sakalėlis;GENIUKŲ;1027765680;Taip;12;0;0;12
10895;Sakalėlis;GENIUKŲ;81681433432;Taip;10;1;1;12
10896;Sakalėlis;GENIUKŲ;96053733139;Taip;14;1;3;18
10897;Sakalėlis;GENIUKŲ;4612388683;Taip;12;8;0;20
10898;Sakalėlis;GENIUKŲ;7159705304;Taip;10;0;0;10
10899;Sakalėlis;GENIUKŲ;4775685174;Taip;9;0;0;9
10900;Sakalėlis;GENIUKŲ;69916351348;Taip;18;1;0;19
10901;Sakalėlis;GENIUKŲ;8936933971;Taip;10;1;0;11
10902;Sakalėlis;GENIUKŲ;2829386777;Taip;7;1;0;8
10903;Sakalėlis;GENIUKŲ;3371763993;Ne;8;1;0;9
10904;Sakalėlis;GENIUKŲ;7085108710;Taip;13;1;0;14
10905;Sakalėlis;GENIUKŲ;2902195855;Taip;4;1;1;6
10906;Sakalėlis;GENIUKŲ;36670171187;Taip;0;1;1;2
10907;Sakalėlis;GENIUKŲ;6301366135;Taip;0;1;0;1
10908;Sakalėlis;GENIUKŲ;4364341933;Ne;9;1;4;14
10909;Sakalėlis;VOVERIUKŲ;5172421763;Taip;12;0;1;13
10910;Sakalėlis;VOVERIUKŲ;5233697077;Taip;11;1;1;13
10911;Sakalėlis;VOVERIUKŲ;6414564366;Taip;19;0;3;22
10912;Sakalėlis;VOVERIUKŲ;1953356983;Taip;16;0;0;16
10913;Sakalėlis;VOVERIUKŲ;4358313171;Taip;7;0;2;9
10914;Sakalėlis;VOVERIUKŲ;1873392718;Taip;8;0;0;8
10915;Sakalėlis;VOVERIUKŲ;6806170544;Taip;9;0;3;12
10916;Sakalėlis;VOVERIUKŲ;2557089391;Taip;16;0;1;17
10917;Sakalėlis;VOVERIUKŲ;8133985842;Taip;13;0;0;13
10918;Sakalėlis;VOVERIUKŲ;3574956316;Taip;5;3;0;8
10919;Sakalėlis;VOVERIUKŲ;1403384561;Taip;10;0;0;10
10920;Sakalėlis;VOVERIUKŲ;3927363997;Ne;14;0;0;14
10921;Sakalėlis;VOVERIUKŲ;6293226507;Taip;16;0;0;16
10922;Sakalėlis;VOVERIUKŲ;2699844937;Taip;6;0;0;6
10923;Sakalėlis;VOVERIUKŲ;1273843302;Ne;8;1;1;10
10924;Sakalėlis;VOVERIUKŲ;6217643065;Taip;11;0;3;14
10925;Sakalėlis;VOVERIUKŲ;1669610397;Taip;0;0;9;9
10926;Sakalėlis;VOVERIUKŲ;4344537391;Taip;7;0;2;9
10927;Sakalėlis;VOVERIUKŲ;6016854405;Ne;3;7;0;10
10928;Sakalėlis;VOVERIUKŲ;2531146677;Taip;12;0;3;15
10929;Sakalėlis;VOVERIUKŲ;2575873447;Taip;13;0;0;13
10930;Sakalėlis;VOVERIUKŲ;9592852011;Taip;1;0;0;1
10931;Sakalėlis;VOVERIUKŲ;4968216193;Ne;9;0;3;12
10932;Sakalėlis;PĖLEDŽIUKŲ;1133377117;Taip;4;1;2;7
10933;Sakalėlis;PĖLEDŽIUKŲ;6190741162;Taip;0;1;5;6
10934;Sakalėlis;PĖLEDŽIUKŲ;4430763418;Ne;14;4;0;18
10935;Sakalėlis;PĖLEDŽIUKŲ;1104881142;Taip;6;2;0;8
10936;Sakalėlis;PĖLEDŽIUKŲ;6321575268;Taip;0;1;2;3
10937;Sakalėlis;PĖLEDŽIUKŲ;1702964714;Taip;5;4;1;10
10938;Sakalėlis;PĖLEDŽIUKŲ;30987215315;Taip;0;1;2;3
10939;Sakalėlis;PĖLEDŽIUKŲ;2796230671;Taip;10;1;2;13
10940;Sakalėlis;PĖLEDŽIUKŲ;3962436122;Taip;6;3;0;9
10941;Sakalėlis;PĖLEDŽIUKŲ;1912068116;Ne;0;1;2;3
10942;Sakalėlis;PĖLEDŽIUKŲ;34464485043;Taip;5;0;2;7
10943;Sakalėlis;PĖLEDŽIUKŲ;1141943082;Taip;0;0;2;2
10944;Sakalėlis;PĖLEDŽIUKŲ;46629941288;Taip;0;1;0;1
10945;Sakalėlis;PĖLEDŽIUKŲ;5782214279;Taip;5;1;2;8
10946;Sakalėlis;PĖLEDŽIUKŲ;8852001037;Taip;0;5;3;8
10947;Sakalėlis;PĖLEDŽIUKŲ;6180987643;Ne;21;1;0;22
10948;Sakalėlis;PĖLEDŽIUKŲ;3678172501;Taip;9;5;0;14
10949;Sakalėlis;PĖLEDŽIUKŲ;7567476424;Taip;0;1;3;4
10950;Sakalėlis;PĖLEDŽIUKŲ;2055710873;Taip;0;1;0;1
10951;Sakalėlis;PĖLEDŽIUKŲ;1839096675;Taip;2;0;1;3
10952;Sakalėlis;PĖLEDŽIUKŲ;1339314644;Taip;0;0;2;2
10953;Sakalėlis;PĖLEDŽIUKŲ;5884781964;Taip;7;0;0;7
10954;Sakalėlis;PĖLEDŽIUKŲ;4495453007;Taip;7;1;4;12
10955;Sakalėlis;"BITUČIŲ (LOGOPEDINĖ)";7241416465;Ne;6;1;2;9
10956;Sakalėlis;"BITUČIŲ (LOGOPEDINĖ)";8610668395;Taip;7;2;2;11
10957;Sakalėlis;"BITUČIŲ (LOGOPEDINĖ)";4986131090;Taip;6;1;0;7
10958;Sakalėlis;"BITUČIŲ (LOGOPEDINĖ)";6259640492;Taip;15;0;1;16
10959;Sakalėlis;"BITUČIŲ (LOGOPEDINĖ)";1723436498;Taip;17;1;0;18
10960;Sakalėlis;"BITUČIŲ (LOGOPEDINĖ)";3938470708;Taip;11;0;0;11
10961;Sakalėlis;"BITUČIŲ (LOGOPEDINĖ)";4931253729;Taip;0;0;5;5
10962;Sakalėlis;"BITUČIŲ (LOGOPEDINĖ)";5376872141;Ne;8;0;0;8
10963;Sakalėlis;"BITUČIŲ (LOGOPEDINĖ)";4303490614;Taip;0;5;0;5
10964;Sakalėlis;"BORUŽIUKŲ (LOGOPEDINĖ)";4514546151;Taip;3;1;0;4
10965;Sakalėlis;"BORUŽIUKŲ (LOGOPEDINĖ)";3972897839;Taip;0;2;2;4
10966;Sakalėlis;"BORUŽIUKŲ (LOGOPEDINĖ)";1806698668;Ne;6;1;1;8
10967;Sakalėlis;"BORUŽIUKŲ (LOGOPEDINĖ)";6727251397;Taip;4;1;0;5
10968;Sakalėlis;"BORUŽIUKŲ (LOGOPEDINĖ)";6222204020;Taip;0;0;1;1
10969;Sakalėlis;"BORUŽIUKŲ (LOGOPEDINĖ)";7602249339;Taip;0;0;1;1
10970;Sakalėlis;"BORUŽIUKŲ (LOGOPEDINĖ)";8263169658;Taip;0;0;3;3
10971;Sakalėlis;MEŠKUČIŲ;9546779717;Taip;13;2;0;15
10972;Sakalėlis;MEŠKUČIŲ;8535457018;Taip;0;7;3;10
10973;Sakalėlis;MEŠKUČIŲ;4813561523;Taip;14;0;1;15
10974;Sakalėlis;MEŠKUČIŲ;7154383856;Taip;18;0;0;18
10975;Sakalėlis;MEŠKUČIŲ;5082756444;Taip;0;0;7;7
10976;Sakalėlis;MEŠKUČIŲ;7839893402;Taip;4;0;0;4
10977;Sakalėlis;MEŠKUČIŲ;3092760315;Taip;0;12;0;12
10978;Sakalėlis;MEŠKUČIŲ;3524545708;Taip;4;4;0;8
10979;Sakalėlis;MEŠKUČIŲ;5961207419;Taip;10;0;1;11
10980;Sakalėlis;MEŠKUČIŲ;5961861760;Taip;2;0;0;2
10981;Sakalėlis;MEŠKUČIŲ;5677280944;Taip;6;0;1;7
10982;Sakalėlis;MEŠKUČIŲ;2389541483;Taip;7;3;0;10
10983;Sakalėlis;MEŠKUČIŲ;4063074948;Taip;4;0;0;4
10984;Sakalėlis;MEŠKUČIŲ;8108456923;Taip;7;0;0;7
10985;Sakalėlis;MEŠKUČIŲ;7285230768;Taip;12;2;0;14
10986;Sakalėlis;MEŠKUČIŲ;8888784168;Ne;10;4;0;14
10987;Sakalėlis;MEŠKUČIŲ;2090313887;Ne;8;0;1;9
10988;Sakalėlis;MEŠKUČIŲ;9794245922;Taip;0;0;11;11
10989;Sakalėlis;MEŠKUČIŲ;8106231242;Taip;4;11;0;15
10990;Sakalėlis;MEŠKUČIŲ;4520212128;Taip;9;1;0;10
10991;Sakalėlis;MEŠKUČIŲ;7228559861;Taip;0;10;6;16
10992;Sakalėlis;MEŠKUČIŲ;1208798798;Taip;11;0;0;11
10993;Sakalėlis;KIŠKUČIŲ;2505477059;Taip;9;4;0;13
10994;Sakalėlis;KIŠKUČIŲ;1004062550;Taip;14;1;0;15
10995;Sakalėlis;KIŠKUČIŲ;5865993835;Taip;5;0;3;8
10996;Sakalėlis;KIŠKUČIŲ;2003090775;Taip;7;0;0;7
10997;Sakalėlis;KIŠKUČIŲ;8228039819;Taip;15;0;2;17
10998;Sakalėlis;KIŠKUČIŲ;7006304327;Taip;0;0;6;6
10999;Sakalėlis;KIŠKUČIŲ;6029443196;Taip;19;0;2;21
11000;Sakalėlis;KIŠKUČIŲ;4633296169;Taip;0;0;1;1
11001;Sakalėlis;KIŠKUČIŲ;4611384179;Taip;8;2;0;10
11002;Sakalėlis;KIŠKUČIŲ;4490632523;Taip;0;7;0;7
11003;Sakalėlis;KIŠKUČIŲ;8015985605;Taip;14;3;0;17
11004;Sakalėlis;KIŠKUČIŲ;5052638078;Taip;22;0;0;22
11005;Sakalėlis;KIŠKUČIŲ;5327382009;Taip;22;0;0;22
11006;Sakalėlis;KIŠKUČIŲ;6897550418;Taip;3;0;1;4
11007;Sakalėlis;KIŠKUČIŲ;9642519454;Taip;12;0;0;12
11008;Sakalėlis;KIŠKUČIŲ;5387119771;Taip;22;0;0;22
11009;Sakalėlis;KIŠKUČIŲ;6328924318;Taip;12;0;3;15
11010;Sakalėlis;KIŠKUČIŲ;8868588637;Taip;7;3;4;14
11011;Sakalėlis;SVIRPLIUKŲ;6597274376;Taip;7;2;0;9
11012;Sakalėlis;SVIRPLIUKŲ;5500248048;Taip;11;2;1;14
11013;Sakalėlis;SVIRPLIUKŲ;8562164673;Taip;7;0;0;7
11014;Sakalėlis;SVIRPLIUKŲ;3719351129;Taip;9;3;0;12
11015;Sakalėlis;SVIRPLIUKŲ;3570413330;Taip;10;0;0;10
11016;Sakalėlis;SVIRPLIUKŲ;6889888573;Taip;14;0;0;14
11017;Sakalėlis;SVIRPLIUKŲ;7852255204;Taip;0;0;6;6
11018;Sakalėlis;SVIRPLIUKŲ;9926328835;Taip;0;1;0;1
11019;Sakalėlis;SVIRPLIUKŲ;1253452975;Taip;4;0;3;7
11020;Sakalėlis;SVIRPLIUKŲ;8328069876;Taip;0;0;2;2
11021;Sakalėlis;SVIRPLIUKŲ;7480286509;Taip;0;1;3;4
11022;Sakalėlis;SVIRPLIUKŲ;2250828607;Taip;0;1;8;9
11023;Sakalėlis;SVIRPLIUKŲ;2672429406;Taip;0;1;8;9
11024;Sakalėlis;SVIRPLIUKŲ;6851247779;Taip;0;0;2;2
11025;Sakalėlis;SVIRPLIUKŲ;9776767584;Ne;18;0;0;18
11026;Sakalėlis;SVIRPLIUKŲ;8501785305;Ne;10;0;2;12
11027;Sakalėlis;SVIRPLIUKŲ;1121818878;Taip;3;1;0;4
11028;Sakalėlis;SVIRPLIUKŲ;5465596207;Taip;17;0;0;17
11029;Sakalėlis;SVIRPLIUKŲ;2233966176;Taip;5;1;15;21
11030;Sakalėlis;SVIRPLIUKŲ;7079300418;Taip;11;0;4;15
11031;Sakalėlis;SVIRPLIUKŲ;8659925528;Taip;4;0;7;11
11032;Sakalėlis;GANDRIUKŲ;8502289806;Taip;0;1;0;1
11033;Sakalėlis;GANDRIUKŲ;5292978341;Ne;0;0;1;1
11034;Sakalėlis;GANDRIUKŲ;9368758708;Ne;7;0;0;7
11035;Sakalėlis;GANDRIUKŲ;8326977226;Taip;0;0;2;2
11036;Sakalėlis;GANDRIUKŲ;7384400795;Taip;10;5;1;16
11037;Sakalėlis;GANDRIUKŲ;3644413861;Taip;0;3;0;3
11038;Sakalėlis;GANDRIUKŲ;4576495786;Taip;0;1;0;1
11039;Sakalėlis;GANDRIUKŲ;4230762388;Taip;15;0;0;15
11040;Sakalėlis;GANDRIUKŲ;3228617971;Taip;0;1;0;1
11041;Sakalėlis;GANDRIUKŲ;1545323439;Ne;0;0;4;4
11042;Sakalėlis;GANDRIUKŲ;5748438461;Taip;15;1;0;16
11043;Sakalėlis;GANDRIUKŲ;2734462553;Taip;10;0;0;10
11044;Sakalėlis;GANDRIUKŲ;2481285439;Taip;9;0;4;13
11045;Sakalėlis;GANDRIUKŲ;7345113972;Taip;0;1;2;3
11046;Sakalėlis;GANDRIUKŲ;6069544792;Ne;0;0;1;1
11047;Sakalėlis;GANDRIUKŲ;8869621812;Ne;0;0;1;1
11048;Sakalėlis;GANDRIUKŲ;5460619168;Ne;13;0;1;14
11049;Sakalėlis;GANDRIUKŲ;1560077883;Ne;7;7;2;16
11050;Salininkų;BORUŽIUKAI;8329495685;Taip;15;2;2;19
11051;Salininkų;BORUŽIUKAI;1005025619;Ne;0;8;0;8
11052;Salininkų;BORUŽIUKAI;3925860408;Taip;11;0;0;11
11053;Salininkų;BORUŽIUKAI;2146404021;Ne;4;2;0;6
11054;Salininkų;BORUŽIUKAI;8718514114;Ne;22;2;0;24
11055;Salininkų;BORUŽIUKAI;8930622266;Taip;0;6;0;6
11056;Salininkų;BORUŽIUKAI;5447236646;Taip;10;3;2;15
11057;Salininkų;BORUŽIUKAI;2208793412;Taip;9;1;0;10
11058;Salininkų;BORUŽIUKAI;5045064069;Taip;0;0;7;7
11059;Salininkų;BORUŽIUKAI;1647401700;Taip;15;0;0;15
11060;Salininkų;BORUŽIUKAI;9817285587;Taip;18;0;0;18
11061;Salininkų;BORUŽIUKAI;8823595510;Taip;0;10;0;10
11062;Salininkų;BORUŽIUKAI;9416926474;Taip;11;1;0;12
11063;Salininkų;BORUŽIUKAI;5671229613;Taip;0;3;0;3
11064;Salininkų;BORUŽIUKAI;1254843449;Ne;13;7;0;20
11065;Salininkų;BORUŽIUKAI;3231379271;Taip;9;7;0;16
11066;Salininkų;BORUŽIUKAI;1346133493;Taip;0;2;0;2
11067;Salininkų;BORUŽIUKAI;2273407270;Taip;0;2;0;2
11068;Salininkų;BORUŽIUKAI;9855014750;Taip;13;0;0;13
11069;Salininkų;BORUŽIUKAI;8911016037;Taip;15;0;0;15
11070;Salininkų;GĖLYTĖS;8602489420;Taip;13;5;0;18
11071;Salininkų;GĖLYTĖS;2895782373;Taip;8;7;0;15
11072;Salininkų;GĖLYTĖS;4971070998;Taip;5;0;2;7
11073;Salininkų;GĖLYTĖS;9893985732;Taip;5;8;0;13
11074;Salininkų;GĖLYTĖS;3686372180;Taip;26;0;0;26
11075;Salininkų;GĖLYTĖS;9892443649;Taip;5;1;0;6
11076;Salininkų;GĖLYTĖS;3703729963;Ne;6;1;0;7
11077;Salininkų;GĖLYTĖS;3338213592;Taip;4;1;0;5
11078;Salininkų;GĖLYTĖS;6506819265;Taip;11;0;0;11
11079;Salininkų;GĖLYTĖS;6510096414;Taip;4;16;0;20
11080;Salininkų;GĖLYTĖS;9482632726;Taip;7;0;0;7
11081;Salininkų;GĖLYTĖS;2491796874;Taip;0;0;10;10
11082;Salininkų;GĖLYTĖS;3464228778;Taip;9;0;4;13
11083;Salininkų;GĖLYTĖS;8141168894;Taip;14;0;0;14
11084;Salininkų;GĖLYTĖS;2440831687;Taip;20;5;0;25
11085;Salininkų;GĖLYTĖS;1284909139;Ne;0;5;0;5
11086;Salininkų;GĖLYTĖS;5164367382;Ne;13;2;0;15
11087;Salininkų;GĖLYTĖS;2798153926;Taip;14;0;0;14
11088;Salininkų;GĖLYTĖS;2726813574;Taip;19;2;0;21
11089;Salininkų;GĖLYTĖS;1453214735;Taip;4;2;0;6
11090;Salininkų;DRUGELIAI;2684868661;Taip;18;0;0;18
11091;Salininkų;DRUGELIAI;8063397588;Taip;10;0;0;10
11092;Salininkų;DRUGELIAI;4333027447;Taip;10;0;0;10
11093;Salininkų;DRUGELIAI;3115232507;Taip;5;0;0;5
11094;Salininkų;DRUGELIAI;2009246885;Taip;10;0;0;10
11095;Salininkų;DRUGELIAI;3420217477;Taip;14;0;0;14
11096;Salininkų;DRUGELIAI;3890914603;Taip;21;3;0;24
11097;Salininkų;DRUGELIAI;3181932118;Taip;31;2;0;33
11098;Salininkų;DRUGELIAI;5017068344;Taip;0;8;0;8
11099;Salininkų;DRUGELIAI;3761217912;Taip;15;0;0;15
11100;Salininkų;DRUGELIAI;2208607684;Taip;9;2;0;11
11101;Salininkų;DRUGELIAI;3963410827;Taip;16;0;0;16
11102;Salininkų;DRUGELIAI;5539560359;Taip;9;3;4;16
11103;Salininkų;DRUGELIAI;5587577036;Taip;18;0;0;18
11104;Salininkų;DRUGELIAI;5375668400;Ne;0;10;0;10
11105;Salininkų;DRUGELIAI;4529253958;Taip;10;1;0;11
11106;Salininkų;DRUGELIAI;5583804491;Taip;21;1;0;22
11107;Salininkų;DRUGELIAI;6786504670;Taip;7;0;0;7
11108;Salininkų;DRUGELIAI;7063718023;Taip;11;0;1;12
11109;Salininkų;DRUGELIAI;9018366347;Taip;15;0;0;15
11110;Salininkų;ŽIRNIUKAI;7643665643;Taip;10;1;0;11
11111;Salininkų;ŽIRNIUKAI;9198411540;Taip;13;3;0;16
11112;Salininkų;ŽIRNIUKAI;6885580632;Taip;11;12;2;25
11113;Salininkų;ŽIRNIUKAI;7409604480;Ne;4;3;0;7
11114;Salininkų;ŽIRNIUKAI;3677558828;Taip;0;4;0;4
11115;Salininkų;ŽIRNIUKAI;8095820690;Ne;11;0;0;11
11116;Salininkų;ŽIRNIUKAI;6482437251;Taip;9;0;0;9
11117;Salininkų;ŽIRNIUKAI;1380797788;Taip;10;6;0;16
11118;Salininkų;ŽIRNIUKAI;2495782496;Taip;0;3;12;15
11119;Salininkų;ŽIRNIUKAI;9896357816;Taip;25;2;0;27
11120;Salininkų;ŽIRNIUKAI;4568462071;Taip;19;0;2;21
11121;Salininkų;ŽIRNIUKAI;9137783249;Taip;7;5;0;12
11122;Salininkų;ŽIRNIUKAI;8524400656;Taip;14;2;0;16
11123;Salininkų;ŽIRNIUKAI;7463713798;Taip;17;5;0;22
11124;Salininkų;ŽIRNIUKAI;9617873735;Taip;10;0;0;10
11125;Salininkų;ŽIRNIUKAI;1111197633;Taip;9;3;0;12
11126;Salininkų;ŽIRNIUKAI;6143967744;Taip;14;0;10;24
11127;Salininkų;ŽIRNIUKAI;8552427446;Taip;0;0;16;16
11128;Salininkų;ŽIRNIUKAI;6586988786;Taip;4;6;0;10
11129;Salininkų;ŽIRNIUKAI;1587485662;Ne;6;1;8;15
11130;Salininkų;PAUKŠČIUKAI;8047582970;Ne;0;0;1;1
11131;Salininkų;PAUKŠČIUKAI;5427013789;Ne;6;4;0;10
11132;Salininkų;PAUKŠČIUKAI;3100499807;Ne;6;4;0;10
11133;Salininkų;PAUKŠČIUKAI;6850925495;Ne;0;3;1;4
11134;Salininkų;PAUKŠČIUKAI;5867676844;Taip;6;0;3;9
11135;Salininkų;PAUKŠČIUKAI;3585435095;Ne;9;1;0;10
11136;Salininkų;PAUKŠČIUKAI;2760231414;Ne;6;3;2;11
11137;Salininkų;PAUKŠČIUKAI;7665409499;Taip;21;0;1;22
11138;Salininkų;PAUKŠČIUKAI;9724367035;Taip;9;2;0;11
11139;Salininkų;PAUKŠČIUKAI;1658695150;Ne;0;1;3;4
11140;Salininkų;PAUKŠČIUKAI;7383557807;Taip;0;9;0;9
11141;Salininkų;PAUKŠČIUKAI;9344614003;Ne;14;1;0;15
11142;Salininkų;PAUKŠČIUKAI;2808778763;Taip;0;7;0;7
11143;Salininkų;PAUKŠČIUKAI;6656578271;Taip;19;2;0;21
11144;Salininkų;PAUKŠČIUKAI;7737045952;Ne;1;3;0;4
11145;Salininkų;PAUKŠČIUKAI;9890660815;Ne;0;3;0;3
11146;Salininkų;PAUKŠČIUKAI;8995565864;Ne;9;3;0;12
11147;Salininkų;PAUKŠČIUKAI;7782972361;Taip;0;8;0;8
11148;Salininkų;PAUKŠČIUKAI;8394582546;Ne;0;8;0;8
11149;Salininkų;PAUKŠČIUKAI;6327046935;Ne;0;3;0;3
11150;Salininkų;PAUKŠČIUKAI;4425748908;Ne;0;2;0;2
11151;Salininkų;PAUKŠČIUKAI;4323257798;Ne;15;4;0;19
11152;Salininkų;PAUKŠČIUKAI;6266609965;Ne;0;10;0;10
11153;Salininkų;PAUKŠČIUKAI;3737834032;Taip;7;0;2;9
11154;Salininkų;PAUKŠČIUKAI;9813360176;Ne;4;2;0;6
11155;Salininkų;BITUTĖS;3252151974;Ne;20;0;1;21
11156;Salininkų;BITUTĖS;6845471044;Taip;13;0;1;14
11157;Salininkų;BITUTĖS;7253347059;Taip;15;0;0;15
11158;Salininkų;BITUTĖS;2467926286;Taip;0;4;0;4
11159;Salininkų;BITUTĖS;8774984357;Taip;7;0;1;8
11160;Salininkų;BITUTĖS;9902751686;Taip;12;1;0;13
11161;Salininkų;BITUTĖS;6125152143;Taip;10;0;1;11
11162;Salininkų;BITUTĖS;2095952937;Taip;9;0;1;10
11163;Salininkų;BITUTĖS;6551489987;Taip;12;1;0;13
11164;Salininkų;BITUTĖS;6979816464;Taip;0;1;2;3
11165;Salininkų;BITUTĖS;1928897962;Taip;5;1;0;6
11166;Salininkų;BITUTĖS;3527495230;Taip;0;1;0;1
11167;Salininkų;BITUTĖS;5582091833;Taip;10;0;0;10
11168;Salininkų;BITUTĖS;2073939432;Taip;9;0;0;9
11169;Salininkų;BITUTĖS;9996809930;Taip;11;0;4;15
11170;Salininkų;BITUTĖS;8992580214;Taip;0;4;0;4
11171;Salininkų;BITUTĖS;3915336062;Taip;31;0;0;31
11172;Salininkų;BITUTĖS;6577237672;Taip;9;0;0;9
11173;Salininkų;BITUTĖS;7115888747;Taip;0;0;1;1
11174;Salininkų;BITUTĖS;7639362434;Taip;16;0;1;17
11175;Salininkų;BITUTĖS;2370778977;Taip;0;0;3;3
11176;Salininkų;BITUTĖS;1020073382;Taip;0;0;3;3
11177;Salininkų;BITUTĖS;4480303856;Taip;8;0;2;10
11178;Salvija;Daigelis(šatil);1062662192;Taip;10;0;1;11
11179;Salvija;Daigelis(šatil);4577248630;Taip;22;0;0;22
11180;Salvija;Daigelis(šatil);9978634888;Taip;0;0;22;22
11181;Salvija;Daigelis(šatil);1676795179;Taip;1;0;1;2
11182;Salvija;Daigelis(šatil);6509829735;Taip;5;0;1;6
11183;Salvija;Daigelis(šatil);4665919836;Taip;13;0;0;13
11184;Salvija;Daigelis(šatil);1511271658;Taip;10;0;0;10
11185;Salvija;Daigelis(šatil);3345231579;Taip;13;0;0;13
11186;Salvija;Daigelis(šatil);3640213912;Taip;9;0;2;11
11187;Salvija;Daigelis(šatil);1509182157;Taip;9;0;0;9
11188;Salvija;Daigelis(šatil);8337554678;Taip;8;0;1;9
11189;Salvija;Daigelis(šatil);5327735648;Taip;10;5;3;18
11190;Salvija;Daigelis(šatil);5805537864;Taip;9;0;0;9
11191;Salvija;Daigelis(šatil);6323383244;Taip;22;0;0;22
11192;Salvija;Daigelis(šatil);3857916185;Taip;0;0;11;11
11193;Salvija;Daigelis(šatil);4719344565;Taip;9;0;7;16
11194;Salvija;Daigelis(šatil);5554431690;Taip;9;0;6;15
11195;Salvija;Daigelis(šatil);1065575041;Taip;9;0;13;22
11196;Salvija;Daigelis(šatil);1168900211;Taip;10;0;0;10
11197;Salvija;Daigelis(šatil);7410091250;Taip;8;0;0;8
11198;Salvija;Daigelis(šatil);5761622263;Taip;4;0;0;4
11199;Salvija;"Pienė (savjon)";5494438837;Taip;0;0;3;3
11200;Salvija;"Pienė (savjon)";8023422294;Taip;5;0;3;8
11201;Salvija;"Pienė (savjon)";4152602039;Taip;2;0;1;3
11202;Salvija;"Pienė (savjon)";8981331532;Taip;14;0;3;17
11203;Salvija;"Pienė (savjon)";8306404275;Taip;0;0;7;7
11204;Salvija;"Pienė (savjon)";1261005294;Taip;0;0;1;1
11205;Salvija;"Pienė (savjon)";8013023311;Taip;0;0;2;2
11206;Salvija;"Pienė (savjon)";1653831148;Taip;15;0;0;15
11207;Salvija;"Pienė (savjon)";4325636377;Taip;4;0;1;5
11208;Salvija;"Pienė (savjon)";8892646200;Taip;13;0;1;14
11209;Salvija;"Pienė (savjon)";7477171133;Taip;19;0;0;19
11210;Salvija;"Pienė (savjon)";6706565915;Ne;9;0;0;9
11211;Salvija;"Pienė (savjon)";8853389268;Ne;3;12;0;15
11212;Salvija;"Pienė (savjon)";3856351749;Ne;6;4;0;10
11213;Salvija;"Pienė (savjon)";8158680641;Taip;5;0;1;6
11214;Salvija;"Pienė (savjon)";7862619996;Ne;5;0;2;7
11215;Salvija;"Pienė (savjon)";3487446998;Taip;10;0;0;10
11216;Salvija;"Pienė (savjon)";4373711097;Ne;0;0;1;1
11217;Salvija;"Pienė (savjon)";5816893736;Taip;10;0;0;10
11218;Salvija;"Pienė (savjon)";1975032693;Ne;0;10;0;10
11219;Saulėtekis;BERŽELIS;3493175211;Taip;4;5;0;9
11220;Saulėtekis;BERŽELIS;8023603198;Taip;12;0;0;12
11221;Saulėtekis;BERŽELIS;8086451893;Taip;4;0;1;5
11222;Saulėtekis;BERŽELIS;9351122147;Taip;14;0;0;14
11223;Saulėtekis;BERŽELIS;6667804855;Taip;0;1;0;1
11224;Saulėtekis;BERŽELIS;1852180633;Ne;23;0;0;23
11225;Saulėtekis;BERŽELIS;5468364505;Taip;0;0;2;2
11226;Saulėtekis;BERŽELIS;4704426104;Taip;9;0;2;11
11227;Saulėtekis;BERŽELIS;7407540257;Taip;4;0;0;4
11228;Saulėtekis;BERŽELIS;6920619390;Ne;6;0;0;6
11229;Saulėtekis;BERŽELIS;7698241758;Ne;3;0;0;3
11230;Saulėtekis;BERŽELIS;5194925689;Taip;3;1;1;5
11231;Saulėtekis;BERŽELIS;7494641077;Taip;5;1;0;6
11232;Saulėtekis;BERŽELIS;1577609727;Taip;3;1;0;4
11233;Saulėtekis;BERŽELIS;2672108464;Taip;9;1;0;10
11234;Saulėtekis;BERŽELIS;9579088485;Taip;8;2;0;10
11235;Saulėtekis;BERŽELIS;2568544418;Taip;8;0;1;9
11236;Saulėtekis;BERŽELIS;8927598999;Ne;17;0;0;17
11237;Saulėtekis;BERŽELIS;9734188792;Ne;14;0;2;16
11238;Saulėtekis;BERŽELIS;6983324115;Taip;11;1;2;14
11239;Saulėtekis;BERŽELIS;8061477303;Taip;1;1;1;3
11240;Saulėtekis;BERŽELIS;7436158953;Taip;10;1;2;13
11241;Saulėtekis;ŠYPSENA;9972687066;Ne;10;1;1;12
11242;Saulėtekis;ŠYPSENA;7346852524;Taip;7;1;0;8
11243;Saulėtekis;ŠYPSENA;6072030240;Taip;0;1;1;2
11244;Saulėtekis;ŠYPSENA;7893982893;Taip;3;1;5;9
11245;Saulėtekis;ŠYPSENA;7505040675;Taip;4;2;0;6
11246;Saulėtekis;ŠYPSENA;9791926936;Taip;12;0;1;13
11247;Saulėtekis;ŠYPSENA;8620689981;Taip;0;7;0;7
11248;Saulėtekis;ŠYPSENA;8143793642;Taip;0;5;0;5
11249;Saulėtekis;ŠYPSENA;7673965242;Taip;18;0;0;18
11250;Saulėtekis;ŠYPSENA;3166959569;Taip;0;0;2;2
11251;Saulėtekis;ŠYPSENA;9661075465;Taip;3;1;0;4
11252;Saulėtekis;ŠYPSENA;9383567339;Taip;12;0;1;13
11253;Saulėtekis;ŠYPSENA;6608831217;Taip;6;1;0;7
11254;Saulėtekis;ŠYPSENA;7730889108;Taip;9;1;2;12
11255;Saulėtekis;ŠYPSENA;7435424899;Taip;10;1;2;13
11256;Saulėtekis;ŠYPSENA;7803735686;Taip;3;1;1;5
11257;Saulėtekis;ŠYPSENA;9694119292;Taip;22;0;0;22
11258;Saulėtekis;ŠYPSENA;8881524909;Taip;9;1;3;13
11259;Saulėtekis;ŠYPSENA;5518726567;Taip;10;1;0;11
11260;Saulėtekis;ŠYPSENA;2177470008;Taip;10;0;2;12
11261;Saulėtekis;ŠYPSENA;4250589212;Taip;10;0;3;13
11262;Saulėtekis;ŠYPSENA;2686041419;Taip;0;0;13;13
11263;Saulėtekis;NYKŠTUKAI;1896847801;Taip;5;0;0;5
11264;Saulėtekis;NYKŠTUKAI;7849181976;Taip;5;3;0;8
11265;Saulėtekis;NYKŠTUKAI;5748816813;Taip;11;4;0;15
11266;Saulėtekis;NYKŠTUKAI;7555273745;Taip;12;0;0;12
11267;Saulėtekis;NYKŠTUKAI;1416983683;Taip;0;4;0;4
11268;Saulėtekis;NYKŠTUKAI;4758423356;Taip;0;10;0;10
11269;Saulėtekis;NYKŠTUKAI;9270109327;Taip;0;3;0;3
11270;Saulėtekis;NYKŠTUKAI;5183297420;Taip;11;4;0;15
11271;Saulėtekis;NYKŠTUKAI;8007704080;Taip;15;0;0;15
11272;Saulėtekis;NYKŠTUKAI;8683571534;Ne;12;4;0;16
11273;Saulėtekis;NYKŠTUKAI;9481578412;Taip;22;0;0;22
11274;Saulėtekis;NYKŠTUKAI;8167740525;Taip;15;0;0;15
11275;Saulėtekis;NYKŠTUKAI;3371045145;Taip;6;0;1;7
11276;Saulėtekis;NYKŠTUKAI;9818660340;Taip;10;3;0;13
11277;Saulėtekis;NYKŠTUKAI;3729811521;Taip;2;3;0;5
11278;Saulėtekis;NYKŠTUKAI;5888979911;Taip;0;5;0;5
11279;Saulėtekis;NYKŠTUKAI;9787534807;Taip;3;0;0;3
11280;Saulėtekis;NYKŠTUKAI;8090571664;Taip;0;1;0;1
11281;Saulėtekis;NYKŠTUKAI;9104549419;Ne;3;1;0;4
11282;Saulėtekis;NYKŠTUKAI;3957655772;Taip;22;0;0;22
11283;Saulėtekis;NYKŠTUKAI;3270283626;Ne;18;1;0;19
11284;Saulėtekis;PAGRANDUKAS;8102360466;Taip;5;0;1;6
11285;Saulėtekis;PAGRANDUKAS;2371396923;Taip;0;1;0;1
11286;Saulėtekis;PAGRANDUKAS;4152255439;Taip;4;1;0;5
11287;Saulėtekis;PAGRANDUKAS;2209156661;Taip;12;1;2;15
11288;Saulėtekis;PAGRANDUKAS;5552614092;Ne;0;1;0;1
11289;Saulėtekis;PAGRANDUKAS;9497129509;Taip;4;0;0;4
11290;Saulėtekis;PAGRANDUKAS;7186085219;Taip;9;1;0;10
11291;Saulėtekis;PAGRANDUKAS;1020209414;Taip;5;1;4;10
11292;Saulėtekis;PAGRANDUKAS;8745921541;Taip;1;1;0;2
11293;Saulėtekis;PAGRANDUKAS;2728836108;Taip;7;0;3;10
11294;Saulėtekis;PAGRANDUKAS;7164579375;Ne;0;1;0;1
11295;Saulėtekis;PAGRANDUKAS;8574702901;Taip;5;1;0;6
11296;Saulėtekis;PAGRANDUKAS;9941731250;Taip;0;0;3;3
11297;Saulėtekis;PAGRANDUKAS;4038684284;Ne;9;0;1;10
11298;Saulėtekis;PAGRANDUKAS;2935641362;Taip;0;15;0;15
11299;Saulėtekis;PAGRANDUKAS;4676218435;Ne;0;1;1;2
11300;Saulėtekis;PAGRANDUKAS;7598254324;Taip;18;0;4;22
11301;Saulėtekis;PAGRANDUKAS;6026600803;Taip;5;1;1;7
11302;Saulėtekis;PAGRANDUKAS;9737568538;Taip;10;0;1;11
11303;Saulėtekis;PAGRANDUKAS;8468491266;Taip;7;0;1;8
11304;Saulėtekis;PAGRANDUKAS;6181992249;Ne;5;0;2;7
11305;Saulėtekis;PAGRANDUKAS;8390615573;Taip;4;0;0;4
11306;Saulėtekis;PAGRANDUKAS;3366064429;Ne;11;1;0;12
11307;Saulėtekis;PAGRANDUKAS;5824537129;Taip;8;0;6;14
11308;Saulėtekis;RAMUNĖLIŲ;8739919774;Taip;14;6;0;20
11309;Saulėtekis;RAMUNĖLIŲ;4681031693;Taip;9;3;1;13
11310;Saulėtekis;RAMUNĖLIŲ;2316817605;Taip;3;0;0;3
11311;Saulėtekis;RAMUNĖLIŲ;3987535802;Taip;13;0;1;14
11312;Saulėtekis;RAMUNĖLIŲ;5297650157;Taip;9;1;0;10
11313;Saulėtekis;RAMUNĖLIŲ;6979741482;Taip;4;0;1;5
11314;Saulėtekis;RAMUNĖLIŲ;8348456528;Taip;10;1;0;11
11315;Saulėtekis;RAMUNĖLIŲ;3430209353;Taip;10;2;0;12
11316;Saulėtekis;RAMUNĖLIŲ;5980690239;Taip;12;1;0;13
11317;Saulėtekis;RAMUNĖLIŲ;2786112846;Taip;9;2;0;11
11318;Saulėtekis;RAMUNĖLIŲ;8876580678;Taip;9;2;0;11
11319;Saulėtekis;RAMUNĖLIŲ;1427323748;Taip;0;0;7;7
11320;Saulėtekis;RAMUNĖLIŲ;3224110585;Taip;19;0;0;19
11321;Saulėtekis;RAMUNĖLIŲ;2002180753;Taip;17;0;2;19
11322;Saulėtekis;RAMUNĖLIŲ;5685176596;Taip;4;1;0;5
11323;Saulėtekis;RAMUNĖLIŲ;9668125862;Taip;8;0;1;9
11324;Saulėtekis;RAMUNĖLIŲ;4736430248;Taip;9;8;0;17
11325;Saulėtekis;RAMUNĖLIŲ;1108736588;Ne;11;0;1;12
11326;Saulėtekis;RAMUNĖLIŲ;3680199463;Taip;10;1;3;14
11327;Saulėtekis;RAMUNĖLIŲ;2383861394;Taip;0;15;0;15
11328;Saulėtekis;RAMUNĖLIŲ;2872732978;Taip;4;10;0;14
11329;Saulėtekis;PASAKAITĖ;8033763960;Taip;16;1;0;17
11330;Saulėtekis;PASAKAITĖ;9428709415;Taip;1;1;0;2
11331;Saulėtekis;PASAKAITĖ;5086871001;Taip;16;0;0;16
11332;Saulėtekis;PASAKAITĖ;2446282019;Taip;0;8;0;8
11333;Saulėtekis;PASAKAITĖ;8572701238;Taip;0;8;0;8
11334;Saulėtekis;PASAKAITĖ;6063956790;Taip;1;5;0;6
11335;Saulėtekis;PASAKAITĖ;4437540996;Taip;22;0;0;22
11336;Saulėtekis;PASAKAITĖ;7407451018;Taip;0;7;0;7
11337;Saulėtekis;PASAKAITĖ;9226317303;Taip;0;3;0;3
11338;Saulėtekis;PASAKAITĖ;9267790598;Taip;14;3;0;17
11339;Saulėtekis;PASAKAITĖ;6670590135;Taip;4;6;0;10
11340;Saulėtekis;PASAKAITĖ;6720758829;Taip;8;1;0;9
11341;Saulėtekis;PASAKAITĖ;7966714585;Taip;1;0;0;1
11342;Saulėtekis;PASAKAITĖ;3224883243;Taip;9;4;0;13
11343;Saulėtekis;PASAKAITĖ;9382031144;Taip;12;2;0;14
11344;Saulėtekis;PASAKAITĖ;3371914339;Taip;9;4;0;13
11345;Saulėtekis;PASAKAITĖ;6214539956;Taip;4;5;0;9
11346;Saulėtekis;PASAKAITĖ;9584556476;Taip;12;0;0;12
11347;Saulėtekis;PASAKAITĖ;9799880235;Taip;11;0;0;11
11348;Saulėtekis;PASAKAITĖ;2469458604;Taip;10;2;0;12
11349;Saulėtekis;PASAKAITĖ;3499575148;Taip;10;3;0;13
11350;Saulėtekis;PASAKAITĖ;2206038658;Taip;7;0;0;7
11351;Saulėtekis;VARPELIAI;3303064486;Taip;13;0;5;18
11352;Saulėtekis;VARPELIAI;1355354514;Taip;7;0;0;7
11353;Saulėtekis;VARPELIAI;8195320453;Ne;5;0;2;7
11354;Saulėtekis;VARPELIAI;6534433593;Taip;9;0;1;10
11355;Saulėtekis;VARPELIAI;5997903066;Taip;9;0;4;13
11356;Saulėtekis;VARPELIAI;7338301696;Taip;0;4;1;5
11357;Saulėtekis;VARPELIAI;9383203972;Taip;6;0;0;6
11358;Saulėtekis;VARPELIAI;5870177112;Taip;5;0;0;5
11359;Saulėtekis;VARPELIAI;7171550857;Taip;8;0;6;14
11360;Saulėtekis;VARPELIAI;3157110037;Taip;8;0;14;22
11361;Saulėtekis;VARPELIAI;8331659142;Ne;13;6;3;22
11362;Saulėtekis;VARPELIAI;3832717108;Taip;13;0;5;18
11363;Saulėtekis;VARPELIAI;1198692142;Taip;13;0;0;13
11364;Saulėtekis;VARPELIAI;1240595768;Taip;9;0;1;10
11365;Saulėtekis;VARPELIAI;9246555859;Taip;12;1;3;16
11366;Saulėtekis;VARPELIAI;1479530265;Taip;8;1;2;11
11367;Saulėtekis;VARPELIAI;1164913351;Taip;11;1;1;13
11368;Saulėtekis;VARPELIAI;3499215193;Taip;8;0;0;8
11369;Saulėtekis;GRŪDELIS;1864236745;Taip;15;1;0;16
11370;Saulėtekis;GRŪDELIS;7171048750;Taip;3;0;0;3
11371;Saulėtekis;GRŪDELIS;6535620172;Taip;13;0;4;17
11372;Saulėtekis;GRŪDELIS;8252953405;Ne;15;1;2;18
11373;Saulėtekis;GRŪDELIS;8219644557;Taip;10;0;4;14
11374;Saulėtekis;GRŪDELIS;5161940030;Taip;0;5;1;6
11375;Saulėtekis;GRŪDELIS;5218345414;Taip;10;0;0;10
11376;Saulėtekis;GRŪDELIS;9646060606;Taip;5;5;1;11
11377;Saulėtekis;GRŪDELIS;1934900185;Ne;15;6;0;21
11378;Saulėtekis;GRŪDELIS;1331793286;Taip;10;1;8;19
11379;Saulėtekis;GRŪDELIS;9995919137;Taip;10;3;0;13
11380;Saulėtekis;GRŪDELIS;6928825133;Taip;1;0;0;1
11381;Saulėtekis;GRŪDELIS;8138047893;Taip;7;0;3;10
11382;Saulėtekis;GRŪDELIS;3953501167;Taip;10;2;0;12
11383;Saulėtekis;GRŪDELIS;2799966199;Taip;0;0;1;1
11384;Saulėtekis;GRŪDELIS;2646213073;Taip;8;0;3;11
11385;Saulėtekis;GRŪDELIS;6482182524;Taip;7;1;0;8
11386;Saulėtekis;GRŪDELIS;6779891385;Taip;7;1;0;8
11387;Saulėtekis;GRŪDELIS;9743690247;Taip;18;0;0;18
11388;Saulėtekis;GRŪDELIS;7666624373;Taip;13;0;1;14
11389;Saulėtekis;JONVABALIS;1715634399;Taip;18;1;0;19
11390;Saulėtekis;JONVABALIS;7227802003;Taip;0;1;0;1
11391;Saulėtekis;JONVABALIS;4613040294;Taip;5;1;0;6
11392;Saulėtekis;JONVABALIS;1655720839;Taip;7;2;0;9
11393;Saulėtekis;JONVABALIS;3166181835;Taip;2;3;0;5
11394;Saulėtekis;JONVABALIS;6599452886;Taip;5;3;0;8
11395;Saulėtekis;JONVABALIS;8896065807;Taip;18;2;0;20
11396;Saulėtekis;JONVABALIS;3207128776;Taip;0;1;0;1
11397;Saulėtekis;JONVABALIS;2311184444;Taip;8;4;0;12
11398;Saulėtekis;JONVABALIS;9618342480;Taip;17;0;0;17
11399;Saulėtekis;JONVABALIS;1516164123;Taip;7;1;0;8
11400;Saulėtekis;JONVABALIS;60462712074;Taip;0;7;0;7
11401;Saulėtekis;JONVABALIS;1902333363;Taip;0;1;0;1
11402;Saulėtekis;JONVABALIS;4610536784;Ne;0;4;0;4
11403;Saulėtekis;JONVABALIS;8239855620;Taip;0;1;0;1
11404;Saulėtekis;JONVABALIS;6501250875;Taip;12;2;0;14
11405;Saulėtekis;JONVABALIS;8231869593;Taip;0;13;0;13
11406;Saulėtekis;JONVABALIS;8603952810;Taip;7;1;0;8
11407;Saulėtekis;JONVABALIS;9657195627;Taip;0;4;0;4
11408;Saulėtekis;JONVABALIS;3541535891;Taip;2;6;0;8
11409;Saulėtekis;JONVABALIS;4663268649;Taip;9;2;0;11
11410;Saulėtekis;JONVABALIS;25199011812;Taip;0;3;0;3
11411;Saulėtekis;SMALSUČIAI;2474900044;Taip;6;0;2;8
11412;Saulėtekis;SMALSUČIAI;7051608858;Taip;9;0;0;9
11413;Saulėtekis;SMALSUČIAI;2021901593;Taip;11;1;0;12
11414;Saulėtekis;SMALSUČIAI;5954194843;Taip;1;1;0;2
11415;Saulėtekis;SMALSUČIAI;2546789906;Taip;5;0;0;5
11416;Saulėtekis;SMALSUČIAI;8002806189;Taip;9;0;0;9
11417;Saulėtekis;SMALSUČIAI;4832534190;Taip;13;0;0;13
11418;Saulėtekis;SMALSUČIAI;2238947856;Taip;0;2;7;9
11419;Saulėtekis;SMALSUČIAI;5678858566;Taip;3;5;0;8
11420;Saulėtekis;SMALSUČIAI;2407911405;Taip;0;1;1;2
11421;Saulėtekis;SMALSUČIAI;9634949452;Taip;3;0;1;4
11422;Saulėtekis;SMALSUČIAI;3450907715;Ne;18;2;0;20
11423;Saulėtekis;SMALSUČIAI;4338502152;Taip;2;0;0;2
11424;Saulėtekis;SMALSUČIAI;81153273188;Taip;11;1;0;12
11425;Saulėtekis;SMALSUČIAI;6102064617;Taip;0;1;0;1
11426;Saulėtekis;SMALSUČIAI;7842280836;Taip;10;1;0;11
11427;Saulėtekis;SMALSUČIAI;9945647968;Taip;4;4;0;8
11428;Saulėtekis;SMALSUČIAI;9983577817;Taip;6;0;1;7
11429;Saulėtekis;SMALSUČIAI;84982517658;Taip;0;0;1;1
11430;Saulėtekis;SMALSUČIAI;5487547105;Ne;0;22;0;22
11431;Saulėtekis;SMALSUČIAI;1922979974;Taip;7;0;0;7
11432;Saulėtekis;BITUTĖS;7766084857;Taip;0;1;0;1
11433;Saulėtekis;BITUTĖS;4537254306;Taip;12;0;0;12
11434;Saulėtekis;BITUTĖS;1699576940;Ne;0;0;2;2
11435;Saulėtekis;BITUTĖS;8302260087;Taip;13;1;1;15
11436;Saulėtekis;BITUTĖS;2593106154;Taip;0;0;2;2
11437;Saulėtekis;BITUTĖS;2813949848;Taip;0;5;0;5
11438;Saulėtekis;BITUTĖS;6643388548;Taip;5;0;1;6
11439;Saulėtekis;BITUTĖS;3058991890;Taip;4;0;1;5
11440;Saulėtekis;BITUTĖS;7986712728;Taip;0;8;0;8
11441;Saulėtekis;BITUTĖS;6087170055;Ne;4;0;3;7
11442;Saulėtekis;BITUTĖS;7758268674;Taip;9;0;1;10
11443;Saulėtekis;BITUTĖS;2077976415;Ne;9;1;3;13
11444;Saulėtekis;BITUTĖS;7075757274;Taip;11;8;0;19
11445;Saulėtekis;BITUTĖS;9870595577;Taip;4;0;0;4
11446;Saulėtekis;BITUTĖS;2154590089;Taip;4;5;0;9
11447;Saulėtekis;BITUTĖS;3220993253;Taip;4;1;1;6
11448;Saulėtekis;BITUTĖS;9918219913;Taip;3;1;4;8
11449;Saulėtekis;BITUTĖS;2698535938;Taip;0;2;2;4
11450;Saulėtekis;BITUTĖS;8517049464;Taip;5;1;0;6
11451;Saulėtekis;BITUTĖS;2656659133;Ne;4;4;0;8
11452;Saulėtekis;BITUTĖS;7027103276;Taip;0;1;1;2
11453;Saulėtekis;BITUTĖS;9605052795;Taip;0;1;9;10
11454;Saulėtekis;RIEŠUTĖLIAI;8767786444;Taip;9;0;1;10
11455;Saulėtekis;RIEŠUTĖLIAI;2224626144;Taip;19;0;0;19
11456;Saulėtekis;RIEŠUTĖLIAI;9270231819;Taip;8;5;1;14
11457;Saulėtekis;RIEŠUTĖLIAI;5898051775;Taip;10;0;0;10
11458;Saulėtekis;RIEŠUTĖLIAI;7898928446;Taip;5;0;0;5
11459;Saulėtekis;RIEŠUTĖLIAI;3356705340;Taip;18;0;4;22
11460;Saulėtekis;RIEŠUTĖLIAI;2849915655;Taip;10;0;1;11
11461;Saulėtekis;RIEŠUTĖLIAI;7824492464;Taip;3;0;0;3
11462;Saulėtekis;RIEŠUTĖLIAI;3935935671;Taip;6;0;0;6
11463;Saulėtekis;RIEŠUTĖLIAI;7807096583;Taip;9;0;1;10
11464;Saulėtekis;RIEŠUTĖLIAI;2548612572;Taip;17;0;1;18
11465;Saulėtekis;RIEŠUTĖLIAI;2908714227;Taip;18;0;0;18
11466;Saulėtekis;RIEŠUTĖLIAI;7305619721;Taip;0;19;0;19
11467;Saulėtekis;RIEŠUTĖLIAI;9516841263;Taip;7;0;1;8
11468;Saulėtekis;RIEŠUTĖLIAI;6557482092;Taip;8;0;0;8
11469;Saulėtekis;RIEŠUTĖLIAI;6183384994;Ne;18;0;0;18
11470;Saulėtekis;RIEŠUTĖLIAI;3559882322;Taip;3;0;2;5
11471;Saulėtekis;RIEŠUTĖLIAI;4767842376;Taip;8;0;3;11
11472;Skroblinukas;SVIRPLIUKŲ;2195112297;Taip;0;2;12;14
11473;Skroblinukas;SVIRPLIUKŲ;4198512202;Taip;32;0;0;32
11474;Skroblinukas;SVIRPLIUKŲ;7750501815;Taip;17;0;5;22
11475;Skroblinukas;SVIRPLIUKŲ;4960825597;Taip;12;7;0;19
11476;Skroblinukas;SVIRPLIUKŲ;1544598440;Taip;12;1;0;13
11477;Skroblinukas;SVIRPLIUKŲ;6574558658;Ne;11;1;3;15
11478;Skroblinukas;SVIRPLIUKŲ;4861971439;Taip;8;2;1;11
11479;Skroblinukas;SVIRPLIUKŲ;7817632987;Ne;7;4;5;16
11480;Skroblinukas;SVIRPLIUKŲ;7675772872;Ne;7;0;2;9
11481;Skroblinukas;SVIRPLIUKŲ;4266945644;Taip;11;0;7;18
11482;Skroblinukas;SVIRPLIUKŲ;9003855190;Ne;0;24;1;25
11483;Skroblinukas;SVIRPLIUKŲ;7216760382;Taip;18;0;0;18
11484;Skroblinukas;SVIRPLIUKŲ;5154111867;Taip;9;7;0;16
11485;Skroblinukas;SVIRPLIUKŲ;8622930871;Taip;20;0;12;32
11486;Skroblinukas;SVIRPLIUKŲ;9661609284;Taip;0;0;1;1
11487;Skroblinukas;SVIRPLIUKŲ;3260267388;Taip;13;0;2;15
11488;Skroblinukas;SVIRPLIUKŲ;7761972818;Taip;19;0;0;19
11489;Skroblinukas;SVIRPLIUKŲ;9629502585;Taip;18;3;0;21
11490;Skroblinukas;SVIRPLIUKŲ;6461678336;Taip;16;0;2;18
11491;Skroblinukas;SVIRPLIUKŲ;8283516422;Taip;5;0;6;11
11492;Skroblinukas;GANDRIUKŲ;2406619611;Taip;0;2;0;2
11493;Skroblinukas;GANDRIUKŲ;9572912046;Taip;0;5;0;5
11494;Skroblinukas;GANDRIUKŲ;5646847921;Taip;15;3;0;18
11495;Skroblinukas;GANDRIUKŲ;1851920334;Taip;10;0;0;10
11496;Skroblinukas;GANDRIUKŲ;6235844690;Taip;6;0;0;6
11497;Skroblinukas;GANDRIUKŲ;6489976163;Taip;10;0;3;13
11498;Skroblinukas;GANDRIUKŲ;1159546580;Taip;0;4;2;6
11499;Skroblinukas;GANDRIUKŲ;2630699296;Taip;0;5;0;5
11500;Skroblinukas;GANDRIUKŲ;2310750833;Taip;5;4;3;12
11501;Skroblinukas;GANDRIUKŲ;9888115079;Ne;5;3;0;8
11502;Skroblinukas;GANDRIUKŲ;9475514959;Ne;0;5;0;5
11503;Skroblinukas;GANDRIUKŲ;9031598603;Taip;13;0;0;13
11504;Skroblinukas;GANDRIUKŲ;5251903769;Ne;5;11;0;16
11505;Skroblinukas;GANDRIUKŲ;7385271438;Taip;7;1;2;10
11506;Skroblinukas;VYTURIUKŲ;3954228349;Taip;0;0;9;9
11507;Skroblinukas;VYTURIUKŲ;6879979868;Taip;0;1;4;5
11508;Skroblinukas;VYTURIUKŲ;4560580022;Taip;0;0;4;4
11509;Skroblinukas;VYTURIUKŲ;3065235192;Ne;10;0;4;14
11510;Skroblinukas;VYTURIUKŲ;5902713448;Taip;0;10;0;10
11511;Skroblinukas;VYTURIUKŲ;3594000419;Taip;5;7;0;12
11512;Skroblinukas;VYTURIUKŲ;3512297435;Taip;5;7;0;12
11513;Skroblinukas;VYTURIUKŲ;2481980627;Taip;5;0;0;5
11514;Skroblinukas;VYTURIUKŲ;6293879765;Taip;0;0;1;1
11515;Skroblinukas;VYTURIUKŲ;9725125130;Taip;0;1;0;1
11516;Skroblinukas;VYTURIUKŲ;2978284436;Taip;0;0;9;9
11517;Skroblinukas;VYTURIUKŲ;7068452970;Ne;0;0;4;4
11518;Skroblinukas;VYTURIUKŲ;3292517112;Taip;5;1;1;7
11519;Skroblinukas;VYTURIUKŲ;3461165182;Taip;0;14;18;32
11520;Skroblinukas;VYTURIUKŲ;4129726208;Taip;12;0;0;12
11521;Skroblinukas;VYTURIUKŲ;3351309750;Ne;0;0;2;2
11522;Skroblinukas;VYTURIUKŲ;5101136022;Ne;0;1;10;11
11523;Skroblinukas;GENIUKŲ;48655837755;Taip;0;1;5;6
11524;Skroblinukas;GENIUKŲ;2323980730;Taip;0;0;1;1
11525;Skroblinukas;GENIUKŲ;1325903217;Taip;0;5;0;5
11526;Skroblinukas;GENIUKŲ;8380073853;Taip;7;11;5;23
11527;Skroblinukas;GENIUKŲ;4436698905;Taip;0;32;0;32
11528;Skroblinukas;GENIUKŲ;1905085978;Taip;0;0;13;13
11529;Skroblinukas;GENIUKŲ;1557733803;Taip;0;20;0;20
11530;Skroblinukas;GENIUKŲ;9433465007;Taip;0;5;0;5
11531;Skroblinukas;GENIUKŲ;1395950886;Ne;4;1;1;6
11532;Skroblinukas;GENIUKŲ;1696303051;Taip;8;0;0;8
11533;Skroblinukas;GENIUKŲ;9846569195;Taip;6;1;7;14
11534;Skroblinukas;GENIUKŲ;4773576465;Ne;0;2;2;4
11535;Skroblinukas;GENIUKŲ;2704157855;Taip;0;6;2;8
11536;Skroblinukas;GENIUKŲ;9564385215;Taip;0;10;2;12
11537;Skroblinukas;GENIUKŲ;6129591146;Taip;0;6;1;7
11538;Skroblinukas;GENIUKŲ;3128337104;Taip;0;1;3;4
11539;Skroblinukas;GENIUKŲ;4272941994;Taip;0;3;1;4
11540;Skroblinukas;GENIUKŲ;3864043251;Taip;9;3;5;17
11541;Skroblinukas;GENIUKŲ;1064449916;Taip;0;1;9;10
11542;Skroblinukas;GENIUKŲ;2071447940;Taip;13;3;0;16
11543;Skroblinukas;BITUČIŲ;1255323441;Taip;0;1;1;2
11544;Skroblinukas;BITUČIŲ;1934804499;Taip;6;2;0;8
11545;Skroblinukas;BITUČIŲ;2134821488;Taip;15;0;0;15
11546;Skroblinukas;BITUČIŲ;6604496585;Taip;0;5;0;5
11547;Skroblinukas;BITUČIŲ;3736883850;Taip;5;2;0;7
11548;Skroblinukas;BITUČIŲ;7191689856;Taip;9;4;0;13
11549;Skroblinukas;BITUČIŲ;8778072326;Taip;8;0;0;8
11550;Skroblinukas;BITUČIŲ;2032621707;Ne;0;2;5;7
11551;Skroblinukas;BITUČIŲ;8277152812;Taip;0;10;0;10
11552;Skroblinukas;BITUČIŲ;8374103872;Taip;5;1;0;6
11553;Skroblinukas;BITUČIŲ;8618587013;Taip;0;9;0;9
11554;Skroblinukas;BITUČIŲ;4945107862;Ne;0;1;3;4
11555;Skroblinukas;BITUČIŲ;9594078223;Taip;0;4;0;4
11556;Skroblinukas;BITUČIŲ;1688990637;Taip;6;0;1;7
11557;Skroblinukas;BITUČIŲ;1957488412;Taip;0;1;0;1
11558;Skroblinukas;BITUČIŲ;1000804920;Taip;12;0;0;12
11559;Skroblinukas;BITUČIŲ;1711568129;Ne;5;8;1;14
11560;Skroblinukas;BITUČIŲ;1293348150;Taip;0;1;1;2
11561;Skroblinukas;BITUČIŲ;9664357125;Taip;0;1;7;8
11562;Skroblinukas;BITUČIŲ;5001921323;Taip;15;0;0;15
11563;Skroblinukas;BITUČIŲ;6227583229;Taip;4;3;0;7
11564;Skroblinukas;BORUŽĖLIŲ;8715188878;Taip;15;10;6;31
11565;Skroblinukas;BORUŽĖLIŲ;4688496560;Taip;0;0;5;5
11566;Skroblinukas;BORUŽĖLIŲ;7407601996;Taip;0;0;1;1
11567;Skroblinukas;BORUŽĖLIŲ;7255510731;Taip;0;0;2;2
11568;Skroblinukas;BORUŽĖLIŲ;5841866621;Taip;5;0;0;5
11569;Skroblinukas;BORUŽĖLIŲ;9341501143;Taip;8;0;0;8
11570;Skroblinukas;BORUŽĖLIŲ;2523742608;Taip;10;5;0;15
11571;Skroblinukas;BORUŽĖLIŲ;2311459579;Taip;10;5;0;15
11572;Skroblinukas;BORUŽĖLIŲ;3490684777;Taip;14;0;0;14
11573;Skroblinukas;BORUŽĖLIŲ;2717586232;Taip;8;3;0;11
11574;Skroblinukas;BORUŽĖLIŲ;4840767748;Taip;0;4;0;4
11575;Skroblinukas;BORUŽĖLIŲ;5694105568;Taip;13;0;2;15
11576;Skroblinukas;BORUŽĖLIŲ;4631657273;Taip;16;0;0;16
11577;Skroblinukas;BORUŽĖLIŲ;8711201474;Ne;0;1;6;7
11578;Skroblinukas;SKRUZDĖLIUKŲ;5688453546;Taip;0;3;0;3
11579;Skroblinukas;SKRUZDĖLIUKŲ;6890306112;Taip;9;1;0;10
11580;Skroblinukas;SKRUZDĖLIUKŲ;6445065388;Taip;9;6;0;15
11581;Skroblinukas;SKRUZDĖLIUKŲ;3006521657;Taip;5;2;0;7
11582;Skroblinukas;SKRUZDĖLIUKŲ;9448253468;Taip;10;0;0;10
11583;Skroblinukas;SKRUZDĖLIUKŲ;3771045336;Taip;6;2;0;8
11584;Skroblinukas;SKRUZDĖLIUKŲ;4424763028;Taip;0;6;0;6
11585;Skroblinukas;SKRUZDĖLIUKŲ;9353353289;Taip;15;2;1;18
11586;Skroblinukas;SKRUZDĖLIUKŲ;5252389111;Ne;14;0;0;14
11587;Skroblinukas;SKRUZDĖLIUKŲ;2883593274;Taip;8;0;0;8
11588;Skroblinukas;SKRUZDĖLIUKŲ;5157913924;Taip;2;9;0;11
11589;Skroblinukas;SKRUZDĖLIUKŲ;9368764758;Taip;8;2;0;10
11590;Skroblinukas;SKRUZDĖLIUKŲ;9958188318;Taip;15;1;0;16
11591;Skroblinukas;SKRUZDĖLIUKŲ;8576448571;Taip;4;10;0;14
11592;Skroblinukas;SKRUZDĖLIUKŲ;1002570367;Ne;0;3;0;3
11593;Skroblinukas;SKRUZDĖLIUKŲ;3290115134;Taip;5;2;0;7
11594;Skroblinukas;SKRUZDĖLIUKŲ;9813249677;Ne;20;2;0;22
11595;Skroblinukas;SKRUZDĖLIUKŲ;2101748012;Taip;8;3;0;11
11596;Skroblinukas;SKRUZDĖLIUKŲ;2706526326;Ne;11;0;0;11
11597;Skroblinukas;SKRUZDĖLIUKŲ;5915278745;Taip;16;0;0;16
11598;Skroblinukas;SKRUZDĖLIUKŲ;6640062847;Ne;11;2;2;15
11599;Skroblinukas;ŽVIRBLIUKŲ;7955574061;Taip;8;3;0;11
11600;Skroblinukas;ŽVIRBLIUKŲ;1232121301;Ne;18;1;0;19
11601;Skroblinukas;ŽVIRBLIUKŲ;1014993354;Taip;4;0;0;4
11602;Skroblinukas;ŽVIRBLIUKŲ;7527177120;Taip;10;5;0;15
11603;Skroblinukas;ŽVIRBLIUKŲ;4002729040;Taip;11;0;0;11
11604;Skroblinukas;ŽVIRBLIUKŲ;4197050176;Taip;0;9;0;9
11605;Skroblinukas;ŽVIRBLIUKŲ;4390614970;Taip;14;0;0;14
11606;Skroblinukas;ŽVIRBLIUKŲ;6135412007;Taip;13;0;6;19
11607;Skroblinukas;ŽVIRBLIUKŲ;2312400921;Taip;13;0;6;19
11608;Skroblinukas;ŽVIRBLIUKŲ;4491947846;Taip;14;2;0;16
11609;Skroblinukas;ŽVIRBLIUKŲ;7804920443;Taip;10;0;0;10
11610;Skroblinukas;ŽIOGELIŲ;2885814517;Taip;3;4;0;7
11611;Skroblinukas;ŽIOGELIŲ;2363368201;Taip;8;0;0;8
11612;Skroblinukas;ŽIOGELIŲ;4639384934;Taip;8;0;0;8
11613;Skroblinukas;ŽIOGELIŲ;5206925237;Taip;8;0;10;18
11614;Skroblinukas;ŽIOGELIŲ;7581372511;Taip;11;0;3;14
11615;Skroblinukas;ŽIOGELIŲ;6279909049;Taip;5;0;2;7
11616;Skroblinukas;ŽIOGELIŲ;8998236911;Taip;11;0;0;11
11617;Skroblinukas;ŽIOGELIŲ;6791969485;Taip;19;0;1;20
11618;Skroblinukas;ŽIOGELIŲ;9737310101;Taip;0;0;9;9
11619;Skroblinukas;ŽIOGELIŲ;8680329175;Taip;17;0;0;17
11620;Skroblinukas;ŽIOGELIŲ;7028068342;Taip;4;0;6;10
11621;Skroblinukas;ŽIOGELIŲ;8118284793;Taip;3;0;0;3
11622;Skroblinukas;ŽIOGELIŲ;1844211217;Taip;0;7;1;8
11623;Skroblinukas;ŽIOGELIŲ;5354832150;Taip;0;1;0;1
11624;Skroblinukas;ŽIOGELIŲ;3689247672;Taip;4;1;0;5
11625;Skroblinukas;STRAZDELIŲ;1820748152;Taip;9;3;1;13
11626;Skroblinukas;STRAZDELIŲ;5946356374;Taip;18;0;0;18
11627;Skroblinukas;STRAZDELIŲ;5274898590;Taip;0;8;0;8
11628;Skroblinukas;STRAZDELIŲ;8629189405;Ne;0;0;2;2
11629;Skroblinukas;STRAZDELIŲ;4091852305;Taip;8;5;0;13
11630;Skroblinukas;STRAZDELIŲ;9809817630;Taip;28;0;1;29
11631;Skroblinukas;STRAZDELIŲ;6475609065;Taip;6;0;0;6
11632;Skroblinukas;STRAZDELIŲ;3705638869;Taip;10;0;0;10
11633;Skroblinukas;STRAZDELIŲ;2511496284;Taip;23;0;0;23
11634;Skroblinukas;STRAZDELIŲ;7153774246;Ne;11;5;0;16
11635;Skroblinukas;STRAZDELIŲ;7045587415;Taip;10;0;5;15
11636;Skroblinukas;STRAZDELIŲ;8734405028;Taip;0;7;0;7
11637;Skroblinukas;STRAZDELIŲ;3885884265;Taip;22;0;1;23
11638;Skroblinukas;STRAZDELIŲ;8544069746;Taip;8;3;0;11
11639;Skroblinukas;STRAZDELIŲ;6011466024;Ne;9;0;0;9
11640;Skroblinukas;DRUGELIŲ;8305867345;Taip;15;0;1;16
11641;Skroblinukas;DRUGELIŲ;7400908711;Ne;10;9;3;22
11642;Skroblinukas;DRUGELIŲ;3889890374;Taip;8;4;0;12
11643;Skroblinukas;DRUGELIŲ;9481718833;Taip;12;0;0;12
11644;Skroblinukas;DRUGELIŲ;8864594520;Ne;12;0;2;14
11645;Skroblinukas;DRUGELIŲ;2772360168;Taip;7;3;0;10
11646;Skroblinukas;DRUGELIŲ;3624518310;Taip;8;1;0;9
11647;Skroblinukas;DRUGELIŲ;4831370981;Taip;0;4;0;4
11648;Skroblinukas;DRUGELIŲ;5957417413;Taip;20;3;0;23
11649;Skroblinukas;DRUGELIŲ;3226115050;Taip;30;0;0;30
11650;Skroblinukas;DRUGELIŲ;2887161771;Taip;14;0;0;14
11651;Skroblinukas;DRUGELIŲ;4737605061;Ne;0;17;7;24
11652;Skroblinukas;DRUGELIŲ;3046542264;Taip;4;0;0;4
11653;Skroblinukas;DRUGELIŲ;8390240445;Taip;10;0;1;11
11654;Skroblinukas;DRUGELIŲ;2948231687;Taip;11;0;3;14
11655;Skroblinukas;DRUGELIŲ;5912771080;Taip;13;0;0;13
11656;Skroblinukas;DRUGELIŲ;7528824951;Ne;0;0;5;5
11657;Skroblinukas;DRUGELIŲ;2987938909;Taip;1;13;5;19
11658;Skroblinukas;DRUGELIŲ;8064713969;Taip;10;0;0;10
11659;Skroblinukas;DRUGELIŲ;8286842648;Taip;0;2;1;3
11660;Skroblinukas;DRUGELIŲ;1453029732;Taip;14;0;0;14
11661;Skroblinukas;PELĖDŽIUKŲ;8953844650;Ne;7;1;0;8
11662;Skroblinukas;PELĖDŽIUKŲ;5813075721;Taip;14;0;1;15
11663;Skroblinukas;PELĖDŽIUKŲ;3646325903;Taip;10;7;0;17
11664;Skroblinukas;PELĖDŽIUKŲ;9292990596;Ne;14;0;0;14
11665;Skroblinukas;PELĖDŽIUKŲ;8202855376;Ne;14;11;7;32
11666;Skroblinukas;PELĖDŽIUKŲ;8312341293;Taip;0;0;3;3
11667;Skroblinukas;PELĖDŽIUKŲ;3658815079;Taip;18;0;0;18
11668;Skroblinukas;PELĖDŽIUKŲ;5418212729;Taip;8;2;0;10
11669;Skroblinukas;PELĖDŽIUKŲ;4168542339;Taip;10;0;0;10
11670;Skroblinukas;PELĖDŽIUKŲ;8958893525;Taip;10;0;1;11
11671;Skroblinukas;PELĖDŽIUKŲ;6675716937;Taip;0;0;1;1
11672;Skroblinukas;PELĖDŽIUKŲ;1009065470;Ne;0;13;0;13
11673;Skroblinukas;PELĖDŽIUKŲ;9699407871;Taip;8;1;0;9
11674;Skroblinukas;PELĖDŽIUKŲ;9553242594;Taip;17;0;0;17
11675;Skroblinukas;PELĖDŽIUKŲ;4802801867;Ne;13;1;0;14
11676;Skroblinukas;PELĖDŽIUKŲ;3532258904;Ne;18;1;0;19
11677;Skroblinukas;PELĖDŽIUKŲ;8465074037;Taip;0;0;20;20
11678;Skroblinukas;PELĖDŽIUKŲ;2071093890;Taip;11;1;2;14
11679;Skroblinukas;PELĖDŽIUKŲ;9523720873;Taip;14;0;11;25
11680;Skroblinukas;PELĖDŽIUKŲ;7920117036;Taip;32;0;0;32
11681;Skroblinukas;PELĖDŽIUKŲ;2215428081;Taip;6;9;0;15
11682;Smalsučiai;Žibuoklės;6535494814;Taip;11;0;1;12
11683;Smalsučiai;Žibuoklės;3309134310;Taip;0;2;0;2
11684;Smalsučiai;Žibuoklės;2326167599;Taip;4;7;0;11
11685;Smalsučiai;Žibuoklės;4094037708;Taip;5;0;0;5
11686;Smalsučiai;Žibuoklės;5893045664;Taip;0;2;0;2
11687;Smalsučiai;Žibuoklės;5482692473;Taip;13;0;0;13
11688;Smalsučiai;Žibuoklės;2742992400;Taip;10;0;0;10
11689;Smalsučiai;Žibuoklės;6299355505;Ne;4;1;0;5
11690;Smalsučiai;Žibuoklės;3877274360;Ne;14;5;0;19
11691;Smalsučiai;Žibuoklės;7726086066;Taip;0;1;0;1
11692;Smalsučiai;Žibuoklės;9988599126;Taip;11;0;1;12
11693;Smalsučiai;Žibuoklės;5489140006;Taip;5;1;4;10
11694;Smalsučiai;Žibuoklės;5900294530;Ne;8;0;0;8
11695;Smalsučiai;Žibuoklės;1380214235;Taip;8;0;0;8
11696;Smalsučiai;Žibuoklės;8644849194;Taip;16;2;0;18
11697;Smalsučiai;Žibuoklės;4506058735;Taip;14;3;0;17
11698;Smalsučiai;Žibuoklės;6931092874;Taip;9;2;2;13
11699;Smalsučiai;Žibuoklės;3071594259;Taip;10;2;1;13
11700;Smalsučiai;Žibuoklės;7107126092;Taip;10;2;1;13
11701;Smalsučiai;Žibuoklės;7070240693;Taip;0;2;0;2
11702;Smalsučiai;Aitvarų;3349726106;Taip;14;0;0;14
11703;Smalsučiai;Aitvarų;2219168902;Taip;0;0;5;5
11704;Smalsučiai;Aitvarų;9305837033;Taip;14;0;1;15
11705;Smalsučiai;Aitvarų;9305837033;Taip;14;0;1;15
11706;Smalsučiai;Aitvarų;9305837033;Taip;14;0;1;15
11707;Smalsučiai;Aitvarų;8877566394;Taip;0;0;1;1
11708;Smalsučiai;Aitvarų;3888093640;Taip;2;0;2;4
11709;Smalsučiai;Aitvarų;8284740122;Ne;17;0;4;21
11710;Smalsučiai;Aitvarų;1309254661;Taip;0;1;0;1
11711;Smalsučiai;Aitvarų;4154327720;Taip;4;5;1;10
11712;Smalsučiai;Aitvarų;8985656809;Taip;5;0;3;8
11713;Smalsučiai;Aitvarų;6032887449;Taip;0;1;0;1
11714;Smalsučiai;Aitvarų;9821259659;Taip;4;1;0;5
11715;Smalsučiai;Aitvarų;4054278651;Ne;9;0;0;9
11716;Smalsučiai;Aitvarų;6232068532;Ne;4;2;3;9
11717;Smalsučiai;Aitvarų;3157534923;Taip;18;0;5;23
11718;Smalsučiai;Aitvarų;6825499095;Taip;5;0;6;11
11719;Smalsučiai;Aitvarų;4832292565;Taip;1;1;0;2
11720;Smalsučiai;Aitvarų;2835117069;Taip;4;1;0;5
11721;Smalsučiai;Aitvarų;2610753472;Taip;10;0;0;10
11722;Smalsučiai;Aitvarų;6090244401;Taip;4;0;2;6
11723;Smalsučiai;Sraigiukų;7933302912;Taip;0;6;0;6
11724;Smalsučiai;Sraigiukų;1471941426;Taip;5;4;0;9
11725;Smalsučiai;Sraigiukų;1458544456;Ne;7;5;0;12
11726;Smalsučiai;Sraigiukų;5406430393;Taip;8;3;0;11
11727;Smalsučiai;Sraigiukų;9582225178;Taip;10;7;0;17
11728;Smalsučiai;Sraigiukų;9604182559;Ne;0;16;0;16
11729;Smalsučiai;Sraigiukų;6469604093;Taip;2;5;0;7
11730;Smalsučiai;Sraigiukų;4364810458;Taip;5;1;0;6
11731;Smalsučiai;Sraigiukų;4566816316;Taip;5;2;0;7
11732;Smalsučiai;Sraigiukų;5184903287;Taip;9;1;0;10
11733;Smalsučiai;Sraigiukų;4629526320;Taip;6;0;0;6
11734;Smalsučiai;Sraigiukų;4134975456;Taip;13;3;0;16
11735;Smalsučiai;Sraigiukų;7396172351;Taip;8;0;0;8
11736;Smalsučiai;Sraigiukų;6358800570;Taip;9;2;0;11
11737;Smalsučiai;Sraigiukų;2327930850;Taip;5;1;0;6
11738;Smalsučiai;Sraigiukų;3787937467;Taip;0;16;0;16
11739;Smalsučiai;Sraigiukų;4824786207;Taip;4;2;0;6
11740;Smalsučiai;Sraigiukų;3399798448;Taip;9;0;0;9
11741;Smalsučiai;Sraigiukų;1997966082;Taip;10;6;0;16
11742;Smalsučiai;Sraigiukų;4585930202;Taip;1;0;0;1
11743;Smalsučiai;Sraigiukų;9155011285;Taip;3;2;3;8
11744;Smalsučiai;Saulučių;1776385691;Taip;10;0;0;10
11745;Smalsučiai;Saulučių;1162964613;Taip;10;0;5;15
11746;Smalsučiai;Saulučių;9934952886;Taip;7;1;4;12
11747;Smalsučiai;Saulučių;9556433086;Taip;0;8;0;8
11748;Smalsučiai;Saulučių;1904973393;Taip;6;0;0;6
11749;Smalsučiai;Saulučių;3252901131;Taip;0;0;3;3
11750;Smalsučiai;Saulučių;9743116843;Taip;10;0;0;10
11751;Smalsučiai;Saulučių;2392217952;Taip;12;0;2;14
11752;Smalsučiai;Saulučių;1447512509;Taip;22;0;0;22
11753;Smalsučiai;Saulučių;2034284973;Taip;4;3;3;10
11754;Smalsučiai;Saulučių;7049101015;Taip;5;0;2;7
11755;Smalsučiai;Saulučių;9183519167;Taip;11;5;0;16
11756;Smalsučiai;Saulučių;5708986552;Taip;15;0;0;15
11757;Smalsučiai;Saulučių;4889923629;Taip;0;0;4;4
11758;Smalsučiai;Saulučių;8630411244;Taip;18;0;0;18
11759;Smalsučiai;Saulučių;5541908981;Taip;0;0;2;2
11760;Smalsučiai;Viščiukų;6006832443;Taip;0;1;0;1
11761;Smalsučiai;Viščiukų;9864518144;Taip;4;3;0;7
11762;Smalsučiai;Viščiukų;8128348060;Taip;19;0;0;19
11763;Smalsučiai;Viščiukų;4847584492;Ne;11;0;0;11
11764;Smalsučiai;Viščiukų;6415906523;Taip;10;2;0;12
11765;Smalsučiai;Viščiukų;4425714802;Taip;9;0;0;9
11766;Smalsučiai;Viščiukų;9732075162;Taip;4;0;0;4
11767;Smalsučiai;Viščiukų;6090391818;Taip;11;1;0;12
11768;Smalsučiai;Viščiukų;8259056296;Taip;14;0;2;16
11769;Smalsučiai;Viščiukų;9637877396;Taip;18;4;0;22
11770;Smalsučiai;Viščiukų;7137550663;Taip;5;0;2;7
11771;Smalsučiai;Viščiukų;3582805599;Taip;8;0;0;8
11772;Smalsučiai;Viščiukų;3757955200;Taip;21;1;0;22
11773;Smalsučiai;Viščiukų;4288788194;Taip;4;0;0;4
11774;Smalsučiai;Viščiukų;7874635165;Taip;4;1;3;8
11775;Smalsučiai;Viščiukų;5098291946;Ne;7;5;0;12
11776;Smalsučiai;Viščiukų;8578693978;Taip;0;4;0;4
11777;Smalsučiai;Viščiukų;4379645417;Taip;0;8;0;8
11778;Smalsučiai;Viščiukų;5536697307;Taip;17;3;0;20
11779;Smalsučiai;Boružėlių;9426629964;Ne;3;3;0;6
11780;Smalsučiai;Boružėlių;1703679877;Taip;5;0;0;5
11781;Smalsučiai;Boružėlių;2208462326;Taip;19;3;0;22
11782;Smalsučiai;Boružėlių;6643253926;Taip;5;4;0;9
11783;Smalsučiai;Boružėlių;1473016908;Taip;0;2;0;2
11784;Smalsučiai;Boružėlių;7226242747;Ne;5;3;0;8
11785;Smalsučiai;Boružėlių;6085020049;Taip;10;2;0;12
11786;Smalsučiai;Boružėlių;8340768848;Taip;0;3;0;3
11787;Smalsučiai;Boružėlių;6578328053;Taip;7;0;1;8
11788;Smalsučiai;Boružėlių;69450514879;Taip;10;3;0;13
11789;Smalsučiai;Boružėlių;4046718551;Taip;0;0;2;2
11790;Smalsučiai;Boružėlių;2694575252;Taip;8;1;1;10
11791;Smalsučiai;Boružėlių;3063127699;Taip;7;3;0;10
11792;Smalsučiai;Boružėlių;2737886714;Taip;0;7;0;7
11793;Smalsučiai;Boružėlių;8523742213;Ne;11;3;0;14
11794;Smalsučiai;Boružėlių;2034790691;Taip;10;0;0;10
11795;Smalsučiai;Boružėlių;5325706638;Taip;10;6;0;16
11796;Smalsučiai;Boružėlių;9314811354;Taip;0;7;0;7
11797;Smalsučiai;Boružėlių;9196634595;Taip;0;1;1;2
11798;Smalsučiai;Boružėlių;6899040199;Taip;0;3;1;4
11799;Smalsučiai;Zuikių;2802867649;Taip;0;2;0;2
11800;Smalsučiai;Zuikių;96002139110;Taip;0;2;0;2
11801;Smalsučiai;Zuikių;2953239027;Ne;0;7;0;7
11802;Smalsučiai;Zuikių;2638709634;Taip;4;3;0;7
11803;Smalsučiai;Zuikių;9632022271;Taip;0;2;1;3
11804;Smalsučiai;Zuikių;8306946163;Taip;0;6;0;6
11805;Smalsučiai;Zuikių;6469044880;Taip;10;3;0;13
11806;Smalsučiai;Zuikių;99467576480;Taip;0;2;0;2
11807;Smalsučiai;Zuikių;2136420967;Taip;3;1;0;4
11808;Smalsučiai;Zuikių;2059832436;Ne;0;4;0;4
11809;Smalsučiai;Zuikių;1316590100;Taip;0;3;0;3
11810;Smalsučiai;Zuikių;1372591510;Taip;0;3;0;3
11811;Smalsučiai;Zuikių;8810690546;Taip;0;5;0;5
11812;Smalsučiai;Zuikių;9703726869;Taip;4;1;0;5
11813;Smalsučiai;Zuikių;9481692900;Taip;0;6;0;6
11814;Smalsučiai;Zuikių;4909226602;Taip;6;0;1;7
11815;Smalsučiai;Zuikių;6536165801;Taip;0;4;0;4
11816;Smalsučiai;Zuikių;3644256220;Taip;6;4;1;11
11817;Smalsučiai;Nykštukų;9181601713;Taip;0;7;0;7
11818;Smalsučiai;Nykštukų;7637630200;Taip;4;0;0;4
11819;Smalsučiai;Nykštukų;1247774684;Taip;1;7;2;10
11820;Smalsučiai;Nykštukų;2375360937;Taip;10;0;0;10
11821;Smalsučiai;Nykštukų;2015172985;Taip;5;2;0;7
11822;Smalsučiai;Nykštukų;8893480054;Taip;11;1;1;13
11823;Smalsučiai;Nykštukų;6996192450;Taip;15;1;0;16
11824;Smalsučiai;Nykštukų;9378696084;Taip;17;0;3;20
11825;Smalsučiai;Nykštukų;7267389695;Taip;13;0;0;13
11826;Smalsučiai;Nykštukų;6996901033;Ne;10;0;0;10
11827;Smalsučiai;Nykštukų;4847212069;Taip;13;0;1;14
11828;Smalsučiai;Nykštukų;1344461213;Taip;11;0;0;11
11829;Smalsučiai;Nykštukų;1224857159;Taip;9;2;0;11
11830;Smalsučiai;Nykštukų;8690626891;Taip;6;1;0;7
11831;Smalsučiai;Nykštukų;5719056997;Taip;13;3;1;17
11832;Smalsučiai;Nykštukų;3646740184;Ne;19;0;0;19
11833;Smalsučiai;Nykštukų;6642882883;Taip;17;0;3;20
11834;Smalsučiai;Nykštukų;7143824796;Taip;10;0;0;10
11835;Smalsučiai;Nykštukų;1023255628;Ne;9;0;3;12
11836;Smalsučiai;Katinėlių;4760366724;Taip;0;2;0;2
11837;Smalsučiai;Katinėlių;2045283348;Taip;5;3;0;8
11838;Smalsučiai;Katinėlių;4847029162;Taip;9;0;0;9
11839;Smalsučiai;Katinėlių;9710944054;Taip;20;1;0;21
11840;Smalsučiai;Katinėlių;5213319192;Taip;17;0;0;17
11841;Smalsučiai;Katinėlių;3782502443;Ne;0;2;0;2
11842;Smalsučiai;Katinėlių;6358968221;Taip;7;2;0;9
11843;Smalsučiai;Katinėlių;9984878984;Taip;22;0;0;22
11844;Smalsučiai;Katinėlių;2369569130;Taip;9;4;0;13
11845;Smalsučiai;Katinėlių;5535858303;Taip;9;0;1;10
11846;Smalsučiai;Katinėlių;8724759192;Taip;2;0;3;5
11847;Smalsučiai;Katinėlių;2662588310;Ne;10;1;1;12
11848;Smalsučiai;Katinėlių;2668720481;Taip;7;4;0;11
11849;Smalsučiai;Katinėlių;4030955447;Ne;5;9;0;14
11850;Smalsučiai;Katinėlių;2926560092;Taip;10;1;0;11
11851;Smalsučiai;Katinėlių;8210141253;Taip;4;2;0;6
11852;Smalsučiai;Katinėlių;6131743288;Taip;10;0;1;11
11853;Smalsučiai;Katinėlių;7318218997;Taip;20;0;0;20
11854;Smalsučiai;Katinėlių;1331674807;Taip;10;0;2;12
11855;Smalsučiai;PELĖDŽIUKAI;1668692281;Ne;9;1;0;10
11856;Smalsučiai;PELĖDŽIUKAI;7794541741;Taip;0;3;3;6
11857;Smalsučiai;PELĖDŽIUKAI;1181574676;Taip;0;1;0;1
11858;Smalsučiai;PELĖDŽIUKAI;1599488035;Taip;0;1;0;1
11859;Smalsučiai;PELĖDŽIUKAI;4727475042;Ne;4;1;0;5
11860;Smalsučiai;PELĖDŽIUKAI;8520753848;Taip;0;3;0;3
11861;Smalsučiai;PELĖDŽIUKAI;22791221635;Taip;0;3;0;3
11862;Smalsučiai;PELĖDŽIUKAI;3607226859;Taip;10;5;0;15
11863;Smalsučiai;PELĖDŽIUKAI;1467603676;Taip;3;9;0;12
11864;Smalsučiai;PELĖDŽIUKAI;5159799570;Taip;4;8;0;12
11865;Smalsučiai;PELĖDŽIUKAI;19592364606;Ne;0;12;0;12
11866;Smalsučiai;PELĖDŽIUKAI;1824321380;Taip;2;1;2;5
11867;Smalsučiai;PELĖDŽIUKAI;6207026048;Taip;0;1;0;1
11868;Smalsučiai;PELĖDŽIUKAI;4145769042;Taip;0;3;0;3
11869;Smalsučiai;PELĖDŽIUKAI;6529889121;Ne;12;3;0;15
11870;Smalsučiai;PELĖDŽIUKAI;2618753095;Taip;0;1;2;3
11871;Smalsučiai;PELĖDŽIUKAI;1673246147;Taip;0;12;0;12
11872;Smalsučiai;PELĖDŽIUKAI;7713078413;Taip;3;8;0;11
11873;Smalsučiai;PELĖDŽIUKAI;3627324317;Taip;0;5;0;5
11874;Smalsučiai;PELĖDŽIUKAI;5611487967;Taip;6;1;0;7
11875;Smalsučiai;Pingvinukai;1305808180;Taip;0;9;0;9
11876;Smalsučiai;Pingvinukai;2305950301;Taip;2;0;1;3
11877;Smalsučiai;Pingvinukai;9222858199;Taip;14;0;0;14
11878;Smalsučiai;Pingvinukai;1909797307;Taip;7;0;3;10
11879;Smalsučiai;Pingvinukai;7400990599;Taip;16;0;0;16
11880;Smalsučiai;Pingvinukai;2673224420;Taip;10;0;0;10
11881;Smalsučiai;Pingvinukai;9771532192;Taip;0;18;0;18
11882;Smalsučiai;Pingvinukai;8402519872;Taip;8;5;0;13
11883;Smalsučiai;Pingvinukai;3746193901;Taip;1;8;0;9
11884;Smalsučiai;Pingvinukai;8499612926;Taip;9;0;0;9
11885;Smalsučiai;Pingvinukai;3625628040;Taip;16;3;0;19
11886;Smalsučiai;Pingvinukai;6128134712;Taip;9;0;0;9
11887;Smalsučiai;Pingvinukai;3045521655;Taip;17;1;0;18
11888;Smalsučiai;Pingvinukai;8615789381;Taip;15;0;3;18
11889;Smalsučiai;Voverikų;4811022648;Taip;5;4;2;11
11890;Smalsučiai;Voverikų;4973651632;Taip;3;0;2;5
11891;Smalsučiai;Voverikų;3509573985;Taip;16;0;0;16
11892;Smalsučiai;Voverikų;2878060759;Taip;6;3;0;9
11893;Smalsučiai;Voverikų;1485450504;Taip;6;6;1;13
11894;Smalsučiai;Voverikų;3042578767;Taip;15;4;0;19
11895;Smalsučiai;Voverikų;2070248478;Taip;20;0;0;20
11896;Smalsučiai;Voverikų;7205498813;Taip;13;1;0;14
11897;Smalsučiai;Voverikų;2612579099;Taip;0;21;0;21
11898;Smalsučiai;Voverikų;1559069582;Taip;6;0;0;6
11899;Smalsučiai;Voverikų;2885279828;Taip;4;0;0;4
11900;Smalsučiai;Voverikų;1162035522;Taip;11;0;14;25
11901;Smalsučiai;Voverikų;5964344820;Taip;17;0;0;17
11902;Smalsučiai;Voverikų;4105866680;Ne;5;18;0;23
11903;Spragtukas;NYKŠTUKAI;4527798635;Taip;0;3;0;3
11904;Spragtukas;NYKŠTUKAI;8551195766;Taip;13;0;0;13
11905;Spragtukas;NYKŠTUKAI;2943832694;Taip;0;5;0;5
11906;Spragtukas;NYKŠTUKAI;8297700739;Taip;0;1;0;1
11907;Spragtukas;NYKŠTUKAI;9595221494;Taip;0;5;0;5
11908;Spragtukas;NYKŠTUKAI;6185016824;Taip;9;8;0;17
11909;Spragtukas;NYKŠTUKAI;1710184531;Taip;11;1;0;12
11910;Spragtukas;NYKŠTUKAI;2076126173;Ne;0;10;0;10
11911;Spragtukas;NYKŠTUKAI;3012345413;Ne;9;3;0;12
11912;Spragtukas;NYKŠTUKAI;8698492694;Taip;15;5;0;20
11913;Spragtukas;NYKŠTUKAI;1150002524;Taip;0;2;0;2
11914;Spragtukas;NYKŠTUKAI;4493810276;Taip;0;1;0;1
11915;Spragtukas;NYKŠTUKAI;8288793522;Taip;5;9;0;14
11916;Spragtukas;NYKŠTUKAI;6986034864;Taip;0;12;0;12
11917;Spragtukas;NYKŠTUKAI;9665371858;Ne;5;2;0;7
11918;Spragtukas;SAULUTĖ;3337355440;Taip;0;1;0;1
11919;Spragtukas;SAULUTĖ;4669257062;Taip;8;1;0;9
11920;Spragtukas;SAULUTĖ;3692960591;Taip;9;3;0;12
11921;Spragtukas;SAULUTĖ;6192381779;Taip;5;1;0;6
11922;Spragtukas;SAULUTĖ;4586034709;Taip;8;0;0;8
11923;Spragtukas;SAULUTĖ;2305568596;Taip;0;2;2;4
11924;Spragtukas;SAULUTĖ;3968434618;Taip;7;0;0;7
11925;Spragtukas;SAULUTĖ;1150727381;Taip;9;8;0;17
11926;Spragtukas;SAULUTĖ;3948232692;Taip;11;3;1;15
11927;Spragtukas;SAULUTĖ;9149954373;Taip;6;9;0;15
11928;Spragtukas;SAULUTĖ;7511680722;Taip;0;1;3;4
11929;Spragtukas;SAULUTĖ;8235791891;Taip;8;0;0;8
11930;Spragtukas;SAULUTĖ;2987638580;Taip;11;3;0;14
11931;Spragtukas;SAULUTĖ;5687853390;Taip;0;7;0;7
11932;Spragtukas;SAULUTĖ;6679886985;Taip;10;0;0;10
11933;Spragtukas;SAULUTĖ;2879077913;Ne;4;9;0;13
11934;Spragtukas;SAULUTĖ;1998148708;Ne;12;0;0;12
11935;Spragtukas;SAULUTĖ;8227086854;Taip;0;8;0;8
11936;Spragtukas;SAULUTĖ;5697451914;Taip;4;5;0;9
11937;Spragtukas;SAULUTĖ;3086399458;Taip;11;1;0;12
11938;Spragtukas;SAULUTĖ;2879614195;Taip;8;11;0;19
11939;Spragtukas;SPINDULĖLIAI;4675031453;Taip;0;0;5;5
11940;Spragtukas;SPINDULĖLIAI;9781727236;Taip;7;1;0;8
11941;Spragtukas;SPINDULĖLIAI;1029392579;Taip;6;0;0;6
11942;Spragtukas;SPINDULĖLIAI;6417098461;Taip;7;0;0;7
11943;Spragtukas;SPINDULĖLIAI;4485715299;Taip;9;6;0;15
11944;Spragtukas;SPINDULĖLIAI;4224693184;Taip;0;1;0;1
11945;Spragtukas;SPINDULĖLIAI;2493749424;Taip;0;3;2;5
11946;Spragtukas;SPINDULĖLIAI;3411349574;Taip;5;0;0;5
11947;Spragtukas;SPINDULĖLIAI;1323065222;Taip;9;5;0;14
11948;Spragtukas;SPINDULĖLIAI;1827458781;Taip;0;1;6;7
11949;Spragtukas;SPINDULĖLIAI;4764295850;Taip;17;0;0;17
11950;Spragtukas;SPINDULĖLIAI;6385589724;Taip;0;0;1;1
11951;Spragtukas;SPINDULĖLIAI;8912031554;Taip;0;18;0;18
11952;Spragtukas;SPINDULĖLIAI;3798118695;Taip;3;12;0;15
11953;Spragtukas;SPINDULĖLIAI;6634972088;Ne;0;22;0;22
11954;Spragtukas;SPINDULĖLIAI;7326816081;Ne;0;7;0;7
11955;Spragtukas;SPINDULĖLIAI;5864894208;Ne;0;8;0;8
11956;Spragtukas;GINTARĖLIAI;8339926929;Taip;9;3;0;12
11957;Spragtukas;GINTARĖLIAI;1525489137;Taip;11;0;0;11
11958;Spragtukas;GINTARĖLIAI;5724874569;Taip;0;5;0;5
11959;Spragtukas;GINTARĖLIAI;1430632638;Ne;14;1;0;15
11960;Spragtukas;GINTARĖLIAI;8625143071;Taip;0;2;0;2
11961;Spragtukas;GINTARĖLIAI;2255007161;Taip;12;7;0;19
11962;Spragtukas;GINTARĖLIAI;6493380877;Taip;9;1;0;10
11963;Spragtukas;GINTARĖLIAI;9664130733;Taip;10;3;0;13
11964;Spragtukas;GINTARĖLIAI;2316071393;Ne;8;2;0;10
11965;Spragtukas;GINTARĖLIAI;8698469979;Taip;7;12;0;19
11966;Spragtukas;GINTARĖLIAI;1747417905;Taip;0;10;0;10
11967;Spragtukas;GINTARĖLIAI;6388163866;Taip;8;6;0;14
11968;Spragtukas;GINTARĖLIAI;8191270443;Taip;6;1;0;7
11969;Spragtukas;GINTARĖLIAI;8893190073;Taip;4;3;0;7
11970;Spragtukas;GINTARĖLIAI;3684183344;Ne;0;5;0;5
11971;Spragtukas;GINTARĖLIAI;7806145224;Ne;10;4;0;14
11972;Spragtukas;GINTARĖLIAI;2992201984;Taip;13;6;0;19
11973;Spragtukas;GINTARĖLIAI;2217627240;Taip;0;9;0;9
11974;Spragtukas;ČIPOLINO;2371848091;Taip;0;6;0;6
11975;Spragtukas;ČIPOLINO;6582680700;Taip;19;0;0;19
11976;Spragtukas;ČIPOLINO;1599958343;Taip;9;3;0;12
11977;Spragtukas;ČIPOLINO;1547670082;Ne;0;6;0;6
11978;Spragtukas;ČIPOLINO;7504632314;Taip;0;2;0;2
11979;Spragtukas;ČIPOLINO;1597988501;Taip;5;1;0;6
11980;Spragtukas;ČIPOLINO;6526633051;Taip;3;0;0;3
11981;Spragtukas;ČIPOLINO;1058970799;Taip;0;2;0;2
11982;Spragtukas;ČIPOLINO;45661532130;Taip;0;3;0;3
11983;Spragtukas;ČIPOLINO;3045382299;Taip;0;1;0;1
11984;Spragtukas;ČIPOLINO;7640805299;Taip;0;14;0;14
11985;Spragtukas;ČIPOLINO;1365907314;Taip;10;0;0;10
11986;Spragtukas;ČIPOLINO;4941531443;Taip;9;0;0;9
11987;Spragtukas;ČIPOLINO;3566797064;Taip;3;3;0;6
11988;Spragtukas;ČIPOLINO;2902550587;Taip;8;1;0;9
11989;Spragtukas;ČIPOLINO;69114720307;Ne;9;4;0;13
11990;Spragtukas;ČIPOLINO;1044112039;Taip;12;4;0;16
11991;Spragtukas;ČIPOLINO;5707084920;Taip;8;11;0;19
11992;Spragtukas;ČIPOLINO;1482803930;Taip;0;13;0;13
11993;Spragtukas;ČIPOLINO;3356307067;Taip;0;10;0;10
11994;Spragtukas;ČIPOLINO;2691004546;Taip;0;22;0;22
11995;Spragtukas;BORUŽĖLĖS;8614890958;Taip;3;10;0;13
11996;Spragtukas;BORUŽĖLĖS;6548270099;Taip;21;1;0;22
11997;Spragtukas;BORUŽĖLĖS;2356476212;Taip;16;2;0;18
11998;Spragtukas;BORUŽĖLĖS;8287102733;Taip;5;6;0;11
11999;Spragtukas;BORUŽĖLĖS;6584145176;Taip;9;3;0;12
12000;Spragtukas;BORUŽĖLĖS;9965087132;Taip;8;1;0;9
12001;Spragtukas;BORUŽĖLĖS;5150028968;Taip;3;1;0;4
12002;Spragtukas;BORUŽĖLĖS;9754594384;Taip;10;3;0;13
12003;Spragtukas;BORUŽĖLĖS;6824861247;Taip;10;4;0;14
12004;Spragtukas;BORUŽĖLĖS;7264683147;Taip;12;3;0;15
12005;Spragtukas;BORUŽĖLĖS;5556920140;Taip;0;2;0;2
12006;Spragtukas;BORUŽĖLĖS;6547167325;Taip;6;1;0;7
12007;Spragtukas;BORUŽĖLĖS;4347275614;Taip;8;0;0;8
12008;Spragtukas;BORUŽĖLĖS;7073092344;Taip;22;0;0;22
12009;Spragtukas;BORUŽĖLĖS;7042345781;Ne;14;0;0;14
12010;Spragtukas;BORUŽĖLĖS;1046613540;Taip;7;6;0;13
12011;Spragtukas;DRUGELIAI;1336973131;Taip;1;6;0;7
12012;Spragtukas;DRUGELIAI;1514277186;Taip;11;3;0;14
12013;Spragtukas;DRUGELIAI;1326603216;Taip;7;1;0;8
12014;Spragtukas;DRUGELIAI;5306883933;Taip;9;3;0;12
12015;Spragtukas;DRUGELIAI;6322121173;Taip;11;2;0;13
12016;Spragtukas;DRUGELIAI;6573750143;Taip;4;3;0;7
12017;Spragtukas;DRUGELIAI;6800727630;Taip;0;1;0;1
12018;Spragtukas;DRUGELIAI;72636559695;Ne;10;1;0;11
12019;Spragtukas;DRUGELIAI;1384812263;Taip;6;0;0;6
12020;Spragtukas;DRUGELIAI;3654640843;Taip;2;1;0;3
12021;Spragtukas;DRUGELIAI;8246512283;Taip;0;2;0;2
12022;Spragtukas;DRUGELIAI;9045185920;Taip;15;3;0;18
12023;Spragtukas;DRUGELIAI;1627243902;Taip;4;2;0;6
12024;Spragtukas;DRUGELIAI;3113106252;Taip;0;1;0;1
12025;Spragtukas;DRUGELIAI;4131998934;Taip;0;1;0;1
12026;Spragtukas;DRUGELIAI;5477997543;Taip;0;1;0;1
12027;Spragtukas;DRUGELIAI;70413855110;Taip;5;1;0;6
12028;Spragtukas;GAIDELIAI;2541126095;Taip;8;0;3;11
12029;Spragtukas;GAIDELIAI;4097458544;Taip;0;3;6;9
12030;Spragtukas;GAIDELIAI;8957903306;Taip;9;2;2;13
12031;Spragtukas;GAIDELIAI;1326714513;Ne;0;1;4;5
12032;Spragtukas;GAIDELIAI;4676052255;Ne;6;11;0;17
12033;Spragtukas;GAIDELIAI;7108640957;Taip;9;1;0;10
12034;Spragtukas;GAIDELIAI;6370760287;Taip;0;3;2;5
12035;Spragtukas;GAIDELIAI;7911124524;Taip;5;4;1;10
12036;Spragtukas;GAIDELIAI;9509296936;Taip;0;22;0;22
12037;Spragtukas;GAIDELIAI;3216796441;Taip;15;2;0;17
12038;Spragtukas;GAIDELIAI;8440836721;Taip;19;3;0;22
12039;Spragtukas;GAIDELIAI;4535021524;Taip;0;1;0;1
12040;Spragtukas;GAIDELIAI;2679834328;Taip;16;0;0;16
12041;Spragtukas;GAIDELIAI;7313963137;Taip;8;0;0;8
12042;Spragtukas;ŽUVELĖS;9078163633;Taip;15;0;0;15
12043;Spragtukas;ŽUVELĖS;8762832644;Taip;4;0;0;4
12044;Spragtukas;ŽUVELĖS;8652973900;Taip;11;3;0;14
12045;Spragtukas;ŽUVELĖS;3261213140;Taip;8;4;0;12
12046;Spragtukas;ŽUVELĖS;5689392663;Taip;13;1;0;14
12047;Spragtukas;ŽUVELĖS;9592271053;Taip;10;3;0;13
12048;Spragtukas;ŽUVELĖS;1272075883;Taip;9;4;0;13
12049;Spragtukas;ŽUVELĖS;6465991136;Taip;10;0;0;10
12050;Spragtukas;ŽUVELĖS;9282940430;Taip;9;0;0;9
12051;Spragtukas;ŽUVELĖS;6503842956;Taip;5;1;0;6
12052;Spragtukas;ŽUVELĖS;2578400770;Taip;5;0;0;5
12053;Spragtukas;ŽUVELĖS;3139748724;Taip;10;0;6;16
12054;Spragtukas;ŽUVELĖS;8640877497;Taip;8;1;1;10
12055;Spragtukas;ŽUVELĖS;2025314314;Taip;0;1;0;1
12056;Spragtukas;ŽUVELĖS;4848647219;Taip;18;0;0;18
12057;Spragtukas;ŽUVELĖS;3491418162;Taip;8;1;0;9
12058;Spragtukas;ŽUVELĖS;5836788916;Taip;8;1;0;9
12059;Spragtukas;ŽUVELĖS;5704941595;Taip;10;4;0;14
12060;Spragtukas;ŽUVELĖS;3286456855;Taip;13;2;0;15
12061;Spragtukas;ŽUVELĖS;9662188102;Taip;14;0;0;14
12062;Spragtukas;ŽUVELĖS;2539660577;Taip;6;2;0;8
12063;Spragtukas;ŽUVELĖS;6836232179;Taip;3;2;1;6
12064;Spragtukas;ŽUVELĖS;6757604305;Taip;6;0;0;6
12065;Spragtukas;RIEŠUTĖLIAI;8684246143;Taip;13;0;0;13
12066;Spragtukas;RIEŠUTĖLIAI;1407611561;Taip;7;1;0;8
12067;Spragtukas;RIEŠUTĖLIAI;8773952377;Ne;10;3;0;13
12068;Spragtukas;RIEŠUTĖLIAI;1977526177;Taip;5;1;0;6
12069;Spragtukas;RIEŠUTĖLIAI;7615522850;Taip;8;1;0;9
12070;Spragtukas;RIEŠUTĖLIAI;6797841737;Ne;6;1;0;7
12071;Spragtukas;RIEŠUTĖLIAI;8342098575;Taip;10;0;0;10
12072;Spragtukas;RIEŠUTĖLIAI;1992850470;Taip;4;0;0;4
12073;Spragtukas;RIEŠUTĖLIAI;6158327941;Taip;8;2;0;10
12074;Spragtukas;RIEŠUTĖLIAI;4134127256;Taip;7;0;0;7
12075;Spragtukas;RIEŠUTĖLIAI;1946493379;Taip;13;0;0;13
12076;Spragtukas;RIEŠUTĖLIAI;3009567338;Taip;13;2;1;16
12077;Spragtukas;RIEŠUTĖLIAI;2648358901;Ne;5;7;0;12
12078;Spragtukas;RIEŠUTĖLIAI;3822599790;Taip;0;16;0;16
12079;Spragtukas;RIEŠUTĖLIAI;7767940027;Taip;11;2;0;13
12080;Spragtukas;RIEŠUTĖLIAI;4625065223;Taip;10;0;0;10
12081;Spragtukas;RIEŠUTĖLIAI;6963190259;Taip;9;0;0;9
12082;Spragtukas;RIEŠUTĖLIAI;8732886749;Taip;14;2;0;16
12083;Spragtukas;RIEŠUTĖLIAI;9975308171;Taip;23;0;0;23
12084;Spragtukas;VIŠČIUKAI;8473814776;Taip;3;1;0;4
12085;Spragtukas;VIŠČIUKAI;9951226210;Taip;14;2;0;16
12086;Spragtukas;VIŠČIUKAI;9294770557;Taip;8;0;0;8
12087;Spragtukas;VIŠČIUKAI;9443091032;Taip;10;3;0;13
12088;Spragtukas;VIŠČIUKAI;3110077272;Taip;8;0;0;8
12089;Spragtukas;VIŠČIUKAI;4461217748;Taip;0;3;0;3
12090;Spragtukas;VIŠČIUKAI;7412489884;Taip;22;0;0;22
12091;Spragtukas;VIŠČIUKAI;9579825533;Taip;14;0;0;14
12092;Spragtukas;VIŠČIUKAI;2087416420;Taip;0;4;0;4
12093;Spragtukas;VIŠČIUKAI;7933945356;Taip;4;3;0;7
12094;Spragtukas;VIŠČIUKAI;1545887575;Taip;8;0;0;8
12095;Spragtukas;VIŠČIUKAI;5948139350;Taip;5;1;0;6
12096;Spragtukas;VIŠČIUKAI;8110631015;Taip;0;4;0;4
12097;Spragtukas;VIŠČIUKAI;7522592685;Ne;14;3;0;17
12098;Spragtukas;MEŠKIUKAI;5440632023;Taip;15;0;0;15
12099;Spragtukas;MEŠKIUKAI;7271482702;Taip;13;6;0;19
12100;Spragtukas;MEŠKIUKAI;9099921999;Taip;9;0;0;9
12101;Spragtukas;MEŠKIUKAI;8307801987;Ne;3;1;0;4
12102;Spragtukas;MEŠKIUKAI;1493711333;Ne;9;1;0;10
12103;Spragtukas;MEŠKIUKAI;4742132709;Taip;10;8;0;18
12104;Spragtukas;MEŠKIUKAI;7256772984;Taip;7;0;0;7
12105;Spragtukas;MEŠKIUKAI;1487259291;Taip;2;0;0;2
12106;Spragtukas;MEŠKIUKAI;5225669850;Taip;15;0;0;15
12107;Spragtukas;MEŠKIUKAI;8109894184;Taip;12;0;0;12
12108;Spragtukas;MEŠKIUKAI;8396134652;Taip;9;2;0;11
12109;Spragtukas;MEŠKIUKAI;1784758799;Taip;7;5;0;12
12110;Spragtukas;MEŠKIUKAI;4441290823;Taip;32;0;0;32
12111;Spragtukas;MEŠKIUKAI;9310818975;Taip;3;1;0;4
12112;Spragtukas;MEŠKIUKAI;8486415968;Taip;7;2;0;9
12113;Spragtukas;MEŠKIUKAI;2026249018;Ne;17;4;0;21
12114;Spragtukas;MEŠKIUKAI;3423699840;Taip;7;5;0;12
12115;Strazdelis;Žiogelių;5346485534;Taip;0;4;0;4
12116;Strazdelis;Žiogelių;9933042249;Taip;0;8;0;8
12117;Strazdelis;Žiogelių;8581533423;Taip;16;0;0;16
12118;Strazdelis;Žiogelių;8209625399;Taip;18;4;0;22
12119;Strazdelis;Žiogelių;1141752802;Taip;18;0;0;18
12120;Strazdelis;Žiogelių;1228651165;Taip;0;5;4;9
12121;Strazdelis;Žiogelių;7768700192;Ne;4;1;0;5
12122;Strazdelis;Žiogelių;3596394112;Taip;26;0;0;26
12123;Strazdelis;Žiogelių;8493572399;Taip;0;0;19;19
12124;Strazdelis;Žiogelių;4563247013;Taip;22;0;0;22
12125;Strazdelis;Žiogelių;6437928004;Taip;5;2;0;7
12126;Strazdelis;Žiogelių;5600979545;Taip;8;6;0;14
12127;Strazdelis;Žiogelių;8971395173;Taip;7;0;0;7
12128;Strazdelis;Žiogelių;4955907851;Taip;14;0;0;14
12129;Strazdelis;Žiogelių;7425818775;Ne;10;1;0;11
12130;Strazdelis;Žiogelių;9567476872;Taip;10;1;0;11
12131;Strazdelis;Žiogelių;4516288199;Taip;12;0;0;12
12132;Strazdelis;Žiogelių;3028208428;Taip;8;0;1;9
12133;Strazdelis;Žiogelių;2753635198;Ne;0;2;3;5
12134;Strazdelis;Žiogelių;1194918926;Taip;0;0;6;6
12135;Strazdelis;Žiogelių;6651360492;Taip;21;4;0;25
12136;Strazdelis;Žiogelių;8686828982;Ne;0;3;0;3
12137;Strazdelis;Žiogelių;7913526787;Taip;10;0;0;10
12138;Strazdelis;Šeimynėlės;6570504154;Taip;5;0;0;5
12139;Strazdelis;Šeimynėlės;3897248010;Ne;6;1;1;8
12140;Strazdelis;Šeimynėlės;2990771887;Taip;0;7;0;7
12141;Strazdelis;Šeimynėlės;2185364583;Taip;10;0;1;11
12142;Strazdelis;Šeimynėlės;7905687363;Taip;2;2;0;4
12143;Strazdelis;Šeimynėlės;4501391298;Taip;10;3;0;13
12144;Strazdelis;Šeimynėlės;9057914477;Taip;15;5;0;20
12145;Strazdelis;Šeimynėlės;1277844969;Taip;2;0;0;2
12146;Strazdelis;Šeimynėlės;1012692326;Taip;3;0;0;3
12147;Strazdelis;Šeimynėlės;8899530711;Taip;7;0;0;7
12148;Strazdelis;Šeimynėlės;8336759173;Taip;19;0;4;23
12149;Strazdelis;Šeimynėlės;5784406335;Taip;0;5;0;5
12150;Strazdelis;Šeimynėlės;2068793184;Taip;5;3;0;8
12151;Strazdelis;Šeimynėlės;5296218650;Taip;8;0;1;9
12152;Strazdelis;Šeimynėlės;1754106518;Taip;4;5;0;9
12153;Strazdelis;Šeimynėlės;9806107189;Taip;27;0;0;27
12154;Strazdelis;Šeimynėlės;9209201954;Taip;5;0;0;5
12155;Strazdelis;Šeimynėlės;5924324241;Taip;0;0;13;13
12156;Strazdelis;Šeimynėlės;8295035233;Taip;7;0;2;9
12157;Strazdelis;Šeimynėlės;1553329770;Taip;18;0;0;18
12158;Strazdelis;Genelio;8277333786;Taip;8;0;1;9
12159;Strazdelis;Genelio;9586256979;Taip;8;3;0;11
12160;Strazdelis;Genelio;3084249678;Ne;10;3;0;13
12161;Strazdelis;Genelio;5499310072;Taip;14;1;0;15
12162;Strazdelis;Genelio;8333151969;Taip;8;2;0;10
12163;Strazdelis;Genelio;7083940713;Taip;8;0;0;8
12164;Strazdelis;Genelio;6271193831;Taip;3;1;0;4
12165;Strazdelis;Genelio;6480803618;Taip;14;1;0;15
12166;Strazdelis;Genelio;9490861272;Taip;9;5;0;14
12167;Strazdelis;Genelio;6071502600;Taip;9;2;0;11
12168;Strazdelis;Genelio;3713797440;Taip;9;2;0;11
12169;Strazdelis;Genelio;3456287323;Taip;31;0;0;31
12170;Strazdelis;Genelio;1034497200;Taip;2;0;0;2
12171;Strazdelis;Genelio;2459718449;Taip;7;5;0;12
12172;Strazdelis;Genelio;2483283363;Taip;2;1;0;3
12173;Strazdelis;Genelio;5714581201;Taip;0;3;0;3
12174;Strazdelis;Genelio;8956634754;Taip;16;0;0;16
12175;Strazdelis;Genelio;8762859576;Taip;2;1;2;5
12176;Strazdelis;Genelio;2306665561;Taip;0;4;0;4
12177;Strazdelis;Genelio;7680242840;Taip;7;1;0;8
12178;Strazdelis;Genelio;4545538133;Taip;4;1;0;5
12179;Strazdelis;Genelio;5742215922;Ne;7;2;0;9
12180;Strazdelis;Vikruolių;2078150337;Taip;5;0;0;5
12181;Strazdelis;Vikruolių;8182994112;Taip;4;0;0;4
12182;Strazdelis;Vikruolių;1362428967;Taip;5;2;0;7
12183;Strazdelis;Vikruolių;2871673641;Taip;10;1;0;11
12184;Strazdelis;Vikruolių;9198429790;Taip;0;1;0;1
12185;Strazdelis;Vikruolių;4655931716;Taip;7;2;0;9
12186;Strazdelis;Vikruolių;8754275576;Taip;0;1;0;1
12187;Strazdelis;Vikruolių;6147183190;Ne;9;1;0;10
12188;Strazdelis;Vikruolių;7216768880;Taip;0;2;0;2
12189;Strazdelis;Vikruolių;7823110477;Ne;0;8;0;8
12190;Strazdelis;Vikruolių;1187534672;Taip;0;3;3;6
12191;Strazdelis;Vikruolių;9904719582;Taip;6;8;0;14
12192;Strazdelis;Vikruolių;7308925265;Taip;19;6;0;25
12193;Strazdelis;Vikruolių;50350281905;Taip;16;7;0;23
12194;Strazdelis;Vikruolių;8038163444;Taip;0;2;0;2
12195;Strazdelis;Vikruolių;8801420992;Taip;0;4;0;4
12196;Strazdelis;Vikruolių;5580738386;Taip;0;4;0;4
12197;Strazdelis;Vikruolių;3955783379;Taip;15;3;0;18
12198;Strazdelis;Vikruolių;4430183106;Ne;19;1;0;20
12199;Strazdelis;Vikruolių;4076266466;Taip;9;3;0;12
12200;Strazdelis;Vyturėlių;4929828091;Taip;0;4;0;4
12201;Strazdelis;Vyturėlių;4454199703;Ne;14;1;0;15
12202;Strazdelis;Vyturėlių;3662217925;Ne;0;3;0;3
12203;Strazdelis;Vyturėlių;4698566091;Taip;5;2;1;8
12204;Strazdelis;Vyturėlių;8274897977;Taip;5;2;0;7
12205;Strazdelis;Vyturėlių;1665134387;Taip;3;2;7;12
12206;Strazdelis;Vyturėlių;45083023033;Taip;3;3;0;6
12207;Strazdelis;Vyturėlių;5698472204;Taip;0;17;0;17
12208;Strazdelis;Vyturėlių;43314069648;Ne;11;1;0;12
12209;Strazdelis;Vyturėlių;1481671624;Taip;16;0;1;17
12210;Strazdelis;Vyturėlių;4697537943;Ne;0;9;0;9
12211;Strazdelis;Vyturėlių;6014213362;Taip;10;2;0;12
12212;Strazdelis;Vyturėlių;7900362267;Taip;8;0;1;9
12213;Strazdelis;Vyturėlių;9835716116;Taip;13;0;0;13
12214;Strazdelis;Vyturėlių;3943578036;Taip;0;2;0;2
12215;Strazdelis;Vyturėlių;2802486859;Taip;5;1;0;6
12216;Strazdelis;Vyturėlių;3482802557;Taip;6;0;0;6
12217;Strazdelis;Vyturėlių;5749300013;Taip;8;0;0;8
12218;Strazdelis;Vyturėlių;7215063033;Taip;0;5;0;5
12219;Strazdelis;Vyturėlių;7149827850;Taip;0;0;3;3
12220;Strazdelis;Vyturėlių;5834348507;Taip;9;6;0;15
12221;Strazdelis;Vyturėlių;2238875354;Taip;3;1;1;5
12222;Strazdelis;Varpelio;4159072583;Taip;8;6;0;14
12223;Strazdelis;Varpelio;2662549392;Taip;13;0;0;13
12224;Strazdelis;Varpelio;9502341478;Taip;0;4;0;4
12225;Strazdelis;Varpelio;6311710825;Taip;0;3;0;3
12226;Strazdelis;Varpelio;1955166372;Taip;8;0;0;8
12227;Strazdelis;Varpelio;4873707286;Taip;5;5;0;10
12228;Strazdelis;Varpelio;6527855940;Ne;5;7;0;12
12229;Strazdelis;Varpelio;2824416350;Taip;14;3;0;17
12230;Strazdelis;Varpelio;3610250359;Taip;0;7;0;7
12231;Strazdelis;Varpelio;2766970956;Ne;17;13;0;30
12232;Strazdelis;Varpelio;1173067724;Taip;17;1;0;18
12233;Strazdelis;Varpelio;1021364759;Taip;12;7;0;19
12234;Strazdelis;Varpelio;7469848482;Taip;16;0;0;16
12235;Strazdelis;Varpelio;1841285441;Ne;6;0;0;6
12236;Strazdelis;Varpelio;6555803164;Ne;5;3;0;8
12237;Strazdelis;Varpelio;1706026100;Taip;10;1;0;11
12238;Strazdelis;Varpelio;8035603341;Taip;10;1;0;11
12239;Strazdelis;Varpelio;2789987994;Taip;0;7;0;7
12240;Strazdelis;Varpelio;2251157025;Taip;7;4;0;11
12241;Strazdelis;Varpelio;5904388732;Taip;0;9;0;9
12242;Strazdelis;Varpelio;3460993302;Taip;11;1;0;12
12243;Strazdelis;Varpelio;9776075027;Taip;10;0;0;10
12244;Strazdelis;Pelėdžiukų;5892430004;Ne;16;7;0;23
12245;Strazdelis;Pelėdžiukų;8637386316;Taip;5;1;0;6
12246;Strazdelis;Pelėdžiukų;1704292727;Taip;14;1;0;15
12247;Strazdelis;Pelėdžiukų;8371999002;Taip;0;3;0;3
12248;Strazdelis;Pelėdžiukų;6046139859;Taip;0;1;0;1
12249;Strazdelis;Pelėdžiukų;8287554571;Taip;3;0;0;3
12250;Strazdelis;Pelėdžiukų;4448556404;Taip;9;10;0;19
12251;Strazdelis;Pelėdžiukų;4004930488;Taip;0;1;0;1
12252;Strazdelis;Pelėdžiukų;5768674837;Taip;6;0;0;6
12253;Strazdelis;Pelėdžiukų;9761595867;Taip;4;3;0;7
12254;Strazdelis;Pelėdžiukų;2848984531;Taip;0;1;0;1
12255;Strazdelis;Pelėdžiukų;1420438624;Ne;0;2;0;2
12256;Strazdelis;Pelėdžiukų;4617237063;Taip;12;1;0;13
12257;Strazdelis;Pelėdžiukų;3036380561;Taip;13;1;0;14
12258;Strazdelis;Pelėdžiukų;7349106795;Taip;4;1;3;8
12259;Strazdelis;Pelėdžiukų;3943914976;Taip;4;0;0;4
12260;Strazdelis;Pelėdžiukų;2852253325;Ne;0;6;0;6
12261;Strazdelis;Pelėdžiukų;8938997208;Ne;0;5;1;6
12262;Strazdelis;Pelėdžiukų;4562530311;Taip;0;0;4;4
12263;Strazdelis;Saulutės;27177757900;Taip;0;2;0;2
12264;Strazdelis;Saulutės;40932140069;Taip;0;3;0;3
12265;Strazdelis;Saulutės;1523471662;Taip;6;2;0;8
12266;Strazdelis;Saulutės;2854642875;Taip;5;1;2;8
12267;Strazdelis;Saulutės;7578229276;Taip;12;1;0;13
12268;Strazdelis;Saulutės;8710848483;Taip;0;3;1;4
12269;Strazdelis;Saulutės;6614184499;Taip;0;2;0;2
12270;Strazdelis;Saulutės;4129957131;Taip;4;1;0;5
12271;Strazdelis;Saulutės;3425430317;Taip;0;2;0;2
12272;Strazdelis;Saulutės;7081517417;Taip;0;4;0;4
12273;Strazdelis;Saulutės;67641340859;Taip;5;2;0;7
12274;Strazdelis;Saulutės;15298412755;Taip;0;3;0;3
12275;Strazdelis;Saulutės;1802092125;Taip;0;1;0;1
12276;Strazdelis;Saulutės;1391009140;Taip;9;2;3;14
12277;Strazdelis;Saulutės;8808299050;Taip;0;1;0;1
12278;Strazdelis;Saulutės;3270413614;Taip;5;3;0;8
12279;Strazdelis;Saulutės;6113491562;Taip;6;2;1;9
12280;Strazdelis;Saulutės;3753612757;Taip;4;0;0;4
12281;Strazdelis;Saulutės;1474503932;Taip;0;0;3;3
12282;Strazdelis;Saulutės;6779352728;Taip;3;0;0;3
12283;Strazdelis;Saulutės;9662566992;Taip;0;1;1;2
12284;Strazdelis;Bitutės;8485509145;Taip;6;6;0;12
12285;Strazdelis;Bitutės;6508933324;Taip;7;0;0;7
12286;Strazdelis;Bitutės;4020547762;Taip;5;1;0;6
12287;Strazdelis;Bitutės;8753316532;Ne;8;1;0;9
12288;Strazdelis;Bitutės;5232064496;Taip;8;4;0;12
12289;Strazdelis;Bitutės;9555240419;Taip;0;2;0;2
12290;Strazdelis;Bitutės;1539984888;Taip;5;3;0;8
12291;Strazdelis;Bitutės;4400849922;Taip;6;1;0;7
12292;Strazdelis;Bitutės;7890064837;Ne;8;1;0;9
12293;Strazdelis;Bitutės;1881071425;Ne;18;0;3;21
12294;Strazdelis;Bitutės;2908567982;Taip;19;0;0;19
12295;Strazdelis;Bitutės;9548465554;Taip;0;17;0;17
12296;Strazdelis;Bitutės;7466648222;Ne;11;0;0;11
12297;Strazdelis;Bitutės;4463378251;Taip;18;0;0;18
12298;Strazdelis;Bitutės;8443837176;Taip;16;0;0;16
12299;Strazdelis;Bitutės;4369569609;Taip;0;6;0;6
12300;Strazdelis;Bitutės;1005082012;Taip;14;2;0;16
12301;Strazdelis;Bitutės;2589303722;Taip;6;2;0;8
12302;Strazdelis;Bitutės;3149930355;Taip;5;0;0;5
12303;Strazdelis;Bitutės;2081538505;Taip;9;5;0;14
12304;Strazdelis;Bitutės;4784401449;Taip;4;0;0;4
12305;Strazdelis;Mažylių;9357195019;Taip;9;0;0;9
12306;Strazdelis;Mažylių;5256750516;Taip;10;2;0;12
12307;Strazdelis;Mažylių;4965049621;Taip;2;0;0;2
12308;Strazdelis;Mažylių;9383398775;Taip;8;0;0;8
12309;Strazdelis;Mažylių;2378910473;Taip;10;8;0;18
12310;Strazdelis;Mažylių;4699373769;Taip;3;1;0;4
12311;Strazdelis;Mažylių;3648883435;Taip;7;0;1;8
12312;Strazdelis;Mažylių;6788732053;Taip;14;3;0;17
12313;Strazdelis;Mažylių;2764495554;Taip;14;3;0;17
12314;Strazdelis;Mažylių;7039347901;Taip;0;0;3;3
12315;Strazdelis;Mažylių;4904388387;Ne;0;1;0;1
12316;Strazdelis;Mažylių;3082900425;Taip;10;1;0;11
12317;Strazdelis;Mažylių;1265557971;Taip;12;2;4;18
12318;Strazdelis;Mažylių;3900225484;Taip;12;2;0;14
12319;Strazdelis;Mažylių;8734458997;Taip;3;3;2;8
12320;Strazdelis;Mažylių;3561551193;Taip;14;0;0;14
12321;Strazdelis;Mažylių;1932428439;Taip;5;2;0;7
12322;Strazdelis;Mažylių;2871841427;Taip;9;0;0;9
12323;Strazdelis;Mažylių;3572665646;Taip;9;0;2;11
12324;Strazdelis;Mažylių;8699020650;Taip;13;0;2;15
12325;Strazdelis;Pabiručių;7087235151;Taip;11;11;0;22
12326;Strazdelis;Pabiručių;3030445367;Taip;11;0;0;11
12327;Strazdelis;Pabiručių;4966668662;Taip;10;0;0;10
12328;Strazdelis;Pabiručių;8484672456;Ne;15;0;0;15
12329;Strazdelis;Pabiručių;8953577585;Taip;11;4;0;15
12330;Strazdelis;Pabiručių;1823053560;Taip;0;0;22;22
12331;Strazdelis;Pabiručių;8677659019;Taip;12;0;0;12
12332;Strazdelis;Pabiručių;4848650799;Taip;4;0;0;4
12333;Strazdelis;Pabiručių;7716476995;Taip;8;0;0;8
12334;Strazdelis;Pabiručių;4174940099;Taip;22;0;0;22
12335;Strazdelis;Pabiručių;8554043784;Taip;9;10;0;19
12336;Strazdelis;Pabiručių;1952086370;Taip;18;0;0;18
12337;Strazdelis;Pabiručių;7802337169;Taip;12;0;0;12
12338;Strazdelis;Pabiručių;4461728361;Taip;0;0;2;2
12339;Strazdelis;Pabiručių;8356680705;Taip;6;0;0;6
12340;Strazdelis;Pabiručių;6457478289;Ne;15;0;0;15
12341;Strazdelis;Pabiručių;3426039979;Taip;17;0;2;19
12342;Strazdelis;Pabiručių;4715198107;Taip;5;1;0;6
12343;Strazdelis;Pabiručių;4334385271;Taip;20;0;0;20
12344;Strazdelis;Pabiručių;1770338988;Taip;6;0;0;6
12345;Strazdelis;"NAUJA (MODUILINIS)";3054317854;Taip;5;0;0;5
12346;Sveikuolis;Nykštukai;1708201772;Taip;8;0;0;8
12347;Sveikuolis;Nykštukai;1713177832;Taip;4;0;0;4
12348;Sveikuolis;Nykštukai;4224536998;Taip;17;0;0;17
12349;Sveikuolis;Nykštukai;49329397005;Taip;8;0;0;8
12350;Sveikuolis;Saulutė;5406563941;Taip;5;0;0;5
12351;Sveikuolis;Saulutė;2325496546;Taip;5;0;0;5
12352;Sveikuolis;Saulutė;2182354299;Taip;14;0;0;14
12353;Sveikuolis;Saulutė;7776916182;Taip;15;0;0;15
12354;Sveikuolis;Gintarėlis;4166776211;Taip;9;0;0;9
12355;Sveikuolis;EŽIUKAI;8230064533;Taip;4;0;0;4
12356;Sveikuolis;Boružėlė;5591658359;Taip;10;0;0;10
12357;Sveikuolis;Boružėlė;6221037630;Taip;10;0;0;10
12358;Sveikuolis;Boružėlė;6515123277;Taip;10;0;0;10
12359;Sveikuolis;Boružėlė;1226952966;Ne;8;0;0;8
12360;Sveikuolis;LAIVELIS;2185418747;Taip;10;0;0;10
12361;Sveikuolis;BITUTĖ;9674705043;Taip;8;0;0;8
12362;Sveikuolis;BITUTĖ;4168236478;Taip;6;0;0;6
12363;Sveikuolis;BITUTĖ;4459702578;Taip;10;0;0;10
12364;Sveikuolis;VARPELIS;5936442120;Taip;10;0;0;10
12365;Sveikuolis;VARPELIS;3425138386;Taip;5;0;0;5
12366;Sveikuolis;DRUGELIAI;4062019702;Taip;9;0;0;9
12367;Sveikuolis;DRUGELIAI;2737692810;Taip;11;0;0;11
12368;Sveikuolis;ŽVAIGŽDUTĖ;8011420868;Taip;15;0;0;15
12369;Sveikuolis;ŽVAIGŽDUTĖ;8105068323;Taip;10;0;0;10
12370;Sveikuolis;ŽVAIGŽDUTĖ;6461929579;Taip;5;0;0;5
12371;Sveikuolis;ŽVAIGŽDUTĖ;1291963422;Taip;9;0;0;9
12372;Sveikuolis;ŽVAIGŽDUTĖ;9893764995;Taip;6;0;0;6
12373;Sveikuolis;MEŠKIUKAI;1180602629;Taip;6;0;0;6
12374;Sveikuolis;MEŠKIUKAI;2978563798;Taip;13;0;0;13
12375;Sveikuolis;MEŠKIUKAI;7159776808;Taip;5;0;0;5
12376;Sveikuolis;MEŠKIUKAI;1398901995;Taip;10;0;0;10
12377;Sveikuolis;SAULĖGRĄŽA;3244634788;Taip;10;0;0;10
12378;Šermukšnėlė;MOLINUKAI;9746313951;Taip;6;0;0;6
12379;Šermukšnėlė;MOLINUKAI;4638109666;Ne;9;0;1;10
12380;Šermukšnėlė;MOLINUKAI;9329824053;Taip;9;3;0;12
12381;Šermukšnėlė;MOLINUKAI;2714018690;Taip;18;0;0;18
12382;Šermukšnėlė;MOLINUKAI;5262882873;Taip;9;1;0;10
12383;Šermukšnėlė;MOLINUKAI;2985284699;Ne;8;3;0;11
12384;Šermukšnėlė;MOLINUKAI;4983510683;Ne;8;3;0;11
12385;Šermukšnėlė;MOLINUKAI;7385114026;Taip;12;0;0;12
12386;Šermukšnėlė;MOLINUKAI;2784732759;Taip;1;0;0;1
12387;Šermukšnėlė;MOLINUKAI;3342919832;Taip;8;3;0;11
12388;Šermukšnėlė;MOLINUKAI;9337047371;Taip;0;3;3;6
12389;Šermukšnėlė;MOLINUKAI;2098090763;Taip;8;1;1;10
12390;Šermukšnėlė;MOLINUKAI;5835100042;Taip;0;0;7;7
12391;Šermukšnėlė;MOLINUKAI;8000479161;Taip;2;1;1;4
12392;Šermukšnėlė;MOLINUKAI;4952285322;Taip;8;0;0;8
12393;Šermukšnėlė;MOLINUKAI;5733048755;Taip;3;0;0;3
12394;Šermukšnėlė;MOLINUKAI;6608458145;Taip;8;0;0;8
12395;Šermukšnėlė;MOLINUKAI;8104182167;Taip;16;0;0;16
12396;Šermukšnėlė;MOLINUKAI;6988120570;Taip;0;12;0;12
12397;Šermukšnėlė;MOLINUKAI;8728441474;Taip;11;1;0;12
12398;Šermukšnėlė;MOLINUKAI;4075151928;Ne;0;0;7;7
12399;Šermukšnėlė;MOLINUKAI;9527382390;Taip;7;0;1;8
12400;Šermukšnėlė;MOLINUKAI;4968522498;Taip;18;0;0;18
12401;Šermukšnėlė;ŠIAUDINUKAI;7249568196;Taip;0;6;0;6
12402;Šermukšnėlė;ŠIAUDINUKAI;3451361097;Taip;7;0;0;7
12403;Šermukšnėlė;ŠIAUDINUKAI;7002917737;Taip;9;0;4;13
12404;Šermukšnėlė;ŠIAUDINUKAI;7785671936;Taip;5;0;0;5
12405;Šermukšnėlė;ŠIAUDINUKAI;3637882900;Taip;3;5;0;8
12406;Šermukšnėlė;ŠIAUDINUKAI;1159472154;Taip;0;1;1;2
12407;Šermukšnėlė;ŠIAUDINUKAI;4956414941;Taip;9;1;0;10
12408;Šermukšnėlė;ŠIAUDINUKAI;3499394539;Ne;9;7;0;16
12409;Šermukšnėlė;ŠIAUDINUKAI;1157979179;Taip;6;2;0;8
12410;Šermukšnėlė;ŠIAUDINUKAI;3701053997;Taip;16;0;0;16
12411;Šermukšnėlė;ŠIAUDINUKAI;8048598135;Taip;0;0;1;1
12412;Šermukšnėlė;ŠIAUDINUKAI;7917101921;Taip;9;0;0;9
12413;Šermukšnėlė;ŠIAUDINUKAI;3082272196;Ne;13;1;1;15
12414;Šermukšnėlė;ŠIAUDINUKAI;9903310024;Taip;7;0;0;7
12415;Šermukšnėlė;ŠIAUDINUKAI;9012757607;Taip;0;1;0;1
12416;Šermukšnėlė;ŠIAUDINUKAI;3550736579;Taip;12;0;4;16
12417;Šermukšnėlė;ŠIAUDINUKAI;5993599994;Taip;12;0;2;14
12418;Šermukšnėlė;ŠIAUDINUKAI;3522028983;Taip;11;0;0;11
12419;Šermukšnėlė;ŠIAUDINUKAI;6077798297;Taip;7;1;1;9
12420;Šermukšnėlė;ŠIAUDINUKAI;2351386211;Taip;9;0;0;9
12421;Šermukšnėlė;ŠIAUDINUKAI;1437314920;Taip;0;5;0;5
12422;Šermukšnėlė;TOŠINUKAI;1661977128;Taip;10;0;3;13
12423;Šermukšnėlė;TOŠINUKAI;3994316729;Taip;2;10;1;13
12424;Šermukšnėlė;TOŠINUKAI;1459253197;Taip;4;0;1;5
12425;Šermukšnėlė;TOŠINUKAI;5140264695;Ne;0;4;1;5
12426;Šermukšnėlė;TOŠINUKAI;78341448188;Taip;6;2;1;9
12427;Šermukšnėlė;TOŠINUKAI;8279692394;Taip;17;0;0;17
12428;Šermukšnėlė;TOŠINUKAI;5096946133;Taip;0;1;0;1
12429;Šermukšnėlė;TOŠINUKAI;2380988728;Ne;0;1;1;2
12430;Šermukšnėlė;TOŠINUKAI;8956573129;Ne;11;0;0;11
12431;Šermukšnėlė;TOŠINUKAI;4981204674;Taip;3;1;0;4
12432;Šermukšnėlė;TOŠINUKAI;7229632099;Taip;8;1;0;9
12433;Šermukšnėlė;TOŠINUKAI;2529526401;Ne;7;1;3;11
12434;Šermukšnėlė;TOŠINUKAI;7038705221;Taip;5;0;0;5
12435;Šermukšnėlė;TOŠINUKAI;6413821285;Taip;0;12;0;12
12436;Šermukšnėlė;TOŠINUKAI;9035625467;Ne;0;0;1;1
12437;Šermukšnėlė;TOŠINUKAI;3081548524;Taip;2;1;0;3
12438;Šermukšnėlė;TOŠINUKAI;5832072195;Taip;3;10;0;13
12439;Šermukšnėlė;TOŠINUKAI;3222466449;Taip;7;3;1;11
12440;Šermukšnėlė;TOŠINUKAI;6430627501;Taip;0;4;0;4
12441;Šermukšnėlė;TOŠINUKAI;9442514813;Taip;3;0;0;3
12442;Šermukšnėlė;TOŠINUKAI;1569084597;Taip;7;1;1;9
12443;Šermukšnėlė;ODINUKAI;4422415026;Ne;8;6;6;20
12444;Šermukšnėlė;ODINUKAI;5545018656;Taip;0;0;1;1
12445;Šermukšnėlė;ODINUKAI;2176788727;Ne;8;0;1;9
12446;Šermukšnėlė;ODINUKAI;5575518612;Taip;5;0;0;5
12447;Šermukšnėlė;ODINUKAI;5733540837;Taip;10;0;4;14
12448;Šermukšnėlė;ODINUKAI;7262199284;Taip;5;1;0;6
12449;Šermukšnėlė;ODINUKAI;5159461963;Taip;0;6;0;6
12450;Šermukšnėlė;ODINUKAI;5354978646;Taip;0;1;2;3
12451;Šermukšnėlė;ODINUKAI;1882432812;Taip;0;1;2;3
12452;Šermukšnėlė;ODINUKAI;3949629658;Taip;0;1;0;1
12453;Šermukšnėlė;ODINUKAI;6105915822;Taip;6;0;0;6
12454;Šermukšnėlė;ODINUKAI;9742208172;Taip;1;1;1;3
12455;Šermukšnėlė;ODINUKAI;7667114310;Taip;14;1;1;16
12456;Šermukšnėlė;ODINUKAI;7245206247;Taip;0;0;4;4
12457;Šermukšnėlė;ODINUKAI;5397385093;Taip;6;0;3;9
12458;Šermukšnėlė;ODINUKAI;4331948700;Taip;0;0;2;2
12459;Šermukšnėlė;ODINUKAI;6718242890;Taip;10;1;0;11
12460;Šermukšnėlė;ODINUKAI;9664249364;Taip;7;1;0;8
12461;Šermukšnėlė;ODINUKAI;1064222922;Taip;16;0;4;20
12462;Šermukšnėlė;ODINUKAI;7770630580;Taip;5;0;7;12
12463;Šermukšnėlė;ODINUKAI;6194188831;Taip;0;1;0;1
12464;Šermukšnėlė;KRIAUKLELĖS;3613456202;Taip;8;0;6;14
12465;Šermukšnėlė;KRIAUKLELĖS;8541743148;Taip;3;1;0;4
12466;Šermukšnėlė;KRIAUKLELĖS;8709426669;Taip;0;12;0;12
12467;Šermukšnėlė;KRIAUKLELĖS;6585484701;Taip;9;1;1;11
12468;Šermukšnėlė;KRIAUKLELĖS;6599779539;Taip;8;5;0;13
12469;Šermukšnėlė;KRIAUKLELĖS;9876533442;Taip;0;0;1;1
12470;Šermukšnėlė;KRIAUKLELĖS;3653792683;Taip;5;3;2;10
12471;Šermukšnėlė;KRIAUKLELĖS;2506945279;Taip;6;0;0;6
12472;Šermukšnėlė;KRIAUKLELĖS;7266947985;Taip;3;0;2;5
12473;Šermukšnėlė;KRIAUKLELĖS;4256630681;Taip;14;0;0;14
12474;Šermukšnėlė;KRIAUKLELĖS;8117261716;Taip;10;0;0;10
12475;Šermukšnėlė;KRIAUKLELĖS;7458930634;Taip;7;1;0;8
12476;Šermukšnėlė;KRIAUKLELĖS;3245643086;Taip;14;5;0;19
12477;Šermukšnėlė;KRIAUKLELĖS;6342714998;Taip;14;0;0;14
12478;Šermukšnėlė;KRIAUKLELĖS;6946711443;Taip;7;0;3;10
12479;Šermukšnėlė;KRIAUKLELĖS;9074111563;Taip;0;0;3;3
12480;Šermukšnėlė;KRIAUKLELĖS;9908568127;Taip;3;6;0;9
12481;Šermukšnėlė;KRIAUKLELĖS;9783673534;Taip;0;1;1;2
12482;Šermukšnėlė;KRIAUKLELĖS;3002999054;Taip;2;0;0;2
12483;Šermukšnėlė;KRIAUKLELĖS;8748166398;Ne;6;0;2;8
12484;Šermukšnėlė;KRIAUKLELĖS;5408843906;Taip;8;1;0;9
12485;Šermukšnėlė;VYTINUKAI;1523361932;Taip;0;1;2;3
12486;Šermukšnėlė;VYTINUKAI;8531953934;Taip;8;1;1;10
12487;Šermukšnėlė;VYTINUKAI;25189813939;Taip;8;1;3;12
12488;Šermukšnėlė;VYTINUKAI;83123267733;Taip;5;1;3;9
12489;Šermukšnėlė;VYTINUKAI;20028832329;Taip;0;4;0;4
12490;Šermukšnėlė;VYTINUKAI;3959795064;Taip;0;3;0;3
12491;Šermukšnėlė;VYTINUKAI;8498288021;Ne;0;1;0;1
12492;Šermukšnėlė;VYTINUKAI;1244964311;Taip;6;1;0;7
12493;Šermukšnėlė;VYTINUKAI;83882579952;Taip;0;6;0;6
12494;Šermukšnėlė;VYTINUKAI;60840526220;Taip;8;0;0;8
12495;Šermukšnėlė;VYTINUKAI;1025787925;Taip;0;1;1;2
12496;Šermukšnėlė;VYTINUKAI;1519623099;Taip;0;10;0;10
12497;Šermukšnėlė;VYTINUKAI;9654198217;Taip;8;4;1;13
12498;Šermukšnėlė;VYTINUKAI;1670047548;Taip;6;0;1;7
12499;Šermukšnėlė;VYTINUKAI;5281637612;Taip;0;1;2;3
12500;Šermukšnėlė;VYTINUKAI;1685592290;Taip;3;0;0;3
12501;Šermukšnėlė;VYTINUKAI;8123096990;Taip;4;1;1;6
12502;Šermukšnėlė;VYTINUKAI;8511421692;Taip;6;1;3;10
12503;Šermukšnėlė;VYTINUKAI;3883861823;Taip;0;8;0;8
12504;Šermukšnėlė;VYTINUKAI;2163955454;Taip;9;0;0;9
12505;Šermukšnėlė;VYTINUKAI;5225263863;Taip;0;7;2;9
12506;Šermukšnėlė;GINTARĖLIAI;5069572637;Taip;5;1;1;7
12507;Šermukšnėlė;GINTARĖLIAI;8249749948;Taip;14;1;0;15
12508;Šermukšnėlė;GINTARĖLIAI;2989011150;Taip;11;1;1;13
12509;Šermukšnėlė;GINTARĖLIAI;3747531232;Ne;0;1;1;2
12510;Šermukšnėlė;GINTARĖLIAI;1996859146;Taip;4;0;2;6
12511;Šermukšnėlė;GINTARĖLIAI;4176986876;Taip;9;8;0;17
12512;Šermukšnėlė;GINTARĖLIAI;7036078780;Taip;12;3;0;15
12513;Šermukšnėlė;GINTARĖLIAI;1994737857;Taip;15;0;0;15
12514;Šermukšnėlė;GINTARĖLIAI;4619811264;Taip;4;0;0;4
12515;Šermukšnėlė;GINTARĖLIAI;5886893562;Taip;6;7;0;13
12516;Šermukšnėlė;GINTARĖLIAI;4783726095;Taip;3;1;0;4
12517;Šermukšnėlė;GINTARĖLIAI;9714566919;Ne;10;0;1;11
12518;Šermukšnėlė;GINTARĖLIAI;5172187141;Taip;0;12;0;12
12519;Šermukšnėlė;GINTARĖLIAI;3688946505;Taip;16;0;1;17
12520;Šermukšnėlė;GINTARĖLIAI;5905330617;Taip;8;0;1;9
12521;Šermukšnėlė;GINTARĖLIAI;1636944853;Taip;0;13;0;13
12522;Šermukšnėlė;GINTARĖLIAI;7053319091;Ne;7;0;4;11
12523;Šermukšnėlė;GINTARĖLIAI;6351841889;Taip;22;0;0;22
12524;Šermukšnėlė;GINTARĖLIAI;7305013368;Taip;0;2;0;2
12525;Šermukšnėlė;GINTARĖLIAI;6698650179;Taip;10;0;3;13
12526;Šermukšnėlė;GINTARĖLIAI;7106405983;Taip;13;4;0;17
12527;Šermukšnėlė;GINTARĖLIAI;8639470631;Taip;8;0;1;9
12528;Šermukšnėlė;AKMENUKAI;3543061360;Taip;8;0;0;8
12529;Šermukšnėlė;AKMENUKAI;7564745299;Taip;0;10;0;10
12530;Šermukšnėlė;AKMENUKAI;9617044855;Taip;0;12;0;12
12531;Šermukšnėlė;AKMENUKAI;1856012121;Taip;9;0;0;9
12532;Šermukšnėlė;AKMENUKAI;8407947566;Taip;11;0;0;11
12533;Šermukšnėlė;AKMENUKAI;8859731179;Taip;6;3;1;10
12534;Šermukšnėlė;AKMENUKAI;1902848560;Taip;5;5;0;10
12535;Šermukšnėlė;AKMENUKAI;3513568460;Taip;11;3;1;15
12536;Šermukšnėlė;AKMENUKAI;6896990721;Taip;6;1;0;7
12537;Šermukšnėlė;AKMENUKAI;4230698872;Taip;3;0;0;3
12538;Šermukšnėlė;AKMENUKAI;8669676262;Taip;5;0;0;5
12539;Šermukšnėlė;AKMENUKAI;3148857617;Taip;0;14;0;14
12540;Šermukšnėlė;AKMENUKAI;4965640386;Taip;0;0;5;5
12541;Šermukšnėlė;AKMENUKAI;3639954786;Taip;5;0;8;13
12542;Šermukšnėlė;AKMENUKAI;7843128263;Taip;0;1;0;1
12543;Šermukšnėlė;AKMENUKAI;9805841777;Taip;2;10;0;12
12544;Šermukšnėlė;AKMENUKAI;3945291560;Taip;3;0;0;3
12545;Šermukšnėlė;AKMENUKAI;5660238634;Taip;4;0;2;6
12546;Šermukšnėlė;AKMENUKAI;6067298318;Taip;7;1;0;8
12547;Šermukšnėlė;AKMENUKAI;5678559268;Taip;10;3;0;13
12548;Šermukšnėlė;AKMENUKAI;8479230675;Taip;0;11;0;11
12549;Šermukšnėlė;AKMENUKAI;6162830167;Taip;14;0;2;16
12550;Šermukšnėlė;SIŪLINUKAI;4619600451;Ne;0;0;8;8
12551;Šermukšnėlė;SIŪLINUKAI;2967000352;Ne;3;0;3;6
12552;Šermukšnėlė;SIŪLINUKAI;4528448735;Taip;5;0;0;5
12553;Šermukšnėlė;SIŪLINUKAI;2740644605;Taip;15;0;0;15
12554;Šermukšnėlė;SIŪLINUKAI;8454298610;Taip;4;0;4;8
12555;Šermukšnėlė;SIŪLINUKAI;6429038861;Taip;7;0;2;9
12556;Šermukšnėlė;SIŪLINUKAI;6429038861;Taip;7;0;2;9
12557;Šermukšnėlė;SIŪLINUKAI;6429038861;Taip;7;0;2;9
12558;Šermukšnėlė;SIŪLINUKAI;6429038861;Taip;7;0;2;9
12559;Šermukšnėlė;SIŪLINUKAI;1819553019;Taip;22;0;0;22
12560;Šermukšnėlė;SIŪLINUKAI;7568969509;Taip;17;0;0;17
12561;Šermukšnėlė;SIŪLINUKAI;7758886713;Ne;0;1;0;1
12562;Šermukšnėlė;SIŪLINUKAI;4390650081;Taip;0;0;4;4
12563;Šermukšnėlė;SIŪLINUKAI;5072021867;Taip;4;0;0;4
12564;Šermukšnėlė;SIŪLINUKAI;7934772640;Taip;9;2;0;11
12565;Šermukšnėlė;SIŪLINUKAI;3994075596;Ne;6;0;0;6
12566;Šermukšnėlė;SIŪLINUKAI;6231057889;Taip;7;0;2;9
12567;Šermukšnėlė;SIŪLINUKAI;3106890807;Taip;0;1;0;1
12568;Šermukšnėlė;SIŪLINUKAI;3979766151;Ne;8;0;0;8
12569;Šermukšnėlė;SIŪLINUKAI;9534316724;Taip;0;3;3;6
12570;Šermukšnėlė;SIŪLINUKAI;2705569653;Taip;4;0;2;6
12571;Šermukšnėlė;MEDINUKAi;8558117857;Ne;0;22;0;22
12572;Šermukšnėlė;MEDINUKAi;1318170904;Taip;3;0;5;8
12573;Šermukšnėlė;MEDINUKAi;6149973884;Taip;17;0;0;17
12574;Šermukšnėlė;MEDINUKAi;5874725607;Taip;3;0;4;7
12575;Šermukšnėlė;MEDINUKAi;7532979465;Taip;17;0;0;17
12576;Šermukšnėlė;MEDINUKAi;7834844175;Taip;1;0;0;1
12577;Šermukšnėlė;MEDINUKAi;7211488009;Taip;4;0;0;4
12578;Šermukšnėlė;MEDINUKAi;3359398381;Taip;14;0;0;14
12579;Šermukšnėlė;MEDINUKAi;6928863055;Taip;4;0;0;4
12580;Šermukšnėlė;MEDINUKAi;6531113007;Taip;2;1;0;3
12581;Šermukšnėlė;MEDINUKAi;8437052600;Taip;6;0;3;9
12582;Šermukšnėlė;MEDINUKAi;8200175951;Taip;25;0;0;25
12583;Šermukšnėlė;MEDINUKAi;7546040491;Taip;19;0;0;19
12584;Šermukšnėlė;MEDINUKAi;9872479998;Taip;15;6;0;21
12585;Šermukšnėlė;MEDINUKAi;8587108797;Taip;22;0;0;22
12586;Šermukšnėlė;MEDINUKAi;5605191023;Taip;4;0;0;4
12587;Šermukšnėlė;MEDINUKAi;2698741674;Taip;1;1;0;2
12588;Šermukšnėlė;SKUDURINUKAI;7523588943;Taip;1;1;0;2
12589;Šermukšnėlė;SKUDURINUKAI;9535836301;Taip;8;0;1;9
12590;Šermukšnėlė;SKUDURINUKAI;3138507073;Taip;13;0;0;13
12591;Šermukšnėlė;SKUDURINUKAI;5162694179;Taip;16;0;0;16
12592;Šermukšnėlė;SKUDURINUKAI;9247356229;Taip;8;5;0;13
12593;Šermukšnėlė;SKUDURINUKAI;3206222470;Taip;19;0;0;19
12594;Šermukšnėlė;SKUDURINUKAI;5751303170;Taip;4;1;0;5
12595;Šermukšnėlė;SKUDURINUKAI;2810624440;Taip;4;7;0;11
12596;Šermukšnėlė;SKUDURINUKAI;3955219247;Taip;6;4;0;10
12597;Šermukšnėlė;SKUDURINUKAI;5564759354;Ne;22;0;0;22
12598;Šermukšnėlė;SKUDURINUKAI;1931894084;Taip;10;0;1;11
12599;Šermukšnėlė;SKUDURINUKAI;6778901855;Taip;6;0;4;10
12600;Šermukšnėlė;SKUDURINUKAI;1502704170;Taip;19;3;0;22
12601;Šermukšnėlė;SKUDURINUKAI;6524173015;Taip;3;0;0;3
12602;Šermukšnėlė;SKUDURINUKAI;4323596263;Taip;4;0;0;4
12603;Šermukšnėlė;PAGRANDUKAI;8802335133;Taip;10;6;0;16
12604;Šermukšnėlė;PAGRANDUKAI;6797936390;Taip;5;7;0;12
12605;Šermukšnėlė;PAGRANDUKAI;1312471779;Taip;0;1;3;4
12606;Šermukšnėlė;PAGRANDUKAI;6286235756;Taip;8;1;1;10
12607;Šermukšnėlė;PAGRANDUKAI;4219655802;Taip;14;0;1;15
12608;Šermukšnėlė;PAGRANDUKAI;4337084152;Taip;17;0;0;17
12609;Šermukšnėlė;PAGRANDUKAI;8710910167;Taip;5;0;7;12
12610;Šermukšnėlė;PAGRANDUKAI;8092422909;Taip;16;0;3;19
12611;Šermukšnėlė;PAGRANDUKAI;9246072554;Taip;9;1;0;10
12612;Šermukšnėlė;PAGRANDUKAI;6185588116;Ne;0;0;5;5
12613;Šermukšnėlė;PAGRANDUKAI;1209135668;Taip;18;0;0;18
12614;Šermukšnėlė;PAGRANDUKAI;9080074486;Taip;8;2;5;15
12615;Šermukšnėlė;PAGRANDUKAI;7098953763;Taip;10;4;0;14
12616;Šermukšnėlė;PAGRANDUKAI;5081685546;Ne;13;0;8;21
12617;Šermukšnėlė;PAGRANDUKAI;5456669766;Taip;0;5;0;5
12618;Šermukšnėlė;PAGRANDUKAI;8641098720;Taip;14;0;0;14
12619;Šermukšnėlė;PAGRANDUKAI;4810571143;Taip;3;2;0;5
12620;Šermukšnėlė;PAGRANDUKAI;8130815072;Ne;12;0;0;12
12621;Šypsena;NYKŠTUKAI;8913058656;Taip;15;2;1;18
12622;Šypsena;NYKŠTUKAI;8508569167;Taip;6;2;0;8
12623;Šypsena;NYKŠTUKAI;5818211923;Taip;10;0;7;17
12624;Šypsena;NYKŠTUKAI;8665786789;Taip;4;0;5;9
12625;Šypsena;NYKŠTUKAI;1716274053;Ne;0;6;2;8
12626;Šypsena;NYKŠTUKAI;6724776618;Taip;12;3;7;22
12627;Šypsena;NYKŠTUKAI;2790906806;Ne;10;4;0;14
12628;Šypsena;NYKŠTUKAI;9363618080;Taip;11;0;0;11
12629;Šypsena;NYKŠTUKAI;9702364620;Ne;6;13;0;19
12630;Šypsena;NYKŠTUKAI;3733757483;Taip;5;0;0;5
12631;Šypsena;NYKŠTUKAI;2179657619;Ne;16;6;0;22
12632;Šypsena;NYKŠTUKAI;2900195046;Taip;8;19;0;27
12633;Šypsena;NYKŠTUKAI;3724645162;Taip;17;0;0;17
12634;Šypsena;NYKŠTUKAI;3003901966;Taip;24;5;0;29
12635;Šypsena;NYKŠTUKAI;2182189246;Taip;15;0;1;16
12636;Šypsena;NYKŠTUKAI;1431850136;Taip;0;11;0;11
12637;Šypsena;NYKŠTUKAI;5142969776;Taip;13;0;8;21
12638;Šypsena;NYKŠTUKAI;8439694239;Taip;18;1;5;24
12639;Šypsena;NYKŠTUKAI;6377979434;Taip;11;2;5;18
12640;Šypsena;NYKŠTUKAI;7332307199;Taip;15;0;3;18
12641;Šypsena;NYKŠTUKAI;7074211876;Taip;0;17;5;22
12642;Šypsena;SPINDULIUKAI;7898387398;Taip;5;0;10;15
12643;Šypsena;SPINDULIUKAI;1324902555;Taip;12;1;1;14
12644;Šypsena;SPINDULIUKAI;5222603743;Taip;9;0;0;9
12645;Šypsena;SPINDULIUKAI;7120597034;Taip;2;0;2;4
12646;Šypsena;SPINDULIUKAI;5879506651;Ne;17;0;7;24
12647;Šypsena;SPINDULIUKAI;3823623458;Ne;0;5;0;5
12648;Šypsena;SPINDULIUKAI;4695547847;Taip;6;0;0;6
12649;Šypsena;SPINDULIUKAI;6713182218;Taip;11;4;4;19
12650;Šypsena;SPINDULIUKAI;1287205292;Ne;17;0;1;18
12651;Šypsena;SPINDULIUKAI;8215278033;Ne;0;0;10;10
12652;Šypsena;SPINDULIUKAI;7537442618;Taip;8;1;7;16
12653;Šypsena;SPINDULIUKAI;2584574423;Taip;23;0;0;23
12654;Šypsena;SPINDULIUKAI;9704350208;Ne;0;5;10;15
12655;Šypsena;SPINDULIUKAI;5906001927;Taip;13;0;3;16
12656;Šypsena;SPINDULIUKAI;6951845385;Taip;3;0;4;7
12657;Šypsena;SPINDULIUKAI;7877396588;Taip;6;2;5;13
12658;Šypsena;SPINDULIUKAI;4520148322;Taip;5;2;0;7
12659;Šypsena;SPINDULIUKAI;3901424559;Taip;0;15;7;22
12660;Šypsena;SPINDULIUKAI;8765509994;Taip;8;2;2;12
12661;Šypsena;SPINDULIUKAI;3429836513;Taip;10;3;20;33
12662;Šypsena;SPINDULIUKAI;8566236342;Taip;13;0;7;20
12663;Šypsena;SKRUZDELIUKAI;5611440056;Ne;8;0;0;8
12664;Šypsena;SKRUZDELIUKAI;1114341518;Taip;15;0;0;15
12665;Šypsena;SKRUZDELIUKAI;1558614852;Taip;10;2;2;14
12666;Šypsena;SKRUZDELIUKAI;1897176871;Taip;0;12;0;12
12667;Šypsena;SKRUZDELIUKAI;8715718525;Taip;6;0;9;15
12668;Šypsena;SKRUZDELIUKAI;1181590127;Taip;5;17;0;22
12669;Šypsena;SKRUZDELIUKAI;4808041625;Taip;23;0;0;23
12670;Šypsena;SKRUZDELIUKAI;4038279267;Taip;12;1;0;13
12671;Šypsena;SKRUZDELIUKAI;5834057370;Taip;6;4;0;10
12672;Šypsena;SKRUZDELIUKAI;1515803985;Taip;0;6;0;6
12673;Šypsena;SKRUZDELIUKAI;3809171499;Taip;0;5;0;5
12674;Šypsena;SKRUZDELIUKAI;4344780723;Taip;3;0;8;11
12675;Šypsena;SKRUZDELIUKAI;5928432220;Taip;8;0;3;11
12676;Šypsena;SKRUZDELIUKAI;5504570516;Taip;7;4;0;11
12677;Šypsena;SKRUZDELIUKAI;1063834589;Taip;8;0;0;8
12678;Šypsena;SKRUZDELIUKAI;5369445077;Taip;5;0;2;7
12679;Šypsena;SKRUZDELIUKAI;2798819321;Taip;8;9;0;17
12680;Šypsena;SKRUZDELIUKAI;3506046076;Ne;13;1;1;15
12681;Šypsena;SKRUZDELIUKAI;4450146424;Taip;12;0;1;13
12682;Šypsena;SKRUZDELIUKAI;7519967594;Taip;0;0;1;1
12683;Šypsena;Bitutės;1796837022;Ne;0;3;0;3
12684;Šypsena;Bitutės;6158973964;Taip;8;0;0;8
12685;Šypsena;Bitutės;4766170132;Ne;0;0;1;1
12686;Šypsena;Bitutės;7569495879;Taip;5;0;0;5
12687;Šypsena;Bitutės;6832433711;Taip;0;9;0;9
12688;Šypsena;Bitutės;2995753269;Taip;0;3;3;6
12689;Šypsena;Bitutės;2312828770;Taip;1;0;0;1
12690;Šypsena;Bitutės;2248628927;Taip;0;1;0;1
12691;Šypsena;Bitutės;2706678026;Ne;11;0;0;11
12692;Šypsena;Bitutės;7413098580;Ne;4;7;0;11
12693;Šypsena;Bitutės;3063226692;Ne;0;3;0;3
12694;Šypsena;Bitutės;5985974927;Taip;0;9;0;9
12695;Šypsena;Bitutės;3387625466;Taip;10;3;4;17
12696;Šypsena;Bitutės;1669768648;Ne;0;6;0;6
12697;Šypsena;Bitutės;1575413188;Taip;0;3;0;3
12698;Šypsena;Bitutės;6511231991;Ne;0;0;1;1
12699;Šypsena;Bitutės;2005543016;Ne;9;1;0;10
12700;Šypsena;Bitutės;5568502083;Taip;5;2;0;7
12701;Šypsena;MEŠKIUKAI;9696633725;Taip;7;0;10;17
12702;Šypsena;MEŠKIUKAI;7876871684;Taip;8;6;0;14
12703;Šypsena;MEŠKIUKAI;6055482561;Ne;15;0;0;15
12704;Šypsena;MEŠKIUKAI;6028006499;Taip;7;0;1;8
12705;Šypsena;MEŠKIUKAI;3724483762;Ne;8;0;0;8
12706;Šypsena;MEŠKIUKAI;7817486488;Taip;20;1;2;23
12707;Šypsena;MEŠKIUKAI;9862387726;Taip;9;1;4;14
12708;Šypsena;MEŠKIUKAI;8001187137;Ne;0;0;1;1
12709;Šypsena;MEŠKIUKAI;3663446767;Taip;3;6;0;9
12710;Šypsena;MEŠKIUKAI;8094166916;Taip;13;1;2;16
12711;Šypsena;MEŠKIUKAI;5446516798;Taip;12;0;0;12
12712;Šypsena;MEŠKIUKAI;5094556499;Taip;18;0;1;19
12713;Šypsena;MEŠKIUKAI;4496704989;Taip;5;8;2;15
12714;Šypsena;MEŠKIUKAI;7471913547;Taip;2;1;1;4
12715;Šypsena;MEŠKIUKAI;7174068697;Taip;17;0;1;18
12716;Šypsena;BORUŽĖLĖS;6738149077;Taip;15;5;2;22
12717;Šypsena;BORUŽĖLĖS;7905089772;Taip;6;1;5;12
12718;Šypsena;BORUŽĖLĖS;4011596895;Taip;12;1;3;16
12719;Šypsena;BORUŽĖLĖS;7234904026;Ne;20;3;0;23
12720;Šypsena;BORUŽĖLĖS;8963484558;Ne;10;1;0;11
12721;Šypsena;BORUŽĖLĖS;3951000812;Taip;9;10;0;19
12722;Šypsena;BORUŽĖLĖS;2177181171;Taip;28;0;0;28
12723;Šypsena;BORUŽĖLĖS;7960872132;Ne;15;0;1;16
12724;Šypsena;BORUŽĖLĖS;4260693029;Ne;10;12;0;22
12725;Šypsena;BORUŽĖLĖS;1657019248;Taip;13;0;2;15
12726;Šypsena;BORUŽĖLĖS;8756079118;Taip;0;9;0;9
12727;Šypsena;BORUŽĖLĖS;6859531936;Ne;14;1;0;15
12728;Šnekutis;DRUGELIŲ;1504945841;Taip;9;9;0;18
12729;Šnekutis;DRUGELIŲ;6305168453;Taip;5;0;3;8
12730;Šnekutis;DRUGELIŲ;9543014297;Taip;18;0;0;18
12731;Šnekutis;DRUGELIŲ;3096125224;Taip;0;22;0;22
12732;Šnekutis;DRUGELIŲ;3386995244;Taip;7;0;0;7
12733;Šnekutis;DRUGELIŲ;2131948397;Taip;0;0;3;3
12734;Šnekutis;DRUGELIŲ;1902486846;Taip;10;0;0;10
12735;Šnekutis;DRUGELIŲ;8984597121;Taip;10;0;0;10
12736;Šnekutis;DRUGELIŲ;8810371475;Taip;0;0;2;2
12737;Šnekutis;DRUGELIŲ;7680962037;Taip;11;0;0;11
12738;Šnekutis;DRUGELIŲ;7089148766;Ne;9;0;0;9
12739;Šnekutis;DRUGELIŲ;3611064172;Taip;7;0;0;7
12740;Šnekutis;DRUGELIŲ;3079202929;Taip;5;0;0;5
12741;Šnekutis;DRUGELIŲ;8209686459;Taip;3;0;0;3
12742;Šnekutis;DRUGELIŲ;8036600501;Taip;7;0;0;7
12743;Šnekutis;DRUGELIŲ;6071004512;Taip;5;2;0;7
12744;Šnekutis;DRUGELIŲ;8570372260;Taip;5;0;0;5
12745;Šnekutis;DRUGELIŲ;1556960616;Taip;6;4;0;10
12746;Šnekutis;DRUGELIŲ;3177449195;Taip;5;2;0;7
12747;Šnekutis;DRUGELIŲ;4380966487;Taip;7;0;0;7
12748;Šnekutis;DRUGELIŲ;7954240439;Taip;21;0;0;21
12749;Šnekutis;DRUGELIŲ;6330033887;Taip;10;0;0;10
12750;Šnekutis;Kačiukų;3281475303;Taip;7;0;1;8
12751;Šnekutis;Kačiukų;9670205249;Taip;6;1;0;7
12752;Šnekutis;Kačiukų;7615716438;Ne;5;2;0;7
12753;Šnekutis;Kačiukų;9780684867;Ne;8;4;0;12
12754;Šnekutis;Kačiukų;3271262071;Ne;14;0;0;14
12755;Šnekutis;Kačiukų;3166309530;Taip;6;3;4;13
12756;Šnekutis;Kačiukų;4143844589;Taip;0;0;1;1
12757;Šnekutis;Kačiukų;7236658561;Taip;9;0;0;9
12758;Šnekutis;Kačiukų;4992188525;Ne;5;0;0;5
12759;Šnekutis;Kačiukų;7638626055;Taip;0;0;6;6
12760;Šnekutis;Kačiukų;9157136735;Ne;0;15;0;15
12761;Šnekutis;Kačiukų;4920263429;Taip;8;5;0;13
12762;Šnekutis;Kačiukų;5909584565;Taip;9;3;0;12
12763;Šnekutis;Kačiukų;6234943180;Taip;11;3;0;14
12764;Šnekutis;Kačiukų;2914145045;Ne;28;0;0;28
12765;Šnekutis;Kačiukų;8340697546;Ne;10;0;0;10
12766;Šnekutis;Kačiukų;9896249776;Taip;10;3;0;13
12767;Šnekutis;Kačiukų;2656152037;Taip;0;6;0;6
12768;Šnekutis;Kačiukų;9051956302;Taip;8;3;11;22
12769;Šnekutis;Kačiukų;5521822696;Ne;0;1;0;1
12770;Šnekutis;Kačiukų;9942669058;Ne;0;0;1;1
12771;Šnekutis;Kačiukų;4624075875;Taip;0;0;9;9
12772;Šnekutis;Pėlėdžiukų;4334155280;Taip;0;1;0;1
12773;Šnekutis;Pėlėdžiukų;77534335117;Ne;0;1;0;1
12774;Šnekutis;Pėlėdžiukų;3312928478;Taip;0;3;0;3
12775;Šnekutis;Pėlėdžiukų;8745465796;Taip;0;3;17;20
12776;Šnekutis;Pėlėdžiukų;3170928052;Ne;8;1;0;9
12777;Šnekutis;Pėlėdžiukų;3578045341;Ne;0;2;2;4
12778;Šnekutis;Pėlėdžiukų;5117544317;Taip;0;0;1;1
12779;Šnekutis;Pėlėdžiukų;5615869149;Taip;8;4;0;12
12780;Šnekutis;Pėlėdžiukų;9511116249;Taip;7;3;0;10
12781;Šnekutis;Pėlėdžiukų;1369660223;Taip;0;3;1;4
12782;Šnekutis;Pėlėdžiukų;2525115674;Taip;6;0;0;6
12783;Šnekutis;Pėlėdžiukų;9601932777;Taip;9;3;3;15
12784;Šnekutis;Pėlėdžiukų;4302555600;Taip;9;3;3;15
12785;Šnekutis;Pėlėdžiukų;7507857415;Ne;0;3;0;3
12786;Šnekutis;Pėlėdžiukų;7514753023;Taip;6;0;5;11
12787;Šnekutis;Boružėlių;4835202527;Taip;9;0;0;9
12788;Šnekutis;Boružėlių;9326455786;Taip;3;0;0;3
12789;Šnekutis;Boružėlių;9054899440;Taip;0;0;1;1
12790;Šnekutis;Boružėlių;9862362744;Taip;6;0;0;6
12791;Šnekutis;Boružėlių;5597629090;Taip;6;0;1;7
12792;Šnekutis;Boružėlių;2843483435;Taip;11;0;0;11
12793;Šnekutis;Boružėlių;5906320006;Taip;7;0;0;7
12794;Šnekutis;Boružėlių;6405894763;Ne;10;7;0;17
12795;Šnekutis;Boružėlių;3889176018;Taip;4;0;0;4
12796;Šnekutis;Boružėlių;6749848086;Taip;0;0;2;2
12797;Šnekutis;Boružėlių;6544973632;Taip;9;0;0;9
12798;Šnekutis;Boružėlių;6146988521;Taip;5;8;0;13
12799;Šnekutis;Boružėlių;5519015388;Taip;0;0;10;10
12800;Šnekutis;Boružėlių;3628210526;Taip;15;1;0;16
12801;Šnekutis;Boružėlių;7344776758;Taip;6;0;2;8
12802;Šnekutis;Boružėlių;5970951526;Taip;0;0;1;1
12803;Šnekutis;Boružėlių;3344425033;Ne;9;0;6;15
12804;Šnekutis;Boružėlių;3937465849;Ne;7;4;2;13
12805;Šnekutis;Boružėlių;8219465079;Taip;5;5;0;10
12806;Šnekutis;Boružėlių;7307895397;Taip;3;0;1;4
12807;Šnekutis;Boružėlių;3371393656;Taip;0;0;8;8
12808;Šnekutis;Boružėlių;2779793970;Ne;10;3;0;13
12809;Šnekutis;Meškučių;2852111627;Taip;13;0;0;13
12810;Šnekutis;Meškučių;3214549246;Ne;22;0;0;22
12811;Šnekutis;Meškučių;6306269165;Taip;7;0;0;7
12812;Šnekutis;Meškučių;2626247219;Taip;14;0;2;16
12813;Šnekutis;Meškučių;7707897830;Taip;17;0;0;17
12814;Šnekutis;Meškučių;2042842873;Taip;9;1;0;10
12815;Šnekutis;Meškučių;2140099519;Taip;9;0;0;9
12816;Šnekutis;Meškučių;9709701441;Taip;6;0;0;6
12817;Šnekutis;Meškučių;2761479685;Taip;3;0;0;3
12818;Šnekutis;Meškučių;1219175855;Taip;19;0;0;19
12819;Šnekutis;Meškučių;9574210410;Taip;6;0;0;6
12820;Šnekutis;Meškučių;7980166125;Taip;12;3;0;15
12821;Šnekutis;Meškučių;8456957469;Taip;11;0;0;11
12822;Šnekutis;Meškučių;3572114463;Taip;9;0;0;9
12823;Šnekutis;Meškučių;8417485561;Taip;8;0;1;9
12824;Šnekutis;Meškučių;2312968654;Taip;7;0;0;7
12825;Šnekutis;Meškučių;1475304511;Taip;10;4;0;14
12826;Šnekutis;Viščiukų;9322106995;Taip;7;0;0;7
12827;Šnekutis;Viščiukų;3842436406;Taip;12;0;0;12
12828;Šnekutis;Viščiukų;3115675798;Taip;11;0;0;11
12829;Šnekutis;Viščiukų;9385583890;Taip;16;6;0;22
12830;Šnekutis;Viščiukų;4848437026;Taip;9;0;0;9
12831;Šnekutis;Viščiukų;9772257715;Taip;4;9;0;13
12832;Šnekutis;Viščiukų;3593766968;Taip;6;0;4;10
12833;Šnekutis;Viščiukų;1833392181;Taip;1;0;1;2
12834;Šnekutis;Viščiukų;1805259980;Taip;3;0;0;3
12835;Šnekutis;Viščiukų;3588737003;Taip;0;0;21;21
12836;Šnekutis;Viščiukų;7200356364;Taip;14;0;0;14
12837;Šnekutis;Viščiukų;1248466603;Taip;22;0;0;22
12838;Šnekutis;Viščiukų;7006343288;Taip;22;0;0;22
12839;Šnekutis;Viščiukų;5919317274;Taip;1;0;0;1
12840;Užupiukas;VYTURĖLIŲ;5116564840;Taip;5;0;7;12
12841;Užupiukas;VYTURĖLIŲ;7443013255;Taip;7;0;3;10
12842;Užupiukas;VYTURĖLIŲ;3656400244;Taip;0;14;4;18
12843;Užupiukas;VYTURĖLIŲ;3829013911;Taip;0;1;5;6
12844;Užupiukas;VYTURĖLIŲ;9212428150;Taip;0;0;1;1
12845;Užupiukas;VYTURĖLIŲ;8001099421;Taip;11;0;0;11
12846;Užupiukas;VYTURĖLIŲ;4401569800;Taip;7;1;4;12
12847;Užupiukas;VYTURĖLIŲ;1391826582;Taip;4;0;7;11
12848;Užupiukas;VYTURĖLIŲ;5021163099;Taip;0;0;4;4
12849;Užupiukas;VYTURĖLIŲ;8960813016;Taip;0;0;4;4
12850;Užupiukas;VYTURĖLIŲ;9132605734;Taip;14;0;3;17
12851;Užupiukas;VYTURĖLIŲ;8245876832;Ne;10;3;0;13
12852;Užupiukas;VYTURĖLIŲ;7532497390;Taip;0;0;9;9
12853;Užupiukas;VYTURĖLIŲ;5168946019;Taip;0;5;2;7
12854;Užupiukas;VYTURĖLIŲ;5718382826;Taip;9;5;4;18
12855;Užupiukas;VYTURĖLIŲ;9209209113;Ne;8;0;2;10
12856;Užupiukas;VYTURĖLIŲ;9070732925;Taip;0;8;0;8
12857;Užupiukas;VYTURĖLIŲ;1647271985;Ne;0;0;7;7
12858;Užupiukas;VYTURĖLIŲ;1791922219;Taip;0;0;2;2
12859;Užupiukas;VYTURĖLIŲ;8347350503;Taip;19;0;0;19
12860;Užupiukas;VYTURĖLIŲ;2580733127;Taip;3;1;2;6
12861;Užupiukas;KAČIUKŲ;3905448176;Taip;0;0;2;2
12862;Užupiukas;KAČIUKŲ;3567963511;Taip;4;3;4;11
12863;Užupiukas;KAČIUKŲ;9991552624;Taip;0;3;6;9
12864;Užupiukas;KAČIUKŲ;3048959458;Taip;13;1;0;14
12865;Užupiukas;KAČIUKŲ;3080668107;Ne;0;3;5;8
12866;Užupiukas;KAČIUKŲ;1809036046;Ne;9;1;1;11
12867;Užupiukas;KAČIUKŲ;1102468034;Taip;0;3;2;5
12868;Užupiukas;KAČIUKŲ;1464016943;Taip;11;3;0;14
12869;Užupiukas;KAČIUKŲ;4485435274;Taip;0;2;3;5
12870;Užupiukas;KAČIUKŲ;1102293237;Taip;5;3;0;8
12871;Užupiukas;KAČIUKŲ;9386211193;Taip;3;8;4;15
12872;Užupiukas;KAČIUKŲ;7048114101;Taip;8;3;2;13
12873;Užupiukas;KAČIUKŲ;1388346927;Taip;0;2;0;2
12874;Užupiukas;KAČIUKŲ;9333587467;Taip;0;1;0;1
12875;Užupiukas;KAČIUKŲ;7574528186;Ne;0;3;1;4
12876;Užupiukas;KAČIUKŲ;7092857844;Taip;0;3;1;4
12877;Užupiukas;KAČIUKŲ;2606742144;Taip;7;3;0;10
12878;Užupiukas;KAČIUKŲ;5233447872;Taip;0;0;22;22
12879;Užupiukas;KAČIUKŲ;9719845726;Taip;9;1;0;10
12880;Užupiukas;KAČIUKŲ;3543913063;Taip;4;3;7;14
12881;Užupiukas;KAČIUKŲ;4920190785;Taip;11;3;4;18
12882;Užupiukas;DRUGELIŲ;8876174256;Taip;9;0;4;13
12883;Užupiukas;DRUGELIŲ;5239006321;Taip;0;2;9;11
12884;Užupiukas;DRUGELIŲ;7581152903;Taip;4;1;4;9
12885;Užupiukas;DRUGELIŲ;5361599156;Taip;5;0;0;5
12886;Užupiukas;DRUGELIŲ;4680027403;Taip;9;0;5;14
12887;Užupiukas;DRUGELIŲ;6698907535;Taip;13;0;0;13
12888;Užupiukas;DRUGELIŲ;9577167600;Ne;11;1;2;14
12889;Užupiukas;DRUGELIŲ;3419182422;Taip;9;0;3;12
12890;Užupiukas;DRUGELIŲ;4854016957;Taip;9;1;3;13
12891;Užupiukas;DRUGELIŲ;8692826414;Taip;5;1;3;9
12892;Užupiukas;DRUGELIŲ;7169272175;Taip;15;1;5;21
12893;Užupiukas;DRUGELIŲ;1156471313;Taip;5;3;3;11
12894;Užupiukas;DRUGELIŲ;4595291532;Taip;0;0;10;10
12895;Užupiukas;DRUGELIŲ;3383643388;Ne;10;2;6;18
12896;Užupiukas;DRUGELIŲ;3961733676;Taip;22;0;0;22
12897;Užupiukas;DRUGELIŲ;5006880916;Taip;2;2;5;9
12898;Užupiukas;DRUGELIŲ;9715624372;Taip;12;0;2;14
12899;Užupiukas;DRUGELIŲ;1108429907;Ne;5;2;6;13
12900;Užupiukas;DRUGELIŲ;9295230331;Taip;0;0;4;4
12901;Užupiukas;DRUGELIŲ;3940029893;Taip;5;0;3;8
12902;Užupiukas;DRUGELIŲ;3575209839;Taip;6;2;0;8
12903;Užupiukas;DRUGELIŲ;1037307190;Taip;0;0;11;11
12904;Užupiukas;EŽIUKŲ;1526296386;Ne;8;14;0;22
12905;Užupiukas;EŽIUKŲ;9774124589;Ne;0;18;0;18
12906;Užupiukas;EŽIUKŲ;2724216446;Ne;16;11;0;27
12907;Užupiukas;EŽIUKŲ;9446562736;Taip;10;0;1;11
12908;Užupiukas;EŽIUKŲ;5072363435;Taip;8;0;2;10
12909;Užupiukas;EŽIUKŲ;1651249962;Taip;0;0;1;1
12910;Užupiukas;EŽIUKŲ;1100574872;Taip;0;2;0;2
12911;Užupiukas;EŽIUKŲ;5204808398;Taip;11;1;0;12
12912;Užupiukas;EŽIUKŲ;3171528288;Taip;0;0;5;5
12913;Užupiukas;EŽIUKŲ;7860601571;Taip;1;1;0;2
12914;Užupiukas;EŽIUKŲ;3611922301;Taip;5;1;1;7
12915;Užupiukas;EŽIUKŲ;8020138690;Taip;0;0;2;2
12916;Užupiukas;EŽIUKŲ;6823724962;Taip;0;8;3;11
12917;Užupiukas;EŽIUKŲ;5538327364;Taip;5;0;0;5
12918;Užupiukas;EŽIUKŲ;3057147440;Taip;0;1;6;7
12919;Užupiukas;EŽIUKŲ;6370918943;Taip;0;1;9;10
12920;Užupiukas;EŽIUKŲ;6512355340;Taip;4;0;0;4
12921;Užupiukas;EŽIUKŲ;4356736070;Taip;2;0;5;7
12922;Užupiukas;EŽIUKŲ;9906475253;Taip;10;0;3;13
12923;Užupiukas;EŽIUKŲ;8127218866;Taip;18;3;0;21
12924;Užupiukas;EŽIUKŲ;8720638097;Taip;0;1;1;2
12925;Užupiukas;BORUŽĖLIŲ;4781598862;Taip;13;1;4;18
12926;Užupiukas;BORUŽĖLIŲ;7861121290;Taip;1;0;2;3
12927;Užupiukas;BORUŽĖLIŲ;12787288319;Taip;0;0;3;3
12928;Užupiukas;BORUŽĖLIŲ;6526550727;Taip;0;15;0;15
12929;Užupiukas;BORUŽĖLIŲ;9735462228;Taip;0;1;0;1
12930;Užupiukas;BORUŽĖLIŲ;1582921323;Taip;0;0;2;2
12931;Užupiukas;BORUŽĖLIŲ;9791681813;Taip;9;1;0;10
12932;Užupiukas;BORUŽĖLIŲ;1503714343;Taip;0;1;3;4
12933;Užupiukas;BORUŽĖLIŲ;8313812681;Taip;9;0;1;10
12934;Užupiukas;BORUŽĖLIŲ;9677572224;Taip;1;1;0;2
12935;Užupiukas;BORUŽĖLIŲ;2445335267;Taip;4;0;0;4
12936;Užupiukas;BORUŽĖLIŲ;38066177076;Taip;0;5;0;5
12937;Užupiukas;BORUŽĖLIŲ;1514268763;Taip;0;1;2;3
12938;Užupiukas;BORUŽĖLIŲ;7555702944;Taip;0;1;0;1
12939;Užupiukas;BORUŽĖLIŲ;2307600884;Taip;0;1;2;3
12940;Užupiukas;BORUŽĖLIŲ;6073039842;Taip;5;4;0;9
12941;Užupiukas;BORUŽĖLIŲ;3038973312;Taip;5;1;1;7
12942;Užupiukas;BORUŽĖLIŲ;6601099182;Ne;5;8;0;13
12943;Užupiukas;BORUŽĖLIŲ;3940264504;Taip;0;0;1;1
12944;Užupiukas;BORUŽĖLIŲ;5517458323;Ne;0;0;3;3
12945;Užupiukas;BORUŽĖLIŲ;7427702848;Taip;3;6;0;9
12946;Užupiukas;SPINDULIUKŲ;5889162375;Taip;0;0;2;2
12947;Užupiukas;SPINDULIUKŲ;1718518621;Taip;0;1;3;4
12948;Užupiukas;SPINDULIUKŲ;7140606152;Taip;5;0;0;5
12949;Užupiukas;SPINDULIUKŲ;1679324943;Taip;17;0;1;18
12950;Užupiukas;SPINDULIUKŲ;7298322865;Taip;22;0;0;22
12951;Užupiukas;SPINDULIUKŲ;8734960045;Taip;0;1;12;13
12952;Užupiukas;SPINDULIUKŲ;9863097416;Taip;8;0;0;8
12953;Užupiukas;SPINDULIUKŲ;3579499796;Taip;13;0;0;13
12954;Užupiukas;SPINDULIUKŲ;1772019951;Taip;10;0;0;10
12955;Užupiukas;SPINDULIUKŲ;3298267311;Taip;5;3;0;8
12956;Užupiukas;SPINDULIUKŲ;9617597828;Taip;3;0;1;4
12957;Užupiukas;SPINDULIUKŲ;8915159672;Ne;9;1;0;10
12958;Užupiukas;SPINDULIUKŲ;2348243399;Taip;9;0;0;9
12959;Užupiukas;SPINDULIUKŲ;1554333137;Taip;0;1;19;20
12960;Užupiukas;SPINDULIUKŲ;9723966502;Taip;0;0;8;8
12961;Užupiukas;SPINDULIUKŲ;9655636851;Taip;0;0;4;4
12962;Užupiukas;SPINDULIUKŲ;8724566014;Taip;0;1;19;20
12963;Užupiukas;SPINDULIUKŲ;8870229834;Taip;10;1;8;19
12964;Užupiukas;SPINDULIUKŲ;9096157655;Taip;0;1;5;6
12965;Užupiukas;SPINDULIUKŲ;9782972949;Taip;4;1;3;8
12966;Užupiukas;SPINDULIUKŲ;3958071677;Ne;9;1;3;13
12967;Užupiukas;SPINDULIUKŲ;3231001225;Taip;4;0;0;4
12968;Užupiukas;SPINDULIUKŲ;5406866873;Taip;4;0;0;4
12969;Užupiukas;ŽVIRBLIUKŲ;8519118225;Taip;9;5;0;14
12970;Užupiukas;ŽVIRBLIUKŲ;7549628277;Taip;9;5;0;14
12971;Užupiukas;ŽVIRBLIUKŲ;5085660507;Taip;6;5;0;11
12972;Užupiukas;ŽVIRBLIUKŲ;2273766308;Taip;15;0;0;15
12973;Užupiukas;ŽVIRBLIUKŲ;7530856195;Taip;3;1;0;4
12974;Užupiukas;ŽVIRBLIUKŲ;9925592494;Taip;5;5;0;10
12975;Užupiukas;ŽVIRBLIUKŲ;7345579721;Taip;0;3;0;3
12976;Užupiukas;ŽVIRBLIUKŲ;4710910251;Taip;5;6;1;12
12977;Užupiukas;ŽVIRBLIUKŲ;9428884149;Ne;10;3;0;13
12978;Užupiukas;ŽVIRBLIUKŲ;4054724625;Taip;0;16;0;16
12979;Užupiukas;ŽVIRBLIUKŲ;2210437775;Taip;9;1;0;10
12980;Užupiukas;ŽVIRBLIUKŲ;1995228207;Taip;8;1;0;9
12981;Užupiukas;ŽVIRBLIUKŲ;1496541880;Ne;8;4;5;17
12982;Užupiukas;ŽVIRBLIUKŲ;1684901495;Taip;11;2;0;13
12983;Užupiukas;ŽVIRBLIUKŲ;2390955083;Taip;9;1;0;10
12984;Užupiukas;ŽVIRBLIUKŲ;6001766518;Taip;5;5;0;10
12985;Užupiukas;ŽVIRBLIUKŲ;3768945773;Taip;9;1;0;10
12986;Užupiukas;ŽVIRBLIUKŲ;3224193396;Taip;0;1;0;1
12987;Užupiukas;ŽVIRBLIUKŲ;1843171673;Taip;0;15;0;15
12988;Užupiukas;ŽVIRBLIUKŲ;4785494419;Ne;5;12;0;17
12989;Užupiukas;ŽVIRBLIUKŲ;8119142600;Taip;7;3;3;13
12990;Užupiukas;ŽVIRBLIUKŲ;2362568676;Taip;10;1;3;14
12991;Užupiukas;PELĖDŽIUKŲ;2938276316;Taip;0;1;0;1
12992;Užupiukas;PELĖDŽIUKŲ;5320544400;Taip;4;0;5;9
12993;Užupiukas;PELĖDŽIUKŲ;40704768956;Taip;0;0;5;5
12994;Užupiukas;PELĖDŽIUKŲ;5665323444;Ne;16;1;4;21
12995;Užupiukas;PELĖDŽIUKŲ;4880828482;Taip;0;1;6;7
12996;Užupiukas;PELĖDŽIUKŲ;6478702476;Taip;0;8;6;14
12997;Užupiukas;PELĖDŽIUKŲ;6110869303;Taip;0;0;15;15
12998;Užupiukas;PELĖDŽIUKŲ;3205769002;Taip;14;1;2;17
12999;Užupiukas;PELĖDŽIUKŲ;79442829922;Taip;0;1;0;1
13000;Užupiukas;PELĖDŽIUKŲ;4247280316;Taip;1;1;10;12
13001;Užupiukas;PELĖDŽIUKŲ;4608233152;Taip;7;1;4;12
13002;Užupiukas;PELĖDŽIUKŲ;5498369850;Taip;7;1;3;11
13003;Užupiukas;PELĖDŽIUKŲ;2821350355;Taip;10;0;5;15
13004;Užupiukas;PELĖDŽIUKŲ;3309195572;Taip;0;1;10;11
13005;Užupiukas;PELĖDŽIUKŲ;4132760111;Ne;0;3;3;6
13006;Užupiukas;PELĖDŽIUKŲ;22401995674;Taip;10;1;0;11
13007;Užupiukas;PELĖDŽIUKŲ;53412835151;Taip;3;0;1;4
13008;Užupiukas;PELĖDŽIUKŲ;6236652118;Taip;5;0;1;6
13009;Užupiukas;PELĖDŽIUKŲ;3774364829;Taip;0;1;1;2
13010;Užupiukas;PELĖDŽIUKŲ;9197242545;Ne;5;1;5;11
13011;Užupiukas;PELĖDŽIUKŲ;5357731534;Ne;5;0;4;9
13012;Užupiukas;PELĖDŽIUKŲ;5046355276;Taip;9;0;0;9
13013;Užupiukas;PELĖDŽIUKŲ;1091861376;Taip;10;0;1;11
13014;Užupiukas;VARPELIŲ;7107441792;Taip;6;0;1;7
13015;Užupiukas;VARPELIŲ;8881187663;Taip;4;0;0;4
13016;Užupiukas;VARPELIŲ;7895825571;Taip;0;0;6;6
13017;Užupiukas;VARPELIŲ;8518137669;Taip;5;6;0;11
13018;Užupiukas;VARPELIŲ;7919242126;Taip;7;0;0;7
13019;Užupiukas;VARPELIŲ;9310238442;Taip;3;0;2;5
13020;Užupiukas;VARPELIŲ;2769924857;Taip;8;0;0;8
13021;Užupiukas;VARPELIŲ;6538402680;Taip;9;0;0;9
13022;Užupiukas;VARPELIŲ;5941280824;Taip;0;0;18;18
13023;Užupiukas;VARPELIŲ;7105857162;Taip;0;12;4;16
13024;Užupiukas;VARPELIŲ;2485426055;Taip;12;0;0;12
13025;Užupiukas;VARPELIŲ;7314085267;Taip;8;0;0;8
13026;Užupiukas;VARPELIŲ;2752139377;Taip;6;0;4;10
13027;Užupiukas;VARPELIŲ;4106614478;Taip;0;0;9;9
13028;Užupiukas;VARPELIŲ;1407429980;Taip;5;0;1;6
13029;Užupiukas;VARPELIŲ;4811619739;Taip;0;1;0;1
13030;Užupiukas;VARPELIŲ;7837545732;Taip;6;0;1;7
13031;Užupiukas;VARPELIŲ;2767523129;Taip;4;0;2;6
13032;Užupiukas;VARPELIŲ;9523512906;Taip;22;0;0;22
13033;Užupiukas;VARPELIŲ;3745080560;Ne;0;0;7;7
13034;Užupiukas;VARPELIŲ;5148672602;Taip;4;0;0;4
13035;Užupiukas;SAULUČIŲ;5704945892;Taip;0;1;6;7
13036;Užupiukas;SAULUČIŲ;2681679016;Taip;5;0;2;7
13037;Užupiukas;SAULUČIŲ;3684774901;Ne;7;1;2;10
13038;Užupiukas;SAULUČIŲ;8163092636;Taip;0;0;2;2
13039;Užupiukas;SAULUČIŲ;1976775494;Ne;0;10;0;10
13040;Užupiukas;SAULUČIŲ;5874450724;Taip;0;0;6;6
13041;Užupiukas;SAULUČIŲ;3341292382;Taip;17;0;0;17
13042;Užupiukas;SAULUČIŲ;2211595125;Taip;5;0;4;9
13043;Užupiukas;SAULUČIŲ;7450368045;Taip;10;1;16;27
13044;Užupiukas;SAULUČIŲ;5570569874;Taip;3;0;6;9
13045;Užupiukas;SAULUČIŲ;7643286183;Ne;5;1;0;6
13046;Užupiukas;SAULUČIŲ;2814556305;Taip;7;0;0;7
13047;Užupiukas;SAULUČIŲ;7209853233;Taip;7;0;3;10
13048;Užupiukas;SAULUČIŲ;9953994943;Taip;0;10;0;10
13049;Užupiukas;SAULUČIŲ;6849149197;Ne;0;0;3;3
13050;Užupiukas;SAULUČIŲ;7956550754;Ne;12;0;1;13
13051;Užupiukas;SAULUČIŲ;5469735455;Taip;0;2;9;11
13052;Užupiukas;SAULUČIŲ;8489545569;Ne;8;1;1;10
13053;Užupiukas;SAULUČIŲ;7990479988;Taip;0;0;9;9
13054;Užupiukas;SAULUČIŲ;4691413468;Taip;5;0;2;7
13055;Užupiukas;SAULUČIŲ;7423292334;Taip;5;3;2;10
13056;Užupiukas;SAULUČIŲ;9216626936;Taip;12;1;1;14
13057;Užupiukas;SAULUČIŲ;9962455415;Taip;0;0;3;3
13058;Užupiukas;LAPIUKŲ;9833934299;Taip;3;4;1;8
13059;Užupiukas;LAPIUKŲ;4963679583;Taip;5;2;7;14
13060;Užupiukas;LAPIUKŲ;2679915982;Ne;5;0;5;10
13061;Užupiukas;LAPIUKŲ;6004467875;Taip;10;0;0;10
13062;Užupiukas;LAPIUKŲ;1718048938;Taip;7;3;0;10
13063;Užupiukas;LAPIUKŲ;7986962850;Taip;8;3;0;11
13064;Užupiukas;LAPIUKŲ;2517606394;Taip;9;0;0;9
13065;Užupiukas;LAPIUKŲ;5965564175;Ne;0;2;1;3
13066;Užupiukas;LAPIUKŲ;7161001771;Taip;8;8;0;16
13067;Užupiukas;LAPIUKŲ;1886792898;Taip;0;2;1;3
13068;Užupiukas;LAPIUKŲ;6967184410;Taip;0;6;1;7
13069;Užupiukas;LAPIUKŲ;4900699267;Taip;11;0;0;11
13070;Užupiukas;LAPIUKŲ;1178152392;Taip;14;3;0;17
13071;Užupiukas;LAPIUKŲ;7029091978;Taip;0;3;2;5
13072;Užupiukas;LAPIUKŲ;3311694266;Taip;9;1;1;11
13073;Užupiukas;LAPIUKŲ;1041972540;Taip;0;4;2;6
13074;Užupiukas;LAPIUKŲ;4467470795;Taip;0;4;2;6
13075;Užupiukas;LAPIUKŲ;8252575784;Taip;5;3;0;8
13076;Užupiukas;LAPIUKŲ;3333547785;Taip;10;3;1;14
13077;Užupiukas;LAPIUKŲ;8529259340;Taip;6;2;0;8
13078;Užupiukas;NYKŠTUKŲ;4895744524;Taip;20;0;0;20
13079;Užupiukas;NYKŠTUKŲ;3811750547;Taip;0;0;6;6
13080;Užupiukas;NYKŠTUKŲ;2158976125;Taip;0;0;4;4
13081;Užupiukas;NYKŠTUKŲ;6857321547;Taip;22;0;0;22
13082;Užupiukas;NYKŠTUKŲ;5381329362;Ne;3;0;0;3
13083;Užupiukas;NYKŠTUKŲ;4841475687;Taip;12;0;0;12
13084;Užupiukas;NYKŠTUKŲ;1399112659;Taip;13;0;15;28
13085;Užupiukas;NYKŠTUKŲ;9714322911;Taip;0;0;3;3
13086;Užupiukas;NYKŠTUKŲ;3014087333;Taip;0;0;6;6
13087;Užupiukas;NYKŠTUKŲ;7589905741;Taip;0;0;17;17
13088;Užupiukas;NYKŠTUKŲ;1891855020;Taip;0;0;2;2
13089;Užupiukas;NYKŠTUKŲ;1473606331;Taip;0;0;4;4
13090;Užupiukas;NYKŠTUKŲ;4570457987;Taip;17;0;0;17
13091;Užupiukas;NYKŠTUKŲ;9312234251;Taip;0;0;1;1
13092;Vaidilutė;Žiogelis;7779630805;Taip;4;0;1;5
13093;Vaidilutė;Žiogelis;9876388990;Taip;4;0;1;5
13094;Vaidilutė;Žiogelis;3990013866;Taip;0;4;0;4
13095;Vaidilutė;Žiogelis;45949026707;Taip;0;3;3;6
13096;Vaidilutė;Žiogelis;1853463568;Taip;5;0;2;7
13097;Vaidilutė;Žiogelis;5620009051;Taip;5;0;0;5
13098;Vaidilutė;Žiogelis;16491592864;Taip;0;1;0;1
13099;Vaidilutė;Žiogelis;5203062837;Taip;10;0;1;11
13100;Vaidilutė;Žiogelis;3112025222;Taip;8;0;0;8
13101;Vaidilutė;Žiogelis;4334934114;Taip;10;1;12;23
13102;Vaidilutė;Žiogelis;7843388119;Taip;5;1;0;6
13103;Vaidilutė;Žiogelis;2041126370;Taip;0;0;2;2
13104;Vaidilutė;Žiogelis;3152118407;Taip;5;0;1;6
13105;Vaidilutė;Žiogelis;5991149222;Taip;8;1;3;12
13106;Vaidilutė;Žiogelis;1786022030;Taip;4;1;2;7
13107;Vaidilutė;Žiogelis;1266927367;Taip;0;3;7;10
13108;Vaidilutė;Žiogelis;1430802591;Taip;5;1;0;6
13109;Vaidilutė;Žiogelis;4259585225;Taip;4;1;1;6
13110;Vaidilutė;Žiogelis;9556632708;Taip;3;1;1;5
13111;Vaidilutė;Rūtelė;2131127298;Taip;0;1;0;1
13112;Vaidilutė;Rūtelė;8789527552;Taip;0;1;0;1
13113;Vaidilutė;Rūtelė;7319037375;Taip;4;0;3;7
13114;Vaidilutė;Rūtelė;4838951446;Taip;2;1;0;3
13115;Vaidilutė;Rūtelė;7494818866;Taip;0;1;0;1
13116;Vaidilutė;Rūtelė;5500950179;Taip;5;0;1;6
13117;Vaidilutė;Rūtelė;1140011879;Taip;0;1;7;8
13118;Vaidilutė;Rūtelė;9563257771;Taip;8;1;0;9
13119;Vaidilutė;Rūtelė;9652684068;Taip;10;0;4;14
13120;Vaidilutė;Rūtelė;2024078532;Taip;0;0;7;7
13121;Vaidilutė;Rūtelė;5482030284;Taip;0;1;0;1
13122;Vaidilutė;Rūtelė;8505156287;Taip;5;0;0;5
13123;Vaidilutė;Rūtelė;9568450630;Taip;5;0;0;5
13124;Vaidilutė;Rūtelė;7306768961;Taip;9;0;0;9
13125;Vaidilutė;Rūtelė;7532115462;Taip;10;0;3;13
13126;Vaidilutė;Rūtelė;3059654988;Taip;3;0;6;9
13127;Vaidilutė;Rūtelė;1341696594;Taip;0;0;3;3
13128;Vaidilutė;Rūtelė;1141947715;Taip;2;1;6;9
13129;Vaidilutė;Rūtelė;9437865610;Taip;0;1;3;4
13130;Vaidilutė;Rūtelė;2014160468;Ne;4;0;4;8
13131;Vaidilutė;Voveraitė;3248203941;Taip;0;0;4;4
13132;Vaidilutė;Voveraitė;1608646909;Taip;11;0;0;11
13133;Vaidilutė;Voveraitė;9429544108;Taip;9;0;1;10
13134;Vaidilutė;Voveraitė;5652381296;Taip;8;0;0;8
13135;Vaidilutė;Voveraitė;8377824920;Taip;5;6;0;11
13136;Vaidilutė;Voveraitė;5296146822;Taip;10;0;0;10
13137;Vaidilutė;Voveraitė;3299081380;Taip;3;0;1;4
13138;Vaidilutė;Voveraitė;3634285869;Taip;0;0;20;20
13139;Vaidilutė;Voveraitė;7703578508;Taip;16;0;0;16
13140;Vaidilutė;Voveraitė;3150642420;Taip;0;0;3;3
13141;Vaidilutė;Voveraitė;5855762068;Ne;8;0;2;10
13142;Vaidilutė;Voveraitė;8177787790;Taip;6;0;2;8
13143;Vaidilutė;Voveraitė;7327131165;Taip;12;3;0;15
13144;Vaidilutė;Voveraitė;2318578603;Taip;20;0;0;20
13145;Vaidilutė;Voveraitė;9372280434;Ne;15;0;0;15
13146;Vaidilutė;Voveraitė;1372767364;Ne;9;0;0;9
13147;Vaidilutė;Voveraitė;7478943531;Taip;10;0;0;10
13148;Vaidilutė;Voveraitė;4738318120;Taip;5;8;0;13
13149;Vaidilutė;Voveraitė;3319615121;Taip;9;0;1;10
13150;Vaidilutė;Voveraitė;6299324271;Ne;10;0;0;10
13151;Vaidilutė;Voveraitė;4186708502;Ne;13;0;0;13
13152;Vaidilutė;Voveraitė;2855672500;Taip;12;1;0;13
13153;Vaidilutė;Voveraitė;8053548602;Taip;0;0;22;22
13154;Vaidilutė;Saulutė;8492055287;Taip;5;3;6;14
13155;Vaidilutė;Saulutė;6844372910;Taip;10;0;7;17
13156;Vaidilutė;Saulutė;4972645715;Taip;0;0;8;8
13157;Vaidilutė;Saulutė;1355005114;Ne;0;2;2;4
13158;Vaidilutė;Saulutė;4680645841;Taip;0;18;1;19
13159;Vaidilutė;Saulutė;2662468804;Ne;6;3;0;9
13160;Vaidilutė;Saulutė;5217609332;Taip;0;4;3;7
13161;Vaidilutė;Saulutė;2864731541;Taip;10;0;0;10
13162;Vaidilutė;Saulutė;1998872078;Taip;0;0;5;5
13163;Vaidilutė;Saulutė;2468220275;Taip;0;3;4;7
13164;Vaidilutė;Saulutė;1610262589;Taip;10;0;1;11
13165;Vaidilutė;Saulutė;2356037175;Taip;0;1;0;1
13166;Vaidilutė;Saulutė;5054640268;Taip;13;0;0;13
13167;Vaidilutė;Saulutė;6885473308;Taip;7;0;0;7
13168;Vaidilutė;Saulutė;7826111890;Taip;0;1;0;1
13169;Vaidilutė;Saulutė;9870763434;Taip;9;0;1;10
13170;Vaidilutė;Saulutė;5945744595;Taip;16;3;0;19
13171;Vaidilutė;Saulutė;6674238265;Ne;0;3;8;11
13172;Vaidilutė;Saulutė;1092821241;Taip;4;0;0;4
13173;Vaidilutė;Saulutė;2294802783;Taip;5;3;3;11
13174;Vaidilutė;Žibutė;5668493994;Taip;15;0;0;15
13175;Vaidilutė;Žibutė;4085959509;Taip;0;0;1;1
13176;Vaidilutė;Žibutė;1001320466;Taip;2;3;0;5
13177;Vaidilutė;Žibutė;3051006765;Taip;0;0;1;1
13178;Vaidilutė;Žibutė;9189713003;Taip;4;0;3;7
13179;Vaidilutė;Žibutė;7903242996;Taip;3;0;9;12
13180;Vaidilutė;Žibutė;7400197367;Taip;0;1;0;1
13181;Vaidilutė;Žibutė;5236154349;Taip;6;0;0;6
13182;Vaidilutė;Žibutė;3980894528;Ne;12;1;0;13
13183;Vaidilutė;Žibutė;1362256314;Taip;8;1;0;9
13184;Vaidilutė;Žibutė;7940581813;Taip;0;1;0;1
13185;Vaidilutė;Žibutė;2767482145;Taip;5;0;0;5
13186;Vaidilutė;Žibutė;7765298370;Taip;14;6;0;20
13187;Vaidilutė;Žibutė;8769601956;Taip;0;0;3;3
13188;Vaidilutė;Žibutė;1726638921;Taip;3;0;6;9
13189;Vaidilutė;Žibutė;5415279154;Taip;1;1;0;2
13190;Vaidilutė;Žibutė;4124217264;Taip;5;0;2;7
13191;Vaidilutė;Žibutė;7429825620;Taip;8;0;1;9
13192;Vaidilutė;Žibutė;7690470762;Taip;11;0;0;11
13193;Vaidilutė;"Ąžuoliukas ";3463112472;Taip;0;0;3;3
13194;Vaidilutė;"Ąžuoliukas ";3730573432;Taip;9;0;1;10
13195;Vaidilutė;"Ąžuoliukas ";6586072228;Taip;5;0;0;5
13196;Vaidilutė;"Ąžuoliukas ";5988376676;Taip;5;0;5;10
13197;Vaidilutė;"Ąžuoliukas ";1305478052;Taip;12;0;0;12
13198;Vaidilutė;"Ąžuoliukas ";4954285515;Ne;13;1;0;14
13199;Vaidilutė;"Ąžuoliukas ";5556351358;Taip;0;3;0;3
13200;Vaidilutė;"Ąžuoliukas ";5439973183;Taip;14;0;0;14
13201;Vaidilutė;"Ąžuoliukas ";4761992071;Taip;14;0;1;15
13202;Vaidilutė;"Ąžuoliukas ";3381544575;Taip;5;0;3;8
13203;Vaidilutė;"Ąžuoliukas ";5307486959;Taip;4;3;3;10
13204;Vaidilutė;"Ąžuoliukas ";1653497170;Taip;4;3;1;8
13205;Vaidilutė;"Ąžuoliukas ";1440819171;Ne;6;3;0;9
13206;Vaidilutė;"Ąžuoliukas ";4901387311;Taip;15;0;0;15
13207;Vaidilutė;"Ąžuoliukas ";9811981645;Taip;5;0;0;5
13208;Vaidilutė;"Ąžuoliukas ";2997948252;Taip;10;3;0;13
13209;Vaidilutė;"Ąžuoliukas ";9723156071;Taip;2;0;3;5
13210;Vaidilutė;"Ąžuoliukas ";4193108560;Ne;7;0;0;7
13211;Vaidilutė;"Ąžuoliukas ";3782651091;Taip;20;0;0;20
13212;Vaidilutė;"Ąžuoliukas ";6637224510;Taip;0;0;9;9
13213;Vaidilutė;"Ąžuoliukas ";6067801976;Taip;4;0;0;4
13214;Vaidilutė;"Žemuogėlė ";1993403692;Ne;5;1;3;9
13215;Vaidilutė;"Žemuogėlė ";42503303158;Taip;4;3;0;7
13216;Vaidilutė;"Žemuogėlė ";9869134464;Taip;0;1;0;1
13217;Vaidilutė;"Žemuogėlė ";29153363263;Taip;3;0;3;6
13218;Vaidilutė;"Žemuogėlė ";3069613102;Taip;1;1;0;2
13219;Vaidilutė;"Žemuogėlė ";1297817018;Taip;4;10;0;14
13220;Vaidilutė;"Žemuogėlė ";5177060346;Taip;6;0;0;6
13221;Vaidilutė;"Žemuogėlė ";4671287016;Ne;11;2;0;13
13222;Vaidilutė;"Žemuogėlė ";9124975928;Taip;14;3;0;17
13223;Vaidilutė;"Žemuogėlė ";7419525100;Taip;8;3;1;12
13224;Vaidilutė;"Žemuogėlė ";1363913645;Taip;0;1;0;1
13225;Vaidilutė;"Žemuogėlė ";5252637701;Taip;1;1;0;2
13226;Vaidilutė;"Žemuogėlė ";3202508790;Taip;0;1;5;6
13227;Vaidilutė;"Žemuogėlė ";1320999237;Taip;0;4;0;4
13228;Vaidilutė;"Žemuogėlė ";9769645272;Taip;0;0;1;1
13229;Vaidilutė;"Žemuogėlė ";1691407801;Taip;1;1;0;2
13230;Vaidilutė;"Žemuogėlė ";1315347184;Taip;5;1;1;7
13231;Vaidilutė;"Žemuogėlė ";1704155743;Taip;1;2;1;4
13232;Vaidilutė;"Žemuogėlė ";5276088687;Taip;8;0;2;10
13233;Vaidilutė;"Žemuogėlė ";1477508451;Taip;0;7;1;8
13234;Vaidilutė;"Vyturėlis ";3121914268;Taip;0;0;1;1
13235;Vaidilutė;"Vyturėlis ";5050251048;Taip;0;0;5;5
13236;Vaidilutė;"Vyturėlis ";7106410219;Taip;0;0;1;1
13237;Vaidilutė;"Vyturėlis ";9558983004;Taip;4;1;3;8
13238;Vaidilutė;"Vyturėlis ";5326935037;Taip;0;0;7;7
13239;Vaidilutė;"Vyturėlis ";2189753894;Taip;0;3;0;3
13240;Vaidilutė;"Vyturėlis ";9689388330;Taip;1;1;1;3
13241;Vaidilutė;"Vyturėlis ";9584702487;Taip;4;0;0;4
13242;Vaidilutė;"Vyturėlis ";2081959307;Taip;0;0;6;6
13243;Vaidilutė;"Vyturėlis ";8882402632;Ne;0;0;3;3
13244;Vaidilutė;"Vyturėlis ";1539700521;Taip;5;0;0;5
13245;Vaidilutė;"Vyturėlis ";4230076320;Taip;8;0;1;9
13246;Vaidilutė;"Vyturėlis ";8628545847;Taip;0;1;2;3
13247;Vaidilutė;"Vyturėlis ";2058071219;Taip;12;0;1;13
13248;Vaidilutė;"Vyturėlis ";4388069915;Taip;8;0;0;8
13249;Vaidilutė;"Vyturėlis ";1401180999;Taip;10;1;1;12
13250;Vaidilutė;"Vyturėlis ";1417828163;Taip;0;2;0;2
13251;Vaidilutė;"Vyturėlis ";5651628204;Ne;6;1;3;10
13252;Vaidilutė;"Vyturėlis ";2251608691;Taip;5;0;3;8
13253;Vaidilutė;"Vyturėlis ";7914006128;Taip;8;0;0;8
13254;Vaidilutė;"Vyturėlis ";7131561558;Taip;0;0;3;3
13255;Vaidilutė;"Vyturėlis ";2194984060;Taip;10;0;7;17
13256;Vaidilutė;"Vyturėlis ";3351968717;Ne;4;2;0;6
13257;Vaidilutė;"Varpelis ";6250831269;Taip;0;1;0;1
13258;Vaidilutė;"Varpelis ";2763266518;Taip;0;2;0;2
13259;Vaidilutė;"Varpelis ";6037349527;Taip;9;0;3;12
13260;Vaidilutė;"Varpelis ";5867501558;Taip;0;1;4;5
13261;Vaidilutė;"Varpelis ";3832349858;Taip;0;0;1;1
13262;Vaidilutė;"Varpelis ";9317774960;Taip;0;1;0;1
13263;Vaidilutė;"Varpelis ";5448014291;Taip;0;2;3;5
13264;Vaidilutė;"Varpelis ";3497795848;Taip;0;0;4;4
13265;Vaidilutė;"Varpelis ";4280822951;Ne;0;0;3;3
13266;Vaidilutė;"Varpelis ";6107554047;Taip;0;0;2;2
13267;Vaidilutė;"Varpelis ";3453045619;Taip;0;0;3;3
13268;Vaidilutė;"Varpelis ";6022130248;Taip;3;6;0;9
13269;Vaidilutė;"Varpelis ";5101104226;Taip;0;0;3;3
13270;Vaidilutė;"Varpelis ";5594121340;Taip;0;0;1;1
13271;Vaidilutė;"Varpelis ";1882829340;Taip;0;0;14;14
13272;Vaidilutė;"Varpelis ";6097229427;Taip;8;0;1;9
13273;Vaidilutė;"Varpelis ";3353827105;Ne;10;0;1;11
13274;Vaidilutė;"Varpelis ";4362797606;Taip;8;0;1;9
13275;Vaidilutė;"Varpelis ";6322986820;Taip;0;0;1;1
13276;Vaidilutė;"Varpelis ";2941550026;Taip;0;0;8;8
13277;Vaidilutė;"Boružėlių ";6928815317;Taip;21;0;0;21
13278;Vaidilutė;"Boružėlių ";2164241264;Taip;13;0;0;13
13279;Vaidilutė;"Boružėlių ";4648985217;Taip;0;1;0;1
13280;Vaidilutė;"Boružėlių ";4805621473;Taip;3;0;0;3
13281;Vaidilutė;"Boružėlių ";4348206726;Taip;22;0;0;22
13282;Vaidilutė;"Boružėlių ";5405461987;Taip;5;0;0;5
13283;Vaidilutė;"Boružėlių ";8629789128;Taip;18;1;0;19
13284;Vaidilutė;"Boružėlių ";8413764934;Taip;0;1;0;1
13285;Vaidilutė;"Boružėlių ";2315322608;Taip;16;1;0;17
13286;Vaidilutė;"Boružėlių ";7019245743;Taip;8;0;0;8
13287;Vaidilutė;"Boružėlių ";7075509397;Taip;8;0;0;8
13288;Vaidilutė;"Boružėlių ";4760330697;Taip;5;0;0;5
13289;Vaidilutė;"Boružėlių ";5205356977;Taip;22;0;0;22
13290;Vaidilutė;"Boružėlių ";5095161432;Taip;9;0;3;12
13291;Vaidilutė;"Boružėlių ";6239494382;Taip;5;0;0;5
13292;Vaidilutė;"Malūnelis ";4887753072;Taip;5;7;0;12
13293;Vaidilutė;"Malūnelis ";7726116370;Taip;0;0;1;1
13294;Vaidilutė;"Malūnelis ";2876157676;Taip;10;0;0;10
13295;Vaidilutė;"Malūnelis ";3557654689;Taip;6;1;0;7
13296;Vaidilutė;"Malūnelis ";8257746012;Taip;6;1;0;7
13297;Vaidilutė;"Malūnelis ";8444010416;Taip;10;0;8;18
13298;Vaidilutė;"Malūnelis ";4568108299;Taip;18;0;0;18
13299;Vaidilutė;"Malūnelis ";1998966302;Taip;0;0;2;2
13300;Vaidilutė;"Malūnelis ";5026620305;Taip;5;1;0;6
13301;Vaidilutė;"Malūnelis ";3826303389;Taip;8;0;0;8
13302;Vaidilutė;"Malūnelis ";4469754560;Taip;7;0;0;7
13303;Vaidilutė;"Malūnelis ";8433116520;Taip;10;0;0;10
13304;Vaidilutė;"Malūnelis ";5918039529;Taip;18;0;4;22
13305;Vaidilutė;"Malūnelis ";3850868701;Taip;11;0;0;11
13306;Vaidilutė;"Malūnelis ";7660273021;Taip;15;0;0;15
13307;Vaidilutė;"Malūnelis ";6449710777;Taip;0;0;2;2
13308;Vaidilutė;"Malūnelis ";2444426554;Taip;0;0;2;2
13309;Vaidilutė;"Riešutėlis ";3605988018;Taip;10;0;0;10
13310;Vaidilutė;"Riešutėlis ";1161455376;Taip;25;0;0;25
13311;Vaidilutė;"Riešutėlis ";4518002596;Ne;16;0;0;16
13312;Vaidilutė;"Riešutėlis ";4657952465;Taip;11;0;0;11
13313;Vaidilutė;"Riešutėlis ";8756807918;Taip;4;0;5;9
13314;Vaidilutė;"Riešutėlis ";9782176726;Taip;0;0;1;1
13315;Vaidilutė;"Riešutėlis ";1206696843;Taip;0;1;0;1
13316;Vaidilutė;"Riešutėlis ";9872915544;Taip;5;7;0;12
13317;Vaidilutė;"Riešutėlis ";2976615414;Taip;8;0;3;11
13318;Vaidilutė;"Riešutėlis ";4709977896;Taip;8;0;0;8
13319;Vaidilutė;"Riešutėlis ";2409760986;Taip;8;0;5;13
13320;Vaidilutė;"Riešutėlis ";2564536281;Ne;5;0;0;5
13321;Vaidilutė;"Riešutėlis ";4051575845;Taip;0;0;3;3
13322;Vaidilutė;"Riešutėlis ";9025469107;Taip;4;0;0;4
13323;Vaidilutė;"Riešutėlis ";3862444839;Taip;10;0;0;10
13324;Vaidilutė;"Riešutėlis ";9567786222;Taip;0;0;5;5
13325;Vaidilutė;"Riešutėlis ";3321127541;Taip;11;0;0;11
13326;Vaidilutė;"Riešutėlis ";7713772984;Taip;0;0;22;22
13327;Vaidilutė;"Riešutėlis ";3064988592;Ne;12;0;2;14
13328;Vaidilutė;"Riešutėlis ";8296567629;Taip;8;0;1;9
13329;Vaidilutė;"Riešutėlis ";7871629009;Taip;0;0;4;4
13330;Vandenis;ŽUVĖDRŲ;5362078687;Taip;0;4;0;4
13331;Vandenis;ŽUVĖDRŲ;6784010746;Ne;17;0;0;17
13332;Vandenis;ŽUVĖDRŲ;2238926097;Taip;10;3;0;13
13333;Vandenis;ŽUVĖDRŲ;9334958945;Taip;7;1;0;8
13334;Vandenis;ŽUVĖDRŲ;7447487403;Taip;10;0;0;10
13335;Vandenis;ŽUVĖDRŲ;7646133208;Taip;10;0;0;10
13336;Vandenis;ŽUVĖDRŲ;4303303483;Taip;7;1;0;8
13337;Vandenis;ŽUVĖDRŲ;2649542586;Taip;9;6;0;15
13338;Vandenis;ŽUVĖDRŲ;1144490168;Taip;6;3;0;9
13339;Vandenis;ŽUVĖDRŲ;7948161881;Taip;7;0;0;7
13340;Vandenis;ŽUVĖDRŲ;7391206543;Taip;10;1;0;11
13341;Vandenis;ŽUVĖDRŲ;9335319713;Taip;10;1;0;11
13342;Vandenis;ŽUVĖDRŲ;6068154206;Taip;0;7;0;7
13343;Vandenis;ŽUVĖDRŲ;7296608892;Taip;0;8;0;8
13344;Vandenis;ŽUVĖDRŲ;4117091634;Taip;0;8;0;8
13345;Vandenis;ŽUVĖDRŲ;5408971428;Taip;0;3;0;3
13346;Vandenis;ŽUVĖDRŲ;2276497021;Taip;5;0;0;5
13347;Vandenis;ŽUVĖDRŲ;6063181697;Taip;7;3;0;10
13348;Vandenis;ŽUVĖDRŲ;6661117114;Taip;0;9;0;9
13349;Vandenis;ŽUVĖDRŲ;6456557095;Taip;18;0;0;18
13350;Vandenis;ŽUVĖDRŲ;3342147138;Taip;22;0;0;22
13351;Vandenis;ŽUVĖDRŲ;5112768778;Taip;10;6;0;16
13352;Vandenis;RUONIUKŲ;2422642232;Taip;0;10;0;10
13353;Vandenis;RUONIUKŲ;1051281257;Taip;0;10;0;10
13354;Vandenis;RUONIUKŲ;7565308536;Taip;0;10;0;10
13355;Vandenis;RUONIUKŲ;1120907086;Taip;0;8;0;8
13356;Vandenis;RUONIUKŲ;1563710105;Taip;0;13;0;13
13357;Vandenis;RUONIUKŲ;7702272913;Ne;4;0;1;5
13358;Vandenis;RUONIUKŲ;6476051751;Taip;3;7;0;10
13359;Vandenis;RUONIUKŲ;9162936403;Taip;0;10;0;10
13360;Vandenis;RUONIUKŲ;4713395766;Taip;0;3;0;3
13361;Vandenis;RUONIUKŲ;6986724058;Taip;4;1;0;5
13362;Vandenis;RUONIUKŲ;7754158588;Taip;10;0;4;14
13363;Vandenis;RUONIUKŲ;9731729915;Taip;8;0;0;8
13364;Vandenis;RUONIUKŲ;9527253920;Taip;0;2;0;2
13365;Vandenis;RUONIUKŲ;8971291182;Taip;5;0;0;5
13366;Vandenis;RUONIUKŲ;6330187732;Taip;8;7;0;15
13367;Vandenis;RUONIUKŲ;9688954631;Taip;0;7;0;7
13368;Vandenis;RUONIUKŲ;8729351613;Ne;9;0;0;9
13369;Vandenis;RUONIUKŲ;4971165639;Taip;1;1;0;2
13370;Vandenis;RUONIUKŲ;6158299885;Taip;4;0;2;6
13371;Vandenis;RUONIUKŲ;3664560833;Taip;4;3;0;7
13372;Vandenis;RUONIUKŲ;5535901447;Taip;0;1;0;1
13373;Vandenis;ŽUVYČIŲ;55421695186;Taip;0;2;0;2
13374;Vandenis;ŽUVYČIŲ;43933878402;Taip;0;2;0;2
13375;Vandenis;ŽUVYČIŲ;9608871155;Taip;5;0;0;5
13376;Vandenis;ŽUVYČIŲ;7381695975;Taip;0;1;0;1
13377;Vandenis;ŽUVYČIŲ;8430706407;Taip;2;1;0;3
13378;Vandenis;ŽUVYČIŲ;8689134931;Taip;0;1;0;1
13379;Vandenis;ŽUVYČIŲ;4085256182;Taip;0;3;0;3
13380;Vandenis;ŽUVYČIŲ;6828175620;Taip;0;2;0;2
13381;Vandenis;ŽUVYČIŲ;1535450614;Taip;4;0;0;4
13382;Vandenis;ŽUVYČIŲ;7408758565;Taip;0;1;0;1
13383;Vandenis;ŽUVYČIŲ;1598122777;Taip;0;2;0;2
13384;Vandenis;ŽUVYČIŲ;18336904438;Taip;10;3;0;13
13385;Vandenis;ŽUVYČIŲ;1815765498;Taip;2;2;0;4
13386;Vandenis;ŽUVYČIŲ;5549292096;Taip;0;6;0;6
13387;Vandenis;ŽUVYČIŲ;8705188652;Taip;16;3;0;19
13388;Vandenis;ŽUVYČIŲ;71513217054;Taip;0;1;0;1
13389;Vandenis;ŽUVYČIŲ;24217366528;Taip;7;1;0;8
13390;Vandenis;ŽUVYČIŲ;9994373029;Taip;4;1;0;5
13391;Vandenis;ŽUVYČIŲ;3544717790;Taip;0;2;0;2
13392;Vandenis;ŽUVYČIŲ;4643267945;Taip;5;2;0;7
13393;Vandenis;ŽUVYČIŲ;9518434896;Ne;0;8;0;8
13394;Vandenis;ŽUVYČIŲ;2638433939;Taip;14;0;0;14
13395;Vandenis;PERLIUKŲ;8678508812;Taip;0;12;0;12
13396;Vandenis;PERLIUKŲ;2645775090;Taip;0;1;0;1
13397;Vandenis;PERLIUKŲ;5844576485;Taip;5;0;1;6
13398;Vandenis;PERLIUKŲ;6295009202;Taip;0;9;0;9
13399;Vandenis;PERLIUKŲ;7598257845;Taip;5;0;0;5
13400;Vandenis;PERLIUKŲ;7473692892;Taip;5;0;0;5
13401;Vandenis;PERLIUKŲ;5323428164;Taip;7;0;0;7
13402;Vandenis;PERLIUKŲ;6073002418;Taip;0;3;8;11
13403;Vandenis;PERLIUKŲ;5565147603;Taip;8;0;0;8
13404;Vandenis;PERLIUKŲ;2690536940;Taip;0;2;0;2
13405;Vandenis;PERLIUKŲ;2576575249;Taip;0;0;5;5
13406;Vandenis;PERLIUKŲ;7832674282;Taip;14;1;0;15
13407;Vandenis;PERLIUKŲ;9798192239;Taip;10;0;0;10
13408;Vandenis;PERLIUKŲ;1975385430;Taip;6;3;0;9
13409;Vandenis;PERLIUKŲ;3061606138;Taip;0;11;0;11
13410;Vandenis;PERLIUKŲ;8117385209;Taip;0;0;6;6
13411;Vandenis;PERLIUKŲ;5613067534;Ne;0;3;1;4
13412;Vandenis;PERLIUKŲ;2321919298;Ne;6;11;0;17
13413;Vandenis;PERLIUKŲ;5963181638;Taip;10;0;0;10
13414;Vandenis;PERLIUKŲ;5609737826;Taip;0;0;7;7
13415;Vandenis;PERLIUKŲ;3239754791;Taip;10;3;0;13
13416;Vandenis;PERLIUKŲ;5129492284;Taip;0;2;2;4
13417;Vandenis;ANČIUKŲ;4607196473;Taip;0;11;2;13
13418;Vandenis;ANČIUKŲ;6189862061;Taip;1;5;0;6
13419;Vandenis;ANČIUKŲ;4345021061;Taip;1;5;0;6
13420;Vandenis;ANČIUKŲ;9763300020;Taip;9;2;0;11
13421;Vandenis;ANČIUKŲ;9968877035;Taip;13;1;0;14
13422;Vandenis;ANČIUKŲ;4715198793;Taip;11;0;0;11
13423;Vandenis;ANČIUKŲ;1213743099;Taip;6;1;0;7
13424;Vandenis;ANČIUKŲ;4954121871;Taip;12;0;0;12
13425;Vandenis;ANČIUKŲ;8751355814;Taip;4;0;0;4
13426;Vandenis;ANČIUKŲ;4983424940;Taip;0;1;0;1
13427;Vandenis;ANČIUKŲ;4978712442;Taip;10;5;0;15
13428;Vandenis;ANČIUKŲ;7631982912;Taip;5;1;0;6
13429;Vandenis;ANČIUKŲ;7581114286;Ne;0;1;0;1
13430;Vandenis;ANČIUKŲ;9679010239;Taip;11;1;0;12
13431;Vandenis;ANČIUKŲ;9314410776;Taip;0;5;14;19
13432;Vandenis;ANČIUKŲ;1132534461;Taip;8;1;0;9
13433;Vandenis;ANČIUKŲ;9498231306;Taip;0;1;0;1
13434;Vandenis;ANČIUKŲ;2647966131;Taip;10;1;0;11
13435;Vandenis;ANČIUKŲ;5610800263;Taip;3;0;0;3
13436;Vandenis;ANČIUKŲ;3544764716;Ne;10;5;0;15
13437;Vandenis;ANČIUKŲ;4530824157;Taip;17;0;0;17
13438;Vandenis;VĖŽLIUKŲ;2309166304;Ne;22;0;0;22
13439;Vandenis;VĖŽLIUKŲ;5454049563;Taip;0;2;0;2
13440;Vandenis;VĖŽLIUKŲ;9805578141;Taip;0;2;0;2
13441;Vandenis;VĖŽLIUKŲ;8921666108;Ne;0;4;0;4
13442;Vandenis;VĖŽLIUKŲ;8116532445;Taip;0;6;0;6
13443;Vandenis;VĖŽLIUKŲ;7069369080;Taip;0;2;0;2
13444;Vandenis;VĖŽLIUKŲ;7924399684;Taip;0;15;0;15
13445;Vandenis;VĖŽLIUKŲ;1187395353;Taip;0;7;0;7
13446;Vandenis;VĖŽLIUKŲ;5126732658;Taip;0;5;0;5
13447;Vandenis;VĖŽLIUKŲ;7059385610;Taip;0;6;0;6
13448;Vandenis;VĖŽLIUKŲ;9158541919;Taip;5;5;0;10
13449;Vandenis;VĖŽLIUKŲ;5959181898;Taip;5;5;0;10
13450;Vandenis;VĖŽLIUKŲ;1707354287;Taip;0;7;0;7
13451;Vandenis;VĖŽLIUKŲ;4413648496;Taip;1;5;0;6
13452;Vandenis;VĖŽLIUKŲ;4177166475;Taip;0;6;0;6
13453;Vandenis;VĖŽLIUKŲ;5218101579;Taip;0;6;0;6
13454;Vandenis;VĖŽLIUKŲ;8416839037;Taip;19;0;0;19
13455;Vandenis;VĖŽLIUKŲ;2936885357;Taip;13;0;0;13
13456;Vandenis;VĖŽLIUKŲ;8879608849;Taip;0;16;0;16
13457;Vandenis;AŠTUNKOJŲ;2077783219;Taip;0;2;1;3
13458;Vandenis;AŠTUNKOJŲ;8511948282;Taip;3;2;0;5
13459;Vandenis;AŠTUNKOJŲ;2096950367;Taip;4;2;0;6
13460;Vandenis;AŠTUNKOJŲ;71786730314;Taip;2;1;0;3
13461;Vandenis;AŠTUNKOJŲ;6181866272;Taip;0;3;0;3
13462;Vandenis;AŠTUNKOJŲ;5395847317;Taip;0;1;0;1
13463;Vandenis;AŠTUNKOJŲ;33317650043;Taip;0;2;0;2
13464;Vandenis;AŠTUNKOJŲ;7522472652;Taip;0;2;0;2
13465;Vandenis;AŠTUNKOJŲ;3243079651;Taip;0;4;0;4
13466;Vandenis;AŠTUNKOJŲ;3067868099;Taip;0;1;0;1
13467;Vandenis;AŠTUNKOJŲ;3578947540;Taip;0;3;0;3
13468;Vandenis;AŠTUNKOJŲ;61120985165;Taip;0;1;1;2
13469;Vandenis;AŠTUNKOJŲ;1222539247;Taip;2;1;0;3
13470;Vandenis;AŠTUNKOJŲ;8251169901;Taip;8;4;0;12
13471;Vandenis;AŠTUNKOJŲ;4750141780;Taip;7;2;0;9
13472;Vandenis;AŠTUNKOJŲ;1621481561;Taip;0;1;0;1
13473;Vandenis;AŠTUNKOJŲ;1314724267;Taip;4;5;0;9
13474;Vandenis;AŠTUNKOJŲ;1282499654;Taip;9;3;0;12
13475;Vandenis;AŠTUNKOJŲ;1739780612;Ne;9;7;0;16
13476;Vandenis;AŠTUNKOJŲ;8233407105;Taip;0;2;0;2
13477;Vandenis;AŠTUNKOJŲ;2489776665;Taip;13;0;0;13
13478;Vandenis;AŠTUNKOJŲ;3938359901;Taip;0;1;0;1
13479;Vandenis;AŠTUNKOJŲ;33782837791;Taip;0;4;0;4
13480;Vandenis;AŠTUNKOJŲ;1633589144;Taip;0;1;0;1
13481;Vandenis;GANDRIUKŲ;4753416316;Taip;14;3;0;17
13482;Vandenis;GANDRIUKŲ;8264797886;Taip;17;0;0;17
13483;Vandenis;GANDRIUKŲ;9936940067;Ne;22;0;0;22
13484;Vandenis;GANDRIUKŲ;6153669587;Taip;4;0;0;4
13485;Vandenis;GANDRIUKŲ;6260893699;Taip;0;6;0;6
13486;Vandenis;GANDRIUKŲ;1919577714;Taip;17;1;1;19
13487;Vandenis;GANDRIUKŲ;7019646962;Taip;0;3;4;7
13488;Vandenis;GANDRIUKŲ;2078767085;Taip;4;2;2;8
13489;Vandenis;GANDRIUKŲ;2976505868;Taip;24;1;2;27
13490;Vandenis;GANDRIUKŲ;6558155968;Taip;0;1;0;1
13491;Vandenis;GANDRIUKŲ;6691874473;Taip;5;1;4;10
13492;Vandenis;GANDRIUKŲ;6483030616;Taip;1;1;0;2
13493;Vandenis;GANDRIUKŲ;8144830789;Taip;1;0;0;1
13494;Vandenis;GANDRIUKŲ;2381566229;Taip;3;0;3;6
13495;Vandenis;GANDRIUKŲ;5899846599;Ne;7;0;3;10
13496;Vandenis;GANDRIUKŲ;8127873607;Ne;8;0;0;8
13497;Vandenis;GANDRIUKŲ;1606103904;Taip;6;13;0;19
13498;Vandenis;GANDRIUKŲ;1753180703;Taip;0;1;3;4
13499;Vandenis;GANDRIUKŲ;7303512055;Taip;17;0;0;17
13500;Vandenis;GANDRIUKŲ;3231434944;Ne;2;0;20;22
13501;Vandenis;GANDRIUKŲ;6327478049;Taip;21;0;0;21
13502;Vandenis;GANDRIUKŲ;7311677107;Taip;8;0;0;8
13503;Vandenis;GANDRIUKŲ;6586215199;Taip;0;4;0;4
13504;Vandenis;ŽĄSIUKAI;8034690071;Taip;12;0;1;13
13505;Vandenis;ŽĄSIUKAI;9937317687;Taip;7;0;0;7
13506;Vandenis;ŽĄSIUKAI;2004158593;Taip;0;1;0;1
13507;Vandenis;ŽĄSIUKAI;4984723792;Taip;4;1;0;5
13508;Vandenis;ŽĄSIUKAI;8014569725;Taip;4;0;0;4
13509;Vandenis;ŽĄSIUKAI;1333381525;Taip;0;2;0;2
13510;Vandenis;ŽĄSIUKAI;7071349847;Taip;0;3;0;3
13511;Vandenis;ŽĄSIUKAI;7070234429;Taip;4;2;0;6
13512;Vandenis;ŽĄSIUKAI;4072405890;Taip;4;1;0;5
13513;Vandenis;ŽĄSIUKAI;5684262347;Taip;0;0;5;5
13514;Vandenis;ŽĄSIUKAI;4349464804;Taip;6;1;0;7
13515;Vandenis;ŽĄSIUKAI;7596199296;Taip;8;2;0;10
13516;Vandenis;ŽĄSIUKAI;6876019354;Taip;8;8;0;16
13517;Vandenis;ŽĄSIUKAI;5607412408;Taip;4;0;0;4
13518;Vandenis;ŽĄSIUKAI;1925178245;Taip;6;2;0;8
13519;Vandenis;ŽĄSIUKAI;5641929490;Taip;0;9;0;9
13520;Vandenis;ŽĄSIUKAI;1850352131;Taip;5;0;0;5
13521;Vandenis;ŽĄSIUKAI;2454959791;Taip;8;0;0;8
13522;Vandenis;ŽĄSIUKAI;4565893472;Taip;7;0;1;8
13523;Vandenis;ŽĄSIUKAI;9801593009;Taip;0;5;1;6
13524;Vandenis;PURIENŲ;6851178154;Taip;9;2;0;11
13525;Vandenis;PURIENŲ;5440027798;Taip;22;0;0;22
13526;Vandenis;PURIENŲ;4455886780;Taip;17;0;0;17
13527;Vandenis;PURIENŲ;1031451445;Taip;10;0;0;10
13528;Vandenis;PURIENŲ;4815210197;Taip;0;2;0;2
13529;Vandenis;PURIENŲ;3337286021;Taip;9;0;0;9
13530;Vandenis;PURIENŲ;7020534318;Taip;5;1;1;7
13531;Vandenis;PURIENŲ;6027680514;Taip;8;2;0;10
13532;Vandenis;PURIENŲ;2960005490;Taip;0;0;1;1
13533;Vandenis;PURIENŲ;1180322026;Taip;0;0;1;1
13534;Vandenis;PURIENŲ;3633805607;Taip;0;2;0;2
13535;Vandenis;PURIENŲ;7959438279;Taip;9;0;0;9
13536;Vandenis;PURIENŲ;1788652447;Taip;0;1;0;1
13537;Vandenis;PURIENŲ;6332179750;Taip;0;4;0;4
13538;Vandenis;PURIENŲ;2315167746;Taip;0;1;0;1
13539;Vandenis;PURIENŲ;5540306590;Taip;0;1;0;1
13540;Vandenis;PURIENŲ;2719678617;Taip;0;1;0;1
13541;Vandenis;PURIENŲ;7171302906;Taip;7;1;0;8
13542;Vandenis;PURIENŲ;8085633453;Taip;7;1;0;8
13543;Vandenis;PURIENŲ;1244502945;Taip;0;4;0;4
13544;Vandenis;VARLIUKAI;6907717590;Taip;6;0;0;6
13545;Vandenis;VARLIUKAI;2661339448;Taip;13;1;0;14
13546;Vandenis;VARLIUKAI;2451901210;Taip;13;3;0;16
13547;Vandenis;VARLIUKAI;1786146371;Taip;11;1;0;12
13548;Vandenis;VARLIUKAI;3393306645;Taip;17;1;0;18
13549;Vandenis;VARLIUKAI;2506411643;Taip;19;1;0;20
13550;Vandenis;VARLIUKAI;8841954633;Taip;18;0;0;18
13551;Vandenis;VARLIUKAI;7001613448;Taip;18;0;0;18
13552;Vandenis;VARLIUKAI;1983972864;Taip;0;7;0;7
13553;Vandenis;VARLIUKAI;6067408982;Taip;9;1;0;10
13554;Vandenis;VARLIUKAI;8239664149;Taip;18;5;0;23
13555;Vandenis;VARLIUKAI;9380306986;Taip;5;4;0;9
13556;Vandenis;VARLIUKAI;1953052452;Taip;7;0;0;7
13557;Vandenis;VARLIUKAI;1799139825;Taip;12;1;0;13
13558;Vandenis;VARLIUKAI;3038533882;Taip;16;2;0;18
13559;Vandenis;VARLIUKAI;3173213991;Taip;0;8;0;8
13560;Vandenis;VARLIUKAI;5675840354;Taip;7;0;0;7
13561;Vandenis;VARLIUKAI;6570331247;Taip;13;1;0;14
13562;Vandenis;VARLIUKAI;2883058280;Taip;14;0;0;14
13563;Vandenis;PINGVINAI;2209513000;Taip;0;0;1;1
13564;Vandenis;PINGVINAI;2665865704;Ne;23;0;0;23
13565;Vandenis;PINGVINAI;8755050997;Taip;21;5;0;26
13566;Vandenis;PINGVINAI;1780124964;Taip;0;1;0;1
13567;Vandenis;PINGVINAI;9609168578;Taip;0;6;0;6
13568;Vandenis;PINGVINAI;2156775779;Taip;3;1;0;4
13569;Vandenis;PINGVINAI;3360623444;Taip;5;0;0;5
13570;Vandenis;PINGVINAI;5191604973;Taip;8;3;0;11
13571;Vandenis;PINGVINAI;2757376962;Taip;5;2;0;7
13572;Vandenis;PINGVINAI;6992750701;Taip;7;4;0;11
13573;Vandenis;PINGVINAI;6731336385;Taip;3;0;0;3
13574;Vandenis;PINGVINAI;3933306911;Taip;0;8;24;32
13575;Vandenis;PINGVINAI;2534991705;Taip;3;0;0;3
13576;Vandenis;PINGVINAI;4347489809;Taip;6;0;5;11
13577;Vandenis;PINGVINAI;7267965471;Taip;9;0;0;9
13578;Vandenis;PINGVINAI;5632082019;Taip;0;1;0;1
13579;Vandenis;PINGVINAI;9717294497;Taip;5;2;0;7
13580;Vandenis;PINGVINAI;7770227772;Taip;0;19;0;19
13581;Vandenis;PINGVINAI;8560123112;Taip;7;5;0;12
13582;Vandenis;PINGVINAI;4091633411;Taip;5;0;0;5
13583;Vandenis;"NAUJA GRUPĖ (MODULINIS)";3262634002;Taip;10;0;0;10
13584;Varpelis;NYKŠTUKAI;3840270467;Taip;16;0;0;16
13585;Varpelis;NYKŠTUKAI;5322766823;Taip;6;0;0;6
13586;Varpelis;NYKŠTUKAI;6455435982;Taip;12;0;0;12
13587;Varpelis;NYKŠTUKAI;5155733224;Taip;10;0;0;10
13588;Varpelis;NYKŠTUKAI;4553345643;Taip;5;0;0;5
13589;Varpelis;NYKŠTUKAI;8269062925;Taip;10;0;0;10
13590;Varpelis;"SPINDULIUKŲ su Valdorfo elementais";7878525896;Taip;9;0;0;9
13591;Varpelis;"SPINDULIUKŲ su Valdorfo elementais";3055411665;Taip;13;0;0;13
13592;Varpelis;"SPINDULIUKŲ su Valdorfo elementais";4625794062;Ne;20;0;0;20
13593;Varpelis;SMALSUČIŲ;6873406894;Taip;8;0;0;8
13594;Varpelis;GINTARĖLIAI;2739291648;Taip;6;0;0;6
13595;Varpelis;AITVARIUKŲ;7557698033;Taip;10;0;0;10
13596;Varpelis;AITVARIUKŲ;1561644697;Taip;5;0;0;5
13597;Varpelis;BORUŽĖLIŲ;9459203013;Taip;5;0;0;5
13598;Varpelis;ZUIKUČIŲ;9560973046;Ne;4;0;0;4
13599;Varpelis;ZUIKUČIŲ;1336468541;Taip;5;0;0;5
13600;Varpelis;BITUTĖS;3225870950;Taip;8;0;0;8
13601;Varpelis;BITUTĖS;6272649584;Taip;5;0;0;5
13602;Varpelis;BITUTĖS;7497169351;Taip;5;0;0;5
13603;Varpelis;BITUTĖS;9539132116;Taip;10;0;0;10
13604;Varpelis;DRUGELIAI;9846434157;Taip;23;0;0;23
13605;Varpelis;DRUGELIAI;5721776638;Ne;6;0;0;6
13606;Varpelis;DRUGELIAI;2087032775;Taip;18;0;0;18
13607;Varpelis;DRUGELIAI;5357387099;Ne;16;0;0;16
13608;Varpelis;LAŠIUKŲ;5687696766;Taip;5;0;0;5
13609;Varpelis;LAŠIUKŲ;4054668754;Taip;10;0;0;10
13610;Varpelis;LAŠIUKŲ;8203343084;Taip;11;0;0;11
13611;Varpelis;ŽIRNIUKŲ;8502345965;Taip;11;0;0;11
13612;Vėjelis;Pumpurėliai;2541077369;Ne;17;0;0;17
13613;Vėjelis;Pumpurėliai;3125815427;Taip;10;0;3;13
13614;Vėjelis;Pumpurėliai;5516672613;Taip;17;0;0;17
13615;Vėjelis;Pumpurėliai;1084415930;Taip;14;0;0;14
13616;Vėjelis;Pumpurėliai;9071878406;Taip;11;0;0;11
13617;Vėjelis;Pumpurėliai;3206025676;Taip;5;0;0;5
13618;Vėjelis;Pumpurėliai;5611813359;Taip;9;3;0;12
13619;Vėjelis;Pumpurėliai;1057586168;Ne;22;0;0;22
13620;Vėjelis;Pumpurėliai;9583495324;Taip;6;6;0;12
13621;Vėjelis;Pumpurėliai;7539681314;Taip;4;1;0;5
13622;Vėjelis;Pumpurėliai;3081923183;Taip;9;0;0;9
13623;Vėjelis;Pumpurėliai;9003601108;Taip;5;0;0;5
13624;Vėjelis;Pumpurėliai;6168648640;Taip;8;1;0;9
13625;Vėjelis;Pumpurėliai;1876663813;Taip;13;1;0;14
13626;Vėjelis;Pumpurėliai;6840643273;Ne;9;6;0;15
13627;Vėjelis;Pumpurėliai;9824130744;Ne;15;0;0;15
13628;Vėjelis;Pumpurėliai;1842552329;Taip;11;0;0;11
13629;Vėjelis;Pumpurėliai;9986867356;Taip;5;1;0;6
13630;Vėjelis;Pumpurėliai;8467887788;Taip;11;4;0;15
13631;Vėjelis;Pumpurėliai;9274287800;Taip;6;0;1;7
13632;Vėjelis;Pumpurėliai;5619026707;Taip;8;0;0;8
13633;Vėjelis;Pumpurėliai;8994680698;Taip;8;3;0;11
13634;Vėjelis;Pumpurėliai;2656895893;Taip;10;0;0;10
13635;Vėjelis;Drugeliai;4746932126;Taip;10;1;0;11
13636;Vėjelis;Drugeliai;1978952781;Taip;0;1;0;1
13637;Vėjelis;Drugeliai;8353084814;Taip;0;1;3;4
13638;Vėjelis;Drugeliai;2416832899;Taip;4;1;0;5
13639;Vėjelis;Drugeliai;2734024890;Taip;24;3;0;27
13640;Vėjelis;Drugeliai;7981032872;Taip;0;22;0;22
13641;Vėjelis;Drugeliai;7594586198;Taip;4;1;3;8
13642;Vėjelis;Drugeliai;7697394469;Taip;13;4;0;17
13643;Vėjelis;Drugeliai;4066956765;Taip;8;1;1;10
13644;Vėjelis;Drugeliai;2788205363;Taip;0;3;6;9
13645;Vėjelis;Drugeliai;1331334220;Taip;0;3;6;9
13646;Vėjelis;Drugeliai;2151737048;Taip;10;8;0;18
13647;Vėjelis;Drugeliai;1862173525;Taip;0;0;6;6
13648;Vėjelis;Drugeliai;4988352741;Taip;9;0;0;9
13649;Vėjelis;Drugeliai;3982318250;Taip;8;1;0;9
13650;Vėjelis;Drugeliai;4473677352;Taip;3;3;0;6
13651;Vėjelis;Drugeliai;4506243333;Taip;13;1;0;14
13652;Vėjelis;Drugeliai;3524350131;Taip;4;1;0;5
13653;Vėjelis;Drugeliai;6061966626;Taip;6;0;1;7
13654;Vėjelis;Drugeliai;6891260701;Taip;9;4;0;13
13655;Vėjelis;Malūnėlis;1994035417;Ne;7;2;0;9
13656;Vėjelis;Malūnėlis;7097474285;Taip;8;0;3;11
13657;Vėjelis;Malūnėlis;1448699738;Taip;9;2;4;15
13658;Vėjelis;Malūnėlis;3275186042;Taip;16;0;0;16
13659;Vėjelis;Malūnėlis;1882750621;Taip;10;1;0;11
13660;Vėjelis;Malūnėlis;5109441799;Taip;14;3;0;17
13661;Vėjelis;Malūnėlis;4171024976;Taip;17;0;0;17
13662;Vėjelis;Malūnėlis;1871467392;Taip;13;0;4;17
13663;Vėjelis;Malūnėlis;1342200813;Taip;2;0;1;3
13664;Vėjelis;Malūnėlis;8221349174;Taip;9;2;0;11
13665;Vėjelis;Malūnėlis;6600504736;Taip;12;0;0;12
13666;Vėjelis;Malūnėlis;8063276082;Taip;13;2;0;15
13667;Vėjelis;Malūnėlis;6244227830;Taip;10;0;2;12
13668;Vėjelis;Malūnėlis;1417987860;Taip;14;0;3;17
13669;Vėjelis;Malūnėlis;9636946669;Taip;12;0;2;14
13670;Vėjelis;Malūnėlis;5066748621;Taip;11;0;4;15
13671;Vėjelis;Malūnėlis;8822873586;Taip;10;0;2;12
13672;Vėjelis;Žvaigždutės;9492690970;Taip;12;0;0;12
13673;Vėjelis;Žvaigždutės;1436893015;Taip;12;1;0;13
13674;Vėjelis;Žvaigždutės;2117924725;Taip;4;0;0;4
13675;Vėjelis;Žvaigždutės;8866974952;Taip;8;1;0;9
13676;Vėjelis;Žvaigždutės;1549518622;Ne;6;4;0;10
13677;Vėjelis;Žvaigždutės;6386092350;Taip;8;8;0;16
13678;Vėjelis;Žvaigždutės;6844704326;Taip;15;0;0;15
13679;Vėjelis;Žvaigždutės;4353239658;Taip;9;1;1;11
13680;Vėjelis;Žvaigždutės;3315240387;Taip;0;11;0;11
13681;Vėjelis;Žvaigždutės;9557135813;Taip;0;4;1;5
13682;Vėjelis;Žvaigždutės;2132551615;Taip;16;3;2;21
13683;Vėjelis;Žvaigždutės;2522750651;Taip;12;1;0;13
13684;Vėjelis;Žvaigždutės;6777528441;Taip;0;5;0;5
13685;Vėjelis;Žvaigždutės;4868574574;Taip;8;0;0;8
13686;Vėjelis;Žvaigždutės;9135807341;Taip;21;0;0;21
13687;Vėjelis;Žvaigždutės;4101161670;Taip;8;2;0;10
13688;Vėjelis;Žvaigždutės;7247057946;Taip;5;1;4;10
13689;Vėjelis;Žvaigždutės;7046938604;Taip;8;6;0;14
13690;Vėjelis;Žvaigždutės;3495322620;Taip;1;2;0;3
13691;Vėjelis;Žvaigždutės;1956418258;Taip;0;11;0;11
13692;Vėjelis;Žvaigždutės;7203026860;Taip;10;3;0;13
13693;Vėjelis;Žvaigždutės;8300497094;Taip;9;2;2;13
13694;Vėjelis;Varpeliai;7274745807;Ne;8;5;0;13
13695;Vėjelis;Varpeliai;5931553549;Taip;0;5;0;5
13696;Vėjelis;Varpeliai;9926991259;Taip;13;4;0;17
13697;Vėjelis;Varpeliai;6608657740;Taip;17;4;0;21
13698;Vėjelis;Varpeliai;2794205377;Taip;10;3;0;13
13699;Vėjelis;Varpeliai;7507448059;Taip;9;4;0;13
13700;Vėjelis;Varpeliai;2363974247;Taip;0;5;1;6
13701;Vėjelis;Varpeliai;8379298947;Taip;0;5;1;6
13702;Vėjelis;Varpeliai;1205392813;Taip;5;9;0;14
13703;Vėjelis;Varpeliai;98588113289;Taip;9;4;0;13
13704;Vėjelis;Varpeliai;5396347620;Taip;8;1;0;9
13705;Vėjelis;Varpeliai;5031781196;Taip;11;0;0;11
13706;Vėjelis;Varpeliai;4219672982;Taip;20;1;0;21
13707;Vėjelis;Varpeliai;50124109589;Taip;0;9;0;9
13708;Vėjelis;Varpeliai;4853650350;Taip;9;5;0;14
13709;Vėjelis;Varpeliai;4521161684;Taip;7;2;0;9
13710;Vėjelis;Varpeliai;60890519853;Taip;12;5;0;17
13711;Vėjelis;Varpeliai;8684461171;Taip;8;6;0;14
13712;Vėjelis;Varpeliai;7133454882;Taip;8;4;0;12
13713;Vėjelis;Varpeliai;1863210064;Taip;0;4;0;4
13714;Vėjelis;Varpeliai;6221257045;Taip;0;2;0;2
13715;Vėjelis;Varpeliai;1534169381;Taip;9;6;0;15
13716;Vėjelis;Varpeliai;2957105835;Ne;6;0;2;8
13717;Vėjelis;Varpeliai;8748218387;Taip;11;0;0;11
13718;Vėjelis;Pelėdžiukų;3067215309;Taip;5;0;0;5
13719;Vėjelis;Pelėdžiukų;7211756910;Taip;0;2;0;2
13720;Vėjelis;Pelėdžiukų;2302652824;Ne;10;0;0;10
13721;Vėjelis;Pelėdžiukų;4852532740;Taip;0;22;0;22
13722;Vėjelis;Pelėdžiukų;4450739919;Taip;0;1;0;1
13723;Vėjelis;Pelėdžiukų;9202471939;Taip;0;7;0;7
13724;Vėjelis;Pelėdžiukų;1615837863;Taip;0;7;0;7
13725;Vėjelis;Pelėdžiukų;9852892338;Taip;3;1;0;4
13726;Vėjelis;Pelėdžiukų;8433853523;Taip;7;3;0;10
13727;Vėjelis;Pelėdžiukų;4746355716;Taip;10;3;0;13
13728;Vėjelis;Pelėdžiukų;5507017221;Taip;0;5;0;5
13729;Vėjelis;Pelėdžiukų;1259743374;Ne;12;2;1;15
13730;Vėjelis;Pelėdžiukų;6226234271;Taip;0;22;0;22
13731;Vėjelis;Pelėdžiukų;7559733997;Taip;7;1;0;8
13732;Vėjelis;Pelėdžiukų;3764096742;Taip;5;0;0;5
13733;Vėjelis;Pelėdžiukų;8153021028;Ne;11;0;0;11
13734;Vėjelis;Pelėdžiukų;8067153728;Taip;6;2;0;8
13735;Vėjelis;Pelėdžiukų;2283628712;Taip;0;0;13;13
13736;Vėjelis;Pelėdžiukų;2729246397;Taip;22;0;0;22
13737;Vėjelis;Pelėdžiukų;9769871497;Taip;19;0;2;21
13738;Vėjelis;Pelėdžiukų;4318295503;Taip;11;0;0;11
13739;Vėjelis;Pelėdžiukų;9867392835;Taip;8;0;4;12
13740;Vėjelis;Skruzdeliukų;2167025998;Taip;9;0;1;10
13741;Vėjelis;Skruzdeliukų;2467377103;Taip;0;1;5;6
13742;Vėjelis;Skruzdeliukų;8470977526;Taip;3;11;0;14
13743;Vėjelis;Skruzdeliukų;9434737088;Taip;0;1;0;1
13744;Vėjelis;Skruzdeliukų;1952141664;Ne;6;4;1;11
13745;Vėjelis;Skruzdeliukų;3264153232;Taip;1;3;9;13
13746;Vėjelis;Skruzdeliukų;4992783345;Taip;9;5;0;14
13747;Vėjelis;Skruzdeliukų;4997987762;Taip;5;0;2;7
13748;Vėjelis;Skruzdeliukų;4412135676;Taip;4;0;0;4
13749;Vėjelis;Skruzdeliukų;8356715925;Ne;0;1;7;8
13750;Vėjelis;Skruzdeliukų;4946988585;Taip;11;0;2;13
13751;Vėjelis;Skruzdeliukų;6408918277;Taip;4;5;5;14
13752;Vėjelis;Skruzdeliukų;7240155487;Taip;5;3;2;10
13753;Vėjelis;Skruzdeliukų;7695719991;Ne;8;2;0;10
13754;Vėjelis;Skruzdeliukų;6618114389;Taip;14;1;0;15
13755;Vėjelis;Skruzdeliukų;1381923971;Taip;0;3;0;3
13756;Vėjelis;Skruzdeliukų;8630131152;Taip;0;0;9;9
13757;Vėjelis;Skruzdeliukų;6431589805;Taip;8;1;0;9
13758;Vėjelis;Skruzdeliukų;9177137585;Taip;6;0;0;6
13759;Vėjelis;Skruzdeliukų;4906958328;Taip;0;5;3;8
13760;Vėjelis;Skruzdeliukų;4080198912;Taip;10;0;0;10
13761;Vėjelis;Skruzdeliukų;1555270425;Taip;0;0;1;1
13762;Vėjelis;Skruzdeliukų;7400967836;Taip;0;1;2;3
13763;Vėjelis;Skruzdeliukų;1467023330;Taip;0;3;3;6
13764;Vėjelis;Pieštukų;8995478684;Taip;9;0;1;10
13765;Vėjelis;Pieštukų;7860576967;Taip;7;0;0;7
13766;Vėjelis;Pieštukų;9546928491;Taip;7;0;0;7
13767;Vėjelis;Pieštukų;9675488924;Taip;7;0;0;7
13768;Vėjelis;Pieštukų;4884057836;Taip;0;0;7;7
13769;Vėjelis;Pieštukų;3898751303;Taip;13;7;1;21
13770;Vėjelis;Pieštukų;8281508498;Ne;0;5;6;11
13771;Vėjelis;Pieštukų;1075188861;Taip;17;0;0;17
13772;Vėjelis;Pieštukų;6823103188;Taip;22;0;0;22
13773;Vėjelis;Pieštukų;7854614677;Taip;6;5;0;11
13774;Vėjelis;Pieštukų;9451358807;Taip;19;0;0;19
13775;Vėjelis;Pieštukų;6453605110;Ne;0;12;0;12
13776;Vėjelis;Pieštukų;2720886612;Ne;0;4;0;4
13777;Vėjelis;Pieštukų;2734891342;Taip;10;3;0;13
13778;Vėjelis;Pieštukų;7101585528;Taip;5;5;0;10
13779;Vėjelis;Pieštukų;2373132607;Taip;15;0;0;15
13780;Vėjelis;Ramunėlių;5987294293;Ne;0;8;0;8
13781;Vėjelis;Ramunėlių;8047799576;Ne;13;3;0;16
13782;Vėjelis;Ramunėlių;7178844364;Ne;6;2;0;8
13783;Vėjelis;Ramunėlių;6996900411;Ne;14;2;0;16
13784;Vėjelis;Ramunėlių;4733227215;Ne;8;5;0;13
13785;Vėjelis;Ramunėlių;5909697341;Ne;0;3;0;3
13786;Vėjelis;Ramunėlių;6451722893;Taip;9;4;0;13
13787;Vėjelis;Ramunėlių;3584347608;Ne;0;2;0;2
13788;Vėjelis;Ramunėlių;1381191703;Ne;6;2;0;8
13789;Vėjelis;Ramunėlių;9042329808;Ne;9;0;0;9
13790;Vėjelis;Ramunėlių;6660799519;Taip;9;1;0;10
13791;Vėjelis;Ramunėlių;6889825160;Taip;15;1;0;16
13792;Vėjelis;Ramunėlių;4433799070;Taip;5;2;0;7
13793;Vėjelis;Ramunėlių;1235788079;Taip;8;1;0;9
13794;Vėjelis;Ramunėlių;4745262277;Taip;11;1;0;12
13795;Vėjelis;Ramunėlių;7790713917;Taip;11;2;0;13
13796;Vėjelis;Ramunėlių;8054114720;Ne;3;7;0;10
13797;Vėjelis;Ramunėlių;8986581196;Taip;12;3;0;15
13798;Vėjelis;Ramunėlių;3123360955;Taip;9;0;0;9
13799;Vėjelis;Nykštukai;6741600874;Taip;14;0;0;14
13800;Vėjelis;Nykštukai;9957614551;Ne;6;1;0;7
13801;Vėjelis;Nykštukai;7233448544;Taip;14;3;0;17
13802;Vėjelis;Nykštukai;5339200991;Taip;0;10;0;10
13803;Vėjelis;Nykštukai;6602964509;Taip;8;0;0;8
13804;Vėjelis;Nykštukai;2573683778;Taip;8;2;0;10
13805;Vėjelis;Nykštukai;3843601190;Taip;16;0;1;17
13806;Vėjelis;Nykštukai;3574432129;Taip;3;3;0;6
13807;Vėjelis;Nykštukai;4713754452;Ne;6;3;0;9
13808;Vėjelis;Nykštukai;7889625599;Taip;11;5;0;16
13809;Vėjelis;Nykštukai;7763996061;Taip;5;7;0;12
13810;Vėjelis;Nykštukai;3813509637;Taip;11;0;0;11
13811;Vėjelis;Nykštukai;8755889077;Taip;7;1;0;8
13812;Vėjelis;Nykštukai;2763569936;Ne;0;13;0;13
13813;Vėjelis;Nykštukai;9979979480;Taip;22;0;0;22
13814;Vėjelis;Nykštukai;4063795811;Taip;0;6;0;6
13815;Vėjelis;Nykštukai;8698788528;Taip;9;0;0;9
13816;Vėjelis;BITUTĖS;6824919005;Taip;7;3;0;10
13817;Vėjelis;BITUTĖS;4276237884;Taip;11;5;0;16
13818;Vėjelis;BITUTĖS;3772706363;Ne;13;3;0;16
13819;Vėjelis;BITUTĖS;1834203833;Taip;14;2;0;16
13820;Vėjelis;BITUTĖS;8452132066;Taip;0;22;0;22
13821;Vėjelis;BITUTĖS;6283428333;Taip;10;1;0;11
13822;Vėjelis;BITUTĖS;1112394040;Taip;22;0;0;22
13823;Vėjelis;BITUTĖS;3767625080;Taip;11;1;0;12
13824;Vėjelis;BITUTĖS;6569848405;Taip;17;0;0;17
13825;Vėjelis;BITUTĖS;1457373815;Taip;20;0;0;20
13826;Vėjelis;BITUTĖS;8571757635;Taip;4;4;0;8
13827;Vėjelis;BITUTĖS;1022888418;Taip;0;2;0;2
13828;Vėjelis;BITUTĖS;9625857378;Taip;11;3;0;14
13829;Vėjelis;BITUTĖS;1116238331;Taip;4;14;0;18
13830;Vėjelis;BITUTĖS;8286070405;Taip;6;6;0;12
13831;Vėjelis;BITUTĖS;1674810054;Taip;12;0;1;13
13832;Vėjelis;BITUTĖS;6581265682;Taip;9;0;0;9
13833;Vėjelis;BITUTĖS;1070853175;Taip;3;0;2;5
13834;Vėjelis;BITUTĖS;4348246825;Taip;0;16;0;16
13835;Vėjelis;Boruželės;2199680661;Taip;7;0;0;7
13836;Vėjelis;Boruželės;5325081841;Taip;9;0;0;9
13837;Vėjelis;Boruželės;5381588565;Taip;0;6;0;6
13838;Vėjelis;Boruželės;9037622738;Taip;10;0;0;10
13839;Vėjelis;Boruželės;1588345134;Taip;0;3;5;8
13840;Vėjelis;Boruželės;1429496839;Taip;0;0;1;1
13841;Vėjelis;Boruželės;1931659200;Taip;9;0;0;9
13842;Vėjelis;Boruželės;8666759391;Taip;5;2;0;7
13843;Vėjelis;Boruželės;3844131154;Taip;9;1;0;10
13844;Vėjelis;Boruželės;4747466651;Taip;9;9;0;18
13845;Vėjelis;Boruželės;3473416323;Taip;0;0;1;1
13846;Vėjelis;Boruželės;8141198449;Taip;0;8;1;9
13847;Vėjelis;Boruželės;8121537795;Taip;0;10;0;10
13848;Vėjelis;Boruželės;5517128872;Taip;0;5;1;6
13849;Vėjelis;Boruželės;8938491367;Taip;8;1;0;9
13850;Vėjelis;Boruželės;6108049183;Ne;5;5;0;10
13851;Vėjelis;Boruželės;1115802837;Taip;9;3;0;12
13852;Vėjelis;Boruželės;3276062426;Taip;4;0;2;6
13853;Vėjelis;Boruželės;9298789434;Taip;0;1;0;1
13854;Vėjelis;Boruželės;4132824111;Taip;11;3;0;14
13855;Vėjelis;Boruželės;2000277444;Taip;0;4;0;4
13856;Vėjelis;Boruželės;7752923796;Taip;9;3;1;13
13857;Vėtrungė;Debesėlių;3655025938;Ne;9;1;1;11
13858;Vėtrungė;Debesėlių;2825732654;Taip;11;0;0;11
13859;Vėtrungė;Debesėlių;7863176604;Taip;0;1;0;1
13860;Vėtrungė;Debesėlių;3179715496;Taip;0;1;0;1
13861;Vėtrungė;Debesėlių;6439014588;Taip;9;3;0;12
13862;Vėtrungė;Debesėlių;9423361592;Taip;12;2;0;14
13863;Vėtrungė;Debesėlių;4269488000;Taip;2;0;0;2
13864;Vėtrungė;Debesėlių;1191007983;Taip;10;4;0;14
13865;Vėtrungė;Debesėlių;3745680607;Taip;10;3;1;14
13866;Vėtrungė;Debesėlių;9359012317;Taip;9;3;0;12
13867;Vėtrungė;Debesėlių;1807742144;Taip;0;6;16;22
13868;Vėtrungė;Debesėlių;9893842192;Taip;9;0;0;9
13869;Vėtrungė;Debesėlių;3433811829;Taip;10;1;0;11
13870;Vėtrungė;Debesėlių;2447851565;Taip;17;7;0;24
13871;Vėtrungė;Debesėlių;2136966687;Taip;9;8;0;17
13872;Vėtrungė;Debesėlių;5246813735;Taip;0;1;0;1
13873;Vėtrungė;Debesėlių;5836190044;Taip;22;0;0;22
13874;Vėtrungė;Debesėlių;8957071345;Taip;7;2;1;10
13875;Vėtrungė;Debesėlių;5545581078;Taip;9;0;0;9
13876;Vėtrungė;Debesėlių;7185104341;Ne;17;1;4;22
13877;Vėtrungė;Debesėlių;6374739740;Taip;9;3;1;13
13878;Vėtrungė;Debesėlių;5939537473;Taip;9;0;4;13
13879;Vėtrungė;Debesėlių;1871358961;Taip;10;0;0;10
13880;Vėtrungė;Zuikių;9332362038;Taip;8;0;0;8
13881;Vėtrungė;Zuikių;9407558097;Taip;0;9;0;9
13882;Vėtrungė;Zuikių;2985829593;Taip;0;1;1;2
13883;Vėtrungė;Zuikių;4121886031;Taip;16;5;0;21
13884;Vėtrungė;Zuikių;7573021445;Taip;12;11;0;23
13885;Vėtrungė;Zuikių;3335047815;Ne;0;1;0;1
13886;Vėtrungė;Zuikių;8157356569;Ne;0;1;0;1
13887;Vėtrungė;Zuikių;9742099165;Ne;0;2;0;2
13888;Vėtrungė;Zuikių;1215953192;Taip;8;0;0;8
13889;Vėtrungė;Zuikių;3908259010;Ne;13;2;0;15
13890;Vėtrungė;Zuikių;1729819557;Ne;13;4;1;18
13891;Vėtrungė;Zuikių;4916692634;Ne;6;7;0;13
13892;Vėtrungė;Zuikių;6416245099;Ne;0;7;0;7
13893;Vėtrungė;Zuikių;4197321604;Taip;4;0;0;4
13894;Vėtrungė;Zuikių;1007578933;Taip;15;2;0;17
13895;Vėtrungė;Zuikių;7558548846;Taip;20;0;0;20
13896;Vėtrungė;Zuikių;8742161467;Taip;0;5;1;6
13897;Vėtrungė;Zuikių;2537221101;Ne;24;3;1;28
13898;Vėtrungė;Zuikių;7342250921;Taip;8;10;0;18
13899;Vėtrungė;Zuikių;9248113268;Taip;16;0;0;16
13900;Vėtrungė;Zuikių;7435005821;Ne;0;14;1;15
13901;Vėtrungė;Zuikių;1280823326;Ne;18;1;0;19
13902;Vėtrungė;Drugelių;5366256528;Ne;5;4;0;9
13903;Vėtrungė;Drugelių;5622109033;Taip;0;10;3;13
13904;Vėtrungė;Drugelių;6457369177;Taip;0;2;0;2
13905;Vėtrungė;Drugelių;8744050633;Taip;4;0;0;4
13906;Vėtrungė;Drugelių;7943682529;Taip;0;0;3;3
13907;Vėtrungė;Drugelių;9090873546;Taip;9;0;0;9
13908;Vėtrungė;Drugelių;2124476787;Taip;13;3;0;16
13909;Vėtrungė;Drugelių;2970067995;Taip;9;4;0;13
13910;Vėtrungė;Drugelių;4578835070;Ne;9;0;0;9
13911;Vėtrungė;Drugelių;8729505032;Taip;15;0;0;15
13912;Vėtrungė;Drugelių;5251308945;Taip;3;2;0;5
13913;Vėtrungė;Drugelių;9812496068;Taip;9;5;0;14
13914;Vėtrungė;Drugelių;8753387108;Taip;8;0;0;8
13915;Vėtrungė;Drugelių;3634995652;Taip;8;1;0;9
13916;Vėtrungė;Drugelių;2123410772;Taip;4;0;0;4
13917;Vėtrungė;Drugelių;3744377479;Taip;9;0;0;9
13918;Vėtrungė;Drugelių;8905533826;Taip;6;2;1;9
13919;Vėtrungė;Drugelių;7186353024;Taip;13;3;0;16
13920;Vėtrungė;Drugelių;2933312366;Taip;0;17;0;17
13921;Vėtrungė;Drugelių;2508501223;Taip;6;5;0;11
13922;Vėtrungė;Drugelių;3638303693;Ne;9;1;0;10
13923;Vėtrungė;Do-re-mi;6449124019;Taip;0;0;1;1
13924;Vėtrungė;Do-re-mi;9324733839;Taip;8;2;0;10
13925;Vėtrungė;Do-re-mi;2287044278;Ne;6;6;0;12
13926;Vėtrungė;Do-re-mi;2928868412;Taip;10;4;1;15
13927;Vėtrungė;Do-re-mi;2883254822;Taip;4;0;0;4
13928;Vėtrungė;Do-re-mi;9518734260;Taip;10;2;2;14
13929;Vėtrungė;Do-re-mi;7496582551;Taip;12;0;1;13
13930;Vėtrungė;Do-re-mi;5430818470;Taip;13;4;0;17
13931;Vėtrungė;Do-re-mi;5832298824;Ne;0;2;0;2
13932;Vėtrungė;Do-re-mi;7895027909;Taip;0;1;1;2
13933;Vėtrungė;Do-re-mi;7807708310;Taip;0;3;9;12
13934;Vėtrungė;Do-re-mi;3200251047;Taip;14;0;2;16
13935;Vėtrungė;Do-re-mi;3369970611;Taip;0;13;0;13
13936;Vėtrungė;Do-re-mi;1808699695;Taip;0;5;9;14
13937;Vėtrungė;Do-re-mi;9079483362;Taip;33;0;0;33
13938;Vėtrungė;Do-re-mi;9271869305;Taip;5;0;0;5
13939;Vėtrungė;Do-re-mi;4709068324;Taip;5;2;1;8
13940;Vėtrungė;Do-re-mi;5452337780;Taip;2;0;11;13
13941;Vėtrungė;Do-re-mi;8956375453;Ne;7;4;5;16
13942;Vėtrungė;Do-re-mi;9865628172;Taip;10;1;0;11
13943;Vėtrungė;Smalsučių;7803736567;Taip;7;9;0;16
13944;Vėtrungė;Smalsučių;6599281163;Taip;17;0;0;17
13945;Vėtrungė;Smalsučių;3249689008;Taip;16;1;0;17
13946;Vėtrungė;Smalsučių;7129180154;Taip;4;6;0;10
13947;Vėtrungė;Smalsučių;7295216791;Taip;7;2;0;9
13948;Vėtrungė;Smalsučių;9795630131;Taip;0;4;8;12
13949;Vėtrungė;Smalsučių;2636219826;Taip;9;0;0;9
13950;Vėtrungė;Smalsučių;7363490503;Ne;10;0;0;10
13951;Vėtrungė;Smalsučių;16216365941;Taip;0;10;0;10
13952;Vėtrungė;Smalsučių;2471926240;Taip;0;8;0;8
13953;Vėtrungė;Smalsučių;7813907852;Taip;0;3;5;8
13954;Vėtrungė;Smalsučių;2440001662;Taip;10;3;0;13
13955;Vėtrungė;Smalsučių;4000379945;Ne;3;13;0;16
13956;Vėtrungė;Smalsučių;5367369908;Taip;9;4;0;13
13957;Vėtrungė;Smalsučių;4154712272;Taip;7;2;0;9
13958;Vėtrungė;Smalsučių;3278452234;Taip;6;4;0;10
13959;Vėtrungė;Smalsučių;7483624989;Ne;8;1;0;9
13960;Vėtrungė;Smalsučių;4394100006;Taip;14;1;0;15
13961;Vėtrungė;Smalsučių;7730716483;Taip;9;4;0;13
13962;Vėtrungė;Smalsučių;5786557195;Taip;0;0;3;3
13963;Vėtrungė;Gudručių;6732632515;Ne;3;2;0;5
13964;Vėtrungė;Gudručių;8721035192;Taip;0;18;0;18
13965;Vėtrungė;Gudručių;1970034012;Ne;0;3;0;3
13966;Vėtrungė;Gudručių;3404120492;Taip;0;1;0;1
13967;Vėtrungė;Gudručių;8897558066;Taip;4;1;0;5
13968;Vėtrungė;Gudručių;7921863675;Taip;0;2;0;2
13969;Vėtrungė;Gudručių;8154023892;Ne;7;4;0;11
13970;Vėtrungė;Gudručių;1522141057;Taip;5;7;0;12
13971;Vėtrungė;Gudručių;9962435598;Ne;16;3;0;19
13972;Vėtrungė;Gudručių;2864217098;Taip;0;8;5;13
13973;Vėtrungė;Gudručių;6964225210;Ne;4;0;0;4
13974;Vėtrungė;Gudručių;2482436192;Taip;0;2;0;2
13975;Vėtrungė;Gudručių;4092242233;Taip;19;2;1;22
13976;Vėtrungė;Gudručių;1551989977;Taip;4;2;0;6
13977;Vėtrungė;Gudručių;4091719904;Taip;8;4;0;12
13978;Vėtrungė;Gudručių;5994465833;Ne;0;3;0;3
13979;Vėtrungė;Gudručių;4347810256;Taip;4;2;0;6
13980;Vėtrungė;Gudručių;7704497739;Taip;0;5;0;5
13981;Vėtrungė;Gudručių;8643181832;Taip;8;11;4;23
13982;Vėtrungė;Gudručių;1520846063;Taip;2;2;10;14
13983;Vėtrungė;Kodėlčių;9172488122;Taip;0;4;0;4
13984;Vėtrungė;Kodėlčių;2739382736;Taip;0;18;0;18
13985;Vėtrungė;Kodėlčių;3903604247;Taip;4;2;0;6
13986;Vėtrungė;Kodėlčių;3500551575;Taip;7;1;0;8
13987;Vėtrungė;Kodėlčių;7872043253;Taip;0;5;0;5
13988;Vėtrungė;Kodėlčių;9852609222;Taip;12;1;0;13
13989;Vėtrungė;Kodėlčių;8465132902;Taip;4;2;0;6
13990;Vėtrungė;Kodėlčių;8859592174;Taip;10;1;0;11
13991;Vėtrungė;Kodėlčių;7862615352;Taip;0;4;0;4
13992;Vėtrungė;Kodėlčių;5385880910;Taip;6;0;0;6
13993;Vėtrungė;Kodėlčių;9211406129;Taip;7;10;0;17
13994;Vėtrungė;Kodėlčių;1032730549;Taip;11;5;0;16
13995;Vėtrungė;Kodėlčių;7511121411;Taip;0;3;0;3
13996;Vėtrungė;Kodėlčių;9127735773;Taip;7;5;0;12
13997;Vėtrungė;Kodėlčių;4756863295;Taip;11;4;0;15
13998;Vėtrungė;Kodėlčių;8985054558;Taip;0;1;0;1
13999;Vėtrungė;Kodėlčių;3922749661;Taip;0;18;0;18
14000;Vėtrungė;Kodėlčių;8013249618;Taip;0;3;0;3
14001;Vėtrungė;Kodėlčių;3887230224;Taip;0;1;0;1
14002;Vėtrungė;Kodėlčių;7740260264;Taip;0;0;2;2
14003;Vėtrungė;Kodėlčių;6807838878;Taip;8;0;0;8
14004;Vėtrungė;Paukštelių;6983172988;Taip;18;0;0;18
14005;Vėtrungė;Paukštelių;8744205170;Taip;6;0;0;6
14006;Vėtrungė;Paukštelių;3957148270;Ne;4;0;4;8
14007;Vėtrungė;Paukštelių;3466149991;Taip;15;4;0;19
14008;Vėtrungė;Paukštelių;7258995031;Taip;0;1;3;4
14009;Vėtrungė;Paukštelių;5338424871;Taip;10;2;10;22
14010;Vėtrungė;Paukštelių;4805836717;Taip;5;3;1;9
14011;Vėtrungė;Paukštelių;6812588777;Taip;11;5;0;16
14012;Vėtrungė;Paukštelių;2798915063;Taip;19;0;0;19
14013;Vėtrungė;Paukštelių;2981610749;Taip;1;0;7;8
14014;Vėtrungė;Paukštelių;6146327857;Taip;24;0;0;24
14015;Vėtrungė;Paukštelių;8149563485;Taip;3;1;0;4
14016;Vėtrungė;Viščiukų;2725607774;Taip;4;1;3;8
14017;Vėtrungė;Viščiukų;5021830780;Taip;8;6;2;16
14018;Vėtrungė;Viščiukų;5808423634;Taip;5;0;0;5
14019;Vėtrungė;Viščiukų;6190900822;Taip;0;1;3;4
14020;Vėtrungė;Viščiukų;3834510410;Taip;7;0;1;8
14021;Vėtrungė;Viščiukų;4597361099;Taip;4;1;13;18
14022;Vėtrungė;Viščiukų;2490075899;Taip;9;2;0;11
14023;Vėtrungė;Viščiukų;4712052283;Ne;4;5;0;9
14024;Vėtrungė;Viščiukų;8761701511;Taip;5;4;7;16
14025;Vėtrungė;Viščiukų;3527585648;Taip;7;0;3;10
14026;Vėtrungė;Viščiukų;9684184905;Ne;4;0;0;4
14027;Vėtrungė;Viščiukų;4145172377;Taip;8;1;2;11
14028;Vėtrungė;Viščiukų;8577668542;Taip;16;0;0;16
14029;Vėtrungė;Viščiukų;4740985408;Taip;0;0;3;3
14030;Vėtrungė;Nykštukų;9696984346;Taip;1;14;0;15
14031;Vėtrungė;Nykštukų;7819147751;Ne;11;0;0;11
14032;Vėtrungė;Nykštukų;6990506209;Taip;21;1;0;22
14033;Vėtrungė;Nykštukų;2348557463;Taip;5;1;0;6
14034;Vėtrungė;Nykštukų;7733472482;Taip;11;0;0;11
14035;Vėtrungė;Nykštukų;2309821873;Taip;9;2;0;11
14036;Vėtrungė;Nykštukų;2364156362;Taip;8;5;0;13
14037;Vėtrungė;Nykštukų;8059553343;Taip;17;10;0;27
14038;Vėtrungė;Nykštukų;4020987532;Taip;1;2;2;5
14039;Vėtrungė;Nykštukų;9569555731;Taip;10;1;0;11
14040;Vėtrungė;Nykštukų;7699392279;Taip;0;20;0;20
14041;Vėtrungė;Nykštukų;9773838651;Taip;3;5;0;8
14042;Vėtrungė;Nykštukų;6866720274;Taip;0;5;0;5
14043;Vėtrungė;Nykštukų;3869546285;Taip;14;2;0;16
14044;Vėtrungė;Nykštukų;6783756347;Taip;6;0;0;6
14045;Vėtrungė;Nykštukų;4289435509;Taip;16;1;0;17
14046;Vėtrungė;Meškiukų;2510763357;Taip;3;0;0;3
14047;Vėtrungė;Meškiukų;4713420194;Taip;3;0;0;3
14048;Vėtrungė;Meškiukų;2226654309;Taip;0;6;0;6
14049;Vėtrungė;Meškiukų;9207846866;Taip;4;0;0;4
14050;Vėtrungė;Meškiukų;9065848425;Taip;6;6;0;12
14051;Vėtrungė;Meškiukų;3328447991;Taip;0;1;0;1
14052;Vėtrungė;Meškiukų;9685389270;Ne;0;9;0;9
14053;Vėtrungė;Meškiukų;9313438768;Taip;0;6;0;6
14054;Vėtrungė;Meškiukų;3122948974;Taip;0;1;0;1
14055;Vėtrungė;Meškiukų;2520926439;Taip;3;0;0;3
14056;Vėtrungė;Meškiukų;8961791293;Taip;10;2;0;12
14057;Vėtrungė;Meškiukų;2809555356;Taip;10;4;0;14
14058;Vėtrungė;Meškiukų;4624264759;Taip;5;0;0;5
14059;Vėtrungė;Meškiukų;1766599777;Ne;5;1;3;9
14060;Vėtrungė;Meškiukų;9642541034;Taip;4;3;0;7
14061;Vėtrungė;Meškiukų;8958748086;Taip;6;1;0;7
14062;Vėtrungė;Meškiukų;1480035015;Ne;6;0;0;6
14063;Vėtrungė;Ąžuoliukų;8775969909;Taip;0;0;1;1
14064;Vėtrungė;Ąžuoliukų;1034537691;Taip;2;0;1;3
14065;Vėtrungė;Ąžuoliukų;7568316390;Taip;0;3;0;3
14066;Vėtrungė;Ąžuoliukų;6363761237;Taip;5;1;0;6
14067;Vėtrungė;Ąžuoliukų;8913748584;Ne;13;1;0;14
14068;Vėtrungė;Ąžuoliukų;3073965379;Taip;0;5;0;5
14069;Vėtrungė;Ąžuoliukų;3938684888;Taip;7;0;0;7
14070;Vėtrungė;Ąžuoliukų;6073563461;Taip;3;3;1;7
14071;Vėtrungė;Ąžuoliukų;2977116563;Taip;1;0;0;1
14072;Vėtrungė;Ąžuoliukų;4925843510;Taip;19;0;1;20
14073;Vėtrungė;Ąžuoliukų;8867794275;Taip;0;1;0;1
14074;Vėtrungė;Ąžuoliukų;7096106273;Ne;3;0;19;22
14075;Vėtrungė;Ąžuoliukų;8026065367;Taip;0;8;0;8
14076;Vėtrungė;Ąžuoliukų;6476717645;Taip;6;0;1;7
14077;Vėtrungė;Ąžuoliukų;5167580818;Ne;22;0;0;22
14078;Vėtrungė;Ąžuoliukų;1169648551;Ne;12;0;0;12
14079;Vilnelė;Lakštutė;8843094480;Taip;9;1;0;10
14080;Vilnelė;Lakštutė;5786086401;Taip;9;0;0;9
14081;Vilnelė;Lakštutė;6249731759;Taip;0;17;0;17
14082;Vilnelė;Lakštutė;6837850601;Taip;9;2;0;11
14083;Vilnelė;Lakštutė;5554451335;Taip;17;0;0;17
14084;Vilnelė;Lakštutė;1762024490;Ne;0;0;3;3
14085;Vilnelė;Lakštutė;8201829887;Taip;0;9;0;9
14086;Vilnelė;Lakštutė;7702217893;Taip;8;0;0;8
14087;Vilnelė;Lakštutė;4427383755;Taip;11;3;0;14
14088;Vilnelė;Lakštutė;1547117566;Taip;11;3;0;14
14089;Vilnelė;Lakštutė;3231387543;Taip;7;2;0;9
14090;Vilnelė;Lakštutė;1734277231;Taip;9;0;0;9
14091;Vilnelė;Lakštutė;8837662451;Taip;0;18;0;18
14092;Vilnelė;Lakštutė;3900484348;Taip;10;2;2;14
14093;Vilnelė;Lakštutė;5498574366;Taip;0;18;0;18
14094;Vilnelė;Lakštutė;6686896190;Taip;6;3;1;10
14095;Vilnelė;Lakštutė;3032273912;Taip;8;9;0;17
14096;Vilnelė;Lakštutė;4017436910;Ne;5;1;2;8
14097;Vilnelė;Lakštutė;6156838553;Taip;9;1;3;13
14098;Vilnelė;Lakštutė;9843449060;Ne;13;0;3;16
14099;Vilnelė;Lakštutė;2803880424;Taip;6;2;0;8
14100;Vilnelė;Lakštutė;2418216191;Taip;15;0;0;15
14101;Vilnelė;Lakštutė;5913967803;Taip;4;0;3;7
14102;Vilnelė;Vyturėlis;5091272908;Taip;6;3;1;10
14103;Vilnelė;Vyturėlis;1133945467;Taip;7;0;0;7
14104;Vilnelė;Vyturėlis;3009064105;Taip;6;2;0;8
14105;Vilnelė;Vyturėlis;3743740372;Taip;7;0;0;7
14106;Vilnelė;Vyturėlis;2131599015;Taip;4;11;0;15
14107;Vilnelė;Vyturėlis;18740103706;Taip;0;10;0;10
14108;Vilnelė;Vyturėlis;7057183482;Taip;17;1;0;18
14109;Vilnelė;Vyturėlis;8725191514;Taip;5;3;0;8
14110;Vilnelė;Vyturėlis;6308015852;Taip;6;2;0;8
14111;Vilnelė;Vyturėlis;7963783957;Taip;11;0;0;11
14112;Vilnelė;Vyturėlis;1545570307;Taip;6;1;3;10
14113;Vilnelė;Vyturėlis;5540359276;Taip;8;0;0;8
14114;Vilnelė;Vyturėlis;1966090625;Taip;9;3;0;12
14115;Vilnelė;Vyturėlis;8740717061;Taip;7;2;0;9
14116;Vilnelė;Vyturėlis;3772263873;Taip;0;1;2;3
14117;Vilnelė;Vyturėlis;9183391434;Taip;9;11;0;20
14118;Vilnelė;Vyturėlis;2159103903;Taip;0;6;0;6
14119;Vilnelė;Vyturėlis;9369955153;Taip;9;0;0;9
14120;Vilnelė;Vyturėlis;5558584030;Taip;6;2;0;8
14121;Vilnelė;Vyturėlis;1151879281;Taip;10;2;0;12
14122;Vilnelė;Vyturėlis;8820091584;Taip;11;3;0;14
14123;Vilnelė;Vyturėlis;8270866998;Taip;9;11;0;20
14124;Vilnelė;Vyturėlis;28447690974;Taip;5;1;0;6
14125;Vilnelė;Vyturėlis;1462397783;Taip;11;5;0;16
14126;Vilnelė;Pagrandukas;5508759323;Ne;14;0;0;14
14127;Vilnelė;Pagrandukas;2144925171;Taip;11;1;0;12
14128;Vilnelė;Pagrandukas;4295816753;Taip;11;2;0;13
14129;Vilnelė;Pagrandukas;3844066232;Ne;10;3;0;13
14130;Vilnelė;Pagrandukas;6659537454;Taip;11;3;0;14
14131;Vilnelė;Pagrandukas;5953205533;Taip;0;20;0;20
14132;Vilnelė;Pagrandukas;4448413194;Taip;19;0;0;19
14133;Vilnelė;Pagrandukas;6830433856;Taip;10;1;4;15
14134;Vilnelė;Pagrandukas;4664946923;Taip;7;0;0;7
14135;Vilnelė;Pagrandukas;6982847450;Taip;10;3;2;15
14136;Vilnelė;Pagrandukas;7560124407;Taip;13;2;0;15
14137;Vilnelė;Pagrandukas;3685294539;Taip;14;0;0;14
14138;Vilnelė;Pagrandukas;4931943297;Taip;0;9;0;9
14139;Vilnelė;Pagrandukas;7882756938;Taip;16;0;0;16
14140;Vilnelė;Pagrandukas;7348404699;Taip;4;9;0;13
14141;Vilnelė;Pagrandukas;3323738649;Taip;7;1;1;9
14142;Vilnelė;Pagrandukas;8116613831;Taip;8;4;0;12
14143;Vilnelė;Pagrandukas;9489760844;Taip;4;10;0;14
14144;Vilnelė;Pagrandukas;6466321228;Taip;0;10;0;10
14145;Vilnelė;Pagrandukas;4478847902;Taip;0;18;0;18
14146;Vilnelė;Pagrandukas;9635159885;Taip;11;1;4;16
14147;Vilnelė;Pagrandukas;6448119003;Taip;9;7;0;16
14148;Vilnelė;Pagrandukas;2165389724;Taip;14;0;0;14
14149;Vilnelė;Bitutė;1720695615;Taip;0;5;0;5
14150;Vilnelė;Bitutė;2121071276;Taip;4;0;0;4
14151;Vilnelė;Bitutė;7387394504;Taip;0;14;0;14
14152;Vilnelė;Bitutė;8593060923;Taip;8;0;11;19
14153;Vilnelė;Bitutė;1882520335;Taip;8;1;0;9
14154;Vilnelė;Bitutė;85074719873;Taip;8;1;0;9
14155;Vilnelė;Bitutė;2990112955;Taip;0;3;5;8
14156;Vilnelė;Bitutė;6318246517;Taip;22;0;0;22
14157;Vilnelė;Bitutė;1281521052;Taip;10;6;0;16
14158;Vilnelė;Bitutė;9058632601;Taip;0;3;0;3
14159;Vilnelė;Bitutė;8615257084;Taip;8;0;1;9
14160;Vilnelė;Bitutė;98028664140;Taip;1;3;3;7
14161;Vilnelė;Bitutė;1507865281;Taip;9;2;0;11
14162;Vilnelė;Bitutė;2130482375;Taip;0;8;0;8
14163;Vilnelė;Bitutė;7292043157;Taip;12;2;0;14
14164;Vilnelė;Bitutė;4480175299;Taip;0;3;0;3
14165;Vilnelė;Bitutė;39494954188;Taip;9;7;0;16
14166;Vilnelė;Bitutė;6327531229;Taip;0;3;6;9
14167;Vilnelė;Bitutė;42835212158;Taip;11;9;0;20
14168;Vilnelė;Bitutė;6146514112;Taip;14;4;0;18
14169;Vilnelė;Bitutė;5013418313;Taip;10;1;0;11
14170;Vilnelė;Bitutė;5932200003;Ne;14;0;0;14
14171;Vilnelė;Bitutė;1783854203;Taip;4;0;0;4
14172;Vilnelė;Bitutė;9016832316;Taip;5;0;3;8
14173;Vilnelė;Bitutė;6155522893;Taip;9;0;0;9
14174;Vilnelė;Šaltinėlis;7752502124;Taip;11;0;0;11
14175;Vilnelė;Šaltinėlis;3064118212;Taip;9;2;1;12
14176;Vilnelė;Šaltinėlis;5813090771;Taip;10;0;0;10
14177;Vilnelė;Šaltinėlis;9317041585;Taip;17;0;0;17
14178;Vilnelė;Šaltinėlis;4670933970;Taip;10;0;0;10
14179;Vilnelė;Šaltinėlis;4817502971;Taip;14;0;1;15
14180;Vilnelė;Šaltinėlis;3712463891;Taip;2;5;0;7
14181;Vilnelė;Šaltinėlis;2343750614;Taip;11;0;0;11
14182;Vilnelė;Šaltinėlis;2700153185;Taip;7;0;2;9
14183;Vilnelė;Šaltinėlis;7698638698;Taip;0;0;1;1
14184;Vilnelė;Šaltinėlis;7231998656;Taip;22;0;0;22
14185;Vilnelė;Šaltinėlis;2683662906;Taip;10;0;0;10
14186;Vilnelė;Šaltinėlis;4982137749;Ne;13;2;0;15
14187;Vilnelė;Šaltinėlis;1108529953;Taip;8;0;0;8
14188;Vilnelė;Riešutėllis;1027463000;Taip;5;1;0;6
14189;Vilnelė;Riešutėllis;7020707723;Taip;12;6;0;18
14190;Vilnelė;Riešutėllis;1960860528;Taip;0;0;2;2
14191;Vilnelė;Riešutėllis;4203549404;Taip;0;3;4;7
14192;Vilnelė;Riešutėllis;3290952017;Ne;6;0;0;6
14193;Vilnelė;Riešutėllis;8588430578;Taip;9;5;0;14
14194;Vilnelė;Riešutėllis;8750705826;Taip;14;0;0;14
14195;Vilnelė;Riešutėllis;4780827432;Taip;11;1;0;12
14196;Vilnelė;Riešutėllis;4455099179;Taip;0;7;0;7
14197;Vilnelė;Riešutėllis;2367127222;Taip;10;1;0;11
14198;Vilnelė;Riešutėllis;5306723959;Taip;14;3;0;17
14199;Vilnelė;Riešutėllis;3670613082;Ne;14;3;0;17
14200;Vilnelė;Riešutėllis;6417545510;Taip;5;2;0;7
14201;Vilnelė;Riešutėllis;7085972543;Taip;5;0;0;5
14202;Vilnelė;Riešutėllis;3211657057;Taip;3;0;3;6
14203;Vilnelė;Riešutėllis;9016866597;Taip;11;5;0;16
14204;Vilnelė;Riešutėllis;7087798406;Taip;6;2;0;8
14205;Vilnelė;Riešutėllis;4254744025;Ne;9;10;0;19
14206;Vilnelė;Riešutėllis;3730997665;Taip;14;1;0;15
14207;Vilnelė;Riešutėllis;2706699572;Taip;0;6;0;6
14208;Vilnelė;Riešutėllis;8774842903;Taip;0;6;0;6
14209;Vilnelė;Riešutėllis;3031790547;Ne;8;2;0;10
14210;Vilnelė;Nykštukas;4210511566;Ne;4;5;0;9
14211;Vilnelė;Nykštukas;2891787022;Taip;11;0;0;11
14212;Vilnelė;Nykštukas;4734511521;Taip;15;0;0;15
14213;Vilnelė;Nykštukas;6344134620;Taip;0;4;0;4
14214;Vilnelė;Nykštukas;4295630317;Taip;20;11;0;31
14215;Vilnelė;Nykštukas;1554473199;Taip;10;4;0;14
14216;Vilnelė;Nykštukas;1819154122;Ne;10;0;0;10
14217;Vilnelė;Nykštukas;4060927733;Taip;28;0;0;28
14218;Vilnelė;Nykštukas;2299381653;Ne;11;17;0;28
14219;Vilnelė;Nykštukas;5041031750;Taip;6;1;0;7
14220;Vilnelė;Nykštukas;2157793186;Taip;22;0;0;22
14221;Vilnelė;Nykštukas;4516818999;Taip;2;16;0;18
14222;Vilnelė;Nykštukas;8579294202;Taip;19;7;0;26
14223;Vilnelė;Nykštukas;7161529969;Taip;24;0;0;24
14224;Vilnelė;Nykštukas;8493390146;Taip;8;3;0;11
14225;Vilnelė;Nykštukas;6054488692;Taip;10;1;0;11
14226;Vilnelė;Nykštukas;8630048961;Ne;0;11;0;11
14227;Vilnelė;Nykštukas;1500899512;Taip;0;1;0;1
14228;Vilnelė;Nykštukas;7592040226;Taip;12;8;0;20
14229;Vilnelė;Nykštukas;1515873552;Taip;10;2;0;12
14230;Vilnelė;Nykštukas;5629086127;Taip;25;0;0;25
14231;Vilnelė;Pieštukas;9879688569;Taip;0;3;0;3
14232;Vilnelė;Pieštukas;5473379559;Taip;0;2;0;2
14233;Vilnelė;Pieštukas;3781595939;Taip;8;5;0;13
14234;Vilnelė;Pieštukas;9884955712;Taip;18;1;0;19
14235;Vilnelė;Pieštukas;2479090686;Taip;0;10;0;10
14236;Vilnelė;Pieštukas;3945921490;Taip;0;22;0;22
14237;Vilnelė;Pieštukas;1975954784;Ne;0;8;0;8
14238;Vilnelė;Pieštukas;7199490431;Taip;0;1;0;1
14239;Vilnelė;Pieštukas;5778176840;Taip;0;5;0;5
14240;Vilnelė;Pieštukas;6355912551;Taip;0;14;0;14
14241;Vilnelė;Pieštukas;7976798775;Taip;0;2;0;2
14242;Vilnelė;Pieštukas;3811289758;Taip;13;3;0;16
14243;Vilnelė;Pieštukas;3529718234;Taip;5;7;0;12
14244;Vilnelė;Pieštukas;1880318663;Taip;7;3;0;10
14245;Vilnelė;Pieštukas;9589410276;Taip;7;3;0;10
14246;Vilnelė;Pieštukas;4718994967;Taip;0;15;0;15
14247;Vilnelė;Pieštukas;8092642447;Ne;9;2;1;12
14248;Vilnelė;Pieštukas;3856917286;Taip;15;3;0;18
14249;Vilnelė;Pieštukas;6132739519;Ne;7;9;0;16
14250;Vilnelė;Pieštukas;8162191913;Ne;0;1;0;1
14251;Vilnelė;Pieštukas;3791258264;Ne;3;2;0;5
14252;Vilnelė;Voverytė;7536603663;Ne;10;5;0;15
14253;Vilnelė;Voverytė;3503461211;Taip;0;8;0;8
14254;Vilnelė;Voverytė;3993826389;Taip;0;0;1;1
14255;Vilnelė;Voverytė;7388336851;Taip;8;4;0;12
14256;Vilnelė;Voverytė;8667403338;Taip;0;16;0;16
14257;Vilnelė;Voverytė;7883724600;Taip;0;16;0;16
14258;Vilnelė;Voverytė;4166351390;Taip;3;0;1;4
14259;Vilnelė;Voverytė;1351798589;Taip;5;4;0;9
14260;Vilnelė;Voverytė;9162681538;Taip;0;2;0;2
14261;Vilnelė;Voverytė;3075681823;Taip;0;2;0;2
14262;Vilnelė;Voverytė;6342242777;Taip;7;1;0;8
14263;Vilnelė;Voverytė;3843064564;Taip;0;0;2;2
14264;Vilnelė;Voverytė;3558073399;Taip;9;0;1;10
14265;Vilnelė;Voverytė;2841315531;Taip;6;0;3;9
14266;Vilnelė;Voverytė;9804772168;Taip;0;1;0;1
14267;Vilnelė;Voverytė;1596625263;Taip;4;6;0;10
14268;Vilnelė;Voverytė;7338573817;Taip;7;0;5;12
14269;Vilnelė;Voverytė;8121075430;Taip;0;13;0;13
14270;Vilnelė;Voverytė;1574809879;Taip;16;0;0;16
14271;Vilnelė;Voverytė;6083082959;Taip;11;4;0;15
14272;Vilnelė;Voverytė;2788449626;Taip;3;0;0;3
14273;Vilnelė;Kodėlčiukas;4642378600;Taip;9;0;0;9
14274;Vilnelė;Kodėlčiukas;6618109352;Taip;4;12;0;16
14275;Vilnelė;Kodėlčiukas;6715997340;Ne;10;0;0;10
14276;Vilnelė;Kodėlčiukas;9482133396;Taip;18;0;0;18
14277;Vilnelė;Kodėlčiukas;8620789304;Taip;11;0;0;11
14278;Vilnelė;Kodėlčiukas;8439505238;Taip;11;0;0;11
14279;Vilnelė;Kodėlčiukas;1580287517;Taip;7;0;0;7
14280;Vilnelė;Kodėlčiukas;5558378376;Taip;15;0;0;15
14281;Vilnelė;Kodėlčiukas;4328263940;Taip;13;1;0;14
14282;Vilnelė;Kodėlčiukas;3056845279;Taip;9;3;0;12
14283;Vilnelė;Kodėlčiukas;9537740492;Taip;10;0;3;13
14284;Vilnelė;Kodėlčiukas;9640330864;Taip;10;0;0;10
14285;Vilnelė;Kodėlčiukas;3848720970;Taip;17;1;0;18
14286;Vilnelė;Kodėlčiukas;7833531435;Taip;11;3;0;14
14287;Vilnelė;Kodėlčiukas;5961910077;Taip;5;1;2;8
14288;Vilnelė;Kodėlčiukas;3115242919;Ne;9;1;0;10
14289;Vilnelė;Kodėlčiukas;8543995029;Ne;6;15;0;21
14290;Vilnelė;Kodėlčiukas;1933660272;Taip;5;0;10;15
14291;Vilnelė;Kodėlčiukas;4986079102;Taip;10;3;0;13
14292;Vilnelė;Kodėlčiukas;5398303580;Taip;10;0;1;11
14293;Vilnelė;Kodėlčiukas;9418661965;Taip;6;0;0;6
14294;Vilnelė;Kodėlčiukas;5180951251;Taip;17;0;0;17
14295;Vilnelė;Žirniukas;5612501291;Taip;8;0;5;13
14296;Vilnelė;Žirniukas;3654833067;Taip;0;1;14;15
14297;Vilnelė;Žirniukas;4322462166;Taip;0;1;14;15
14298;Vilnelė;Žirniukas;9817054571;Taip;5;2;0;7
14299;Vilnelė;Žirniukas;9316933315;Taip;16;0;0;16
14300;Vilnelė;Žirniukas;1598555488;Taip;16;1;0;17
14301;Vilnelė;Žirniukas;5960725916;Taip;8;5;0;13
14302;Vilnelė;Žirniukas;8329253118;Taip;0;0;22;22
14303;Vilnelė;Žirniukas;9476510950;Taip;0;0;8;8
14304;Vilnelė;Žirniukas;3234028667;Taip;20;2;0;22
14305;Vilnelė;Žirniukas;7870509810;Ne;5;0;0;5
14306;Vilnelė;Žirniukas;6569980514;Taip;6;12;0;18
14307;Vilnelė;Žirniukas;6634526716;Ne;12;10;0;22
14308;Vilnelė;Žirniukas;8848138564;Taip;12;0;0;12
14309;Vilnelė;Žirniukas;5649725693;Taip;0;6;1;7
14310;Vilnelė;Žirniukas;7568755715;Taip;15;1;0;16
14311;Vilnelė;Žirniukas;1371066506;Taip;20;0;0;20
14312;Vilnelė;Žirniukas;4758117005;Ne;8;2;2;12
14313;Vilnelė;Pipiras;2918624119;Taip;10;0;1;11
14314;Vilnelė;Pipiras;3432602015;Taip;14;0;0;14
14315;Vilnelė;Pipiras;9660305163;Taip;14;1;0;15
14316;Vilnelė;Pipiras;2964672357;Taip;4;3;0;7
14317;Vilnelė;Pipiras;1566734465;Taip;9;0;0;9
14318;Vilnelė;Pipiras;9882766915;Taip;0;6;0;6
14319;Vilnelė;Pipiras;8015908754;Taip;7;6;0;13
14320;Vilnelė;Pipiras;7968029402;Taip;8;2;3;13
14321;Vilnelė;Pipiras;7221712624;Taip;8;2;3;13
14322;Vilnelė;Pipiras;6966791665;Taip;9;1;0;10
14323;Vilnelė;Pipiras;7293735126;Taip;9;1;0;10
14324;Vilnelė;Pipiras;9950598582;Ne;12;0;3;15
14325;Vilnelė;Pipiras;5444967820;Taip;12;0;0;12
14326;Vilnelė;Pipiras;3828623778;Taip;10;0;0;10
14327;Vilnelė;Pipiras;5273665901;Taip;4;0;0;4
14328;Vėrinėlis;GAIDELIAI;7069247393;Ne;9;0;1;10
14329;Vėrinėlis;GAIDELIAI;6162461750;Ne;9;0;0;9
14330;Vėrinėlis;GAIDELIAI;3500287869;Ne;18;1;0;19
14331;Vėrinėlis;GAIDELIAI;9370715798;Ne;25;0;0;25
14332;Vėrinėlis;GAIDELIAI;6500266853;Ne;24;0;0;24
14333;Vėrinėlis;GAIDELIAI;5891690000;Ne;27;0;1;28
14334;Vėrinėlis;GAIDELIAI;4401001009;Ne;28;2;0;30
14335;Vėrinėlis;GAIDELIAI;1685329004;Taip;12;0;0;12
14336;Vėrinėlis;GAIDELIAI;4498096701;Ne;8;0;0;8
14337;Vėrinėlis;GAIDELIAI;6055921178;Ne;16;1;0;17
14338;Vėrinėlis;GAIDELIAI;9144004655;Ne;22;0;0;22
14339;Vėrinėlis;GAIDELIAI;8272531606;Taip;23;0;0;23
14340;Vėrinėlis;GAIDELIAI;2114637828;Ne;5;5;0;10
14341;Vėrinėlis;GAIDELIAI;6159725406;Ne;17;0;2;19
14342;Vėrinėlis;GAIDELIAI;1844862699;Ne;25;0;0;25
14343;Vėrinėlis;GAIDELIAI;7455948332;Taip;10;16;0;26
14344;Vėrinėlis;GAIDELIAI;4965735537;Ne;12;0;2;14
14345;Vėrinėlis;SAULUTĖ;7224418233;Taip;27;0;0;27
14346;Vėrinėlis;SAULUTĖ;7471147288;Taip;8;0;0;8
14347;Vėrinėlis;SAULUTĖ;9612956692;Taip;9;8;0;17
14348;Vėrinėlis;SAULUTĖ;8238013636;Taip;20;0;0;20
14349;Vėrinėlis;SAULUTĖ;7273090217;Taip;10;3;0;13
14350;Vėrinėlis;SAULUTĖ;2337883071;Taip;21;0;4;25
14351;Vėrinėlis;SAULUTĖ;6913001318;Taip;0;9;0;9
14352;Vėrinėlis;SAULUTĖ;3882915774;Taip;9;19;0;28
14353;Vėrinėlis;SAULUTĖ;7440020169;Taip;0;10;0;10
14354;Vėrinėlis;SAULUTĖ;7913975075;Taip;3;17;0;20
14355;Vėrinėlis;SAULUTĖ;9967737864;Taip;11;3;0;14
14356;Vėrinėlis;SAULUTĖ;7364698713;Taip;3;0;3;6
14357;Vėrinėlis;SAULUTĖ;9009344779;Taip;18;3;0;21
14358;Vėrinėlis;SAULUTĖ;4059906525;Taip;10;0;2;12
14359;Vėrinėlis;SAULUTĖ;3832662507;Taip;10;1;0;11
14360;Vėrinėlis;SAULUTĖ;3291922401;Taip;10;3;1;14
14361;Vėrinėlis;SAULUTĖ;1007705906;Taip;20;3;0;23
14362;Vėrinėlis;SAULUTĖ;9289003583;Taip;8;2;0;10
14363;Vėrinėlis;SAULUTĖ;1684203955;Taip;8;2;0;10
14364;Vėrinėlis;SAULUTĖ;5942475043;Taip;1;21;0;22
14365;Vėrinėlis;SAULUTĖ;9310629340;Taip;31;0;0;31
14366;Vėrinėlis;SAULUTĖ;2369434537;Ne;14;1;2;17
14367;Vėrinėlis;NYKŠTUKAI;1865151493;Taip;3;0;0;3
14368;Vėrinėlis;NYKŠTUKAI;8755231814;Taip;11;1;3;15
14369;Vėrinėlis;NYKŠTUKAI;9604483237;Ne;4;0;3;7
14370;Vėrinėlis;NYKŠTUKAI;6220653152;Taip;5;1;0;6
14371;Vėrinėlis;NYKŠTUKAI;7981261038;Taip;0;4;0;4
14372;Vėrinėlis;NYKŠTUKAI;19865450007;Taip;10;5;2;17
14373;Vėrinėlis;NYKŠTUKAI;3975934329;Taip;8;0;2;10
14374;Vėrinėlis;NYKŠTUKAI;5511584499;Ne;0;1;3;4
14375;Vėrinėlis;NYKŠTUKAI;3562371502;Taip;11;0;0;11
14376;Vėrinėlis;NYKŠTUKAI;9751037428;Taip;0;3;0;3
14377;Vėrinėlis;NYKŠTUKAI;4089567420;Taip;4;0;1;5
14378;Vėrinėlis;NYKŠTUKAI;8579819581;Taip;0;3;0;3
14379;Vėrinėlis;NYKŠTUKAI;5209398043;Taip;12;5;0;17
14380;Vėrinėlis;NYKŠTUKAI;3074835599;Taip;4;0;0;4
14381;Vėrinėlis;NYKŠTUKAI;6779005350;Taip;15;0;2;17
14382;Vėrinėlis;NYKŠTUKAI;8824435889;Ne;2;1;0;3
14383;Vėrinėlis;BURATINAS;7093959212;Taip;0;5;0;5
14384;Vėrinėlis;BURATINAS;8100283579;Taip;10;4;0;14
14385;Vėrinėlis;BURATINAS;4666918175;Taip;4;0;0;4
14386;Vėrinėlis;BURATINAS;2774618380;Ne;12;2;0;14
14387;Vėrinėlis;BURATINAS;2857591912;Taip;0;1;0;1
14388;Vėrinėlis;BURATINAS;5429955166;Taip;11;0;0;11
14389;Vėrinėlis;BURATINAS;5429372946;Taip;4;0;1;5
14390;Vėrinėlis;BURATINAS;4183077476;Taip;8;9;0;17
14391;Vėrinėlis;BURATINAS;2529641529;Taip;15;6;0;21
14392;Vėrinėlis;BURATINAS;2467700639;Taip;3;8;0;11
14393;Vėrinėlis;BURATINAS;6136232912;Taip;13;5;0;18
14394;Vėrinėlis;BURATINAS;6058712578;Taip;15;1;0;16
14395;Vėrinėlis;BURATINAS;1164396960;Taip;4;5;0;9
14396;Vėrinėlis;BURATINAS;6413701823;Taip;6;1;0;7
14397;Vėrinėlis;BURATINAS;2364117224;Taip;11;6;0;17
14398;Vėrinėlis;BURATINAS;5206206080;Taip;9;3;6;18
14399;Vėrinėlis;BURATINAS;3947650381;Taip;10;0;1;11
14400;Vėrinėlis;GINTARĖLIAI;5987029334;Taip;0;0;22;22
14401;Vėrinėlis;GINTARĖLIAI;8372084728;Taip;14;1;0;15
14402;Vėrinėlis;GINTARĖLIAI;6054398276;Taip;9;1;0;10
14403;Vėrinėlis;GINTARĖLIAI;7432965615;Taip;14;1;0;15
14404;Vėrinėlis;GINTARĖLIAI;3457199716;Taip;7;1;0;8
14405;Vėrinėlis;GINTARĖLIAI;7743951577;Taip;17;0;0;17
14406;Vėrinėlis;GINTARĖLIAI;2006432327;Taip;16;0;0;16
14407;Vėrinėlis;GINTARĖLIAI;6785519869;Taip;10;0;0;10
14408;Vėrinėlis;GINTARĖLIAI;3363388500;Taip;17;1;0;18
14409;Vėrinėlis;GINTARĖLIAI;1872534206;Taip;0;3;0;3
14410;Vėrinėlis;GINTARĖLIAI;8545392429;Taip;11;0;0;11
14411;Vėrinėlis;GINTARĖLIAI;9171173116;Taip;10;0;0;10
14412;Vėrinėlis;GINTARĖLIAI;8343196405;Taip;10;5;0;15
14413;Vėrinėlis;GINTARĖLIAI;2284527544;Taip;14;0;0;14
14414;Vėrinėlis;GINTARĖLIAI;5644772729;Taip;7;0;0;7
14415;Vėrinėlis;GINTARĖLIAI;4034106321;Taip;5;0;0;5
14416;Vėrinėlis;RAMUNĖLĖS;4415030161;Taip;0;6;0;6
14417;Vėrinėlis;RAMUNĖLĖS;8620836106;Taip;18;0;0;18
14418;Vėrinėlis;RAMUNĖLĖS;5003344894;Taip;3;1;1;5
14419;Vėrinėlis;RAMUNĖLĖS;5434506594;Taip;17;1;0;18
14420;Vėrinėlis;RAMUNĖLĖS;5041189990;Taip;18;0;0;18
14421;Vėrinėlis;RAMUNĖLĖS;1047139776;Taip;0;3;0;3
14422;Vėrinėlis;RAMUNĖLĖS;3130841241;Taip;0;3;0;3
14423;Vėrinėlis;RAMUNĖLĖS;9798993200;Taip;0;1;0;1
14424;Vėrinėlis;RAMUNĖLĖS;6435612222;Ne;0;3;0;3
14425;Vėrinėlis;RAMUNĖLĖS;6866592245;Taip;13;0;0;13
14426;Vėrinėlis;RAMUNĖLĖS;4728119881;Taip;0;1;0;1
14427;Vėrinėlis;RAMUNĖLĖS;3316897176;Taip;0;6;0;6
14428;Vėrinėlis;RAMUNĖLĖS;1386916991;Taip;5;5;0;10
14429;Vėrinėlis;RAMUNĖLĖS;2090334618;Taip;4;1;0;5
14430;Vėrinėlis;RAMUNĖLĖS;3810261864;Taip;6;2;1;9
14431;Vėrinėlis;RAMUNĖLĖS;4191386053;Taip;0;6;0;6
14432;Vėrinėlis;KODELČIUKŲ;7070058961;Taip;9;4;0;13
14433;Vėrinėlis;KODELČIUKŲ;3308843618;Taip;5;7;0;12
14434;Vėrinėlis;KODELČIUKŲ;1535567719;Taip;10;12;0;22
14435;Vėrinėlis;KODELČIUKŲ;8755941866;Taip;1;2;2;5
14436;Vėrinėlis;KODELČIUKŲ;9686481278;Taip;0;0;3;3
14437;Vėrinėlis;KODELČIUKŲ;42298331453;Taip;8;0;0;8
14438;Vėrinėlis;KODELČIUKŲ;8709714647;Taip;0;5;4;9
14439;Vėrinėlis;KODELČIUKŲ;6108187043;Taip;0;4;0;4
14440;Vėrinėlis;KODELČIUKŲ;9119967823;Taip;0;1;4;5
14441;Vėrinėlis;KODELČIUKŲ;4067153819;Taip;0;1;8;9
14442;Vėrinėlis;KODELČIUKŲ;5712568063;Taip;10;0;0;10
14443;Vėrinėlis;KODELČIUKŲ;1467899937;Taip;8;1;0;9
14444;Vėrinėlis;KODELČIUKŲ;8885866108;Taip;0;1;4;5
14445;Vėrinėlis;KODELČIUKŲ;7634939364;Taip;4;3;0;7
14446;Vėrinėlis;KODELČIUKŲ;3049346950;Taip;9;1;9;19
14447;Vėrinėlis;KODELČIUKŲ;8652292752;Taip;4;1;3;8
14448;Vėrinėlis;KODELČIUKŲ;4039903678;Taip;11;0;1;12
14449;Vėrinėlis;KODELČIUKŲ;3729926575;Ne;8;1;4;13
14450;Vėrinėlis;KODELČIUKŲ;7167034587;Taip;0;5;0;5
14451;Vėrinėlis;KODELČIUKŲ;9511678036;Taip;0;1;0;1
14452;Vėrinėlis;KODELČIUKŲ;5720076968;Taip;6;1;3;10
14453;Vėrinėlis;ŽIRNIUKAI;1769852084;Taip;9;6;0;15
14454;Vėrinėlis;ŽIRNIUKAI;4718732261;Taip;0;2;0;2
14455;Vėrinėlis;ŽIRNIUKAI;4981127515;Taip;0;1;0;1
14456;Vėrinėlis;ŽIRNIUKAI;8329989952;Taip;11;0;1;12
14457;Vėrinėlis;ŽIRNIUKAI;3202518504;Taip;3;0;2;5
14458;Vėrinėlis;ŽIRNIUKAI;4752902173;Taip;4;8;0;12
14459;Vėrinėlis;ŽIRNIUKAI;5600815908;Taip;11;0;0;11
14460;Vėrinėlis;ŽIRNIUKAI;7367485961;Ne;0;1;0;1
14461;Vėrinėlis;ŽIRNIUKAI;2687583764;Taip;3;0;1;4
14462;Vėrinėlis;ŽIRNIUKAI;2633143128;Taip;0;0;3;3
14463;Vėrinėlis;ŽIRNIUKAI;9419245081;Taip;0;6;4;10
14464;Vėrinėlis;ŽIRNIUKAI;7817387800;Taip;0;0;5;5
14465;Vėrinėlis;ŽIRNIUKAI;6377447141;Ne;0;0;20;20
14466;Vėrinėlis;ŽIRNIUKAI;7371908331;Taip;8;0;3;11
14467;Vėrinėlis;ŽIRNIUKAI;2087129236;Taip;0;0;2;2
14468;Vėrinėlis;ŽIRNIUKAI;6392625405;Ne;4;2;0;6
14469;Vėrinėlis;ŽIRNIUKAI;1896980533;Taip;5;0;3;8
14470;Vėrinėlis;ŽIRNIUKAI;2732572235;Taip;0;1;3;4
14471;Vėrinėlis;ŽIRNIUKAI;8483525051;Taip;4;0;0;4
14472;Vėrinėlis;ŽIRNIUKAI;8397025332;Taip;0;0;1;1
14473;Vėrinėlis;ŽIRNIUKAI;6576726481;Taip;0;0;1;1
14474;Vėrinėlis;VARPELIAI;7416041207;Taip;10;2;0;12
14475;Vėrinėlis;VARPELIAI;8655158155;Taip;0;9;0;9
14476;Vėrinėlis;VARPELIAI;3829146401;Taip;5;0;0;5
14477;Vėrinėlis;VARPELIAI;6177784856;Taip;11;0;0;11
14478;Vėrinėlis;VARPELIAI;9388153932;Taip;0;0;22;22
14479;Vėrinėlis;VARPELIAI;6362125404;Ne;12;1;0;13
14480;Vėrinėlis;VARPELIAI;9599724421;Taip;9;1;0;10
14481;Vėrinėlis;VARPELIAI;7216867683;Taip;8;3;0;11
14482;Vėrinėlis;VARPELIAI;8336694468;Taip;16;1;0;17
14483;Vėrinėlis;VARPELIAI;2731207996;Taip;10;3;2;15
14484;Vėrinėlis;VARPELIAI;9522506115;Taip;0;15;0;15
14485;Vėrinėlis;VARPELIAI;2625930005;Taip;1;0;0;1
14486;Vėrinėlis;VARPELIAI;1026312967;Taip;5;3;0;8
14487;Vėrinėlis;VARPELIAI;2561255096;Taip;11;0;6;17
14488;Vėrinėlis;VARPELIAI;5821107898;Taip;17;0;0;17
14489;Vėrinėlis;VARPELIAI;9351658311;Taip;0;14;0;14
14490;Vėrinėlis;VARPELIAI;3392458614;Ne;15;1;0;16
14491;Vėrinėlis;BORUŽĖLĖS;8759487574;Taip;0;11;0;11
14492;Vėrinėlis;BORUŽĖLĖS;4819016753;Taip;8;0;0;8
14493;Vėrinėlis;BORUŽĖLĖS;1910385020;Taip;4;17;0;21
14494;Vėrinėlis;BORUŽĖLĖS;2078857084;Taip;11;0;3;14
14495;Vėrinėlis;BORUŽĖLĖS;3934652683;Taip;14;0;1;15
14496;Vėrinėlis;BORUŽĖLĖS;6904733283;Taip;12;0;2;14
14497;Vėrinėlis;BORUŽĖLĖS;4446546335;Taip;7;0;0;7
14498;Vėrinėlis;BORUŽĖLĖS;3718510933;Ne;9;0;0;9
14499;Vėrinėlis;BORUŽĖLĖS;2501287529;Taip;9;1;0;10
14500;Vėrinėlis;BORUŽĖLĖS;8904833339;Taip;11;2;0;13
14501;Vėrinėlis;BORUŽĖLĖS;3312501759;Taip;11;2;0;13
14502;Vėrinėlis;BORUŽĖLĖS;9217188911;Taip;5;15;0;20
14503;Vėrinėlis;BORUŽĖLĖS;7414937335;Taip;22;7;0;29
14504;Vėrinėlis;BORUŽĖLĖS;2574507205;Taip;4;6;0;10
14505;Vėrinėlis;BORUŽĖLĖS;6671382987;Taip;10;0;0;10
14506;Vėrinėlis;BORUŽĖLĖS;3200007674;Taip;6;1;0;7
14507;Vėrinėlis;BORUŽĖLĖS;4852563692;Taip;1;4;0;5
14508;Vėrinėlis;BORUŽĖLĖS;5865529907;Taip;17;0;4;21
14509;Vėrinėlis;BORUŽĖLĖS;9613642664;Taip;0;12;0;12
14510;Vėrinėlis;BORUŽĖLĖS;2467242845;Taip;9;9;0;18
14511;Vėrinėlis;SVEIKUOLIAI;1909742394;Taip;8;0;0;8
14512;Vėrinėlis;SVEIKUOLIAI;6176308531;Taip;9;1;0;10
14513;Vėrinėlis;SVEIKUOLIAI;3070965434;Taip;0;1;2;3
14514;Vėrinėlis;SVEIKUOLIAI;3563114419;Ne;21;1;0;22
14515;Vėrinėlis;SVEIKUOLIAI;3973272659;Taip;3;1;1;5
14516;Vėrinėlis;SVEIKUOLIAI;6504377326;Taip;0;1;0;1
14517;Vėrinėlis;SVEIKUOLIAI;8716965452;Taip;9;3;0;12
14518;Vėrinėlis;SVEIKUOLIAI;7584124339;Taip;10;5;0;15
14519;Vėrinėlis;SVEIKUOLIAI;9352630743;Taip;0;1;3;4
14520;Vėrinėlis;SVEIKUOLIAI;4859330774;Ne;17;0;0;17
14521;Vėrinėlis;SVEIKUOLIAI;8543081245;Taip;0;10;0;10
14522;Vėrinėlis;SVEIKUOLIAI;1800434426;Taip;15;1;1;17
14523;Vėrinėlis;SVEIKUOLIAI;5614185158;Taip;0;2;0;2
14524;Vėrinėlis;SVEIKUOLIAI;5539714292;Taip;0;5;0;5
14525;Vėrinėlis;SVEIKUOLIAI;2516474825;Taip;28;0;1;29
14526;Vėrinėlis;SVEIKUOLIAI;9058127692;Taip;0;2;0;2
14527;Vėrinėlis;SVEIKUOLIAI;1278914183;Taip;9;0;0;9
14528;Vėrinėlis;SVEIKUOLIAI;7573209012;Taip;13;0;0;13
14529;Vėrinėlis;SVEIKUOLIAI;3084117432;Taip;0;5;0;5
14530;Vėrinėlis;SVEIKUOLIAI;2015928440;Ne;2;1;1;4
14531;Vėrinėlis;ŠIRDELĖS;7734163541;Taip;0;0;1;1
14532;Vėrinėlis;ŠIRDELĖS;4378592116;Taip;11;21;0;32
14533;Vėrinėlis;ŠIRDELĖS;7517113022;Taip;9;0;0;9
14534;Vėrinėlis;ŠIRDELĖS;1841277321;Taip;0;3;0;3
14535;Vėrinėlis;ŠIRDELĖS;5588658517;Taip;20;4;0;24
14536;Vėrinėlis;ŠIRDELĖS;5653635907;Taip;0;5;0;5
14537;Vėrinėlis;ŠIRDELĖS;1152010178;Taip;7;2;1;10
14538;Vėrinėlis;ŠIRDELĖS;2038169885;Taip;9;13;0;22
14539;Vėrinėlis;ŠIRDELĖS;9375922889;Taip;6;6;0;12
14540;Vėrinėlis;ŠIRDELĖS;5813009126;Taip;0;5;0;5
14541;Vėrinėlis;ŠIRDELĖS;3511809411;Taip;7;11;0;18
14542;Vėrinėlis;ŠIRDELĖS;3535652648;Taip;10;3;1;14
14543;Vėrinėlis;ŠIRDELĖS;9217815657;Taip;2;5;0;7
14544;Vėrinėlis;ŠIRDELĖS;4403875733;Taip;7;0;1;8
14545;Vėrinėlis;ŠIRDELĖS;4700093328;Taip;4;0;3;7
14546;Vėrinėlis;ŠIRDELĖS;1339847370;Taip;6;0;0;6
14547;Vėrinėlis;ŠIRDELĖS;1939318286;Taip;0;5;0;5
14548;Vėrinėlis;ŠIRDELĖS;3687250255;Taip;11;0;4;15
14549;Vėrinėlis;ŠIRDELĖS;7361319518;Taip;0;0;4;4
14550;Vėrinėlis;ŠIRDELĖS;2847839917;Ne;14;0;1;15
14551;Vėrinėlis;ŠIRDELĖS;7311740859;Taip;4;3;0;7
14552;Vėrinėlis;ŠIRDELĖS;6905591549;Ne;10;1;3;14
14553;Viltenė;Drugeliai;3625763429;Taip;0;1;0;1
14554;Viltenė;Drugeliai;2392304909;Taip;13;0;0;13
14555;Viltenė;Drugeliai;5781655552;Taip;5;4;0;9
14556;Viltenė;Drugeliai;2410868015;Taip;0;22;0;22
14557;Viltenė;Drugeliai;4616047113;Ne;18;0;0;18
14558;Viltenė;Drugeliai;6810811656;Taip;10;1;0;11
14559;Viltenė;Drugeliai;9228677568;Taip;4;7;0;11
14560;Viltenė;Drugeliai;3905014810;Taip;9;9;0;18
14561;Viltenė;Drugeliai;4121448859;Taip;7;0;0;7
14562;Viltenė;Drugeliai;9157616307;Taip;5;0;0;5
14563;Viltenė;Drugeliai;9476132305;Taip;1;0;0;1
14564;Viltenė;Drugeliai;3052677157;Taip;0;3;0;3
14565;Viltenė;Drugeliai;7401460248;Taip;0;2;0;2
14566;Viltenė;Drugeliai;9820462941;Taip;5;1;0;6
14567;Viltenė;Drugeliai;5552217000;Ne;0;7;0;7
14568;Viltenė;Drugeliai;9756519374;Taip;7;0;0;7
14569;Viltenė;Drugeliai;7928894276;Taip;0;3;0;3
14570;Viltenė;Drugeliai;8527270437;Taip;0;7;0;7
14571;Viltenė;Drugeliai;4195708756;Taip;15;3;0;18
14572;Viltenė;Drugeliai;1267187553;Taip;5;0;0;5
14573;Viltenė;Drugeliai;1081603034;Taip;0;22;0;22
14574;Viltenė;Drugeliai;7500965165;Taip;0;7;0;7
14575;Viltenė;Bitučių;7158824421;Taip;13;0;0;13
14576;Viltenė;Bitučių;2846574130;Taip;10;7;0;17
14577;Viltenė;Bitučių;8336855920;Taip;0;13;0;13
14578;Viltenė;Bitučių;2841144656;Taip;6;0;0;6
14579;Viltenė;Bitučių;7810374329;Taip;3;3;0;6
14580;Viltenė;Bitučių;4724382069;Ne;15;0;0;15
14581;Viltenė;Bitučių;4001205912;Taip;4;6;0;10
14582;Viltenė;Bitučių;5077874991;Taip;0;6;0;6
14583;Viltenė;Bitučių;7266522399;Taip;0;1;0;1
14584;Viltenė;Bitučių;4379784712;Taip;2;0;0;2
14585;Viltenė;Bitučių;9095458948;Taip;17;0;0;17
14586;Viltenė;Bitučių;4661430937;Taip;17;0;0;17
14587;Viltenė;Bitučių;5241075224;Taip;7;1;0;8
14588;Viltenė;Boružėlių;6642790962;Taip;10;0;0;10
14589;Viltenė;Boružėlių;9572407405;Taip;2;4;0;6
14590;Viltenė;Boružėlių;3738838707;Taip;0;2;0;2
14591;Viltenė;Boružėlių;8473588098;Ne;0;12;0;12
14592;Viltenė;Boružėlių;3995418079;Taip;0;2;0;2
14593;Viltenė;Boružėlių;1399653129;Taip;0;2;0;2
14594;Viltenė;Boružėlių;5379804362;Taip;0;1;0;1
14595;Viltenė;Boružėlių;1936628249;Taip;0;3;0;3
14596;Viltenė;Boružėlių;7912396297;Taip;0;10;0;10
14597;Viltenė;Boružėlių;4036109404;Taip;7;9;0;16
14598;Viltenė;Boružėlių;4604298036;Taip;0;8;0;8
14599;Viltenė;Boružėlių;9242034622;Taip;0;1;0;1
14600;Viltenė;Boružėlių;2383607612;Taip;0;13;0;13
14601;Viltenė;Boružėlių;9597857664;Taip;9;0;0;9
14602;Viltenė;Gandriukų;6481491422;Taip;12;1;2;15
14603;Viltenė;Gandriukų;2452782594;Taip;8;0;0;8
14604;Viltenė;Gandriukų;2884698447;Taip;0;1;0;1
14605;Viltenė;Gandriukų;6060648988;Taip;8;3;0;11
14606;Viltenė;Gandriukų;1840626621;Taip;3;3;0;6
14607;Viltenė;Gandriukų;7796422726;Taip;4;3;0;7
14608;Viltenė;Gandriukų;2815105107;Taip;0;1;0;1
14609;Viltenė;Gandriukų;6511850468;Taip;1;1;0;2
14610;Viltenė;Gandriukų;5850652322;Taip;17;1;0;18
14611;Viltenė;Gandriukų;1243595112;Taip;0;3;0;3
14612;Viltenė;Gandriukų;3073228245;Ne;15;0;1;16
14613;Viltenė;Gandriukų;4468743044;Taip;0;4;0;4
14614;Viltenė;Gandriukų;6355857716;Taip;0;0;4;4
14615;Viltenė;Gandriukų;5929135840;Taip;0;1;0;1
14616;Viltenė;Gandriukų;6473925760;Taip;17;0;0;17
14617;Viltenė;Gandriukų;8458769051;Taip;0;3;7;10
14618;Viltenė;Aitvariukai;5083515613;Ne;0;2;0;2
14619;Viltenė;Aitvariukai;2137929911;Taip;6;3;0;9
14620;Viltenė;Aitvariukai;9185054066;Taip;0;5;0;5
14621;Viltenė;Aitvariukai;2036902795;Taip;0;1;0;1
14622;Viltenė;Aitvariukai;5599943846;Taip;24;0;0;24
14623;Viltenė;Aitvariukai;6721689684;Taip;5;2;0;7
14624;Viltenė;Aitvariukai;6296509460;Taip;10;3;0;13
14625;Viltenė;Aitvariukai;9101795131;Taip;0;2;0;2
14626;Viltenė;Aitvariukai;3908574248;Taip;0;2;0;2
14627;Viltenė;Aitvariukai;8439859449;Taip;17;5;0;22
14628;Viltenė;Aitvariukai;2976705872;Taip;10;2;0;12
14629;Viltenė;Aitvariukai;2192086488;Taip;3;2;0;5
14630;Viltenė;Aitvariukai;2026654467;Ne;3;3;0;6
14631;Viltenė;Aitvariukai;4641365031;Taip;0;7;0;7
14632;Viltenė;Aitvariukai;7277455268;Taip;0;15;0;15
14633;Viltenė;Aitvariukai;3245284852;Taip;8;0;0;8
14634;Viltenė;Aitvariukai;2786572522;Taip;6;7;0;13
14635;Viltenė;Geniukų;1822220265;Taip;12;0;0;12
14636;Viltenė;Geniukų;6349032936;Taip;5;5;0;10
14637;Viltenė;Geniukų;1423254631;Taip;0;4;0;4
14638;Viltenė;Geniukų;3002690526;Taip;4;1;0;5
14639;Viltenė;Geniukų;6276349499;Taip;0;1;0;1
14640;Viltenė;Geniukų;6063181025;Taip;0;7;0;7
14641;Viltenė;Geniukų;1672091332;Taip;8;1;0;9
14642;Viltenė;Geniukų;49998813869;Taip;0;6;0;6
14643;Viltenė;Geniukų;3389110405;Taip;4;2;0;6
14644;Viltenė;Geniukų;4319685140;Taip;4;3;0;7
14645;Viltenė;Geniukų;8125023386;Taip;5;2;0;7
14646;Viltenė;Geniukų;9035687504;Taip;0;1;0;1
14647;Viltenė;Geniukų;1629377078;Ne;9;1;0;10
14648;Viltenė;Geniukų;3746923185;Taip;0;7;0;7
14649;Viltenė;Geniukų;1557503831;Ne;2;7;0;9
14650;Viltenė;Saulutės;2044754943;Taip;0;2;0;2
14651;Viltenė;Saulutės;6848403057;Taip;0;1;0;1
14652;Viltenė;Saulutės;1615415742;Taip;0;2;0;2
14653;Viltenė;Saulutės;7994367286;Taip;0;19;0;19
14654;Viltenė;Saulutės;9935236068;Ne;5;3;0;8
14655;Viltenė;Saulutės;6664059418;Ne;0;5;0;5
14656;Viltenė;Saulutės;2141002432;Taip;0;11;0;11
14657;Viltenė;Saulutės;1362308882;Taip;0;1;0;1
14658;Viltenė;Saulutės;8920533673;Taip;6;0;0;6
14659;Viltenė;Saulutės;5024192785;Taip;0;2;0;2
14660;Viltenė;Saulutės;1918867591;Taip;0;13;0;13
14661;Viltenė;Saulutės;7559243300;Taip;12;3;0;15
14662;Viltenė;Saulutės;8512665706;Taip;0;1;0;1
14663;Viltenė;Saulutės;3560474943;Taip;0;7;0;7
14664;Viltenė;Saulutės;2840208662;Taip;4;1;0;5
14665;Viltenė;Saulutės;1252657362;Taip;0;6;0;6
14666;Viltenė;Saulutės;2559945034;Taip;2;4;0;6
14667;Viltenė;Saulutės;7726650894;Taip;0;9;0;9
14668;Viltenė;Saulutės;1841732416;Taip;0;1;0;1
14669;Viltenė;Lapiukų;2034259692;Taip;0;5;0;5
14670;Viltenė;Lapiukų;3473533533;Taip;0;4;0;4
14671;Viltenė;Lapiukų;8696698257;Taip;0;1;0;1
14672;Viltenė;Lapiukų;8248514570;Taip;0;1;0;1
14673;Viltenė;Lapiukų;2878124826;Ne;11;4;0;15
14674;Viltenė;Lapiukų;2660622296;Taip;12;3;0;15
14675;Viltenė;Lapiukų;4550915388;Ne;12;4;0;16
14676;Viltenė;Lapiukų;8122878153;Taip;22;0;0;22
14677;Viltenė;Lapiukų;4243501722;Taip;0;5;0;5
14678;Viltenė;Lapiukų;5818645490;Taip;9;1;0;10
14679;Viltenė;Lapiukų;6429905246;Taip;4;3;0;7
14680;Viltenė;Lapiukų;6070264006;Taip;0;1;0;1
14681;Viltenė;Lapiukų;8187712849;Taip;0;6;0;6
14682;Viltenė;Lapiukų;3679704404;Taip;0;9;0;9
14683;Viltenė;Lapiukų;1507287948;Taip;1;2;0;3
14684;Viltenė;Lapiukų;9846205631;Taip;0;4;0;4
14685;Viltenė;Lapiukų;9063994291;Taip;3;0;0;3
14686;Viltenė;Voveriukai;6888346135;Taip;15;11;0;26
14687;Viltenė;Voveriukai;2936670828;Ne;0;1;1;2
14688;Viltenė;Voveriukai;5816623708;Taip;22;0;0;22
14689;Viltenė;Voveriukai;5611839058;Taip;0;1;0;1
14690;Viltenė;Voveriukai;4414192600;Taip;22;0;0;22
14691;Viltenė;Voveriukai;2483760198;Ne;10;0;0;10
14692;Viltenė;Voveriukai;8341211836;Taip;13;0;0;13
14693;Viltenė;Voveriukai;6954065006;Taip;9;1;1;11
14694;Viltenė;Voveriukai;6741521720;Taip;0;10;0;10
14695;Viltenė;Voveriukai;2642080849;Taip;0;1;9;10
14696;Viltenė;Voveriukai;6040634853;Taip;0;1;0;1
14697;Viltenė;Voveriukai;7322841332;Taip;20;1;0;21
14698;Viltenė;Voveriukai;1888167096;Taip;0;1;0;1
14699;Viltenė;Voveriukai;3291926243;Taip;6;7;0;13
14700;Viltenė;Voveriukai;2013415571;Taip;3;4;1;8
14701;Viltenė;Voveriukai;2894570917;Ne;4;0;0;4
14702;Viltenė;Voveriukai;1890096287;Taip;12;2;0;14
14703;Viltenė;Kiškučiai;6595715908;Taip;15;0;0;15
14704;Viltenė;Kiškučiai;3347380524;Ne;17;0;0;17
14705;Viltenė;Kiškučiai;1641406030;Taip;6;0;0;6
14706;Viltenė;Kiškučiai;2192673126;Taip;16;0;0;16
14707;Viltenė;Kiškučiai;3157417614;Taip;15;0;0;15
14708;Viltenė;Kiškučiai;5974408492;Taip;13;0;0;13
14709;Viltenė;Kiškučiai;9578037239;Taip;21;0;0;21
14710;Viltenė;Kiškučiai;4615393852;Ne;3;1;0;4
14711;Viltenė;Kiškučiai;2903596382;Taip;6;1;0;7
14712;Viltenė;Kiškučiai;8091905944;Taip;5;0;0;5
14713;Viltenė;Kiškučiai;7314937470;Taip;13;0;0;13
14714;Viltenė;Kiškučiai;8150583354;Ne;30;0;0;30
14715;Viltenė;Kiškučiai;9760364123;Taip;13;0;0;13
14716;Viltenė;Kiškučiai;6021086235;Taip;19;0;0;19
14717;Viltenė;Kiškučiai;1760899500;Taip;11;0;0;11
14718;Viltenė;Kiškučiai;9862698928;Ne;13;0;0;13
14719;Viltenė;Nykštukų;7993258845;Ne;5;0;0;5
14720;Viltenė;Nykštukų;4981225829;Taip;8;9;0;17
14721;Viltenė;Nykštukų;9424773418;Taip;7;0;0;7
14722;Viltenė;Nykštukų;3343045604;Taip;9;0;0;9
14723;Viltenė;Nykštukų;4537287677;Taip;7;1;0;8
14724;Viltenė;Nykštukų;3306285115;Taip;10;0;0;10
14725;Viltenė;Nykštukų;6992120038;Taip;0;1;6;7
14726;Viltenė;Nykštukų;7331321780;Taip;18;0;0;18
14727;Viltenė;Nykštukų;8958374098;Taip;28;0;0;28
14728;Viltenė;Nykštukų;5707049797;Taip;2;0;0;2
14729;Viltenė;Nykštukų;8950410446;Ne;0;0;3;3
14730;Viltenė;Nykštukų;2036857372;Taip;0;0;1;1
14731;Viltenė;Nykštukų;3853518656;Taip;4;0;0;4
14732;Viltenė;Nykštukų;9288406881;Taip;0;0;1;1
14733;Viltenė;Nykštukų;9263941853;Taip;16;1;0;17
14734;Viltenė;Nykštukų;7370710652;Taip;15;0;0;15
14735;Viltenė;Nykštukų;9582577013;Taip;12;0;0;12
14736;Viltenė;Triušiukai;6379567497;Taip;10;0;0;10
14737;Viltenė;Triušiukai;8346933997;Taip;13;0;0;13
14738;Viltenė;Triušiukai;8278572246;Taip;1;0;0;1
14739;Viltenė;Triušiukai;9819729046;Taip;10;5;0;15
14740;Viltenė;Triušiukai;8258247750;Taip;28;0;0;28
14741;Viltenė;Triušiukai;6635474168;Taip;18;0;0;18
14742;Viltenė;Triušiukai;7754951374;Taip;13;0;0;13
14743;Viltenė;Triušiukai;7145240197;Taip;9;0;1;10
14744;Viltenė;Triušiukai;7058586628;Taip;13;0;2;15
14745;Viltenė;Triušiukai;7005219570;Ne;8;0;1;9
14746;Viltenė;Triušiukai;4552355700;Taip;8;0;0;8
14747;Viltenė;Triušiukai;2850146424;Taip;0;4;0;4
14748;Viltenė;Triušiukai;1318750938;Taip;0;3;0;3
14749;Viltenė;Triušiukai;1788524515;Taip;32;0;0;32
14750;Voveraitė;ŽVIRBLIUKŲ;6684234832;Taip;0;3;15;18
14751;Voveraitė;ŽVIRBLIUKŲ;8119493388;Taip;11;0;1;12
14752;Voveraitė;ŽVIRBLIUKŲ;9715405072;Taip;4;2;3;9
14753;Voveraitė;ŽVIRBLIUKŲ;5804351872;Taip;0;0;4;4
14754;Voveraitė;ŽVIRBLIUKŲ;8925151080;Taip;0;0;11;11
14755;Voveraitė;ŽVIRBLIUKŲ;5510544648;Taip;8;0;3;11
14756;Voveraitė;ŽVIRBLIUKŲ;6959751328;Taip;14;1;1;16
14757;Voveraitė;ŽVIRBLIUKŲ;8803052781;Taip;9;1;0;10
14758;Voveraitė;ŽVIRBLIUKŲ;8257748589;Taip;9;0;4;13
14759;Voveraitė;ŽVIRBLIUKŲ;1522307865;Taip;11;0;0;11
14760;Voveraitė;ŽVIRBLIUKŲ;3811230983;Ne;25;0;7;32
14761;Voveraitė;ŽVIRBLIUKŲ;2142507659;Taip;17;0;1;18
14762;Voveraitė;ŽVIRBLIUKŲ;5395915359;Taip;8;0;0;8
14763;Voveraitė;ŽVIRBLIUKŲ;3247101840;Taip;18;0;2;20
14764;Voveraitė;ŽVIRBLIUKŲ;6643600680;Ne;11;0;1;12
14765;Voveraitė;ŽVIRBLIUKŲ;4460047281;Taip;14;0;0;14
14766;Voveraitė;ŽVIRBLIUKŲ;3877673172;Taip;4;1;12;17
14767;Voveraitė;ŽVIRBLIUKŲ;7008576999;Taip;0;20;0;20
14768;Voveraitė;ŽVIRBLIUKŲ;2716400502;Taip;0;20;0;20
14769;Voveraitė;ŽVIRBLIUKŲ;9117809080;Taip;13;0;1;14
14770;Voveraitė;ŽVIRBLIUKŲ;7861722125;Taip;14;0;1;15
14771;Voveraitė;ŽVIRBLIUKŲ;6994680282;Taip;0;0;1;1
14772;Voveraitė;VOVERIUKŲ;9195700962;Ne;22;0;0;22
14773;Voveraitė;VOVERIUKŲ;1340379090;Taip;13;0;0;13
14774;Voveraitė;VOVERIUKŲ;9912862474;Taip;8;2;0;10
14775;Voveraitė;VOVERIUKŲ;1960385335;Ne;19;2;0;21
14776;Voveraitė;VOVERIUKŲ;2594535017;Ne;0;6;0;6
14777;Voveraitė;VOVERIUKŲ;4563198733;Taip;9;9;0;18
14778;Voveraitė;VOVERIUKŲ;8373093305;Taip;9;0;0;9
14779;Voveraitė;VOVERIUKŲ;9514425475;Taip;4;6;0;10
14780;Voveraitė;VOVERIUKŲ;6017698476;Taip;5;4;0;9
14781;Voveraitė;VOVERIUKŲ;6891841301;Ne;9;7;0;16
14782;Voveraitė;VOVERIUKŲ;5935777154;Taip;10;0;0;10
14783;Voveraitė;VOVERIUKŲ;6007396459;Taip;4;4;0;8
14784;Voveraitė;VOVERIUKŲ;4054841724;Taip;18;0;0;18
14785;Voveraitė;VOVERIUKŲ;2304604061;Taip;4;0;0;4
14786;Voveraitė;VOVERIUKŲ;5956830012;Taip;3;6;0;9
14787;Voveraitė;VOVERIUKŲ;8344323109;Taip;2;1;0;3
14788;Voveraitė;VOVERIUKŲ;1141304286;Taip;14;0;0;14
14789;Voveraitė;VOVERIUKŲ;1663784931;Taip;14;0;0;14
14790;Voveraitė;VOVERIUKŲ;7744504020;Taip;0;1;0;1
14791;Voveraitė;KIŠKUČIŲ;9537862791;Taip;19;1;0;20
14792;Voveraitė;KIŠKUČIŲ;4478984171;Taip;10;0;0;10
14793;Voveraitė;KIŠKUČIŲ;3736638759;Taip;4;3;4;11
14794;Voveraitė;KIŠKUČIŲ;9011096222;Taip;22;0;0;22
14795;Voveraitė;KIŠKUČIŲ;3058377539;Taip;5;5;0;10
14796;Voveraitė;KIŠKUČIŲ;8507818993;Taip;0;2;0;2
14797;Voveraitė;KIŠKUČIŲ;8746008166;Taip;2;0;0;2
14798;Voveraitė;KIŠKUČIŲ;8084986328;Taip;4;1;0;5
14799;Voveraitė;KIŠKUČIŲ;6261152304;Taip;13;1;0;14
14800;Voveraitė;KIŠKUČIŲ;8220437514;Taip;11;3;0;14
14801;Voveraitė;KIŠKUČIŲ;4060906360;Taip;0;1;0;1
14802;Voveraitė;KIŠKUČIŲ;5069929376;Taip;10;0;0;10
14803;Voveraitė;KIŠKUČIŲ;7379045686;Taip;5;3;0;8
14804;Voveraitė;KIŠKUČIŲ;1961699588;Ne;4;2;0;6
14805;Voveraitė;KIŠKUČIŲ;1979839656;Taip;10;0;0;10
14806;Voveraitė;KIŠKUČIŲ;9599137158;Taip;20;0;0;20
14807;Voveraitė;KIŠKUČIŲ;8121423914;Taip;15;3;0;18
14808;Voveraitė;KIŠKUČIŲ;4379372200;Ne;11;1;0;12
14809;Voveraitė;KIŠKUČIŲ;1322927329;Taip;8;0;0;8
14810;Voveraitė;KIŠKUČIŲ;8528435385;Taip;1;1;0;2
14811;Voveraitė;KIŠKUČIŲ;8937070276;Taip;16;0;0;16
14812;Voveraitė;KIŠKUČIŲ;3859125174;Taip;19;3;0;22
14813;Voveraitė;KODĖLČIUKŲ;3274422598;Taip;3;0;0;3
14814;Voveraitė;KODĖLČIUKŲ;8438808999;Ne;7;0;0;7
14815;Voveraitė;KODĖLČIUKŲ;8818603905;Taip;12;0;1;13
14816;Voveraitė;KODĖLČIUKŲ;9397887760;Taip;6;1;0;7
14817;Voveraitė;KODĖLČIUKŲ;4151144278;Ne;5;1;0;6
14818;Voveraitė;KODĖLČIUKŲ;5598685365;Taip;0;3;0;3
14819;Voveraitė;KODĖLČIUKŲ;1482908802;Taip;8;0;2;10
14820;Voveraitė;KODĖLČIUKŲ;3384268786;Taip;5;1;0;6
14821;Voveraitė;KODĖLČIUKŲ;9887747925;Ne;14;0;0;14
14822;Voveraitė;KODĖLČIUKŲ;7605427741;Taip;7;1;0;8
14823;Voveraitė;KODĖLČIUKŲ;3344886524;Ne;10;0;0;10
14824;Voveraitė;KODĖLČIUKŲ;1046297151;Taip;8;0;0;8
14825;Voveraitė;KODĖLČIUKŲ;4996778855;Taip;9;0;0;9
14826;Voveraitė;KODĖLČIUKŲ;3432886020;Taip;14;2;0;16
14827;Voveraitė;KODĖLČIUKŲ;8154347030;Taip;15;2;0;17
14828;Voveraitė;KODĖLČIUKŲ;2482908027;Taip;0;14;0;14
14829;Voveraitė;KODĖLČIUKŲ;8692155848;Taip;0;0;6;6
14830;Voveraitė;KODĖLČIUKŲ;1040007977;Taip;3;3;0;6
14831;Voveraitė;KODĖLČIUKŲ;3881039538;Taip;13;6;0;19
14832;Voveraitė;KODĖLČIUKŲ;7281753415;Taip;13;6;0;19
14833;Voveraitė;KODĖLČIUKŲ;8021563060;Taip;10;4;0;14
14834;Voveraitė;KODĖLČIUKŲ;9816971493;Taip;9;0;0;9
14835;Voveraitė;MEŠKIUKŲ;8881070477;Taip;17;0;0;17
14836;Voveraitė;MEŠKIUKŲ;7253112849;Taip;18;0;0;18
14837;Voveraitė;MEŠKIUKŲ;7499150201;Taip;7;0;0;7
14838;Voveraitė;MEŠKIUKŲ;3217609712;Taip;10;1;0;11
14839;Voveraitė;MEŠKIUKŲ;3088866739;Taip;10;0;0;10
14840;Voveraitė;MEŠKIUKŲ;4207949414;Taip;10;0;0;10
14841;Voveraitė;MEŠKIUKŲ;4547087565;Taip;8;1;0;9
14842;Voveraitė;MEŠKIUKŲ;7474214701;Taip;7;1;0;8
14843;Voveraitė;MEŠKIUKŲ;9729735431;Taip;5;0;0;5
14844;Voveraitė;MEŠKIUKŲ;6853358062;Taip;4;1;0;5
14845;Voveraitė;MEŠKIUKŲ;3539069705;Taip;11;3;0;14
14846;Voveraitė;MEŠKIUKŲ;9544043839;Ne;12;0;0;12
14847;Voveraitė;MEŠKIUKŲ;6609235703;Ne;14;7;0;21
14848;Voveraitė;MEŠKIUKŲ;1528968162;Taip;11;0;0;11
14849;Voveraitė;MEŠKIUKŲ;3159659638;Taip;17;3;0;20
14850;Voveraitė;MEŠKIUKŲ;3532178114;Taip;17;3;0;20
14851;Voveraitė;MEŠKIUKŲ;8992548689;Taip;3;1;0;4
14852;Voveraitė;MEŠKIUKŲ;5196036817;Taip;4;1;0;5
14853;Voveraitė;MEŠKIUKŲ;1813440087;Taip;8;1;0;9
14854;Voveraitė;MEŠKIUKŲ;8534405352;Taip;18;0;0;18
14855;Voveraitė;MEŠKIUKŲ;5018335921;Taip;22;0;0;22
14856;Voveraitė;BORUŽĖLIŲ;3703062195;Taip;0;1;2;3
14857;Voveraitė;BORUŽĖLIŲ;3381417855;Taip;0;1;0;1
14858;Voveraitė;BORUŽĖLIŲ;5437283673;Taip;4;2;0;6
14859;Voveraitė;BORUŽĖLIŲ;3029983180;Taip;0;8;0;8
14860;Voveraitė;BORUŽĖLIŲ;5576058454;Taip;5;0;0;5
14861;Voveraitė;BORUŽĖLIŲ;7797966139;Taip;6;0;2;8
14862;Voveraitė;BORUŽĖLIŲ;4079618555;Taip;0;1;3;4
14863;Voveraitė;BORUŽĖLIŲ;6886337758;Taip;5;11;0;16
14864;Voveraitė;BORUŽĖLIŲ;3987058753;Taip;8;0;0;8
14865;Voveraitė;BORUŽĖLIŲ;1592633500;Taip;0;3;0;3
14866;Voveraitė;BORUŽĖLIŲ;1629942114;Taip;0;5;0;5
14867;Voveraitė;BORUŽĖLIŲ;1058273156;Taip;3;0;0;3
14868;Voveraitė;BORUŽĖLIŲ;3113780055;Taip;7;0;0;7
14869;Voveraitė;BORUŽĖLIŲ;9933037872;Ne;0;3;1;4
14870;Voveraitė;BORUŽĖLIŲ;3615729576;Taip;0;1;0;1
14871;Voveraitė;BORUŽĖLIŲ;65926130735;Taip;5;3;1;9
14872;Voveraitė;BORUŽĖLIŲ;6277010268;Taip;9;0;0;9
14873;Voveraitė;BORUŽĖLIŲ;2831224400;Taip;15;1;2;18
14874;Voveraitė;BORUŽĖLIŲ;2763656717;Taip;0;1;16;17
14875;Voveraitė;PELĖDŽIUKŲ;9491132884;Taip;10;0;0;10
14876;Voveraitė;PELĖDŽIUKŲ;1775800865;Taip;7;1;0;8
14877;Voveraitė;PELĖDŽIUKŲ;1959958256;Ne;14;1;3;18
14878;Voveraitė;PELĖDŽIUKŲ;6649068571;Taip;10;0;0;10
14879;Voveraitė;PELĖDŽIUKŲ;9231751171;Taip;5;1;0;6
14880;Voveraitė;PELĖDŽIUKŲ;54408671673;Taip;7;0;0;7
14881;Voveraitė;PELĖDŽIUKŲ;72154318379;Taip;7;0;0;7
14882;Voveraitė;PELĖDŽIUKŲ;9007031372;Taip;8;3;0;11
14883;Voveraitė;PELĖDŽIUKŲ;7069780513;Taip;2;0;1;3
14884;Voveraitė;PELĖDŽIUKŲ;6369860178;Taip;4;0;0;4
14885;Voveraitė;PELĖDŽIUKŲ;6433760749;Taip;0;5;0;5
14886;Voveraitė;PELĖDŽIUKŲ;6460834118;Taip;16;1;0;17
14887;Voveraitė;PELĖDŽIUKŲ;4338861332;Taip;0;3;2;5
14888;Voveraitė;PELĖDŽIUKŲ;7314148938;Taip;0;2;2;4
14889;Voveraitė;PELĖDŽIUKŲ;4511771924;Taip;0;2;1;3
14890;Voveraitė;PELĖDŽIUKŲ;602726070;Taip;6;2;0;8
14891;Voveraitė;PELĖDŽIUKŲ;4163635632;Taip;0;3;7;10
14892;Voveraitė;PELĖDŽIUKŲ;1397274691;Taip;8;3;0;11
14893;Voveraitė;DRUGELIŲ;1441921029;Taip;0;2;0;2
14894;Voveraitė;DRUGELIŲ;7531020548;Taip;17;3;0;20
14895;Voveraitė;DRUGELIŲ;4300235743;Taip;4;3;0;7
14896;Voveraitė;DRUGELIŲ;1510853268;Taip;0;1;0;1
14897;Voveraitė;DRUGELIŲ;3388547792;Taip;0;3;0;3
14898;Voveraitė;DRUGELIŲ;8719547570;Taip;14;0;0;14
14899;Voveraitė;DRUGELIŲ;3475601049;Taip;6;0;0;6
14900;Voveraitė;DRUGELIŲ;4017408873;Taip;4;0;2;6
14901;Voveraitė;DRUGELIŲ;7533728486;Taip;10;0;0;10
14902;Voveraitė;DRUGELIŲ;1550830434;Taip;4;4;0;8
14903;Voveraitė;DRUGELIŲ;5114768009;Taip;4;1;0;5
14904;Voveraitė;DRUGELIŲ;1045204378;Taip;4;1;0;5
14905;Voveraitė;DRUGELIŲ;4605007814;Taip;7;0;0;7
14906;Voveraitė;DRUGELIŲ;4911291891;Taip;9;6;2;17
14907;Voveraitė;DRUGELIŲ;4782336282;Taip;0;2;0;2
14908;Voveraitė;DRUGELIŲ;6415024059;Ne;7;1;0;8
14909;Voveraitė;DRUGELIŲ;4350450125;Taip;0;10;0;10
14910;Voveraitė;DRUGELIŲ;8913940646;Taip;4;2;11;17
14911;Voveraitė;DRUGELIŲ;1201270622;Taip;21;1;0;22
14912;Voveraitė;DRUGELIŲ;7238482039;Taip;22;0;0;22
14913;Voveraitė;DRUGELIŲ;5605614222;Taip;7;0;0;7
14914;Voveraitė;NYKŠTUKŲ;6579193196;Ne;9;0;0;9
14915;Voveraitė;NYKŠTUKŲ;8940421826;Taip;7;0;0;7
14916;Voveraitė;NYKŠTUKŲ;9332936763;Taip;5;0;3;8
14917;Voveraitė;NYKŠTUKŲ;6206817227;Ne;11;0;1;12
14918;Voveraitė;NYKŠTUKŲ;8206634977;Taip;16;0;0;16
14919;Voveraitė;NYKŠTUKŲ;3068683904;Taip;10;0;8;18
14920;Voveraitė;NYKŠTUKŲ;3600230896;Taip;5;0;0;5
14921;Voveraitė;NYKŠTUKŲ;1294012085;Ne;10;5;0;15
14922;Voveraitė;NYKŠTUKŲ;9363490578;Taip;14;6;0;20
14923;Voveraitė;NYKŠTUKŲ;8217771158;Taip;10;4;0;14
14924;Voveraitė;NYKŠTUKŲ;3409709168;Taip;10;1;1;12
14925;Voveraitė;NYKŠTUKŲ;1045121363;Ne;8;0;0;8
14926;Voveraitė;NYKŠTUKŲ;4319786615;Taip;0;2;1;3
14927;Voveraitė;NYKŠTUKŲ;4430631207;Ne;10;2;0;12
14928;Voveraitė;NYKŠTUKŲ;6092848276;Ne;10;0;1;11
14929;Voveraitė;NYKŠTUKŲ;4533816630;Ne;3;0;0;3
14930;Voveraitė;NYKŠTUKŲ;1237440400;Ne;10;2;0;12
14931;Voveraitė;NYKŠTUKŲ;8664568879;Ne;10;4;0;14
14932;Voveraitė;NYKŠTUKŲ;3261542931;Ne;10;8;4;22
14933;Voveraitė;GENIUKŲ;5467979968;Ne;10;3;0;13
14934;Voveraitė;GENIUKŲ;5296850349;Taip;7;0;0;7
14935;Voveraitė;GENIUKŲ;51213803814;Taip;10;1;0;11
14936;Voveraitė;GENIUKŲ;2304004487;Taip;5;0;0;5
14937;Voveraitė;GENIUKŲ;36749754999;Taip;0;4;0;4
14938;Voveraitė;GENIUKŲ;6819742525;Ne;10;0;0;10
14939;Voveraitė;GENIUKŲ;46205148458;Taip;0;1;0;1
14940;Voveraitė;GENIUKŲ;4468214107;Taip;8;0;0;8
14941;Voveraitė;GENIUKŲ;9921313716;Taip;5;1;0;6
14942;Voveraitė;GENIUKŲ;9431523085;Taip;9;0;0;9
14943;Voveraitė;GENIUKŲ;4045121781;Taip;11;1;0;12
14944;Voveraitė;GENIUKŲ;7786378018;Taip;0;3;0;3
14945;Voveraitė;GENIUKŲ;5449490074;Taip;9;2;0;11
14946;Voveraitė;GENIUKŲ;6361417566;Taip;0;2;0;2
14947;Voveraitė;GENIUKŲ;6690309946;Taip;0;1;0;1
14948;Voveraitė;GENIUKŲ;6653141009;Taip;5;0;0;5
14949;Voveraitė;GENIUKŲ;2208396431;Taip;5;0;0;5
14950;Voveraitė;GENIUKŲ;1772758517;Taip;6;4;1;11
14951;Voveraitė;LAPIUKŲ;5104290434;Taip;13;0;9;22
14952;Voveraitė;LAPIUKŲ;8405238812;Taip;10;0;0;10
14953;Voveraitė;LAPIUKŲ;2552772063;Ne;16;1;0;17
14954;Voveraitė;LAPIUKŲ;8152541593;Taip;18;0;0;18
14955;Voveraitė;LAPIUKŲ;4891757467;Taip;0;0;6;6
14956;Voveraitė;LAPIUKŲ;9218074631;Taip;16;0;0;16
14957;Voveraitė;LAPIUKŲ;1921260351;Taip;4;3;7;14
14958;Voveraitė;LAPIUKŲ;9120975451;Taip;3;0;0;3
14959;Voveraitė;LAPIUKŲ;3452040361;Taip;11;0;0;11
14960;Voveraitė;LAPIUKŲ;8382950248;Ne;0;11;0;11
14961;Voveraitė;LAPIUKŲ;8695525951;Taip;13;0;0;13
14962;Voveraitė;LAPIUKŲ;6443288864;Taip;13;1;0;14
14963;Voveraitė;LAPIUKŲ;6650343917;Taip;8;2;0;10
14964;Voveraitė;LAPIUKŲ;8451803815;Taip;8;3;0;11
14965;Voveraitė;EŽIUKŲ;5420123208;Taip;14;0;0;14
14966;Voveraitė;EŽIUKŲ;7969862374;Taip;6;0;3;9
14967;Voveraitė;EŽIUKŲ;1692829228;Taip;17;0;0;17
14968;Voveraitė;EŽIUKŲ;4233627593;Taip;10;0;0;10
14969;Voveraitė;EŽIUKŲ;2446269570;Taip;0;4;6;10
14970;Voveraitė;EŽIUKŲ;2761041681;Taip;15;0;0;15
14971;Voveraitė;EŽIUKŲ;8074808131;Taip;3;0;3;6
14972;Voveraitė;EŽIUKŲ;8675606844;Taip;15;2;0;17
14973;Voveraitė;EŽIUKŲ;8229145014;Ne;9;0;5;14
14974;Voveraitė;EŽIUKŲ;3168493145;Taip;7;0;1;8
14975;Voveraitė;EŽIUKŲ;2118244290;Taip;7;0;0;7
14976;Voveraitė;EŽIUKŲ;3971484538;Taip;8;0;2;10
14977;Voveraitė;EŽIUKŲ;1542869765;Taip;12;0;0;12
14978;Voveraitė;EŽIUKŲ;2755043670;Taip;10;1;0;11
14979;Voveraitė;EŽIUKŲ;3408126903;Taip;12;3;0;15
14980;Voveraitė;EŽIUKŲ;8627692360;Taip;12;0;0;12
14981;Voveraitė;EŽIUKŲ;7776716092;Taip;12;3;0;15
14982;"Trakų Vokė";Voveriukų;1252962923;Taip;19;0;0;19
14983;"Trakų Vokė";Voveriukų;6076083379;Taip;11;0;0;11
14984;"Trakų Vokė";Voveriukų;7656305410;Taip;8;0;0;8
14985;"Trakų Vokė";Voveriukų;5626732539;Taip;0;6;4;10
14986;"Trakų Vokė";Voveriukų;2163756512;Taip;10;0;1;11
14987;"Trakų Vokė";Voveriukų;7706665420;Taip;18;0;0;18
14988;"Trakų Vokė";Voveriukų;7346128036;Taip;0;0;1;1
14989;"Trakų Vokė";Voveriukų;2318712376;Taip;0;0;4;4
14990;"Trakų Vokė";Voveriukų;7671121106;Taip;0;1;16;17
14991;"Trakų Vokė";Voveriukų;9140597911;Taip;0;0;4;4
14992;"Trakų Vokė";Voveriukų;5741852704;Taip;11;0;3;14
14993;"Trakų Vokė";Voveriukų;8636196544;Taip;0;1;1;2
14994;"Trakų Vokė";Voveriukų;1157451579;Taip;22;0;0;22
14995;"Trakų Vokė";Voveriukų;4516714702;Taip;13;0;2;15
14996;"Trakų Vokė";Voveriukų;7797516793;Taip;4;0;4;8
14997;"Trakų Vokė";Voveriukų;3445611475;Taip;15;0;0;15
14998;"Trakų Vokė";Boružėlių;3319243283;Taip;0;0;2;2
14999;"Trakų Vokė";Boružėlių;1039690987;Taip;0;0;1;1
15000;"Trakų Vokė";Boružėlių;2516219363;Taip;0;0;5;5
15001;"Trakų Vokė";Boružėlių;1088928094;Taip;0;0;1;1
15002;"Trakų Vokė";Boružėlių;6908913934;Ne;0;0;8;8
15003;"Trakų Vokė";Boružėlių;7909596435;Ne;9;1;0;10
15004;"Trakų Vokė";Boružėlių;6751625456;Ne;5;0;1;6
15005;"Trakų Vokė";Boružėlių;7752786907;Ne;16;0;0;16
15006;"Trakų Vokė";Boružėlių;2475068032;Ne;0;0;6;6
15007;"Trakų Vokė";Boružėlių;4601374629;Ne;1;3;0;4
15008;"Trakų Vokė";Boružėlių;4438127190;Ne;0;0;5;5
15009;"Trakų Vokė";Boružėlių;9453317084;Taip;0;0;4;4
15010;"Trakų Vokė";Boružėlių;1080300137;Ne;5;0;0;5
15011;"Trakų Vokė";Boružėlių;2469340933;Ne;0;0;1;1
15012;"Trakų Vokė";Boružėlių;6732422645;Ne;0;3;0;3
15013;"Trakų Vokė";Boružėlių;5338798362;Ne;0;0;2;2
15014;"Trakų Vokė";Boružėlių;3913623741;Taip;0;0;4;4
15015;"Trakų Vokė";Boružėlių;4014027030;Taip;0;0;8;8
15016;"Trakų Vokė";Boružėlių;7660240598;Ne;0;16;0;16
15017;"Trakų Vokė";KIŠKUČIŲ;9094930495;Taip;9;0;1;10
15018;"Trakų Vokė";KIŠKUČIŲ;9483709021;Taip;4;0;0;4
15019;"Trakų Vokė";KIŠKUČIŲ;2503382218;Ne;3;0;0;3
15020;"Trakų Vokė";KIŠKUČIŲ;8605461082;Taip;8;1;1;10
15021;"Trakų Vokė";KIŠKUČIŲ;6369848950;Ne;18;0;6;24
15022;"Trakų Vokė";KIŠKUČIŲ;4854440884;Ne;4;0;3;7
15023;"Trakų Vokė";KIŠKUČIŲ;2761614687;Ne;4;0;3;7
15024;"Trakų Vokė";KIŠKUČIŲ;9233090228;Taip;10;0;2;12
15025;"Trakų Vokė";KIŠKUČIŲ;2880299812;Taip;10;0;2;12
15026;"Trakų Vokė";KIŠKUČIŲ;1360046096;Taip;0;5;1;6
15027;"Trakų Vokė";KIŠKUČIŲ;3611639112;Taip;6;1;2;9
15028;"Trakų Vokė";KIŠKUČIŲ;3328527700;Taip;3;1;0;4
15029;"Trakų Vokė";KIŠKUČIŲ;5206616285;Taip;8;0;0;8
15030;"Trakų Vokė";KIŠKUČIŲ;2869217654;Taip;11;3;0;14
15031;"Trakų Vokė";KIŠKUČIŲ;4535167417;Taip;7;4;0;11
15032;"Trakų Vokė";KIŠKUČIŲ;6326568445;Taip;4;3;0;7
15033;"Trakų Vokė";KIŠKUČIŲ;3278842582;Ne;7;0;0;7
15034;"Trakų Vokė";KIŠKUČIŲ;8874384610;Taip;8;0;1;9
15035;"Trakų Vokė";KIŠKUČIŲ;2453791555;Ne;22;0;0;22
15036;"Trakų Vokė";KIŠKUČIŲ;9506008651;Taip;10;0;1;11
15037;"Trakų Vokė";BITUČIŲ;7632198751;Ne;13;0;2;15
15038;"Trakų Vokė";BITUČIŲ;3686108421;Taip;11;0;0;11
15039;"Trakų Vokė";BITUČIŲ;3333979364;Taip;5;1;0;6
15040;"Trakų Vokė";BITUČIŲ;5810595458;Taip;0;1;0;1
15041;"Trakų Vokė";BITUČIŲ;8783922678;Ne;0;1;0;1
15042;"Trakų Vokė";BITUČIŲ;5031669549;Taip;14;0;0;14
15043;"Trakų Vokė";BITUČIŲ;8703806519;Taip;0;22;0;22
15044;"Trakų Vokė";BITUČIŲ;4531294784;Taip;4;1;1;6
15045;"Trakų Vokė";BITUČIŲ;2133793458;Taip;0;5;2;7
15046;"Trakų Vokė";BITUČIŲ;3023545645;Taip;17;0;0;17
15047;"Trakų Vokė";BITUČIŲ;5720994041;Taip;15;1;0;16
15048;"Trakų Vokė";BITUČIŲ;6428645462;Taip;0;2;1;3
15049;"Trakų Vokė";BITUČIŲ;7459132887;Taip;14;3;0;17
15050;"Trakų Vokė";BITUČIŲ;1808420447;Taip;0;3;0;3
15051;"Trakų Vokė";BITUČIŲ;6402002961;Taip;5;1;0;6
15052;"Trakų Vokė";BITUČIŲ;3536227018;Taip;16;0;0;16
15053;"Trakų Vokė";BITUČIŲ;6787506848;Taip;0;1;0;1
15054;"Trakų Vokė";BITUČIŲ;3372734352;Taip;3;0;0;3
15055;"Trakų Vokė";BITUČIŲ;1000323267;Taip;0;1;0;1
15056;"Trakų Vokė";BITUČIŲ;1359519176;Taip;0;2;3;5
15057;"Trakų Vokė";BITUČIŲ;1039317931;Taip;13;0;4;17
15058;Zylutė;Katerok;8749296671;Taip;0;2;2;4
15059;Zylutė;Katerok;4592825972;Taip;7;2;0;9
15060;Zylutė;Katerok;8747721198;Taip;20;0;0;20
15061;Zylutė;Katerok;8212030518;Taip;19;1;0;20
15062;Zylutė;Katerok;7706833089;Taip;0;13;7;20
15063;Zylutė;Katerok;3115223229;Ne;0;0;3;3
15064;Zylutė;Katerok;2968625045;Ne;0;0;3;3
15065;Zylutė;Katerok;1897871944;Ne;8;2;0;10
15066;Zylutė;Katerok;5687201052;Ne;0;0;1;1
15067;Zylutė;Katerok;3055559237;Taip;0;0;2;2
15068;Zylutė;Katerok;2792217953;Taip;4;0;0;4
15069;Zylutė;Katerok;5948147748;Ne;0;0;3;3
15070;Zylutė;Katerok;7851423851;Taip;6;1;3;10
15071;Zylutė;Katerok;2945894661;Taip;12;0;2;14
15072;Zylutė;Katerok;9986289837;Taip;11;0;0;11
15073;Zylutė;Katerok;1164530815;Taip;0;0;2;2
15074;Zylutė;Katerok;1423890598;Ne;5;0;1;6
15075;Zylutė;Katerok;2558354198;Taip;4;3;0;7
15076;Zylutė;Katerok;8618778936;Taip;6;3;0;9
15077;Zylutė;"Vesole misiaki";3332865242;Taip;0;3;0;3
15078;Zylutė;"Vesole misiaki";9162232979;Taip;7;0;0;7
15079;Zylutė;"Vesole misiaki";9457457032;Taip;12;1;0;13
15080;Zylutė;"Vesole misiaki";4543822765;Taip;22;0;0;22
15081;Zylutė;"Vesole misiaki";4566817285;Taip;12;0;0;12
15082;Zylutė;"Vesole misiaki";9737308076;Taip;7;4;0;11
15083;Zylutė;"Vesole misiaki";2999425729;Taip;14;2;0;16
15084;Zylutė;"Vesole misiaki";1290248125;Ne;6;3;0;9
15085;Zylutė;"Vesole misiaki";5027134228;Taip;12;8;0;20
15086;Zylutė;"Vesole misiaki";5589330186;Taip;22;0;0;22
15087;Zylutė;"Vesole misiaki";3848401615;Taip;0;3;2;5
15088;Zylutė;"Vesole misiaki";2913504349;Taip;0;10;0;10
15089;Zylutė;"Vesole misiaki";6601967273;Taip;10;2;1;13
15090;Zylutė;"Vesole misiaki";2501761963;Taip;6;3;0;9
15091;Zylutė;"Vesole misiaki";6833822248;Taip;18;0;0;18
15092;Zylutė;"Vesole misiaki";3976277394;Ne;0;10;0;10
15093;Zylutė;"Vesole misiaki";2489898107;Taip;22;0;0;22
15094;Zylutė;"Vesole misiaki";2313423907;Taip;14;4;0;18
15095;Zylutė;NYKŠTUKAI;3371202491;Ne;7;4;0;11
15096;Zylutė;NYKŠTUKAI;8820121776;Taip;9;1;0;10
15097;Zylutė;NYKŠTUKAI;4611555689;Taip;3;9;0;12
15098;Zylutė;NYKŠTUKAI;1169490002;Taip;9;4;0;13
15099;Zylutė;NYKŠTUKAI;3994691080;Taip;6;7;0;13
15100;Zylutė;NYKŠTUKAI;4894611078;Taip;7;3;0;10
15101;Zylutė;NYKŠTUKAI;7648922403;Ne;6;0;0;6
15102;Zylutė;NYKŠTUKAI;2113594059;Taip;10;1;0;11
15103;Zylutė;NYKŠTUKAI;9615779237;Taip;4;5;0;9
15104;Zylutė;NYKŠTUKAI;2604844156;Taip;0;16;0;16
15105;Zylutė;NYKŠTUKAI;2511658462;Ne;9;0;0;9
15106;Zylutė;NYKŠTUKAI;3035745273;Taip;17;0;0;17
15107;Zylutė;NYKŠTUKAI;2620903587;Ne;8;14;0;22
15108;Zylutė;Ručijok;5096881585;Ne;14;3;1;18
15109;Zylutė;Ručijok;3201966434;Taip;0;0;1;1
15110;Zylutė;Ručijok;9904758615;Taip;16;0;0;16
15111;Zylutė;Ručijok;4874246039;Taip;14;1;0;15
15112;Zylutė;Ručijok;6607670962;Taip;22;0;0;22
15113;Zylutė;Ručijok;1145229045;Taip;14;0;1;15
15114;Zylutė;Ručijok;3058040516;Taip;6;0;0;6
15115;Zylutė;Ručijok;2916622808;Taip;20;0;0;20
15116;Zylutė;Ručijok;5038936878;Taip;15;0;3;18
15117;Zylutė;Ručijok;2491905840;Ne;28;0;0;28
15118;Zylutė;Ručijok;7742044835;Ne;0;19;0;19
15119;Zylutė;Ručijok;5956114459;Taip;14;3;0;17
15120;Zylutė;Ručijok;6276017610;Taip;7;4;0;11
15121;Zylutė;Ručijok;3128535871;Taip;21;0;0;21
15122;Zylutė;Raduga;9325387975;Taip;7;0;5;12
15123;Zylutė;Raduga;6569135467;Taip;9;0;0;9
15124;Zylutė;Raduga;3117948118;Taip;9;0;9;18
15125;Zylutė;Raduga;3943002728;Taip;0;2;0;2
15126;Zylutė;Raduga;4043810535;Ne;0;3;3;6
15127;Zylutė;Raduga;2107123106;Ne;18;1;0;19
15128;Zylutė;Raduga;7482740111;Taip;4;0;0;4
15129;Zylutė;Raduga;7824348276;Taip;3;1;0;4
15130;Zylutė;Raduga;4811667497;Ne;23;4;0;27
15131;Zylutė;Raduga;2681013154;Taip;18;0;0;18
15132;Zylutė;Raduga;6391999153;Taip;14;0;1;15
15133;Zylutė;Raduga;4493469560;Taip;19;0;3;22
15134;Zylutė;Raduga;3608920051;Taip;9;3;0;12
15135;Zylutė;Raduga;3059970035;Taip;13;4;0;17
15136;Zylutė;Raduga;5408157164;Taip;0;0;16;16
15137;Zylutė;Raduga;3780475392;Taip;27;3;0;30
15138;Zylutė;"Miki Maus";9159342804;Taip;0;14;0;14
15139;Zylutė;"Miki Maus";8023418946;Ne;10;3;0;13
15140;Zylutė;"Miki Maus";5369354390;Ne;0;17;0;17
15141;Zylutė;"Miki Maus";8101232865;Taip;6;0;1;7
15142;Zylutė;"Miki Maus";9018673580;Taip;12;0;0;12
15143;Zylutė;"Miki Maus";7762245887;Taip;10;0;0;10
15144;Zylutė;"Miki Maus";9213491152;Taip;12;0;0;12
15145;Zylutė;"Miki Maus";3928932787;Taip;8;1;0;9
15146;Zylutė;"Miki Maus";4057419108;Ne;0;13;0;13
15147;Zylutė;"Miki Maus";3668160578;Taip;10;2;0;12
15148;Zylutė;"Miki Maus";9093777086;Taip;1;4;0;5
15149;Zylutė;"Miki Maus";7123399601;Ne;15;4;0;19
15150;Zylutė;"Miki Maus";5975875502;Ne;9;1;0;10
15151;Zylutė;Solnyško;8379932761;Taip;13;1;0;14
15152;Zylutė;Solnyško;5556769710;Taip;0;3;3;6
15153;Zylutė;Solnyško;2088316489;Taip;0;8;0;8
15154;Zylutė;Solnyško;1076803315;Taip;10;0;2;12
15155;Zylutė;Solnyško;7616444695;Ne;19;0;0;19
15156;Zylutė;Solnyško;5939522435;Taip;0;11;0;11
15157;Zylutė;Solnyško;2117820453;Taip;5;0;0;5
15158;Zylutė;Solnyško;3111739911;Ne;0;0;2;2
15159;Zylutė;Solnyško;5826813410;Taip;0;9;0;9
15160;Zylutė;Solnyško;7447067072;Taip;18;0;0;18
15161;Zylutė;Solnyško;1386683435;Taip;18;0;0;18
15162;Zylutė;Solnyško;4669449744;Taip;3;0;0;3
15163;Zylutė;Solnyško;4478652694;Ne;0;5;0;5
15164;Zylutė;Solnyško;1969578486;Taip;0;0;2;2
15165;Zylutė;Solnyško;6573541087;Taip;15;0;0;15
15166;Zylutė;Solnyško;2520744071;Taip;10;0;1;11
15167;Zylutė;Solnyško;3894885445;Taip;0;0;5;5
15168;Zylutė;Motyliok;7241045507;Ne;12;0;2;14
15169;Zylutė;Motyliok;9913001904;Ne;20;3;1;24
15170;Zylutė;Motyliok;5891900062;Taip;11;5;0;16
15171;Zylutė;Motyliok;8178488164;Taip;5;3;0;8
15172;Zylutė;Motyliok;3547185618;Taip;0;3;2;5
15173;Zylutė;Motyliok;5045652581;Taip;6;10;0;16
15174;Zylutė;Motyliok;9586800176;Taip;6;0;0;6
15175;Zylutė;Motyliok;4497904128;Taip;5;7;0;12
15176;Zylutė;Motyliok;3355159275;Taip;19;3;0;22
15177;Zylutė;Motyliok;9995791665;Ne;0;18;0;18
15178;Zylutė;Motyliok;1455822427;Taip;9;0;0;9
15179;Zylutė;Motyliok;2654373943;Ne;16;0;0;16
15180;Zylutė;Motyliok;3455374127;Taip;12;0;0;12
15181;Zylutė;Motyliok;1632490481;Taip;12;3;0;15
15182;Zylutė;Motyliok;1726060015;Ne;7;0;2;9
15183;Zylutė;Motyliok;3084870481;Taip;0;0;4;4
15184;Zylutė;Motyliok;6051657134;Taip;14;3;0;17
15185;Zylutė;Motyliok;3271366684;Taip;13;0;1;14
15186;Zylutė;Motyliok;3633983359;Taip;14;3;0;17
15187;Zylutė;Motyliok;9155513221;Ne;0;3;1;4
15188;Zylutė;ŽVIRBLIUKAI;6282501549;Taip;0;0;6;6
15189;Zylutė;ŽVIRBLIUKAI;1319040747;Ne;9;1;4;14
15190;Zylutė;ŽVIRBLIUKAI;4394023057;Taip;8;0;1;9
15191;Zylutė;ŽVIRBLIUKAI;8326987895;Taip;0;1;4;5
15192;Zylutė;ŽVIRBLIUKAI;9330583784;Taip;10;0;2;12
15193;Zylutė;ŽVIRBLIUKAI;9150157724;Ne;5;0;0;5
15194;Zylutė;ŽVIRBLIUKAI;8268700439;Taip;0;3;18;21
15195;Zylutė;ŽVIRBLIUKAI;1220439948;Taip;8;10;0;18
15196;Zylutė;ŽVIRBLIUKAI;4646273830;Ne;14;0;0;14
15197;Zylutė;ŽVIRBLIUKAI;9580188426;Ne;7;0;0;7
15198;Zylutė;ŽVIRBLIUKAI;1797701777;Taip;10;1;0;11
15199;Zylutė;ŽVIRBLIUKAI;2966482773;Ne;13;3;0;16
15200;Zylutė;ŽVIRBLIUKAI;1452384017;Taip;4;0;0;4
15201;Zylutė;ŽVIRBLIUKAI;2697867000;Ne;8;3;3;14
15202;Zylutė;ŽVIRBLIUKAI;8262929231;Ne;5;2;0;7
15203;Zylutė;ŽVIRBLIUKAI;8152140523;Taip;15;0;0;15
15204;Zylutė;ŽVIRBLIUKAI;8346794629;Taip;9;0;0;9
15205;Zylutė;ŽVIRBLIUKAI;2061747513;Ne;15;0;0;15
15206;Zylutė;"DRUŽNYJE REBIATA";5332039406;Ne;22;0;0;22
15207;Zylutė;"DRUŽNYJE REBIATA";9039665233;Taip;14;0;0;14
15208;Zylutė;"DRUŽNYJE REBIATA";6075614020;Taip;18;2;0;20
15209;Zylutė;"DRUŽNYJE REBIATA";9518714240;Taip;0;7;4;11
15210;Zylutė;"DRUŽNYJE REBIATA";2693961315;Taip;8;0;1;9
15211;Zylutė;"DRUŽNYJE REBIATA";3372639449;Ne;15;0;0;15
15212;Zylutė;"DRUŽNYJE REBIATA";4916625058;Taip;9;1;0;10
15213;Zylutė;"DRUŽNYJE REBIATA";3447644735;Taip;16;4;0;20
15214;Zylutė;"DRUŽNYJE REBIATA";3174042441;Taip;9;3;0;12
15215;Zylutė;"DRUŽNYJE REBIATA";6848387941;Ne;18;0;0;18
15216;Zylutė;"DRUŽNYJE REBIATA";1404949829;Taip;6;1;0;7
15217;Zylutė;"DRUŽNYJE REBIATA";4548205666;Taip;5;2;0;7
15218;Zylutė;"DRUŽNYJE REBIATA";6962852787;Taip;5;2;0;7
15219;Zylutė;"DRUŽNYJE REBIATA";9220918504;Taip;5;2;0;7
15220;Zylutė;"DRUŽNYJE REBIATA";9193349264;Taip;21;0;0;21
15221;Zylutė;"DRUŽNYJE REBIATA";2444440430;Taip;5;0;0;5
15222;Zylutė;"DRUŽNYJE REBIATA";8204885376;Taip;9;3;0;12
15223;Zylutė;"DRUŽNYJE REBIATA";8130859512;Taip;9;0;0;9
15224;Zylutė;"DRUŽNYJE REBIATA";6281989117;Taip;24;0;0;24
15225;Zylutė;"DRUŽNYJE REBIATA";9769201088;Ne;10;8;0;18
15226;Zylutė;"DRUŽNYJE REBIATA";5233163416;Taip;7;4;0;11
15227;Zylutė;"DRUŽNYJE REBIATA";6784471792;Taip;7;4;0;11
15228;Zylutė;"DRUŽNYJE REBIATA";5126282685;Taip;14;3;0;17
15229;Zylutė;VIEVERSĖLIAI;2125519672;Taip;0;7;0;7
15230;Zylutė;VIEVERSĖLIAI;4505081448;Ne;11;0;0;11
15231;Zylutė;VIEVERSĖLIAI;72716975865;Taip;9;0;0;9
15232;Zylutė;VIEVERSĖLIAI;6275164528;Taip;13;1;0;14
15233;Zylutė;VIEVERSĖLIAI;5172154642;Taip;0;9;0;9
15234;Zylutė;VIEVERSĖLIAI;2943888466;Taip;8;11;0;19
15235;Zylutė;VIEVERSĖLIAI;6907378757;Ne;3;0;0;3
15236;Zylutė;VIEVERSĖLIAI;4016518230;Taip;8;4;0;12
15237;Zylutė;VIEVERSĖLIAI;9660898505;Taip;7;8;0;15
15238;Zylutė;VIEVERSĖLIAI;5544338521;Taip;6;3;0;9
15239;Zylutė;VIEVERSĖLIAI;3246229837;Taip;8;0;0;8
15240;Zylutė;VIEVERSĖLIAI;27488840113;Taip;2;3;0;5
15241;Zylutė;VIEVERSĖLIAI;5162635301;Taip;22;0;0;22
15242;Zylutė;VIEVERSĖLIAI;1939618217;Taip;0;1;0;1
15243;Zylutė;VIEVERSĖLIAI;20569748356;Taip;0;2;0;2
15244;Zylutė;VIEVERSĖLIAI;1048279422;Taip;0;10;0;10
15245;Zylutė;VIEVERSĖLIAI;3919565034;Taip;0;8;0;8
15246;Zylutė;VIEVERSĖLIAI;6548786007;Ne;7;4;0;11
15247;Zylutė;VIEVERSĖLIAI;3074954453;Taip;2;1;0;3
15248;Zylutė;VIEVERSĖLIAI;2364890732;Taip;4;1;0;5
15249;Želmenėliai;Bitučių;3268310531;Taip;9;2;0;11
15250;Želmenėliai;Bitučių;2122665619;Taip;12;5;2;19
15251;Želmenėliai;Bitučių;2563117992;Taip;0;1;0;1
15252;Želmenėliai;Bitučių;6799702725;Taip;0;3;0;3
15253;Želmenėliai;Bitučių;8358780570;Taip;4;1;0;5
15254;Želmenėliai;Bitučių;9006406225;Taip;0;5;2;7
15255;Želmenėliai;Bitučių;2102401372;Taip;4;3;0;7
15256;Želmenėliai;Bitučių;4931835807;Taip;3;0;0;3
15257;Želmenėliai;Bitučių;5147895081;Taip;0;4;0;4
15258;Želmenėliai;Bitučių;6481952132;Taip;8;1;0;9
15259;Želmenėliai;Bitučių;9611741258;Taip;3;1;0;4
15260;Želmenėliai;Bitučių;1619143702;Taip;7;0;0;7
15261;Želmenėliai;Bitučių;9825545754;Taip;9;1;0;10
15262;Želmenėliai;Bitučių;5314438217;Taip;9;4;0;13
15263;Želmenėliai;Bitučių;4927030144;Taip;0;4;6;10
15264;Želmenėliai;Bitučių;3739751121;Taip;12;3;0;15
15265;Želmenėliai;Bitučių;2853659708;Taip;0;8;0;8
15266;Želmenėliai;Bitučių;9207984505;Taip;0;9;0;9
15267;Želmenėliai;Kačiukų;1292462938;Taip;7;0;0;7
15268;Želmenėliai;Kačiukų;2350936740;Ne;24;0;0;24
15269;Želmenėliai;Kačiukų;3063417708;Ne;22;0;0;22
15270;Želmenėliai;Kačiukų;2570248893;Taip;9;0;0;9
15271;Želmenėliai;Kačiukų;2577850672;Taip;12;0;0;12
15272;Želmenėliai;Kačiukų;7197717698;Taip;26;0;0;26
15273;Želmenėliai;Kačiukų;7849682820;Taip;9;8;0;17
15274;Želmenėliai;Kačiukų;2111008869;Taip;0;3;3;6
15275;Želmenėliai;Kačiukų;4589396143;Taip;8;0;0;8
15276;Želmenėliai;Kačiukų;4198085732;Taip;20;0;0;20
15277;Želmenėliai;Kačiukų;6509783586;Taip;15;1;0;16
15278;Želmenėliai;Kačiukų;4126499046;Taip;9;2;0;11
15279;Želmenėliai;Kačiukų;4758240577;Taip;4;1;0;5
15280;Želmenėliai;Kačiukų;7094853897;Taip;12;0;0;12
15281;Želmenėliai;Kačiukų;9493581034;Taip;15;5;0;20
15282;Želmenėliai;Kačiukų;4931664953;Taip;25;0;0;25
15283;Želmenėliai;Kačiukų;4376978921;Taip;15;3;0;18
15284;Želmenėliai;Kačiukų;9313666706;Taip;7;1;0;8
15285;Želmenėliai;Kačiukų;8590129703;Taip;1;0;5;6
15286;Želmenėliai;Kačiukų;3959066963;Taip;4;1;1;6
15287;Želmenėliai;Kačiukų;6761848439;Taip;11;0;0;11
15288;Želmenėliai;Voveriukų;6343814445;Taip;0;7;0;7
15289;Želmenėliai;Voveriukų;7833143421;Taip;1;1;2;4
15290;Želmenėliai;Voveriukų;8418427863;Taip;6;0;0;6
15291;Želmenėliai;Voveriukų;5360157217;Taip;22;0;0;22
15292;Želmenėliai;Voveriukų;2545133678;Ne;0;1;0;1
15293;Želmenėliai;Voveriukų;7423900312;Taip;10;16;0;26
15294;Želmenėliai;Voveriukų;2025424742;Taip;9;0;0;9
15295;Želmenėliai;Voveriukų;2924134152;Taip;20;0;0;20
15296;Želmenėliai;Voveriukų;6857922902;Ne;19;0;0;19
15297;Želmenėliai;Voveriukų;9811131936;Taip;10;0;0;10
15298;Želmenėliai;Voveriukų;8968533318;Taip;0;11;0;11
15299;Želmenėliai;Voveriukų;6264955603;Taip;0;10;0;10
15300;Želmenėliai;Voveriukų;8952421941;Taip;20;1;0;21
15301;Želmenėliai;Voveriukų;7345540758;Taip;15;0;0;15
15302;Želmenėliai;Voveriukų;9709599805;Taip;19;1;0;20
15303;Želmenėliai;Voveriukų;4248374729;Taip;0;11;0;11
15304;Želmenėliai;Ežiukų;1652131150;Taip;0;1;0;1
15305;Želmenėliai;Ežiukų;5795735579;Taip;3;2;0;5
15306;Želmenėliai;Ežiukų;3572462731;Taip;12;2;0;14
15307;Želmenėliai;Ežiukų;3353793939;Taip;9;1;0;10
15308;Želmenėliai;Ežiukų;7495157523;Taip;7;1;0;8
15309;Želmenėliai;Ežiukų;3972980949;Taip;12;6;0;18
15310;Želmenėliai;Ežiukų;6779746783;Taip;13;0;0;13
15311;Želmenėliai;Ežiukų;6876147546;Ne;9;8;0;17
15312;Želmenėliai;Ežiukų;9126715074;Ne;14;7;0;21
15313;Želmenėliai;Ežiukų;1260607572;Taip;3;1;0;4
15314;Želmenėliai;Ežiukų;5638248652;Taip;12;0;0;12
15315;Želmenėliai;Ežiukų;8154713582;Taip;23;3;0;26
15316;Želmenėliai;Ežiukų;2296870749;Taip;9;1;1;11
15317;Želmenėliai;Ežiukų;6180553648;Taip;10;4;0;14
15318;Želmenėliai;Ežiukų;5171736943;Taip;2;3;0;5
15319;Želmenėliai;Ežiukų;7294722095;Taip;18;5;0;23
15320;Želmenėliai;Ežiukų;4120125150;Taip;10;4;0;14
15321;Želmenėliai;Ežiukų;5281861477;Taip;17;0;0;17
15322;Želmenėliai;Ežiukų;8987377791;Taip;15;3;0;18
15323;Želmenėliai;Ežiukų;7373892344;Taip;22;0;0;22
15324;Želmenėliai;Peledžiukų;8491797555;Ne;12;8;0;20
15325;Želmenėliai;Peledžiukų;7058759730;Ne;9;4;0;13
15326;Želmenėliai;Peledžiukų;3869372021;Taip;5;0;0;5
15327;Želmenėliai;Peledžiukų;4374898642;Taip;7;1;0;8
15328;Želmenėliai;Peledžiukų;7751609462;Taip;4;0;0;4
15329;Želmenėliai;Peledžiukų;5929410363;Taip;5;12;0;17
15330;Želmenėliai;Peledžiukų;5205425589;Taip;0;3;0;3
15331;Želmenėliai;Peledžiukų;5362390260;Taip;0;4;0;4
15332;Želmenėliai;Peledžiukų;1580370689;Taip;0;1;0;1
15333;Želmenėliai;Peledžiukų;7672980212;Taip;0;6;0;6
15334;Želmenėliai;Peledžiukų;6260153299;Taip;14;2;0;16
15335;Želmenėliai;Peledžiukų;6187661667;Taip;23;0;0;23
15336;Želmenėliai;Peledžiukų;6109546917;Ne;0;9;0;9
15337;Želmenėliai;Peledžiukų;4746898209;Taip;0;6;0;6
15338;Želmenėliai;Peledžiukų;9929149682;Ne;8;6;0;14
15339;Želmenėliai;Peledžiukų;3723155757;Taip;12;4;0;16
15340;Želmenėliai;Peledžiukų;6662439747;Taip;9;1;0;10
15341;Želmenėliai;Drugelių;7664430346;Taip;0;7;0;7
15342;Želmenėliai;Drugelių;3417538909;Taip;0;5;0;5
15343;Želmenėliai;Drugelių;3295852546;Taip;3;10;0;13
15344;Želmenėliai;Drugelių;3379266015;Ne;0;12;0;12
15345;Želmenėliai;Drugelių;1984105453;Taip;24;2;0;26
15346;Želmenėliai;Drugelių;4652412483;Taip;0;16;0;16
15347;Želmenėliai;Drugelių;1652949383;Taip;0;4;0;4
15348;Želmenėliai;Drugelių;5046836398;Taip;23;0;0;23
15349;Želmenėliai;Drugelių;9237611484;Taip;0;4;0;4
15350;Želmenėliai;Drugelių;13558387807;Taip;0;2;0;2
15351;Želmenėliai;Drugelių;5143554665;Taip;6;5;0;11
15352;Želmenėliai;Drugelių;7585159351;Taip;6;8;0;14
15353;Želmenėliai;Drugelių;4634346755;Taip;5;4;0;9
15354;Želmenėliai;Drugelių;4916436238;Taip;8;8;0;16
15355;Želmenėliai;Drugelių;5558795651;Taip;13;6;0;19
15356;Želmenėliai;Drugelių;8504963337;Taip;0;1;0;1
15357;Želmenėliai;Drugelių;7572597061;Taip;6;2;0;8
15358;Želmenėliai;Voriukų;4264751761;Taip;0;12;0;12
15359;Želmenėliai;Voriukų;1203343580;Taip;6;9;0;15
15360;Želmenėliai;Voriukų;9351650342;Ne;13;5;0;18
15361;Želmenėliai;Voriukų;6916426436;Taip;9;0;0;9
15362;Želmenėliai;Voriukų;7563461821;Taip;8;13;0;21
15363;Želmenėliai;Voriukų;4534946646;Taip;0;7;0;7
15364;Želmenėliai;Voriukų;4075533071;Taip;0;4;0;4
15365;Želmenėliai;Voriukų;4545012342;Taip;15;8;0;23
15366;Želmenėliai;Voriukų;7505996978;Taip;6;10;0;16
15367;Želmenėliai;Voriukų;2722619508;Taip;0;3;0;3
15368;Želmenėliai;Voriukų;5025345647;Taip;0;2;0;2
15369;Želmenėliai;Voriukų;8892137326;Taip;6;15;0;21
15370;Želmenėliai;Voriukų;7700521261;Taip;3;5;0;8
15371;Želmenėliai;Voriukų;1649724696;Ne;10;2;0;12
15372;Želmenėliai;Voriukų;5794346039;Taip;15;0;0;15
15373;Želmenėliai;Voriukų;8273301992;Taip;26;0;0;26
15374;Želmenėliai;Voriukų;8206979332;Taip;0;6;0;6
15375;Želmenėliai;Boružėlių;7792850272;Taip;20;0;0;20
15376;Želmenėliai;Boružėlių;1764468979;Taip;6;1;0;7
15377;Želmenėliai;Boružėlių;5161934903;Taip;0;15;0;15
15378;Želmenėliai;Boružėlių;8722573513;Taip;6;5;0;11
15379;Želmenėliai;Boružėlių;3516695805;Taip;19;11;0;30
15380;Želmenėliai;Boružėlių;5949535657;Taip;7;1;0;8
15381;Želmenėliai;Boružėlių;2262009049;Taip;8;3;0;11
15382;Želmenėliai;Boružėlių;7077832687;Taip;5;15;0;20
15383;Želmenėliai;Boružėlių;3896171121;Ne;0;22;0;22
15384;Želmenėliai;Boružėlių;2951719129;Taip;13;6;0;19
15385;Želmenėliai;Boružėlių;2066439950;Taip;10;1;0;11
15386;Želmenėliai;Boružėlių;5207899503;Taip;10;18;0;28
15387;Želmenėliai;Boružėlių;2111705047;Taip;11;6;0;17
15388;Želmenėliai;Boružėlių;5514167627;Taip;14;4;0;18
15389;Želmenėliai;Boružėlių;8474210476;Taip;16;0;0;16
15390;Želmenėliai;Boružėlių;2179165096;Ne;22;10;0;32
15391;Želmenėliai;Pūkuotukų;3258904017;Taip;6;3;0;9
15392;Želmenėliai;Pūkuotukų;8667865301;Taip;6;4;0;10
15393;Želmenėliai;Pūkuotukų;1952686295;Taip;17;1;0;18
15394;Želmenėliai;Pūkuotukų;5787772212;Taip;10;2;0;12
15395;Želmenėliai;Pūkuotukų;2727113833;Taip;14;1;0;15
15396;Želmenėliai;Pūkuotukų;6816346946;Taip;0;12;0;12
15397;Želmenėliai;Pūkuotukų;37152467004;Taip;0;5;0;5
15398;Želmenėliai;Pūkuotukų;5842563754;Taip;0;3;0;3
15399;Želmenėliai;Pūkuotukų;1941723687;Taip;4;4;0;8
15400;Želmenėliai;Pūkuotukų;1239398642;Taip;0;5;0;5
15401;Želmenėliai;Pūkuotukų;5616709457;Taip;15;5;0;20
15402;Želmenėliai;Pūkuotukų;4206128805;Taip;13;0;0;13
15403;Želmenėliai;Pūkuotukų;1248541555;Taip;0;4;0;4
15404;Želmenėliai;Pūkuotukų;8300887366;Taip;8;6;0;14
15405;Želmenėliai;Pūkuotukų;7099039424;Taip;0;2;1;3
15406;Želmenėliai;Pūkuotukų;1582618217;Taip;0;5;0;5
15407;Želmenėliai;Ančiukų;4979494010;Taip;13;2;1;16
15408;Želmenėliai;Ančiukų;7925266303;Taip;5;5;1;11
15409;Želmenėliai;Ančiukų;2578675950;Taip;21;0;1;22
15410;Želmenėliai;Ančiukų;8060048377;Taip;27;1;0;28
15411;Želmenėliai;Ančiukų;1606079948;Taip;19;4;0;23
15412;Želmenėliai;Ančiukų;9250666159;Taip;28;0;0;28
15413;Želmenėliai;Ančiukų;5569699398;Taip;28;0;0;28
15414;Želmenėliai;Ančiukų;3926238501;Taip;10;8;0;18
15415;Želmenėliai;Ančiukų;4207070475;Taip;12;0;0;12
15416;Želmenėliai;Ančiukų;8409831053;Taip;27;1;0;28
15417;Želmenėliai;Ančiukų;3608041516;Taip;0;4;4;8
15418;Želmenėliai;Ančiukų;5454656514;Taip;5;4;0;9
15419;Želmenėliai;Ančiukų;8165683014;Taip;21;5;0;26
15420;Želmenėliai;Ančiukų;3172645969;Taip;28;0;0;28
15421;Želmenėliai;Ančiukų;7128213908;Taip;8;12;0;20
15422;Želmenėliai;Nykštukų;6230010537;Taip;13;1;0;14
15423;Želmenėliai;Nykštukų;4722890143;Taip;5;0;0;5
15424;Želmenėliai;Nykštukų;5052052744;Taip;24;0;0;24
15425;Želmenėliai;Nykštukų;6764567873;Taip;0;14;0;14
15426;Želmenėliai;Nykštukų;9901320882;Taip;6;0;0;6
15427;Želmenėliai;Nykštukų;4526936339;Taip;15;0;0;15
15428;Želmenėliai;Nykštukų;8276857357;Taip;10;0;0;10
15429;Želmenėliai;Nykštukų;3232996198;Taip;7;0;0;7
15430;Želmenėliai;Nykštukų;2878494111;Taip;9;1;0;10
15431;Želmenėliai;Nykštukų;5169813205;Taip;25;0;0;25
15432;Želmenėliai;Nykštukų;7341132501;Taip;13;1;0;14
15433;Želmenėliai;Nykštukų;9661692350;Ne;22;0;0;22
15434;Želmenėliai;Nykštukų;3003922213;Taip;17;0;0;17
15435;Želmenėliai;Nykštukų;7123290599;Taip;10;0;0;10
15436;Želmenėliai;Lašelių;8654298177;Taip;9;2;0;11
15437;Želmenėliai;Lašelių;4451798870;Taip;10;0;0;10
15438;Želmenėliai;Lašelių;4485851428;Taip;10;1;0;11
15439;Želmenėliai;Lašelių;3558547171;Taip;9;0;0;9
15440;Želmenėliai;Lašelių;4930868989;Taip;8;1;0;9
15441;Želmenėliai;Lašelių;2501163903;Taip;17;2;0;19
15442;Želmenėliai;Lašelių;9076874685;Taip;7;1;0;8
15443;Želmenėliai;Lašelių;3346680108;Taip;8;9;0;17
15444;Želmenėliai;Lašelių;4679930998;Taip;28;0;0;28
15445;Želmenėliai;Lašelių;3344426717;Taip;17;1;0;18
15446;Želmenėliai;Lašelių;9483665065;Taip;11;0;0;11
15447;Želmenėliai;Lašelių;1426080041;Taip;7;0;0;7
15448;Želmenėliai;Lašelių;9182208354;Taip;7;1;0;8
15449;Želmenėliai;Lašelių;8104790589;Taip;13;1;0;14
15450;Želmenėliai;Lašelių;9544233589;Taip;22;0;0;22
15451;Želmenėliai;Lašelių;3979635800;Taip;2;1;0;3
15452;Žemyna;Čiauškučiai;9985529041;Ne;5;1;2;8
15453;Žemyna;Čiauškučiai;9570187081;Ne;0;2;1;3
15454;Žemyna;Čiauškučiai;2547436771;Taip;3;1;0;4
15455;Žemyna;Čiauškučiai;6051208732;Taip;5;1;0;6
15456;Žemyna;Čiauškučiai;6346173832;Taip;0;0;1;1
15457;Žemyna;Čiauškučiai;8694608716;Taip;3;1;0;4
15458;Žemyna;Čiauškučiai;3074391266;Taip;4;0;2;6
15459;Žemyna;Čiauškučiai;4693414703;Taip;2;1;0;3
15460;Žemyna;Čiauškučiai;1365045512;Taip;4;0;1;5
15461;Žemyna;Čiauškučiai;7620179886;Taip;2;0;4;6
15462;Žemyna;Čiauškučiai;2792702536;Taip;0;1;1;2
15463;Žemyna;Čiauškučiai;7376806308;Taip;0;1;0;1
15464;Žemyna;Čiauškučiai;7277970673;Taip;7;2;2;11
15465;Žemyna;Čiauškučiai;5069437469;Taip;4;1;1;6
15466;Žemyna;Čiauškučiai;7427119736;Taip;0;1;1;2
15467;Žemyna;Čiauškučiai;4642600915;Ne;0;1;1;2
15468;Žemyna;Čiauškučiai;2354265632;Taip;2;0;2;4
15469;Žemyna;Čiauškučiai;2887459684;Taip;17;1;0;18
15470;Žemyna;Čiauškučiai;1654157342;Taip;11;0;0;11
15471;Žemyna;Čiauškučiai;4652384557;Taip;22;0;0;22
15472;Žemyna;Čiauškučiai;7352868453;Taip;12;0;0;12
15473;Žemyna;Čiauškučiai;4501408683;Taip;0;0;1;1
15474;Žemyna;Čiauškučiai;4613946229;Taip;9;1;0;10
15475;Žemyna;Čiauškučiai;7675699775;Taip;0;6;1;7
15476;Žemyna;Nykštukai;5114094924;Taip;0;3;0;3
15477;Žemyna;Nykštukai;3874855308;Taip;11;0;0;11
15478;Žemyna;Nykštukai;2461700030;Taip;5;1;0;6
15479;Žemyna;Nykštukai;1725771976;Taip;0;0;16;16
15480;Žemyna;Nykštukai;3643594001;Taip;0;1;3;4
15481;Žemyna;Nykštukai;9182709647;Taip;0;3;0;3
15482;Žemyna;Nykštukai;7121742098;Taip;0;4;0;4
15483;Žemyna;Nykštukai;3519840747;Taip;0;1;0;1
15484;Žemyna;Nykštukai;1468040559;Ne;3;0;0;3
15485;Žemyna;Nykštukai;4322192775;Taip;0;4;3;7
15486;Žemyna;Nykštukai;4444870782;Taip;18;0;0;18
15487;Žemyna;Nykštukai;7781924111;Taip;0;1;1;2
15488;Žemyna;Nykštukai;4257096808;Taip;0;3;0;3
15489;Žemyna;Nykštukai;2860210906;Taip;14;0;2;16
15490;Žemyna;Nykštukai;7832066079;Taip;8;0;0;8
15491;Žemyna;Nykštukai;9653530823;Taip;3;1;0;4
15492;Žemyna;Nykštukai;7508491119;Taip;0;2;0;2
15493;Žemyna;Nykštukai;4524929331;Taip;0;3;0;3
15494;Žemyna;Nykštukai;4759403487;Taip;0;6;0;6
15495;Žemyna;Voveriukai;9855080887;Taip;9;1;0;10
15496;Žemyna;Voveriukai;8525229514;Taip;15;0;0;15
15497;Žemyna;Voveriukai;1846287760;Ne;0;1;11;12
15498;Žemyna;Voveriukai;8775518984;Taip;7;1;0;8
15499;Žemyna;Voveriukai;5337086029;Taip;10;0;0;10
15500;Žemyna;Voveriukai;8926045231;Ne;6;7;1;14
15501;Žemyna;Voveriukai;3860791215;Taip;0;10;0;10
15502;Žemyna;Voveriukai;8185243991;Ne;3;1;2;6
15503;Žemyna;Voveriukai;9471382383;Taip;19;3;0;22
15504;Žemyna;Voveriukai;4549562657;Taip;7;0;0;7
15505;Žemyna;Voveriukai;8882641275;Taip;13;5;0;18
15506;Žemyna;Voveriukai;7121061078;Taip;3;0;0;3
15507;Žemyna;Voveriukai;4900914346;Taip;9;3;0;12
15508;Žemyna;Voveriukai;8241038433;Taip;8;4;0;12
15509;Žemyna;Voveriukai;5450351549;Taip;0;0;1;1
15510;Žemyna;Voveriukai;5189603013;Taip;5;0;0;5
15511;Žemyna;Voveriukai;3500358886;Ne;8;1;2;11
15512;Žemyna;Kiškučiai;1575505075;Taip;0;0;4;4
15513;Žemyna;Kiškučiai;39916867354;Taip;0;0;2;2
15514;Žemyna;Kiškučiai;4317779866;Taip;0;0;2;2
15515;Žemyna;Kiškučiai;5258444578;Taip;0;0;4;4
15516;Žemyna;Kiškučiai;7785889259;Taip;0;0;1;1
15517;Žemyna;Kiškučiai;7676796264;Taip;0;5;0;5
15518;Žemyna;Kiškučiai;6536698798;Taip;0;6;0;6
15519;Žemyna;Kiškučiai;8139714064;Ne;0;0;1;1
15520;Žemyna;Kiškučiai;2090395417;Taip;3;7;0;10
15521;Žemyna;Kiškučiai;3895238312;Ne;0;0;8;8
15522;Žemyna;Kiškučiai;4519502372;Taip;0;0;8;8
15523;Žemyna;Kiškučiai;2137718635;Taip;0;0;2;2
15524;Žemyna;Kiškučiai;1717797530;Taip;0;0;6;6
15525;Žemyna;Kiškučiai;1058705875;Taip;0;8;1;9
15526;Žemyna;Kiškučiai;5233574060;Taip;0;0;1;1
15527;Žemyna;Kiškučiai;15110117571;Taip;3;1;0;4
15528;Žemyna;Kiškučiai;9219519029;Taip;12;3;0;15
15529;Žemyna;Kiškučiai;3875204515;Taip;4;0;0;4
15530;Žemyna;Kiškučiai;7638038269;Ne;0;1;0;1
15531;Žemyna;Vyturiukai;2526949655;Taip;9;1;0;10
15532;Žemyna;Vyturiukai;1417007895;Taip;0;4;0;4
15533;Žemyna;Vyturiukai;5355845891;Taip;2;1;0;3
15534;Žemyna;Vyturiukai;1481273689;Taip;7;0;1;8
15535;Žemyna;Vyturiukai;7781332622;Taip;0;7;0;7
15536;Žemyna;Vyturiukai;9366133892;Taip;0;4;0;4
15537;Žemyna;Vyturiukai;1031171460;Taip;0;0;2;2
15538;Žemyna;Vyturiukai;5204349188;Taip;22;0;0;22
15539;Žemyna;Vyturiukai;6097681172;Taip;0;13;0;13
15540;Žemyna;Vyturiukai;3446774478;Taip;0;10;0;10
15541;Žemyna;Vyturiukai;6271057561;Taip;16;3;0;19
15542;Žemyna;Vyturiukai;2304633263;Taip;0;10;3;13
15543;Žemyna;Vyturiukai;7300819771;Taip;6;1;0;7
15544;Žemyna;Vyturiukai;3679990879;Taip;13;0;0;13
15545;Žemyna;Vyturiukai;8461326396;Taip;0;22;0;22
15546;Žemyna;Vyturiukai;8681308720;Taip;5;1;0;6
15547;Žemyna;Vyturiukai;8577299116;Taip;12;3;3;18
15548;Žemyna;Vyturiukai;9646494715;Taip;0;1;0;1
15549;Žemyna;Vyturiukai;4863350801;Taip;19;0;0;19
15550;Žemyna;Vyturiukai;6372465987;Taip;5;0;0;5
15551;Žemyna;Vyturiukai;5655302107;Ne;0;0;3;3
15552;Žemyna;Pelėdžiukai;8040359407;Ne;0;1;7;8
15553;Žemyna;Pelėdžiukai;37570629861;Taip;11;4;0;15
15554;Žemyna;Pelėdžiukai;55161890341;Taip;9;1;0;10
15555;Žemyna;Pelėdžiukai;59506345859;Ne;0;4;0;4
15556;Žemyna;Pelėdžiukai;85135645557;Taip;3;2;0;5
15557;Žemyna;Pelėdžiukai;38769607968;Taip;4;0;0;4
15558;Žemyna;Pelėdžiukai;4235160760;Taip;12;0;0;12
15559;Žemyna;Pelėdžiukai;3622634119;Taip;3;0;0;3
15560;Žemyna;Pelėdžiukai;6618285685;Taip;0;1;2;3
15561;Žemyna;Pelėdžiukai;5306392307;Taip;6;5;0;11
15562;Žemyna;Pelėdžiukai;5508251792;Taip;0;2;0;2
15563;Žemyna;Pelėdžiukai;9018138289;Taip;0;0;1;1
15564;Žemyna;Pelėdžiukai;8096035110;Ne;0;10;1;11
15565;Žemyna;Pelėdžiukai;1687206394;Taip;0;1;5;6
15566;Žemyna;Pelėdžiukai;93423088394;Taip;0;11;0;11
15567;Žemyna;Pelėdžiukai;5933910526;Taip;11;1;0;12
15568;Žemyna;Pelėdžiukai;5506889213;Ne;0;1;1;2
15569;Žemyna;Pelėdžiukai;5815116293;Ne;4;0;2;6
15570;Žemyna;Pelėdžiukai;13242930752;Taip;4;1;2;7
15571;Žemyna;Pelėdžiukai;89787441782;Taip;0;1;0;1
15572;Žemyna;Pelėdžiukai;9224203811;Taip;13;1;4;18
15573;Žemyna;Pelėdžiukai;2527337934;Taip;1;0;1;2
15574;Žemyna;Pelėdžiukai;1867198805;Ne;0;4;0;4
15575;Žemyna;Vijurkai;8500642069;Taip;7;0;3;10
15576;Žemyna;Vijurkai;9148594407;Taip;5;0;2;7
15577;Žemyna;Vijurkai;6812823390;Taip;0;0;1;1
15578;Žemyna;Vijurkai;3938938667;Taip;0;1;4;5
15579;Žemyna;Vijurkai;7125026803;Taip;6;1;2;9
15580;Žemyna;Vijurkai;7693278353;Taip;0;3;0;3
15581;Žemyna;Vijurkai;6430348135;Taip;0;3;0;3
15582;Žemyna;Vijurkai;2976467316;Taip;0;0;1;1
15583;Žemyna;Vijurkai;3357339710;Taip;0;0;5;5
15584;Žemyna;Vijurkai;7341750699;Taip;0;1;0;1
15585;Žemyna;Vijurkai;7925774308;Taip;0;1;0;1
15586;Žemyna;Vijurkai;9958040413;Taip;8;1;5;14
15587;Žemyna;Vijurkai;9866110744;Ne;0;1;0;1
15588;Žemyna;Vijurkai;2412956023;Taip;0;1;0;1
15589;Žemyna;Vijurkai;1114714466;Taip;0;0;6;6
15590;Žemyna;Vijurkai;5318574856;Ne;0;0;2;2
15591;Žemyna;Vijurkai;1264659113;Taip;0;15;0;15
15592;Žemyna;Vijurkai;4410293832;Ne;0;0;4;4
15593;Žemyna;Vijurkai;1652681820;Ne;0;1;0;1
15594;Žemyna;Šnekučiai;9501126807;Taip;3;0;0;3
15595;Žemyna;Šnekučiai;6735720135;Ne;0;2;3;5
15596;Žemyna;Šnekučiai;9912869400;Taip;12;0;0;12
15597;Žemyna;Šnekučiai;2006173745;Taip;0;1;0;1
15598;Žemyna;Šnekučiai;6116581655;Taip;6;0;0;6
15599;Žemyna;Šnekučiai;6419974691;Taip;12;1;3;16
15600;Žemyna;Šnekučiai;9818711030;Ne;4;2;0;6
15601;Žemyna;Šnekučiai;7764615445;Taip;0;1;0;1
15602;Žemyna;Šnekučiai;5868208651;Taip;7;0;2;9
15603;Žemyna;Šnekučiai;3992383447;Taip;15;0;3;18
15604;Žemyna;Šnekučiai;9668975591;Taip;0;0;5;5
15605;Žemyna;Šnekučiai;6856737270;Taip;4;1;0;5
15606;Žemyna;Šnekučiai;5188496664;Taip;5;1;0;6
15607;Žemyna;Šnekučiai;4872348199;Taip;5;6;0;11
15608;Žemyna;Šnekučiai;4502958166;Taip;3;2;0;5
15609;Žemyna;Šnekučiai;6728229865;Taip;0;6;0;6
15610;Žemyna;Šnekučiai;2710551760;Taip;3;2;0;5
15611;Žemyna;Šnekučiai;4612112289;Taip;10;3;0;13
15612;Žemyna;Šnekučiai;9568886284;Taip;4;0;3;7
15613;Žemyna;Šnekučiai;3982766622;Taip;0;1;3;4
15614;Žemyna;Pabiručiai;9827401825;Taip;0;4;0;4
15615;Žemyna;Pabiručiai;5743535463;Taip;0;9;0;9
15616;Žemyna;Pabiručiai;6958537154;Taip;0;7;0;7
15617;Žemyna;Pabiručiai;7005045961;Taip;0;5;0;5
15618;Žemyna;Pabiručiai;1745197274;Taip;3;6;0;9
15619;Žemyna;Pabiručiai;6041223291;Taip;22;0;0;22
15620;Žemyna;Pabiručiai;9094718595;Ne;0;0;1;1
15621;Žemyna;Pabiručiai;6208953341;Taip;7;4;0;11
15622;Žemyna;Pabiručiai;5127174926;Taip;10;0;0;10
15623;Žemyna;Pabiručiai;8559870965;Taip;0;1;0;1
15624;Žemyna;Pabiručiai;1850100203;Taip;6;1;0;7
15625;Žemyna;Pabiručiai;6450681255;Taip;9;0;0;9
15626;Žemyna;Pabiručiai;2860232791;Taip;4;0;0;4
15627;Žemyna;Pabiručiai;4237778022;Taip;0;2;0;2
15628;Žemyna;Pabiručiai;2414400761;Taip;12;3;0;15
15629;Žemyna;Pabiručiai;9511935264;Taip;8;2;0;10
15630;Žemyna;Pabiručiai;4176386795;Taip;0;1;0;1
15631;Žemyna;Pabiručiai;3393414493;Taip;1;1;0;2
15632;Žemyna;Pabiručiai;4960936366;Ne;22;0;0;22
15633;Žemyna;Drugeliai;7564693757;Taip;20;0;2;22
15634;Žemyna;Drugeliai;8302345911;Taip;0;2;1;3
15635;Žemyna;Drugeliai;3505551915;Taip;9;0;2;11
15636;Žemyna;Drugeliai;2231967652;Taip;17;0;0;17
15637;Žemyna;Drugeliai;3755964840;Taip;10;1;0;11
15638;Žemyna;Drugeliai;9171823612;Taip;3;0;15;18
15639;Žemyna;Drugeliai;5518125715;Taip;5;0;1;6
15640;Žemyna;Drugeliai;9589582451;Taip;0;10;1;11
15641;Žemyna;Drugeliai;3872427931;Taip;7;0;0;7
15642;Žemyna;Drugeliai;1279981170;Taip;6;0;0;6
15643;Žemyna;Drugeliai;2102920661;Taip;8;0;4;12
15644;Žemyna;Drugeliai;6575272457;Taip;10;0;1;11
15645;Žemyna;Drugeliai;6164541167;Taip;0;0;1;1
15646;Žemyna;Drugeliai;7461187735;Taip;4;10;2;16
15647;Žemyna;Drugeliai;3390442637;Taip;8;0;6;14
15648;Žemyna;Drugeliai;2371069183;Taip;8;0;0;8
15649;Žemyna;Drugeliai;2139103576;Taip;0;3;2;5
15650;Žemyna;Drugeliai;7920398415;Taip;8;1;0;9
15651;Žemyna;Drugeliai;1695063377;Taip;9;0;3;12
15652;Žemyna;Drugeliai;7745383607;Taip;11;0;1;12
15653;Žemyna;Drugeliai;7661182825;Taip;7;0;1;8
15654;Žemyna;Drugeliai;4861799571;Taip;9;0;1;10
15655;Žemyna;Drugeliai;8709792653;Taip;9;0;0;9
15656;Žemyna;"ŽIRNIUKAI ";4540472310;Taip;29;2;0;31
15657;Žemyna;"ŽIRNIUKAI ";9647706055;Taip;14;3;0;17
15658;Žemyna;"ŽIRNIUKAI ";2883862675;Taip;0;2;0;2
15659;Žemyna;"ŽIRNIUKAI ";7537145330;Taip;12;3;4;19
15660;Žemyna;"ŽIRNIUKAI ";7683443675;Taip;12;3;4;19
15661;Žemyna;"ŽIRNIUKAI ";5262196604;Taip;12;0;0;12
15662;Žemyna;"ŽIRNIUKAI ";9796331127;Taip;5;1;0;6
15663;Žemyna;"ŽIRNIUKAI ";3996577758;Ne;0;2;4;6
15664;Žemyna;"ŽIRNIUKAI ";6783675344;Taip;22;0;0;22
15665;Žemyna;"ŽIRNIUKAI ";9082375371;Taip;22;0;0;22
15666;Žemyna;"ŽIRNIUKAI ";1795919515;Taip;10;3;0;13
15667;Žemyna;"ŽIRNIUKAI ";3899901920;Ne;0;9;0;9
15668;Žemyna;"ŽIRNIUKAI ";7831778620;Taip;3;2;0;5
15669;Žemyna;"ŽIRNIUKAI ";9692952139;Ne;0;1;0;1
15670;Žemyna;"ŽIOGELIAI ";2039344248;Taip;9;0;0;9
15671;Žemyna;"ŽIOGELIAI ";5193466394;Taip;8;0;0;8
15672;Žemyna;"ŽIOGELIAI ";5968816137;Taip;10;0;2;12
15673;Žemyna;"ŽIOGELIAI ";4238528111;Ne;12;0;0;12
15674;Žemyna;"ŽIOGELIAI ";3741459808;Ne;12;0;0;12
15675;Žemyna;"ŽIOGELIAI ";3164469202;Taip;7;1;0;8
15676;Žemyna;"ŽIOGELIAI ";3870917221;Taip;14;0;0;14
15677;Žemyna;"ŽIOGELIAI ";6571952468;Taip;9;0;0;9
15678;Žemyna;"ŽIOGELIAI ";6632827240;Taip;11;0;0;11
15679;Žemyna;"ŽIOGELIAI ";3935318882;Taip;10;1;0;11
15680;Žemyna;"ŽIOGELIAI ";2010676445;Taip;10;1;0;11
15681;Žemyna;"ŽIOGELIAI ";1581399038;Taip;7;0;0;7
15682;Žemyna;"ŽIOGELIAI ";8611258788;Taip;9;0;0;9
15683;Žemyna;"ŽIOGELIAI ";6592356004;Taip;13;0;0;13
15684;Žemyna;"ŽIOGELIAI ";9788890112;Taip;22;0;0;22
15685;Žemuogėlė;Boružiukai;1350671777;Taip;10;0;9;19
15686;Žemuogėlė;Boružiukai;9344628661;Taip;0;2;0;2
15687;Žemuogėlė;Boružiukai;2158359435;Ne;1;1;1;3
15688;Žemuogėlė;Boružiukai;1639634300;Ne;15;4;0;19
15689;Žemuogėlė;Boružiukai;5521993938;Ne;15;0;1;16
15690;Žemuogėlė;Boružiukai;1267222057;Taip;5;2;0;7
15691;Žemuogėlė;Boružiukai;9562512849;Taip;22;1;0;23
15692;Žemuogėlė;Boružiukai;8661864424;Taip;3;1;1;5
15693;Žemuogėlė;Boružiukai;5427045039;Taip;8;0;21;29
15694;Žemuogėlė;Boružiukai;1150466286;Taip;12;4;0;16
15695;Žemuogėlė;Boružiukai;8040255583;Taip;0;1;0;1
15696;Žemuogėlė;Boružiukai;2190458676;Ne;13;0;0;13
15697;Žemuogėlė;Boružiukai;6073591450;Taip;8;0;0;8
15698;Žemuogėlė;Boružiukai;7328566035;Ne;4;0;0;4
15699;Žemuogėlė;Boružiukai;8557325116;Taip;2;1;0;3
15700;Žemuogėlė;Boružiukai;1350383125;Taip;10;0;2;12
15701;Žemuogėlė;Boružiukai;7050896262;Taip;9;3;0;12
15702;Žemuogėlė;Boružiukai;3413805578;Taip;5;0;0;5
15703;Žemuogėlė;Boružiukai;3677459716;Taip;11;0;0;11
15704;Žemuogėlė;Boružiukai;8426601160;Taip;4;0;6;10
15705;Žemuogėlė;Boružiukai;5911215640;Ne;14;2;1;17
15706;Žemuogėlė;Šviesuliukai;3837424301;Taip;11;3;0;14
15707;Žemuogėlė;Šviesuliukai;5499401648;Taip;6;0;0;6
15708;Žemuogėlė;Šviesuliukai;3746045950;Taip;9;13;0;22
15709;Žemuogėlė;Šviesuliukai;4663181188;Taip;16;0;0;16
15710;Žemuogėlė;Šviesuliukai;8492878852;Ne;10;1;2;13
15711;Žemuogėlė;Šviesuliukai;7603740057;Taip;20;0;1;21
15712;Žemuogėlė;Šviesuliukai;6755278376;Ne;4;0;2;6
15713;Žemuogėlė;Šviesuliukai;4506847669;Taip;5;2;0;7
15714;Žemuogėlė;Šviesuliukai;7708949381;Taip;9;0;1;10
15715;Žemuogėlė;Šviesuliukai;7189855370;Taip;10;9;0;19
15716;Žemuogėlė;Šviesuliukai;3801534195;Taip;33;0;0;33
15717;Žemuogėlė;Šviesuliukai;1341637008;Taip;2;0;2;4
15718;Žemuogėlė;Šviesuliukai;8890454460;Taip;15;0;0;15
15719;Žemuogėlė;Šviesuliukai;7288060676;Taip;8;0;10;18
15720;Žemuogėlė;Šviesuliukai;6086270618;Ne;0;14;0;14
15721;Žemuogėlė;Šviesuliukai;7551522580;Taip;9;0;2;11
15722;Žemuogėlė;Lašiukai;3190523750;Taip;6;0;0;6
15723;Žemuogėlė;Lašiukai;1251497003;Taip;12;4;0;16
15724;Žemuogėlė;Lašiukai;3706531223;Taip;11;0;0;11
15725;Žemuogėlė;Lašiukai;8029484123;Taip;17;0;0;17
15726;Žemuogėlė;Lašiukai;5992802843;Taip;6;0;0;6
15727;Žemuogėlė;Lašiukai;3753156044;Taip;2;0;0;2
15728;Žemuogėlė;Lašiukai;7592566602;Taip;4;0;1;5
15729;Žemuogėlė;Lašiukai;1953538445;Ne;3;0;3;6
15730;Žemuogėlė;Lašiukai;8644564820;Taip;0;1;0;1
15731;Žemuogėlė;Lašiukai;3546429231;Taip;0;9;0;9
15732;Žemuogėlė;Lašiukai;9579921777;Taip;11;4;0;15
15733;Žemuogėlė;Lašiukai;3073956225;Ne;13;0;0;13
15734;Žemuogėlė;Lašiukai;9693814425;Taip;8;0;1;9
15735;Žemuogėlė;Lašiukai;3825509486;Taip;16;3;0;19
15736;Žemuogėlė;Lašiukai;3059525247;Taip;5;5;0;10
15737;Žemuogėlė;Lašiukai;6747566307;Taip;10;3;0;13
15738;Žemuogėlė;Lašiukai;2115883173;Taip;33;0;0;33
15739;Žemuogėlė;Lašiukai;9732291476;Taip;3;0;2;5
15740;Žemuogėlė;Skambaliukai;54663750186;Taip;0;5;3;8
15741;Žemuogėlė;Skambaliukai;4231767115;Taip;0;2;0;2
15742;Žemuogėlė;Skambaliukai;3977351017;Taip;8;0;0;8
15743;Žemuogėlė;Skambaliukai;3854265246;Ne;0;1;0;1
15744;Žemuogėlė;Skambaliukai;5147617128;Taip;0;16;0;16
15745;Žemuogėlė;Skambaliukai;1058207935;Taip;12;2;0;14
15746;Žemuogėlė;Skambaliukai;1628749648;Taip;0;2;0;2
15747;Žemuogėlė;Skambaliukai;6962103028;Taip;3;4;0;7
15748;Žemuogėlė;Skambaliukai;7714826773;Taip;0;2;0;2
15749;Žemuogėlė;Skambaliukai;3134493860;Taip;0;7;0;7
15750;Žemuogėlė;Skambaliukai;1907004376;Taip;0;3;0;3
15751;Žemuogėlė;Skambaliukai;38870047353;Taip;0;1;0;1
15752;Žemuogėlė;Skambaliukai;7403172794;Taip;7;3;0;10
15753;Žemuogėlė;Skambaliukai;9315711142;Taip;0;6;3;9
15754;Žemuogėlė;Skambaliukai;2102057496;Ne;3;6;0;9
15755;Žemuogėlė;Skambaliukai;4421397490;Taip;0;3;9;12
15756;Žemuogėlė;Skambaliukai;94792383091;Taip;0;15;0;15
15757;Žemuogėlė;Spinduliukai;3411390558;Taip;0;5;0;5
15758;Žemuogėlė;Spinduliukai;9955429241;Taip;3;0;6;9
15759;Žemuogėlė;Spinduliukai;5971652934;Taip;0;12;0;12
15760;Žemuogėlė;Spinduliukai;5127370193;Taip;0;0;4;4
15761;Žemuogėlė;Spinduliukai;1049009199;Taip;10;4;0;14
15762;Žemuogėlė;Spinduliukai;4578291476;Taip;0;23;0;23
15763;Žemuogėlė;Spinduliukai;5126348190;Taip;6;3;0;9
15764;Žemuogėlė;Spinduliukai;9534937419;Taip;9;6;0;15
15765;Žemuogėlė;Spinduliukai;3612833383;Ne;9;1;0;10
15766;Žemuogėlė;Spinduliukai;9689082202;Ne;0;12;0;12
15767;Žemuogėlė;Spinduliukai;6707522989;Taip;4;10;0;14
15768;Žemuogėlė;Spinduliukai;6059069293;Taip;0;21;0;21
15769;Žemuogėlė;Spinduliukai;5770044886;Taip;0;16;0;16
15770;Žemuogėlė;Spinduliukai;7669457695;Ne;0;2;3;5
15771;Žemuogėlė;Spinduliukai;3041461125;Taip;0;2;0;2
15772;Žemuogėlė;Spinduliukai;8675089149;Taip;6;0;0;6
15773;Žemuogėlė;Spinduliukai;4933948491;Taip;1;1;4;6
15774;Žemuogėlė;Perliukai;4629107942;Ne;5;6;3;14
15775;Žemuogėlė;Perliukai;1306065826;Taip;0;2;0;2
15776;Žemuogėlė;Perliukai;8106709288;Taip;3;10;1;14
15777;Žemuogėlė;Perliukai;2664267604;Taip;21;4;0;25
15778;Žemuogėlė;Perliukai;1060986850;Taip;10;2;0;12
15779;Žemuogėlė;Perliukai;7794377881;Ne;15;1;0;16
15780;Žemuogėlė;Perliukai;1658954821;Taip;0;2;1;3
15781;Žemuogėlė;Perliukai;4698671798;Taip;12;0;0;12
15782;Žemuogėlė;Perliukai;2922827304;Taip;8;3;0;11
15783;Žemuogėlė;Perliukai;7415364637;Taip;10;1;0;11
15784;Žemuogėlė;Perliukai;3710681463;Taip;9;8;0;17
15785;Žemuogėlė;Perliukai;1796489729;Ne;5;2;0;7
15786;Žemuogėlė;Perliukai;8215763877;Taip;8;2;0;10
15787;Žemuogėlė;Perliukai;2934225120;Ne;10;3;0;13
15788;Žemuogėlė;Perliukai;3426685084;Ne;12;2;9;23
15789;Žemuogėlė;Perliukai;9150335499;Taip;17;2;0;19
15790;Žemuogėlė;Perliukai;1079114347;Taip;33;0;0;33
15791;Žemuogėlė;Perliukai;5902241163;Ne;9;0;0;9
15792;Žemuogėlė;Perliukai;7879519193;Ne;9;2;1;12
15793;Žemuogėlė;Perliukai;2109195565;Taip;8;1;0;9
15794;Žemuogėlė;Drugeliai;2745609317;Taip;9;0;4;13
15795;Žemuogėlė;Drugeliai;9694133286;Taip;7;0;0;7
15796;Žemuogėlė;Drugeliai;5557409350;Taip;11;4;0;15
15797;Žemuogėlė;Drugeliai;7668200447;Taip;9;1;0;10
15798;Žemuogėlė;Drugeliai;7148244029;Taip;0;3;0;3
15799;Žemuogėlė;Drugeliai;1901423257;Taip;0;2;0;2
15800;Žemuogėlė;Drugeliai;4862145385;Taip;9;7;0;16
15801;Žemuogėlė;Drugeliai;4368183799;Ne;6;1;0;7
15802;Žemuogėlė;Drugeliai;9902953729;Taip;19;4;0;23
15803;Žemuogėlė;Drugeliai;9537297860;Taip;6;1;3;10
15804;Žemuogėlė;Drugeliai;5170205929;Taip;11;6;0;17
15805;Žemuogėlė;Drugeliai;2428043195;Taip;15;0;0;15
15806;Žemuogėlė;Drugeliai;1716114524;Taip;11;0;3;14
15807;Žemuogėlė;Drugeliai;8137567729;Taip;8;8;0;16
15808;Žemuogėlė;Drugeliai;8348185761;Taip;28;1;0;29
15809;Žemuogėlė;Drugeliai;9273896998;Taip;17;0;0;17
15810;Žemuogėlė;"VIEVERSIUKAI ";6520776378;Taip;4;0;0;4
15811;Žemuogėlė;"VIEVERSIUKAI ";8048818368;Taip;14;0;2;16
15812;Žemuogėlė;"VIEVERSIUKAI ";6577040746;Taip;17;2;5;24
15813;Žemuogėlė;"VIEVERSIUKAI ";9872387354;Taip;10;0;0;10
15814;Žemuogėlė;"VIEVERSIUKAI ";2674188340;Taip;17;0;0;17
15815;Žemuogėlė;"VIEVERSIUKAI ";5300388726;Taip;5;0;0;5
15816;Žemuogėlė;"VIEVERSIUKAI ";7823828526;Taip;5;4;0;9
15817;Žemuogėlė;"VIEVERSIUKAI ";4172356209;Ne;33;0;0;33
15818;Žemuogėlė;"VIEVERSIUKAI ";6379837644;Taip;17;0;0;17
15819;Žemuogėlė;"VIEVERSIUKAI ";3104276726;Taip;8;0;1;9
15820;Žemuogėlė;"VIEVERSIUKAI ";3419907292;Taip;33;0;0;33
15821;Žemuogėlė;"VIEVERSIUKAI ";7323868051;Taip;0;4;5;9
15822;Žemuogėlė;"VIEVERSIUKAI ";2800160529;Taip;24;0;0;24
15823;Žemuogėlė;"VIEVERSIUKAI ";8934779062;Taip;23;0;0;23
15824;Žemuogėlė;"VIEVERSIUKAI ";3090630899;Taip;13;1;3;17
15825;Žemuogėlė;"VIEVERSIUKAI ";8091000121;Taip;6;4;2;12
15826;Žemuogėlė;"VIEVERSIUKAI ";2110963483;Taip;33;0;0;33
15827;Žemuogėlė;"NYKŠTUKAI ";1002937953;Taip;5;0;1;6
15828;Žemuogėlė;"NYKŠTUKAI ";6504659145;Ne;3;0;3;6
15829;Žemuogėlė;"NYKŠTUKAI ";3505090532;Taip;2;0;5;7
15830;Žemuogėlė;"NYKŠTUKAI ";5208043522;Ne;14;0;1;15
15831;Žemuogėlė;"NYKŠTUKAI ";3740127955;Taip;6;0;6;12
15832;Žemuogėlė;"NYKŠTUKAI ";5614510812;Taip;33;0;0;33
15833;Žemuogėlė;"NYKŠTUKAI ";4089939292;Taip;0;0;5;5
15834;Žemuogėlė;"NYKŠTUKAI ";9584172565;Ne;13;7;1;21
15835;Žemuogėlė;"NYKŠTUKAI ";8706379207;Taip;7;0;0;7
15836;Žemuogėlė;"NYKŠTUKAI ";1790341419;Ne;5;7;0;12
15837;Žemuogėlė;"NYKŠTUKAI ";4998981337;Taip;16;0;0;16
15838;Žemuogėlė;"NYKŠTUKAI ";6045257180;Taip;4;0;7;11
15839;Žemuogėlė;"NYKŠTUKAI ";8301927361;Taip;12;0;0;12
15840;Žemuogėlė;"NYKŠTUKAI ";2496321184;Taip;7;3;3;13
15841;Žemuogėlė;"NYKŠTUKAI ";8490643028;Taip;16;0;0;16
15842;Žemuogėlė;"NYKŠTUKAI ";2139102266;Taip;20;1;1;22
15843;Žemuogėlė;"NYKŠTUKAI ";9735379466;Taip;3;7;0;10
15844;Žemuogėlė;KIŠKUČIAI;4654060157;Ne;10;0;4;14
15845;Žemuogėlė;KIŠKUČIAI;2652630375;Taip;10;0;2;12
15846;Žemuogėlė;KIŠKUČIAI;1250186598;Taip;7;1;6;14
15847;Žemuogėlė;KIŠKUČIAI;3287415964;Ne;8;7;4;19
15848;Žemuogėlė;KIŠKUČIAI;5094867109;Taip;0;0;2;2
15849;Žemuogėlė;KIŠKUČIAI;5186248897;Ne;33;0;0;33
15850;Žemuogėlė;KIŠKUČIAI;5125826172;Taip;5;9;0;14
15851;Žemuogėlė;KIŠKUČIAI;8262862183;Taip;22;1;0;23
15852;Žemuogėlė;KIŠKUČIAI;8798113318;Taip;7;0;2;9
15853;Žemuogėlė;KIŠKUČIAI;1280794094;Taip;6;1;1;8
15854;Žemuogėlė;KIŠKUČIAI;2251142510;Taip;22;1;1;24
15855;Žemuogėlė;KIŠKUČIAI;1417355297;Taip;0;1;0;1
15856;Žemuogėlė;KIŠKUČIAI;4974793430;Taip;13;0;8;21
15857;Žemuogėlė;KIŠKUČIAI;6659616731;Taip;8;0;0;8
15858;Žemuogėlė;KIŠKUČIAI;3459960812;Taip;16;0;2;18
15859;Žemuogėlė;Žiniukai;7804015060;Taip;5;7;0;12
15860;Žemuogėlė;Žiniukai;3765022476;Taip;4;3;0;7
15861;Žemuogėlė;Žiniukai;9476688736;Taip;15;1;2;18
15862;Žemuogėlė;Žiniukai;2001471529;Taip;0;0;1;1
15863;Žemuogėlė;Žiniukai;9519563708;Taip;0;3;2;5
15864;Žemuogėlė;Žiniukai;5266493632;Taip;3;2;0;5
15865;Žemuogėlė;Žiniukai;2841634296;Taip;0;3;1;4
15866;Žemuogėlė;Žiniukai;3237083654;Taip;7;3;3;13
15867;Žemuogėlė;Žiniukai;2259779058;Taip;0;3;0;3
15868;Žemuogėlė;Žiniukai;9693894254;Ne;9;5;3;17
15869;Žemuogėlė;Žiniukai;9378432383;Taip;5;3;0;8
15870;Žemuogėlė;Žiniukai;6073971598;Taip;8;3;0;11
15871;Žemuogėlė;Žiniukai;6913038845;Taip;0;4;0;4
15872;Žemuogėlė;Žiniukai;6581889641;Taip;3;2;1;6
15873;Žemuogėlė;Žiniukai;2555902309;Taip;14;2;0;16
15874;Žemuogėlė;Žiniukai;8757701456;Taip;6;10;0;16
15875;Žemuogėlė;Žiniukai;2132549536;Taip;0;8;0;8
15876;Žemuogėlė;Žiniukai;5532053268;Taip;8;0;0;8
15877;Žemuogėlė;Žiniukai;8496353410;Taip;0;5;0;5
15878;Žemuogėlė;Žiniukai;1733808230;Taip;0;15;0;15
15879;Žemuogėlė;Žiniukai;4660479216;Taip;10;1;0;11
15880;Žemuogėlė;Žiniukai;1469759840;Taip;4;1;0;5
15881;Žibutė;PELĖDŽIUKAI;3496675605;Taip;0;1;0;1
15882;Žibutė;PELĖDŽIUKAI;59824395612;Taip;0;1;2;3
15883;Žibutė;PELĖDŽIUKAI;2361682400;Taip;0;1;3;4
15884;Žibutė;PELĖDŽIUKAI;1826763192;Taip;0;2;9;11
15885;Žibutė;PELĖDŽIUKAI;3826875107;Taip;12;3;0;15
15886;Žibutė;PELĖDŽIUKAI;3186792146;Taip;0;1;6;7
15887;Žibutė;PELĖDŽIUKAI;7344095020;Taip;4;0;1;5
15888;Žibutė;PELĖDŽIUKAI;1078105287;Taip;0;4;0;4
15889;Žibutė;PELĖDŽIUKAI;2152452830;Taip;0;0;2;2
15890;Žibutė;PELĖDŽIUKAI;1394895695;Taip;0;3;0;3
15891;Žibutė;PELĖDŽIUKAI;2236930916;Taip;7;1;1;9
15892;Žibutė;PELĖDŽIUKAI;7095870173;Taip;0;6;0;6
15893;Žibutė;PELĖDŽIUKAI;2840754631;Taip;0;5;0;5
15894;Žibutė;PELĖDŽIUKAI;6089325755;Taip;13;0;0;13
15895;Žibutė;PELĖDŽIUKAI;1274409680;Taip;3;1;0;4
15896;Žibutė;PELĖDŽIUKAI;8278928396;Taip;3;0;3;6
15897;Žibutė;PELĖDŽIUKAI;2957525481;Taip;8;3;2;13
15898;Žibutė;PELĖDŽIUKAI;3191351976;Taip;0;1;9;10
15899;Žibutė;PELĖDŽIUKAI;6495108202;Taip;0;2;0;2
15900;Žibutė;KREGŽDUTĖS;7036454359;Taip;0;0;2;2
15901;Žibutė;KREGŽDUTĖS;3555071718;Taip;10;0;2;12
15902;Žibutė;KREGŽDUTĖS;5187777741;Taip;8;0;0;8
15903;Žibutė;KREGŽDUTĖS;5190377896;Taip;22;0;0;22
15904;Žibutė;KREGŽDUTĖS;6013340521;Taip;1;1;0;2
15905;Žibutė;KREGŽDUTĖS;6194464236;Taip;0;0;8;8
15906;Žibutė;KREGŽDUTĖS;3777544301;Taip;12;0;3;15
15907;Žibutė;KREGŽDUTĖS;9923687090;Ne;20;0;5;25
15908;Žibutė;KREGŽDUTĖS;4847295068;Taip;0;0;6;6
15909;Žibutė;KREGŽDUTĖS;9700866512;Taip;0;2;0;2
15910;Žibutė;KREGŽDUTĖS;7774532200;Taip;8;6;0;14
15911;Žibutė;KREGŽDUTĖS;2607509585;Taip;1;2;1;4
15912;Žibutė;KREGŽDUTĖS;8944042589;Taip;2;4;0;6
15913;Žibutė;KREGŽDUTĖS;2438980348;Taip;4;1;2;7
15914;Žibutė;KREGŽDUTĖS;9918283923;Taip;9;0;0;9
15915;Žibutė;KREGŽDUTĖS;5126232169;Taip;4;0;2;6
15916;Žibutė;KREGŽDUTĖS;8792292819;Taip;22;0;0;22
15917;Žibutė;KREGŽDUTĖS;7668484415;Taip;8;1;0;9
15918;Žibutė;KREGŽDUTĖS;2516448580;Taip;0;7;0;7
15919;Žibutė;BORUŽĖLĖS;4278832423;Taip;11;0;6;17
15920;Žibutė;BORUŽĖLĖS;3066580779;Taip;7;0;0;7
15921;Žibutė;BORUŽĖLĖS;1786332689;Taip;0;0;3;3
15922;Žibutė;BORUŽĖLĖS;2910188022;Taip;0;0;5;5
15923;Žibutė;BORUŽĖLĖS;8879347884;Taip;5;0;5;10
15924;Žibutė;BORUŽĖLĖS;7764376193;Taip;0;0;2;2
15925;Žibutė;BORUŽĖLĖS;3618347199;Taip;0;0;4;4
15926;Žibutė;BORUŽĖLĖS;5186839413;Taip;6;3;0;9
15927;Žibutė;BORUŽĖLĖS;2374119662;Taip;22;0;0;22
15928;Žibutė;BORUŽĖLĖS;1381488132;Taip;0;0;10;10
15929;Žibutė;BORUŽĖLĖS;5591970907;Taip;8;0;0;8
15930;Žibutė;BORUŽĖLĖS;6672033757;Taip;0;2;3;5
15931;Žibutė;BORUŽĖLĖS;7481695788;Taip;7;0;0;7
15932;Žibutė;BORUŽĖLĖS;1112295932;Ne;0;6;0;6
15933;Žibutė;BORUŽĖLĖS;8155327668;Taip;2;3;0;5
15934;Žibutė;BORUŽĖLĖS;5632520305;Taip;0;0;8;8
15935;Žibutė;BORUŽĖLĖS;4622674814;Ne;0;1;3;4
15936;Žibutė;BORUŽĖLĖS;7805758264;Taip;5;4;0;9
15937;Žibutė;BORUŽĖLĖS;8640664660;Taip;10;0;0;10
15938;Žibutė;BITUTĖS;7023683517;Taip;0;2;0;2
15939;Žibutė;BITUTĖS;7853531467;Ne;0;1;0;1
15940;Žibutė;BITUTĖS;3687123871;Taip;0;0;1;1
15941;Žibutė;BITUTĖS;2312717334;Taip;5;3;0;8
15942;Žibutė;BITUTĖS;6361543454;Taip;14;0;0;14
15943;Žibutė;BITUTĖS;1297347740;Taip;3;0;0;3
15944;Žibutė;BITUTĖS;6934760468;Taip;8;1;0;9
15945;Žibutė;BITUTĖS;4455757640;Taip;0;1;5;6
15946;Žibutė;BITUTĖS;8797870379;Taip;0;8;0;8
15947;Žibutė;BITUTĖS;7792267540;Taip;6;4;0;10
15948;Žibutė;BITUTĖS;9221523836;Taip;4;4;0;8
15949;Žibutė;BITUTĖS;3632745935;Taip;0;1;0;1
15950;Žibutė;BITUTĖS;7611641692;Taip;3;8;0;11
15951;Žibutė;BITUTĖS;5112512917;Taip;0;4;1;5
15952;Žibutė;BITUTĖS;8276724226;Taip;5;0;0;5
15953;Žibutė;BITUTĖS;4685356158;Taip;3;0;0;3
15954;Žibutė;BITUTĖS;1515636796;Taip;5;0;0;5
15955;Žibutė;BITUTĖS;7872636200;Taip;5;0;0;5
15956;Žibutė;BITUTĖS;6833179680;Taip;0;0;1;1
15957;Žibutė;BITUTĖS;1614551884;Taip;10;0;2;12
15958;Žibutė;KAČIUKAI;6978977383;Taip;10;1;0;11
15959;Žibutė;KAČIUKAI;9868621666;Ne;3;0;0;3
15960;Žibutė;KAČIUKAI;1366469428;Taip;0;1;1;2
15961;Žibutė;KAČIUKAI;4825064521;Taip;15;0;9;24
15962;Žibutė;KAČIUKAI;5826523148;Taip;7;1;2;10
15963;Žibutė;KAČIUKAI;3957898269;Taip;3;0;1;4
15964;Žibutė;KAČIUKAI;4382812297;Taip;3;0;0;3
15965;Žibutė;KAČIUKAI;1004098038;Taip;4;8;0;12
15966;Žibutė;KAČIUKAI;2880593326;Taip;2;0;0;2
15967;Žibutė;KAČIUKAI;7479437931;Taip;22;0;0;22
15968;Žibutė;KAČIUKAI;1362419302;Taip;0;0;4;4
15969;Žibutė;KAČIUKAI;7531027545;Ne;5;0;2;7
15970;Žibutė;KAČIUKAI;3645481894;Taip;5;2;0;7
15971;Žibutė;KAČIUKAI;8880329060;Ne;5;1;7;13
15972;Žibutė;KAČIUKAI;7136145033;Ne;5;0;0;5
15973;Žibutė;KAČIUKAI;9498011134;Taip;0;1;1;2
15974;Žibutė;KAČIUKAI;5677389434;Taip;0;3;0;3
15975;Žibutė;KAČIUKAI;5416015554;Taip;0;0;8;8
15976;Žibutė;ZUIKIAI;4741505387;Taip;33;0;0;33
15977;Žibutė;ZUIKIAI;6209156111;Taip;0;5;4;9
15978;Žibutė;ZUIKIAI;2787326978;Taip;3;0;6;9
15979;Žibutė;ZUIKIAI;9856822557;Taip;1;1;0;2
15980;Žibutė;ZUIKIAI;4787010953;Taip;0;4;0;4
15981;Žibutė;ZUIKIAI;3875455223;Taip;0;8;0;8
15982;Žibutė;ZUIKIAI;3449188614;Taip;7;5;1;13
15983;Žibutė;ZUIKIAI;4434623264;Taip;0;13;0;13
15984;Žibutė;ZUIKIAI;9769180056;Taip;27;0;4;31
15985;Žibutė;ZUIKIAI;2013724729;Taip;14;8;0;22
15986;Žibutė;ZUIKIAI;3786933891;Taip;4;0;0;4
15987;Žibutė;ZUIKIAI;9379539151;Taip;6;0;10;16
15988;Žibutė;ZUIKIAI;9439026609;Taip;23;6;1;30
15989;Žibutė;ZUIKIAI;6234135622;Taip;13;1;0;14
15990;Žibutė;ZUIKIAI;8585964720;Taip;19;0;0;19
15991;Žibutė;ZUIKIAI;9793570682;Taip;0;1;3;4
15992;Žibutė;ZUIKIAI;6618315401;Taip;8;0;0;8
15993;Žiedas;Bitutės;1484464986;Taip;0;0;1;1
15994;Žiedas;Bitutės;4807479784;Ne;5;0;0;5
15995;Žiedas;Bitutės;5513311280;Taip;4;3;0;7
15996;Žiedas;Bitutės;1529988412;Taip;4;1;0;5
15997;Žiedas;Bitutės;1007894628;Taip;17;0;0;17
15998;Žiedas;Bitutės;1625009666;Taip;0;2;0;2
15999;Žiedas;Bitutės;1550350520;Ne;14;2;0;16
16000;Žiedas;Bitutės;9058688663;Ne;10;3;0;13
16001;Žiedas;Bitutės;7150433256;Taip;4;4;1;9
16002;Žiedas;Bitutės;3414702993;Taip;8;0;0;8
16003;Žiedas;Bitutės;2507543124;Taip;22;0;0;22
16004;Žiedas;Bitutės;88471315730;Taip;5;3;0;8
16005;Žiedas;Bitutės;34193530;Taip;14;0;0;14
16006;Žiedas;Bitutės;69485023219;Taip;4;3;0;7
16007;Žiedas;Bitutės;86877563124;Taip;22;0;0;22
16008;Žiedas;Bitutės;78720591915;Taip;6;1;0;7
16009;Žiedas;Bitutės;2026728639;Taip;5;0;0;5
16010;Žiedas;Bitutės;5108263139;Taip;0;3;0;3
16011;Žiedas;Bitutės;5885209631;Taip;8;0;2;10
16012;Žiedas;Bitutės;1737296046;Taip;0;0;3;3
16013;Žiedas;Bitutės;1048272199;Taip;1;0;0;1
16014;Žiedas;Bitutės;5007348884;Ne;5;1;0;6
16015;Žiedas;Varpeliai;7097790025;Taip;0;2;0;2
16016;Žiedas;Varpeliai;3230107921;Taip;0;0;6;6
16017;Žiedas;Varpeliai;3178778438;Taip;2;13;0;15
16018;Žiedas;Varpeliai;9602083568;Taip;4;5;0;9
16019;Žiedas;Varpeliai;5628720422;Taip;0;6;0;6
16020;Žiedas;Varpeliai;1582961378;Taip;2;0;1;3
16021;Žiedas;Varpeliai;1878050384;Ne;6;0;0;6
16022;Žiedas;Varpeliai;6882614465;Taip;0;2;0;2
16023;Žiedas;Varpeliai;5578227349;Taip;12;2;0;14
16024;Žiedas;Varpeliai;6914059680;Taip;0;1;0;1
16025;Žiedas;Varpeliai;7771247056;Taip;0;1;0;1
16026;Žiedas;Varpeliai;6515510381;Taip;11;0;0;11
16027;Žiedas;Varpeliai;3842589827;Taip;11;0;5;16
16028;Žiedas;Varpeliai;5835309107;Taip;13;1;0;14
16029;Žiedas;Varpeliai;3387263016;Ne;5;0;0;5
16030;Žiedas;Varpeliai;3178580610;Taip;3;1;0;4
16031;Žiedas;Varpeliai;1043230748;Taip;0;1;8;9
16032;Žiedas;Varpeliai;5061575884;Taip;18;0;0;18
16033;Žiedas;Varpeliai;1333233100;Ne;3;7;0;10
16034;Žiedas;Varpeliai;9020540780;Taip;10;0;0;10
16035;Žiedas;Varpeliai;8148831014;Taip;10;0;0;10
16036;Žiedas;Varpeliai;9140396365;Taip;0;0;1;1
16037;Žiedas;Ramunėlės;3055218791;Taip;6;2;0;8
16038;Žiedas;Ramunėlės;1333555044;Taip;9;3;0;12
16039;Žiedas;Ramunėlės;2092319455;Taip;4;4;0;8
16040;Žiedas;Ramunėlės;5789261620;Taip;7;1;0;8
16041;Žiedas;Ramunėlės;8753972322;Taip;0;8;0;8
16042;Žiedas;Ramunėlės;3900091129;Ne;3;15;0;18
16043;Žiedas;Ramunėlės;2515028280;Taip;14;6;0;20
16044;Žiedas;Ramunėlės;1583038469;Taip;13;3;0;16
16045;Žiedas;Ramunėlės;8208331527;Taip;5;3;0;8
16046;Žiedas;Ramunėlės;9037835899;Taip;9;2;0;11
16047;Žiedas;Ramunėlės;5577339739;Taip;9;2;2;13
16048;Žiedas;Ramunėlės;6884933845;Taip;9;0;0;9
16049;Žiedas;Ramunėlės;7548653053;Taip;11;1;0;12
16050;Žiedas;Ramunėlės;1659873036;Taip;21;5;0;26
16051;Žiedas;Ramunėlės;2843328732;Taip;6;3;1;10
16052;Žiedas;Ramunėlės;1243169901;Taip;12;0;0;12
16053;Žiedas;Ramunėlės;1580781723;Taip;15;2;0;17
16054;Žiedas;Ramunėlės;5920211041;Ne;13;1;0;14
16055;Žiedas;Ramunėlės;4933650089;Taip;1;2;0;3
16056;Žiedas;Ramunėlės;4044156905;Taip;6;3;2;11
16057;Žiedas;Ramunėlės;4844442247;Taip;11;4;0;15
16058;Žiedas;Ramunėlės;7294671324;Taip;13;0;0;13
16059;Žiedas;Ramunėlės;8812316692;Taip;9;2;0;11
16060;Žiedas;Pakalnutės;7798930533;Ne;14;1;0;15
16061;Žiedas;Pakalnutės;1094506858;Ne;4;4;0;8
16062;Žiedas;Pakalnutės;9375048835;Taip;0;7;0;7
16063;Žiedas;Pakalnutės;5266048033;Taip;9;7;0;16
16064;Žiedas;Pakalnutės;5804334198;Taip;3;0;0;3
16065;Žiedas;Pakalnutės;1721956438;Ne;11;3;0;14
16066;Žiedas;Pakalnutės;4808020243;Taip;5;1;0;6
16067;Žiedas;Pakalnutės;3742949697;Taip;9;3;0;12
16068;Žiedas;Pakalnutės;6343634478;Taip;6;6;0;12
16069;Žiedas;Pakalnutės;8015880569;Taip;14;0;0;14
16070;Žiedas;Pakalnutės;8857150598;Taip;5;4;0;9
16071;Žiedas;Pakalnutės;2416234016;Taip;7;3;0;10
16072;Žiedas;Pakalnutės;9054709268;Taip;0;6;0;6
16073;Žiedas;Pakalnutės;9964883646;Taip;4;2;1;7
16074;Žiedas;Pakalnutės;4917324037;Taip;0;6;0;6
16075;Žiedas;Pakalnutės;4021189767;Taip;6;2;0;8
16076;Žiedas;Pakalnutės;1346658299;Taip;6;2;0;8
16077;Žiedas;Pakalnutės;4697477761;Taip;6;1;0;7
16078;Žiedas;Pakalnutės;7678333395;Taip;5;1;0;6
16079;Žiedas;Pakalnutės;9207945616;Taip;5;6;0;11
16080;Žiedas;Pakalnutės;7221702677;Ne;8;0;0;8
16081;Žiedas;Pakalnutės;2393112381;Taip;0;4;0;4
16082;Žiedas;Rožytės;8645771800;Taip;0;0;4;4
16083;Žiedas;Rožytės;7942276632;Ne;14;1;0;15
16084;Žiedas;Rožytės;7799489700;Taip;14;6;0;20
16085;Žiedas;Rožytės;8163645535;Taip;12;2;0;14
16086;Žiedas;Rožytės;8927034492;Taip;0;0;22;22
16087;Žiedas;Rožytės;2182381160;Taip;22;0;0;22
16088;Žiedas;Rožytės;8822472312;Taip;14;3;0;17
16089;Žiedas;Rožytės;9021286246;Taip;10;6;0;16
16090;Žiedas;Rožytės;6261847845;Taip;9;0;0;9
16091;Žiedas;Rožytės;5020148822;Taip;14;0;0;14
16092;Žiedas;Rožytės;1777501190;Taip;7;4;0;11
16093;Žiedas;Rožytės;1844621525;Ne;9;1;0;10
16094;Žiedas;Rožytės;1219634640;Ne;0;0;4;4
16095;Žiedas;Rožytės;6459679214;Taip;5;10;0;15
16096;Žiedas;Rožytės;7672879525;Taip;0;3;0;3
16097;Žiedas;Rožytės;6175213274;Taip;10;0;0;10
16098;Žiedas;Rožytės;3984607857;Taip;14;3;0;17
16099;Žiedas;Rožytės;6041919197;Taip;11;3;0;14
16100;Žiedas;Pumpurėliai;5830738378;Taip;0;1;1;2
16101;Žiedas;Pumpurėliai;2320543511;Taip;8;4;0;12
16102;Žiedas;Pumpurėliai;4360175072;Taip;3;0;5;8
16103;Žiedas;Pumpurėliai;9238553024;Taip;7;0;0;7
16104;Žiedas;Pumpurėliai;7780469974;Taip;6;3;0;9
16105;Žiedas;Pumpurėliai;8056265378;Ne;21;1;0;22
16106;Žiedas;Pumpurėliai;9337317396;Taip;2;3;2;7
16107;Žiedas;Pumpurėliai;1086714229;Taip;14;2;0;16
16108;Žiedas;Pumpurėliai;2320411618;Taip;9;4;0;13
16109;Žiedas;Pumpurėliai;5635958124;Taip;8;6;0;14
16110;Žiedas;Pumpurėliai;7677595571;Taip;7;2;6;15
16111;Žiedas;Pumpurėliai;4699833757;Taip;4;3;0;7
16112;Žiedas;Pumpurėliai;2633676360;Taip;3;1;2;6
16113;Žiedas;Pumpurėliai;8797245208;Ne;9;0;1;10
16114;Žiedas;"Dobiliukai ";6066566242;Taip;0;2;10;12
16115;Žiedas;"Dobiliukai ";8436592169;Taip;12;0;0;12
16116;Žiedas;"Dobiliukai ";3654878543;Taip;14;0;0;14
16117;Žiedas;"Dobiliukai ";8794003030;Taip;9;0;0;9
16118;Žiedas;"Dobiliukai ";8444690698;Taip;15;0;0;15
16119;Žiedas;"Dobiliukai ";2715554681;Ne;20;0;0;20
16120;Žiedas;"Dobiliukai ";2132564079;Taip;10;0;3;13
16121;Žiedas;"Dobiliukai ";9586578606;Taip;0;12;0;12
16122;Žiedas;"Dobiliukai ";3940002957;Ne;9;1;0;10
16123;Žiedas;"Dobiliukai ";5353507617;Taip;13;2;0;15
16124;Žiedas;"Dobiliukai ";4087903129;Taip;0;7;0;7
16125;Žiedas;"Dobiliukai ";8185042446;Taip;0;0;8;8
16126;Žiedas;"Dobiliukai ";7049399327;Ne;10;0;4;14
16127;Žiedas;"Dobiliukai ";5788152675;Taip;15;0;0;15
16128;Žiedas;"Dobiliukai ";2462497997;Taip;12;0;0;12
16129;Žiedas;"Dobiliukai ";3011163947;Taip;15;0;0;15
16130;Žiedas;"Dobiliukai ";6748378606;Taip;12;2;3;17
16131;Žiedas;"Dobiliukai ";7558307454;Taip;8;0;0;8
16132;Žiedas;"Dobiliukai ";6795173519;Taip;15;0;0;15
16133;Žiedas;RŪTELĖS;2134466899;Taip;10;2;0;12
16134;Žiedas;RŪTELĖS;6822887260;Taip;0;3;0;3
16135;Žiedas;RŪTELĖS;5914428064;Ne;0;10;0;10
16136;Žiedas;RŪTELĖS;3857121753;Taip;15;2;0;17
16137;Žiedas;RŪTELĖS;6443633568;Taip;8;5;1;14
16138;Žiedas;RŪTELĖS;5959899914;Taip;8;2;0;10
16139;Žiedas;RŪTELĖS;7333813704;Taip;4;2;2;8
16140;Žiedas;RŪTELĖS;6658762922;Taip;0;4;0;4
16141;Žiedas;RŪTELĖS;5703750436;Taip;4;1;0;5
16142;Žiedas;RŪTELĖS;5126173608;Taip;2;4;0;6
16143;Žiedas;RŪTELĖS;1738121071;Taip;5;10;0;15
16144;Žiedas;RŪTELĖS;5420327672;Taip;5;2;0;7
16145;Žiedas;RŪTELĖS;1253833615;Taip;8;4;0;12
16146;Žiedas;RŪTELĖS;7172793351;Taip;7;1;0;8
16147;Žiedas;RŪTELĖS;4497634040;Taip;0;1;0;1
16148;Žiedas;RŪTELĖS;9218388800;Taip;10;3;0;13
16149;Žiedas;RŪTELĖS;7072578987;Taip;16;3;0;19
16150;Žiedas;RŪTELĖS;3715928992;Ne;0;2;4;6
16151;Žiedas;RŪTELĖS;9352485926;Taip;7;1;0;8
16152;Žiedas;RŪTELĖS;7578964555;Taip;5;5;0;10
16153;Žiedas;RŪTELĖS;5647232875;Taip;9;0;0;9
16154;Žiedas;RŪTELĖS;5928377774;Taip;11;1;0;12
16155;Žiedas;SAULĖGRĄŽOS;1011602827;Taip;0;3;5;8
16156;Žiedas;SAULĖGRĄŽOS;8887021328;Taip;14;0;0;14
16157;Žiedas;SAULĖGRĄŽOS;2932857132;Taip;12;1;1;14
16158;Žiedas;SAULĖGRĄŽOS;5552786845;Taip;13;4;0;17
16159;Žiedas;SAULĖGRĄŽOS;8833895006;Taip;14;4;0;18
16160;Žiedas;SAULĖGRĄŽOS;5658235821;Taip;14;0;0;14
16161;Žiedas;SAULĖGRĄŽOS;4992446383;Taip;9;5;0;14
16162;Žiedas;SAULĖGRĄŽOS;9057761408;Taip;6;0;0;6
16163;Žiedas;SAULĖGRĄŽOS;1645402434;Taip;10;0;0;10
16164;Žiedas;SAULĖGRĄŽOS;2026540724;Taip;14;3;0;17
16165;Žiedas;SAULĖGRĄŽOS;4564268323;Taip;5;9;1;15
16166;Žiedas;SAULĖGRĄŽOS;8801900486;Taip;0;3;19;22
16167;Žiedas;SAULĖGRĄŽOS;1609487830;Taip;9;3;1;13
16168;Žiedas;SAULĖGRĄŽOS;3437651010;Taip;14;3;0;17
16169;Žiedas;SAULĖGRĄŽOS;3422053505;Taip;15;1;0;16
16170;Žiedas;SAULĖGRĄŽOS;5274845525;Taip;15;0;0;15
16171;Žiedas;SAULĖGRĄŽOS;6053010050;Taip;5;0;0;5
16172;Žiedas;SAULĖGRĄŽOS;7057747531;Taip;5;0;0;5
16173;Žiedas;SAULĖGRĄŽOS;9685152753;Taip;11;1;0;12
16174;Žiedas;SAULĖGRĄŽOS;8819018248;Taip;9;4;0;13
16175;Žiedas;SAULĖGRĄŽOS;7604200899;Taip;3;1;0;4
16176;Žiedas;SAULĖGRĄŽOS;3303581707;Taip;7;2;0;9
16177;Žiedas;RUGIAGĖLĖS;1035854293;Taip;0;0;5;5
16178;Žiedas;RUGIAGĖLĖS;1917085385;Taip;9;4;0;13
16179;Žiedas;RUGIAGĖLĖS;5987689515;Taip;20;0;0;20
16180;Žiedas;RUGIAGĖLĖS;1826599535;Taip;4;1;2;7
16181;Žiedas;RUGIAGĖLĖS;3477341028;Taip;6;11;0;17
16182;Žiedas;RUGIAGĖLĖS;2124086277;Taip;4;2;4;10
16183;Žiedas;RUGIAGĖLĖS;2642760082;Taip;0;4;0;4
16184;Žiedas;RUGIAGĖLĖS;1093479755;Taip;12;0;0;12
16185;Žiedas;RUGIAGĖLĖS;7381658912;Taip;4;2;2;8
16186;Žiedas;RUGIAGĖLĖS;2964286644;Ne;0;0;22;22
16187;Žiedas;RUGIAGĖLĖS;7228139235;Taip;2;2;0;4
16188;Žiedas;RUGIAGĖLĖS;2347857813;Taip;0;22;0;22
16189;Žiedas;RUGIAGĖLĖS;1975718197;Taip;4;0;0;4
16190;Žiedas;RUGIAGĖLĖS;2312361963;Taip;0;0;22;22
16191;Žiedas;RUGIAGĖLĖS;6859410675;Taip;10;8;0;18
16192;Žiedas;RUGIAGĖLĖS;2148027253;Taip;7;2;0;9
16193;Žiedas;RUGIAGĖLĖS;1758868055;Taip;0;1;2;3
16194;Žiedas;RUGIAGĖLĖS;2182340305;Taip;10;0;0;10
16195;Žiedas;RUGIAGĖLĖS;1958481432;Taip;3;0;0;3
16196;Žiedas;RUGIAGĖLĖS;3099608553;Taip;22;0;0;22
16197;Žiedas;RUGIAGĖLĖS;1390431397;Taip;10;1;0;11
16198;Žiedas;RUGIAGĖLĖS;9393499257;Taip;3;3;0;6
16199;Žiedas;RUGIAGĖLĖS;2170318597;Ne;2;5;0;7
16200;Žiedas;RUGIAGĖLĖS;8276022676;Taip;2;2;1;5
16201;Žiedas;RUGIAGĖLĖS;7584712202;Taip;3;2;0;5
16202;Žiedas;Boružėlės;4922560649;Taip;11;0;0;11
16203;Žiedas;Boružėlės;2095655987;Taip;10;6;0;16
16204;Žiedas;Boružėlės;7814504623;Taip;10;3;0;13
16205;Žiedas;Boružėlės;9648580306;Taip;4;5;0;9
16206;Žiedas;Boružėlės;9699668892;Taip;0;3;0;3
16207;Žiedas;Boružėlės;5653785844;Taip;7;1;0;8
16208;Žiedas;Boružėlės;9247088735;Taip;16;0;1;17
16209;Žiedas;Boružėlės;7396006218;Taip;0;5;0;5
16210;Žiedas;Boružėlės;5588136738;Taip;0;8;0;8
16211;Žiedas;Boružėlės;6786526552;Taip;8;0;0;8
16212;Žiedas;Boružėlės;2511423525;Taip;0;0;2;2
16213;Žiedas;Boružėlės;6432090199;Taip;17;0;0;17
16214;Žiedas;Boružėlės;5626494892;Taip;3;1;0;4
16215;Žiedas;Boružėlės;7954517383;Taip;10;3;0;13
16216;Žiedas;Boružėlės;3702078720;Taip;5;3;1;9
16217;Žiedas;Boružėlės;2849254119;Ne;15;4;0;19
16218;Žiedas;Boružėlės;9736967156;Taip;10;2;0;12
16219;Žiedas;Boružėlės;3586376571;Taip;3;5;0;8
16220;Žiedas;Boružėlės;1139186052;Taip;8;1;0;9
16221;Žiedas;Boružėlės;3704491209;Taip;13;0;1;14
16222;Žiedas;AGUONĖLĖS;1885623466;Taip;17;0;0;17
16223;Žiedas;AGUONĖLĖS;9464217926;Taip;18;0;0;18
16224;Žiedas;AGUONĖLĖS;9543860953;Taip;12;0;0;12
16225;Žiedas;AGUONĖLĖS;3247328978;Taip;9;2;1;12
16226;Žiedas;AGUONĖLĖS;4250009129;Taip;13;2;0;15
16227;Žiedas;AGUONĖLĖS;7399937598;Taip;15;0;0;15
16228;Žiedas;AGUONĖLĖS;1325715061;Taip;8;0;0;8
16229;Žiedas;AGUONĖLĖS;9111149805;Taip;11;0;0;11
16230;Žiedas;AGUONĖLĖS;4695900874;Taip;11;0;0;11
16231;Žiedas;AGUONĖLĖS;3258241663;Taip;6;0;0;6
16232;Žiedas;AGUONĖLĖS;6700593422;Taip;22;0;0;22
16233;Žiedas;AGUONĖLĖS;3835714894;Taip;7;0;0;7
16234;Žiedas;AGUONĖLĖS;7535993061;Taip;13;1;0;14
16235;Žiedas;AGUONĖLĖS;1956219718;Taip;8;2;0;10
16236;Žiedas;AGUONĖLĖS;4809093267;Taip;17;0;0;17
16237;Žiedas;AGUONĖLĖS;1874460511;Taip;0;0;1;1
16238;Žiedas;AGUONĖLĖS;6245366671;Taip;26;0;0;26
16239;Žiedas;AGUONĖLĖS;6856477482;Taip;22;0;0;22
16240;Žiedas;ŽIBUTĖS;8638720939;Taip;9;0;1;10
16241;Žiedas;ŽIBUTĖS;3654749109;Taip;0;5;0;5
16242;Žiedas;ŽIBUTĖS;4039958043;Taip;16;0;0;16
16243;Žiedas;ŽIBUTĖS;1835893385;Taip;17;2;0;19
16244;Žiedas;ŽIBUTĖS;2913328259;Taip;9;0;0;9
16245;Žiedas;ŽIBUTĖS;7418985667;Taip;5;3;0;8
16246;Žiedas;ŽIBUTĖS;4568189195;Ne;7;0;2;9
16247;Žiedas;ŽIBUTĖS;2097392327;Taip;9;5;0;14
16248;Žiedas;ŽIBUTĖS;9269909624;Taip;5;4;0;9
16249;Žiedas;ŽIBUTĖS;7114207461;Taip;10;1;3;14
16250;Žiedas;ŽIBUTĖS;5106427067;Taip;10;4;0;14
16251;Žiedas;ŽIBUTĖS;3407247493;Taip;3;1;4;8
16252;Žiedas;ŽIBUTĖS;8084555994;Taip;10;3;3;16
16253;Žiedas;ŽIBUTĖS;7613786936;Taip;0;14;0;14
16254;Žiedas;ŽIBUTĖS;6923562927;Taip;22;0;0;22
16255;Žiedas;ŽIBUTĖS;1669599543;Taip;15;0;1;16
16256;Žiedas;ŽIBUTĖS;1509140770;Taip;11;0;0;11
16257;Žiedas;ŽIBUTĖS;7498211984;Taip;9;5;0;14
16258;Žiedas;ŽIBUTĖS;3948942801;Taip;0;4;0;4
16259;Žiedas;DRUGELIAI;8517250094;Taip;0;11;0;11
16260;Žiedas;DRUGELIAI;9894489800;Taip;11;0;0;11
16261;Žiedas;DRUGELIAI;2763469583;Taip;5;2;0;7
16262;Žiedas;DRUGELIAI;9757771445;Taip;0;19;0;19
16263;Žiedas;DRUGELIAI;4222689492;Ne;8;1;0;9
16264;Žiedas;DRUGELIAI;2763996098;Taip;22;0;0;22
16265;Žiedas;DRUGELIAI;4983852075;Ne;0;6;0;6
16266;Žiedas;DRUGELIAI;9129315784;Taip;12;5;0;17
16267;Žiedas;DRUGELIAI;7952899220;Taip;7;6;0;13
16268;Žiedas;DRUGELIAI;2679205188;Ne;0;3;4;7
16269;Žiedas;DRUGELIAI;2026462074;Taip;10;1;0;11
16270;Žiedas;DRUGELIAI;4749655084;Taip;5;1;1;7
16271;Žiedas;DRUGELIAI;9587581470;Taip;0;3;0;3
16272;Žiedas;DRUGELIAI;9415269410;Ne;4;4;0;8
16273;Žilvitis;ŽIOGELIAI;1681949015;Taip;5;0;0;5
16274;Žilvitis;ŽIOGELIAI;8776206514;Ne;9;0;0;9
16275;Žilvitis;ŽIOGELIAI;1494531594;Taip;6;0;0;6
16276;Žilvitis;ŽIOGELIAI;4206900881;Taip;7;0;0;7
16277;Žilvitis;ŽIOGELIAI;3753646163;Taip;11;0;0;11
16278;Žilvitis;KREGŽDUTĖS;2566267415;Taip;5;0;0;5
16279;Žilvitis;KREGŽDUTĖS;2340002881;Taip;15;0;0;15
16280;Žilvitis;KREGŽDUTĖS;9192673832;Taip;8;0;0;8
16281;Žilvitis;BORUŽĖLĖS;6048530704;Taip;5;0;0;5
16282;Žilvitis;KIŠKIUKAI;82960228242;Taip;5;0;0;5
16283;Žilvitis;BITUČIŲ;9102284379;Taip;5;0;0;5
16284;Žilvitis;BITUČIŲ;8237473897;Taip;10;0;0;10
16285;Žilvitis;BITUČIŲ;1968616253;Taip;10;0;0;10
16286;Žilvitis;BITUČIŲ;4158933782;Taip;8;0;0;8
16287;Žilvitis;BITUČIŲ;2747099559;Taip;7;0;0;7
16288;Žilvitis;BITUČIŲ;9780232059;Taip;10;0;0;10
16289;Žilvitis;BITUČIŲ;7054808979;Ne;10;0;0;10
16290;Žilvitis;KATINĖLIŲ;63557403647;Taip;5;0;0;5
16291;Žilvitis;MEŠKIUKŲ;8176348935;Taip;16;0;0;16
16292;Žilvitis;MEŠKIUKŲ;3216967815;Taip;18;0;0;18
16293;Žilvitis;VOVERIUKAI;7825739323;Taip;9;0;0;9
16294;Žilvitis;VOVERIUKAI;2445903681;Taip;9;0;0;9
16295;Žilvitis;VOVERIUKAI;8966682808;Taip;9;0;0;9
16296;Žilvitis;VOVERIUKAI;8931585095;Taip;18;0;0;18
16297;Žilvitis;VOVERIUKAI;1310073061;Taip;17;0;0;17
16298;Žilvitis;SVAJOKLIAI;3984219150;Taip;3;0;0;3
16299;Žilvitis;SVAJOKLIAI;9495417427;Taip;5;0;0;5
16300;Žilvitis;SVAJOKLIAI;1139159071;Taip;8;0;0;8
16301;Žilvitis;SVAJOKLIAI;3459612961;Taip;9;0;0;9
16302;Žilvitis;PELĖDŽIUKAI;1248507608;Taip;10;0;0;10
16303;Žilvitis;PELĖDŽIUKAI;2502326158;Taip;3;0;0;3
16304;Žilvitis;PELĖDŽIUKAI;2908294931;Taip;20;0;0;20
16305;Žilvitis;LAŠELIAI;8324405560;Taip;14;0;0;14
16306;Žilvitis;LAŠELIAI;7087311769;Taip;5;0;0;5
16307;Žilvitis;LAŠELIAI;5372458087;Taip;15;0;0;15
16308;Žilvitis;LAŠELIAI;3122232547;Taip;7;0;0;7
16309;Žilvitis;SKRUZDĖLIUKAI;9319247575;Taip;2;0;0;2
16310;Žilvitis;SKRUZDĖLIUKAI;6323451037;Taip;7;0;0;7
16311;Žilvitis;SKRUZDĖLIUKAI;5152056691;Taip;4;0;0;4
16312;Žilvinėlio;SAULUTĖS;9774076824;Taip;10;0;0;10
16313;Žilvinėlio;SAULUTĖS;93987159767;Taip;5;0;0;5
16314;Žilvinėlio;SAULUTĖS;7121926191;Taip;5;0;0;5
16315;Žilvinėlio;RAMUNIUKAI;3308355684;Taip;20;0;0;20
16316;Žilvinėlio;RAMUNIUKAI;3225180564;Taip;9;0;0;9
16317;Žilvinėlio;ŽUVYČIŲ;6380359918;Taip;10;0;0;10
16318;Žilvinėlio;ŽUVYČIŲ;4232223600;Taip;5;0;0;5
16319;Žilvinėlio;EGLUTĖS;7919935370;Taip;9;0;0;9
16320;Žilvinėlio;GINTARĖLIAI;6902924243;Taip;11;0;0;11
16321;Žilvinėlio;GINTARĖLIAI;5870873341;Ne;15;0;0;15
16322;Žilvinėlio;PAUKŠTELIAI;2921485707;Taip;10;0;0;10
16323;Žilvinėlio;DREBULIUKAI;5444902879;Taip;16;0;0;16
16324;Žilvinėlio;DREBULIUKAI;4621511107;Ne;6;0;0;6
16325;Žilvinėlio;ĄŽUOLIUKAI;8326996805;Taip;16;0;0;16
16326;Žilvinėlio;ĄŽUOLIUKAI;9347663648;Taip;9;0;0;9
16327;Žilvinėlio;DRUGELIAI;6861762242;Taip;25;0;0;25
16328;Žilvinėlio;DRUGELIAI;7629852556;Taip;1;0;0;1
16329;Žilvinėlio;DRUGELIAI;2842693420;Taip;11;0;0;11
16330;Žiogelis;SKRUZDELYTĖS;2959983278;Taip;10;0;4;14
16331;Žiogelis;SKRUZDELYTĖS;4677024422;Taip;4;0;1;5
16332;Žiogelis;SKRUZDELYTĖS;6165380986;Taip;4;0;1;5
16333;Žiogelis;SKRUZDELYTĖS;5281321968;Taip;6;0;0;6
16334;Žiogelis;SKRUZDELYTĖS;8410428124;Taip;10;0;0;10
16335;Žiogelis;SKRUZDELYTĖS;3214640817;Taip;19;0;0;19
16336;Žiogelis;SKRUZDELYTĖS;1937740173;Taip;5;4;0;9
16337;Žiogelis;SKRUZDELYTĖS;4115425880;Taip;6;4;0;10
16338;Žiogelis;SKRUZDELYTĖS;5737326104;Taip;11;0;0;11
16339;Žiogelis;SKRUZDELYTĖS;2614574694;Ne;7;0;0;7
16340;Žiogelis;SKRUZDELYTĖS;7107814348;Taip;6;4;0;10
16341;Žiogelis;SKRUZDELYTĖS;9243862028;Taip;9;1;0;10
16342;Žiogelis;SKRUZDELYTĖS;7395901559;Taip;7;0;0;7
16343;Žiogelis;SKRUZDELYTĖS;9819352425;Ne;14;0;2;16
16344;Žiogelis;SKRUZDELYTĖS;8780773039;Taip;7;8;0;15
16345;Žiogelis;SKRUZDELYTĖS;7881734492;Taip;5;0;2;7
16346;Žiogelis;SKRUZDELYTĖS;2701091043;Taip;5;0;0;5
16347;Žiogelis;SKRUZDELYTĖS;9330018409;Taip;4;0;0;4
16348;Žiogelis;SKRUZDELYTĖS;9120836406;Taip;5;0;2;7
16349;Žiogelis;SKRUZDELYTĖS;6742462116;Ne;11;0;3;14
16350;Žiogelis;SKRUZDELYTĖS;8763533677;Ne;22;0;3;25
16351;Žiogelis;SKRUZDELYTĖS;6608146625;Taip;4;0;0;4
16352;Žiogelis;SKRUZDELYTĖS;9035254979;Taip;11;0;4;15
16353;Žiogelis;ŽIRNIUKAI;2348525913;Taip;27;0;0;27
16354;Žiogelis;ŽIRNIUKAI;2771911603;Taip;7;0;0;7
16355;Žiogelis;ŽIRNIUKAI;6617995346;Taip;3;0;1;4
16356;Žiogelis;ŽIRNIUKAI;7936785905;Ne;0;1;0;1
16357;Žiogelis;ŽIRNIUKAI;9142952548;Taip;4;1;0;5
16358;Žiogelis;ŽIRNIUKAI;4450344120;Taip;7;0;4;11
16359;Žiogelis;ŽIRNIUKAI;8998694866;Taip;9;0;3;12
16360;Žiogelis;ŽIRNIUKAI;3472310047;Taip;5;1;0;6
16361;Žiogelis;ŽIRNIUKAI;8018943297;Taip;1;0;0;1
16362;Žiogelis;ŽIRNIUKAI;8038242532;Taip;12;0;0;12
16363;Žiogelis;ŽIRNIUKAI;9421670525;Taip;4;4;0;8
16364;Žiogelis;ŽIRNIUKAI;2463360858;Taip;5;0;1;6
16365;Žiogelis;ŽIRNIUKAI;1067136657;Taip;13;0;1;14
16366;Žiogelis;ŽIRNIUKAI;5337641310;Taip;4;3;0;7
16367;Žiogelis;ŽIRNIUKAI;4755709634;Taip;8;0;0;8
16368;Žiogelis;ŽIRNIUKAI;2833768296;Taip;6;0;1;7
16369;Žiogelis;ŽIRNIUKAI;6857937795;Taip;13;1;0;14
16370;Žiogelis;ŽIRNIUKAI;9918493914;Taip;16;0;0;16
16371;Žiogelis;ŽIRNIUKAI;3516143432;Taip;14;2;4;20
16372;Žiogelis;ŽIRNIUKAI;5223426277;Taip;16;0;0;16
16373;Žiogelis;DOBILĖLIAI;8683148826;Taip;0;17;0;17
16374;Žiogelis;DOBILĖLIAI;2117192553;Taip;0;4;0;4
16375;Žiogelis;DOBILĖLIAI;1190395481;Taip;0;8;0;8
16376;Žiogelis;DOBILĖLIAI;1465027680;Taip;0;0;3;3
16377;Žiogelis;DOBILĖLIAI;6495456608;Taip;0;1;0;1
16378;Žiogelis;DOBILĖLIAI;5364996984;Taip;14;0;0;14
16379;Žiogelis;DOBILĖLIAI;9568208184;Taip;14;0;0;14
16380;Žiogelis;DOBILĖLIAI;6340620973;Ne;0;5;4;9
16381;Žiogelis;DOBILĖLIAI;5961630249;Taip;0;1;0;1
16382;Žiogelis;DOBILĖLIAI;6532218580;Taip;3;0;0;3
16383;Žiogelis;DOBILĖLIAI;1763070523;Ne;0;1;0;1
16384;Žiogelis;DOBILĖLIAI;5911231906;Taip;9;3;0;12
16385;Žiogelis;DOBILĖLIAI;9610249055;Taip;0;2;0;2
16386;Žiogelis;DOBILĖLIAI;6115834138;Taip;12;0;0;12
16387;Žiogelis;DOBILĖLIAI;3887222613;Taip;7;7;0;14
16388;Žiogelis;DOBILĖLIAI;8485067381;Taip;0;4;0;4
16389;Žiogelis;DOBILĖLIAI;7065052244;Taip;14;0;1;15
16390;Žiogelis;DOBILĖLIAI;3427704550;Ne;0;1;0;1
16391;Žiogelis;DOBILĖLIAI;4103035195;Taip;11;0;0;11
16392;Žiogelis;DOBILĖLIAI;3392582853;Taip;0;2;0;2
16393;Žiogelis;DOBILĖLIAI;5557800297;Taip;0;1;0;1
16394;Žiogelis;BORUŽĖLĖS;9295720241;Taip;2;0;1;3
16395;Žiogelis;BORUŽĖLĖS;24941867247;Taip;3;4;0;7
16396;Žiogelis;BORUŽĖLĖS;8819549855;Ne;25;1;0;26
16397;Žiogelis;BORUŽĖLĖS;3189872952;Taip;5;2;0;7
16398;Žiogelis;BORUŽĖLĖS;2883732914;Taip;4;4;0;8
16399;Žiogelis;BORUŽĖLĖS;3503872654;Taip;4;3;4;11
16400;Žiogelis;BORUŽĖLĖS;4445888917;Taip;9;3;0;12
16401;Žiogelis;BORUŽĖLĖS;7881358741;Taip;0;2;0;2
16402;Žiogelis;BORUŽĖLĖS;8702710674;Taip;0;7;0;7
16403;Žiogelis;BORUŽĖLĖS;4671356872;Taip;4;0;0;4
16404;Žiogelis;BORUŽĖLĖS;18018505301;Taip;7;0;0;7
16405;Žiogelis;BORUŽĖLĖS;3750023611;Taip;6;0;0;6
16406;Žiogelis;BORUŽĖLĖS;4343510173;Taip;9;9;0;18
16407;Žiogelis;BORUŽĖLĖS;6659086172;Taip;6;3;0;9
16408;Žiogelis;BORUŽĖLĖS;95713316600;Taip;3;1;0;4
16409;Žiogelis;BORUŽĖLĖS;3203359908;Taip;4;4;0;8
16410;Žiogelis;BORUŽĖLĖS;3320077143;Taip;7;1;0;8
16411;Žiogelis;BORUŽĖLĖS;60959051938;Taip;0;1;0;1
16412;Žiogelis;BORUŽĖLĖS;1609336147;Taip;11;0;0;11
16413;Žiogelis;BORUŽĖLĖS;6346503991;Taip;7;3;5;15
16414;Žiogelis;BORUŽĖLĖS;3560637865;Taip;13;3;0;16
16415;Žiogelis;BORUŽĖLĖS;3420228264;Taip;5;0;0;5
16416;Žiogelis;BORUŽĖLĖS;1996517542;Taip;17;2;0;19
16417;Žiogelis;BORUŽĖLĖS;6760074113;Ne;5;0;4;9
16418;Žiogelis;DRUGELIAI;2797078863;Taip;20;3;0;23
16419;Žiogelis;DRUGELIAI;3813592739;Taip;9;0;0;9
16420;Žiogelis;DRUGELIAI;3820406417;Taip;17;3;0;20
16421;Žiogelis;DRUGELIAI;9533670829;Ne;6;2;2;10
16422;Žiogelis;DRUGELIAI;1673279182;Taip;14;7;0;21
16423;Žiogelis;DRUGELIAI;9964121573;Taip;14;1;2;17
16424;Žiogelis;DRUGELIAI;5104952346;Taip;7;0;0;7
16425;Žiogelis;DRUGELIAI;9431525960;Taip;16;0;0;16
16426;Žiogelis;DRUGELIAI;9717527407;Taip;7;0;1;8
16427;Žiogelis;DRUGELIAI;2622354022;Taip;19;3;0;22
16428;Žiogelis;DRUGELIAI;7462316396;Taip;10;6;0;16
16429;Žiogelis;DRUGELIAI;2243541285;Taip;15;3;0;18
16430;Žiogelis;DRUGELIAI;3810309354;Taip;15;0;0;15
16431;Žiogelis;DRUGELIAI;2326799191;Ne;10;0;0;10
16432;Žiogelis;DRUGELIAI;7974212517;Taip;12;2;0;14
16433;Žiogelis;DRUGELIAI;9423979719;Taip;12;2;0;14
16434;Žiogelis;DRUGELIAI;1833992163;Ne;12;0;0;12
16435;Žiogelis;DRUGELIAI;2529171444;Taip;0;5;0;5
16436;Žiogelis;DRUGELIAI;4946802677;Taip;10;0;0;10
16437;Žiogelis;PELĖDŽIUKAI;4156736676;Taip;6;1;0;7
16438;Žiogelis;PELĖDŽIUKAI;7128248940;Taip;5;1;0;6
16439;Žiogelis;PELĖDŽIUKAI;6709029770;Taip;5;1;0;6
16440;Žiogelis;PELĖDŽIUKAI;7502572217;Taip;15;1;0;16
16441;Žiogelis;PELĖDŽIUKAI;1134384178;Taip;5;0;0;5
16442;Žiogelis;PELĖDŽIUKAI;5876904663;Taip;13;0;0;13
16443;Žiogelis;PELĖDŽIUKAI;8217782981;Taip;9;5;0;14
16444;Žiogelis;PELĖDŽIUKAI;7120126547;Taip;0;2;0;2
16445;Žiogelis;PELĖDŽIUKAI;9387048672;Taip;8;8;0;16
16446;Žiogelis;PELĖDŽIUKAI;4378941619;Taip;14;0;0;14
16447;Žiogelis;PELĖDŽIUKAI;3937261260;Taip;9;3;0;12
16448;Žiogelis;PELĖDŽIUKAI;8873231715;Taip;5;0;0;5
16449;Žiogelis;PELĖDŽIUKAI;8894068297;Taip;0;4;0;4
16450;Žiogelis;PELĖDŽIUKAI;2759766559;Taip;5;8;0;13
16451;Žiogelis;PELĖDŽIUKAI;2160862681;Taip;10;1;0;11
16452;Žiogelis;PELĖDŽIUKAI;7725494899;Taip;7;4;0;11
16453;Žiogelis;PELĖDŽIUKAI;1939672072;Taip;5;0;3;8
16454;Žiogelis;PELĖDŽIUKAI;4565342104;Taip;8;0;0;8
16455;Žiogelis;PELĖDŽIUKAI;1223396469;Taip;0;3;2;5
16456;Žiogelis;PELĖDŽIUKAI;3500076229;Taip;0;2;5;7
16457;Žiogelis;PELĖDŽIUKAI;8715501524;Taip;16;1;0;17
16458;Žiogelis;VARPELIAI;7888873296;Taip;3;5;0;8
16459;Žiogelis;VARPELIAI;8262619320;Taip;0;1;0;1
16460;Žiogelis;VARPELIAI;3520393042;Ne;3;9;0;12
16461;Žiogelis;VARPELIAI;8983731310;Taip;6;4;0;10
16462;Žiogelis;VARPELIAI;1954544417;Ne;9;2;0;11
16463;Žiogelis;VARPELIAI;6716558946;Ne;14;0;0;14
16464;Žiogelis;VARPELIAI;1035890284;Ne;15;3;0;18
16465;Žiogelis;VARPELIAI;9385596579;Taip;3;3;0;6
16466;Žiogelis;VARPELIAI;1447349850;Taip;4;3;0;7
16467;Žiogelis;VARPELIAI;3752358694;Ne;10;2;0;12
16468;Žiogelis;VARPELIAI;6402784913;Ne;15;3;0;18
16469;Žiogelis;VARPELIAI;3502278745;Taip;0;1;0;1
16470;Žiogelis;VARPELIAI;4462189852;Taip;0;4;0;4
16471;Žiogelis;VARPELIAI;9470241656;Ne;22;0;0;22
16472;Žiogelis;VARPELIAI;8133583992;Ne;15;2;0;17
16473;Žiogelis;VARPELIAI;2346231162;Ne;9;3;0;12
16474;Žiogelis;VARPELIAI;6658457517;Ne;18;1;0;19
16475;Žiogelis;VARPELIAI;6650891980;Ne;9;0;0;9
16476;Žiogelis;VARPELIAI;5076511003;Ne;21;0;0;21
16477;Žiogelis;VARPELIAI;1139259000;Taip;17;0;0;17
16478;Žiogelis;VARPELIAI;7992701275;Taip;8;1;0;9
16479;Žiogelis;KREGŽDUTĖS;1309122110;Taip;7;0;0;7
16480;Žiogelis;KREGŽDUTĖS;7704256764;Taip;0;5;0;5
16481;Žiogelis;KREGŽDUTĖS;1235203700;Ne;0;4;0;4
16482;Žiogelis;KREGŽDUTĖS;6701809272;Taip;4;1;0;5
16483;Žiogelis;KREGŽDUTĖS;6697117406;Taip;11;0;0;11
16484;Žiogelis;KREGŽDUTĖS;2028383677;Taip;5;7;0;12
16485;Žiogelis;KREGŽDUTĖS;3910954904;Taip;0;17;0;17
16486;Žiogelis;KREGŽDUTĖS;2233244282;Taip;7;2;0;9
16487;Žiogelis;KREGŽDUTĖS;9862582346;Taip;11;1;0;12
16488;Žiogelis;KREGŽDUTĖS;9406830518;Taip;13;1;0;14
16489;Žiogelis;KREGŽDUTĖS;1320651707;Taip;4;9;0;13
16490;Žiogelis;KREGŽDUTĖS;85437321236;Taip;5;2;0;7
16491;Žiogelis;KREGŽDUTĖS;1320126836;Taip;10;1;0;11
16492;Žiogelis;KREGŽDUTĖS;3310492752;Taip;8;3;0;11
16493;Žiogelis;KREGŽDUTĖS;2366095661;Taip;4;1;0;5
16494;Žiogelis;KREGŽDUTĖS;8675451323;Taip;6;1;0;7
16495;Žiogelis;KREGŽDUTĖS;7087781379;Taip;0;4;0;4
16496;Žiogelis;KREGŽDUTĖS;4015109974;Taip;0;4;0;4
16497;Žiogelis;KREGŽDUTĖS;14932261911;Taip;0;6;0;6
16498;Žiogelis;KREGŽDUTĖS;4713696984;Taip;10;6;0;16
16499;Žiogelis;KREGŽDUTĖS;1442866468;Taip;8;4;0;12
16500;Žiogelis;KREGŽDUTĖS;1660784232;Ne;0;4;0;4
16501;Žiogelis;KREGŽDUTĖS;5579709130;Taip;11;1;0;12
16502;Žiogelis;KREGŽDUTĖS;9128728457;Ne;0;2;0;2
16503;Žiogelis;KREGŽDUTĖS;5340501392;Taip;18;0;0;18
16504;Žiogelis;KREGŽDUTĖS;8979747150;Taip;2;2;0;4
16505;Žiogelis;ŽVIRBLIUKAI;9769735869;Taip;6;1;0;7
16506;Žiogelis;ŽVIRBLIUKAI;1106149118;Taip;2;2;0;4
16507;Žiogelis;ŽVIRBLIUKAI;6284764694;Taip;7;2;1;10
16508;Žiogelis;ŽVIRBLIUKAI;9842311161;Taip;9;2;0;11
16509;Žiogelis;ŽVIRBLIUKAI;5475797764;Taip;24;0;0;24
16510;Žiogelis;ŽVIRBLIUKAI;2036243422;Taip;11;6;0;17
16511;Žiogelis;ŽVIRBLIUKAI;9634291623;Taip;10;1;0;11
16512;Žiogelis;ŽVIRBLIUKAI;7802165127;Taip;5;2;2;9
16513;Žiogelis;ŽVIRBLIUKAI;6491130711;Taip;0;0;2;2
16514;Žiogelis;ŽVIRBLIUKAI;9378236361;Taip;14;0;0;14
16515;Žiogelis;ŽVIRBLIUKAI;5445409452;Taip;14;0;0;14
16516;Žiogelis;ŽVIRBLIUKAI;4155916507;Taip;14;1;0;15
16517;Žiogelis;ŽVIRBLIUKAI;4623532521;Taip;5;1;0;6
16518;Žiogelis;ŽVIRBLIUKAI;6988180082;Taip;15;1;0;16
16519;Žiogelis;ŽVIRBLIUKAI;4677227753;Taip;15;1;0;16
16520;Žiogelis;ŽVIRBLIUKAI;9737574835;Taip;7;0;0;7
16521;Žiogelis;ŽVIRBLIUKAI;5996045442;Taip;17;1;0;18
16522;Žiogelis;BITUTĖS;4814936645;Taip;0;1;0;1
16523;Žiogelis;BITUTĖS;3752355139;Taip;0;3;0;3
16524;Žiogelis;BITUTĖS;2173494736;Taip;0;0;5;5
16525;Žiogelis;BITUTĖS;6347738933;Taip;5;6;0;11
16526;Žiogelis;BITUTĖS;9627583831;Taip;7;0;0;7
16527;Žiogelis;BITUTĖS;3792114246;Taip;0;6;0;6
16528;Žiogelis;BITUTĖS;9981130790;Taip;10;2;0;12
16529;Žiogelis;BITUTĖS;3820534331;Taip;0;1;0;1
16530;Žiogelis;BITUTĖS;4630381709;Taip;5;1;0;6
16531;Žiogelis;BITUTĖS;9790463889;Ne;0;5;0;5
16532;Žiogelis;BITUTĖS;6024752960;Taip;0;6;0;6
16533;Žiogelis;BITUTĖS;8853905367;Taip;0;6;0;6
16534;Žiogelis;BITUTĖS;1397686161;Taip;0;10;0;10
16535;Žiogelis;BITUTĖS;2171351454;Taip;0;3;0;3
16536;Žiogelis;BITUTĖS;8835394030;Ne;0;7;0;7
16537;Žiogelis;BITUTĖS;4645245689;Taip;7;1;0;8
16538;Žiogelis;BITUTĖS;9874412804;Taip;0;6;0;6
16539;Žiogelis;BITUTĖS;5139645108;Taip;0;13;0;13
16540;Žiogelis;BITUTĖS;9766966628;Taip;0;5;0;5
16541;Žiogelis;RIEŠUTĖLIAI;8303283893;Taip;0;7;0;7
16542;Žiogelis;RIEŠUTĖLIAI;9863503924;Taip;0;0;5;5
16543;Žiogelis;RIEŠUTĖLIAI;6718866954;Taip;5;0;8;13
16544;Žiogelis;RIEŠUTĖLIAI;9144282935;Taip;4;0;2;6
16545;Žiogelis;RIEŠUTĖLIAI;8485973974;Taip;5;5;1;11
16546;Žiogelis;RIEŠUTĖLIAI;6039409252;Taip;9;0;1;10
16547;Žiogelis;RIEŠUTĖLIAI;2275123126;Taip;4;0;0;4
16548;Žiogelis;RIEŠUTĖLIAI;4994053705;Taip;14;2;0;16
16549;Žiogelis;RIEŠUTĖLIAI;6048534817;Taip;0;3;0;3
16550;Žiogelis;RIEŠUTĖLIAI;5133034709;Taip;11;1;0;12
16551;Žiogelis;RIEŠUTĖLIAI;4147132498;Taip;4;1;0;5
16552;Žiogelis;RIEŠUTĖLIAI;2724389716;Taip;10;0;3;13
16553;Žiogelis;RIEŠUTĖLIAI;7763941077;Ne;8;0;0;8
16554;Žiogelis;RIEŠUTĖLIAI;7008807839;Taip;3;0;3;6
16555;Žiogelis;RIEŠUTĖLIAI;2518015116;Taip;5;2;0;7
16556;Žiogelis;RIEŠUTĖLIAI;5984496369;Taip;5;6;0;11
16557;Žiogelis;PAKALNUTĖS;1618384759;Taip;0;1;0;1
16558;Žiogelis;PAKALNUTĖS;5054228916;Taip;2;0;1;3
16559;Žiogelis;PAKALNUTĖS;8712788346;Taip;7;0;1;8
16560;Žiogelis;PAKALNUTĖS;3428197871;Taip;0;1;0;1
16561;Žiogelis;PAKALNUTĖS;7535167450;Taip;6;4;0;10
16562;Žiogelis;PAKALNUTĖS;3361421852;Taip;2;1;1;4
16563;Žiogelis;PAKALNUTĖS;1268908081;Taip;1;4;0;5
16564;Žiogelis;PAKALNUTĖS;3856321373;Ne;9;9;0;18
16565;Žiogelis;PAKALNUTĖS;6378295945;Ne;20;0;0;20
16566;Žiogelis;PAKALNUTĖS;8959934210;Taip;2;0;0;2
16567;Žiogelis;PAKALNUTĖS;8591680136;Ne;0;9;0;9
16568;Žiogelis;PAKALNUTĖS;6980853713;Taip;4;0;1;5
16569;Žiogelis;PAKALNUTĖS;7340918175;Taip;2;5;4;11
16570;Žiogelis;PAKALNUTĖS;6866685213;Taip;19;0;0;19
16571;Žiogelis;PAKALNUTĖS;5487213418;Taip;4;1;2;7
16572;Žiogelis;PAKALNUTĖS;8058231095;Ne;11;3;0;14
16573;Žiogelis;PAKALNUTĖS;6593794147;Taip;7;0;0;7
16574;Žiogelis;PAKALNUTĖS;1650284820;Ne;11;0;0;11
16575;Žiogelis;PAKALNUTĖS;6515890056;Taip;6;0;0;6
16576;Žiogelis;PAKALNUTĖS;1763603533;Taip;6;8;0;14
16577;Žiogelis;PAKALNUTĖS;9813150014;Taip;10;3;0;13
16578;Žiogelis;PAKALNUTĖS;5454676924;Taip;16;1;2;19
16579;Žiogelis;PAKALNUTĖS;7702173581;Taip;5;0;0;5
16580;Žolynėlis;Spanguolėlė;8810441600;Taip;3;5;4;12
16581;Žolynėlis;Spanguolėlė;6440991320;Taip;11;2;0;13
16582;Žolynėlis;Spanguolėlė;3631138915;Taip;4;4;0;8
16583;Žolynėlis;Spanguolėlė;5218448120;Taip;0;8;0;8
16584;Žolynėlis;Spanguolėlė;4076450179;Taip;4;4;0;8
16585;Žolynėlis;Spanguolėlė;4494255525;Ne;7;0;0;7
16586;Žolynėlis;Spanguolėlė;2493633505;Taip;0;0;7;7
16587;Žolynėlis;Spanguolėlė;5438607463;Taip;14;0;0;14
16588;Žolynėlis;Spanguolėlė;5208585298;Taip;12;4;0;16
16589;Žolynėlis;Spanguolėlė;7451189254;Taip;5;10;0;15
16590;Žolynėlis;Spanguolėlė;3498596516;Taip;19;2;0;21
16591;Žolynėlis;Spanguolėlė;9498369210;Taip;4;3;0;7
16592;Žolynėlis;Spanguolėlė;7260397656;Taip;0;2;9;11
16593;Žolynėlis;Spanguolėlė;2315947380;Taip;10;2;1;13
16594;Žolynėlis;Spanguolėlė;5074658392;Taip;12;1;0;13
16595;Žolynėlis;Spanguolėlė;6288526291;Ne;0;1;0;1
16596;Žolynėlis;"RŪTELĖ (spec)";1540454207;Taip;0;6;0;6
16597;Žolynėlis;"RŪTELĖ (spec)";4000928238;Taip;5;5;0;10
16598;Žolynėlis;"RŪTELĖ (spec)";5610113641;Taip;0;7;0;7
16599;Žolynėlis;"RŪTELĖ (spec)";9507509872;Taip;0;8;0;8
16600;Žolynėlis;"RŪTELĖ (spec)";2256262371;Taip;9;4;0;13
16601;Žolynėlis;"RŪTELĖ (spec)";1412336878;Taip;3;0;0;3
16602;Žolynėlis;"RŪTELĖ (spec)";8588753136;Taip;14;8;0;22
16603;Žolynėlis;"SAULUTĖ (spec)";9675783636;Taip;11;2;0;13
16604;Žolynėlis;"SAULUTĖ (spec)";7962304738;Taip;0;2;3;5
16605;Žolynėlis;"SAULUTĖ (spec)";6678697536;Taip;4;1;0;5
16606;Žolynėlis;"SAULUTĖ (spec)";6559029399;Taip;0;2;3;5
16607;Žolynėlis;"SAULUTĖ (spec)";3043560150;Taip;4;1;0;5
16608;Žolynėlis;"SAULUTĖ (spec)";3934182673;Taip;0;3;2;5
16609;Žolynėlis;"LINELIS (spec)";2665355759;Taip;8;2;1;11
16610;Žolynėlis;"LINELIS (spec)";2346018814;Taip;0;2;14;16
16611;Žolynėlis;"LINELIS (spec)";1916465295;Taip;3;2;0;5
16612;Žolynėlis;"LINELIS (spec)";3337602618;Ne;0;2;9;11
16613;Žolynėlis;"LINELIS (spec)";8930536051;Taip;6;2;0;8
16614;Žolynėlis;"LINELIS (spec)";2740906284;Taip;0;2;12;14
16615;Žolynėlis;"RASAKILA (spec)";4971887781;Taip;5;0;0;5
16616;Žolynėlis;"RASAKILA (spec)";6510930436;Taip;9;0;0;9
16617;Žolynėlis;"RASAKILA (spec)";6619551947;Taip;9;2;0;11
16618;Žolynėlis;"RASAKILA (spec)";4337084252;Taip;3;1;1;5
16619;Žolynėlis;"RASAKILA (spec)";8839037219;Taip;0;1;0;1
16620;Žolynėlis;"RASAKILA (spec)";4481343085;Ne;19;1;0;20
16621;Žolynėlis;"RAMUNĖLĖS (spec)";4559404699;Taip;4;0;2;6
16622;Žolynėlis;"RAMUNĖLĖS (spec)";1703785525;Taip;7;4;1;12
16623;Žolynėlis;"RAMUNĖLĖS (spec)";2072569949;Taip;9;1;0;10
16624;Žolynėlis;"RAMUNĖLĖS (spec)";1090944316;Taip;0;1;6;7
16625;Žolynėlis;Dobiliukai;2005661306;Taip;0;5;0;5
16626;Žolynėlis;Dobiliukai;2820649587;Taip;5;0;0;5
16627;Žolynėlis;Dobiliukai;7581436340;Taip;15;0;1;16
16628;Žolynėlis;Dobiliukai;6204102296;Ne;8;1;3;12
16629;Žolynėlis;Dobiliukai;3385748516;Taip;14;5;0;19
16630;Žolynėlis;Dobiliukai;4151633786;Taip;9;0;0;9
16631;Žolynėlis;Dobiliukai;2957426163;Taip;0;0;3;3
16632;Žolynėlis;Dobiliukai;5456771327;Taip;16;0;0;16
16633;Žolynėlis;Dobiliukai;8341730420;Taip;4;1;1;6
16634;Žolynėlis;Dobiliukai;5634886191;Taip;5;0;0;5
16635;Žolynėlis;Dobiliukai;3350246193;Taip;9;0;0;9
16636;Žolynėlis;Dobiliukai;5269388947;Taip;5;2;0;7
16637;Žolynėlis;Dobiliukai;1206144208;Taip;11;3;0;14
16638;Žolynėlis;Dobiliukai;1213384150;Taip;9;6;0;15
16639;Žolynėlis;Dobiliukai;7485033527;Taip;10;3;0;13
16640;Žolynėlis;Dobiliukai;4462289757;Taip;9;0;0;9
16641;Žolynėlis;Aguonėlė;3071570864;Taip;0;9;0;9
16642;Žolynėlis;Aguonėlė;1440666914;Taip;6;6;0;12
16643;Žolynėlis;Aguonėlė;1365534272;Taip;12;1;0;13
16644;Žolynėlis;Aguonėlė;2628636018;Taip;4;14;0;18
16645;Žolynėlis;Aguonėlė;6740105842;Taip;13;0;0;13
16646;Žolynėlis;Aguonėlė;3952731134;Taip;8;0;0;8
16647;Žolynėlis;Aguonėlė;6554864184;Ne;0;13;0;13
16648;Žolynėlis;Aguonėlė;9904373687;Taip;11;0;0;11
16649;Žolynėlis;Aguonėlė;9285539649;Ne;7;0;0;7
16650;Žolynėlis;Aguonėlė;5243624422;Taip;0;22;0;22
16651;Žolynėlis;Aguonėlė;4761054847;Taip;9;0;0;9
16652;Žolynėlis;Aguonėlė;9120786116;Taip;0;6;0;6
16653;Žolynėlis;Aguonėlė;1748987196;Ne;4;12;0;16
16654;Žolynėlis;Aguonėlė;4427274462;Taip;4;0;0;4
16655;Žolynėlis;Aguonėlė;3819863015;Taip;0;1;1;2
16656;Žolynėlis;Pienė;3520272555;Taip;0;10;0;10
16657;Žolynėlis;Pienė;2934361190;Taip;0;16;0;16
16658;Žolynėlis;Pienė;6763515483;Taip;7;1;0;8
16659;Žolynėlis;Pienė;1163753820;Taip;5;3;0;8
16660;Žolynėlis;Pienė;9106152447;Taip;17;3;0;20
16661;Žolynėlis;Pienė;1879046798;Taip;0;1;0;1
16662;Žolynėlis;Pienė;9238832484;Taip;12;1;0;13
16663;Žolynėlis;Pienė;3877168024;Taip;22;0;0;22
16664;Žolynėlis;Pienė;6416217971;Taip;5;6;0;11
16665;Žolynėlis;Pienė;4618251201;Ne;3;4;0;7
16666;Žolynėlis;Pienė;5432464074;Taip;5;5;0;10
16667;Žolynėlis;Pienė;8510764089;Ne;0;1;0;1
16668;Žolynėlis;Pienė;1264022895;Ne;5;3;2;10
16669;Žolynėlis;Pienė;8697184617;Taip;6;3;0;9
16670;Žolynėlis;Pienė;8713225753;Taip;0;3;0;3
16671;Žolynėlis;Pienė;5332349177;Taip;0;9;0;9
16672;Žolynėlis;Pienė;5787331165;Taip;4;13;0;17
16673;Žolynėlis;Pienė;5474876914;Ne;3;0;0;3
16674;Žolynėlis;Pienė;3091749692;Taip;4;3;5;12
16675;Žolynėlis;Pienė;2263679711;Ne;3;1;0;4
16676;Žolynėlis;Pienė;5149512625;Ne;0;3;0;3
16677;Žolynėlis;Pienė;5973298389;Taip;9;3;0;12
16678;Žolynėlis;Čiobreliai;5564338170;Taip;7;0;0;7
16679;Žolynėlis;Čiobreliai;6543503409;Taip;10;5;0;15
16680;Žolynėlis;Čiobreliai;8215427354;Taip;10;0;0;10
16681;Žolynėlis;Čiobreliai;8700231970;Taip;10;0;0;10
16682;Žolynėlis;Čiobreliai;7339496409;Taip;12;1;0;13
16683;Žolynėlis;Čiobreliai;2565770471;Taip;12;1;0;13
16684;Žolynėlis;Čiobreliai;3198470147;Taip;0;3;0;3
16685;Žolynėlis;Čiobreliai;6829144389;Taip;6;3;0;9
16686;Žolynėlis;Čiobreliai;4545601535;Taip;0;5;0;5
16687;Žolynėlis;Čiobreliai;7256502393;Ne;10;0;0;10
16688;Žolynėlis;Čiobreliai;1901979061;Ne;7;1;0;8
16689;Žolynėlis;Čiobreliai;8027151284;Taip;13;1;0;14
16690;Žolynėlis;Čiobreliai;5717038791;Taip;0;10;0;10
16691;Žolynėlis;Čiobreliai;1933377698;Ne;5;8;0;13
16692;Žolynėlis;Čiobreliai;2108221942;Taip;3;11;0;14
16693;Žolynėlis;Čiobreliai;2881461471;Taip;14;1;0;15
16694;Žolynėlis;Čiobreliai;7339110559;Taip;1;1;0;2
16695;Žolynėlis;Čiobreliai;2460982987;Ne;7;2;0;9
16696;Žolynėlis;Čiobreliai;7980206574;Taip;5;0;0;5
16697;Žolynėlis;Čiobreliai;3088932720;Taip;9;3;0;12
16698;Žolynėlis;Čiobreliai;4758738231;Taip;20;0;0;20
16699;Žolynėlis;Čiobreliai;6024288147;Taip;10;1;0;11
16700;Žolynėlis;Čiobreliai;1485195267;Taip;0;4;0;4
16701;Žolynėlis;Avietėlė;4277871671;Taip;12;0;0;12
16702;Žolynėlis;Avietėlė;9404844632;Taip;12;0;0;12
16703;Žolynėlis;Avietėlė;5873931225;Ne;17;0;0;17
16704;Žolynėlis;Avietėlė;6124252688;Taip;15;0;0;15
16705;Žolynėlis;Avietėlė;3293250169;Taip;2;4;0;6
16706;Žolynėlis;Avietėlė;1266614631;Taip;12;1;0;13
16707;Žolynėlis;Avietėlė;9993230229;Taip;6;1;0;7
16708;Žolynėlis;Avietėlė;2727273826;Taip;11;5;0;16
16709;Žolynėlis;Avietėlė;2718255075;Taip;0;12;0;12
16710;Žolynėlis;Avietėlė;7201413203;Taip;8;0;0;8
16711;Žolynėlis;Avietėlė;7517815798;Taip;7;0;0;7
16712;Žolynėlis;Avietėlė;4094173207;Taip;16;3;0;19
16713;Žolynėlis;Avietėlė;4229530366;Taip;14;4;0;18
16714;Žolynėlis;Avietėlė;5771745015;Taip;2;0;0;2
16715;Žuvėdra;"JŪROS ŽVAIGŽDUTĖS";7272717439;Taip;0;0;2;2
16716;Žuvėdra;"JŪROS ŽVAIGŽDUTĖS";9230342970;Taip;4;1;1;6
16717;Žuvėdra;"JŪROS ŽVAIGŽDUTĖS";1938808693;Taip;5;0;0;5
16718;Žuvėdra;"JŪROS ŽVAIGŽDUTĖS";2660909247;Taip;7;0;0;7
16719;Žuvėdra;"JŪROS ŽVAIGŽDUTĖS";2092890028;Taip;6;1;4;11
16720;Žuvėdra;"JŪROS ŽVAIGŽDUTĖS";2334342995;Taip;0;1;0;1
16721;Žuvėdra;"JŪROS ŽVAIGŽDUTĖS";5049101816;Taip;4;4;0;8
16722;Žuvėdra;"JŪROS ŽVAIGŽDUTĖS";4011849839;Taip;0;4;0;4
16723;Žuvėdra;"JŪROS ŽVAIGŽDUTĖS";1164464390;Taip;9;5;0;14
16724;Žuvėdra;"JŪROS ŽVAIGŽDUTĖS";1200084485;Taip;0;7;0;7
16725;Žuvėdra;"JŪROS ŽVAIGŽDUTĖS";4177319374;Ne;6;5;0;11
16726;Žuvėdra;"JŪROS ŽVAIGŽDUTĖS";7121154799;Taip;0;17;0;17
16727;Žuvėdra;"JŪROS ŽVAIGŽDUTĖS";8162649794;Taip;0;1;0;1
16728;Žuvėdra;"JŪROS ŽVAIGŽDUTĖS";7710853637;Taip;5;0;1;6
16729;Žuvėdra;"JŪROS ŽVAIGŽDUTĖS";2858729034;Ne;0;1;7;8
16730;Žuvėdra;"JŪROS ŽVAIGŽDUTĖS";7958768355;Ne;6;0;0;6
16731;Žuvėdra;"JŪROS ŽVAIGŽDUTĖS";6672289932;Ne;4;0;4;8
16732;Žuvėdra;"JŪROS ŽVAIGŽDUTĖS";9733979816;Ne;6;0;6;12
16733;Žuvėdra;"JŪROS ŽVAIGŽDUTĖS";5571732399;Taip;13;0;1;14
16734;Žuvėdra;"JŪROS ŽVAIGŽDUTĖS";3620753237;Taip;4;8;0;12
16735;Žuvėdra;DELFINUKAI;5436158437;Taip;0;7;0;7
16736;Žuvėdra;DELFINUKAI;6952843736;Taip;4;0;0;4
16737;Žuvėdra;DELFINUKAI;2582404760;Taip;0;13;0;13
16738;Žuvėdra;DELFINUKAI;5818639448;Taip;17;0;0;17
16739;Žuvėdra;DELFINUKAI;1171751803;Taip;17;0;0;17
16740;Žuvėdra;DELFINUKAI;7235005234;Taip;0;0;6;6
16741;Žuvėdra;DELFINUKAI;5876618912;Taip;10;0;0;10
16742;Žuvėdra;DELFINUKAI;6989906913;Taip;4;0;0;4
16743;Žuvėdra;DELFINUKAI;4702627979;Taip;0;1;0;1
16744;Žuvėdra;DELFINUKAI;5002760763;Taip;19;0;0;19
16745;Žuvėdra;DELFINUKAI;6327915228;Taip;11;0;0;11
16746;Žuvėdra;DELFINUKAI;7803397430;Taip;4;3;0;7
16747;Žuvėdra;DELFINUKAI;7705946236;Taip;22;0;0;22
16748;Žuvėdra;DELFINUKAI;1974766090;Taip;6;6;0;12
16749;Žuvėdra;DELFINUKAI;8869169590;Taip;22;0;0;22
16750;Žuvėdra;DELFINUKAI;3069506904;Taip;17;3;0;20
16751;Žuvėdra;DELFINUKAI;4146310547;Taip;0;1;0;1
16752;Žuvėdra;DELFINUKAI;5913580058;Ne;11;0;0;11
16753;Žuvėdra;DELFINUKAI;9651268462;Taip;5;1;0;6
16754;Žuvėdra;DELFINUKAI;2082128566;Taip;0;0;6;6
16755;Žuvėdra;OSMINOŽKI;5021263583;Taip;0;2;0;2
16756;Žuvėdra;OSMINOŽKI;63053155507;Taip;0;1;0;1
16757;Žuvėdra;OSMINOŽKI;6007871092;Taip;0;3;0;3
16758;Žuvėdra;OSMINOŽKI;2731016281;Taip;0;8;0;8
16759;Žuvėdra;OSMINOŽKI;6612880861;Taip;0;2;0;2
16760;Žuvėdra;OSMINOŽKI;75901332720;Taip;0;2;0;2
16761;Žuvėdra;OSMINOŽKI;14760907606;Taip;5;0;6;11
16762;Žuvėdra;OSMINOŽKI;5684848140;Taip;8;9;0;17
16763;Žuvėdra;OSMINOŽKI;5489757084;Taip;0;7;0;7
16764;Žuvėdra;OSMINOŽKI;8408371550;Taip;0;7;0;7
16765;Žuvėdra;OSMINOŽKI;5496071972;Taip;0;11;0;11
16766;Žuvėdra;OSMINOŽKI;5273726957;Taip;9;2;0;11
16767;Žuvėdra;OSMINOŽKI;6537464526;Taip;0;21;0;21
16768;Žuvėdra;OSMINOŽKI;7630057671;Taip;0;1;0;1
16769;Žuvėdra;OSMINOŽKI;7368183516;Taip;11;7;0;18
16770;Žuvėdra;OSMINOŽKI;3853045274;Taip;0;6;0;6
16771;Žuvėdra;OSMINOŽKI;3185158741;Taip;0;8;0;8
16772;Žuvėdra;OSMINOŽKI;8822952385;Ne;22;0;0;22
16773;Žuvėdra;OSMINOŽKI;5198825127;Taip;22;0;0;22
16774;Žuvėdra;OSMINOŽKI;5561903903;Taip;0;18;0;18
16775;Žuvėdra;RUSALAČKA;8700802853;Taip;0;9;0;9
16776;Žuvėdra;RUSALAČKA;1509519996;Ne;0;7;0;7
16777;Žuvėdra;RUSALAČKA;4907571967;Taip;5;0;0;5
16778;Žuvėdra;RUSALAČKA;3613045982;Taip;1;0;0;1
16779;Žuvėdra;RUSALAČKA;7467154866;Ne;12;1;1;14
16780;Žuvėdra;RUSALAČKA;5151984122;Taip;0;19;0;19
16781;Žuvėdra;RUSALAČKA;4715123063;Taip;0;3;0;3
16782;Žuvėdra;RUSALAČKA;6715416675;Taip;4;0;1;5
16783;Žuvėdra;RUSALAČKA;3349158713;Taip;16;2;0;18
16784;Žuvėdra;RUSALAČKA;8942228415;Ne;8;0;1;9
16785;Žuvėdra;RUSALAČKA;8670342549;Taip;0;3;3;6
16786;Žuvėdra;RUSALAČKA;1810114962;Ne;10;4;0;14
16787;Žuvėdra;RUSALAČKA;1960306957;Taip;7;2;0;9
16788;Žuvėdra;RUSALAČKA;2640238143;Taip;8;3;0;11
16789;Žuvėdra;RUSALAČKA;2577280901;Taip;8;5;0;13
16790;Žuvėdra;RUSALAČKA;5481785360;Taip;8;0;0;8
16791;Žuvėdra;RUSALAČKA;6862766787;Ne;15;0;0;15
16792;Žuvėdra;RUSALAČKA;9011276878;Taip;4;7;0;11
16793;Žuvėdra;RUSALAČKA;7387863175;Taip;0;13;0;13
16794;Žuvėdra;JANTARIKI;8111760611;Taip;12;0;0;12
16795;Žuvėdra;JANTARIKI;4893062971;Taip;10;0;3;13
16796;Žuvėdra;JANTARIKI;1219808187;Ne;11;1;0;12
16797;Žuvėdra;JANTARIKI;9200342856;Taip;0;11;0;11
16798;Žuvėdra;JANTARIKI;2197976174;Taip;7;2;0;9
16799;Žuvėdra;JANTARIKI;4881712317;Taip;14;0;2;16
16800;Žuvėdra;JANTARIKI;1929548863;Taip;3;0;3;6
16801;Žuvėdra;JANTARIKI;7464494386;Taip;0;1;0;1
16802;Žuvėdra;JANTARIKI;1072201019;Taip;22;0;0;22
16803;Žuvėdra;JANTARIKI;1993897043;Taip;10;0;0;10
16804;Žuvėdra;JANTARIKI;3058300342;Taip;3;2;1;6
16805;Žuvėdra;JANTARIKI;7227722516;Ne;18;0;0;18
16806;Žuvėdra;JANTARIKI;9256424331;Taip;8;3;0;11
16807;Žuvėdra;JANTARIKI;7908898376;Taip;17;0;0;17
16808;Žuvėdra;JANTARIKI;2789379055;Taip;13;1;0;14
16809;Žuvėdra;JANTARIKI;9838754800;Taip;8;0;0;8
16810;Žuvėdra;JANTARIKI;1039661177;Ne;14;0;0;14
16811;Žuvėdra;JANTARIKI;1604010000;Taip;8;2;0;10
16812;Žuvėdra;"AUKSINĖ ŽUVELĖ";9914814198;Taip;0;0;1;1
16813;Žuvėdra;"AUKSINĖ ŽUVELĖ";6287034023;Taip;13;9;0;22
16814;Žuvėdra;"AUKSINĖ ŽUVELĖ";2844920302;Taip;8;1;0;9
16815;Žuvėdra;"AUKSINĖ ŽUVELĖ";9460887312;Taip;8;0;3;11
16816;Žuvėdra;"AUKSINĖ ŽUVELĖ";9382616403;Taip;10;0;0;10
16817;Žuvėdra;"AUKSINĖ ŽUVELĖ";2323431685;Taip;9;0;0;9
16818;Žuvėdra;"AUKSINĖ ŽUVELĖ";4888533074;Taip;10;4;0;14
16819;Žuvėdra;"AUKSINĖ ŽUVELĖ";5009153711;Taip;15;2;0;17
16820;Žuvėdra;"AUKSINĖ ŽUVELĖ";7258677907;Taip;0;21;0;21
16821;Žuvėdra;"AUKSINĖ ŽUVELĖ";4739865462;Taip;2;0;4;6
16822;Žuvėdra;"AUKSINĖ ŽUVELĖ";7135848009;Taip;3;1;0;4
16823;Žuvėdra;"AUKSINĖ ŽUVELĖ";3781157324;Ne;18;0;0;18
16824;Žuvėdra;"AUKSINĖ ŽUVELĖ";7164457313;Taip;11;8;0;19
16825;Žuvėdra;"AUKSINĖ ŽUVELĖ";9215777054;Taip;8;0;0;8
16826;Žvangutis;PELIUKŲ;7616874368;Taip;8;0;0;8
16827;Žvangutis;PELIUKŲ;3906808900;Taip;4;0;2;6
16828;Žvangutis;PELIUKŲ;7722153982;Taip;12;0;0;12
16829;Žvangutis;PELIUKŲ;4295016449;Taip;0;7;0;7
16830;Žvangutis;PELIUKŲ;9958554027;Taip;4;2;0;6
16831;Žvangutis;PELIUKŲ;8592522675;Taip;8;0;0;8
16832;Žvangutis;PELIUKŲ;3957064486;Ne;0;3;0;3
16833;Žvangutis;PELIUKŲ;5112520119;Taip;0;1;0;1
16834;Žvangutis;PELIUKŲ;5817402847;Taip;22;0;0;22
16835;Žvangutis;PELIUKŲ;4407484687;Taip;4;1;0;5
16836;Žvangutis;PELIUKŲ;5638068914;Taip;16;3;0;19
16837;Žvangutis;PELIUKŲ;4337928288;Taip;5;0;0;5
16838;Žvangutis;PELIUKŲ;6788355315;Taip;0;2;0;2
16839;Žvangutis;PELIUKŲ;8062689240;Taip;6;1;0;7
16840;Žvangutis;PELIUKŲ;3875906173;Taip;18;1;0;19
16841;Žvangutis;PELIUKŲ;1328464199;Taip;3;0;12;15
16842;Žvangutis;PELIUKŲ;3546672690;Taip;6;2;1;9
16843;Žvangutis;PELIUKŲ;4992231141;Ne;9;0;0;9
16844;Žvangutis;PELIUKŲ;3408933802;Taip;4;0;2;6
16845;Žvangutis;PELIUKŲ;8481666202;Taip;0;10;0;10
16846;Žvangutis;PELIUKŲ;4705131089;Taip;3;2;0;5
16847;Žvangutis;ANČIUKŲ;1420510354;Taip;3;6;0;9
16848;Žvangutis;ANČIUKŲ;6579934222;Taip;0;2;0;2
16849;Žvangutis;ANČIUKŲ;9134683276;Taip;2;2;2;6
16850;Žvangutis;ANČIUKŲ;9145365865;Taip;13;1;1;15
16851;Žvangutis;ANČIUKŲ;6701947168;Taip;0;1;0;1
16852;Žvangutis;ANČIUKŲ;7320625500;Taip;4;1;0;5
16853;Žvangutis;ANČIUKŲ;6110958520;Taip;0;2;3;5
16854;Žvangutis;ANČIUKŲ;6989839997;Taip;5;1;0;6
16855;Žvangutis;ANČIUKŲ;3817258555;Ne;2;0;0;2
16856;Žvangutis;ANČIUKŲ;3775960571;Taip;8;1;0;9
16857;Žvangutis;ANČIUKŲ;7267340112;Ne;5;0;0;5
16858;Žvangutis;ANČIUKŲ;3513746926;Taip;8;0;0;8
16859;Žvangutis;ANČIUKŲ;4053450010;Taip;1;0;0;1
16860;Žvangutis;ANČIUKŲ;8511103595;Taip;0;1;6;7
16861;Žvangutis;ANČIUKŲ;6815104137;Taip;0;3;0;3
16862;Žvangutis;ANČIUKŲ;6844824726;Taip;23;1;0;24
16863;Žvangutis;ANČIUKŲ;9408369641;Ne;0;1;0;1
16864;Žvangutis;ANČIUKŲ;2600596320;Ne;6;0;0;6
16865;Žvangutis;PELĖDŽIUKŲ;2755838558;Taip;8;0;0;8
16866;Žvangutis;PELĖDŽIUKŲ;1322688456;Ne;0;11;0;11
16867;Žvangutis;PELĖDŽIUKŲ;9036869235;Taip;5;1;0;6
16868;Žvangutis;PELĖDŽIUKŲ;2570379643;Taip;0;3;0;3
16869;Žvangutis;PELĖDŽIUKŲ;2623107843;Taip;0;1;0;1
16870;Žvangutis;PELĖDŽIUKŲ;1185135525;Taip;0;2;0;2
16871;Žvangutis;PELĖDŽIUKŲ;2411307963;Taip;5;0;0;5
16872;Žvangutis;PELĖDŽIUKŲ;9468660351;Taip;0;3;0;3
16873;Žvangutis;PELĖDŽIUKŲ;1324948757;Taip;12;0;0;12
16874;Žvangutis;PELĖDŽIUKŲ;2922083476;Ne;13;1;0;14
16875;Žvangutis;PELĖDŽIUKŲ;1282567366;Ne;7;1;0;8
16876;Žvangutis;PELĖDŽIUKŲ;6068428687;Taip;9;1;0;10
16877;Žvangutis;PELĖDŽIUKŲ;9149037184;Taip;0;15;0;15
16878;Žvangutis;PELĖDŽIUKŲ;5012996199;Taip;5;4;0;9
16879;Žvangutis;PELĖDŽIUKŲ;8295525284;Ne;0;6;0;6
16880;Žvangutis;PELĖDŽIUKŲ;3276065009;Ne;10;2;0;12
16881;Žvangutis;PELĖDŽIUKŲ;6040986672;Taip;0;3;12;15
16882;Žvangutis;PELĖDŽIUKŲ;2716216474;Taip;12;0;0;12
16883;Žvangutis;PELĖDŽIUKŲ;5723728310;Taip;9;2;0;11
16884;Žvangutis;PELĖDŽIUKŲ;1404378308;Taip;4;1;0;5
16885;Žvangutis;PELĖDŽIUKŲ;6207989105;Taip;3;2;0;5
16886;Žvangutis;PELĖDŽIUKŲ;5539992579;Taip;5;3;0;8
16887;Žvangutis;KAČIUKŲ;7213349517;Taip;5;3;0;8
16888;Žvangutis;KAČIUKŲ;7581320158;Ne;3;2;4;9
16889;Žvangutis;KAČIUKŲ;2296360416;Taip;0;16;0;16
16890;Žvangutis;KAČIUKŲ;7721746116;Ne;0;9;0;9
16891;Žvangutis;KAČIUKŲ;2598842770;Taip;5;1;0;6
16892;Žvangutis;KAČIUKŲ;1142315595;Taip;9;0;0;9
16893;Žvangutis;KAČIUKŲ;9239279639;Taip;6;4;0;10
16894;Žvangutis;KAČIUKŲ;4696437804;Taip;22;0;0;22
16895;Žvangutis;KAČIUKŲ;8492637734;Taip;29;2;0;31
16896;Žvangutis;KAČIUKŲ;2503355659;Taip;5;0;0;5
16897;Žvangutis;KAČIUKŲ;9235884407;Taip;12;9;0;21
16898;Žvangutis;KAČIUKŲ;8360356476;Taip;6;0;0;6
16899;Žvangutis;KAČIUKŲ;8863909185;Taip;8;7;0;15
16900;Žvangutis;KAČIUKŲ;3498584864;Ne;0;1;0;1
16901;Žvangutis;KAČIUKŲ;4408086513;Taip;8;11;0;19
16902;Žvangutis;KAČIUKŲ;1256264382;Taip;0;12;0;12
16903;Žvangutis;KAČIUKŲ;8030520477;Taip;6;1;6;13
16904;Žvangutis;KAČIUKŲ;5166614226;Taip;5;0;1;6
16905;Žvangutis;KAČIUKŲ;8810739982;Taip;0;0;3;3
16906;Žvangutis;KAČIUKŲ;2740875969;Taip;4;1;1;6
16907;Žvangutis;KAČIUKŲ;8269992031;Ne;5;8;0;13
16908;Žvangutis;KAČIUKŲ;1224292338;Taip;14;0;1;15
16909;Žvangutis;KAČIUKŲ;1634651749;Taip;1;0;0;1
16910;Žvangutis;MEŠKUČIŲ;8753815074;Taip;14;0;0;14
16911;Žvangutis;MEŠKUČIŲ;3781959962;Taip;0;3;6;9
16912;Žvangutis;MEŠKUČIŲ;8506809320;Taip;0;2;0;2
16913;Žvangutis;MEŠKUČIŲ;8376022173;Ne;10;0;0;10
16914;Žvangutis;MEŠKUČIŲ;6825952779;Taip;25;0;0;25
16915;Žvangutis;MEŠKUČIŲ;4920234186;Taip;8;0;0;8
16916;Žvangutis;MEŠKUČIŲ;1590704985;Taip;12;0;0;12
16917;Žvangutis;MEŠKUČIŲ;9306755042;Taip;0;0;5;5
16918;Žvangutis;MEŠKUČIŲ;1352736819;Ne;0;0;1;1
16919;Žvangutis;MEŠKUČIŲ;5328547183;Taip;0;6;0;6
16920;Žvangutis;MEŠKUČIŲ;2298103025;Taip;0;2;0;2
16921;Žvangutis;MEŠKUČIŲ;9523189658;Taip;8;0;0;8
16922;Žvangutis;MEŠKUČIŲ;9406190681;Taip;10;0;0;10
16923;Žvangutis;MEŠKUČIŲ;5126809299;Taip;0;6;8;14
16924;Žvangutis;MEŠKUČIŲ;6511539983;Taip;10;0;0;10
16925;Žvangutis;MEŠKUČIŲ;9883337991;Taip;18;0;0;18
16926;Žvangutis;MEŠKUČIŲ;8598396569;Taip;18;1;0;19
16927;Žvangutis;KIŠKUČIŲ;8906823569;Taip;13;0;0;13
16928;Žvangutis;KIŠKUČIŲ;6094686500;Ne;0;0;1;1
16929;Žvangutis;KIŠKUČIŲ;2049990751;Taip;0;1;3;4
16930;Žvangutis;KIŠKUČIŲ;2308726385;Taip;0;1;1;2
16931;Žvangutis;KIŠKUČIŲ;9711017196;Taip;0;1;2;3
16932;Žvangutis;KIŠKUČIŲ;7051007224;Taip;3;1;0;4
16933;Žvangutis;KIŠKUČIŲ;3940893168;Taip;4;0;4;8
16934;Žvangutis;KIŠKUČIŲ;1592158260;Taip;10;0;1;11
16935;Žvangutis;KIŠKUČIŲ;5022657156;Taip;0;1;0;1
16936;Žvangutis;KIŠKUČIŲ;7645908955;Taip;6;0;0;6
16937;Žvangutis;KIŠKUČIŲ;6741623841;Taip;1;0;1;2
16938;Žvangutis;KIŠKUČIŲ;3029382724;Taip;13;1;0;14
16939;Žvangutis;KIŠKUČIŲ;4514606021;Taip;0;11;0;11
16940;Žvangutis;KIŠKUČIŲ;7844987649;Taip;5;1;0;6
16941;Žvangutis;KIŠKUČIŲ;7599491698;Taip;14;0;0;14
16942;Žvangutis;KIŠKUČIŲ;4128856598;Taip;12;0;1;13
16943;Žirniukas;Boružiukų;5311746004;Taip;16;0;2;18
16944;Žirniukas;Boružiukų;2476906136;Taip;0;3;0;3
16945;Žirniukas;Boružiukų;2785102131;Taip;0;2;1;3
16946;Žirniukas;Boružiukų;6624263476;Taip;0;1;0;1
16947;Žirniukas;Boružiukų;8213507698;Taip;1;3;8;12
16948;Žirniukas;Boružiukų;2528905738;Taip;3;2;1;6
16949;Žirniukas;Boružiukų;6268788036;Taip;0;3;0;3
16950;Žirniukas;Boružiukų;6363169823;Taip;5;13;0;18
16951;Žirniukas;Boružiukų;2636634198;Taip;0;7;0;7
16952;Žirniukas;Boružiukų;8148254025;Taip;10;1;0;11
16953;Žirniukas;Boružiukų;6531175340;Taip;0;3;5;8
16954;Žirniukas;Boružiukų;9647374339;Taip;5;0;0;5
16955;Žirniukas;Boružiukų;6641200341;Taip;0;1;0;1
16956;Žirniukas;Boružiukų;3022672028;Taip;14;2;0;16
16957;Žirniukas;Boružiukų;3909152902;Taip;2;2;0;4
16958;Žirniukas;Boružiukų;8180092480;Ne;6;0;1;7
16959;Žirniukas;Boružiukų;9896989995;Taip;0;1;0;1
16960;Žirniukas;Boružiukų;5420360864;Taip;0;1;0;1
16961;Žirniukas;Boružiukų;1873446232;Taip;0;0;2;2
16962;Žirniukas;Boružiukų;8294569569;Taip;4;3;0;7
16963;Žirniukas;Boružiukų;7397202752;Taip;11;3;0;14
16964;Žirniukas;Boružiukų;7190628011;Taip;4;0;3;7
16965;Žirniukas;Smalsučiai;2557138057;Taip;0;1;1;2
16966;Žirniukas;Smalsučiai;8644938346;Taip;0;0;3;3
16967;Žirniukas;Smalsučiai;5761169841;Taip;7;0;0;7
16968;Žirniukas;Smalsučiai;5471647472;Taip;0;2;0;2
16969;Žirniukas;Smalsučiai;2151329751;Ne;0;3;0;3
16970;Žirniukas;Smalsučiai;5939918015;Taip;0;0;1;1
16971;Žirniukas;Smalsučiai;2049123663;Taip;5;3;0;8
16972;Žirniukas;Smalsučiai;3010062747;Taip;0;2;0;2
16973;Žirniukas;Smalsučiai;2162238771;Taip;3;3;1;7
16974;Žirniukas;Smalsučiai;1064894307;Taip;0;10;0;10
16975;Žirniukas;Smalsučiai;4378877068;Taip;10;1;0;11
16976;Žirniukas;Smalsučiai;2029018108;Taip;0;6;0;6
16977;Žirniukas;Smalsučiai;2309995947;Taip;5;1;0;6
16978;Žirniukas;Smalsučiai;1162904969;Taip;3;3;0;6
16979;Žirniukas;Smalsučiai;7644911127;Taip;0;1;0;1
16980;Žirniukas;Smalsučiai;1514504241;Taip;0;2;0;2
16981;Žirniukas;Smalsučiai;6180439078;Ne;0;3;4;7
16982;Žirniukas;Smalsučiai;5987510202;Taip;0;0;1;1
16983;Žirniukas;Smalsučiai;1944169398;Taip;0;2;0;2
16984;Žirniukas;Smalsučiai;3808838764;Taip;0;1;0;1
16985;Žirniukas;Smalsučiai;9896415564;Ne;4;0;0;4
16986;Žirniukas;Smalsučiai;1678041002;Ne;0;6;6;12
16987;Žirniukas;Gėlyčių;2982628594;Taip;9;1;0;10
16988;Žirniukas;Gėlyčių;6121388208;Taip;14;2;3;19
16989;Žirniukas;Gėlyčių;6201949014;Taip;4;0;5;9
16990;Žirniukas;Gėlyčių;5103440019;Taip;10;0;0;10
16991;Žirniukas;Gėlyčių;3370588608;Taip;3;0;0;3
16992;Žirniukas;Gėlyčių;9497414375;Taip;9;1;1;11
16993;Žirniukas;Gėlyčių;5422282267;Taip;11;0;2;13
16994;Žirniukas;Gėlyčių;5427116799;Taip;11;0;0;11
16995;Žirniukas;Gėlyčių;3214136760;Taip;10;4;0;14
16996;Žirniukas;Gėlyčių;9021495553;Taip;7;0;0;7
16997;Žirniukas;Nykštukų;2489070480;Taip;5;3;3;11
16998;Žirniukas;Nykštukų;5734197350;Taip;0;2;1;3
16999;Žirniukas;Nykštukų;2746074694;Taip;10;2;0;12
17000;Žirniukas;Nykštukų;4282344625;Taip;4;1;0;5
17001;Žirniukas;Nykštukų;3874713264;Taip;12;1;0;13
17002;Žirniukas;Nykštukų;1532129054;Taip;3;0;0;3
17003;Žirniukas;Nykštukų;7368124402;Taip;9;5;0;14
17004;Žirniukas;Nykštukų;1635353228;Taip;14;2;0;16
17005;Žirniukas;Nykštukų;2526769571;Taip;4;1;1;6
17006;Žirniukas;Nykštukų;2027344763;Taip;0;0;3;3
17007;Žirniukas;Nykštukų;9730269905;Taip;5;2;0;7
17008;Žirniukas;Nykštukų;9478756666;Taip;0;1;0;1
17009;Žirniukas;Nykštukų;9425682286;Taip;0;7;0;7
17010;Žirniukas;Nykštukų;4704879073;Taip;7;0;1;8
17011;Žirniukas;Nykštukų;4732089209;Taip;5;2;0;7
17012;Žirniukas;Nykštukų;9988669252;Ne;7;0;0;7
17013;Žirniukas;Nykštukų;8242086461;Taip;3;2;1;6
17014;Žirniukas;Nykštukų;8242086461;Taip;3;2;1;6
17015;Žirniukas;Nykštukų;8242086461;Taip;3;2;1;6
17016;Žirniukas;Nykštukų;6511802399;Taip;3;2;1;6
17017;Žirniukas;Nykštukų;6511802399;Taip;3;2;1;6
17018;Žirniukas;Nykštukų;6511802399;Taip;3;2;1;6
17019;Žirniukas;Saulytės;5819443551;Taip;13;0;0;13
17020;Žirniukas;Saulytės;2733313392;Taip;0;4;1;5
17021;Žirniukas;Saulytės;9707776533;Taip;8;2;1;11
17022;Žirniukas;Saulytės;7278153529;Taip;8;3;0;11
17023;Žirniukas;Saulytės;7927815250;Taip;0;3;3;6
17024;Žirniukas;Saulytės;2325139043;Taip;9;2;0;11
17025;Žirniukas;Saulytės;4527367786;Taip;6;0;0;6
17026;Žirniukas;Saulytės;3610402086;Taip;8;1;0;9
17027;Žirniukas;Saulytės;6362626389;Taip;0;4;1;5
17028;Žirniukas;Saulytės;9961947583;Taip;0;6;0;6
17029;Žirniukas;Saulytės;1074945082;Taip;9;2;0;11
17030;Žirniukas;Saulytės;1594735501;Taip;6;0;0;6
17031;Žirniukas;Saulytės;4433579937;Ne;10;1;0;11
17032;Žirniukas;Saulytės;4229687519;Taip;14;1;0;15
17033;Žirniukas;Saulytės;8151071354;Ne;12;0;0;12
17034;Žirniukas;Saulytės;8599313527;Ne;4;2;1;7
17035;Žirniukas;Saulytės;4320686646;Taip;13;2;0;15
17036;Žirniukas;Drugelių;6271194358;Taip;4;4;0;8
17037;Žirniukas;Drugelių;9232828844;Taip;7;10;0;17
17038;Žirniukas;Drugelių;5269074776;Taip;9;0;6;15
17039;Žirniukas;Drugelių;3509857181;Ne;5;0;0;5
17040;Žirniukas;Drugelių;1590778538;Ne;0;0;1;1
17041;Žirniukas;Drugelių;2517524802;Taip;5;1;0;6
17042;Žirniukas;Drugelių;9901196251;Taip;6;0;3;9
17043;Žirniukas;Drugelių;2555959199;Taip;6;0;4;10
17044;Žirniukas;Drugelių;4762596462;Taip;14;0;1;15
17045;Žirniukas;Drugelių;5046469974;Taip;0;5;1;6
17046;Žirniukas;Drugelių;1826203483;Ne;23;0;0;23
17047;Žirniukas;Drugelių;4536071547;Taip;4;0;0;4
17048;Žirniukas;Drugelių;6501961029;Taip;0;1;0;1
17049;Žirniukas;Drugelių;3996393849;Taip;9;0;3;12
17050;Žirniukas;Drugelių;7240364379;Taip;5;0;3;8
17051;Žirniukas;Drugelių;6300372863;Taip;7;1;0;8
17052;Žirniukas;Drugelių;5670489807;Taip;2;9;0;11
17053;Žirniukas;Drugelių;9794535841;Taip;13;0;1;14
17054;Žirniukas;Drugelių;1031316325;Taip;5;0;0;5
17055;Žirniukas;Drugelių;1018506580;Taip;3;3;0;6
17056;Žirniukas;Drugelių;6993784924;Taip;5;0;3;8
17057;Žirniukas;Drugelių;9384464752;Taip;0;2;1;3
17058;Žirniukas;Pelėdžiukai;7889803840;Taip;0;1;0;1
17059;Žirniukas;Pelėdžiukai;2895924102;Taip;10;0;0;10
17060;Žirniukas;Pelėdžiukai;4347695841;Taip;0;0;8;8
17061;Žirniukas;Pelėdžiukai;9381704756;Taip;5;0;1;6
17062;Žirniukas;Pelėdžiukai;4847093256;Taip;0;14;0;14
17063;Žirniukas;Pelėdžiukai;7356213150;Ne;10;1;0;11
17064;Žirniukas;Pelėdžiukai;7545458622;Ne;10;4;0;14
17065;Žirniukas;Pelėdžiukai;5376080603;Taip;15;0;0;15
17066;Žirniukas;Pelėdžiukai;9511974432;Taip;4;2;3;9
17067;Žirniukas;Pelėdžiukai;7755938379;Taip;6;1;0;7
17068;Žirniukas;Pelėdžiukai;5470692657;Taip;0;4;10;14
17069;Žirniukas;Pelėdžiukai;8690042163;Taip;11;1;0;12
17070;Žirniukas;Pelėdžiukai;8808445761;Taip;17;0;0;17
17071;Žirniukas;Pelėdžiukai;2332260494;Taip;0;3;0;3
17072;Žirniukas;Pelėdžiukai;6941160450;Taip;14;0;0;14
17073;Žirniukas;Pelėdžiukai;4464151713;Taip;10;0;0;10
17074;Žirniukas;Pelėdžiukai;3907578167;Ne;7;0;0;7
17075;Žirniukas;Pelėdžiukai;4069128550;Taip;0;0;3;3
17076;Žirniukas;Pelėdžiukai;2489163786;Taip;8;0;1;9
17077;Žirniukas;Pelėdžiukai;7767762079;Taip;9;10;0;19
17078;Žirniukas;ZUIKUČIAI;5613818351;Ne;9;2;0;11
17079;Žirniukas;ZUIKUČIAI;1345594362;Taip;0;5;1;6
17080;Žirniukas;ZUIKUČIAI;5212289551;Taip;0;0;3;3
17081;Žirniukas;ZUIKUČIAI;1005139737;Taip;7;0;1;8
17082;Žirniukas;ZUIKUČIAI;7968189099;Taip;14;0;0;14
17083;Žirniukas;ZUIKUČIAI;7081683726;Taip;0;8;0;8
17084;Žirniukas;ZUIKUČIAI;7021496832;Taip;21;0;2;23
17085;Žirniukas;ZUIKUČIAI;1449763041;Taip;12;1;0;13
17086;Žirniukas;ZUIKUČIAI;4860680720;Taip;10;5;0;15
17087;Žirniukas;ZUIKUČIAI;7269948694;Taip;0;1;0;1
17088;Žirniukas;ZUIKUČIAI;9993119353;Taip;0;6;0;6
17089;Žirniukas;ZUIKUČIAI;1679864330;Taip;14;3;1;18
17090;Žirniukas;ZUIKUČIAI;9569187800;Taip;17;1;0;18
17091;Žirniukas;ZUIKUČIAI;2302878611;Taip;5;5;0;10
17092;Aušra;Kodėlčiukai;2611563172;Taip;8;4;0;12
17093;Aušra;Kodėlčiukai;3420851059;Taip;10;0;0;10
17094;Aušra;Kodėlčiukai;2199083085;Taip;0;22;0;22
17095;Aušra;Kodėlčiukai;4720749995;Taip;9;0;0;9
17096;Aušra;Kodėlčiukai;5929538617;Ne;0;2;0;2
17097;Aušra;Kodėlčiukai;6139706771;Taip;7;0;0;7
17098;Aušra;Kodėlčiukai;7314273812;Taip;11;5;0;16
17099;Aušra;Kodėlčiukai;5046439805;Taip;1;2;0;3
17100;Aušra;Kodėlčiukai;4540040693;Taip;4;3;0;7
17101;Aušra;Kodėlčiukai;1423840991;Ne;22;0;0;22
17102;Aušra;Kodėlčiukai;5013135853;Taip;13;2;0;15
17103;Aušra;Kodėlčiukai;9728140172;Taip;0;1;0;1
17104;Aušra;Kodėlčiukai;7765504789;Taip;0;5;0;5
17105;Aušra;Kodėlčiukai;8108663467;Taip;18;0;0;18
17106;Aušra;Kodėlčiukai;4824773027;Ne;6;0;0;6
17107;Aušra;Kodėlčiukai;1897365632;Taip;3;2;0;5
17108;Aušra;Kodėlčiukai;7469266085;Taip;0;20;0;20
17109;Aušra;Kodėlčiukai;1010721404;Taip;0;6;0;6
17110;Aušra;Kodėlčiukai;1883185016;Ne;0;2;0;2
17111;Aušra;Kodėlčiukai;1773343262;Taip;3;3;0;6
17112;Aušra;Kodėlčiukai;9437530221;Taip;33;0;0;33
17113;Aušra;Kodėlčiukai;7367602247;Taip;2;3;0;5
17114;Aušra;Kodėlčiukai;3627487971;Taip;5;3;0;8
17115;Aušra;"4B klasė";92119607174;Taip;12;3;0;15
17116;Aušra;"4B klasė";22923377435;Taip;1;1;0;2
17117;Aušra;"4B klasė";41852924528;Taip;0;22;0;22
17118;Aušra;"4B klasė";58526614808;Taip;0;22;0;22
17119;Aušra;"4B klasė";41039525379;Ne;0;1;0;1
17120;Aušra;"4B klasė";37339481276;Taip;1;2;0;3
17121;Aušra;"4B klasė";45165946624;Taip;0;22;0;22
17122;Aušra;"4B klasė";59107169775;Taip;0;1;0;1
17123;Aušra;"4B klasė";48349819906;Taip;0;1;0;1
17124;Aušra;"4B klasė";71596384638;Taip;0;1;0;1
17125;Aušra;"4B klasė";52332096506;Taip;1;1;0;2
17126;Aušra;"4B klasė";35703433862;Taip;4;1;0;5
17127;Aušra;"4B klasė";6201728036;Taip;0;22;0;22
17128;Aušra;"4B klasė";36889923728;Taip;0;22;0;22
17129;Aušra;"4B klasė";39957179831;Taip;0;1;0;1
17130;Aušra;"4B klasė";52909474598;Ne;5;1;0;6
17131;Aušra;"4B klasė";8901585006;Taip;0;22;0;22
17132;Aušra;"4B klasė";64562667133;Taip;0;22;0;22
17133;Aušra;"4B klasė";95076478544;Ne;0;1;0;1
17134;Aušra;"4B klasė";36899257479;Ne;6;1;0;7
17135;Aušra;"4B klasė";57520886724;Taip;0;1;0;1
17136;Aušra;"4B klasė";1815771421;Taip;0;1;0;1
17137;Aušra;"4B klasė";75433637766;Taip;0;22;0;22
17138;Aušra;"4B klasė";83119050626;Taip;0;22;0;22
17139;Aušra;Smalsučiai;1450251779;Taip;0;5;0;5
17140;Aušra;Smalsučiai;5409157554;Taip;16;1;0;17
17141;Aušra;Smalsučiai;8176840834;Taip;9;7;0;16
17142;Aušra;Smalsučiai;3680329197;Taip;15;1;0;16
17143;Aušra;Smalsučiai;8740755922;Taip;1;1;2;4
17144;Aušra;Smalsučiai;3898178166;Taip;5;3;2;10
17145;Aušra;Smalsučiai;29499576216;Taip;3;1;2;6
17146;Aušra;Smalsučiai;1940882109;Taip;2;1;0;3
17147;Aušra;Smalsučiai;4404047456;Taip;0;1;6;7
17148;Aušra;Smalsučiai;97102749430;Taip;0;1;0;1
17149;Aušra;Smalsučiai;9702136789;Taip;0;8;3;11
17150;Aušra;Smalsučiai;8709340592;Taip;5;1;0;6
17151;Aušra;Smalsučiai;5673568541;Taip;8;1;0;9
17152;Aušra;Smalsučiai;5524681006;Taip;6;3;4;13
17153;Aušra;Smalsučiai;6384243597;Taip;0;10;0;10
17154;Aušra;Smalsučiai;19402768340;Taip;0;5;0;5
17155;Aušra;Smalsučiai;2523842161;Taip;7;1;2;10
17156;Aušra;Smalsučiai;1343532870;Taip;0;0;2;2
17157;Aušra;Smalsučiai;7043021721;Taip;0;22;0;22
17158;Aušra;Smalsučiai;1612662076;Taip;0;16;0;16
17159;Aušra;Smalsučiai;1387254053;Taip;0;1;0;1
17160;Aušra;Smalsučiai;1575761029;Taip;9;1;5;15
17161;Aušra;Smalsučiai;5777939563;Taip;5;2;0;7
17162;Aušra;Smalsučiai;7814902928;Taip;1;1;0;2
17163;Aušra;"1A klasė";3001784066;Taip;7;1;0;8
17164;Aušra;"1A klasė";84116863778;Taip;2;1;0;3
17165;Aušra;"1A klasė";2227238810;Taip;0;1;0;1
17166;Aušra;"1A klasė";59837942520;Taip;12;1;0;13
17167;Aušra;"1A klasė";11053850075;Taip;0;1;0;1
17168;Aušra;"1A klasė";23609052737;Taip;4;1;0;5
17169;Aušra;"1A klasė";41017803426;Taip;5;1;0;6
17170;Aušra;"1A klasė";21544489661;Taip;2;1;0;3
17171;Aušra;"1A klasė";24625925423;Taip;0;1;0;1
17172;Aušra;"1A klasė";62186117615;Taip;0;1;0;1
17173;Aušra;"1A klasė";3526237179;Ne;7;1;0;8
17174;Aušra;"1A klasė";1893586984;Taip;0;22;0;22
17175;Aušra;"1A klasė";8686777160;Taip;2;1;0;3
17176;Aušra;"1A klasė";15657824495;Taip;0;1;0;1
17177;Aušra;"1A klasė";5988529284;Taip;1;1;0;2
17178;Aušra;"1A klasė";79051821501;Taip;1;1;0;2
17179;Aušra;"1A klasė";2062470430;Ne;2;1;0;3
17180;Aušra;"1A klasė";5815377310;Taip;5;1;0;6
17181;Aušra;"1A klasė";58254707316;Taip;0;1;0;1
17182;Aušra;"1A klasė";1385844067;Taip;0;1;0;1
17183;Aušra;"1A klasė";2121418946;Ne;0;1;0;1
17184;Aušra;"1A klasė";1219257874;Taip;0;22;0;22
17185;Aušra;"1A klasė";4325224130;Ne;0;1;0;1
17186;Aušra;"1A klasė";59267104215;Taip;8;1;0;9
17187;Aušra;"1A klasė";1623803107;Taip;0;1;0;1
17188;Aušra;"1B klasė";1988459596;Taip;0;1;0;1
17189;Aušra;"1B klasė";4930807661;Ne;0;1;0;1
17190;Aušra;"1B klasė";86128256406;Taip;1;1;0;2
17191;Aušra;"1B klasė";50687988382;Taip;0;1;0;1
17192;Aušra;"1B klasė";1021183555;Taip;2;1;0;3
17193;Aušra;"1B klasė";41268510292;Taip;2;2;0;4
17194;Aušra;"1B klasė";8428069167;Taip;3;3;0;6
17195;Aušra;"1B klasė";3910688753;Taip;0;1;0;1
17196;Aušra;"1B klasė";4024898537;Taip;0;2;0;2
17197;Aušra;"1B klasė";1238171728;Taip;0;2;0;2
17198;Aušra;"1B klasė";4103951942;Taip;0;1;0;1
17199;Aušra;"1B klasė";46481555688;Taip;3;2;0;5
17200;Aušra;"1B klasė";1063755068;Taip;2;1;0;3
17201;Aušra;"1B klasė";70844824182;Ne;5;1;0;6
17202;Aušra;"1B klasė";17098859260;Taip;1;3;0;4
17203;Aušra;"1B klasė";9940683245;Taip;0;1;0;1
17204;Aušra;"1B klasė";2841526614;Ne;8;1;0;9
17205;Aušra;"1B klasė";8813044848;Taip;3;1;0;4
17206;Aušra;"1B klasė";58741201573;Taip;0;1;0;1
17207;Aušra;"1B klasė";2003368811;Ne;0;1;0;1
17208;Aušra;"1B klasė";65840410497;Ne;0;1;0;1
17209;Aušra;"1B klasė";1640356242;Taip;0;1;0;1
17210;Aušra;"1B klasė";90604001837;Ne;2;3;0;5
17211;Aušra;"1B klasė";7794899167;Taip;0;1;0;1
17212;Aušra;"2A klasė";5468993286;Taip;2;2;0;4
17213;Aušra;"2A klasė";1167565535;Ne;2;1;0;3
17214;Aušra;"2A klasė";75047415039;Ne;0;1;0;1
17215;Aušra;"2A klasė";85826303673;Taip;0;1;0;1
17216;Aušra;"2A klasė";1145863002;Taip;0;22;0;22
17217;Aušra;"2A klasė";77966124767;Taip;0;1;0;1
17218;Aušra;"2A klasė";1473962346;Taip;3;1;0;4
17219;Aušra;"2A klasė";1049364899;Taip;3;1;0;4
17220;Aušra;"2A klasė";1427235223;Taip;4;1;0;5
17221;Aušra;"2A klasė";97312326369;Ne;0;1;0;1
17222;Aušra;"2A klasė";2019480768;Taip;0;1;0;1
17223;Aušra;"2A klasė";48817619537;Taip;1;1;0;2
17224;Aušra;"2A klasė";55937499558;Taip;0;1;0;1
17225;Aušra;"2A klasė";35779814505;Taip;0;1;0;1
17226;Aušra;"2A klasė";76280361479;Taip;0;1;0;1
17227;Aušra;"2A klasė";2131349938;Taip;0;1;0;1
17228;Aušra;"2A klasė";36447115547;Taip;7;1;0;8
17229;Aušra;"2A klasė";1455625997;Taip;0;1;0;1
17230;Aušra;"2A klasė";1393006122;Taip;0;1;0;1
17231;Aušra;"2A klasė";7998332115;Taip;2;1;0;3
17232;Aušra;"2A klasė";14611425618;Ne;0;1;0;1
17233;Aušra;"2A klasė";31458685084;Taip;1;1;0;2
17234;Aušra;"2A klasė";9603569117;Ne;3;2;0;5
17235;Aušra;"2A klasė";1315930711;Ne;12;1;0;13
17236;Aušra;"2A klasė";42344686036;Taip;0;1;0;1
17237;Aušra;"2A klasė";2647629246;Taip;5;1;0;6
17238;Aušra;"2A klasė";95586246863;Taip;4;2;0;6
17239;Aušra;"2A klasė";4110537888;Taip;6;1;0;7
17240;Aušra;"3A klasė";8510995681;Ne;2;1;0;3
17241;Aušra;"3A klasė";9605206310;Taip;0;1;0;1
17242;Aušra;"3A klasė";3284383302;Taip;0;1;0;1
17243;Aušra;"3A klasė";13157844661;Taip;2;1;0;3
17244;Aušra;"3A klasė";14157070764;Taip;1;1;0;2
17245;Aušra;"3A klasė";99073448709;Taip;0;22;0;22
17246;Aušra;"3A klasė";68160889669;Taip;0;1;0;1
17247;Aušra;"3A klasė";1437126272;Ne;2;3;0;5
17248;Aušra;"3A klasė";15330844181;Taip;0;1;0;1
17249;Aušra;"3A klasė";39537089288;Taip;0;1;0;1
17250;Aušra;"3A klasė";2062775070;Taip;0;22;0;22
17251;Aušra;"3A klasė";3965445196;Taip;0;1;0;1
17252;Aušra;"3A klasė";85578471272;Taip;0;1;0;1
17253;Aušra;"3A klasė";88655846176;Taip;5;2;0;7
17254;Aušra;"3A klasė";73509864636;Ne;4;1;0;5
17255;Aušra;"3A klasė";27958163601;Taip;1;1;0;2
17256;Aušra;"3A klasė";40499781883;Taip;7;1;0;8
17257;Aušra;"3A klasė";68031503463;Taip;2;1;0;3
17258;Aušra;"3A klasė";81633973264;Taip;0;22;0;22
17259;Aušra;"3A klasė";70233681803;Taip;0;22;0;22
17260;Aušra;"3A klasė";1437385365;Taip;0;22;0;22
17261;Aušra;"3A klasė";51185323645;Ne;0;22;0;22
17262;Aušra;"3A klasė";52985512945;Taip;0;22;0;22
17263;Aušra;"3A klasė";97781409787;Taip;0;22;0;22
17264;Aušra;"3A klasė";474412140;Ne;0;1;0;1
17265;Aušra;"3A klasė";40714551025;Taip;2;1;0;3
17266;Aušra;"3A klasė";58699109274;Taip;2;1;0;3
17267;Aušra;"4A klasė";68481706412;Taip;0;22;0;22
17268;Aušra;"4A klasė";99886964420;Taip;0;22;0;22
17269;Aušra;"4A klasė";19920237804;Taip;5;1;0;6
17270;Aušra;"4A klasė";13361663464;Taip;0;1;0;1
17271;Aušra;"4A klasė";95948867937;Taip;2;1;0;3
17272;Aušra;"4A klasė";78030425432;Taip;1;1;0;2
17273;Aušra;"4A klasė";97596344387;Taip;10;2;0;12
17274;Aušra;"4A klasė";97596344387;Taip;10;2;0;12
17275;Aušra;"4A klasė";34795588283;Ne;0;22;0;22
17276;Aušra;"4A klasė";29636399665;Taip;0;1;0;1
17277;Aušra;"4A klasė";81428848455;Taip;0;2;0;2
17278;Aušra;"4A klasė";47725613978;Taip;11;3;0;14
17279;Aušra;"4A klasė";93365393803;Taip;0;22;0;22
17280;Aušra;"4A klasė";52864653926;Ne;3;1;0;4
17281;Aušra;"4A klasė";10272136932;Ne;3;1;0;4
17282;Aušra;"4A klasė";77425098448;Taip;3;1;0;4
17283;Aušra;"4A klasė";20550256232;Taip;14;2;0;16
17284;Aušra;"4A klasė";42015974556;Taip;1;3;0;4
17285;Aušra;"4A klasė";2113586354;Taip;4;1;0;5
17286;Aušra;"4A klasė";19718806057;Taip;0;22;0;22
17287;Aušra;"4A klasė";21856009403;Taip;0;22;0;22
17288;Aušra;"4A klasė";5166358753;Taip;0;1;0;1
17289;Aušra;Pabiručiai;7542690501;Taip;0;22;0;22
17290;Aušra;Pabiručiai;7476662446;Taip;2;0;1;3
17291;Aušra;Pabiručiai;9466807067;Taip;5;0;5;10
17292;Aušra;Pabiručiai;6508435821;Taip;9;0;0;9
17293;Aušra;Pabiručiai;7926621700;Taip;0;5;0;5
17294;Aušra;Pabiručiai;8665364744;Taip;22;0;0;22
17295;Aušra;Pabiručiai;6555345047;Taip;1;5;0;6
17296;Aušra;Pabiručiai;7888891808;Taip;3;0;0;3
17297;Aušra;Pabiručiai;8769357172;Taip;5;3;0;8
17298;Aušra;Pabiručiai;1306616759;Taip;8;4;1;13
17299;Aušra;Pabiručiai;3275288747;Taip;7;3;0;10
17300;Aušra;Pabiručiai;5797692122;Ne;12;3;1;16
17301;Aušra;Pabiručiai;4071233786;Taip;13;0;0;13
17302;Aušra;Pabiručiai;4646215025;Taip;10;0;0;10
17303;Aušra;Pabiručiai;7199483890;Ne;0;2;2;4
17304;Aušra;Pabiručiai;3008573040;Ne;0;2;4;6
17305;Aušra;Pabiručiai;7944904281;Taip;0;4;5;9
17306;Aušra;Pabiručiai;3336605264;Taip;4;0;3;7
17307;Aušra;Pabiručiai;7159809546;Taip;6;2;0;8
17308;Aušra;Pabiručiai;3759593393;Taip;0;1;0;1
17309;Aušra;Pabiručiai;2904303784;Taip;10;2;3;15
17310;Aušra;Pabiručiai;6056923592;Ne;2;3;0;5
17311;Aušra;Pabiručiai;3953653896;Taip;0;8;0;8
17312;Aušra;Pabiručiai;2273160688;Taip;12;1;0;13
17313;Aušra;Pabiručiai;8462418277;Taip;9;0;0;9
17314;Aušra;Gudručiai;4564561993;Taip;1;1;0;2
17315;Aušra;Gudručiai;5854637278;Taip;3;0;0;3
17316;Aušra;Gudručiai;8715912139;Ne;0;1;0;1
17317;Aušra;Gudručiai;7783006852;Taip;0;1;0;1
17318;Aušra;Gudručiai;9614562473;Taip;0;1;0;1
17319;Aušra;Gudručiai;6658178519;Taip;0;2;0;2
17320;Aušra;Gudručiai;7921251819;Taip;18;0;0;18
17321;Aušra;Gudručiai;9628651723;Ne;7;4;0;11
17322;Aušra;Gudručiai;3343235857;Taip;5;1;0;6
17323;Aušra;Gudručiai;1337138547;Taip;0;1;0;1
17324;Aušra;Gudručiai;3530905126;Taip;0;22;0;22
17325;Aušra;Gudručiai;1429548355;Ne;0;22;0;22
17326;Aušra;Gudručiai;1933801749;Taip;0;6;0;6
17327;Aušra;Gudručiai;5955385407;Ne;16;3;0;19
17328;Aušra;Gudručiai;2243689816;Taip;0;8;0;8
17329;Aušra;Gudručiai;6935310711;Taip;0;8;0;8
17330;Aušra;Gudručiai;3698868934;Taip;8;2;0;10
17331;Aušra;Gudručiai;9079804366;Taip;0;2;0;2
17332;Aušra;Gudručiai;3498143162;Taip;0;2;0;2
17333;Aušra;Gudručiai;5053808615;Taip;0;2;0;2
17334;Aušra;Naminukai;5993984086;Taip;10;0;0;10
17335;Aušra;Naminukai;8884580599;Ne;11;0;1;12
17336;Aušra;Naminukai;6614027605;Ne;17;0;0;17
17337;Aušra;Naminukai;2039920706;Taip;0;7;0;7
17338;Aušra;Naminukai;6965081051;Taip;19;2;0;21
17339;Aušra;Naminukai;2768220823;Taip;14;0;4;18
17340;Aušra;Naminukai;5925213006;Ne;10;0;0;10
17341;Aušra;Naminukai;1630814772;Taip;7;1;0;8
17342;Aušra;Naminukai;9333701196;Taip;0;8;0;8
17343;Aušra;Naminukai;4010347313;Taip;14;3;0;17
17344;Aušra;Naminukai;3860755808;Taip;14;0;1;15
17345;Aušra;Naminukai;4339450816;Taip;0;1;0;1
17346;Aušra;Naminukai;4000881716;Taip;5;9;1;15
17347;Aušra;Naminukai;8021547491;Ne;9;2;0;11
17348;Aušra;Naminukai;5268479689;Taip;9;0;0;9
17349;Aušra;Naminukai;3526010606;Taip;3;0;0;3
17350;Aušra;Naminukai;4163605313;Taip;5;14;0;19
17351;Aušra;Naminukai;3468946868;Taip;15;0;0;15
17352;Aušra;Naminukai;7710131755;Ne;5;0;0;5
17353;Aušra;Naminukai;8584355573;Ne;0;14;0;14
17354;Aušra;Naminukai;2495610772;Taip;0;11;0;11
17355;Aušra;Naminukai;8489362814;Taip;11;0;0;11
17356;Aušra;Naminukai;3675175233;Taip;10;3;0;13
17357;Aušra;" 1C klasė";1426802917;Taip;2;3;0;5
17358;Aušra;" 1C klasė";26010333641;Taip;4;3;0;7
17359;Aušra;" 1C klasė";3133031845;Taip;2;3;0;5
17360;Aušra;" 1C klasė";11130172902;Ne;2;3;0;5
17361;Aušra;" 1C klasė";43737170074;Taip;2;2;0;4
17362;Aušra;" 1C klasė";1370336984;Taip;0;1;0;1
17363;Aušra;" 1C klasė";6483078840;Taip;0;1;0;1
17364;Aušra;" 1C klasė";1684481833;Taip;12;1;0;13
17365;Aušra;" 1C klasė";1198248619;Taip;0;1;0;1
17366;Aušra;" 1C klasė";4765125810;Taip;0;2;0;2
17367;Aušra;" 1C klasė";5704281727;Taip;2;3;0;5
17368;Aušra;" 1C klasė";1479311429;Taip;2;2;0;4
17369;Aušra;" 1C klasė";1542575012;Ne;2;1;0;3
17370;Aušra;" 1C klasė";1291782232;Taip;0;1;0;1
17371;Aušra;" 1C klasė";90520726029;Taip;0;1;0;1
17372;Aušra;" 1C klasė";1844632980;Ne;0;2;0;2
17373;Aušra;" 1C klasė";94478599707;Taip;1;2;0;3
17374;Aušra;" 1C klasė";78489473446;Taip;4;1;0;5
17375;Aušra;" 1C klasė";29328876924;Taip;0;1;0;1
17376;Aušra;" 1C klasė";7649832094;Taip;1;3;0;4
17377;Aušra;" 1C klasė";8225188274;Taip;9;1;0;10
17378;Aušra;" 1C klasė";1371282149;Taip;2;2;0;4
17379;Aušra;" 1C klasė";57559227292;Taip;1;1;0;2
17380;Berželis;PČIOLKI;6113571093;Taip;15;3;0;18
17381;Berželis;PČIOLKI;9024992452;Taip;0;3;0;3
17382;Berželis;PČIOLKI;1521982237;Taip;0;3;2;5
17383;Berželis;PČIOLKI;3437712794;Taip;0;3;0;3
17384;Berželis;PČIOLKI;3298044639;Taip;0;3;0;3
17385;Berželis;PČIOLKI;2615440913;Ne;6;3;0;9
17386;Berželis;PČIOLKI;4013215941;Taip;0;3;0;3
17387;Berželis;PČIOLKI;3772780161;Taip;10;4;0;14
17388;Berželis;PČIOLKI;4563582416;Taip;10;4;0;14
17389;Berželis;PČIOLKI;1225018351;Taip;0;2;0;2
17390;Berželis;PČIOLKI;9894751274;Taip;5;3;1;9
17391;Berželis;PČIOLKI;7526006253;Taip;0;3;1;4
17392;Berželis;PČIOLKI;1036370516;Taip;0;3;0;3
17393;Berželis;PČIOLKI;9644196870;Taip;0;3;1;4
17394;Berželis;PČIOLKI;2214171136;Taip;3;3;2;8
17395;Berželis;PČIOLKI;6473498471;Taip;7;3;0;10
17396;Berželis;PČIOLKI;97218091736;Taip;12;3;0;15
17397;Berželis;PČIOLKI;5798989689;Taip;9;3;0;12
17398;Berželis;PČIOLKI;2007064959;Taip;9;3;1;13
17399;Berželis;PČIOLKI;5084171353;Taip;0;3;1;4
17400;Berželis;PČIOLKI;4521372127;Taip;0;9;0;9
17401;Berželis;PČIOLKI;1067618571;Taip;0;3;0;3
17402;Berželis;PČIOLKI;7287552286;Taip;6;3;0;9
17403;Berželis;"BOŽJI KOROVKI";3162044236;Taip;14;0;0;14
17404;Berželis;"BOŽJI KOROVKI";9132058594;Taip;14;3;0;17
17405;Berželis;"BOŽJI KOROVKI";7421059780;Taip;11;0;0;11
17406;Berželis;"BOŽJI KOROVKI";5739847580;Taip;9;0;0;9
17407;Berželis;"BOŽJI KOROVKI";4100740863;Taip;0;16;0;16
17408;Berželis;"BOŽJI KOROVKI";1750209600;Taip;6;0;0;6
17409;Berželis;"BOŽJI KOROVKI";5953387226;Taip;9;4;2;15
17410;Berželis;"BOŽJI KOROVKI";3070917065;Ne;11;9;0;20
17411;Berželis;"BOŽJI KOROVKI";8118040960;Taip;19;0;0;19
17412;Berželis;"BOŽJI KOROVKI";2005082089;Taip;8;1;0;9
17413;Berželis;"BOŽJI KOROVKI";5692603837;Taip;29;0;0;29
17414;Berželis;"BOŽJI KOROVKI";5194480946;Taip;9;1;1;11
17415;Berželis;"BOŽJI KOROVKI";9848723402;Taip;7;1;0;8
17416;Berželis;"BOŽJI KOROVKI";5551459997;Taip;0;5;0;5
17417;Berželis;"BOŽJI KOROVKI";6651007152;Taip;12;0;0;12
17418;Berželis;"BOŽJI KOROVKI";8451877584;Taip;13;0;0;13
17419;Berželis;"BOŽJI KOROVKI";7080168105;Taip;13;1;0;14
17420;Berželis;"BOŽJI KOROVKI";1132252592;Taip;12;0;0;12
17421;Berželis;"BOŽJI KOROVKI";5550598069;Taip;2;4;0;6
17422;Berželis;"BOŽJI KOROVKI";1852964349;Taip;7;0;1;8
17423;Berželis;"BOŽJI KOROVKI";8871199713;Taip;19;0;1;20
17424;Berželis;"BOŽJI KOROVKI";1722262813;Taip;11;7;0;18
17425;Berželis;"BOŽJI KOROVKI";9466461910;Taip;14;3;0;17
17426;Berželis;SOLNYŠKO;1498165322;Taip;4;0;0;4
17427;Berželis;SOLNYŠKO;8737788279;Taip;7;0;1;8
17428;Berželis;SOLNYŠKO;2901168499;Ne;17;0;0;17
17429;Berželis;SOLNYŠKO;7411282628;Taip;0;22;0;22
17430;Berželis;SOLNYŠKO;8957312159;Taip;0;22;0;22
17431;Berželis;SOLNYŠKO;5408368340;Taip;0;0;2;2
17432;Berželis;SOLNYŠKO;1070751052;Taip;8;0;1;9
17433;Berželis;SOLNYŠKO;5464385395;Taip;0;8;0;8
17434;Berželis;SOLNYŠKO;6422037185;Taip;19;0;0;19
17435;Berželis;SOLNYŠKO;1424868444;Taip;0;11;0;11
17436;Berželis;SOLNYŠKO;1146976812;Ne;4;0;0;4
17437;Berželis;SOLNYŠKO;6774460279;Taip;19;3;0;22
17438;Berželis;SOLNYŠKO;5866092980;Taip;14;0;0;14
17439;Berželis;BABOČKI;4923631429;Taip;4;0;0;4
17440;Berželis;BABOČKI;2016194182;Taip;0;0;3;3
17441;Berželis;BABOČKI;2030770943;Taip;5;2;0;7
17442;Berželis;BABOČKI;2667957070;Taip;9;1;2;12
17443;Berželis;BABOČKI;7781031211;Taip;0;14;0;14
17444;Berželis;BABOČKI;2493612905;Ne;0;1;3;4
17445;Berželis;BABOČKI;5688897783;Taip;12;10;0;22
17446;Berželis;BABOČKI;6942559693;Taip;5;1;2;8
17447;Berželis;BABOČKI;9245706377;Taip;14;2;0;16
17448;Berželis;BABOČKI;6352635742;Taip;0;10;0;10
17449;Berželis;BABOČKI;3613459846;Taip;0;0;1;1
17450;Berželis;BABOČKI;8448872491;Taip;7;0;2;9
17451;Berželis;BABOČKI;5069322062;Taip;0;3;6;9
17452;Berželis;BABOČKI;2954451168;Taip;9;8;0;17
17453;Berželis;BABOČKI;9585609150;Taip;15;7;0;22
17454;Berželis;BABOČKI;9091691636;Taip;8;0;11;19
17455;Berželis;BABOČKI;7940591009;Taip;6;0;7;13
17456;Berželis;BABOČKI;4546285993;Taip;0;22;0;22
17457;Berželis;BABOČKI;5876182759;Ne;8;4;0;12
17458;Berželis;BABOČKI;9568910880;Taip;6;6;0;12
17459;Berželis;BABOČKI;6577232093;Taip;9;0;4;13
17460;Berželis;SOVUŠKI;5350402890;Taip;0;0;2;2
17461;Berželis;SOVUŠKI;8185887403;Taip;14;0;0;14
17462;Berželis;SOVUŠKI;8989621715;Taip;4;0;0;4
17463;Berželis;SOVUŠKI;1289333809;Taip;14;0;0;14
17464;Berželis;SOVUŠKI;8086074279;Taip;0;5;0;5
17465;Berželis;SOVUŠKI;9273819928;Taip;4;1;0;5
17466;Berželis;SOVUŠKI;9750863775;Taip;15;0;0;15
17467;Berželis;SOVUŠKI;1769470120;Taip;0;3;1;4
17468;Berželis;SOVUŠKI;3885474466;Taip;8;0;0;8
17469;Berželis;SOVUŠKI;1825910306;Taip;6;0;2;8
17470;Berželis;SOVUŠKI;6706273205;Taip;11;0;2;13
17471;Berželis;SOVUŠKI;2895332184;Ne;18;0;0;18
17472;Berželis;SOVUŠKI;1464998584;Taip;13;0;0;13
17473;Berželis;SOVUŠKI;2844736188;Taip;11;1;0;12
17474;Berželis;SOVUŠKI;3835273594;Taip;10;1;0;11
17475;Berželis;SOVUŠKI;2632535013;Taip;19;0;0;19
17476;Berželis;SOVUŠKI;6698849108;Taip;11;0;5;16
17477;Berželis;SOVUŠKI;1583268041;Taip;13;0;0;13
17478;Berželis;PODSOLNUŠKI;1044720859;Taip;0;0;3;3
17479;Berželis;PODSOLNUŠKI;3157906472;Taip;22;0;0;22
17480;Berželis;PODSOLNUŠKI;9945124824;Taip;11;0;1;12
17481;Berželis;PODSOLNUŠKI;5925726854;Taip;4;0;4;8
17482;Berželis;PODSOLNUŠKI;8168498937;Ne;7;0;0;7
17483;Berželis;PODSOLNUŠKI;8633724383;Taip;11;0;0;11
17484;Berželis;PODSOLNUŠKI;2259367998;Taip;4;0;2;6
17485;Berželis;PODSOLNUŠKI;3033042487;Ne;28;0;0;28
17486;Berželis;PODSOLNUŠKI;2136455625;Taip;0;0;3;3
17487;Berželis;PODSOLNUŠKI;1964320071;Taip;10;3;2;15
17488;Berželis;PODSOLNUŠKI;2615832804;Taip;8;3;0;11
17489;Berželis;PODSOLNUŠKI;9133988149;Taip;6;3;0;9
17490;Berželis;PODSOLNUŠKI;5795151632;Taip;9;0;0;9
17491;Berželis;PODSOLNUŠKI;6686248053;Taip;14;2;0;16
17492;Berželis;PODSOLNUŠKI;1081582842;Taip;6;16;0;22
17493;Berželis;PODSOLNUŠKI;5963915092;Taip;10;0;0;10
17494;Berželis;PODSOLNUŠKI;3378237475;Taip;11;0;0;11
17495;Berželis;LAPIUKAI;2539824027;Taip;0;0;4;4
17496;Berželis;LAPIUKAI;2971765753;Taip;0;0;10;10
17497;Berželis;LAPIUKAI;3813964138;Taip;9;0;1;10
17498;Berželis;LAPIUKAI;9658062645;Taip;9;0;0;9
17499;Berželis;LAPIUKAI;7947225506;Ne;0;0;7;7
17500;Berželis;LAPIUKAI;2144796691;Taip;26;0;0;26
17501;Berželis;LAPIUKAI;1834920753;Ne;0;0;8;8
17502;Berželis;LAPIUKAI;6384939601;Taip;7;0;6;13
17503;Berželis;LAPIUKAI;2410514408;Taip;5;0;0;5
17504;Berželis;LAPIUKAI;2794074071;Taip;9;0;0;9
17505;Berželis;LAPIUKAI;9681310544;Taip;5;7;0;12
17506;Berželis;LAPIUKAI;4254592648;Taip;14;0;0;14
17507;Berželis;LAPIUKAI;9543499205;Taip;8;0;0;8
17508;Berželis;LAPIUKAI;9749516260;Taip;14;0;0;14
17509;Berželis;LAPIUKAI;2947072348;Ne;0;0;3;3
17510;Berželis;MEŠKIUKAI;8994102218;Ne;0;10;0;10
17511;Berželis;MEŠKIUKAI;4854931959;Ne;12;0;2;14
17512;Berželis;MEŠKIUKAI;7902774064;Ne;15;0;1;16
17513;Berželis;MEŠKIUKAI;2062794406;Taip;15;0;0;15
17514;Berželis;MEŠKIUKAI;9459031158;Taip;14;0;0;14
17515;Berželis;MEŠKIUKAI;9178527605;Taip;0;2;0;2
17516;Berželis;MEŠKIUKAI;1235617054;Taip;15;0;0;15
17517;Berželis;MEŠKIUKAI;1178588907;Taip;0;10;0;10
17518;Berželis;MEŠKIUKAI;5100214127;Ne;9;0;0;9
17519;Berželis;MEŠKIUKAI;3535856504;Taip;13;1;0;14
17520;Berželis;MEŠKIUKAI;6186408090;Ne;5;0;3;8
17521;Berželis;MEŠKIUKAI;1673524685;Taip;0;0;1;1
17522;Berželis;MEŠKIUKAI;2762946143;Taip;14;3;0;17
17523;Berželis;MEŠKIUKAI;8560266611;Taip;4;0;1;5
17524;Berželis;MEŠKIUKAI;3936106342;Ne;5;0;0;5
17525;Berželis;ŽIEDELIAI;3786609012;Ne;0;4;0;4
17526;Berželis;ŽIEDELIAI;9805181733;Taip;12;0;1;13
17527;Berželis;ŽIEDELIAI;1165300871;Taip;7;0;6;13
17528;Berželis;ŽIEDELIAI;2016827207;Ne;12;0;0;12
17529;Berželis;ŽIEDELIAI;9979442772;Ne;0;0;11;11
17530;Berželis;ŽIEDELIAI;9881246268;Taip;6;1;0;7
17531;Berželis;ŽIEDELIAI;7042967329;Taip;19;0;0;19
17532;Berželis;ŽIEDELIAI;9925865228;Taip;0;0;11;11
17533;Berželis;ŽIEDELIAI;1402975280;Taip;8;3;0;11
17534;Berželis;ŽIEDELIAI;1535940949;Taip;0;13;0;13
17535;Berželis;ŽIEDELIAI;2030492491;Taip;4;0;0;4
17536;Berželis;ŽIEDELIAI;3351114197;Taip;5;0;12;17
17537;Berželis;ŽIEDELIAI;5248880873;Taip;7;0;3;10
17538;Berželis;ŽIEDELIAI;2262911854;Taip;3;0;0;3
17539;Berželis;ŽIEDELIAI;2508532190;Taip;8;0;2;10
17540;Berželis;ŽIEDELIAI;5649793735;Ne;5;0;0;5
17541;Berželis;NYKŠTUKAI;8148104183;Ne;5;0;3;8
17542;Berželis;NYKŠTUKAI;7935684899;Ne;10;0;9;19
17543;Berželis;NYKŠTUKAI;1403664386;Taip;8;2;0;10
17544;Berželis;NYKŠTUKAI;5637168259;Taip;7;6;0;13
17545;Berželis;NYKŠTUKAI;9666648116;Taip;10;0;2;12
17546;Berželis;NYKŠTUKAI;3559065542;Ne;15;1;5;21
17547;Berželis;NYKŠTUKAI;3556594755;Taip;0;3;5;8
17548;Berželis;NYKŠTUKAI;2933069798;Taip;3;0;1;4
17549;Berželis;NYKŠTUKAI;8430372047;Taip;0;1;4;5
17550;Berželis;NYKŠTUKAI;5099275362;Taip;10;0;0;10
17551;Berželis;NYKŠTUKAI;5101382213;Taip;0;0;5;5
17552;Berželis;NYKŠTUKAI;2425621326;Ne;10;0;2;12
17553;Berželis;NYKŠTUKAI;7676141462;Ne;0;9;4;13
17554;Berželis;NYKŠTUKAI;3852021563;Taip;8;0;0;8
17555;Berželis;NYKŠTUKAI;3379227410;Taip;19;0;1;20
17556;Berželis;NYKŠTUKAI;4032178538;Taip;0;3;0;3
17557;Berželis;NYKŠTUKAI;5839964720;Taip;0;9;0;9
17558;Berželis;UOGELĖS;8735934456;Taip;7;0;0;7
17559;Berželis;UOGELĖS;5304917030;Taip;0;0;4;4
17560;Berželis;UOGELĖS;8907020701;Taip;5;0;0;5
17561;Berželis;UOGELĖS;6136155301;Taip;16;0;5;21
17562;Berželis;UOGELĖS;9950641759;Taip;25;0;5;30
17563;Berželis;UOGELĖS;9034464618;Taip;14;0;0;14
17564;Berželis;UOGELĖS;5851732944;Taip;13;0;3;16
17565;Berželis;UOGELĖS;2321608974;Ne;0;3;4;7
17566;Berželis;UOGELĖS;3229996417;Taip;3;0;7;10
17567;Berželis;UOGELĖS;6773760208;Ne;20;0;0;20
17568;Berželis;UOGELĖS;7750905743;Taip;4;0;0;4
17569;Berželis;UOGELĖS;4607486516;Ne;22;0;0;22
17570;Berželis;UOGELĖS;8814953641;Ne;8;0;0;8
17571;Berželis;UOGELĖS;5197350105;Taip;14;1;0;15
17572;Berželis;KODĖLČIUKAI;5786052354;Ne;6;0;1;7
17573;Berželis;KODĖLČIUKAI;5134372871;Ne;0;1;0;1
17574;Berželis;KODĖLČIUKAI;7852089381;Taip;11;0;3;14
17575;Berželis;KODĖLČIUKAI;5751995154;Ne;9;1;0;10
17576;Berželis;KODĖLČIUKAI;3589890886;Taip;0;1;7;8
17577;Berželis;KODĖLČIUKAI;7986744784;Ne;7;1;0;8
17578;Berželis;KODĖLČIUKAI;1127524998;Taip;16;3;0;19
17579;Berželis;KODĖLČIUKAI;3951962738;Taip;11;2;0;13
17580;Berželis;KODĖLČIUKAI;2193392844;Taip;15;0;1;16
17581;Berželis;KODĖLČIUKAI;9696962207;Taip;8;0;1;9
17582;Berželis;KODĖLČIUKAI;8286301258;Taip;14;0;0;14
17583;Berželis;KODĖLČIUKAI;8875116641;Taip;0;0;3;3
17584;Berželis;KODĖLČIUKAI;9282593781;Taip;6;9;2;17
17585;Berželis;KODĖLČIUKAI;6500588668;Taip;8;0;0;8
17586;Berželis;KODĖLČIUKAI;3327751482;Ne;9;3;6;18
17587;Berželis;KODĖLČIUKAI;6060490387;Taip;0;0;1;1
17588;"Vilniaus savivaldybės Grigiškių lopšelis-darželis „Pelėdžiukas“";Boružiukai;5736036224;Taip;5;0;0;5
17589;"Vilniaus savivaldybės Grigiškių lopšelis-darželis „Pelėdžiukas“";Boružiukai;4858745575;Taip;7;0;0;7
17590;"Vilniaus savivaldybės Grigiškių lopšelis-darželis „Pelėdžiukas“";Bitutės;9354676901;Ne;4;0;0;4
17591;"Vilniaus savivaldybės Grigiškių lopšelis-darželis „Pelėdžiukas“";Bitutės;2149035671;Taip;4;0;0;4
17592;"Vilniaus savivaldybės Grigiškių lopšelis-darželis „Pelėdžiukas“";Bitutės;7619901360;Taip;15;0;0;15
17593;"Vilniaus savivaldybės Grigiškių lopšelis-darželis „Pelėdžiukas“";Šimtakojai;9324834640;Taip;5;0;0;5
17594;"Vilniaus savivaldybės Grigiškių lopšelis-darželis „Pelėdžiukas“";Šimtakojai;9540483835;Ne;13;0;0;13
17595;"Vilniaus savivaldybės Grigiškių lopšelis-darželis „Pelėdžiukas“";Šimtakojai;8509392550;Taip;7;0;0;7
17596;"Vilniaus savivaldybės Grigiškių lopšelis-darželis „Pelėdžiukas“";Voriukai;9091186589;Ne;5;0;0;5
17597;"Vilniaus savivaldybės Grigiškių lopšelis-darželis „Pelėdžiukas“";Voriukai;6933363951;Taip;5;0;0;5
17598;"Vilniaus savivaldybės Grigiškių lopšelis-darželis „Pelėdžiukas“";Žiogeliai;6271697959;Taip;23;0;0;23
17599;"Vilniaus savivaldybės Grigiškių lopšelis-darželis „Pelėdžiukas“";Žiogeliai;4056015075;Ne;4;0;0;4
17600;"Vilniaus savivaldybės Grigiškių lopšelis-darželis „Pelėdžiukas“";Žiogeliai;2271597631;Taip;5;0;0;5
17601;"Vilniaus savivaldybės Grigiškių lopšelis-darželis „Pelėdžiukas“";Žiogeliai;6943790883;Taip;17;0;0;17
17602;"Vilniaus savivaldybės Grigiškių lopšelis-darželis „Pelėdžiukas“";Žiogeliai;7540349241;Taip;13;0;0;13
17603;"Vilniaus savivaldybės Grigiškių lopšelis-darželis „Pelėdžiukas“";SKRUZDELIUKAI;7154840871;Taip;22;0;0;22
17604;"Vilniaus savivaldybės Grigiškių lopšelis-darželis „Pelėdžiukas“";SKRUZDELIUKAI;3037312244;Taip;19;0;0;19
17605;"Vilniaus savivaldybės Grigiškių lopšelis-darželis „Pelėdžiukas“";SKRUZDELIUKAI;5331504479;Taip;10;0;0;10
17606;"Vilniaus savivaldybės Grigiškių lopšelis-darželis „Pelėdžiukas“";DRUGELIAI;7670521802;Ne;11;0;0;11
17607;"Vilniaus savivaldybės Grigiškių lopšelis-darželis „Pelėdžiukas“";DRUGELIAI;3537539278;Taip;5;0;0;5
17608;"Vilniaus savivaldybės Grigiškių lopšelis-darželis „Pelėdžiukas“";LAUMŽIRGIAI;3989005936;Taip;8;0;0;8
17609;Saulutė;Drugeliai;5987478379;Ne;2;0;3;5
17610;Saulutė;Drugeliai;5943795519;Taip;7;1;3;11
17611;Saulutė;Drugeliai;4453610732;Taip;0;0;5;5
17612;Saulutė;Drugeliai;4067009709;Taip;12;1;0;13
17613;Saulutė;Drugeliai;3991128892;Taip;13;0;1;14
17614;Saulutė;Drugeliai;4781756849;Taip;0;22;0;22
17615;Saulutė;Drugeliai;7689842018;Taip;9;0;0;9
17616;Saulutė;Drugeliai;4288298305;Taip;5;1;3;9
17617;Saulutė;Drugeliai;9133269796;Ne;5;1;3;9
17618;Saulutė;Drugeliai;6057938367;Taip;19;0;0;19
17619;Saulutė;Drugeliai;1268204445;Taip;1;1;2;4
17620;Saulutė;Drugeliai;1585403702;Taip;6;0;1;7
17621;Saulutė;Drugeliai;4915192103;Taip;0;0;2;2
17622;Saulutė;Drugeliai;8003855875;Taip;9;0;0;9
17623;Saulutė;Drugeliai;2301903550;Taip;22;0;0;22
17624;Saulutė;Drugeliai;3265401334;Taip;7;0;1;8
17625;Saulutė;Drugeliai;2337702344;Taip;4;2;0;6
17626;Saulutė;Drugeliai;6455593653;Taip;6;1;2;9
17627;Saulutė;Drugeliai;9410517602;Taip;9;0;3;12
17628;Saulutė;Drugeliai;1088813143;Taip;9;0;1;10
17629;Saulutė;Drugeliai;8409958782;Taip;7;1;0;8
17630;Saulutė;Drugeliai;6304028361;Ne;3;1;2;6
17631;Saulutė;"Saulės zuikučiai";8946107286;Taip;4;1;0;5
17632;Saulutė;"Saulės zuikučiai";2397257894;Taip;0;1;6;7
17633;Saulutė;"Saulės zuikučiai";5148542811;Taip;28;0;0;28
17634;Saulutė;"Saulės zuikučiai";2259917151;Taip;0;1;0;1
17635;Saulutė;"Saulės zuikučiai";3749374270;Taip;10;1;0;11
17636;Saulutė;"Saulės zuikučiai";8242602551;Ne;7;7;0;14
17637;Saulutė;"Saulės zuikučiai";5247769309;Taip;5;7;0;12
17638;Saulutė;"Saulės zuikučiai";2816806902;Taip;6;8;0;14
17639;Saulutė;"Saulės zuikučiai";2781003892;Taip;0;4;0;4
17640;Saulutė;"Saulės zuikučiai";7888435573;Taip;7;8;3;18
17641;Saulutė;"Saulės zuikučiai";9521155670;Taip;2;0;1;3
17642;Saulutė;"Saulės zuikučiai";3089541630;Taip;0;13;0;13
17643;Saulutė;"Saulės zuikučiai";5326279083;Taip;0;5;0;5
17644;Saulutė;"Saulės zuikučiai";1562393383;Taip;0;0;9;9
17645;Saulutė;"Saulės zuikučiai";3272296969;Taip;10;6;0;16
17646;Saulutė;"Saulės zuikučiai";6924891265;Taip;0;2;11;13
17647;Saulutė;"Saulės zuikučiai";4663795223;Taip;7;3;3;13
17648;Saulutė;"Saulės zuikučiai";5931269521;Taip;13;0;0;13
17649;Saulutė;"Saulės zuikučiai";7839168221;Taip;11;1;0;12
17650;Saulutė;"Saulės zuikučiai";4945943570;Ne;3;0;6;9
17651;Saulutė;"Saulės zuikučiai";3730442890;Taip;13;3;0;16
17652;Saulutė;"Saulės zuikučiai";3620722907;Taip;8;1;3;12
17653;Saulutė;Boružėlės;3295289082;Taip;0;4;0;4
17654;Saulutė;Boružėlės;1587328722;Taip;2;1;0;3
17655;Saulutė;Boružėlės;8390767549;Taip;9;1;2;12
17656;Saulutė;Boružėlės;7576532632;Taip;5;0;3;8
17657;Saulutė;Boružėlės;2725491887;Taip;22;0;0;22
17658;Saulutė;Boružėlės;9314889468;Taip;4;2;0;6
17659;Saulutė;Boružėlės;7764493159;Taip;7;1;0;8
17660;Saulutė;Boružėlės;5565832676;Taip;7;1;0;8
17661;Saulutė;Boružėlės;5811810714;Taip;11;4;0;15
17662;Saulutė;Boružėlės;8643975544;Ne;10;0;2;12
17663;Saulutė;Boružėlės;7081700501;Taip;6;0;0;6
17664;Saulutė;Boružėlės;7474989619;Ne;0;13;6;19
17665;Saulutė;Boružėlės;8619163154;Ne;0;0;6;6
17666;Saulutė;Boružėlės;7574225926;Taip;8;1;0;9
17667;Saulutė;Boružėlės;1803710557;Ne;7;0;3;10
17668;Saulutė;Boružėlės;9173336078;Taip;9;1;0;10
17669;Saulutė;Boružėlės;9098663596;Taip;6;0;1;7
17670;Saulutė;Boružėlės;7425789805;Taip;0;19;0;19
17671;Saulutė;Boružėlės;1265174091;Taip;0;0;3;3
17672;Saulutė;Boružėlės;2527027536;Taip;0;1;1;2
17673;Saulutė;Boružėlės;2988010963;Taip;0;18;0;18
17674;Saulutė;Boružėlės;3852862834;Taip;4;0;3;7
17675;Saulutė;Boružėlės;1275552038;Taip;0;0;8;8
17676;Saulutė;Nykštukai;2601822200;Taip;7;0;2;9
17677;Saulutė;Nykštukai;3244850673;Taip;0;2;0;2
17678;Saulutė;Nykštukai;9497439410;Taip;0;9;0;9
17679;Saulutė;Nykštukai;5607937410;Taip;4;14;0;18
17680;Saulutė;Nykštukai;3571751974;Taip;5;0;6;11
17681;Saulutė;Nykštukai;3221612665;Ne;12;0;0;12
17682;Saulutė;Nykštukai;2140277182;Taip;6;1;1;8
17683;Saulutė;Nykštukai;4510990261;Taip;30;0;0;30
17684;Saulutė;Nykštukai;4800144085;Taip;0;22;0;22
17685;Saulutė;Nykštukai;8257363228;Taip;2;0;1;3
17686;Saulutė;Nykštukai;9664809396;Ne;18;0;0;18
17687;Saulutė;Nykštukai;8984040932;Taip;9;4;0;13
17688;Saulutė;Nykštukai;3463428772;Taip;11;0;0;11
17689;Saulutė;Nykštukai;4390098560;Taip;4;0;1;5
17690;Saulutė;Nykštukai;3363212754;Taip;4;5;0;9
17691;Saulutė;Nykštukai;5442075474;Taip;18;0;0;18
17692;Saulutė;Nykštukai;8722717930;Ne;0;0;22;22
17693;Saulutė;Nykštukai;9930330487;Taip;5;1;1;7
17694;Saulutė;Nykštukai;7158455528;Taip;7;0;2;9
17695;Saulutė;Nykštukai;2669711574;Ne;9;0;0;9
17696;Saulutė;Nykštukai;6982979199;Taip;7;0;0;7
17697;Saulutė;Meškiukai;8952893819;Taip;0;15;0;15
17698;Saulutė;Meškiukai;4222649372;Ne;13;0;0;13
17699;Saulutė;Meškiukai;1229624643;Taip;0;9;2;11
17700;Saulutė;Meškiukai;9572394489;Taip;15;10;4;29
17701;Saulutė;Meškiukai;9567511354;Taip;10;0;3;13
17702;Saulutė;Meškiukai;6579874077;Taip;0;16;0;16
17703;Saulutė;Meškiukai;6178908581;Ne;0;0;8;8
17704;Saulutė;Meškiukai;8472510151;Taip;0;3;2;5
17705;Saulutė;Meškiukai;6955061957;Taip;7;8;0;15
17706;Saulutė;Meškiukai;7478215328;Taip;10;3;1;14
17707;Saulutė;Meškiukai;9727366891;Taip;11;0;9;20
17708;Saulutė;Meškiukai;5219429911;Taip;0;22;0;22
17709;Saulutė;Meškiukai;3125186472;Taip;13;0;0;13
17710;Saulutė;Meškiukai;8919457259;Taip;8;0;0;8
17711;Saulutė;Meškiukai;5509365461;Taip;13;0;1;14
17712;Saulutė;Meškiukai;8787977881;Ne;0;0;3;3
17713;Saulutė;Meškiukai;8147755754;Taip;9;0;0;9
17714;Saulutė;Ežiukai;2813274509;Ne;15;0;3;18
17715;Saulutė;Ežiukai;3410606033;Taip;0;8;0;8
17716;Saulutė;Ežiukai;2315812734;Taip;3;11;8;22
17717;Saulutė;Ežiukai;2059342403;Ne;8;0;0;8
17718;Saulutė;Ežiukai;8736917541;Taip;3;0;0;3
17719;Saulutė;Ežiukai;5999318972;Taip;12;0;0;12
17720;Saulutė;Ežiukai;4363210987;Taip;14;3;1;18
17721;Saulutė;Ežiukai;5972503001;Taip;2;0;2;4
17722;Saulutė;Ežiukai;6884472677;Taip;8;0;0;8
17723;Saulutė;Ežiukai;6219942114;Taip;6;0;0;6
17724;Saulutė;Ežiukai;4194586403;Ne;19;0;0;19
17725;Saulutė;Ežiukai;1853984777;Taip;19;0;0;19
17726;Saulutė;Ežiukai;1666301750;Ne;0;3;11;14
17727;Saulutė;Ežiukai;3133714991;Taip;0;0;8;8
17728;Saulutė;Ežiukai;4039065925;Ne;0;0;5;5
17729;Saulutė;Ežiukai;7967532537;Taip;0;0;1;1
17730;Saulutė;Ežiukai;1370201372;Taip;0;2;0;2
17731;Saulutė;Ežiukai;5335820652;Taip;0;0;1;1
17732;Saulutė;Ežiukai;2728669975;Taip;6;1;0;7
17733;Saulutė;Ežiukai;9892855816;Taip;6;0;0;6
17734;Saulutė;Ežiukai;9398356470;Taip;13;9;0;22
17735;Saulutė;Ežiukai;6126870829;Taip;6;0;0;6
17736;Saulutė;Bitutės;5200638523;Ne;12;3;1;16
17737;Saulutė;Bitutės;5448950324;Taip;31;0;0;31
17738;Saulutė;Bitutės;3948540247;Taip;4;0;5;9
17739;Saulutė;Bitutės;4130972647;Taip;9;0;3;12
17740;Saulutė;Bitutės;3242810449;Ne;10;10;0;20
17741;Saulutė;Bitutės;7032417938;Taip;0;0;10;10
17742;Saulutė;Bitutės;5897526863;Taip;8;5;1;14
17743;Saulutė;Bitutės;1648978545;Taip;4;15;3;22
17744;Saulutė;Bitutės;6927834443;Taip;2;15;0;17
17745;Saulutė;Bitutės;8714520840;Ne;0;22;0;22
17746;Saulutė;Bitutės;9726675673;Taip;22;0;0;22
17747;Saulutė;Bitutės;8520474896;Taip;22;0;0;22
17748;Saulutė;Bitutės;6189637986;Taip;9;1;0;10
17749;Saulutė;Bitutės;7132125341;Taip;14;0;0;14
17750;Saulutė;Bitutės;3215349379;Taip;8;9;3;20
17751;Saulutė;Bitutės;3259790911;Taip;10;0;6;16
17752;Saulutė;Bitutės;7311594119;Taip;12;3;1;16
17753;Saulutė;Pelėdžiukai;8512137633;Taip;0;2;2;4
17754;Saulutė;Pelėdžiukai;7139492238;Taip;5;0;3;8
17755;Saulutė;Pelėdžiukai;4211866191;Taip;5;0;4;9
17756;Saulutė;Pelėdžiukai;2373409300;Taip;0;0;9;9
17757;Saulutė;Pelėdžiukai;8405262902;Taip;10;0;1;11
17758;Saulutė;Pelėdžiukai;1745754752;Taip;0;0;1;1
17759;Saulutė;Pelėdžiukai;4123500930;Ne;0;3;1;4
17760;Saulutė;Pelėdžiukai;1056158093;Taip;7;0;4;11
17761;Saulutė;Pelėdžiukai;8371366346;Taip;0;0;12;12
17762;Saulutė;Pelėdžiukai;6842585310;Taip;10;2;1;13
17763;Saulutė;Pelėdžiukai;1776164273;Taip;6;2;1;9
17764;Saulutė;Pelėdžiukai;5850783789;Taip;10;3;0;13
17765;Saulutė;Pelėdžiukai;6608003946;Taip;0;22;0;22
17766;Saulutė;Pelėdžiukai;7243072252;Taip;0;1;0;1
17767;Saulutė;Pelėdžiukai;9903380188;Taip;0;0;4;4
17768;Saulutė;Pelėdžiukai;2450554594;Taip;0;1;0;1
17769;Saulutė;Pelėdžiukai;7620841597;Taip;5;0;0;5
17770;Saulutė;Pelėdžiukai;7640441297;Taip;0;0;4;4
17771;Saulutė;Pelėdžiukai;6046611248;Taip;9;13;0;22
17772;Saulutė;Pelėdžiukai;4301516165;Taip;0;22;0;22
17773;Saulutė;Pelėdžiukai;7258180835;Ne;10;0;0;10
17774;Saulutė;Pelėdžiukai;2566263680;Ne;6;2;4;12
17775;Saulutė;Pelėdžiukai;9106119465;Ne;0;0;8;8
17776;Saulutė;Zylutės;3228226715;Taip;16;4;0;20
17777;Saulutė;Zylutės;8040751073;Ne;7;0;1;8
17778;Saulutė;Zylutės;2074473832;Taip;6;1;0;7
17779;Saulutė;Zylutės;8041118115;Taip;0;22;0;22
17780;Saulutė;Zylutės;5198558993;Taip;22;0;0;22
17781;Saulutė;Zylutės;6109527712;Ne;4;1;0;5
17782;Saulutė;Zylutės;7446423510;Taip;13;0;3;16
17783;Saulutė;Zylutės;8717210130;Taip;7;2;4;13
17784;Saulutė;Zylutės;5264813819;Taip;0;0;5;5
17785;Saulutė;Zylutės;2885398200;Taip;0;3;1;4
17786;Saulutė;Zylutės;7844396402;Taip;0;2;0;2
17787;Saulutė;Zylutės;7351477901;Taip;10;3;0;13
17788;Saulutė;Zylutės;9146298505;Ne;0;12;0;12
17789;Saulutė;Zylutės;1324799653;Taip;0;4;0;4
17790;Saulutė;Zylutės;3691381351;Taip;0;2;0;2
17791;Saulutė;Zylutės;2010774109;Taip;3;6;0;9
17792;Saulutė;Zylutės;1546200973;Taip;2;0;2;4
17793;Saulutė;Zylutės;8379304869;Ne;1;3;2;6
17794;Saulutė;Zylutės;66108847230;Taip;0;14;0;14
17795;Saulutė;Zylutės;95439358242;Ne;0;1;0;1
17796;Saulutė;Zylutės;9947607411;Ne;5;3;1;9
17797;Saulutė;Zylutės;3408369823;Taip;0;3;8;11
17798;Saulutė;"1 klasė";1717909005;Taip;5;1;0;6
17799;Saulutė;"1 klasė";87814849917;Taip;2;1;0;3
17800;Saulutė;"1 klasė";84919478493;Taip;6;1;0;7
17801;Saulutė;"1 klasė";1320018338;Taip;3;1;0;4
17802;Saulutė;"1 klasė";8599199376;Taip;2;1;0;3
17803;Saulutė;"1 klasė";8944601874;Taip;2;1;0;3
17804;Saulutė;"1 klasė";3064199909;Taip;3;1;0;4
17805;Saulutė;"1 klasė";1556270046;Taip;2;1;0;3
17806;Saulutė;"1 klasė";4272320685;Taip;5;1;0;6
17807;Saulutė;"1 klasė";1291318940;Taip;3;1;0;4
17808;Saulutė;"1 klasė";1391904744;Taip;15;1;0;16
17809;Saulutė;"1 klasė";6096297366;Ne;2;1;0;3
17810;Saulutė;"1 klasė";1609952589;Taip;0;1;0;1
17811;Saulutė;"1 klasė";1513449225;Taip;12;1;0;13
17812;Saulutė;"1 klasė";7281873166;Taip;3;1;0;4
17813;Saulutė;"1 klasė";1911318708;Taip;3;1;0;4
17814;Saulutė;"1 klasė";28772515317;Taip;6;1;0;7
17815;Saulutė;"1 klasė";1786491396;Taip;1;1;0;2
17816;Saulutė;"1 klasė";1332002470;Taip;2;1;0;3
17817;Saulutė;"1 klasė";16622528829;Taip;16;1;0;17
17818;Saulutė;"1 klasė";61073095949;Taip;2;1;0;3
17819;Saulutė;"1 klasė";3505492809;Taip;2;1;0;3
17820;Saulutė;"1 klasė";8952155496;Ne;0;1;0;1
17821;Saulutė;"1 klasė";9235972927;Taip;2;1;0;3
17822;Saulutė;"1 klasė";2677995903;Taip;1;1;0;2
17823;Saulutė;"1 klasė";1386800520;Ne;4;1;0;5
17824;Saulutė;"1 klasė";89920419797;Taip;5;1;0;6
17825;Saulutė;"2 klasė";45306237230;Taip;3;1;0;4
17826;Saulutė;"2 klasė";79438946697;Taip;7;1;0;8
17827;Saulutė;"2 klasė";79919438191;Ne;5;1;0;6
17828;Saulutė;"2 klasė";29074930927;Taip;1;1;0;2
17829;Saulutė;"2 klasė";8369703027;Taip;0;1;0;1
17830;Saulutė;"2 klasė";21605684303;Taip;8;1;0;9
17831;Saulutė;"2 klasė";31705050946;Taip;3;1;0;4
17832;Saulutė;"2 klasė";2622662153;Ne;7;1;0;8
17833;Saulutė;"2 klasė";9612975694;Taip;3;1;0;4
17834;Saulutė;"2 klasė";37315117916;Taip;0;1;0;1
17835;Saulutė;"2 klasė";3445723020;Ne;7;1;0;8
17836;Saulutė;"2 klasė";14195215027;Taip;3;1;0;4
17837;Saulutė;"2 klasė";2098990667;Taip;0;1;0;1
17838;Saulutė;"2 klasė";27386434894;Taip;0;1;0;1
17839;Saulutė;"2 klasė";77923802656;Taip;2;1;0;3
17840;Saulutė;"2 klasė";46280382280;Taip;0;1;0;1
17841;Saulutė;"2 klasė";1935503629;Taip;3;1;0;4
17842;Saulutė;"2 klasė";75405796772;Taip;2;1;0;3
17843;Saulutė;"2 klasė";1277263391;Taip;6;1;0;7
17844;Saulutė;"2 klasė";97145959022;Taip;4;1;0;5
17845;Saulutė;"2 klasė";64418469679;Taip;0;1;0;1
17846;Saulutė;"2 klasė";77170708225;Taip;1;1;0;2
17847;Saulutė;"2 klasė";4640909915;Ne;1;1;0;2
17848;Saulutė;"2 klasė";65492344097;Taip;0;1;0;1
17849;Saulutė;"2 klasė";1704733670;Ne;1;1;0;2
17850;Saulutė;"2 klasė";1534183935;Taip;4;1;0;5
17851;Saulutė;"2 klasė";5574049005;Ne;8;1;0;9
17852;Saulutė;"2 klasė";1510434265;Taip;5;1;0;6
17853;Saulutė;"3 klasė";1005459768;Taip;1;1;0;2
17854;Saulutė;"3 klasė";1804521229;Taip;3;1;0;4
17855;Saulutė;"3 klasė";76108591835;Ne;1;1;0;2
17856;Saulutė;"3 klasė";1475031090;Taip;12;1;0;13
17857;Saulutė;"3 klasė";3156830821;Taip;2;1;0;3
17858;Saulutė;"3 klasė";5741276602;Taip;0;1;0;1
17859;Saulutė;"3 klasė";3246485288;Taip;2;1;0;3
17860;Saulutė;"3 klasė";44452051978;Ne;3;1;0;4
17861;Saulutė;"3 klasė";78967475616;Ne;1;1;0;2
17862;Saulutė;"3 klasė";89710141573;Taip;3;1;0;4
17863;Saulutė;"3 klasė";25124975646;Taip;3;1;0;4
17864;Saulutė;"3 klasė";3450668814;Taip;0;1;0;1
17865;Saulutė;"3 klasė";8168961080;Ne;5;1;0;6
17866;Saulutė;"3 klasė";57283533169;Taip;1;1;0;2
17867;Saulutė;"3 klasė";76744652185;Taip;4;1;0;5
17868;Saulutė;"3 klasė";97296161595;Taip;0;1;0;1
17869;Saulutė;"3 klasė";87409240076;Taip;7;1;0;8
17870;Saulutė;"3 klasė";1205642335;Taip;13;1;0;14
17871;Saulutė;"3 klasė";2426509692;Ne;13;1;0;14
17872;Saulutė;"3 klasė";36414547943;Taip;0;1;0;1
17873;Saulutė;"3 klasė";99841176399;Taip;5;1;0;6
17874;Saulutė;"3 klasė";21703177024;Taip;2;1;0;3
17875;Saulutė;"3 klasė";1337654926;Taip;6;1;0;7
17876;Saulutė;"3 klasė";54950572289;Taip;3;1;0;4
17877;Saulutė;"3 klasė";13147367113;Taip;5;1;0;6
17878;Saulutė;"3 klasė";2216383015;Taip;0;1;0;1
17879;Saulutė;"3 klasė";1644704074;Taip;1;1;0;2
17880;Saulutė;"3 klasė";96497471950;Taip;4;1;0;5
17881;Saulutė;"3 klasė";6557918941;Ne;1;1;0;2
17882;Saulutė;"3 klasė";2787531476;Ne;2;1;0;3
17883;Saulutė;"4 klasė";5822529731;Taip;1;1;0;2
17884;Saulutė;"4 klasė";67739063665;Ne;5;1;0;6
17885;Saulutė;"4 klasė";13916981850;Taip;2;1;0;3
17886;Saulutė;"4 klasė";39606108938;Ne;3;1;0;4
17887;Saulutė;"4 klasė";81191097069;Taip;3;1;0;4
17888;Saulutė;"4 klasė";92198716772;Taip;6;1;0;7
17889;Saulutė;"4 klasė";16523279366;Taip;0;1;0;1
17890;Saulutė;"4 klasė";2262536579;Taip;4;1;0;5
17891;Saulutė;"4 klasė";2095347468;Ne;11;1;0;12
17892;Saulutė;"4 klasė";2819521168;Taip;5;1;0;6
17893;Saulutė;"4 klasė";37839378248;Taip;1;1;0;2
17894;Saulutė;"4 klasė";8308288099;Ne;4;1;0;5
17895;Saulutė;"4 klasė";30863736694;Taip;5;1;0;6
17896;Saulutė;"4 klasė";12964000357;Taip;3;1;0;4
17897;Saulutė;"4 klasė";54726632101;Taip;0;1;0;1
17898;Saulutė;"4 klasė";25720655179;Taip;1;1;0;2
17899;Saulutė;"4 klasė";45877127245;Taip;4;1;0;5
17900;Saulutė;"4 klasė";82106514982;Taip;2;1;0;3
17901;Saulutė;"4 klasė";61113930769;Taip;3;1;0;4
17902;Saulutė;"4 klasė";5213320470;Ne;8;1;0;9
17903;Saulutė;"4 klasė";90078805222;Taip;2;1;0;3
17904;Saulutė;"4 klasė";50110262859;Taip;4;1;0;5
17905;Saulutė;"4 klasė";42204884890;Ne;12;1;0;13
17906;Svaja;SAULĖGRĄŽA;4189290919;Taip;0;22;0;22
17907;Svaja;SAULĖGRĄŽA;4333001830;Taip;6;0;1;7
17908;Svaja;SAULĖGRĄŽA;6980866050;Taip;0;0;4;4
17909;Svaja;SAULĖGRĄŽA;3912426942;Taip;4;2;0;6
17910;Svaja;SAULĖGRĄŽA;9680766688;Taip;6;3;3;12
17911;Svaja;SAULĖGRĄŽA;3809817617;Ne;0;0;1;1
17912;Svaja;SAULĖGRĄŽA;3792660330;Taip;4;1;0;5
17913;Svaja;SAULĖGRĄŽA;4253831334;Taip;3;0;4;7
17914;Svaja;SAULĖGRĄŽA;3461282516;Taip;0;3;3;6
17915;Svaja;SAULĖGRĄŽA;9240037050;Taip;15;3;0;18
17916;Svaja;SAULĖGRĄŽA;7089640807;Taip;10;5;0;15
17917;Svaja;SAULĖGRĄŽA;6963684639;Taip;0;2;0;2
17918;Svaja;SAULĖGRĄŽA;4510147045;Taip;20;1;0;21
17919;Svaja;SAULĖGRĄŽA;6928763381;Taip;17;0;3;20
17920;Svaja;SAULĖGRĄŽA;3501620040;Taip;10;4;0;14
17921;Svaja;SAULĖGRĄŽA;7575922215;Taip;12;0;0;12
17922;Svaja;SAULĖGRĄŽA;7408966637;Taip;7;3;0;10
17923;Svaja;SAULĖGRĄŽA;7747251736;Taip;0;0;4;4
17924;Svaja;"STEBUKLINGAS ŽIBINTAS";9814969596;Taip;7;3;1;11
17925;Svaja;"STEBUKLINGAS ŽIBINTAS";2200408537;Taip;0;1;3;4
17926;Svaja;"STEBUKLINGAS ŽIBINTAS";9086270220;Taip;17;0;0;17
17927;Svaja;"STEBUKLINGAS ŽIBINTAS";3940123543;Taip;17;0;0;17
17928;Svaja;"STEBUKLINGAS ŽIBINTAS";8353427144;Taip;4;3;0;7
17929;Svaja;"STEBUKLINGAS ŽIBINTAS";9843726794;Taip;7;1;1;9
17930;Svaja;"STEBUKLINGAS ŽIBINTAS";4237592104;Ne;17;0;0;17
17931;Svaja;"STEBUKLINGAS ŽIBINTAS";2658828200;Taip;0;8;0;8
17932;Svaja;"STEBUKLINGAS ŽIBINTAS";4290716676;Taip;7;0;0;7
17933;Svaja;"STEBUKLINGAS ŽIBINTAS";1558093905;Taip;13;0;0;13
17934;Svaja;"STEBUKLINGAS ŽIBINTAS";9102872020;Taip;4;0;2;6
17935;Svaja;"STEBUKLINGAS ŽIBINTAS";8827421660;Taip;8;2;0;10
17936;Svaja;"STEBUKLINGAS ŽIBINTAS";7277217069;Taip;6;1;3;10
17937;Svaja;"STEBUKLINGAS ŽIBINTAS";9259478140;Ne;11;0;0;11
17938;Svaja;"STEBUKLINGAS ŽIBINTAS";1050291871;Taip;17;1;0;18
17939;Svaja;"STEBUKLINGAS ŽIBINTAS";2188430052;Taip;16;1;0;17
17940;Svaja;"STEBUKLINGAS ŽIBINTAS";1860076171;Ne;8;0;2;10
17941;Svaja;"STEBUKLINGAS ŽIBINTAS";8363418532;Taip;6;0;5;11
17942;Svaja;"STEBUKLINGAS ŽIBINTAS";8172396846;Taip;8;6;0;14
17943;Svaja;"STEBUKLINGAS ŽIBINTAS";9545690301;Taip;4;1;1;6
17944;Svaja;"STEBUKLINGAS ŽIBINTAS";4004383843;Taip;5;5;0;10
17945;Svaja;"STEBUKLINGAS ŽIBINTAS";6128350581;Taip;6;3;1;10
17946;Svaja;"STEBUKLINGAS ŽIBINTAS";1150040935;Taip;7;0;0;7
17947;Svaja;SAULUTĖ;50207734108;Ne;0;1;0;1
17948;Svaja;SAULUTĖ;20473739993;Taip;10;1;2;13
17949;Svaja;SAULUTĖ;30719991872;Ne;21;0;0;21
17950;Svaja;SAULUTĖ;6665752307;Taip;13;1;0;14
17951;Svaja;SAULUTĖ;4968201186;Ne;8;3;0;11
17952;Svaja;SAULUTĖ;8689706130;Taip;0;5;0;5
17953;Svaja;SAULUTĖ;6807834176;Taip;15;1;0;16
17954;Svaja;SAULUTĖ;7020342969;Taip;0;3;0;3
17955;Svaja;SAULUTĖ;3633996231;Taip;21;0;3;24
17956;Svaja;SAULUTĖ;2750615517;Taip;10;0;0;10
17957;Svaja;SAULUTĖ;3049808328;Ne;12;0;0;12
17958;Svaja;SAULUTĖ;1045300185;Taip;0;0;3;3
17959;Svaja;SAULUTĖ;4341042027;Taip;0;3;0;3
17960;Svaja;SAULUTĖ;3802996573;Ne;23;0;1;24
17961;Svaja;SAULUTĖ;7936765752;Taip;7;3;0;10
17962;Svaja;SAULUTĖ;4293339784;Taip;18;0;0;18
17963;Svaja;SAULUTĖ;9475971731;Taip;11;0;0;11
17964;Svaja;SAULUTĖ;5479482244;Ne;4;0;1;5
17965;Svaja;SAULUTĖ;7473493846;Taip;22;0;0;22
17966;Svaja;SAULUTĖ;5443682744;Taip;7;3;0;10
17967;Svaja;SAULUTĖ;9112198914;Taip;0;1;2;3
17968;Svaja;SAULUTĖ;2166382346;Ne;12;1;0;13
17969;Svaja;SAULUTĖ;8656417794;Taip;9;1;0;10
17970;Svaja;SAULUTĖ;3630922360;Taip;5;0;0;5
17971;Svaja;SAULUTĖ;1377813636;Taip;3;4;1;8
17972;Svaja;"AUKSINĖ ŽUVELĖ";4565097904;Taip;0;0;9;9
17973;Svaja;"AUKSINĖ ŽUVELĖ";9091970902;Taip;4;0;0;4
17974;Svaja;"AUKSINĖ ŽUVELĖ";9826552657;Ne;5;1;6;12
17975;Svaja;"AUKSINĖ ŽUVELĖ";6028471687;Taip;22;0;1;23
17976;Svaja;"AUKSINĖ ŽUVELĖ";1877749103;Taip;10;0;0;10
17977;Svaja;"AUKSINĖ ŽUVELĖ";5033214011;Taip;4;1;0;5
17978;Svaja;"AUKSINĖ ŽUVELĖ";5224855138;Taip;0;1;3;4
17979;Svaja;"AUKSINĖ ŽUVELĖ";5013548619;Taip;0;3;0;3
17980;Svaja;"AUKSINĖ ŽUVELĖ";5908440171;Taip;0;0;5;5
17981;Svaja;"AUKSINĖ ŽUVELĖ";5230444195;Taip;4;0;0;4
17982;Svaja;"AUKSINĖ ŽUVELĖ";1914129062;Taip;16;0;0;16
17983;Svaja;"AUKSINĖ ŽUVELĖ";3567924341;Taip;8;0;4;12
17984;Svaja;"AUKSINĖ ŽUVELĖ";2427918378;Taip;8;3;0;11
17985;Svaja;"AUKSINĖ ŽUVELĖ";3377044908;Taip;14;0;0;14
17986;Svaja;"AUKSINĖ ŽUVELĖ";7605002899;Ne;0;3;4;7
17987;Svaja;"AUKSINĖ ŽUVELĖ";5198482539;Taip;0;2;2;4
17988;Svaja;"AUKSINĖ ŽUVELĖ";7562678317;Taip;16;0;0;16
17989;Svaja;"AUKSINĖ ŽUVELĖ";2641473764;Taip;14;0;0;14
17990;Svaja;"AUKSINĖ ŽUVELĖ";7434898745;Taip;5;5;0;10
17991;Svaja;"PRIE ĮLANKOS";5595087767;Ne;0;6;0;6
17992;Svaja;"PRIE ĮLANKOS";8503177793;Taip;9;0;1;10
17993;Svaja;"PRIE ĮLANKOS";1633236289;Taip;0;15;1;16
17994;Svaja;"PRIE ĮLANKOS";9414846817;Taip;10;0;0;10
17995;Svaja;"PRIE ĮLANKOS";9311520300;Ne;0;1;1;2
17996;Svaja;"PRIE ĮLANKOS";9864664937;Taip;0;4;0;4
17997;Svaja;"PRIE ĮLANKOS";4014493868;Taip;3;4;0;7
17998;Svaja;"PRIE ĮLANKOS";6388514464;Taip;3;4;0;7
17999;Svaja;"PRIE ĮLANKOS";5862570666;Taip;1;0;2;3
18000;Svaja;"PRIE ĮLANKOS";2018689468;Taip;7;1;2;10
18001;Svaja;"PRIE ĮLANKOS";3459060550;Taip;22;0;0;22
18002;Svaja;"PRIE ĮLANKOS";1392455608;Taip;0;1;1;2
18003;Svaja;"PRIE ĮLANKOS";1617844709;Taip;9;0;1;10
18004;Svaja;"PRIE ĮLANKOS";3458374439;Taip;0;0;1;1
18005;Svaja;"PRIE ĮLANKOS";3102257512;Taip;0;0;2;2
18006;Svaja;"PRIE ĮLANKOS";4393041946;Taip;0;3;0;3
18007;Svaja;"PRIE ĮLANKOS";1044733634;Taip;2;0;0;2
18008;Svaja;"PRIE ĮLANKOS";6676145522;Ne;10;1;0;11
18009;Svaja;"PRIE ĮLANKOS";1671495181;Taip;4;1;0;5
18010;Svaja;"PRIE ĮLANKOS";9950569499;Taip;3;0;0;3
18011;Svaja;"PRIE ĮLANKOS";4284157599;Taip;12;0;1;13
18012;Svaja;"PRIE ĮLANKOS";3868254757;Taip;0;1;2;3
18013;Svaja;"PRIE ĮLANKOS";6361228838;Taip;0;0;5;5
18014;Svaja;"PRIE ĮLANKOS";7514587933;Ne;0;1;8;9
18015;Svaja;"1 B klasė";24863928147;Taip;0;3;0;3
18016;Svaja;"1 B klasė";1865658456;Taip;0;7;0;7
18017;Svaja;"1 B klasė";8279605005;Taip;0;22;0;22
18018;Svaja;"1 B klasė";55925058866;Taip;0;22;0;22
18019;Svaja;"1 B klasė";1437557657;Taip;12;6;0;18
18020;Svaja;"1 B klasė";25194696146;Taip;0;5;0;5
18021;Svaja;"1 B klasė";1704075006;Taip;7;5;0;12
18022;Svaja;"1 B klasė";8875237023;Taip;0;5;0;5
18023;Svaja;"1 B klasė";64196174690;Taip;7;15;0;22
18024;Svaja;"1 B klasė";8491275729;Taip;0;1;0;1
18025;Svaja;"1 B klasė";21871530266;Taip;0;3;0;3
18026;Svaja;"1 B klasė";7753488216;Taip;0;3;0;3
18027;Svaja;"1 B klasė";36505115395;Taip;0;22;0;22
18028;Svaja;"1 B klasė";7911488445;Taip;0;7;0;7
18029;Svaja;"1 B klasė";6593047776;Taip;5;3;0;8
18030;Svaja;"1 B klasė";15159708127;Ne;0;13;0;13
18031;Svaja;"1 B klasė";2985196852;Taip;0;6;0;6
18032;Svaja;"1 B klasė";9110985103;Taip;0;2;0;2
18033;Svaja;"1 B klasė";3562817807;Taip;0;13;0;13
18034;Svaja;"1 B klasė";2069150261;Ne;0;1;0;1
18035;Svaja;"1 B klasė";1191494598;Ne;0;1;0;1
18036;Svaja;"1 B klasė";11671380984;Taip;0;6;0;6
18037;Svaja;"1 B klasė";99183628764;Taip;0;5;0;5
18038;Svaja;"1 B klasė";1369637618;Taip;0;5;0;5
18039;Svaja;"1 B klasė";3660152224;Taip;0;1;0;1
18040;Svaja;"1 A klasė";5337604370;Taip;0;3;0;3
18041;Svaja;"1 A klasė";1046879533;Taip;0;8;0;8
18042;Svaja;"1 A klasė";2147266053;Taip;0;1;0;1
18043;Svaja;"1 A klasė";4846025153;Taip;0;3;0;3
18044;Svaja;"1 A klasė";1714711904;Taip;0;4;0;4
18045;Svaja;"1 A klasė";47457128214;Taip;4;5;0;9
18046;Svaja;"1 A klasė";65917456866;Ne;0;1;0;1
18047;Svaja;"1 A klasė";1197826066;Taip;0;1;0;1
18048;Svaja;"1 A klasė";73679997517;Taip;0;22;0;22
18049;Svaja;"1 A klasė";7669562010;Ne;0;4;0;4
18050;Svaja;"1 A klasė";5335776957;Taip;0;22;0;22
18051;Svaja;"1 A klasė";56117509354;Taip;0;6;0;6
18052;Svaja;"1 A klasė";27445299450;Taip;0;2;0;2
18053;Svaja;"1 A klasė";1576498450;Taip;4;3;0;7
18054;Svaja;"1 A klasė";43307670660;Taip;6;17;0;23
18055;Svaja;"1 A klasė";22702341083;Taip;0;8;0;8
18056;Svaja;"1 A klasė";70641067006;Taip;0;22;0;22
18057;Svaja;"1 A klasė";58102699652;Taip;5;1;0;6
18058;Svaja;"1 A klasė";2076060840;Taip;0;5;0;5
18059;Svaja;"1 A klasė";4900757614;Taip;0;1;0;1
18060;Svaja;"1 A klasė";1061894314;Taip;0;1;0;1
18061;Svaja;"1 A klasė";8697355813;Ne;0;4;0;4
18062;Svaja;"1 A klasė";193181908;Ne;0;1;0;1
18063;Svaja;"1 A klasė";193181908;Ne;0;1;0;1
18064;Svaja;"2 A klasė";9628146488;Ne;0;1;0;1
18065;Svaja;"2 A klasė";1562041360;Taip;0;7;0;7
18066;Svaja;"2 A klasė";43223177664;Taip;3;1;0;4
18067;Svaja;"2 A klasė";1017471747;Taip;0;3;0;3
18068;Svaja;"2 A klasė";26500981786;Taip;0;2;0;2
18069;Svaja;"2 A klasė";5522433229;Ne;0;5;0;5
18070;Svaja;"2 A klasė";1400892707;Taip;4;1;0;5
18071;Svaja;"2 A klasė";30027404222;Taip;0;1;0;1
18072;Svaja;"2 A klasė";23112873505;Taip;0;5;0;5
18073;Svaja;"2 A klasė";15246943974;Taip;0;3;0;3
18074;Svaja;"2 A klasė";1297727288;Taip;0;4;0;4
18075;Svaja;"2 A klasė";1304775332;Taip;0;3;0;3
18076;Svaja;"2 A klasė";8198614500;Taip;0;1;0;1
18077;Svaja;"2 A klasė";67462299886;Taip;0;4;0;4
18078;Svaja;"2 A klasė";40856210635;Taip;0;5;0;5
18079;Svaja;"2 A klasė";18733824395;Taip;0;1;0;1
18080;Svaja;"2 A klasė";84508228457;Taip;0;11;0;11
18081;Svaja;"2 A klasė";2058827699;Taip;0;4;0;4
18082;Svaja;"2 A klasė";1352488176;Taip;0;1;0;1
18083;Svaja;"2 A klasė";1660742385;Taip;0;5;0;5
18084;Svaja;"2 A klasė";89042677798;Taip;0;3;0;3
18085;Svaja;"2 A klasė";26902749194;Taip;0;1;0;1
18086;Svaja;"2 A klasė";3022690832;Taip;0;2;0;2
18087;Svaja;"2 A klasė";1943166503;Taip;0;7;0;7
18088;Svaja;"2 A klasė";1048576329;Taip;1;4;0;5
18089;Svaja;"2 B klasė";4804779327;Taip;3;19;0;22
18090;Svaja;"2 B klasė";7719185632;Taip;10;3;0;13
18091;Svaja;"2 B klasė";69028070656;Taip;0;3;0;3
18092;Svaja;"2 B klasė";54745410330;Taip;0;1;0;1
18093;Svaja;"2 B klasė";30036722764;Taip;0;5;0;5
18094;Svaja;"2 B klasė";1509272327;Taip;0;1;0;1
18095;Svaja;"2 B klasė";1601648171;Ne;0;1;0;1
18096;Svaja;"2 B klasė";89316574266;Taip;0;4;0;4
18097;Svaja;"2 B klasė";78293798850;Taip;0;3;0;3
18098;Svaja;"2 B klasė";40814723278;Taip;0;1;0;1
18099;Svaja;"2 B klasė";1967394949;Taip;0;4;0;4
18100;Svaja;"2 B klasė";4881476441;Taip;0;1;0;1
18101;Svaja;"2 B klasė";87432529423;Taip;0;1;0;1
18102;Svaja;"2 B klasė";19887874988;Ne;0;6;0;6
18103;Svaja;"2 B klasė";69413101571;Taip;0;6;0;6
18104;Svaja;"2 B klasė";57216954289;Taip;0;4;0;4
18105;Svaja;"2 B klasė";1655551042;Taip;0;8;0;8
18106;Svaja;"2 B klasė";76618850202;Taip;3;1;0;4
18107;Svaja;"2 B klasė";21608020858;Taip;0;1;0;1
18108;Svaja;"2 B klasė";3077814152;Taip;0;8;0;8
18109;Svaja;"2 B klasė";809734624;Taip;0;5;0;5
18110;Svaja;"2 B klasė";44989143252;Taip;0;1;0;1
18111;Svaja;"2 B klasė";6056157113;Ne;0;4;0;4
18112;Svaja;"2 B klasė";30360097999;Taip;0;22;0;22
18113;Svaja;"2 B klasė";1378219785;Taip;0;1;0;1
18114;Svaja;"3 A klasė";72752022712;Taip;0;13;0;13
18115;Svaja;"3 A klasė";8828911320;Taip;0;6;0;6
18116;Svaja;"3 A klasė";60448774566;Taip;5;3;0;8
18117;Svaja;"3 A klasė";75104768118;Taip;10;1;0;11
18118;Svaja;"3 A klasė";1649920341;Taip;0;1;0;1
18119;Svaja;"3 A klasė";30754812113;Taip;0;2;0;2
18120;Svaja;"3 A klasė";64487515384;Taip;6;22;0;28
18121;Svaja;"3 A klasė";34216516886;Ne;0;6;0;6
18122;Svaja;"3 A klasė";3474439050;Taip;0;4;0;4
18123;Svaja;"3 A klasė";63346231562;Taip;3;22;0;25
18124;Svaja;"3 A klasė";75296600945;Ne;0;7;0;7
18125;Svaja;"3 A klasė";6057524892;Taip;0;22;0;22
18126;Svaja;"3 A klasė";2321739150;Ne;0;4;0;4
18127;Svaja;"3 A klasė";4617061890;Ne;5;1;0;6
18128;Svaja;"3 A klasė";89695643588;Taip;0;6;0;6
18129;Svaja;"3 A klasė";3604946305;Taip;0;22;0;22
18130;Svaja;"3 A klasė";25578518444;Taip;0;3;0;3
18131;Svaja;"3 A klasė";1168637823;Taip;0;9;0;9
18132;Svaja;"3 A klasė";4906784415;Taip;0;3;0;3
18133;Svaja;"3 A klasė";15252353189;Taip;0;8;0;8
18134;Svaja;"3 B klasė";6905550313;Ne;0;12;0;12
18135;Svaja;"3 B klasė";62971657427;Taip;0;4;0;4
18136;Svaja;"3 B klasė";1367687415;Taip;6;5;0;11
18137;Svaja;"3 B klasė";4416877973;Taip;0;4;0;4
18138;Svaja;"3 B klasė";1847775266;Taip;0;22;0;22
18139;Svaja;"3 B klasė";17947580061;Taip;4;3;0;7
18140;Svaja;"3 B klasė";6969692916;Taip;0;8;0;8
18141;Svaja;"3 B klasė";44418402260;Taip;0;2;0;2
18142;Svaja;"3 B klasė";50649509868;Taip;0;2;0;2
18143;Svaja;"3 B klasė";73391331150;Taip;0;4;0;4
18144;Svaja;"3 B klasė";70507326327;Taip;0;22;0;22
18145;Svaja;"3 B klasė";80772711351;Taip;0;7;0;7
18146;Svaja;"3 B klasė";54328462992;Taip;0;22;0;22
18147;Svaja;"3 B klasė";1470843400;Taip;0;5;0;5
18148;Svaja;"3 B klasė";92044111261;Taip;0;1;0;1
18149;Svaja;"3 B klasė";11937575740;Taip;0;7;0;7
18150;Svaja;"3 B klasė";8011137572;Taip;0;7;0;7
18151;Svaja;"3 B klasė";71708072632;Taip;0;6;0;6
18152;Svaja;"3 B klasė";56506642672;Taip;0;7;0;7
18153;Svaja;"3 B klasė";3526873547;Ne;0;22;0;22
18154;Svaja;"3 B klasė";70506691027;Taip;0;22;0;22
18155;Svaja;"3 B klasė";4282243865;Taip;0;22;0;22
18156;Svaja;"4 A klasė";96680395594;Taip;0;7;0;7
18157;Svaja;"4 A klasė";31604152893;Ne;5;2;0;7
18158;Svaja;"4 A klasė";70513111186;Ne;0;8;0;8
18159;Svaja;"4 A klasė";72655912805;Taip;0;22;0;22
18160;Svaja;"4 A klasė";20363553383;Taip;10;2;0;12
18161;Svaja;"4 A klasė";8876971658;Taip;2;6;0;8
18162;Svaja;"4 A klasė";69928474471;Taip;0;22;0;22
18163;Svaja;"4 A klasė";49184638535;Taip;0;22;0;22
18164;Svaja;"4 A klasė";3775578708;Taip;0;2;0;2
18165;Svaja;"4 A klasė";58497063533;Taip;0;6;0;6
18166;Svaja;"4 A klasė";89075087937;Taip;5;17;0;22
18167;Svaja;"4 A klasė";99157757025;Ne;0;2;0;2
18168;Svaja;"4 A klasė";16955510836;Ne;0;5;0;5
18169;Svaja;"4 A klasė";24812635291;Taip;0;3;0;3
18170;Svaja;"4 A klasė";21534170175;Taip;0;2;0;2
18171;Svaja;"4 A klasė";28311552445;Ne;4;1;0;5
18172;Svaja;"4 A klasė";38781141060;Taip;0;7;0;7
18173;Svaja;"4 A klasė";88447528808;Taip;0;4;0;4
18174;Svaja;"4 A klasė";66507774550;Taip;0;10;0;10
18175;Svaja;"4 A klasė";76101749947;Taip;0;22;0;22
18176;Svaja;"4 A klasė";18432518932;Taip;0;5;0;5
18177;Svaja;"4 B klasė";61996055386;Taip;0;22;0;22
18178;Svaja;"4 B klasė";57983452414;Taip;0;22;0;22
18179;Svaja;"4 B klasė";30200636424;Ne;0;22;0;22
18180;Svaja;"4 B klasė";8802243719;Taip;10;13;0;23
18181;Svaja;"4 B klasė";7747921362;Taip;0;22;0;22
18182;Svaja;"4 B klasė";38464012322;Taip;3;5;0;8
18183;Svaja;"4 B klasė";5712106350;Taip;29;3;0;32
18184;Svaja;"4 B klasė";9401605132;Taip;11;4;0;15
18185;Svaja;"4 B klasė";27313057222;Ne;0;22;0;22
18186;Svaja;"4 B klasė";68894832324;Taip;0;22;0;22
18187;Svaja;"4 B klasė";29972474690;Taip;0;22;0;22
18188;Svaja;"4 B klasė";47441661801;Taip;0;10;0;10
18189;Svaja;"4 B klasė";62579722313;Taip;0;1;0;1
18190;Svaja;"4 B klasė";21035820496;Taip;0;22;0;22
18191;Svaja;"4 B klasė";71840791098;Taip;4;1;0;5
18192;Svaja;"4 B klasė";59707838958;Taip;0;22;0;22
18193;Svaja;"4 B klasė";71086654007;Taip;0;22;0;22
18194;Svaja;"4 B klasė";15871540340;Taip;7;15;0;22
18195;Svaja;"4 B klasė";97651620085;Taip;0;5;0;5
18196;Svaja;"4 B klasė";77796846388;Taip;8;18;0;26
18197;Svaja;"4 C klasė";79260508923;Taip;0;9;0;9
18198;Svaja;"4 C klasė";94437606762;Taip;6;16;0;22
18199;Svaja;"4 C klasė";73440582394;Taip;5;17;0;22
18200;Svaja;"4 C klasė";60982723867;Taip;0;22;0;22
18201;Svaja;"4 C klasė";70157518595;Taip;0;22;0;22
18202;Svaja;"4 C klasė";5975083034;Taip;3;19;0;22
18203;Svaja;"4 C klasė";76871144487;Taip;8;14;0;22
18204;Svaja;"4 C klasė";6613028133;Taip;0;6;0;6
18205;Svaja;"4 C klasė";48888360976;Taip;0;6;0;6
18206;Svaja;"4 C klasė";12226488343;Taip;0;22;0;22
18207;Svaja;"4 C klasė";3909240894;Taip;0;1;0;1
18208;Svaja;"4 C klasė";53352329988;Taip;0;2;0;2
18209;Svaja;"4 C klasė";59917024948;Taip;0;2;0;2
18210;Svaja;"4 C klasė";73691352138;Ne;0;1;0;1
18211;Svaja;"4 C klasė";66967032561;Taip;5;5;0;10
18212;Svaja;"4 C klasė";77712240909;Taip;7;1;0;8
18213;Svaja;"4 C klasė";82358174131;Taip;0;3;0;3
18214;Svaja;"4 C klasė";25585032766;Taip;6;16;0;22
18215;Svaja;"4 C klasė";79572045341;Taip;0;22;0;22
18216;Svaja;"3 C klasė";1848422504;Taip;0;6;0;6
18217;Svaja;"3 C klasė";3743948734;Taip;0;8;0;8
18218;Svaja;"3 C klasė";25934507261;Ne;0;7;0;7
18219;Svaja;"3 C klasė";89047123808;Taip;0;16;0;16
18220;Svaja;"3 C klasė";74904581010;Taip;0;22;0;22
18221;Svaja;"3 C klasė";50510924690;Taip;0;1;0;1
18222;Svaja;"3 C klasė";41183537732;Taip;13;8;0;21
18223;Svaja;"3 C klasė";70714898590;Taip;0;3;0;3
18224;Svaja;"3 C klasė";54852358913;Ne;0;22;0;22
18225;Svaja;"3 C klasė";57253216255;Taip;0;9;0;9
18226;Svaja;"3 C klasė";34995551069;Taip;0;22;0;22
18227;Svaja;"3 C klasė";1795682827;Taip;0;5;0;5
18228;Svaja;"3 C klasė";93651139102;Taip;0;1;0;1
18229;Svaja;"3 C klasė";1742951527;Taip;0;1;0;1
18230;Svaja;"3 C klasė";91855230473;Taip;0;13;0;13
18231;Svaja;"3 C klasė";1855559693;Taip;0;22;0;22
18232;Svaja;"3 C klasė";2165716699;Taip;0;10;0;10
18233;Svaja;"3 C klasė";31216445971;Ne;0;22;0;22
18234;Svaja;"3 C klasė";20342193231;Taip;0;2;0;2
18235;Svaja;"3 C klasė";54462393937;Taip;0;9;0;9
18236;Svaja;"3 C klasė";36001411632;Taip;0;9;0;9
18237;Svaja;"3 C klasė";94449039022;Taip;0;22;0;22
18238;Svaja;"3 C klasė";85150525696;Ne;0;1;0;1
18239;Svaja;"3 C klasė";91088224294;Taip;0;11;0;11
18240;Šilelis;PAUKŠTELIAI;6128379060;Taip;15;1;0;16
18241;Šilelis;PAUKŠTELIAI;9653439873;Taip;7;1;0;8
18242;Šilelis;PAUKŠTELIAI;2823486581;Taip;0;3;0;3
18243;Šilelis;PAUKŠTELIAI;6369443270;Taip;0;4;0;4
18244;Šilelis;PAUKŠTELIAI;7595774842;Taip;0;3;1;4
18245;Šilelis;PAUKŠTELIAI;6614686867;Taip;22;0;0;22
18246;Šilelis;PAUKŠTELIAI;3053443777;Taip;12;0;1;13
18247;Šilelis;PAUKŠTELIAI;4960501068;Taip;14;3;0;17
18248;Šilelis;PAUKŠTELIAI;7072057348;Taip;0;4;0;4
18249;Šilelis;PAUKŠTELIAI;5974537364;Taip;18;2;2;22
18250;Šilelis;PAUKŠTELIAI;8166061969;Taip;7;0;0;7
18251;Šilelis;PAUKŠTELIAI;2051644210;Taip;3;0;1;4
18252;Šilelis;PAUKŠTELIAI;1124854378;Taip;16;0;0;16
18253;Šilelis;PAUKŠTELIAI;8184170908;Taip;0;0;2;2
18254;Šilelis;PAUKŠTELIAI;7197420388;Ne;0;6;0;6
18255;Šilelis;PAUKŠTELIAI;9107920165;Ne;0;6;0;6
18256;Šilelis;PAUKŠTELIAI;4432542988;Taip;2;0;0;2
18257;Šilelis;PAUKŠTELIAI;6852463814;Ne;16;2;0;18
18258;Šilelis;PAUKŠTELIAI;9799198904;Taip;0;0;2;2
18259;Šilelis;PAUKŠTELIAI;5493811298;Taip;6;1;4;11
18260;Šilelis;SKRUZDELIUKAI;7502057552;Ne;0;3;0;3
18261;Šilelis;SKRUZDELIUKAI;6099940488;Taip;10;0;0;10
18262;Šilelis;SKRUZDELIUKAI;6139976105;Ne;4;0;0;4
18263;Šilelis;SKRUZDELIUKAI;3823958567;Taip;14;3;0;17
18264;Šilelis;SKRUZDELIUKAI;1887013803;Taip;10;3;0;13
18265;Šilelis;SKRUZDELIUKAI;6359318134;Taip;6;3;0;9
18266;Šilelis;SKRUZDELIUKAI;5598152793;Taip;1;0;0;1
18267;Šilelis;SKRUZDELIUKAI;8090773379;Taip;9;4;0;13
18268;Šilelis;SKRUZDELIUKAI;1200024379;Ne;14;0;0;14
18269;Šilelis;SKRUZDELIUKAI;7299084520;Taip;9;0;0;9
18270;Šilelis;SKRUZDELIUKAI;8578620603;Taip;4;0;0;4
18271;Šilelis;SKRUZDELIUKAI;9589138527;Taip;0;11;0;11
18272;Šilelis;SKRUZDELIUKAI;3967932407;Taip;0;7;0;7
18273;Šilelis;SKRUZDELIUKAI;2972202874;Ne;13;0;0;13
18274;Šilelis;SKRUZDELIUKAI;9461117894;Ne;19;0;0;19
18275;Šilelis;SKRUZDELIUKAI;5817818596;Taip;0;8;3;11
18276;Šilelis;SKRUZDELIUKAI;6827855685;Taip;7;3;1;11
18277;Šilelis;SKRUZDELIUKAI;5091571136;Ne;0;1;0;1
18278;Šilelis;SKRUZDELIUKAI;8297975308;Taip;0;14;0;14
18279;Šilelis;SKRUZDELIUKAI;3381053227;Taip;10;2;0;12
18280;Šilelis;SKRUZDELIUKAI;9276607554;Taip;0;22;0;22
18281;Šilelis;SMERFY;3247333567;Taip;0;6;0;6
18282;Šilelis;SMERFY;6999088222;Taip;0;1;0;1
18283;Šilelis;SMERFY;3089270468;Taip;0;7;0;7
18284;Šilelis;SMERFY;7824279279;Ne;0;8;0;8
18285;Šilelis;SMERFY;4504627601;Taip;4;2;0;6
18286;Šilelis;SMERFY;7534468539;Taip;14;3;0;17
18287;Šilelis;SMERFY;6390855924;Ne;8;3;0;11
18288;Šilelis;SMERFY;1821827154;Taip;11;1;0;12
18289;Šilelis;SMERFY;4196893379;Taip;0;2;0;2
18290;Šilelis;SMERFY;1890114622;Taip;4;1;0;5
18291;Šilelis;SMERFY;5025956218;Taip;5;1;0;6
18292;Šilelis;EŽIUKAI;9266061396;Taip;3;0;1;4
18293;Šilelis;EŽIUKAI;4494932923;Taip;6;2;1;9
18294;Šilelis;EŽIUKAI;7074963804;Taip;0;5;0;5
18295;Šilelis;EŽIUKAI;1165219272;Taip;0;5;0;5
18296;Šilelis;EŽIUKAI;4702068672;Taip;9;3;0;12
18297;Šilelis;EŽIUKAI;5020209473;Ne;0;3;1;4
18298;Šilelis;EŽIUKAI;2295849333;Taip;5;2;0;7
18299;Šilelis;EŽIUKAI;5131051261;Taip;3;0;0;3
18300;Šilelis;EŽIUKAI;1883483049;Taip;4;3;0;7
18301;Šilelis;EŽIUKAI;6386996498;Taip;0;0;2;2
18302;Šilelis;EŽIUKAI;4822495270;Taip;10;3;0;13
18303;Šilelis;EŽIUKAI;3211649292;Taip;0;0;2;2
18304;Šilelis;EŽIUKAI;2681063256;Taip;6;0;1;7
18305;Šilelis;EŽIUKAI;7208757038;Taip;21;0;4;25
18306;Šilelis;NYKŠTUKAI;3046954717;Taip;18;0;0;18
18307;Šilelis;NYKŠTUKAI;2862894359;Taip;5;0;0;5
18308;Šilelis;NYKŠTUKAI;3158708835;Taip;7;1;1;9
18309;Šilelis;NYKŠTUKAI;6195580698;Taip;5;0;0;5
18310;Šilelis;NYKŠTUKAI;4323998445;Taip;9;0;2;11
18311;Šilelis;NYKŠTUKAI;2095572561;Ne;15;0;1;16
18312;Šilelis;NYKŠTUKAI;2161973782;Taip;5;2;0;7
18313;Šilelis;NYKŠTUKAI;4459114205;Taip;15;5;0;20
18314;Šilelis;NYKŠTUKAI;3728633100;Taip;8;1;2;11
18315;Šilelis;NYKŠTUKAI;3999426414;Taip;6;7;0;13
18316;Šilelis;NYKŠTUKAI;5745874033;Taip;5;0;0;5
18317;Šilelis;NYKŠTUKAI;9769483899;Taip;8;3;0;11
18318;Šilelis;NYKŠTUKAI;8944490184;Taip;12;0;0;12
18319;Šilelis;NYKŠTUKAI;2908840424;Taip;4;0;1;5
18320;Šilelis;NYKŠTUKAI;6980045156;Taip;4;0;0;4
18321;Šilelis;NYKŠTUKAI;9685227636;Taip;17;0;0;17
18322;Šilelis;NYKŠTUKAI;4868465692;Taip;0;10;0;10
18323;Šilelis;NYKŠTUKAI;4754544277;Taip;6;8;0;14
18324;Šilelis;NYKŠTUKAI;1222028604;Taip;11;0;3;14
18325;Šilelis;NYKŠTUKAI;7480611069;Ne;0;7;0;7
18326;Šilelis;ANČIUKAI;1726944289;Taip;13;0;9;22
18327;Šilelis;ANČIUKAI;4336942500;Taip;10;0;0;10
18328;Šilelis;ANČIUKAI;9661578871;Taip;10;0;3;13
18329;Šilelis;ANČIUKAI;6616262730;Taip;9;0;0;9
18330;Šilelis;ANČIUKAI;4323750313;Taip;7;0;8;15
18331;Šilelis;ANČIUKAI;3221398692;Taip;21;0;0;21
18332;Šilelis;ANČIUKAI;6364741317;Taip;15;0;0;15
18333;Šilelis;ANČIUKAI;1325857464;Ne;8;0;2;10
18334;Šilelis;ANČIUKAI;9407916190;Ne;2;4;0;6
18335;Šilelis;ANČIUKAI;8188160849;Taip;10;0;0;10
18336;Šilelis;ANČIUKAI;7128670936;Taip;22;0;0;22
18337;Šilelis;ANČIUKAI;8613748314;Taip;15;0;0;15
18338;Šilelis;ANČIUKAI;5381213051;Taip;23;0;0;23
18339;Šilelis;ANČIUKAI;2976607303;Taip;6;0;0;6
18340;Šilelis;ANČIUKAI;8807755852;Taip;0;4;0;4
18341;Šilelis;ANČIUKAI;4135383684;Taip;7;0;0;7
18342;Šilelis;ANČIUKAI;5926624138;Ne;7;0;0;7
18343;Šilelis;ANČIUKAI;8603589758;Taip;0;0;4;4
18344;Šilelis;KAČIUKAI;9899047136;Taip;5;0;0;5
18345;Šilelis;KAČIUKAI;3216168797;Taip;13;0;0;13
18346;Šilelis;KAČIUKAI;9848760151;Ne;0;5;0;5
18347;Šilelis;KAČIUKAI;4743459915;Taip;0;1;0;1
18348;Šilelis;KAČIUKAI;8387022157;Taip;10;4;0;14
18349;Šilelis;KAČIUKAI;3393466953;Ne;0;11;0;11
18350;Šilelis;KAČIUKAI;2111979474;Taip;9;0;0;9
18351;Šilelis;KAČIUKAI;8064905796;Taip;4;12;0;16
18352;Šilelis;KAČIUKAI;5176259940;Ne;4;0;11;15
18353;Šilelis;KAČIUKAI;5589764935;Taip;14;0;3;17
18354;Šilelis;KAČIUKAI;7123048946;Taip;13;1;10;24
18355;Šilelis;KAČIUKAI;6479728064;Taip;8;8;0;16
18356;Šilelis;KAČIUKAI;3686287802;Ne;4;0;0;4
18357;Šilelis;KAČIUKAI;2906501601;Taip;6;9;0;15
18358;Šilelis;KAČIUKAI;6510813364;Taip;0;3;0;3
18359;Šilelis;KAČIUKAI;8319185507;Taip;0;2;0;2
18360;Šilelis;KAČIUKAI;8504187981;Ne;10;1;1;12
18361;Šilelis;KAČIUKAI;6470073008;Taip;0;0;7;7
18362;Šilelis;KAČIUKAI;3419284228;Taip;10;1;0;11
18363;Šilelis;KAČIUKAI;3712001932;Taip;5;3;0;8
18364;Šilelis;KAČIUKAI;9106999969;Taip;12;8;0;20
18365;Šilelis;KAČIUKAI;5030871828;Taip;6;0;4;10
18366;Šilelis;KAČIUKAI;6894466509;Taip;5;8;0;13
18367;Šilelis;KAČIUKAI;5026203678;Taip;0;10;0;10
18368;Šilelis;KIŠKUČIAI;9480895465;Taip;0;0;4;4
18369;Šilelis;KIŠKUČIAI;8759694551;Taip;12;0;3;15
18370;Šilelis;KIŠKUČIAI;2209552706;Taip;12;0;0;12
18371;Šilelis;KIŠKUČIAI;3296197220;Taip;13;0;0;13
18372;Šilelis;KIŠKUČIAI;4386065478;Taip;0;7;0;7
18373;Šilelis;KIŠKUČIAI;7043644521;Taip;10;0;6;16
18374;Šilelis;KIŠKUČIAI;8096868221;Taip;4;0;1;5
18375;Šilelis;KIŠKUČIAI;3395084186;Ne;5;0;0;5
18376;Šilelis;KIŠKUČIAI;3382252131;Taip;12;0;0;12
18377;Šilelis;KIŠKUČIAI;9746722034;Taip;7;0;0;7
18378;Šilelis;KIŠKUČIAI;2551747888;Taip;9;0;0;9
18379;Šilelis;KIŠKUČIAI;5815768693;Taip;16;0;3;19
18380;Šilelis;KIŠKUČIAI;8598321310;Taip;4;0;3;7
18381;Šilelis;KREGŽDUTĖS;9715544798;Taip;13;2;0;15
18382;Šilelis;KREGŽDUTĖS;1025643459;Taip;9;0;1;10
18383;Šilelis;KREGŽDUTĖS;2896605690;Taip;8;0;0;8
18384;Šilelis;KREGŽDUTĖS;8453070684;Ne;1;0;6;7
18385;Šilelis;KREGŽDUTĖS;1286082219;Taip;9;0;1;10
18386;Šilelis;KREGŽDUTĖS;3068950702;Taip;4;0;3;7
18387;Šilelis;KREGŽDUTĖS;8665357907;Taip;12;3;0;15
18388;Šilelis;KREGŽDUTĖS;1152159735;Ne;17;0;0;17
18389;Šilelis;KREGŽDUTĖS;6630114847;Ne;9;0;0;9
18390;Šilelis;KREGŽDUTĖS;3953114161;Ne;18;0;0;18
18391;Šilelis;KREGŽDUTĖS;2499322761;Taip;22;0;0;22
18392;Šilelis;KREGŽDUTĖS;8659845107;Taip;12;0;3;15
18393;Šilelis;KREGŽDUTĖS;5868594049;Taip;13;0;1;14
18394;Šilelis;KREGŽDUTĖS;8855625488;Taip;4;0;1;5
18395;Šilelis;KREGŽDUTĖS;5223262925;Taip;0;4;0;4
18396;Šilelis;KREGŽDUTĖS;1279361795;Taip;10;6;0;16
18397;Šilelis;KREGŽDUTĖS;9292761872;Taip;15;0;5;20
18398;Šilelis;PAGRANDUKAI;9922962130;Taip;0;3;0;3
18399;Šilelis;PAGRANDUKAI;4814863979;Taip;11;1;0;12
18400;Šilelis;PAGRANDUKAI;8357287467;Taip;7;0;0;7
18401;Šilelis;PAGRANDUKAI;20525573092;Taip;0;2;0;2
18402;Šilelis;PAGRANDUKAI;2897196188;Ne;5;0;0;5
18403;Šilelis;PAGRANDUKAI;3583955729;Taip;0;4;0;4
18404;Šilelis;PAGRANDUKAI;9113098594;Taip;0;0;3;3
18405;Šilelis;PAGRANDUKAI;7623203279;Ne;7;1;3;11
18406;Šilelis;PAGRANDUKAI;4340856490;Taip;14;2;0;16
18407;Šilelis;PAGRANDUKAI;3807787648;Taip;5;3;1;9
18408;Šilelis;PAGRANDUKAI;6276408187;Taip;9;0;0;9
18409;Šilelis;PAGRANDUKAI;8416126751;Taip;3;3;2;8
18410;Šilelis;PAGRANDUKAI;1586414960;Taip;9;0;0;9
18411;Šilelis;PAGRANDUKAI;2397366916;Ne;0;1;4;5
18412;Šilelis;PAGRANDUKAI;7936978436;Taip;11;2;0;13
18413;Šilelis;PAGRANDUKAI;1747920772;Taip;5;1;0;6
18414;Šilelis;PAGRANDUKAI;3843999609;Taip;13;4;0;17
18415;Šilelis;PAGRANDUKAI;1898004894;Taip;7;3;0;10
18416;Šilelis;BITUTĖS;2948291866;Taip;5;14;0;19
18417;Šilelis;BITUTĖS;5835209357;Taip;5;2;0;7
18418;Šilelis;BITUTĖS;7512731255;Taip;15;0;0;15
18419;Šilelis;BITUTĖS;1268335563;Taip;5;3;1;9
18420;Šilelis;BITUTĖS;9035595952;Taip;11;1;0;12
18421;Šilelis;BITUTĖS;7814807923;Taip;26;0;0;26
18422;Šilelis;BITUTĖS;5305660046;Taip;6;1;0;7
18423;Šilelis;BITUTĖS;9071963194;Ne;12;0;3;15
18424;Šilelis;BITUTĖS;5843337891;Taip;6;0;0;6
18425;Šilelis;BITUTĖS;1960952604;Taip;12;2;0;14
18426;Šilelis;BITUTĖS;3954379433;Taip;0;5;14;19
18427;Šilelis;BITUTĖS;7350013139;Taip;0;5;0;5
18428;Šilelis;BITUTĖS;3879234745;Taip;0;5;0;5
18429;Šilelis;BITUTĖS;3062557053;Taip;0;0;1;1
18430;Šilelis;BITUTĖS;1390916076;Taip;8;0;5;13
18431;Šilelis;BITUTĖS;6143099736;Taip;6;0;0;6
18432;Šilelis;BITUTĖS;2667785768;Taip;8;0;2;10
18433;Šilelis;BITUTĖS;2023309512;Ne;8;0;0;8
18434;Šilelis;BITUTĖS;5210301367;Taip;10;6;1;17
18435;Šilelis;BITUTĖS;5375413045;Taip;0;13;7;20
18436;Šilelis;BITUTĖS;6297546907;Ne;10;3;6;19
18437;Šilelis;BITUTĖS;4682742121;Taip;10;0;0;10
18438;Šilelis;DRUGELIAI;2079073174;Taip;0;1;0;1
18439;Šilelis;DRUGELIAI;3598370884;Taip;20;3;0;23
18440;Šilelis;DRUGELIAI;1347150938;Taip;0;2;0;2
18441;Šilelis;DRUGELIAI;7636725161;Taip;13;10;0;23
18442;Šilelis;DRUGELIAI;9256656029;Taip;0;3;1;4
18443;Šilelis;DRUGELIAI;1891388542;Taip;6;5;0;11
18444;Šilelis;DRUGELIAI;5759824196;Taip;0;3;0;3
18445;Šilelis;DRUGELIAI;31906089315;Taip;0;1;0;1
18446;Šilelis;DRUGELIAI;4115738520;Taip;0;5;0;5
18447;Šilelis;DRUGELIAI;3824174896;Taip;0;5;0;5
18448;Šilelis;DRUGELIAI;8090765017;Taip;6;6;0;12
18449;Šilelis;DRUGELIAI;54633547799;Taip;0;6;1;7
18450;Šilelis;DRUGELIAI;9100047520;Taip;8;2;0;10
18451;Šilelis;DRUGELIAI;1638362625;Ne;11;1;0;12
18452;Šilelis;DRUGELIAI;9482667810;Taip;0;1;4;5
18453;Šilelis;DRUGELIAI;5379171382;Taip;8;1;0;9
18454;Šilelis;DRUGELIAI;6230566495;Taip;12;3;0;15
18455;Šilelis;DRUGELIAI;6523676718;Taip;0;7;0;7
18456;Šilelis;DRUGELIAI;5766702969;Taip;2;2;0;4
18457;Šilelis;DRUGELIAI;1984731000;Taip;0;2;0;2
18458;Šilelis;DRUGELIAI;6104538160;Taip;0;3;0;3
18459;Šilelis;DRUGELIAI;7542121945;Ne;5;4;4;13
18460;Vaivorykštė;Vasilki;5601359782;Taip;9;0;0;9
18461;Vaivorykštė;Vasilki;1182787416;Ne;20;0;0;20
18462;Vaivorykštė;Vasilki;3636826798;Ne;14;0;0;14
18463;Vaivorykštė;Černički;2939777444;Taip;11;0;0;11
18464;Vaivorykštė;Černički;4285845345;Taip;5;0;0;5
18465;Vaivorykštė;Černički;2921117681;Taip;3;0;0;3
18466;Vaivorykštė;Černički;2447951452;Taip;4;0;0;4
18467;Vaivorykštė;Černički;2697757513;Taip;1;0;0;1
18468;Vaivorykštė;Smorodinki;9240840061;Taip;3;0;0;3
18469;Vaivorykštė;Smorodinki;7498549859;Taip;6;0;0;6
18470;Vaivorykštė;Smorodinki;6660558274;Taip;15;0;0;15
18471;Vaivorykštė;Smorodinki;1878369945;Taip;7;0;0;7
18472;Vaivorykštė;Klubnički;2942304708;Ne;10;0;0;10
18473;Vaivorykštė;Klubnički;6038851172;Taip;5;0;0;5
18474;Vaivorykštė;Klubnički;7416247638;Taip;6;0;0;6
18475;Vaivorykštė;Klubnički;6954620468;Taip;6;0;0;6
18476;Vaivorykštė;Maki;5770527396;Taip;9;0;0;9
18477;Vaivorykštė;Maki;3574911889;Taip;5;0;0;5
18478;Vaivorykštė;"VIŠENKI (LOGOP.)";8269241567;Taip;1;0;0;1
18479;Vaivorykštė;"ANIUTINY GLAZKI (LOGOPED.)";2772343664;Taip;14;0;0;14
18480;Vaivorykštė;"ANIUTINY GLAZKI (LOGOPED.)";5003368837;Taip;5;0;0;5
18481;Vaivorykštė;"ANIUTINY GLAZKI (LOGOPED.)";1568023021;Taip;1;0;0;1
18482;Vaivorykštė;"Kolokolčiki ";9689972596;Taip;8;0;0;8
18483;Vaivorykštė;"Kolokolčiki ";1816560539;Taip;4;0;0;4
18484;Vaivorykštė;"Kolokolčiki ";5302483811;Taip;12;0;0;12
18485;Vaivorykštė;"Vinogradiki ";6800828661;Taip;4;0;0;4
18486;Vaivorykštė;Malinki;1106875762;Taip;13;0;0;13
18487;Vaivorykštė;Malinki;5621269871;Taip;10;0;0;10
18488;Vaivorykštė;1A;92401502319;Ne;2;0;0;2
18489;Vaivorykštė;1B;95055039627;Taip;4;0;0;4
18490;Vaivorykštė;1B;2299368368;Taip;4;0;0;4
18491;Vaivorykštė;1B;49976650682;Taip;2;0;0;2
18492;Vaivorykštė;1C;83397538797;Taip;9;0;0;9
18493;Vaivorykštė;1C;5392153410;Taip;8;0;0;8
18494;Vaivorykštė;1C;1987591278;Taip;3;0;0;3
18495;Vaivorykštė;1C;6291387032;Taip;6;0;0;6
18496;Vaivorykštė;GOROŠKI;7706526762;Taip;6;0;0;6
18497;Vaivorykštė;GOROŠKI;2523377321;Taip;6;0;0;6
18498;Vaduvos;PAGRANDUKAI;1431863758;Taip;0;1;0;1
18499;Vaduvos;PAGRANDUKAI;8408017356;Taip;0;11;4;15
18500;Vaduvos;PAGRANDUKAI;72724196791;Taip;6;11;3;20
18501;Vaduvos;PAGRANDUKAI;9371067563;Taip;0;7;0;7
18502;Vaduvos;PAGRANDUKAI;6425640531;Taip;12;0;0;12
18503;Vaduvos;PAGRANDUKAI;4029586203;Taip;0;1;0;1
18504;Vaduvos;PAGRANDUKAI;73800920781;Taip;0;1;8;9
18505;Vaduvos;PAGRANDUKAI;18035723255;Taip;0;0;2;2
18506;Vaduvos;PAGRANDUKAI;5954492368;Taip;0;7;0;7
18507;Vaduvos;PAGRANDUKAI;7397068779;Ne;0;5;0;5
18508;Vaduvos;PAGRANDUKAI;8875709110;Taip;0;3;0;3
18509;Vaduvos;PAGRANDUKAI;7305111076;Taip;14;3;0;17
18510;Vaduvos;PAGRANDUKAI;68848152670;Ne;7;10;0;17
18511;Vaduvos;PAGRANDUKAI;4105978403;Taip;0;2;0;2
18512;Vaduvos;PAGRANDUKAI;5428067167;Taip;0;0;9;9
18513;Vaduvos;PAGRANDUKAI;3699578284;Taip;9;6;0;15
18514;Vaduvos;PAGRANDUKAI;8299189235;Taip;22;0;0;22
18515;Vaduvos;PAGRANDUKAI;9540008495;Taip;5;0;0;5
18516;Vaduvos;PAGRANDUKAI;7493037613;Taip;0;11;0;11
18517;Vaduvos;PAGRANDUKAI;7163839896;Taip;0;11;0;11
18518;Vaduvos;KODĖLČIUKAI;3010510262;Taip;9;5;0;14
18519;Vaduvos;KODĖLČIUKAI;9429028460;Taip;5;1;0;6
18520;Vaduvos;KODĖLČIUKAI;6210729584;Taip;4;11;0;15
18521;Vaduvos;KODĖLČIUKAI;9606193112;Taip;12;0;0;12
18522;Vaduvos;KODĖLČIUKAI;4177935331;Taip;0;8;0;8
18523;Vaduvos;KODĖLČIUKAI;9983148737;Taip;0;3;0;3
18524;Vaduvos;KODĖLČIUKAI;9072097216;Taip;5;0;4;9
18525;Vaduvos;KODĖLČIUKAI;6810198013;Taip;6;1;0;7
18526;Vaduvos;KODĖLČIUKAI;3641822841;Taip;16;0;3;19
18527;Vaduvos;KODĖLČIUKAI;4270137614;Taip;6;0;0;6
18528;Vaduvos;KODĖLČIUKAI;3682708061;Taip;9;0;0;9
18529;Vaduvos;KODĖLČIUKAI;5262165284;Taip;5;0;1;6
18530;Vaduvos;KODĖLČIUKAI;8603418399;Taip;22;0;0;22
18531;Vaduvos;KODĖLČIUKAI;3096104197;Taip;22;0;0;22
18532;Vaduvos;KODĖLČIUKAI;5761137540;Taip;7;6;0;13
18533;Vaduvos;KODĖLČIUKAI;9597857664;Taip;6;0;0;6
18534;Vaduvos;KODĖLČIUKAI;1054097622;Ne;12;0;0;12
18535;Vaduvos;KODĖLČIUKAI;6013737546;Taip;0;0;19;19
18536;Vaduvos;KODĖLČIUKAI;6991960029;Taip;0;7;0;7
18537;Vaduvos;KODĖLČIUKAI;4789480822;Taip;10;8;0;18
18538;Vaduvos;KODĖLČIUKAI;3164402142;Taip;9;0;0;9
18539;Vaduvos;SMALSUČIAI;3555513755;Ne;0;11;2;13
18540;Vaduvos;SMALSUČIAI;2184711783;Taip;0;2;0;2
18541;Vaduvos;SMALSUČIAI;5573145836;Taip;0;6;2;8
18542;Vaduvos;SMALSUČIAI;7337663549;Taip;0;5;0;5
18543;Vaduvos;SMALSUČIAI;5055972872;Taip;10;2;0;12
18544;Vaduvos;SMALSUČIAI;1423148023;Taip;0;8;0;8
18545;Vaduvos;SMALSUČIAI;3091707832;Ne;6;4;0;10
18546;Vaduvos;SMALSUČIAI;87008942241;Taip;0;1;5;6
18547;Vaduvos;SMALSUČIAI;7181151562;Ne;0;1;0;1
18548;Vaduvos;SMALSUČIAI;7431411663;Taip;0;8;0;8
18549;Vaduvos;SMALSUČIAI;2257135127;Taip;12;0;4;16
18550;Vaduvos;SMALSUČIAI;6462126837;Taip;0;1;0;1
18551;Vaduvos;SMALSUČIAI;6213672547;Taip;13;0;0;13
18552;Vaduvos;SMALSUČIAI;1265287458;Taip;16;0;1;17
18553;Vaduvos;SMALSUČIAI;3948025914;Taip;0;0;12;12
18554;Vaduvos;SMALSUČIAI;7508333714;Ne;0;4;0;4
18555;Vaduvos;SMALSUČIAI;3925021238;Taip;11;0;1;12
18556;Vaduvos;SMALSUČIAI;9384395948;Ne;0;0;1;1
18557;Vaduvos;GILIUKAI;1277811729;Taip;9;7;0;16
18558;Vaduvos;GILIUKAI;1969325922;Taip;0;7;0;7
18559;Vaduvos;GILIUKAI;5376707663;Ne;4;1;2;7
18560;Vaduvos;GILIUKAI;6409466338;Ne;9;1;0;10
18561;Vaduvos;GILIUKAI;2835635250;Taip;0;0;5;5
18562;Vaduvos;GILIUKAI;2939561403;Taip;14;0;1;15
18563;Vaduvos;GILIUKAI;8188374113;Taip;0;8;0;8
18564;Vaduvos;GILIUKAI;6514406042;Taip;4;0;4;8
18565;Vaduvos;GILIUKAI;3057729267;Taip;22;0;0;22
18566;Vaduvos;GILIUKAI;6346625714;Taip;10;0;1;11
18567;Vaduvos;GILIUKAI;8580834401;Taip;7;0;1;8
18568;Vaduvos;GILIUKAI;9167796462;Taip;9;1;2;12
18569;Vaduvos;GILIUKAI;6276149710;Ne;0;0;11;11
18570;Vaduvos;GILIUKAI;6572776966;Taip;6;0;1;7
18571;Vaduvos;GILIUKAI;6676167440;Ne;0;1;5;6
18572;Vaduvos;GILIUKAI;2957685586;Taip;22;0;0;22
18573;Vaduvos;GILIUKAI;3540548094;Taip;17;0;0;17
18574;Vaduvos;GILIUKAI;8964194121;Taip;0;0;8;8
18575;Vaduvos;GILIUKAI;5297217576;Taip;8;5;0;13
18576;Vaduvos;GILIUKAI;5010914832;Taip;24;0;0;24
18577;Vaduvos;GILIUKAI;4030891958;Taip;0;0;10;10
18578;Vaduvos;GILIUKAI;7730737705;Taip;9;0;0;9
18579;Vaduvos;GILIUKAI;2011976336;Taip;9;0;0;9
18580;Vaduvos;BORUŽĖLĖS;2277525837;Taip;0;1;2;3
18581;Vaduvos;BORUŽĖLĖS;6439773886;Taip;0;18;0;18
18582;Vaduvos;BORUŽĖLĖS;5634252033;Taip;8;0;0;8
18583;Vaduvos;BORUŽĖLĖS;6593754016;Taip;11;5;0;16
18584;Vaduvos;BORUŽĖLĖS;7521846747;Taip;10;0;0;10
18585;Vaduvos;BORUŽĖLĖS;1422507884;Taip;12;11;0;23
18586;Vaduvos;BORUŽĖLĖS;3461756429;Taip;1;1;0;2
18587;Vaduvos;BORUŽĖLĖS;8324927031;Taip;0;2;0;2
18588;Vaduvos;BORUŽĖLĖS;4465504676;Taip;10;2;0;12
18589;Vaduvos;BORUŽĖLĖS;7904713344;Taip;11;3;0;14
18590;Vaduvos;BORUŽĖLĖS;2417613291;Taip;10;0;6;16
18591;Vaduvos;BORUŽĖLĖS;5717064754;Ne;9;0;0;9
18592;Vaduvos;BORUŽĖLĖS;8064111922;Taip;20;0;1;21
18593;Vaduvos;BORUŽĖLĖS;2923920649;Taip;13;0;0;13
18594;Vaduvos;BORUŽĖLĖS;6552763746;Taip;13;0;0;13
18595;Vaduvos;BORUŽĖLĖS;3255011809;Taip;0;4;0;4
18596;Vaduvos;BORUŽĖLĖS;8946940285;Taip;0;13;0;13
18597;Vaduvos;BORUŽĖLĖS;9188471756;Taip;8;0;0;8
18598;Vaduvos;BORUŽĖLĖS;7169054113;Taip;0;2;0;2
18599;Vaduvos;BORUŽĖLĖS;2366843609;Taip;5;1;0;6
18600;Vaduvos;BORUŽĖLĖS;1924714755;Taip;5;0;3;8
18601;Vaduvos;DRUGELIAI;4936598927;Taip;17;1;1;19
18602;Vaduvos;DRUGELIAI;2341467486;Taip;18;0;0;18
18603;Vaduvos;DRUGELIAI;5510687497;Ne;5;5;0;10
18604;Vaduvos;DRUGELIAI;9824469881;Taip;0;0;1;1
18605;Vaduvos;DRUGELIAI;5915272436;Ne;12;0;0;12
18606;Vaduvos;DRUGELIAI;4238942070;Taip;13;1;2;16
18607;Vaduvos;DRUGELIAI;1539465611;Taip;4;0;1;5
18608;Vaduvos;DRUGELIAI;8384302877;Taip;20;0;0;20
18609;Vaduvos;DRUGELIAI;6770559352;Taip;8;0;3;11
18610;Vaduvos;DRUGELIAI;4856601924;Taip;11;1;0;12
18611;Vaduvos;DRUGELIAI;3477273224;Taip;7;1;0;8
18612;Vaduvos;DRUGELIAI;2452309232;Taip;0;3;0;3
18613;Vaduvos;DRUGELIAI;6776150749;Ne;10;0;3;13
18614;Vaduvos;DRUGELIAI;4587836073;Taip;7;8;0;15
18615;Vaduvos;DRUGELIAI;9333495119;Taip;10;2;0;12
18616;Vaduvos;DRUGELIAI;7597268115;Taip;5;0;1;6
18617;Vaduvos;DRUGELIAI;8400344609;Taip;17;0;0;17
18618;Vaduvos;DRUGELIAI;2789503381;Taip;1;1;1;3
18619;Vaduvos;DRUGELIAI;1987969267;Taip;22;0;0;22
18620;Vaduvos;DRUGELIAI;8990472878;Ne;8;0;0;8
18621;Vaduvos;DRUGELIAI;2717887489;Taip;6;11;0;17
18622;Vaduvos;DRUGELIAI;5881009426;Taip;6;1;0;7
18623;Vaduvos;RIEŠUTĖLIAI;6611531526;Taip;5;0;7;12
18624;Vaduvos;RIEŠUTĖLIAI;1466282653;Taip;13;0;0;13
18625;Vaduvos;RIEŠUTĖLIAI;3206096414;Ne;9;0;1;10
18626;Vaduvos;RIEŠUTĖLIAI;8055108164;Taip;7;1;0;8
18627;Vaduvos;RIEŠUTĖLIAI;5509202519;Taip;10;0;0;10
18628;Vaduvos;RIEŠUTĖLIAI;3855900628;Taip;13;0;0;13
18629;Vaduvos;RIEŠUTĖLIAI;4576510280;Taip;8;0;0;8
18630;Vaduvos;RIEŠUTĖLIAI;5775152939;Taip;22;0;1;23
18631;Vaduvos;RIEŠUTĖLIAI;3060409258;Taip;3;0;0;3
18632;Vaduvos;RIEŠUTĖLIAI;8070494719;Taip;9;0;1;10
18633;Vaduvos;RIEŠUTĖLIAI;9232960362;Taip;20;0;0;20
18634;Vaduvos;RIEŠUTĖLIAI;7425991335;Taip;7;6;0;13
18635;Vaduvos;RIEŠUTĖLIAI;7592658267;Taip;9;0;3;12
18636;Vaduvos;RIEŠUTĖLIAI;8533315132;Taip;6;0;0;6
18637;Vaduvos;RIEŠUTĖLIAI;2508650990;Taip;7;5;0;12
18638;Vaduvos;RIEŠUTĖLIAI;6943057114;Taip;7;0;1;8
18639;Vaduvos;RIEŠUTĖLIAI;8669267296;Taip;10;7;0;17
18640;Vaduvos;RIEŠUTĖLIAI;1736248725;Taip;14;3;0;17
18641;Vaduvos;"1 klasė";3174998523;Ne;0;2;0;2
18642;Vaduvos;"1 klasė";1825188497;Taip;1;7;0;8
18643;Vaduvos;"1 klasė";3722349868;Taip;0;2;0;2
18644;Vaduvos;"1 klasė";13888236429;Taip;0;1;0;1
18645;Vaduvos;"1 klasė";5307128703;Taip;0;1;0;1
18646;Vaduvos;"1 klasė";6128582180;Taip;5;2;0;7
18647;Vaduvos;"1 klasė";62183976729;Taip;0;1;0;1
18648;Vaduvos;"1 klasė";93702732546;Taip;0;1;0;1
18649;Vaduvos;"1 klasė";15757662594;Taip;0;1;0;1
18650;Vaduvos;"1 klasė";41870343319;Taip;0;1;0;1
18651;Vaduvos;"1 klasė";4513707989;Taip;3;1;0;4
18652;Vaduvos;"1 klasė";68937983441;Taip;0;1;0;1
18653;Vaduvos;"1 klasė";59616893535;Taip;0;1;0;1
18654;Vaduvos;"1 klasė";22641388717;Taip;0;1;0;1
18655;Vaduvos;"1 klasė";21499108813;Taip;0;3;0;3
18656;Vaduvos;"1 klasė";79437154441;Taip;0;1;0;1
18657;Vaduvos;"1 klasė";46608435244;Taip;0;14;0;14
18658;Vaduvos;"1 klasė";61046090149;Taip;0;1;0;1
18659;Vaduvos;"1 klasė";56280470781;Ne;0;1;0;1
18660;Vaduvos;"1 klasė";11202010413;Taip;0;22;0;22
18661;Vaduvos;"1 klasė";1370696345;Taip;0;1;0;1
18662;Vaduvos;"1 klasė";4342471835;Taip;0;1;0;1
18663;Vaduvos;"1 klasė";9112649520;Taip;0;2;0;2
18664;Vaduvos;"1 klasė";1599595256;Taip;0;1;0;1
18665;Vaduvos;"1 klasė";5435336235;Taip;0;1;0;1
18666;Vaduvos;"1 klasė";1681367373;Taip;0;8;0;8
18667;Vaduvos;"3 klasė";97423576166;Taip;5;1;0;6
18668;Vaduvos;"3 klasė";38504924027;Taip;0;6;0;6
18669;Vaduvos;"3 klasė";96148085691;Taip;0;1;0;1
18670;Vaduvos;"3 klasė";12330772986;Ne;0;3;0;3
18671;Vaduvos;"3 klasė";33277362439;Ne;0;5;0;5
18672;Vaduvos;"3 klasė";32138087379;Taip;0;22;0;22
18673;Vaduvos;"3 klasė";67324784528;Taip;0;1;0;1
18674;Vaduvos;"3 klasė";4807104855;Taip;0;1;0;1
18675;Vaduvos;"3 klasė";2181614424;Taip;2;1;0;3
18676;Vaduvos;"3 klasė";2019573643;Taip;10;2;0;12
18677;Vaduvos;"3 klasė";27419094487;Taip;0;2;0;2
18678;Vaduvos;"3 klasė";89793734700;Taip;0;1;0;1
18679;Vaduvos;"3 klasė";17473821556;Taip;0;22;0;22
18680;Vaduvos;"3 klasė";53866301875;Ne;0;22;0;22
18681;Vaduvos;"3 klasė";7786986697;Taip;5;1;0;6
18682;Vaduvos;"3 klasė";9147332638;Taip;0;1;0;1
18683;Vaduvos;"3 klasė";1532675814;Taip;0;1;0;1
18684;Vaduvos;"3 klasė";98259624669;Taip;0;1;0;1
18685;Vaduvos;"3 klasė";36931517006;Taip;0;2;0;2
18686;Vaduvos;"3 klasė";61243424057;Taip;0;1;0;1
18687;Vaduvos;"3 klasė";30979103892;Taip;0;1;0;1
18688;Vaduvos;"3 klasė";78245732319;Taip;0;1;0;1
18689;Vaduvos;"3 klasė";48433447683;Taip;0;13;0;13
18690;Vaduvos;"3 klasė";85090873161;Ne;5;22;0;27
18691;Vaduvos;"3 klasė";41272273463;Ne;0;12;0;12
18692;Vaduvos;"4 klasė";96473212525;Taip;0;1;0;1
18693;Vaduvos;"4 klasė";75428164558;Taip;0;1;0;1
18694;Vaduvos;"4 klasė";63286903462;Taip;0;8;0;8
18695;Vaduvos;"4 klasė";13721939854;Taip;0;1;0;1
18696;Vaduvos;"4 klasė";1171210935;Ne;0;1;0;1
18697;Vaduvos;"4 klasė";7172286009;Taip;0;6;0;6
18698;Vaduvos;"4 klasė";6049882391;Ne;8;22;0;30
18699;Vaduvos;"4 klasė";38013859931;Taip;0;1;0;1
18700;Vaduvos;"4 klasė";4591744662;Taip;0;2;0;2
18701;Vaduvos;"4 klasė";9149523910;Taip;0;2;0;2
18702;Vaduvos;"4 klasė";76662161382;Taip;0;2;0;2
18703;Vaduvos;"4 klasė";26934740147;Taip;0;9;0;9
18704;Vaduvos;"4 klasė";18300713872;Taip;0;22;0;22
18705;Vaduvos;"4 klasė";768455288;Taip;0;4;0;4
18706;Vaduvos;"4 klasė";1768173501;Taip;7;3;0;10
18707;Vaduvos;"4 klasė";60531886576;Taip;0;1;0;1
18708;Vaduvos;"4 klasė";38462664426;Ne;0;3;0;3
18709;Vaduvos;"4 klasė";1821644443;Ne;0;1;0;1
18710;Vaduvos;"2 B klasė";95104294893;Taip;20;2;0;22
18711;Vaduvos;"2 B klasė";40872193458;Taip;0;1;0;1
18712;Vaduvos;"2 B klasė";6500567162;Taip;0;8;0;8
18713;Vaduvos;"2 B klasė";78931952732;Ne;0;3;0;3
18714;Vaduvos;"2 B klasė";1241148402;Ne;0;2;0;2
18715;Vaduvos;"2 B klasė";66359913774;Taip;0;1;0;1
18716;Vaduvos;"2 B klasė";24887196729;Ne;0;2;0;2
18717;Vaduvos;"2 B klasė";39687066893;Taip;0;1;0;1
18718;Vaduvos;"2 B klasė";64074141491;Taip;0;4;0;4
18719;Vaduvos;"2 B klasė";93924290247;Taip;0;6;0;6
18720;Vaduvos;"2 B klasė";47465933557;Taip;0;22;0;22
18721;Vaduvos;"2 B klasė";62521006557;Taip;0;3;0;3
18722;Vaduvos;"2 B klasė";16882774330;Taip;0;7;0;7
18723;Vaduvos;"2 B klasė";3259114583;Taip;7;1;0;8
18724;Vaduvos;"2 B klasė";87671358423;Taip;0;22;0;22
18725;Vaduvos;"2 B klasė";55138588393;Taip;0;3;0;3
18726;Vaduvos;"2 B klasė";3310156076;Ne;0;10;0;10
18727;Vaduvos;"2 A klasė";6279678482;Ne;0;1;0;1
18728;Vaduvos;"2 A klasė";96892752634;Taip;0;2;0;2
18729;Vaduvos;"2 A klasė";61243200177;Taip;5;1;0;6
18730;Vaduvos;"2 A klasė";62703428759;Taip;0;1;0;1
18731;Vaduvos;"2 A klasė";68420568339;Taip;0;5;0;5
18732;Vaduvos;"2 A klasė";49738318631;Taip;0;2;0;2
18733;Vaduvos;"2 A klasė";65647119496;Taip;0;3;0;3
18734;Vaduvos;"2 A klasė";19390879176;Taip;0;1;0;1
18735;Vaduvos;"2 A klasė";6155494370;Ne;0;1;0;1
18736;Vaduvos;"2 A klasė";1139509471;Taip;0;22;0;22
18737;Vaduvos;"2 A klasė";70693742936;Taip;0;3;0;3
18738;Vaduvos;"2 A klasė";1010061503;Taip;0;12;0;12
18739;Vaduvos;"2 A klasė";1107557891;Taip;0;3;0;3
18740;Vaduvos;"2 A klasė";8802765960;Ne;0;1;0;1
18741;Vaduvos;"2 A klasė";3172047211;Taip;0;1;0;1
18742;Vilkpėdės;BORUŽĖLĖS;8002436634;Taip;13;0;0;13
18743;Vilkpėdės;BORUŽĖLĖS;1249504082;Taip;7;0;5;12
18744;Vilkpėdės;BORUŽĖLĖS;4052026470;Taip;13;0;0;13
18745;Vilkpėdės;BORUŽĖLĖS;4726171678;Taip;7;0;0;7
18746;Vilkpėdės;BORUŽĖLĖS;7519472444;Taip;1;0;0;1
18747;Vilkpėdės;BORUŽĖLĖS;3991785883;Taip;0;0;2;2
18748;Vilkpėdės;BORUŽĖLĖS;9334610111;Taip;9;0;0;9
18749;Vilkpėdės;BORUŽĖLĖS;7992484314;Taip;10;0;0;10
18750;Vilkpėdės;BORUŽĖLĖS;5050493757;Taip;17;0;0;17
18751;Vilkpėdės;BORUŽĖLĖS;8217972925;Taip;6;2;0;8
18752;Vilkpėdės;BORUŽĖLĖS;7805866055;Taip;17;0;0;17
18753;Vilkpėdės;BORUŽĖLĖS;3994451071;Taip;23;0;0;23
18754;Vilkpėdės;BORUŽĖLĖS;2529188623;Taip;13;0;0;13
18755;Vilkpėdės;BORUŽĖLĖS;5569182344;Taip;12;0;0;12
18756;Vilkpėdės;BORUŽĖLĖS;5677284428;Taip;13;0;0;13
18757;Vilkpėdės;SKRUZDĖLIUKAI;7661268641;Taip;6;1;0;7
18758;Vilkpėdės;SKRUZDĖLIUKAI;4018140154;Taip;14;0;6;20
18759;Vilkpėdės;SKRUZDĖLIUKAI;2419661008;Taip;3;1;3;7
18760;Vilkpėdės;SKRUZDĖLIUKAI;7114183123;Taip;0;1;1;2
18761;Vilkpėdės;SKRUZDĖLIUKAI;8804335248;Taip;0;1;0;1
18762;Vilkpėdės;SKRUZDĖLIUKAI;2525399410;Taip;8;0;0;8
18763;Vilkpėdės;SKRUZDĖLIUKAI;6198736925;Taip;0;0;1;1
18764;Vilkpėdės;SKRUZDĖLIUKAI;5812430367;Taip;10;1;0;11
18765;Vilkpėdės;SKRUZDĖLIUKAI;1478022307;Taip;0;6;0;6
18766;Vilkpėdės;SKRUZDĖLIUKAI;2205143759;Ne;0;2;1;3
18767;Vilkpėdės;SKRUZDĖLIUKAI;6598572049;Taip;0;0;2;2
18768;Vilkpėdės;SKRUZDĖLIUKAI;7931496783;Taip;2;9;0;11
18769;Vilkpėdės;SKRUZDĖLIUKAI;2418313731;Taip;32;1;0;33
18770;Vilkpėdės;SKRUZDĖLIUKAI;1342167313;Taip;0;18;0;18
18771;Vilkpėdės;SKRUZDĖLIUKAI;1838974989;Ne;0;18;0;18
18772;Vilkpėdės;SKRUZDĖLIUKAI;5334238235;Taip;5;0;0;5
18773;Vilkpėdės;SKRUZDĖLIUKAI;2703704892;Ne;6;1;0;7
18774;Vilkpėdės;SKRUZDĖLIUKAI;8385974099;Taip;10;0;0;10
18775;Vilkpėdės;SKRUZDĖLIUKAI;6671311193;Taip;0;0;3;3
18776;Vilkpėdės;SKRUZDĖLIUKAI;1985540746;Ne;9;1;9;19
18777;Vilkpėdės;DRUGELIAI;1040357501;Taip;30;0;0;30
18778;Vilkpėdės;DRUGELIAI;6876470245;Taip;30;0;0;30
18779;Vilkpėdės;DRUGELIAI;8431620518;Taip;2;2;0;4
18780;Vilkpėdės;DRUGELIAI;1655396296;Taip;15;0;0;15
18781;Vilkpėdės;DRUGELIAI;5076206526;Taip;0;7;0;7
18782;Vilkpėdės;DRUGELIAI;3611416887;Taip;0;7;0;7
18783;Vilkpėdės;DRUGELIAI;7008659662;Taip;5;0;0;5
18784;Vilkpėdės;DRUGELIAI;9501254301;Taip;3;1;0;4
18785;Vilkpėdės;DRUGELIAI;4998396593;Taip;18;0;0;18
18786;Vilkpėdės;DRUGELIAI;1278300322;Taip;0;1;0;1
18787;Vilkpėdės;DRUGELIAI;9797550851;Ne;11;0;0;11
18788;Vilkpėdės;ŽIOGELIAI;1396827668;Taip;10;0;0;10
18789;Vilkpėdės;ŽIOGELIAI;5551822633;Taip;15;13;0;28
18790;Vilkpėdės;ŽIOGELIAI;9544418642;Taip;8;0;0;8
18791;Vilkpėdės;ŽIOGELIAI;1063740772;Taip;0;2;0;2
18792;Vilkpėdės;ŽIOGELIAI;3666145718;Taip;12;4;0;16
18793;Vilkpėdės;ŽIOGELIAI;5633014328;Taip;6;0;0;6
18794;Vilkpėdės;ŽIOGELIAI;5422061533;Taip;4;0;4;8
18795;Vilkpėdės;ŽIOGELIAI;4311938034;Taip;0;0;4;4
18796;Vilkpėdės;ŽIOGELIAI;5346798201;Taip;8;0;0;8
18797;Vilkpėdės;ŽIOGELIAI;1609823694;Taip;7;0;2;9
18798;Vilkpėdės;ŽIOGELIAI;7634076203;Taip;12;0;0;12
18799;Vilkpėdės;ŽIOGELIAI;6690742997;Taip;8;5;0;13
18800;Vilkpėdės;ŽIOGELIAI;3350784810;Taip;6;3;0;9
18801;Vilkpėdės;ŽIOGELIAI;1655985778;Taip;22;0;0;22
18802;Vilkpėdės;ŽIOGELIAI;3664125930;Ne;10;0;0;10
18803;Vilkpėdės;ŽIOGELIAI;3737265597;Taip;11;3;0;14
18804;Vilkpėdės;ŽIOGELIAI;2241104719;Taip;0;0;6;6
18805;Vilkpėdės;ŽIOGELIAI;8423972962;Taip;3;2;1;6
18806;Vilkpėdės;ŽIOGELIAI;1537270256;Taip;10;2;5;17
18807;Vilkpėdės;ŽIOGELIAI;3229559339;Taip;10;2;5;17
18808;Vilkpėdės;ŽIOGELIAI;8783790519;Ne;11;3;0;14
18809;Vilkpėdės;BITUTĖS;6418829930;Taip;0;12;0;12
18810;Vilkpėdės;BITUTĖS;1633942236;Taip;0;10;0;10
18811;Vilkpėdės;BITUTĖS;8484873068;Taip;5;0;0;5
18812;Vilkpėdės;BITUTĖS;2503128176;Ne;11;0;0;11
18813;Vilkpėdės;BITUTĖS;9570469277;Ne;10;1;5;16
18814;Vilkpėdės;BITUTĖS;5420512675;Taip;0;0;8;8
18815;Vilkpėdės;BITUTĖS;8613778606;Taip;12;3;0;15
18816;Vilkpėdės;BITUTĖS;7991758361;Taip;0;4;0;4
18817;Vilkpėdės;BITUTĖS;2736318576;Taip;7;0;0;7
18818;Vilkpėdės;BITUTĖS;6064336759;Taip;12;1;0;13
18819;Vilkpėdės;BITUTĖS;5577199802;Taip;6;1;0;7
18820;Vilkpėdės;BITUTĖS;8930504912;Ne;1;18;0;19
18821;Vilkpėdės;BITUTĖS;3303872633;Taip;10;5;0;15
18822;Vilkpėdės;BITUTĖS;5972405023;Ne;14;0;0;14
18823;Vilkpėdės;BITUTĖS;4485811377;Ne;4;6;0;10
18824;Vilkpėdės;BITUTĖS;5274855225;Taip;33;0;0;33
18825;Vilkpėdės;BITUTĖS;8860791478;Taip;14;1;0;15
18826;Vilkpėdės;BITUTĖS;7829343719;Taip;11;0;6;17
18827;Vilkpėdės;"4 klasė";14499651046;Ne;0;5;0;5
18828;Vilkpėdės;"4 klasė";90217345315;Taip;0;1;0;1
18829;Vilkpėdės;"4 klasė";51286525404;Taip;2;1;0;3
18830;Vilkpėdės;"4 klasė";49513181091;Ne;14;1;0;15
18831;Vilkpėdės;"4 klasė";37450374921;Taip;11;3;0;14
18832;Vilkpėdės;"4 klasė";36704555745;Taip;5;1;0;6
18833;Vilkpėdės;"4 klasė";1024429836;Taip;0;1;0;1
18834;Vilkpėdės;"4 klasė";66356984763;Taip;0;9;0;9
18835;Vilkpėdės;"4 klasė";88279045901;Taip;4;7;0;11
18836;Vilkpėdės;"4 klasė";66451097025;Taip;4;1;0;5
18837;Vilkpėdės;"4 klasė";2806307083;Taip;2;3;0;5
18838;Vilkpėdės;"4 klasė";51799865091;Taip;0;1;0;1
18839;Vilkpėdės;"4 klasė";79269485254;Taip;1;4;0;5
18840;Vilkpėdės;"4 klasė";61833757576;Taip;0;2;0;2
18841;Vilkpėdės;"4 klasė";64216245300;Taip;0;1;0;1
18842;Vilkpėdės;GUDRUČIAI;1527272055;Taip;0;3;0;3
18843;Vilkpėdės;GUDRUČIAI;1451102218;Taip;4;2;2;8
18844;Vilkpėdės;GUDRUČIAI;2065010940;Ne;11;2;0;13
18845;Vilkpėdės;GUDRUČIAI;2181146968;Taip;9;3;2;14
18846;Vilkpėdės;GUDRUČIAI;4392760215;Taip;11;1;0;12
18847;Vilkpėdės;GUDRUČIAI;4515945951;Taip;0;2;3;5
18848;Vilkpėdės;GUDRUČIAI;2736368118;Ne;10;3;0;13
18849;Vilkpėdės;GUDRUČIAI;7527929277;Ne;1;4;4;9
18850;Vilkpėdės;GUDRUČIAI;46561435465;Taip;0;7;0;7
18851;Vilkpėdės;GUDRUČIAI;48059844727;Taip;4;5;0;9
18852;Vilkpėdės;GUDRUČIAI;8865545376;Taip;0;3;0;3
18853;Vilkpėdės;GUDRUČIAI;4735164204;Taip;0;1;0;1
18854;Vilkpėdės;GUDRUČIAI;7889480219;Ne;9;0;0;9
18855;Vilkpėdės;GUDRUČIAI;9867411687;Ne;6;4;0;10
18856;Vilkpėdės;GUDRUČIAI;2900581406;Taip;0;10;0;10
18857;Vilkpėdės;GUDRUČIAI;7875898177;Taip;0;14;0;14
18858;Vilkpėdės;GUDRUČIAI;1195392132;Taip;2;3;0;5
18859;Vilkpėdės;GUDRUČIAI;9605399822;Taip;0;1;0;1
18860;Vilkpėdės;GUDRUČIAI;7634355147;Taip;0;11;0;11
18861;Vilkpėdės;GUDRUČIAI;4276158771;Taip;0;5;0;5
18862;Vilkpėdės;GUDRUČIAI;2604179994;Taip;0;2;0;2
18863;Vilkpėdės;GUDRUČIAI;3696611509;Taip;8;4;0;12
18864;Vilkpėdės;SMALSUČIAI;9294350205;Taip;5;1;0;6
18865;Vilkpėdės;SMALSUČIAI;4095366279;Taip;0;13;0;13
18866;Vilkpėdės;SMALSUČIAI;5048931309;Taip;0;3;0;3
18867;Vilkpėdės;SMALSUČIAI;7698759895;Taip;0;8;0;8
18868;Vilkpėdės;SMALSUČIAI;1019057127;Taip;14;0;0;14
18869;Vilkpėdės;SMALSUČIAI;1217929358;Taip;4;4;0;8
18870;Vilkpėdės;SMALSUČIAI;1807884737;Taip;14;6;0;20
18871;Vilkpėdės;SMALSUČIAI;2251274741;Taip;9;6;0;15
18872;Vilkpėdės;SMALSUČIAI;6816745585;Taip;9;0;0;9
18873;Vilkpėdės;SMALSUČIAI;9460356725;Ne;2;1;0;3
18874;Vilkpėdės;SMALSUČIAI;8128254701;Taip;15;1;0;16
18875;Vilkpėdės;SMALSUČIAI;8015392054;Taip;5;3;0;8
18876;Vilkpėdės;SMALSUČIAI;2320350937;Taip;8;2;0;10
18877;Vilkpėdės;SMALSUČIAI;7747013579;Taip;13;1;0;14
18878;Vilkpėdės;SMALSUČIAI;7894766629;Taip;0;11;0;11
18879;Vilkpėdės;SMALSUČIAI;3987021185;Taip;5;7;0;12
18880;Vilkpėdės;SMALSUČIAI;7908813288;Taip;3;7;0;10
18881;Vilkpėdės;SMALSUČIAI;6522707709;Taip;33;0;0;33
18882;Vilkpėdės;SMALSUČIAI;9795696242;Taip;8;0;0;8
18883;Vilkpėdės;SMALSUČIAI;8581661608;Taip;0;7;0;7
18884;Vilkpėdės;SMALSUČIAI;6261547304;Taip;6;0;0;6
18885;Vilkpėdės;SMALSUČIAI;2420271759;Taip;7;9;0;16
18886;Vilkpėdės;KODĖLČIUKŲ;6283767445;Taip;12;0;0;12
18887;Vilkpėdės;KODĖLČIUKŲ;9605430333;Ne;10;4;0;14
18888;Vilkpėdės;KODĖLČIUKŲ;7745776486;Ne;9;1;0;10
18889;Vilkpėdės;KODĖLČIUKŲ;8969001990;Taip;5;1;0;6
18890;Vilkpėdės;KODĖLČIUKŲ;7158737372;Taip;16;0;0;16
18891;Vilkpėdės;KODĖLČIUKŲ;3785308006;Taip;4;3;0;7
18892;Vilkpėdės;KODĖLČIUKŲ;6744834487;Taip;9;1;0;10
18893;Vilkpėdės;KODĖLČIUKŲ;4166416292;Taip;15;8;0;23
18894;Vilkpėdės;KODĖLČIUKŲ;3888880306;Taip;10;2;0;12
18895;Vilkpėdės;KODĖLČIUKŲ;9601934563;Taip;7;1;0;8
18896;Vilkpėdės;KODĖLČIUKŲ;7401886306;Ne;0;2;0;2
18897;Vilkpėdės;KODĖLČIUKŲ;1528619779;Taip;8;0;0;8
18898;Vilkpėdės;KODĖLČIUKŲ;2359315281;Taip;0;1;0;1
18899;Vilkpėdės;KODĖLČIUKŲ;1571869318;Ne;10;0;0;10
18900;Vilkpėdės;KODĖLČIUKŲ;6820236577;Taip;8;4;0;12
18901;Vilkpėdės;KODĖLČIUKŲ;4255757333;Ne;15;1;0;16
18902;Vilkpėdės;KODĖLČIUKŲ;1063561954;Taip;8;1;0;9
18903;Vilkpėdės;KODĖLČIUKŲ;5053032081;Taip;6;1;0;7
18904;Vilkpėdės;KODĖLČIUKŲ;6778288398;Taip;7;3;0;10
18905;Vilkpėdės;KODĖLČIUKŲ;7284081203;Taip;7;0;0;7
18906;Žiburėlis;Nykštukai;6696156248;Taip;0;4;0;4
18907;Žiburėlis;Nykštukai;7163594513;Taip;0;2;0;2
18908;Žiburėlis;Nykštukai;5174211773;Taip;0;2;0;2
18909;Žiburėlis;Nykštukai;5408766721;Taip;0;2;0;2
18910;Žiburėlis;Nykštukai;3646988912;Ne;10;3;0;13
18911;Žiburėlis;Nykštukai;7211961512;Taip;0;1;0;1
18912;Žiburėlis;Nykštukai;7862546963;Taip;13;0;0;13
18913;Žiburėlis;Nykštukai;8902837168;Taip;10;0;0;10
18914;Žiburėlis;Nykštukai;7465939429;Taip;11;4;0;15
18915;Žiburėlis;Nykštukai;7307386173;Ne;12;0;0;12
18916;Žiburėlis;Nykštukai;8215816053;Taip;0;2;0;2
18917;Žiburėlis;Nykštukai;4710995351;Taip;9;0;4;13
18918;Žiburėlis;Nykštukai;7633450988;Taip;8;2;0;10
18919;Žiburėlis;Nykštukai;2292895729;Taip;0;7;0;7
18920;Žiburėlis;Nykštukai;7273838695;Taip;0;1;0;1
18921;Žiburėlis;Nykštukai;9806454408;Ne;6;11;0;17
18922;Žiburėlis;Nykštukai;3938379566;Taip;10;3;0;13
18923;Žiburėlis;Nykštukai;9932264675;Taip;9;5;0;14
18924;Žiburėlis;Nykštukai;2253167147;Taip;20;0;0;20
18925;Žiburėlis;Nykštukai;8480167191;Taip;0;20;0;20
18926;Žiburėlis;Nykštukai;1559091567;Taip;14;1;0;15
18927;Žiburėlis;Nykštukai;3750024153;Taip;14;1;0;15
18928;Žiburėlis;"Žiniukai ";5816890413;Taip;0;4;0;4
18929;Žiburėlis;"Žiniukai ";2928528630;Ne;9;3;0;12
18930;Žiburėlis;"Žiniukai ";2624326930;Taip;15;4;0;19
18931;Žiburėlis;"Žiniukai ";6300247811;Taip;6;1;0;7
18932;Žiburėlis;"Žiniukai ";3033049328;Taip;0;1;0;1
18933;Žiburėlis;"Žiniukai ";3262856058;Taip;9;4;0;13
18934;Žiburėlis;"Žiniukai ";1720078356;Taip;10;1;0;11
18935;Žiburėlis;"Žiniukai ";7424129974;Taip;0;2;0;2
18936;Žiburėlis;"Žiniukai ";4187381976;Taip;13;4;0;17
18937;Žiburėlis;"Žiniukai ";5006361324;Taip;7;0;0;7
18938;Žiburėlis;"Žiniukai ";2956339420;Taip;9;3;0;12
18939;Žiburėlis;"Žiniukai ";2999365435;Ne;5;3;0;8
18940;Žiburėlis;"Žiniukai ";7070952018;Taip;0;12;0;12
18941;Žiburėlis;"Žiniukai ";8438876806;Taip;6;7;0;13
18942;Žiburėlis;"Žiniukai ";3687703187;Ne;0;9;0;9
18943;Žiburėlis;"Žiniukai ";8535429783;Taip;0;2;0;2
18944;Žiburėlis;"Žiniukai ";1543314096;Taip;17;3;0;20
18945;Žiburėlis;"Žiniukai ";1061646244;Ne;0;2;0;2
18946;Žiburėlis;"Žiniukai ";2741301903;Ne;11;2;0;13
18947;Žiburėlis;"Smalsiukai ";5438697081;Ne;18;3;0;21
18948;Žiburėlis;"Smalsiukai ";1126972447;Ne;10;5;0;15
18949;Žiburėlis;"Smalsiukai ";5114554577;Taip;0;6;0;6
18950;Žiburėlis;"Smalsiukai ";3936418539;Taip;3;0;0;3
18951;Žiburėlis;"Smalsiukai ";2072972990;Taip;16;0;0;16
18952;Žiburėlis;"Smalsiukai ";3835820013;Taip;6;0;0;6
18953;Žiburėlis;"Smalsiukai ";4355778076;Taip;4;0;0;4
18954;Žiburėlis;"Smalsiukai ";92490398630;Taip;9;1;0;10
18955;Žiburėlis;"Smalsiukai ";67168630669;Taip;10;3;0;13
18956;Žiburėlis;"Smalsiukai ";3867540155;Taip;3;0;0;3
18957;Žiburėlis;"Smalsiukai ";7578655857;Taip;5;2;0;7
18958;Žiburėlis;"Smalsiukai ";9253393819;Taip;2;2;0;4
18959;Žiburėlis;"Smalsiukai ";1599112927;Taip;7;4;0;11
18960;Žiburėlis;"Smalsiukai ";2796489509;Taip;13;3;0;16
18961;Žiburėlis;"Smalsiukai ";18739941845;Taip;11;1;0;12
18962;Žiburėlis;"Smalsiukai ";24639355056;Taip;8;1;0;9
18963;Žiburėlis;"Smalsiukai ";6519139977;Taip;14;6;0;20
18964;Žiburėlis;"Smalsiukai ";7861704875;Taip;5;0;0;5
18965;Žiburėlis;"Smalsiukai ";34873231652;Taip;6;1;0;7
18966;Žiburėlis;"Smalsiukai ";1125662904;Taip;10;3;0;13
18967;Žiburėlis;"Smalsiukai ";2175751377;Ne;11;0;0;11
18968;Žiburėlis;"Smalsiukai ";28985997205;Taip;0;11;0;11
18969;Žiburėlis;"Giliukai ";7310274376;Taip;11;0;0;11
18970;Žiburėlis;"Giliukai ";1090883494;Taip;19;0;0;19
18971;Žiburėlis;"Giliukai ";9215654134;Taip;6;3;0;9
18972;Žiburėlis;"Giliukai ";2866098551;Ne;22;0;0;22
18973;Žiburėlis;"Giliukai ";6918525245;Ne;0;1;0;1
18974;Žiburėlis;"Giliukai ";6946621147;Taip;0;1;0;1
18975;Žiburėlis;"Giliukai ";5148264064;Ne;11;3;0;14
18976;Žiburėlis;"Giliukai ";6733333096;Ne;24;0;0;24
18977;Žiburėlis;"Giliukai ";1943162133;Taip;8;1;0;9
18978;Žiburėlis;"Giliukai ";6232492947;Taip;7;0;0;7
18979;Žiburėlis;"Giliukai ";3807588865;Ne;11;0;0;11
18980;Žiburėlis;"Giliukai ";4091901597;Taip;5;0;0;5
18981;Žiburėlis;"Giliukai ";4016969144;Taip;0;8;0;8
18982;Žiburėlis;"Giliukai ";3776569251;Taip;13;0;1;14
18983;Žiburėlis;"Giliukai ";9494271740;Taip;7;3;0;10
18984;Žiburėlis;"Giliukai ";3992503848;Taip;0;1;0;1
18985;Žiburėlis;"Giliukai ";8440073413;Taip;8;1;0;9
18986;Žiburėlis;"Giliukai ";6121237159;Taip;8;1;0;9
18987;Žiburėlis;"Giliukai ";6289338466;Taip;14;1;0;15
18988;Žiburėlis;"Giliukai ";7977098545;Taip;9;1;0;10
18989;Žiburėlis;"Giliukai ";2990465012;Taip;4;3;0;7
18990;Žiburėlis;"Giliukai ";8697451319;Taip;9;1;0;10
18991;Žiburėlis;Meškiukai;3593851196;Taip;7;0;0;7
18992;Žiburėlis;Meškiukai;9470154520;Taip;25;1;0;26
18993;Žiburėlis;Meškiukai;2285666668;Ne;10;0;1;11
18994;Žiburėlis;Meškiukai;2836519241;Taip;12;0;0;12
18995;Žiburėlis;Meškiukai;9731661697;Ne;5;1;0;6
18996;Žiburėlis;Meškiukai;2186032732;Taip;5;0;0;5
18997;Žiburėlis;Meškiukai;9321467329;Taip;15;6;0;21
18998;Žiburėlis;Meškiukai;2254407798;Taip;0;2;0;2
18999;Žiburėlis;Meškiukai;4887304311;Taip;15;0;0;15
19000;Žiburėlis;Meškiukai;1651713696;Taip;4;0;1;5
19001;Žiburėlis;Meškiukai;1105220246;Ne;0;0;3;3
19002;Žiburėlis;Meškiukai;8415647388;Taip;8;2;0;10
19003;Žiburėlis;Meškiukai;2371990135;Taip;0;0;3;3
19004;Žiburėlis;Meškiukai;8883542394;Ne;4;0;0;4
19005;Žiburėlis;Meškiukai;6218255066;Taip;10;0;2;12
19006;Žiburėlis;Meškiukai;3522480911;Ne;12;0;1;13
19007;Žiburėlis;Meškiukai;5683969627;Taip;18;0;0;18
19008;Žiburėlis;Meškiukai;4667559315;Taip;13;0;0;13
19009;Žiburėlis;Viščiukai;5115160061;Ne;21;0;0;21
19010;Žiburėlis;Viščiukai;7485768254;Taip;21;0;0;21
19011;Žiburėlis;Viščiukai;7364102991;Ne;23;0;0;23
19012;Žiburėlis;Viščiukai;2506620539;Ne;17;0;0;17
19013;Žiburėlis;Viščiukai;9553194981;Ne;17;0;0;17
19014;Žiburėlis;Viščiukai;8179414341;Taip;24;0;0;24
19015;Žiburėlis;Viščiukai;7140031765;Ne;16;0;3;19
19016;Žiburėlis;Viščiukai;1758251348;Taip;5;1;0;6
19017;Žiburėlis;Viščiukai;3323538690;Taip;19;0;0;19
19018;Žiburėlis;Viščiukai;1121755119;Taip;6;0;0;6
19019;Žiburėlis;Viščiukai;3738184802;Taip;8;8;0;16
19020;Žiburėlis;Viščiukai;8603154782;Taip;19;0;0;19
19021;Žiburėlis;Viščiukai;5213049603;Taip;11;0;0;11
19022;Žiburėlis;Viščiukai;4727673956;Taip;20;0;0;20
19023;Žiburėlis;Viščiukai;1606332622;Ne;20;0;0;20
19024;Žiburėlis;Viščiukai;8284913889;Taip;21;0;0;21
19025;Žiburėlis;Viščiukai;2851350451;Ne;5;2;0;7
19026;Žiburėlis;Viščiukai;6206770019;Taip;5;7;0;12
19027;Žiburėlis;Viščiukai;5314676261;Taip;8;1;0;9
19028;Žiburėlis;"Drambliukai ";5724506894;Taip;5;1;0;6
19029;Žiburėlis;"Drambliukai ";2102574423;Taip;3;1;0;4
19030;Žiburėlis;"Drambliukai ";4937518207;Taip;25;0;0;25
19031;Žiburėlis;"Drambliukai ";9041469393;Ne;11;0;0;11
19032;Žiburėlis;"Drambliukai ";8285987095;Taip;28;0;0;28
19033;Žiburėlis;"Drambliukai ";2805244671;Taip;12;3;0;15
19034;Žiburėlis;"Drambliukai ";5025452484;Ne;15;3;0;18
19035;Žiburėlis;"Drambliukai ";9344950711;Taip;10;2;0;12
19036;Žiburėlis;"Drambliukai ";8082088504;Ne;4;0;0;4
19037;Žiburėlis;"Drambliukai ";4656467260;Taip;8;4;0;12
19038;Žiburėlis;"Drambliukai ";9771442035;Ne;7;4;0;11
19039;Žiburėlis;"Drambliukai ";6274583813;Taip;17;0;0;17
19040;Žiburėlis;"Drambliukai ";5194593598;Taip;28;0;0;28
19041;Žiburėlis;"Drambliukai ";3821663597;Taip;28;0;0;28
19042;Žiburėlis;"Drambliukai ";8752098051;Taip;5;1;0;6
19043;Žiburėlis;"Drambliukai ";8207315673;Ne;10;6;0;16
19044;Žiburėlis;"Drambliukai ";6751043071;Taip;28;0;0;28
19045;Žiburėlis;"Drambliukai ";1449541244;Taip;26;0;0;26
19046;Žiburėlis;BORUŽIUKAI;3723613593;Taip;6;0;0;6
19047;Žiburėlis;BORUŽIUKAI;9964255985;Taip;0;2;0;2
19048;Žiburėlis;BORUŽIUKAI;7895148630;Taip;9;4;1;14
19049;Žiburėlis;BORUŽIUKAI;8936912406;Taip;12;1;0;13
19050;Žiburėlis;BORUŽIUKAI;1422951221;Ne;7;3;0;10
19051;Žiburėlis;BORUŽIUKAI;4631232618;Taip;9;0;0;9
19052;Žiburėlis;BORUŽIUKAI;5793531526;Taip;0;3;0;3
19053;Žiburėlis;BORUŽIUKAI;4578828135;Taip;8;1;1;10
19054;Žiburėlis;BORUŽIUKAI;6128571259;Taip;0;1;3;4
19055;Žiburėlis;BORUŽIUKAI;3760039280;Taip;6;4;0;10
19056;Žiburėlis;BORUŽIUKAI;5799439634;Taip;0;5;0;5
19057;Žiburėlis;BORUŽIUKAI;4229040996;Taip;9;0;0;9
19058;Žiburėlis;BORUŽIUKAI;8373944614;Taip;20;0;5;25
19059;Žiburėlis;BORUŽIUKAI;9256751455;Taip;6;3;0;9
19060;Žiburėlis;BORUŽIUKAI;2077823704;Taip;7;2;0;9
19061;Žiburėlis;BORUŽIUKAI;9357376188;Taip;0;5;0;5
19062;Žiburėlis;BORUŽIUKAI;9029039015;Taip;0;0;4;4
19063;Žiburėlis;BORUŽIUKAI;7017574924;Taip;0;8;0;8
19064;Žiburėlis;BORUŽIUKAI;1661456806;Taip;4;1;0;5
19065;Žiburėlis;BORUŽIUKAI;2527837980;Taip;13;0;1;14
19066;Žiburėlis;SPINDULIUKAI;5002691930;Taip;5;2;0;7
19067;Žiburėlis;SPINDULIUKAI;2995697464;Taip;14;0;1;15
19068;Žiburėlis;SPINDULIUKAI;7856708616;Taip;14;0;0;14
19069;Žiburėlis;SPINDULIUKAI;5205959106;Taip;20;0;0;20
19070;Žiburėlis;SPINDULIUKAI;2491972986;Taip;6;8;0;14
19071;Žiburėlis;SPINDULIUKAI;1190058462;Taip;15;0;0;15
19072;Žiburėlis;SPINDULIUKAI;8970153523;Taip;0;0;2;2
19073;Žiburėlis;SPINDULIUKAI;7402647048;Taip;3;1;0;4
19074;Žiburėlis;SPINDULIUKAI;6830200578;Taip;7;0;0;7
19075;Žiburėlis;SPINDULIUKAI;5951659866;Taip;10;1;0;11
19076;Žiburėlis;SPINDULIUKAI;1775465307;Taip;0;6;0;6
19077;Žiburėlis;SPINDULIUKAI;8346571253;Taip;0;3;0;3
19078;Žiburėlis;SPINDULIUKAI;4720567144;Taip;5;0;0;5
19079;Žiburėlis;SPINDULIUKAI;8973307069;Taip;12;0;0;12
19080;Žiburėlis;SPINDULIUKAI;5098955523;Ne;0;10;0;10
19081;Žiburėlis;SPINDULIUKAI;5629404179;Taip;8;1;0;9
19082;Žiburėlis;SPINDULIUKAI;6647598068;Taip;5;0;0;5
19083;Žiburėlis;SPINDULIUKAI;8686565770;Taip;3;3;0;6
19084;Žiburėlis;SPINDULIUKAI;7111530833;Taip;0;4;0;4
19085;Žiburėlis;SPINDULIUKAI;7825665451;Taip;6;7;0;13
19086;Žiburėlis;SPINDULIUKAI;5556807335;Taip;4;0;0;4
19087;Žiburėlis;SPINDULIUKAI;2808361570;Ne;7;9;0;16
19088;Žiburėlis;KIŠKUČIAI;3352845095;Taip;7;0;0;7
19089;Žiburėlis;KIŠKUČIAI;1004953300;Ne;0;1;0;1
19090;Žiburėlis;KIŠKUČIAI;3296994981;Taip;10;3;0;13
19091;Žiburėlis;KIŠKUČIAI;1887550130;Ne;9;5;0;14
19092;Žiburėlis;KIŠKUČIAI;6019278045;Taip;14;0;0;14
19093;Žiburėlis;KIŠKUČIAI;4079793067;Taip;10;3;1;14
19094;Žiburėlis;KIŠKUČIAI;5418413225;Taip;10;3;0;13
19095;Žiburėlis;KIŠKUČIAI;6044837042;Ne;0;7;4;11
19096;Žiburėlis;KIŠKUČIAI;1334695206;Taip;0;3;18;21
19097;Žiburėlis;KIŠKUČIAI;7597762608;Taip;4;2;0;6
19098;Žiburėlis;KIŠKUČIAI;6562748977;Ne;4;3;1;8
19099;Žiburėlis;KIŠKUČIAI;5145195661;Taip;0;11;0;11
19100;Žiburėlis;KIŠKUČIAI;4477396434;Ne;9;3;10;22
19101;Žiburėlis;KIŠKUČIAI;2712358146;Taip;0;3;19;22
19102;Žiburėlis;KIŠKUČIAI;5410394172;Taip;4;0;2;6
19103;Žiburėlis;KIŠKUČIAI;2117995780;Taip;4;1;0;5
19104;Žiburėlis;KIŠKUČIAI;4003368130;Taip;4;0;2;6
19105;Žiburėlis;KIŠKUČIAI;2456703958;Taip;0;0;1;1
19106;Žiburėlis;KIŠKUČIAI;1868558773;Ne;19;0;0;19
19107;Žiburėlis;KIŠKUČIAI;2083500905;Taip;0;3;0;3
19108;Žiburėlis;KIŠKUČIAI;6577061306;Taip;8;0;2;10
19109;Žiburėlis;DRUGELIAI;9783567484;Taip;8;3;0;11
19110;Žiburėlis;DRUGELIAI;4109288891;Taip;21;1;0;22
19111;Žiburėlis;DRUGELIAI;1015624216;Taip;3;2;0;5
19112;Žiburėlis;DRUGELIAI;9526477121;Ne;8;4;0;12
19113;Žiburėlis;DRUGELIAI;4387021429;Taip;0;8;0;8
19114;Žiburėlis;DRUGELIAI;8018718405;Taip;0;13;0;13
19115;Žiburėlis;DRUGELIAI;4910787530;Taip;0;22;0;22
19116;Žiburėlis;DRUGELIAI;5324852807;Ne;0;3;0;3
19117;Žiburėlis;DRUGELIAI;4916545915;Taip;0;17;0;17
19118;Žiburėlis;DRUGELIAI;8133371774;Taip;16;12;0;28
19119;Žiburėlis;DRUGELIAI;7278242428;Taip;18;0;4;22
19120;Žiburėlis;DRUGELIAI;5732540560;Ne;0;5;0;5
19121;Žiburėlis;DRUGELIAI;2163018032;Taip;0;5;0;5
19122;Žiburėlis;DRUGELIAI;4581800760;Taip;15;0;0;15
19123;Žiburėlis;DRUGELIAI;8493950205;Taip;0;2;0;2
19124;Justinukas;VARLIUKAI;6878000636;Taip;14;0;0;14
19125;Justinukas;ŽIOGELIAI;6444931940;Taip;10;0;0;10
19126;Justinukas;ŽIOGELIAI;9037601873;Taip;11;0;0;11
19127;Justinukas;PELEDŽIUKŲ;5258404345;Taip;9;0;0;9
19128;Justinukas;PELEDŽIUKŲ;2009689031;Taip;12;0;0;12
19129;Justinukas;BORUŽIUKŲ;7295085620;Taip;13;0;0;13
19130;Justinukas;SKRUZDĖLIUKAI;7521830021;Taip;10;0;0;10
19131;Justinukas;SKRUZDĖLIUKAI;9460529256;Taip;6;0;0;6
19132;Justinukas;SKRUZDĖLIUKAI;8557301691;Taip;9;0;0;9
19133;Justinukas;SKRUZDĖLIUKAI;3068758593;Taip;5;0;0;5
19134;Justinukas;SKRUZDĖLIUKAI;9176395771;Taip;6;0;0;6
19135;Justinukas;SKRUZDĖLIUKAI;7724869086;Taip;10;0;0;10
19136;Justinukas;ŽVIRBLIUKAI;3510272433;Taip;18;0;0;18
19137;Justinukas;ŽVIRBLIUKAI;3921870527;Taip;4;0;0;4
19138;Justinukas;EŽIUKAI;3947021827;Taip;5;0;0;5
19139;Justinukas;EŽIUKAI;4425373579;Taip;13;0;0;13
19140;Justinukas;EŽIUKAI;9140896667;Taip;9;0;0;9
19141;Justinukas;DRUGELIAI;3013789713;Taip;5;0;0;5
19142;Justinukas;BITUTĖS;9721186766;Ne;10;0;0;10
19143;Justinukas;BITUTĖS;5731567899;Taip;10;0;0;10
19144;Justinukas;BITUTĖS;5896794895;Taip;11;0;0;11
19145;Justinukas;BITUTĖS;7440371868;Taip;6;0;0;6
19146;Justinukas;KAČIUKAI;8592318869;Taip;5;0;0;5
19147;Justinukas;KAČIUKAI;9680924796;Taip;15;0;0;15
19148;Bangelė;Aštuonkojai;6026399355;Taip;10;0;3;13
19149;Bangelė;Aštuonkojai;5504180016;Ne;0;0;2;2
19150;Bangelė;Aštuonkojai;5476753511;Taip;0;3;5;8
19151;Bangelė;Aštuonkojai;9168310196;Taip;6;3;0;9
19152;Bangelė;Aštuonkojai;1754002501;Taip;9;0;3;12
19153;Bangelė;Aštuonkojai;8336001702;Ne;0;2;0;2
19154;Bangelė;Aštuonkojai;8875703109;Taip;10;8;0;18
19155;Bangelė;Aštuonkojai;6953698592;Ne;10;0;1;11
19156;Bangelė;Aštuonkojai;3063439996;Taip;17;1;0;18
19157;Bangelė;Aštuonkojai;2156837975;Taip;8;0;0;8
19158;Bangelė;Aštuonkojai;9143945953;Taip;6;1;1;8
19159;Bangelė;Aštuonkojai;3022508446;Ne;10;0;2;12
19160;Bangelė;Aštuonkojai;5546256869;Taip;5;0;0;5
19161;Bangelė;Aštuonkojai;6980232224;Ne;11;0;0;11
19162;Bangelė;Aštuonkojai;6145050734;Taip;14;5;0;19
19163;Bangelė;Aštuonkojai;1390623903;Taip;0;9;0;9
19164;Bangelė;Aštuonkojai;9788923823;Taip;14;6;0;20
19165;Bangelė;Aštuonkojai;7136625230;Taip;10;4;0;14
19166;Bangelė;Aštuonkojai;2491928697;Taip;10;0;0;10
19167;Bangelė;Aštuonkojai;6216334243;Taip;5;1;0;6
19168;Bangelė;Delfinukai,;3471355267;Taip;6;0;0;6
19169;Bangelė;Delfinukai,;7107685761;Taip;0;3;1;4
19170;Bangelė;Delfinukai,;6978215876;Taip;1;0;2;3
19171;Bangelė;Delfinukai,;7434358474;Taip;0;19;0;19
19172;Bangelė;Delfinukai,;2575806242;Taip;0;1;8;9
19173;Bangelė;Delfinukai,;9801978617;Taip;0;7;0;7
19174;Bangelė;Delfinukai,;7434879947;Taip;6;0;0;6
19175;Bangelė;Delfinukai,;5994720767;Taip;10;8;0;18
19176;Bangelė;Delfinukai,;4532810332;Taip;0;10;0;10
19177;Bangelė;Delfinukai,;8575020060;Taip;0;1;0;1
19178;Bangelė;Delfinukai,;4036461205;Taip;8;0;0;8
19179;Bangelė;Delfinukai,;3344441441;Taip;11;1;0;12
19180;Bangelė;Delfinukai,;2858929915;Taip;14;4;0;18
19181;Bangelė;Delfinukai,;7068305612;Taip;13;0;5;18
19182;Bangelė;Delfinukai,;4412780063;Taip;14;0;0;14
19183;Bangelė;Delfinukai,;9608900293;Taip;0;0;5;5
19184;Bangelė;Delfinukai,;6819322060;Ne;0;0;7;7
19185;Bangelė;"Saulės spindulėliai";55668308050;Taip;0;15;0;15
19186;Bangelė;"Saulės spindulėliai";9150185864;Taip;0;0;4;4
19187;Bangelė;"Saulės spindulėliai";2863118434;Ne;20;0;0;20
19188;Bangelė;"Saulės spindulėliai";9167286651;Taip;0;4;9;13
19189;Bangelė;"Saulės spindulėliai";43740476077;Taip;0;12;0;12
19190;Bangelė;"Saulės spindulėliai";9846780259;Ne;0;11;0;11
19191;Bangelė;"Saulės spindulėliai";1377734102;Taip;0;1;1;2
19192;Bangelė;"Saulės spindulėliai";5950451237;Taip;0;7;0;7
19193;Bangelė;"Saulės spindulėliai";9488932192;Taip;22;0;0;22
19194;Bangelė;"Saulės spindulėliai";1728085772;Ne;5;1;0;6
19195;Bangelė;"Saulės spindulėliai";1447396084;Ne;0;1;3;4
19196;Bangelė;"Saulės spindulėliai";6927540308;Ne;12;1;5;18
19197;Bangelė;"Saulės spindulėliai";9464115339;Taip;7;2;0;9
19198;Bangelė;"Saulės spindulėliai";4401389067;Taip;0;1;0;1
19199;Bangelė;"Saulės spindulėliai";3338203753;Taip;8;3;0;11
19200;Bangelė;"Saulės spindulėliai";3206495858;Taip;0;5;3;8
19201;Bangelė;"Saulės spindulėliai";7861208185;Taip;0;5;3;8
19202;Bangelė;"Saulės spindulėliai";2027892816;Taip;0;3;0;3
19203;Bangelė;"Saulės spindulėliai";2503946448;Taip;0;2;0;2
19204;Bangelė;"Saulės spindulėliai";2872188915;Ne;16;4;1;21
19205;Bangelė;"Saulės spindulėliai";3132827429;Taip;0;1;0;1
19206;Bangelė;"Pingvinukai ";9980881014;Taip;5;0;0;5
19207;Bangelė;"Pingvinukai ";4317054990;Taip;5;1;1;7
19208;Bangelė;"Pingvinukai ";8943721679;Taip;0;0;2;2
19209;Bangelė;"Pingvinukai ";6566277472;Taip;5;0;6;11
19210;Bangelė;"Pingvinukai ";7362196984;Ne;3;7;2;12
19211;Bangelė;"Pingvinukai ";4712616315;Taip;15;0;0;15
19212;Bangelė;"Pingvinukai ";4940247006;Taip;13;0;0;13
19213;Bangelė;"Pingvinukai ";8335931279;Taip;10;3;0;13
19214;Bangelė;"Pingvinukai ";9311379746;Taip;0;9;1;10
19215;Bangelė;"Pingvinukai ";9955097720;Taip;22;0;0;22
19216;Bangelė;"Pingvinukai ";4851593235;Taip;0;9;1;10
19217;Bangelė;"Pingvinukai ";8998648968;Taip;4;0;0;4
19218;Bangelė;"Pingvinukai ";7016039389;Taip;0;5;0;5
19219;Bangelė;"Pingvinukai ";2127734178;Taip;0;1;0;1
19220;Bangelė;"Pingvinukai ";2107766301;Taip;8;0;0;8
19221;Bangelė;"Pingvinukai ";5237434283;Taip;6;0;0;6
19222;Bangelė;"Pingvinukai ";4651237403;Taip;17;0;0;17
19223;Bangelė;"Pingvinukai ";8661284187;Taip;0;0;1;1
19224;Bangelė;"Pingvinukai ";1541525635;Taip;0;0;1;1
19225;Bangelė;"Jūros žvaigždutės ";5673493708;Taip;22;2;0;24
19226;Bangelė;"Jūros žvaigždutės ";9447145378;Ne;4;3;0;7
19227;Bangelė;"Jūros žvaigždutės ";4086446380;Taip;6;10;0;16
19228;Bangelė;"Jūros žvaigždutės ";8745595583;Ne;14;0;0;14
19229;Bangelė;"Jūros žvaigždutės ";4831656996;Taip;11;0;6;17
19230;Bangelė;"Jūros žvaigždutės ";9267349375;Ne;0;18;4;22
19231;Bangelė;"Jūros žvaigždutės ";3069288815;Ne;13;0;1;14
19232;Bangelė;"Jūros žvaigždutės ";9729929020;Taip;16;0;0;16
19233;Bangelė;"Jūros žvaigždutės ";8563674709;Taip;18;1;0;19
19234;Bangelė;"Jūros žvaigždutės ";3946690047;Taip;5;0;0;5
19235;Bangelė;"Jūros žvaigždutės ";6705583340;Taip;10;0;9;19
19236;Bangelė;"Jūros žvaigždutės ";1544311819;Ne;0;0;1;1
19237;Bangelė;"Jūros žvaigždutės ";2662758502;Taip;13;1;0;14
19238;Bangelė;"Jūros žvaigždutės ";6174617493;Taip;0;0;10;10
19239;Bangelė;"Jūros žvaigždutės ";9633372201;Ne;8;3;0;11
19240;Bangelė;"Jūros žvaigždutės ";8075810032;Taip;6;3;0;9
19241;Bangelė;"Jūros žvaigždutės ";3500097405;Ne;22;0;0;22
19242;Bangelė;Žuvytės;9009809585;Ne;0;4;0;4
19243;Bangelė;Žuvytės;6496580354;Taip;9;0;7;16
19244;Bangelė;Žuvytės;6480681705;Taip;0;8;0;8
19245;Bangelė;Žuvytės;7142694888;Taip;0;0;9;9
19246;Bangelė;Žuvytės;8734511431;Taip;0;6;0;6
19247;Bangelė;Žuvytės;1895213200;Taip;0;0;6;6
19248;Bangelė;Žuvytės;9765268154;Taip;9;11;0;20
19249;Bangelė;Žuvytės;8495423628;Taip;16;0;0;16
19250;Bangelė;Žuvytės;7419016784;Ne;13;0;3;16
19251;Bangelė;Žuvytės;5190563034;Taip;19;0;0;19
19252;Bangelė;Žuvytės;3991021350;Ne;0;0;10;10
19253;Bangelė;Žuvytės;9954762483;Taip;10;2;0;12
19254;Bangelė;Žuvytės;9493465898;Ne;0;10;2;12
19255;Bangelė;Žuvytės;5597329949;Taip;0;11;0;11
19256;Bangelė;Žuvytės;2134225414;Taip;13;0;0;13
19257;Bangelė;Žuvytės;4494049529;Taip;12;0;2;14
19258;Bangelė;Žuvytės;3334029244;Taip;0;9;0;9
19259;Bangelė;Žuvytės;6165322599;Taip;0;4;0;4
19260;Bangelė;Žuvytės;3016778137;Ne;0;0;1;1
19261;Bangelė;Žuvytės;1898671487;Taip;10;1;0;11
19262;Bangelė;Žuvytės;7174742281;Taip;23;0;0;23
19263;Bangelė;Žuvytės;6806911810;Ne;16;0;3;19
19264;Bangelė;Ruoniai;8149880453;Taip;0;6;0;6
19265;Bangelė;Ruoniai;4571869439;Taip;0;5;0;5
19266;Bangelė;Ruoniai;9672505885;Ne;0;3;2;5
19267;Bangelė;Ruoniai;2017886238;Taip;5;0;0;5
19268;Bangelė;Ruoniai;8990701154;Taip;14;0;1;15
19269;Bangelė;Ruoniai;6861123988;Taip;0;5;0;5
19270;Bangelė;Ruoniai;7233139048;Taip;9;1;2;12
19271;Bangelė;Ruoniai;6044653707;Taip;0;9;0;9
19272;Bangelė;Ruoniai;1915827035;Taip;0;9;0;9
19273;Bangelė;Ruoniai;7685394517;Taip;5;0;0;5
19274;Bangelė;Ruoniai;9041585534;Taip;10;4;0;14
19275;Bangelė;Ruoniai;9706351115;Taip;0;1;0;1
19276;Bangelė;Ruoniai;6693019825;Taip;3;1;0;4
19277;Bangelė;Ruoniai;2764009011;Taip;10;0;0;10
19278;Bangelė;Ruoniai;4338067260;Taip;22;0;0;22
19279;Bangelė;Ruoniai;8758933649;Taip;6;0;5;11
19280;Bangelė;Ruoniai;3900236858;Taip;8;1;0;9
19281;Bangelė;Ruoniai;7230987338;Taip;0;0;3;3
19282;Bangelė;Ruoniai;7337449523;Taip;11;0;3;14
19283;Bangelė;Ruoniai;1528387105;Taip;7;7;0;14
19284;Bangelė;Ruoniai;6712145066;Taip;4;0;8;12
19285;Bangelė;"Pagrandukai ";9561221619;Taip;13;7;0;20
19286;Bangelė;"Pagrandukai ";9128326823;Taip;4;1;5;10
19287;Bangelė;"Pagrandukai ";6415607960;Taip;8;0;6;14
19288;Bangelė;"Pagrandukai ";1182624046;Taip;7;5;0;12
19289;Bangelė;"Pagrandukai ";9355348960;Taip;7;1;0;8
19290;Bangelė;"Pagrandukai ";1467390411;Taip;27;0;0;27
19291;Bangelė;"Pagrandukai ";2730545639;Taip;12;0;2;14
19292;Bangelė;"Pagrandukai ";4041276015;Taip;10;0;3;13
19293;Bangelė;"Pagrandukai ";7503518328;Taip;11;0;0;11
19294;Bangelė;"Pagrandukai ";9010238689;Taip;8;3;0;11
19295;Bangelė;"Pagrandukai ";5829865386;Taip;0;0;22;22
19296;Bangelė;"Zuikučiai ";9705672732;Taip;0;2;0;2
19297;Bangelė;"Zuikučiai ";7364368699;Taip;22;1;3;26
19298;Bangelė;"Zuikučiai ";6400785821;Ne;8;5;0;13
19299;Bangelė;"Zuikučiai ";3806267811;Taip;9;0;0;9
19300;Bangelė;"Zuikučiai ";5961647252;Taip;10;2;0;12
19301;Bangelė;"Zuikučiai ";8493650050;Taip;10;3;0;13
19302;Bangelė;"Zuikučiai ";3851738513;Taip;9;1;0;10
19303;Bangelė;"Zuikučiai ";3452984649;Taip;22;0;0;22
19304;Bangelė;"Zuikučiai ";2362345363;Taip;0;0;1;1
19305;Bangelė;"Zuikučiai ";4891131242;Taip;13;3;0;16
19306;Bangelė;"Zuikučiai ";7445583512;Ne;0;9;0;9
19307;Bangelė;"Zuikučiai ";8931569423;Ne;18;0;0;18
19308;Bangelė;"Zuikučiai ";2382714949;Ne;9;0;1;10
19309;Bangelė;"Zuikučiai ";7755966282;Taip;0;1;5;6
19310;Bangelė;"Zuikučiai ";4480762963;Taip;5;1;2;8
19311;Bangelė;"Zuikučiai ";8765892966;Taip;0;4;0;4
19312;Bangelė;Vėžliukai;9142460659;Taip;13;0;2;15
19313;Bangelė;Vėžliukai;7862345122;Taip;9;0;4;13
19314;Bangelė;Vėžliukai;1869389013;Taip;11;11;0;22
19315;Bangelė;Vėžliukai;8243377854;Ne;0;2;0;2
19316;Bangelė;Vėžliukai;2630571748;Taip;1;7;0;8
19317;Bangelė;Vėžliukai;6003859569;Taip;0;5;0;5
19318;Bangelė;Vėžliukai;3978683237;Taip;6;1;0;7
19319;Bangelė;Vėžliukai;5779198855;Taip;0;1;0;1
19320;Bangelė;Vėžliukai;5746189515;Ne;7;2;0;9
19321;Bangelė;Vėžliukai;6312356331;Taip;8;1;5;14
19322;Bangelė;Vėžliukai;8454369872;Ne;0;3;2;5
19323;Gėlynas;PAKALNUTĖ;4557380282;Taip;11;5;0;16
19324;Gėlynas;PAKALNUTĖ;6884111634;Taip;15;0;0;15
19325;Gėlynas;PAKALNUTĖ;1548317086;Taip;6;0;0;6
19326;Gėlynas;PAKALNUTĖ;3470963396;Taip;10;5;0;15
19327;Gėlynas;PAKALNUTĖ;6053841081;Taip;11;0;0;11
19328;Gėlynas;PAKALNUTĖ;2171064300;Taip;14;0;0;14
19329;Gėlynas;PAKALNUTĖ;2404562144;Taip;0;8;0;8
19330;Gėlynas;PAKALNUTĖ;7504469409;Taip;7;0;0;7
19331;Gėlynas;PAKALNUTĖ;8693415786;Taip;7;0;0;7
19332;Gėlynas;PAKALNUTĖ;4366442459;Taip;6;3;0;9
19333;Gėlynas;PAKALNUTĖ;1463783538;Taip;3;0;1;4
19334;Gėlynas;PAKALNUTĖ;7064068912;Ne;0;19;0;19
19335;Gėlynas;PAKALNUTĖ;1822933936;Taip;10;1;0;11
19336;Gėlynas;PAKALNUTĖ;4668195919;Taip;0;10;0;10
19337;Gėlynas;PAKALNUTĖ;8555408466;Ne;10;8;0;18
19338;Gėlynas;PAKALNUTĖ;2377323648;Taip;9;0;0;9
19339;Gėlynas;PAKALNUTĖ;5382148888;Ne;14;0;0;14
19340;Gėlynas;PAKALNUTĖ;6296728638;Taip;0;3;0;3
19341;Gėlynas;PAKALNUTĖ;5826067446;Taip;5;0;0;5
19342;Gėlynas;PAKALNUTĖ;2273705177;Taip;9;8;1;18
19343;Gėlynas;PAKALNUTĖ;5350834071;Taip;0;0;6;6
19344;Gėlynas;PAKALNUTĖ;2520140743;Taip;8;0;0;8
19345;Gėlynas;VARPELIS;2769668641;Taip;4;7;0;11
19346;Gėlynas;VARPELIS;1004866224;Taip;2;0;5;7
19347;Gėlynas;VARPELIS;2417880374;Taip;0;1;11;12
19348;Gėlynas;VARPELIS;4382465307;Taip;8;12;0;20
19349;Gėlynas;VARPELIS;5135747448;Taip;0;1;0;1
19350;Gėlynas;VARPELIS;1754734306;Taip;0;10;0;10
19351;Gėlynas;VARPELIS;1774829898;Taip;0;0;5;5
19352;Gėlynas;VARPELIS;7562201835;Taip;0;4;0;4
19353;Gėlynas;VARPELIS;4445250490;Ne;7;0;4;11
19354;Gėlynas;VARPELIS;2132298690;Taip;13;1;0;14
19355;Gėlynas;VARPELIS;7877521812;Taip;6;0;0;6
19356;Gėlynas;VARPELIS;8464074679;Taip;0;1;8;9
19357;Gėlynas;VARPELIS;9911225363;Taip;0;1;8;9
19358;Gėlynas;VARPELIS;5395474698;Ne;9;7;0;16
19359;Gėlynas;VARPELIS;6898127005;Taip;5;9;0;14
19360;Gėlynas;VARPELIS;3365442661;Taip;22;1;0;23
19361;Gėlynas;VARPELIS;5145396320;Taip;5;8;0;13
19362;Gėlynas;VARPELIS;90046802421;Taip;4;0;2;6
19363;Gėlynas;VARPELIS;7814357385;Ne;0;3;4;7
19364;Gėlynas;VARPELIS;1674569569;Taip;10;5;0;15
19365;Gėlynas;VARPELIS;1036951275;Ne;0;3;5;8
19366;Gėlynas;VARPELIS;7808971151;Taip;0;1;7;8
19367;Gėlynas;VARPELIS;4916885450;Taip;0;1;6;7
19368;Gėlynas;RAKTAŽOLĖ;3572020585;Taip;4;0;0;4
19369;Gėlynas;RAKTAŽOLĖ;5634213306;Taip;3;1;0;4
19370;Gėlynas;RAKTAŽOLĖ;3491517766;Taip;6;2;0;8
19371;Gėlynas;RAKTAŽOLĖ;4505012978;Taip;12;3;0;15
19372;Gėlynas;RAKTAŽOLĖ;5541707540;Taip;11;0;0;11
19373;Gėlynas;RAKTAŽOLĖ;5124029118;Taip;20;4;0;24
19374;Gėlynas;RAKTAŽOLĖ;9508507084;Taip;10;1;0;11
19375;Gėlynas;RAKTAŽOLĖ;8999346908;Taip;16;3;0;19
19376;Gėlynas;RAKTAŽOLĖ;8458276300;Taip;9;4;0;13
19377;Gėlynas;RAKTAŽOLĖ;7730322729;Taip;6;2;0;8
19378;Gėlynas;RAKTAŽOLĖ;2348787949;Taip;4;1;1;6
19379;Gėlynas;RAKTAŽOLĖ;6528464599;Taip;11;3;0;14
19380;Gėlynas;RAKTAŽOLĖ;8615943743;Taip;5;4;0;9
19381;Gėlynas;RAKTAŽOLĖ;7389502638;Ne;17;0;0;17
19382;Gėlynas;RAKTAŽOLĖ;1590299264;Taip;10;5;0;15
19383;Gėlynas;RAKTAŽOLĖ;5751256561;Taip;12;1;1;14
19384;Gėlynas;RAKTAŽOLĖ;8080660097;Ne;11;0;0;11
19385;Gėlynas;RAKTAŽOLĖ;1015554617;Taip;11;0;0;11
19386;Gėlynas;RAKTAŽOLĖ;9252696260;Taip;17;0;0;17
19387;Gėlynas;RAKTAŽOLĖ;6875794958;Taip;0;6;0;6
19388;Gėlynas;RAKTAŽOLĖ;8444505017;Taip;18;4;0;22
19389;Gėlynas;RAKTAŽOLĖ;5695333666;Ne;0;3;0;3
19390;Gėlynas;SAULĖGRĄŽA;5898582218;Taip;6;0;0;6
19391;Gėlynas;SAULĖGRĄŽA;1505666690;Taip;9;0;0;9
19392;Gėlynas;SAULĖGRĄŽA;3492361041;Taip;7;1;0;8
19393;Gėlynas;SAULĖGRĄŽA;6451922757;Taip;5;7;0;12
19394;Gėlynas;SAULĖGRĄŽA;2141722631;Taip;6;7;0;13
19395;Gėlynas;SAULĖGRĄŽA;2742456983;Taip;10;1;2;13
19396;Gėlynas;SAULĖGRĄŽA;4983822000;Taip;4;0;0;4
19397;Gėlynas;SAULĖGRĄŽA;3549079170;Taip;21;3;0;24
19398;Gėlynas;SAULĖGRĄŽA;9305282699;Taip;0;6;0;6
19399;Gėlynas;SAULĖGRĄŽA;6815740588;Taip;0;3;3;6
19400;Gėlynas;SAULĖGRĄŽA;3606076029;Taip;0;10;0;10
19401;Gėlynas;SAULĖGRĄŽA;5964419627;Taip;5;0;3;8
19402;Gėlynas;SAULĖGRĄŽA;4824667762;Taip;0;1;0;1
19403;Gėlynas;SAULĖGRĄŽA;9330385153;Taip;0;16;0;16
19404;Gėlynas;SAULĖGRĄŽA;9724668402;Ne;0;3;0;3
19405;Gėlynas;SAULĖGRĄŽA;9462822190;Taip;11;0;0;11
19406;Gėlynas;SAULĖGRĄŽA;2784709117;Taip;5;0;3;8
19407;Gėlynas;SAULĖGRĄŽA;6114995335;Taip;3;0;7;10
19408;Gėlynas;SAULĖGRĄŽA;5291444399;Taip;8;0;2;10
19409;Gėlynas;SAULĖGRĄŽA;5320531856;Taip;6;1;0;7
19410;Gėlynas;SAULĖGRĄŽA;7998013477;Taip;8;1;0;9
19411;Gėlynas;SAULĖGRĄŽA;6244314445;Taip;0;14;0;14
19412;Gėlynas;RAMUNĖLĖ;1665668966;Taip;12;0;6;18
19413;Gėlynas;RAMUNĖLĖ;9707677931;Taip;10;0;1;11
19414;Gėlynas;RAMUNĖLĖ;1235384604;Taip;9;0;0;9
19415;Gėlynas;RAMUNĖLĖ;9230984365;Taip;4;0;5;9
19416;Gėlynas;RAMUNĖLĖ;5813156578;Taip;11;0;0;11
19417;Gėlynas;RAMUNĖLĖ;6221721945;Taip;9;0;0;9
19418;Gėlynas;RAMUNĖLĖ;7005278902;Taip;0;0;1;1
19419;Gėlynas;RAMUNĖLĖ;6790040590;Ne;7;0;0;7
19420;Gėlynas;RAMUNĖLĖ;4854709904;Taip;0;11;0;11
19421;Gėlynas;RAMUNĖLĖ;2434552926;Taip;14;0;2;16
19422;Gėlynas;RAMUNĖLĖ;1570975863;Taip;5;0;0;5
19423;Gėlynas;RAMUNĖLĖ;9302757372;Taip;0;15;0;15
19424;Gėlynas;RAMUNĖLĖ;8550986498;Taip;8;0;1;9
19425;Gėlynas;RAMUNĖLĖ;6342888072;Taip;0;14;0;14
19426;Gėlynas;RAMUNĖLĖ;9973824348;Taip;9;0;13;22
19427;Gėlynas;RAMUNĖLĖ;1681208354;Taip;8;0;11;19
19428;Gėlynas;RAMUNĖLĖ;1003739544;Taip;15;0;1;16
19429;Gėlynas;ŽIBUTĖ;4192292896;Taip;0;17;0;17
19430;Gėlynas;ŽIBUTĖ;6826311903;Taip;0;2;0;2
19431;Gėlynas;ŽIBUTĖ;8447789767;Taip;19;3;0;22
19432;Gėlynas;ŽIBUTĖ;1862266440;Taip;17;0;0;17
19433;Gėlynas;ŽIBUTĖ;3746597878;Taip;5;3;0;8
19434;Gėlynas;ŽIBUTĖ;9182072776;Taip;5;0;0;5
19435;Gėlynas;ŽIBUTĖ;4292724541;Taip;11;1;0;12
19436;Gėlynas;ŽIBUTĖ;8681345327;Taip;9;0;0;9
19437;Gėlynas;ŽIBUTĖ;7988094745;Taip;15;0;1;16
19438;Gėlynas;ŽIBUTĖ;9552677108;Taip;8;1;0;9
19439;Gėlynas;ŽIBUTĖ;2608369575;Taip;8;1;0;9
19440;Gėlynas;ŽIBUTĖ;1949260962;Taip;11;3;0;14
19441;Gėlynas;ŽIBUTĖ;6635004996;Taip;15;3;0;18
19442;Gėlynas;ŽIBUTĖ;1556683639;Taip;6;0;0;6
19443;Gėlynas;ŽIBUTĖ;5942466822;Taip;15;0;0;15
19444;Gėlynas;ŽIBUTĖ;2193861056;Ne;4;0;5;9
19445;Gėlynas;ŽIBUTĖ;8743722205;Taip;8;0;1;9
19446;Gėlynas;ŽIBUTĖ;2790269385;Taip;11;0;2;13
19447;Gėlynas;ŽIBUTĖ;2885148633;Taip;13;0;0;13
19448;Obelėlė;Gudručiai;2014314139;Ne;14;0;4;18
19449;Obelėlė;Gudručiai;9900484892;Taip;5;0;3;8
19450;Obelėlė;Gudručiai;6145113624;Taip;22;0;0;22
19451;Obelėlė;Gudručiai;9586720282;Taip;5;1;4;10
19452;Obelėlė;Gudručiai;9567704282;Taip;1;1;0;2
19453;Obelėlė;Gudručiai;4015702815;Taip;5;0;1;6
19454;Obelėlė;Gudručiai;4309139638;Taip;8;0;0;8
19455;Obelėlė;Gudručiai;9736557012;Taip;10;1;2;13
19456;Obelėlė;Gudručiai;6720058972;Taip;6;2;0;8
19457;Obelėlė;Gudručiai;4451814487;Taip;4;0;0;4
19458;Obelėlė;Gudručiai;2053807216;Taip;18;0;0;18
19459;Obelėlė;Gudručiai;2204293216;Ne;0;0;1;1
19460;Obelėlė;Gudručiai;1184082097;Taip;22;0;0;22
19461;Obelėlė;Gudručiai;2533715287;Taip;0;6;0;6
19462;Obelėlė;Gudručiai;1312484983;Taip;22;0;0;22
19463;Obelėlė;Gudručiai;1565630870;Taip;0;5;0;5
19464;Obelėlė;Gudručiai;1598785483;Taip;10;5;0;15
19465;Obelėlė;Pasakaitė;1695933896;Ne;14;1;3;18
19466;Obelėlė;Pasakaitė;1555780072;Taip;0;0;6;6
19467;Obelėlė;Pasakaitė;77743243622;Taip;0;0;1;1
19468;Obelėlė;Pasakaitė;1543298097;Taip;0;1;3;4
19469;Obelėlė;Pasakaitė;79601449969;Taip;6;0;0;6
19470;Obelėlė;Pasakaitė;3330983614;Taip;0;1;1;2
19471;Obelėlė;Pasakaitė;4257479486;Taip;0;1;4;5
19472;Obelėlė;Pasakaitė;8394566707;Taip;0;1;1;2
19473;Obelėlė;Pasakaitė;9527363918;Taip;0;0;1;1
19474;Obelėlė;Pasakaitė;10939948244;Taip;0;1;0;1
19475;Obelėlė;Pasakaitė;1707652145;Taip;0;1;0;1
19476;Obelėlė;Pasakaitė;1141707374;Taip;0;0;2;2
19477;Obelėlė;Pasakaitė;6789881144;Taip;7;1;0;8
19478;Obelėlė;Pasakaitė;6036130112;Taip;8;0;0;8
19479;Obelėlė;Pasakaitė;1893470952;Taip;4;1;3;8
19480;Obelėlė;Pasakaitė;7754276632;Taip;0;22;0;22
19481;Obelėlė;Pasakaitė;69055416041;Taip;0;1;3;4
19482;Obelėlė;Pasakaitė;3517342646;Taip;0;0;6;6
19483;Obelėlė;Pasakaitė;4220808775;Taip;5;0;0;5
19484;Obelėlė;Pasakaitė;1507072248;Taip;4;1;3;8
19485;Obelėlė;Pasakaitė;7934760271;Taip;0;5;4;9
19486;Obelėlė;Svajokliai;9981446556;Taip;5;0;2;7
19487;Obelėlė;Svajokliai;4849499826;Taip;8;0;0;8
19488;Obelėlė;Svajokliai;1469593267;Taip;7;3;1;11
19489;Obelėlė;Svajokliai;9819048265;Ne;17;0;0;17
19490;Obelėlė;Svajokliai;1010954005;Taip;8;0;6;14
19491;Obelėlė;Svajokliai;4489212434;Taip;4;0;2;6
19492;Obelėlė;Svajokliai;5312394513;Taip;12;0;0;12
19493;Obelėlė;Svajokliai;1705232474;Taip;2;0;1;3
19494;Obelėlė;Svajokliai;5588467580;Taip;18;0;4;22
19495;Obelėlė;Svajokliai;7094715237;Taip;0;0;4;4
19496;Obelėlė;Svajokliai;3986892111;Taip;0;1;0;1
19497;Obelėlė;Svajokliai;7003947655;Taip;0;1;8;9
19498;Obelėlė;Svajokliai;9641297002;Taip;0;1;1;2
19499;Obelėlė;Svajokliai;8918176312;Taip;5;1;1;7
19500;Obelėlė;Svajokliai;8604451971;Taip;0;0;4;4
19501;Obelėlė;Svajokliai;6785654280;Taip;0;0;2;2
19502;Obelėlė;Svajokliai;6311322617;Taip;5;1;0;6
19503;Obelėlė;Svajokliai;2813927086;Taip;0;2;0;2
19504;Obelėlė;Smalsučiai;6497584911;Taip;0;0;1;1
19505;Obelėlė;Smalsučiai;7687093936;Taip;0;1;0;1
19506;Obelėlė;Smalsučiai;1469375976;Taip;0;0;1;1
19507;Obelėlė;Smalsučiai;7108517080;Taip;0;0;1;1
19508;Obelėlė;Smalsučiai;6008839269;Ne;6;3;0;9
19509;Obelėlė;Smalsučiai;6020342761;Taip;8;0;0;8
19510;Obelėlė;Smalsučiai;4987747783;Taip;7;0;1;8
19511;Obelėlė;Smalsučiai;5085970254;Taip;4;1;2;7
19512;Obelėlė;Smalsučiai;8709758561;Taip;8;0;0;8
19513;Obelėlė;Smalsučiai;4318546408;Taip;5;0;0;5
19514;Obelėlė;Smalsučiai;5739522736;Taip;5;0;0;5
19515;Obelėlė;Smalsučiai;2631405243;Taip;11;0;1;12
19516;Obelėlė;Smalsučiai;8173307704;Taip;10;5;2;17
19517;Obelėlė;Smalsučiai;9796759067;Taip;1;8;0;9
19518;Obelėlė;Smalsučiai;6720808705;Taip;0;1;0;1
19519;Obelėlė;Smalsučiai;9084969712;Ne;7;0;0;7
19520;Obelėlė;Smalsučiai;6364101139;Taip;2;1;4;7
19521;Obelėlė;Smalsučiai;6064646690;Taip;0;0;3;3
19522;Obelėlė;Smalsučiai;6691540418;Ne;15;0;0;15
19523;Obelėlė;Smalsučiai;8183287212;Taip;0;1;3;4
19524;Obelėlė;Smalsučiai;2574840626;Taip;12;2;0;14
19525;Obelėlė;Smalsučiai;8981403984;Taip;0;22;0;22
19526;Obelėlė;Pabiručiai;2035035265;Taip;0;0;6;6
19527;Obelėlė;Pabiručiai;5763713052;Ne;0;22;0;22
19528;Obelėlė;Pabiručiai;7667966704;Taip;14;0;0;14
19529;Obelėlė;Pabiručiai;8579887226;Taip;11;0;1;12
19530;Obelėlė;Pabiručiai;8948297718;Taip;12;0;0;12
19531;Obelėlė;Pabiručiai;3951816174;Taip;21;0;0;21
19532;Obelėlė;Pabiručiai;5599466885;Taip;0;0;8;8
19533;Obelėlė;Pabiručiai;9634414572;Ne;5;0;2;7
19534;Obelėlė;Pabiručiai;2262107831;Taip;12;0;0;12
19535;Obelėlė;Pabiručiai;4851824672;Taip;0;0;7;7
19536;Obelėlė;Pabiručiai;3526079444;Ne;16;0;0;16
19537;Obelėlė;Pabiručiai;9731565368;Taip;6;10;0;16
19538;Obelėlė;Pabiručiai;8827515572;Taip;11;0;0;11
19539;Obelėlė;Pabiručiai;2399173200;Taip;1;0;3;4
19540;Obelėlė;Pabiručiai;8443192155;Taip;8;0;0;8
19541;Obelėlė;Pabiručiai;9627134967;Ne;0;1;0;1
19542;Obelėlė;Pabiručiai;5368376431;Ne;6;0;3;9
19543;Obelėlė;Strakaliukai;1706102918;Ne;0;0;7;7
19544;Obelėlė;Strakaliukai;2770477678;Taip;7;3;0;10
19545;Obelėlė;Strakaliukai;8682794598;Taip;0;6;0;6
19546;Obelėlė;Strakaliukai;8754552660;Taip;0;0;3;3
19547;Obelėlė;Strakaliukai;8092024850;Taip;8;0;0;8
19548;Obelėlė;Strakaliukai;9716500560;Ne;9;1;0;10
19549;Obelėlė;Strakaliukai;4251418414;Ne;3;0;1;4
19550;Obelėlė;Strakaliukai;7128421330;Taip;3;3;1;7
19551;Obelėlė;Strakaliukai;5943314566;Taip;18;0;0;18
19552;Obelėlė;Strakaliukai;3116100694;Taip;0;0;5;5
19553;Obelėlė;Strakaliukai;5741823041;Taip;0;0;2;2
19554;Obelėlė;Strakaliukai;8050551266;Taip;0;4;0;4
19555;Obelėlė;Strakaliukai;7468335279;Ne;0;0;7;7
19556;Obelėlė;Strakaliukai;1180508643;Taip;0;5;1;6
19557;Obelėlė;Strakaliukai;7124393375;Taip;3;8;3;14
19558;Obelėlė;Strakaliukai;5001844064;Taip;0;1;3;4
19559;Obelėlė;Strakaliukai;9976694313;Taip;0;0;3;3
19560;Obelėlė;Saulutė;2772753891;Ne;15;0;0;15
19561;Obelėlė;Saulutė;8486560892;Taip;9;2;0;11
19562;Obelėlė;Saulutė;1858251094;Taip;5;0;7;12
19563;Obelėlė;Saulutė;2893378990;Taip;8;0;0;8
19564;Obelėlė;Saulutė;6874039388;Ne;0;0;13;13
19565;Obelėlė;Saulutė;7491934262;Taip;0;8;2;10
19566;Obelėlė;Saulutė;9043542844;Taip;0;0;3;3
19567;Obelėlė;Saulutė;4321210604;Taip;9;0;7;16
19568;Obelėlė;Saulutė;4209489251;Taip;9;0;5;14
19569;Obelėlė;Saulutė;4309622934;Taip;8;0;1;9
19570;Obelėlė;Saulutė;3590915973;Taip;6;0;6;12
19571;Obelėlė;Saulutė;6470533765;Taip;10;3;6;19
19572;Obelėlė;Saulutė;8223715886;Taip;10;3;6;19
19573;Obelėlė;Saulutė;8461505586;Taip;0;0;8;8
19574;Obelėlė;Saulutė;2730569223;Taip;0;0;5;5
19575;Obelėlė;Saulutė;4218895290;Taip;3;0;3;6
19576;Obelėlė;Rieduliukai;9008900055;Taip;22;0;0;22
19577;Obelėlė;Rieduliukai;9332534001;Taip;22;0;0;22
19578;Obelėlė;Rieduliukai;2465101384;Ne;1;0;1;2
19579;Obelėlė;Rieduliukai;7403160073;Taip;4;0;8;12
19580;Obelėlė;Rieduliukai;2663004768;Taip;19;0;0;19
19581;Obelėlė;Rieduliukai;8060994250;Taip;19;0;0;19
19582;Obelėlė;Rieduliukai;1788880520;Taip;24;0;0;24
19583;Obelėlė;Rieduliukai;3452970142;Taip;0;0;1;1
19584;Obelėlė;Rieduliukai;4505857257;Taip;14;0;1;15
19585;Obelėlė;Rieduliukai;4707488292;Taip;16;0;1;17
19586;Obelėlė;Rieduliukai;5617103957;Taip;22;0;0;22
19587;Obelėlė;Rieduliukai;3646359565;Taip;22;0;0;22
19588;Obelėlė;Rieduliukai;5603904852;Taip;0;0;10;10
19589;Obelėlė;Rieduliukai;2031637374;Ne;0;0;1;1
19590;Obelėlė;Rieduliukai;4678269928;Ne;0;0;2;2
19591;Obelėlė;Žirniukai;5209482838;Taip;0;22;0;22
19592;Obelėlė;Žirniukai;8422696011;Taip;12;1;2;15
19593;Obelėlė;Žirniukai;5503843905;Ne;16;1;0;17
19594;Obelėlė;Žirniukai;6133596410;Taip;12;7;0;19
19595;Obelėlė;Žirniukai;2702773541;Taip;9;0;4;13
19596;Obelėlė;Žirniukai;2769784741;Taip;10;0;2;12
19597;Obelėlė;Žirniukai;8982197866;Taip;9;0;3;12
19598;Obelėlė;Žirniukai;1222183008;Taip;10;0;1;11
19599;Obelėlė;Žirniukai;7813350634;Taip;16;0;0;16
19600;Obelėlė;Žirniukai;3568124213;Taip;8;0;2;10
19601;Obelėlė;Žirniukai;5478392319;Taip;7;0;0;7
19602;Obelėlė;Žirniukai;4223995429;Taip;15;1;0;16
19603;Obelėlė;Žirniukai;5073364608;Taip;2;0;0;2
19604;Obelėlė;Žirniukai;3287262204;Taip;14;0;1;15
19605;Obelėlė;Žirniukai;9005520809;Taip;2;0;1;3
19606;Obelėlė;Žirniukai;5192989376;Taip;12;0;4;16
19607;Obelėlė;Žirniukai;1799603610;Taip;0;22;0;22
19608;Obelėlė;Bičiuliai;3425736276;Taip;6;0;0;6
19609;Obelėlė;Bičiuliai;5776116844;Taip;0;6;0;6
19610;Obelėlė;Bičiuliai;8487088625;Taip;8;1;0;9
19611;Obelėlė;Bičiuliai;1537769810;Taip;5;0;1;6
19612;Obelėlė;Bičiuliai;8371648703;Taip;1;0;2;3
19613;Obelėlė;Bičiuliai;1419189517;Taip;3;0;0;3
19614;Obelėlė;Bičiuliai;8155712451;Taip;9;1;0;10
19615;Obelėlė;Bičiuliai;4849175527;Ne;14;0;3;17
19616;Obelėlė;Bičiuliai;1362135757;Taip;9;0;0;9
19617;Obelėlė;Bičiuliai;3769993089;Taip;5;0;0;5
19618;Obelėlė;Bičiuliai;5374979248;Taip;3;0;0;3
19619;Obelėlė;Bičiuliai;2170134084;Taip;0;22;0;22
19620;Obelėlė;Bičiuliai;1909459236;Taip;0;1;0;1
19621;Obelėlė;Bičiuliai;8757731600;Ne;0;22;0;22
19622;Obelėlė;Kodėlčiukai;9960526051;Taip;0;3;2;5
19623;Obelėlė;Kodėlčiukai;1050919659;Ne;0;1;1;2
19624;Obelėlė;Kodėlčiukai;7014872044;Taip;0;0;7;7
19625;Obelėlė;Kodėlčiukai;3028107343;Ne;6;0;2;8
19626;Obelėlė;Kodėlčiukai;4717038536;Taip;5;0;0;5
19627;Obelėlė;Kodėlčiukai;4840134079;Taip;0;0;1;1
19628;Obelėlė;Kodėlčiukai;8762518354;Taip;3;0;0;3
19629;Obelėlė;Kodėlčiukai;3320493372;Taip;21;0;1;22
19630;Obelėlė;Kodėlčiukai;8366162313;Taip;0;1;0;1
19631;Obelėlė;Kodėlčiukai;7901070568;Ne;3;0;1;4
19632;Obelėlė;Kodėlčiukai;6481365666;Taip;2;0;0;2
19633;Obelėlė;Kodėlčiukai;8818153952;Taip;5;0;0;5
19634;Obelėlė;Kodėlčiukai;4887103549;Ne;5;0;0;5
19635;Obelėlė;Kodėlčiukai;5221918341;Ne;9;0;4;13
19636;Obelėlė;Kodėlčiukai;3748406335;Taip;0;0;1;1
19637;Obelėlė;Kodėlčiukai;7422668691;Ne;9;0;1;10
19638;Obelėlė;Kodėlčiukai;5233321854;Ne;0;3;5;8
19639;Obelėlė;Kodėlčiukai;1472630240;Taip;11;0;7;18
19640;Obelėlė;Pagrandukai;7934967787;Taip;13;0;0;13
19641;Obelėlė;Pagrandukai;4673426170;Taip;14;0;1;15
19642;Obelėlė;Pagrandukai;6436061438;Ne;15;0;0;15
19643;Obelėlė;Pagrandukai;8711370875;Taip;5;0;2;7
19644;Obelėlė;Pagrandukai;6938326798;Taip;0;22;0;22
19645;Obelėlė;Pagrandukai;9258651395;Ne;9;0;0;9
19646;Obelėlė;Pagrandukai;4974008654;Taip;0;22;0;22
19647;Obelėlė;Pagrandukai;3563701047;Taip;10;0;0;10
19648;Obelėlė;Pagrandukai;8664564820;Ne;14;0;1;15
19649;Obelėlė;Pagrandukai;9170515841;Taip;2;22;0;24
19650;Obelėlė;Pagrandukai;9514739912;Taip;7;0;3;10
19651;Obelėlė;Pagrandukai;8534759650;Ne;14;0;0;14
19652;Obelėlė;Pagrandukai;7368698046;Taip;4;0;7;11
19653;Obelėlė;Pagrandukai;3738932600;Taip;10;0;3;13
19654;Spygliukas;Bitutės;8272537768;Ne;9;0;0;9
19655;Spygliukas;Bitutės;8404929784;Taip;0;1;2;3
19656;Spygliukas;Bitutės;4835818382;Taip;0;2;0;2
19657;Spygliukas;Bitutės;3041184642;Taip;4;2;1;7
19658;Spygliukas;Bitutės;9070219319;Taip;0;1;0;1
19659;Spygliukas;Bitutės;9413950200;Taip;5;3;1;9
19660;Spygliukas;Bitutės;1664878188;Taip;0;1;2;3
19661;Spygliukas;Bitutės;5134327772;Taip;0;9;0;9
19662;Spygliukas;Bitutės;8869320003;Taip;0;1;0;1
19663;Spygliukas;Bitutės;8476882854;Taip;17;6;0;23
19664;Spygliukas;Bitutės;1333556956;Ne;0;0;1;1
19665;Spygliukas;Bitutės;3761715811;Taip;0;7;0;7
19666;Spygliukas;Bitutės;8270525839;Taip;5;4;0;9
19667;Spygliukas;Bitutės;3697691132;Taip;22;0;0;22
19668;Spygliukas;Bitutės;1550737449;Taip;10;1;0;11
19669;Spygliukas;Bitutės;5180736358;Taip;0;0;4;4
19670;Spygliukas;Bitutės;9431217584;Taip;2;3;5;10
19671;Spygliukas;Kiškučiai;1927028026;Taip;1;0;0;1
19672;Spygliukas;Kiškučiai;3094528907;Taip;0;2;3;5
19673;Spygliukas;Kiškučiai;9813995933;Ne;0;11;2;13
19674;Spygliukas;Kiškučiai;4013601534;Taip;12;0;0;12
19675;Spygliukas;Kiškučiai;3959136555;Taip;0;9;0;9
19676;Spygliukas;Kiškučiai;6383264068;Taip;8;0;0;8
19677;Spygliukas;Kiškučiai;6246925536;Ne;6;0;0;6
19678;Spygliukas;Kiškučiai;1037321774;Taip;0;3;3;6
19679;Spygliukas;Kiškučiai;5615854225;Taip;0;7;0;7
19680;Spygliukas;Kiškučiai;7261580644;Taip;0;10;0;10
19681;Spygliukas;Kiškučiai;7243104877;Taip;8;1;0;9
19682;Spygliukas;Kiškučiai;1436452804;Taip;5;7;3;15
19683;Spygliukas;Kiškučiai;1330384915;Taip;18;0;0;18
19684;Spygliukas;Kiškučiai;8299276429;Ne;12;2;0;14
19685;Spygliukas;Boružėlės;3569857813;Taip;0;0;6;6
19686;Spygliukas;Boružėlės;6931145017;Taip;6;0;0;6
19687;Spygliukas;Boružėlės;8802722601;Taip;0;3;0;3
19688;Spygliukas;Boružėlės;9285259322;Taip;0;1;0;1
19689;Spygliukas;Boružėlės;1341333016;Taip;22;0;0;22
19690;Spygliukas;Boružėlės;8806126755;Ne;6;1;0;7
19691;Spygliukas;Boružėlės;4477402331;Taip;16;0;0;16
19692;Spygliukas;Boružėlės;2772801133;Taip;5;1;1;7
19693;Spygliukas;Boružėlės;6332646009;Taip;7;1;0;8
19694;Spygliukas;Boružėlės;3706443395;Taip;0;1;0;1
19695;Spygliukas;Boružėlės;5765106914;Taip;10;2;0;12
19696;Spygliukas;Boružėlės;3416275094;Taip;8;0;1;9
19697;Spygliukas;Boružėlės;1401951658;Taip;0;4;1;5
19698;Spygliukas;Boružėlės;6248409896;Ne;0;2;1;3
19699;Spygliukas;Boružėlės;8708083787;Taip;0;10;0;10
19700;Spygliukas;Boružėlės;8825264090;Ne;0;0;6;6
19701;Spygliukas;Boružėlės;3919560072;Taip;5;0;0;5
19702;Spygliukas;Boružėlės;4577592862;Taip;0;3;0;3
19703;Spygliukas;Boružėlės;6835488489;Taip;0;2;3;5
19704;Spygliukas;Boružėlės;7900652746;Taip;0;3;0;3
19705;Spygliukas;Ežiukai;2164549239;Taip;0;0;4;4
19706;Spygliukas;Ežiukai;4340767624;Ne;0;0;2;2
19707;Spygliukas;Ežiukai;1983112873;Taip;3;1;2;6
19708;Spygliukas;Ežiukai;4615217628;Taip;8;0;0;8
19709;Spygliukas;Ežiukai;2184487073;Taip;0;10;0;10
19710;Spygliukas;Ežiukai;5612894706;Taip;0;1;0;1
19711;Spygliukas;Ežiukai;6552944183;Ne;13;0;0;13
19712;Spygliukas;Ežiukai;1353217998;Ne;7;0;0;7
19713;Spygliukas;Ežiukai;6459076295;Taip;5;0;0;5
19714;Spygliukas;Ežiukai;7749937772;Taip;13;9;11;33
19715;Spygliukas;Ežiukai;5160835235;Taip;2;0;5;7
19716;Spygliukas;Ežiukai;2719100414;Taip;10;3;0;13
19717;Spygliukas;Ežiukai;1429613380;Taip;0;0;1;1
19718;Spygliukas;Ežiukai;4026252608;Taip;10;3;0;13
19719;Spygliukas;Ežiukai;4098112375;Taip;10;0;4;14
19720;Spygliukas;Ežiukai;9321493897;Ne;5;0;0;5
19721;Spygliukas;Ežiukai;7908419787;Ne;0;0;8;8
19722;Spygliukas;Ežiukai;5366783639;Taip;0;1;0;1
19723;Spygliukas;Ežiukai;3088387895;Taip;0;0;8;8
19724;Spygliukas;Ežiukai;7287543571;Taip;14;0;2;16
19725;Spygliukas;Geniukai;8821434815;Taip;6;0;0;6
19726;Spygliukas;Geniukai;2713999021;Taip;10;0;0;10
19727;Spygliukas;Geniukai;5782501698;Taip;15;0;0;15
19728;Spygliukas;Geniukai;6700076900;Taip;14;0;1;15
19729;Spygliukas;Geniukai;8338260940;Taip;5;3;0;8
19730;Spygliukas;Geniukai;1863442354;Taip;5;1;0;6
19731;Spygliukas;Geniukai;9945315122;Taip;13;1;0;14
19732;Spygliukas;Geniukai;1291429206;Taip;5;4;0;9
19733;Spygliukas;Geniukai;7477731865;Taip;4;0;5;9
19734;Spygliukas;Geniukai;7561072315;Taip;0;0;7;7
19735;Spygliukas;Geniukai;2950722789;Ne;8;0;0;8
19736;Spygliukas;Geniukai;8093949301;Taip;9;0;0;9
19737;Spygliukas;Geniukai;9141146733;Taip;7;0;0;7
19738;Spygliukas;Geniukai;6363991196;Taip;0;1;0;1
19739;Spygliukas;Geniukai;8308394841;Taip;6;3;0;9
19740;Spygliukas;Geniukai;1127941700;Ne;0;4;0;4
19741;Spygliukas;Geniukai;8581453160;Taip;4;0;1;5
19742;Spygliukas;Geniukai;7573756485;Taip;4;0;0;4
19743;Spygliukas;Geniukai;9770852356;Taip;7;0;5;12
19744;Spygliukas;Geniukai;1283097421;Taip;18;0;2;20
19745;Spygliukas;Riešutėliai;29449834997;Taip;8;1;2;11
19746;Spygliukas;Riešutėliai;47977103711;Taip;0;1;0;1
19747;Spygliukas;Riešutėliai;1855897974;Taip;8;1;2;11
19748;Spygliukas;Riešutėliai;1940209166;Taip;5;3;0;8
19749;Spygliukas;Riešutėliai;8992822256;Taip;6;9;0;15
19750;Spygliukas;Riešutėliai;1238940921;Taip;6;0;0;6
19751;Spygliukas;Riešutėliai;4933577424;Taip;5;0;0;5
19752;Spygliukas;Riešutėliai;9797138740;Taip;0;1;12;13
19753;Spygliukas;Riešutėliai;9001243644;Taip;10;2;4;16
19754;Spygliukas;Riešutėliai;1679263120;Taip;5;0;0;5
19755;Spygliukas;Riešutėliai;7250958367;Taip;6;1;0;7
19756;Spygliukas;Riešutėliai;9975117461;Taip;0;1;3;4
19757;Spygliukas;Riešutėliai;5022615426;Ne;7;1;1;9
19758;Spygliukas;Riešutėliai;7114613140;Taip;7;0;0;7
19759;Spygliukas;Riešutėliai;4430242310;Taip;7;0;0;7
19760;Spygliukas;Riešutėliai;8103481313;Taip;0;1;0;1
19761;Spygliukas;Riešutėliai;7421000718;Taip;6;1;1;8
19762;Spygliukas;Riešutėliai;2980459339;Taip;0;1;0;1
19763;Spygliukas;Riešutėliai;5827455834;Taip;9;0;0;9
19764;Spygliukas;Riešutėliai;4653108810;Taip;0;1;0;1
19765;Spygliukas;Riešutėliai;16828631895;Taip;6;0;0;6
19766;Spygliukas;Pelėdžiukai;1260920726;Taip;21;1;0;22
19767;Spygliukas;Pelėdžiukai;4355472423;Ne;0;1;2;3
19768;Spygliukas;Pelėdžiukai;6242194100;Taip;5;0;1;6
19769;Spygliukas;Pelėdžiukai;8048474808;Ne;5;1;2;8
19770;Spygliukas;Pelėdžiukai;5778081118;Taip;17;0;0;17
19771;Spygliukas;Pelėdžiukai;4721066953;Taip;0;3;1;4
19772;Spygliukas;Pelėdžiukai;8331205164;Taip;11;1;3;15
19773;Spygliukas;Pelėdžiukai;4949371837;Taip;0;6;0;6
19774;Spygliukas;Pelėdžiukai;4650693672;Taip;0;0;1;1
19775;Spygliukas;Pelėdžiukai;3658613027;Ne;3;0;1;4
19776;Spygliukas;Pelėdžiukai;1662885055;Ne;22;0;0;22
19777;Spygliukas;Pelėdžiukai;50047868918;Taip;0;1;4;5
19778;Spygliukas;Pelėdžiukai;3365209400;Taip;0;3;3;6
19779;Spygliukas;Pelėdžiukai;6457632191;Taip;14;0;0;14
19780;Spygliukas;Pelėdžiukai;9178184431;Taip;11;0;3;14
19781;Spygliukas;Pelėdžiukai;5962360012;Taip;2;1;0;3
19782;Spygliukas;Pelėdžiukai;2739564216;Taip;5;1;5;11
19783;Spygliukas;Pelėdžiukai;4610504338;Taip;2;0;0;2
19784;Spygliukas;Pelėdžiukai;89044575245;Taip;8;2;0;10
19785;Spygliukas;Zylutės;9465470810;Ne;26;0;0;26
19786;Spygliukas;Zylutės;8366571422;Taip;4;0;0;4
19787;Spygliukas;Zylutės;4417471958;Taip;8;6;0;14
19788;Spygliukas;Zylutės;3811864870;Taip;0;0;3;3
19789;Spygliukas;Zylutės;4177369871;Taip;13;1;0;14
19790;Spygliukas;Zylutės;8105507156;Taip;16;2;0;18
19791;Spygliukas;Zylutės;6858338620;Taip;3;7;5;15
19792;Spygliukas;Zylutės;9601530981;Taip;9;0;2;11
19793;Spygliukas;Zylutės;3066293772;Ne;13;0;0;13
19794;Spygliukas;Zylutės;3268222954;Taip;11;0;0;11
19795;Spygliukas;Zylutės;5006372835;Taip;5;0;0;5
19796;Spygliukas;Zylutės;1729199382;Ne;10;0;2;12
19797;Spygliukas;Zylutės;8408234202;Taip;10;0;2;12
19798;Spygliukas;Zylutės;3317395260;Taip;9;0;2;11
19799;Spygliukas;Zylutės;6343141973;Taip;3;0;4;7
19800;Spygliukas;Zylutės;2632672131;Taip;7;0;0;7
19801;Spygliukas;Zylutės;5638595939;Taip;16;0;0;16
19802;Spygliukas;Skruzdėliukai;8509447147;Taip;8;0;0;8
19803;Spygliukas;Skruzdėliukai;5739075961;Taip;22;0;0;22
19804;Spygliukas;Skruzdėliukai;7324915516;Taip;22;0;0;22
19805;Spygliukas;Skruzdėliukai;6414439254;Taip;22;0;0;22
19806;Spygliukas;Skruzdėliukai;7663839690;Taip;4;0;0;4
19807;Spygliukas;Skruzdėliukai;2738766977;Taip;3;0;0;3
19808;Spygliukas;Skruzdėliukai;8426426785;Taip;0;2;0;2
19809;Spygliukas;Skruzdėliukai;6680699873;Taip;8;0;5;13
19810;Spygliukas;Skruzdėliukai;2955219028;Ne;14;0;0;14
19811;Spygliukas;Skruzdėliukai;1823720183;Taip;17;4;0;21
19812;Spygliukas;Skruzdėliukai;8565217488;Taip;5;0;5;10
19813;Spygliukas;Skruzdėliukai;2367685286;Taip;9;0;13;22
19814;Spygliukas;Skruzdėliukai;3065727701;Ne;18;0;0;18
19815;Spygliukas;Skruzdėliukai;1775612723;Taip;16;3;0;19
19816;Spygliukas;Voveraitės;9112172144;Taip;0;1;8;9
19817;Spygliukas;Voveraitės;7897603878;Taip;0;5;0;5
19818;Spygliukas;Voveraitės;7741841634;Taip;0;7;0;7
19819;Spygliukas;Voveraitės;3077468722;Taip;4;1;2;7
19820;Spygliukas;Voveraitės;4948147941;Taip;4;0;2;6
19821;Spygliukas;Voveraitės;2272141731;Taip;0;0;1;1
19822;Spygliukas;Voveraitės;6758336405;Ne;0;0;3;3
19823;Spygliukas;Voveraitės;3668191959;Taip;0;6;0;6
19824;Spygliukas;Voveraitės;1426267001;Taip;1;1;2;4
19825;Spygliukas;Voveraitės;8189748611;Taip;13;0;0;13
19826;Spygliukas;Voveraitės;8877911083;Taip;4;2;0;6
19827;Spygliukas;Voveraitės;6405496193;Taip;4;3;1;8
19828;Spygliukas;Voveraitės;7113913750;Ne;0;1;0;1
19829;Spygliukas;Voveraitės;9231097598;Taip;5;1;2;8
19830;Spygliukas;Voveraitės;4681061579;Taip;0;1;4;5
19831;Spygliukas;Voveraitės;7313828707;Taip;8;0;0;8
19832;Spygliukas;Voveraitės;1234195733;Taip;0;3;0;3
19833;Spygliukas;Voveraitės;4508351101;Taip;0;3;0;3
19834;Spygliukas;Giliukų;6015646417;Taip;0;22;0;22
19835;Spygliukas;Giliukų;1761340174;Taip;8;0;3;11
19836;Spygliukas;Giliukų;4854168938;Ne;0;0;5;5
19837;Spygliukas;Giliukų;7522567241;Taip;0;7;2;9
19838;Spygliukas;Giliukų;7460280684;Taip;9;0;3;12
19839;Spygliukas;Giliukų;4429961491;Taip;23;0;0;23
19840;Spygliukas;Giliukų;8821028259;Taip;10;4;0;14
19841;Spygliukas;Giliukų;6485350404;Taip;0;22;0;22
19842;Spygliukas;Giliukų;3237501537;Taip;0;8;5;13
19843;Spygliukas;Giliukų;8722863277;Taip;0;8;1;9
19844;Spygliukas;Giliukų;9025238241;Taip;0;3;0;3
19845;Spygliukas;Giliukų;3603606800;Taip;0;22;0;22
19846;Spygliukas;Giliukų;6290439938;Taip;9;0;4;13
19847;Spygliukas;Giliukų;3777763305;Taip;9;0;0;9
19848;Spygliukas;Giliukų;4626877679;Taip;4;3;5;12
19849;Spygliukas;Giliukų;5255993275;Ne;12;0;1;13
19850;Spygliukas;Drugeliai;7271659513;Taip;0;6;0;6
19851;Spygliukas;Drugeliai;8604767396;Ne;0;0;3;3
19852;Spygliukas;Drugeliai;4634660174;Taip;25;0;1;26
19853;Spygliukas;Drugeliai;7924880159;Taip;3;3;0;6
19854;Spygliukas;Drugeliai;4368224847;Ne;14;5;2;21
19855;Spygliukas;Drugeliai;9316731983;Taip;0;0;9;9
19856;Spygliukas;Drugeliai;6630979640;Ne;1;1;0;2
19857;Spygliukas;Drugeliai;2315421636;Taip;0;1;3;4
19858;Spygliukas;Drugeliai;7125425492;Taip;11;1;0;12
19859;Spygliukas;Drugeliai;9052337501;Taip;5;1;8;14
19860;Spygliukas;Drugeliai;1974541155;Taip;0;1;2;3
19861;Spygliukas;Drugeliai;4505044604;Taip;4;6;0;10
19862;Spygliukas;Drugeliai;2989701249;Taip;10;0;0;10
19863;Spygliukas;Drugeliai;9086986643;Taip;0;2;1;3
19864;Spygliukas;Drugeliai;8646122773;Taip;0;2;1;3
19865;Vieversys;Žirniukai;5365334453;Taip;0;13;0;13
19866;Vieversys;Žirniukai;7029322013;Ne;12;1;0;13
19867;Vieversys;Žirniukai;2266222087;Taip;7;0;1;8
19868;Vieversys;Žirniukai;2869545222;Taip;22;0;0;22
19869;Vieversys;Žirniukai;7601876587;Taip;3;0;0;3
19870;Vieversys;Žirniukai;2024837493;Taip;3;0;5;8
19871;Vieversys;Žirniukai;8129566710;Taip;4;3;3;10
19872;Vieversys;Žirniukai;5576923685;Taip;1;0;0;1
19873;Vieversys;Žirniukai;6052943894;Taip;1;0;10;11
19874;Vieversys;Žirniukai;3295424711;Taip;2;0;1;3
19875;Vieversys;Žirniukai;7309040730;Taip;3;0;0;3
19876;Vieversys;Žirniukai;3575906273;Taip;4;0;0;4
19877;Vieversys;Žirniukai;9856798869;Taip;0;22;0;22
19878;Vieversys;Žirniukai;1724543625;Taip;12;0;2;14
19879;Vieversys;Žirniukai;6530685517;Taip;0;1;0;1
19880;Vieversys;Žirniukai;3533711179;Taip;5;4;0;9
19881;Vieversys;Žirniukai;2242368843;Taip;9;0;0;9
19882;Vieversys;Varpelių;5150986489;Taip;3;0;5;8
19883;Vieversys;Varpelių;9463693741;Taip;0;0;4;4
19884;Vieversys;Varpelių;1924774817;Taip;5;1;0;6
19885;Vieversys;Varpelių;3595005599;Taip;10;0;10;20
19886;Vieversys;Varpelių;9155896981;Taip;0;5;0;5
19887;Vieversys;Varpelių;5160814541;Taip;4;0;0;4
19888;Vieversys;Varpelių;9580031042;Taip;16;3;0;19
19889;Vieversys;Varpelių;2635722489;Taip;0;3;3;6
19890;Vieversys;Varpelių;3262738994;Taip;0;1;0;1
19891;Vieversys;Varpelių;2805682329;Taip;12;1;0;13
19892;Vieversys;Varpelių;2956566201;Taip;0;5;1;6
19893;Vieversys;Varpelių;1727558984;Taip;0;0;8;8
19894;Vieversys;Varpelių;3297728501;Taip;3;2;0;5
19895;Vieversys;Varpelių;3780226431;Taip;2;0;7;9
19896;Vieversys;Varpelių;3572628491;Taip;4;0;0;4
19897;Vieversys;Varpelių;7611047781;Taip;5;2;0;7
19898;Vieversys;Kiškučių;5922485482;Taip;7;2;0;9
19899;Vieversys;Kiškučių;3917758713;Taip;0;3;3;6
19900;Vieversys;Kiškučių;9387421639;Taip;10;1;1;12
19901;Vieversys;Kiškučių;2383765752;Taip;5;1;0;6
19902;Vieversys;Kiškučių;1247565595;Taip;0;18;0;18
19903;Vieversys;Kiškučių;7812227428;Taip;4;0;0;4
19904;Vieversys;Kiškučių;53977164888;Taip;9;1;0;10
19905;Vieversys;Kiškučių;5810605263;Taip;0;1;5;6
19906;Vieversys;Kiškučių;3205204176;Taip;4;1;1;6
19907;Vieversys;Kiškučių;6787960120;Ne;9;2;0;11
19908;Vieversys;Kiškučių;9612415733;Taip;0;3;1;4
19909;Vieversys;Kiškučių;1728554204;Taip;3;2;1;6
19910;Vieversys;Kiškučių;5286521728;Ne;7;1;3;11
19911;Vieversys;Kiškučių;1149316471;Taip;0;14;0;14
19912;Vieversys;Kiškučių;7500147648;Taip;3;2;0;5
19913;Vieversys;Kiškučių;95891054066;Ne;2;0;0;2
19914;Vieversys;Kiškučių;4313822180;Taip;0;2;0;2
19915;Vieversys;Kiškučių;8038341998;Ne;4;5;0;9
19916;Vieversys;Kiškučių;5917328379;Taip;0;3;0;3
19917;Vieversys;Kiškučių;6720355390;Ne;8;1;8;17
19918;Vieversys;Kiškučių;1933907389;Taip;4;3;0;7
19919;Vieversys;Pelėdžiukų;77272293257;Taip;11;1;2;14
19920;Vieversys;Pelėdžiukų;94463134058;Taip;0;1;6;7
19921;Vieversys;Pelėdžiukų;7578552471;Taip;7;0;0;7
19922;Vieversys;Pelėdžiukų;2193074123;Taip;3;1;4;8
19923;Vieversys;Pelėdžiukų;9499315463;Taip;4;1;0;5
19924;Vieversys;Pelėdžiukų;9774365819;Taip;0;3;0;3
19925;Vieversys;Pelėdžiukų;2521488728;Taip;0;3;3;6
19926;Vieversys;Pelėdžiukų;6473759470;Taip;3;3;0;6
19927;Vieversys;Pelėdžiukų;1273951001;Taip;3;1;0;4
19928;Vieversys;Pelėdžiukų;48430863473;Taip;0;0;1;1
19929;Vieversys;Pelėdžiukų;50181034746;Taip;2;0;0;2
19930;Vieversys;Pelėdžiukų;5871715452;Taip;0;0;2;2
19931;Vieversys;Pelėdžiukų;9659337657;Taip;0;1;0;1
19932;Vieversys;Pelėdžiukų;3458399180;Taip;5;4;0;9
19933;Vieversys;Pelėdžiukų;1361156816;Taip;0;2;0;2
19934;Vieversys;Pelėdžiukų;4216521988;Taip;0;22;0;22
19935;Vieversys;Pelėdžiukų;3755410640;Taip;0;6;0;6
19936;Vieversys;Pelėdžiukų;1322495361;Taip;0;1;2;3
19937;Vieversys;Saulučių;3164280186;Taip;4;0;3;7
19938;Vieversys;Saulučių;3405502715;Taip;3;1;0;4
19939;Vieversys;Saulučių;6127272124;Taip;1;0;1;2
19940;Vieversys;Saulučių;4892622551;Taip;0;0;1;1
19941;Vieversys;Saulučių;5654533451;Taip;0;3;0;3
19942;Vieversys;Saulučių;9972526744;Taip;2;0;3;5
19943;Vieversys;Saulučių;9985374057;Taip;22;0;0;22
19944;Vieversys;Saulučių;9308040716;Taip;0;4;0;4
19945;Vieversys;Saulučių;4741252829;Taip;0;4;0;4
19946;Vieversys;Saulučių;2140887757;Taip;0;0;4;4
19947;Vieversys;Saulučių;1748006118;Taip;0;0;1;1
19948;Vieversys;Saulučių;4690095102;Taip;0;1;0;1
19949;Vieversys;Saulučių;7048475906;Taip;14;0;3;17
19950;Vieversys;Saulučių;4072323869;Taip;0;0;1;1
19951;Vieversys;Saulučių;2663322242;Ne;3;0;0;3
19952;Vieversys;Saulučių;7596355010;Taip;15;0;0;15
19953;Vieversys;Saulučių;3360981720;Taip;9;0;3;12
19954;Vieversys;Saulučių;9322322737;Taip;15;3;0;18
19955;Vieversys;Kregždučių;3156245273;Taip;5;5;0;10
19956;Vieversys;Kregždučių;5645852451;Taip;0;0;4;4
19957;Vieversys;Kregždučių;9088171869;Taip;3;3;3;9
19958;Vieversys;Kregždučių;7998100115;Taip;0;2;2;4
19959;Vieversys;Kregždučių;9093088054;Taip;8;1;0;9
19960;Vieversys;Kregždučių;4870401841;Taip;4;0;1;5
19961;Vieversys;Kregždučių;2849852593;Taip;0;0;3;3
19962;Vieversys;Kregždučių;6808541662;Taip;6;2;0;8
19963;Vieversys;Kregždučių;2529690060;Taip;0;1;0;1
19964;Vieversys;Kregždučių;2230503026;Taip;5;2;0;7
19965;Vieversys;Kregždučių;6157594693;Taip;4;5;0;9
19966;Vieversys;Kregždučių;1322953831;Taip;3;0;0;3
19967;Vieversys;Kregždučių;9090281352;Taip;14;0;1;15
19968;Vieversys;Kregždučių;4308330177;Ne;4;1;1;6
19969;Vieversys;Kregždučių;3122763958;Taip;8;0;5;13
19970;Vieversys;Kregždučių;2938302462;Taip;3;0;0;3
19971;Vieversys;Kregždučių;9577869269;Taip;4;0;1;5
19972;Vieversys;Boružėlių;6838828193;Taip;0;0;2;2
19973;Vieversys;Boružėlių;5683183310;Taip;3;4;0;7
19974;Vieversys;Boružėlių;9884517851;Taip;0;2;0;2
19975;Vieversys;Boružėlių;4565799599;Taip;0;3;0;3
19976;Vieversys;Boružėlių;7399326463;Taip;10;0;0;10
19977;Vieversys;Boružėlių;4088189914;Taip;0;2;0;2
19978;Vieversys;Boružėlių;7364582681;Taip;0;2;0;2
19979;Vieversys;Boružėlių;8084767846;Taip;0;0;2;2
19980;Vieversys;Boružėlių;9826657384;Taip;10;0;4;14
19981;Vieversys;Boružėlių;3731412573;Taip;3;0;0;3
19982;Vieversys;Boružėlių;9255292099;Ne;0;4;0;4
19983;Vieversys;Boružėlių;7429565381;Taip;15;3;1;19
19984;Vieversys;Boružėlių;4297477514;Taip;12;0;10;22
19985;Vieversys;Boružėlių;8816714193;Taip;4;0;0;4
19986;Vieversys;Boružėlių;6148482625;Taip;0;0;3;3
19987;Vieversys;Boružėlių;2701284187;Taip;0;6;0;6
19988;Vieversys;Boružėlių;9911792407;Ne;15;0;1;16
19989;Vieversys;Boružėlių;6234199996;Taip;10;0;1;11
19990;Vieversys;Bitučių;9268459013;Taip;0;4;0;4
19991;Vieversys;Bitučių;8706336322;Taip;0;0;2;2
19992;Vieversys;Bitučių;5966170543;Taip;4;1;0;5
19993;Vieversys;Bitučių;5210732072;Taip;7;0;0;7
19994;Vieversys;Bitučių;2072413459;Taip;3;0;0;3
19995;Vieversys;Bitučių;9454017990;Taip;22;0;0;22
19996;Vieversys;Bitučių;9476611261;Taip;8;14;0;22
19997;Vieversys;Bitučių;6083402842;Taip;10;3;1;14
19998;Vieversys;Bitučių;4428101863;Taip;4;1;0;5
19999;Vieversys;Bitučių;6839896363;Taip;0;0;1;1
20000;Vieversys;Bitučių;9978867863;Taip;3;0;6;9
20001;Vieversys;Bitučių;9092693925;Taip;3;0;0;3
20002;Vieversys;Bitučių;2661027772;Taip;1;1;0;2
20003;Vieversys;Bitučių;3601928285;Ne;6;0;0;6
20004;Vieversys;Bitučių;8492908398;Taip;7;0;0;7
20005;Vieversys;Bitučių;5479620291;Ne;0;22;0;22
20006;Vieversys;Bitučių;2931875387;Ne;7;0;0;7
20007;Vieversys;Bitučių;5417413393;Taip;2;3;0;5
20008;Vieversys;Smalsučių;3681120339;Taip;0;0;18;18
20009;Vieversys;Smalsučių;9164615794;Taip;0;3;0;3
20010;Vieversys;Smalsučių;6563139211;Taip;2;2;1;5
20011;Vieversys;Smalsučių;4294676988;Taip;0;7;2;9
20012;Vieversys;Smalsučių;4835022593;Taip;12;0;0;12
20013;Vieversys;Smalsučių;3249717073;Taip;1;13;0;14
20014;Vieversys;Smalsučių;7120329258;Taip;0;3;0;3
20015;Vieversys;Smalsučių;8174124875;Taip;5;4;0;9
20016;Vieversys;Smalsučių;5769453869;Taip;7;4;0;11
20017;Vieversys;Smalsučių;5907903394;Taip;0;1;0;1
20018;Vieversys;Smalsučių;3946609345;Taip;4;0;2;6
20019;Vieversys;Smalsučių;9686787125;Ne;0;1;0;1
20020;Vieversys;Smalsučių;4455039401;Taip;9;0;0;9
20021;Vieversys;Smalsučių;9835682858;Taip;0;16;1;17
20022;Vieversys;Smalsučių;7007620994;Taip;0;0;4;4
20023;Vieversys;Smalsučių;9494957750;Taip;4;1;1;6
20024;Vieversys;Smalsučių;1757028935;Taip;11;1;0;12
20025;Vieversys;Smalsučių;4488027554;Taip;10;1;0;11
20026;Vieversys;Kodėlčiukų;9217208794;Taip;0;22;0;22
20027;Vieversys;Kodėlčiukų;5037806018;Taip;4;0;0;4
20028;Vieversys;Kodėlčiukų;1752359969;Taip;0;3;0;3
20029;Vieversys;Kodėlčiukų;6791121542;Taip;23;0;0;23
20030;Vieversys;Kodėlčiukų;5912306325;Taip;0;11;0;11
20031;Vieversys;Kodėlčiukų;5898422871;Taip;6;6;0;12
20032;Vieversys;Kodėlčiukų;6709556873;Taip;0;0;2;2
20033;Vieversys;Kodėlčiukų;4193031329;Ne;0;0;1;1
20034;Vieversys;Kodėlčiukų;7453156612;Taip;7;0;0;7
20035;Vieversys;Kodėlčiukų;6926960486;Taip;0;1;1;2
20036;Vieversys;Kodėlčiukų;3180687885;Taip;8;1;5;14
20037;Vieversys;Kodėlčiukų;1881076551;Taip;7;1;0;8
20038;Vieversys;Kodėlčiukų;1384388802;Taip;17;0;0;17
20039;Vieversys;Kodėlčiukų;2562413607;Ne;3;0;0;3
20040;Vieversys;Kodėlčiukų;9965162863;Taip;2;5;0;7
20041;Vieversys;Kodėlčiukų;4702339508;Taip;8;0;5;13
20042;Vieversys;Kodėlčiukų;4631238425;Taip;13;4;0;17
20043;Vieversys;Kodėlčiukų;8512643926;Taip;11;0;2;13
20044;Vieversys;Kodėlčiukų;7967372524;Ne;17;0;2;19
20045;Vieversys;Kodėlčiukų;4703696958;Taip;8;0;0;8
20046;Vieversys;NYKŠTUKAI;3332069842;Taip;0;2;5;7
20047;Vieversys;NYKŠTUKAI;2107000312;Taip;3;3;0;6
20048;Vieversys;NYKŠTUKAI;7539934804;Taip;7;0;0;7
20049;Vieversys;NYKŠTUKAI;1714096583;Taip;13;0;0;13
20050;Vieversys;NYKŠTUKAI;8371839883;Taip;12;0;0;12
20051;Vieversys;NYKŠTUKAI;6474334564;Taip;5;0;0;5
20052;Vieversys;NYKŠTUKAI;6631296204;Taip;7;0;0;7
20053;Vieversys;NYKŠTUKAI;2092872414;Taip;2;0;0;2
20054;Vieversys;NYKŠTUKAI;5394635510;Taip;7;0;0;7
20055;Vieversys;NYKŠTUKAI;1160455554;Taip;10;0;1;11
20056;Vieversys;NYKŠTUKAI;8200432952;Taip;13;0;0;13
20057;Vieversys;NYKŠTUKAI;2535992834;Taip;7;0;0;7
20058;Vieversys;NYKŠTUKAI;4974924858;Taip;7;1;2;10
20059;Vieversys;NYKŠTUKAI;4087823915;Taip;15;0;0;15
20060;Vieversys;NYKŠTUKAI;7111551694;Ne;10;0;0;10
20061;Vieversys;DRUGELIAI;2638813853;Taip;0;0;8;8
20062;Vieversys;DRUGELIAI;9412299328;Taip;19;0;0;19
20063;Vieversys;DRUGELIAI;7508850558;Taip;10;0;1;11
20064;Vieversys;DRUGELIAI;1552959751;Taip;5;0;0;5
20065;Vieversys;DRUGELIAI;6669012722;Taip;16;0;0;16
20066;Vieversys;DRUGELIAI;5384977888;Taip;19;0;0;19
20067;Vieversys;DRUGELIAI;6000875464;Taip;3;1;0;4
20068;Vieversys;DRUGELIAI;9813883328;Taip;4;0;1;5
20069;Vieversys;DRUGELIAI;7708807923;Taip;17;0;3;20
20070;Vieversys;DRUGELIAI;5580265718;Ne;14;0;7;21
20071;Vieversys;DRUGELIAI;4129333932;Taip;0;0;22;22
20072;Vieversys;DRUGELIAI;8199984460;Taip;0;0;8;8
20073;Vieversys;DRUGELIAI;6581002790;Taip;4;5;1;10
20074;Vieversys;DRUGELIAI;9666764935;Taip;18;0;0;18
20075;Vieversys;DRUGELIAI;8966020793;Taip;17;0;0;17
20076;Vieversys;DRUGELIAI;5164567779;Taip;1;2;1;4
20077;Vieversys;DRUGELIAI;1720061988;Taip;7;1;0;8
20078;Žirmūnėliai;SAULUTĖS;6116321928;Taip;2;0;0;2
20079;Žirmūnėliai;SAULUTĖS;2310523676;Taip;5;2;0;7
20080;Žirmūnėliai;SAULUTĖS;4922028935;Taip;3;0;0;3
20081;Žirmūnėliai;SAULUTĖS;4763350308;Taip;8;0;0;8
20082;Žirmūnėliai;SAULUTĖS;5626711530;Taip;0;11;0;11
20083;Žirmūnėliai;SAULUTĖS;3902161368;Taip;11;1;0;12
20084;Žirmūnėliai;SAULUTĖS;6072407337;Taip;5;0;0;5
20085;Žirmūnėliai;SAULUTĖS;4338673048;Taip;9;0;0;9
20086;Žirmūnėliai;SAULUTĖS;4793967980;Taip;0;3;0;3
20087;Žirmūnėliai;SAULUTĖS;6177408775;Taip;3;0;0;3
20088;Žirmūnėliai;SAULUTĖS;8242112212;Taip;0;2;2;4
20089;Žirmūnėliai;SAULUTĖS;1940552890;Taip;6;0;0;6
20090;Žirmūnėliai;SAULUTĖS;2392106040;Taip;18;0;0;18
20091;Žirmūnėliai;SAULUTĖS;4343419766;Taip;0;1;0;1
20092;Žirmūnėliai;SAULUTĖS;9145626116;Taip;14;4;1;19
20093;Žirmūnėliai;SAULUTĖS;7675488865;Taip;6;0;1;7
20094;Žirmūnėliai;SAULUTĖS;8345632807;Taip;0;9;0;9
20095;Žirmūnėliai;SAULUTĖS;8592714547;Taip;15;2;2;19
20096;Žirmūnėliai;GILIUKAI;6430944858;Taip;8;0;0;8
20097;Žirmūnėliai;GILIUKAI;3562689670;Taip;7;7;0;14
20098;Žirmūnėliai;GILIUKAI;5929166560;Taip;0;2;2;4
20099;Žirmūnėliai;GILIUKAI;3767421827;Taip;10;0;0;10
20100;Žirmūnėliai;GILIUKAI;4327504033;Taip;0;7;0;7
20101;Žirmūnėliai;GILIUKAI;5104310002;Taip;14;0;0;14
20102;Žirmūnėliai;GILIUKAI;1025809131;Taip;5;1;0;6
20103;Žirmūnėliai;GILIUKAI;6899109664;Taip;3;4;0;7
20104;Žirmūnėliai;GILIUKAI;1473482823;Ne;7;0;0;7
20105;Žirmūnėliai;GILIUKAI;7410921362;Taip;0;8;0;8
20106;Žirmūnėliai;GILIUKAI;6597451758;Taip;7;2;2;11
20107;Žirmūnėliai;GILIUKAI;8627403283;Taip;0;4;5;9
20108;Žirmūnėliai;GILIUKAI;5089884149;Taip;8;0;1;9
20109;Žirmūnėliai;GILIUKAI;1791977446;Taip;8;0;0;8
20110;Žirmūnėliai;GILIUKAI;6875484657;Taip;5;0;4;9
20111;Žirmūnėliai;GILIUKAI;9871163622;Taip;4;0;1;5
20112;Žirmūnėliai;GILIUKAI;3532895278;Ne;2;3;0;5
20113;Žirmūnėliai;GILIUKAI;8459217612;Taip;5;0;1;6
20114;Žirmūnėliai;GILIUKAI;2959090234;Taip;6;0;3;9
20115;Žirmūnėliai;GILIUKAI;5486475468;Taip;5;0;0;5
20116;Žirmūnėliai;GILIUKAI;8618410295;Taip;20;0;0;20
20117;Žirmūnėliai;GILIUKAI;1941509002;Taip;8;0;6;14
20118;Žirmūnėliai;DRUGELIAI;3449815783;Taip;0;2;0;2
20119;Žirmūnėliai;DRUGELIAI;9541122034;Taip;0;1;0;1
20120;Žirmūnėliai;DRUGELIAI;5736502380;Taip;5;2;3;10
20121;Žirmūnėliai;DRUGELIAI;9378860669;Taip;0;5;0;5
20122;Žirmūnėliai;DRUGELIAI;8607934394;Taip;0;4;0;4
20123;Žirmūnėliai;DRUGELIAI;5723289396;Taip;0;4;0;4
20124;Žirmūnėliai;DRUGELIAI;7892626521;Taip;0;6;0;6
20125;Žirmūnėliai;DRUGELIAI;8999160836;Taip;3;2;0;5
20126;Žirmūnėliai;DRUGELIAI;8209309240;Taip;0;6;0;6
20127;Žirmūnėliai;DRUGELIAI;2837129621;Taip;0;5;1;6
20128;Žirmūnėliai;DRUGELIAI;1273684243;Taip;0;0;5;5
20129;Žirmūnėliai;DRUGELIAI;2971175236;Taip;0;3;0;3
20130;Žirmūnėliai;DRUGELIAI;6594728970;Taip;4;0;0;4
20131;Žirmūnėliai;DRUGELIAI;7422544482;Taip;0;1;1;2
20132;Žirmūnėliai;DRUGELIAI;4336415033;Ne;0;1;0;1
20133;Žirmūnėliai;DRUGELIAI;9241738140;Taip;0;5;0;5
20134;Žirmūnėliai;DRUGELIAI;4778339658;Taip;0;3;0;3
20135;Žirmūnėliai;BORUŽIUKAI;4796654075;Taip;9;2;0;11
20136;Žirmūnėliai;BORUŽIUKAI;1234956674;Taip;6;4;3;13
20137;Žirmūnėliai;BORUŽIUKAI;9926432375;Taip;0;9;0;9
20138;Žirmūnėliai;BORUŽIUKAI;2739395691;Taip;0;7;0;7
20139;Žirmūnėliai;BORUŽIUKAI;3351861764;Taip;0;8;0;8
20140;Žirmūnėliai;BORUŽIUKAI;6161223611;Taip;7;2;0;9
20141;Žirmūnėliai;BORUŽIUKAI;7528704460;Taip;0;1;0;1
20142;Žirmūnėliai;BORUŽIUKAI;1618573494;Taip;0;11;0;11
20143;Žirmūnėliai;BORUŽIUKAI;31403739893;Ne;12;0;0;12
20144;Žirmūnėliai;BORUŽIUKAI;6647641423;Taip;0;2;2;4
20145;Žirmūnėliai;BORUŽIUKAI;8623037038;Taip;0;0;3;3
20146;Žirmūnėliai;BORUŽIUKAI;5125341440;Taip;0;1;0;1
20147;Žirmūnėliai;BORUŽIUKAI;1885292520;Taip;3;0;0;3
20148;Žirmūnėliai;BORUŽIUKAI;6337036947;Taip;5;0;1;6
20149;Žirmūnėliai;BORUŽIUKAI;3274576752;Taip;9;1;0;10
20150;Žirmūnėliai;BORUŽIUKAI;5209700153;Taip;3;0;1;4
20151;Žirmūnėliai;BORUŽIUKAI;8339819296;Taip;0;1;9;10
20152;Žirmūnėliai;BORUŽIUKAI;2033271165;Taip;0;1;5;6
20153;Žirmūnėliai;EŽIUKAI;7011701994;Taip;5;0;0;5
20154;Žirmūnėliai;EŽIUKAI;2661052835;Taip;6;14;0;20
20155;Žirmūnėliai;EŽIUKAI;1655437833;Taip;5;0;5;10
20156;Žirmūnėliai;EŽIUKAI;3640979388;Taip;0;3;0;3
20157;Žirmūnėliai;EŽIUKAI;6878528100;Taip;7;0;4;11
20158;Žirmūnėliai;EŽIUKAI;8440187348;Taip;9;0;0;9
20159;Žirmūnėliai;EŽIUKAI;4565479092;Taip;0;1;2;3
20160;Žirmūnėliai;EŽIUKAI;4968278870;Taip;6;0;3;9
20161;Žirmūnėliai;EŽIUKAI;2693415717;Taip;0;1;2;3
20162;Žirmūnėliai;EŽIUKAI;7953019230;Taip;14;9;0;23
20163;Žirmūnėliai;EŽIUKAI;1832367936;Taip;1;0;1;2
20164;Žirmūnėliai;EŽIUKAI;3180116136;Taip;5;2;0;7
20165;Žirmūnėliai;EŽIUKAI;9759491055;Taip;3;1;0;4
20166;Žirmūnėliai;EŽIUKAI;1127214387;Ne;12;2;1;15
20167;Žirmūnėliai;EŽIUKAI;4101748829;Taip;11;2;0;13
20168;Žirmūnėliai;EŽIUKAI;2379638934;Taip;0;7;0;7
20169;Žirmūnėliai;EŽIUKAI;6448582622;Taip;5;5;0;10
20170;Žirmūnėliai;EŽIUKAI;4710829908;Taip;5;4;0;9
20171;Žirmūnėliai;EŽIUKAI;7996709950;Taip;3;0;0;3
20172;Žirmūnėliai;EŽIUKAI;7580002502;Taip;11;0;2;13
20173;Žirmūnėliai;EŽIUKAI;4638575301;Taip;0;1;0;1
20174;Žirmūnėliai;EŽIUKAI;3310847619;Taip;0;0;11;11
20175;Žirmūnėliai;EŽIUKAI;1977798059;Taip;0;3;22;25
20176;Žirmūnėliai;ŽVIRBLIUKAI;6896145409;Taip;19;3;0;22
20177;Žirmūnėliai;ŽVIRBLIUKAI;1255857051;Taip;0;4;4;8
20178;Žirmūnėliai;ŽVIRBLIUKAI;1347664230;Taip;0;1;10;11
20179;Žirmūnėliai;ŽVIRBLIUKAI;8030469722;Taip;8;0;1;9
20180;Žirmūnėliai;ŽVIRBLIUKAI;4517290068;Taip;7;0;0;7
20181;Žirmūnėliai;ŽVIRBLIUKAI;1582563837;Taip;0;4;1;5
20182;Žirmūnėliai;ŽVIRBLIUKAI;1381923106;Taip;0;5;1;6
20183;Žirmūnėliai;ŽVIRBLIUKAI;1725143117;Taip;3;0;0;3
20184;Žirmūnėliai;ŽVIRBLIUKAI;1478039469;Taip;9;0;1;10
20185;Žirmūnėliai;ŽVIRBLIUKAI;5037669167;Taip;0;3;1;4
20186;Žirmūnėliai;ŽVIRBLIUKAI;1073135587;Taip;0;4;0;4
20187;Žirmūnėliai;ŽVIRBLIUKAI;4598761492;Taip;0;8;0;8
20188;Žirmūnėliai;ŽVIRBLIUKAI;1435743911;Taip;5;1;0;6
20189;Žirmūnėliai;ŽVIRBLIUKAI;2007790746;Taip;0;5;0;5
20190;Žirmūnėliai;ŽVIRBLIUKAI;8308074932;Taip;0;5;2;7
20191;Žirmūnėliai;ŽVIRBLIUKAI;1761284228;Taip;11;1;0;12
20192;Žirmūnėliai;ŽVIRBLIUKAI;41018224936;Taip;10;1;0;11
20193;Žirmūnėliai;ŽVIRBLIUKAI;1894070647;Ne;0;4;7;11
20194;Žirmūnėliai;ŽVIRBLIUKAI;7062967491;Taip;0;4;7;11
20195;Žirmūnėliai;ŽVIRBLIUKAI;9482910388;Taip;0;13;0;13
20196;Žirmūnėliai;ŽVIRBLIUKAI;1569772948;Ne;0;1;3;4
20197;Žirmūnėliai;SPALVELĖS;6641667315;Taip;7;4;0;11
20198;Žirmūnėliai;SPALVELĖS;9936156579;Ne;0;2;1;3
20199;Žirmūnėliai;SPALVELĖS;2985092368;Ne;6;1;0;7
20200;Žirmūnėliai;SPALVELĖS;5154076629;Ne;0;2;0;2
20201;Žirmūnėliai;SPALVELĖS;6259368139;Taip;12;3;0;15
20202;Žirmūnėliai;SPALVELĖS;1356219744;Taip;9;7;0;16
20203;Žirmūnėliai;SPALVELĖS;8538773532;Taip;0;7;0;7
20204;Žirmūnėliai;SPALVELĖS;6934204209;Taip;1;0;0;1
20205;Žirmūnėliai;SPALVELĖS;9306935083;Taip;1;15;0;16
20206;Žirmūnėliai;SPALVELĖS;5316869112;Taip;0;14;1;15
20207;Žirmūnėliai;SPALVELĖS;4807331877;Taip;0;0;20;20
20208;Žirmūnėliai;SPALVELĖS;8742911909;Taip;0;12;0;12
20209;Žirmūnėliai;SPALVELĖS;9042509512;Taip;1;14;0;15
20210;Žirmūnėliai;SPALVELĖS;5076712824;Taip;0;3;0;3
20211;Žirmūnėliai;SPALVELĖS;8444883234;Ne;0;8;0;8
20212;Žirmūnėliai;DEBESĖLIAI;6908512961;Taip;0;22;0;22
20213;Žirmūnėliai;DEBESĖLIAI;1571242696;Taip;8;1;0;9
20214;Žirmūnėliai;DEBESĖLIAI;3431320961;Taip;5;0;0;5
20215;Žirmūnėliai;DEBESĖLIAI;7087770068;Taip;0;11;0;11
20216;Žirmūnėliai;DEBESĖLIAI;4347548125;Taip;17;0;3;20
20217;Žirmūnėliai;DEBESĖLIAI;3330603362;Taip;5;1;4;10
20218;Žirmūnėliai;DEBESĖLIAI;5440814849;Taip;5;1;0;6
20219;Žirmūnėliai;DEBESĖLIAI;7680479258;Taip;16;0;4;20
20220;Žirmūnėliai;DEBESĖLIAI;8136265008;Taip;5;14;0;19
20221;Žirmūnėliai;DEBESĖLIAI;7568228423;Taip;7;0;1;8
20222;Žirmūnėliai;DEBESĖLIAI;9813507899;Taip;6;0;1;7
20223;Žirmūnėliai;DEBESĖLIAI;8687642039;Taip;0;0;12;12
20224;Žirmūnėliai;DEBESĖLIAI;5982848146;Taip;18;0;1;19
20225;Žirmūnėliai;DEBESĖLIAI;3646039695;Taip;8;2;0;10
20226;Žirmūnėliai;DEBESĖLIAI;5676730437;Taip;2;0;0;2
20227;Žirmūnėliai;DEBESĖLIAI;4653124134;Taip;0;0;9;9
20228;Žirmūnėliai;DEBESĖLIAI;4501490189;Ne;0;0;8;8
20229;Žirmūnėliai;DEBESĖLIAI;8239982682;Taip;8;0;0;8
20230;Žirmūnėliai;VIŠČIUKAI;2270868598;Taip;5;1;0;6
20231;Žirmūnėliai;VIŠČIUKAI;2802717644;Taip;6;0;1;7
20232;Žirmūnėliai;VIŠČIUKAI;3029428022;Taip;14;0;0;14
20233;Žirmūnėliai;VIŠČIUKAI;9759504463;Taip;5;0;0;5
20234;Žirmūnėliai;VIŠČIUKAI;4134541560;Taip;9;0;1;10
20235;Žirmūnėliai;VIŠČIUKAI;8481357052;Taip;6;0;1;7
20236;Žirmūnėliai;VIŠČIUKAI;6892941066;Taip;4;2;3;9
20237;Žirmūnėliai;VIŠČIUKAI;9858198555;Taip;10;0;0;10
20238;Žirmūnėliai;VIŠČIUKAI;3641319043;Taip;7;0;0;7
20239;Žirmūnėliai;VIŠČIUKAI;6523502376;Taip;4;0;2;6
20240;Žirmūnėliai;VIŠČIUKAI;9280663182;Taip;12;3;0;15
20241;Žirmūnėliai;VIŠČIUKAI;5281338626;Taip;8;2;1;11
20242;Žirmūnėliai;VIŠČIUKAI;9688006040;Taip;0;0;22;22
20243;Žirmūnėliai;VIŠČIUKAI;5622319185;Taip;0;0;3;3
20244;Žirmūnėliai;VIŠČIUKAI;7053321410;Taip;14;0;1;15
20245;Žirmūnėliai;VIŠČIUKAI;4512970900;Taip;0;0;2;2
20246;Žirmūnėliai;ZUIKUČIŲ;4291114238;Taip;5;4;0;9
20247;Žirmūnėliai;ZUIKUČIŲ;4836165731;Taip;9;0;2;11
20248;Žirmūnėliai;ZUIKUČIŲ;3762889366;Taip;0;5;0;5
20249;Žirmūnėliai;ZUIKUČIŲ;3977279181;Taip;6;1;0;7
20250;Žirmūnėliai;ZUIKUČIŲ;8002655555;Taip;0;13;0;13
20251;Žirmūnėliai;ZUIKUČIŲ;6427861912;Taip;7;0;0;7
20252;Žirmūnėliai;ZUIKUČIŲ;2736632324;Taip;0;2;0;2
20253;Žirmūnėliai;ZUIKUČIŲ;2870069039;Taip;5;1;3;9
20254;Žirmūnėliai;ZUIKUČIŲ;6543834058;Taip;14;0;0;14
20255;Žirmūnėliai;ZUIKUČIŲ;8271996884;Taip;0;1;5;6
20256;Žirmūnėliai;ZUIKUČIŲ;3012945005;Ne;9;1;0;10
20257;Žirmūnėliai;ZUIKUČIŲ;8782085662;Taip;15;1;1;17
20258;Žirmūnėliai;ZUIKUČIŲ;5668266601;Taip;0;0;6;6
20259;Žirmūnėliai;ZUIKUČIŲ;9472372819;Ne;0;2;0;2
20260;Žirmūnėliai;ZUIKUČIŲ;6812682361;Taip;1;0;3;4
20261;Žirmūnėliai;OBUOLIUKAI;4575123456;Taip;18;1;0;19
20262;Žirmūnėliai;OBUOLIUKAI;3795476732;Ne;0;2;0;2
20263;Žirmūnėliai;OBUOLIUKAI;1917500190;Taip;0;5;0;5
20264;Žirmūnėliai;OBUOLIUKAI;2073922023;Ne;8;1;0;9
20265;Žirmūnėliai;OBUOLIUKAI;7059249540;Taip;6;1;0;7
20266;Žirmūnėliai;OBUOLIUKAI;4999561481;Taip;0;1;0;1
20267;Žirmūnėliai;OBUOLIUKAI;6358006462;Taip;9;4;0;13
20268;Žirmūnėliai;OBUOLIUKAI;2497258407;Taip;0;3;0;3
20269;Žirmūnėliai;OBUOLIUKAI;6869102228;Taip;20;2;0;22
20270;Žirmūnėliai;OBUOLIUKAI;9367849317;Taip;6;3;0;9
20271;Žirmūnėliai;OBUOLIUKAI;6450412481;Taip;13;0;0;13
20272;Žirmūnėliai;OBUOLIUKAI;1523231731;Taip;0;5;0;5
20273;Žirmūnėliai;OBUOLIUKAI;9225654910;Taip;9;6;0;15
20274;Žirmūnėliai;OBUOLIUKAI;7945713337;Taip;4;2;0;6
20275;Žirmūnėliai;OBUOLIUKAI;8823426998;Taip;6;1;0;7
20276;Žirmūnėliai;DAINORĖLIAI;1255294064;Taip;21;1;0;22
20277;Žirmūnėliai;DAINORĖLIAI;5616289290;Taip;18;1;0;19
20278;Žirmūnėliai;DAINORĖLIAI;3520677404;Taip;19;0;0;19
20279;Žirmūnėliai;DAINORĖLIAI;9978718231;Taip;0;2;3;5
20280;Žirmūnėliai;DAINORĖLIAI;6066212109;Taip;8;0;0;8
20281;Žirmūnėliai;DAINORĖLIAI;4641264260;Taip;19;2;1;22
20282;Žirmūnėliai;DAINORĖLIAI;8794707243;Taip;0;0;6;6
20283;Žirmūnėliai;DAINORĖLIAI;5646794795;Taip;9;0;3;12
20284;Žirmūnėliai;DAINORĖLIAI;9908958250;Taip;0;0;22;22
20285;Žirmūnėliai;DAINORĖLIAI;1116572386;Taip;0;2;5;7
20286;Žirmūnėliai;DAINORĖLIAI;3546787595;Ne;3;1;0;4
20287;"Dainorėliai (Ankštoji g. 11)";VARPELIAI;87242570532;Taip;5;0;0;5
20288;"Dainorėliai (Ankštoji g. 11)";VARPELIAI;18233813290;Taip;0;1;0;1
20289;"Dainorėliai (Ankštoji g. 11)";VARPELIAI;6176171443;Taip;0;1;0;1
20290;"Dainorėliai (Ankštoji g. 11)";VARPELIAI;88781762328;Taip;5;0;0;5
20291;"Dainorėliai (Ankštoji g. 11)";VARPELIAI;5693385617;Taip;0;2;0;2
20292;"Dainorėliai (Ankštoji g. 11)";VARPELIAI;8267213392;Taip;0;4;0;4
20293;"Dainorėliai (Ankštoji g. 11)";VARPELIAI;5959380807;Taip;1;1;0;2
20294;"Dainorėliai (Ankštoji g. 11)";VARPELIAI;2938732886;Taip;0;3;0;3
20295;"Dainorėliai (Ankštoji g. 11)";VARPELIAI;3183793211;Ne;0;3;3;6
20296;"Dainorėliai (Ankštoji g. 11)";VARPELIAI;8521878734;Taip;5;4;0;9
20297;"Dainorėliai (Ankštoji g. 11)";VARPELIAI;6430425182;Taip;0;1;0;1
20298;"Dainorėliai (Ankštoji g. 11)";VARPELIAI;4269946363;Taip;5;3;1;9
20299;"Dainorėliai (Ankštoji g. 11)";VARPELIAI;1088248393;Taip;0;2;7;9
20300;"Dainorėliai (Ankštoji g. 11)";VARPELIAI;2070086316;Taip;0;3;0;3
20301;"Dainorėliai (Ankštoji g. 11)";VARPELIAI;2074070030;Taip;0;3;0;3
20302;"Dainorėliai (Ankštoji g. 11)";VARPELIAI;4591161640;Taip;0;3;0;3
20303;"Dainorėliai (Ankštoji g. 11)";VARPELIAI;6898685834;Taip;0;0;2;2
20304;"Dainorėliai (Ankštoji g. 11)";VARPELIAI;6909583023;Taip;12;1;0;13
20305;"Dainorėliai (Ankštoji g. 11)";VARPELIAI;9319771186;Taip;0;2;7;9
20306;"Dainorėliai (Ankštoji g. 11)";VARPELIAI;68134437706;Taip;0;1;0;1
20307;"Dainorėliai (Ankštoji g. 11)";ŽIOGELIAI;5591598390;Taip;8;1;0;9
20308;"Dainorėliai (Ankštoji g. 11)";ŽIOGELIAI;6481621329;Ne;10;0;0;10
20309;"Dainorėliai (Ankštoji g. 11)";ŽIOGELIAI;5715129088;Taip;0;0;3;3
20310;"Dainorėliai (Ankštoji g. 11)";ŽIOGELIAI;8140354445;Taip;0;1;0;1
20311;"Dainorėliai (Ankštoji g. 11)";ŽIOGELIAI;9132532505;Ne;16;2;0;18
20312;"Dainorėliai (Ankštoji g. 11)";ŽIOGELIAI;2450726148;Taip;6;1;0;7
20313;"Dainorėliai (Ankštoji g. 11)";ŽIOGELIAI;5793828922;Taip;5;1;0;6
20314;"Dainorėliai (Ankštoji g. 11)";ŽIOGELIAI;7591953671;Taip;0;0;22;22
20315;"Dainorėliai (Ankštoji g. 11)";ŽIOGELIAI;6169434322;Taip;7;0;0;7
20316;"Dainorėliai (Ankštoji g. 11)";ŽIOGELIAI;2094849111;Taip;0;6;0;6
20317;"Dainorėliai (Ankštoji g. 11)";ŽIOGELIAI;6659114730;Taip;14;0;2;16
20318;"Dainorėliai (Ankštoji g. 11)";ŽIOGELIAI;3887433142;Taip;9;0;0;9
20319;"Dainorėliai (Ankštoji g. 11)";ŽIOGELIAI;2541781620;Taip;8;0;0;8
20320;"Dainorėliai (Ankštoji g. 11)";ŽIOGELIAI;8239000041;Taip;3;0;0;3
20321;"Dainorėliai (Ankštoji g. 11)";ŽIOGELIAI;7984447187;Taip;16;0;0;16
20322;"Dainorėliai (Ankštoji g. 11)";ŽIOGELIAI;3897725337;Taip;8;0;0;8
20323;"Dainorėliai (Ankštoji g. 11)";ŽIOGELIAI;3598951899;Taip;10;4;0;14
20324;"Dainorėliai (Ankštoji g. 11)";ŽIOGELIAI;4973241539;Taip;22;0;0;22
20325;"Dainorėliai (Ankštoji g. 11)";ŽIOGELIAI;3592770633;Taip;13;0;0;13
20326;"Dainorėliai (Ankštoji g. 11)";ŽIOGELIAI;4969782237;Taip;0;1;0;1
20327;"Dainorėliai (Ankštoji g. 11)";DRUGELIAI;9592384914;Taip;19;0;0;19
20328;"Dainorėliai (Ankštoji g. 11)";DRUGELIAI;6403389248;Taip;17;0;0;17
20329;"Dainorėliai (Ankštoji g. 11)";DRUGELIAI;4900234806;Taip;6;0;0;6
20330;"Dainorėliai (Ankštoji g. 11)";DRUGELIAI;8962657389;Taip;7;1;0;8
20331;"Dainorėliai (Ankštoji g. 11)";DRUGELIAI;2703267758;Taip;7;0;0;7
20332;"Dainorėliai (Ankštoji g. 11)";DRUGELIAI;6899629612;Taip;26;0;0;26
20333;"Dainorėliai (Ankštoji g. 11)";DRUGELIAI;2605119306;Taip;6;1;0;7
20334;"Dainorėliai (Ankštoji g. 11)";DRUGELIAI;9976869100;Taip;21;0;0;21
20335;"Dainorėliai (Ankštoji g. 11)";DRUGELIAI;3063825996;Taip;3;2;2;7
20336;"Dainorėliai (Ankštoji g. 11)";DRUGELIAI;9303046800;Taip;5;0;0;5
20337;"Dainorėliai (Ankštoji g. 11)";DRUGELIAI;5854379630;Ne;0;22;0;22
20338;"Dainorėliai (Ankštoji g. 11)";DRUGELIAI;3711954197;Taip;24;0;0;24
20339;"Dainorėliai (Ankštoji g. 11)";DRUGELIAI;3741337791;Taip;7;0;0;7
20340;"Dainorėliai (Ankštoji g. 11)";DRUGELIAI;8088948564;Taip;15;2;0;17
20341;"Dainorėliai (Ankštoji g. 11)";DRUGELIAI;1718576253;Taip;0;17;0;17
20342;"Dainorėliai (Ankštoji g. 11)";DRUGELIAI;2803571247;Taip;9;10;0;19
20343;"Dainorėliai (Ankštoji g. 11)";DRUGELIAI;5084474142;Taip;6;0;0;6
20344;"Dainorėliai (Ankštoji g. 11)";DRUGELIAI;1332165159;Taip;20;0;0;20
20345;"Dainorėliai (Ankštoji g. 11)";DRUGELIAI;8684975630;Taip;14;0;2;16
20346;"Dainorėliai (Ankštoji g. 11)";DRUGELIAI;2740773904;Taip;5;1;1;7
20347;"Dainorėliai (Ankštoji g. 11)";DRUGELIAI;6460217912;Taip;0;15;0;15
20348;"Dainorėliai (Ankštoji g. 11)";"1 klasė";2520667095;Taip;7;1;0;8
20349;"Dainorėliai (Ankštoji g. 11)";"1 klasė";1333499160;Taip;0;1;0;1
20350;"Dainorėliai (Ankštoji g. 11)";"1 klasė";50432354832;Taip;5;1;0;6
20351;"Dainorėliai (Ankštoji g. 11)";"1 klasė";1626877066;Taip;0;1;0;1
20352;"Dainorėliai (Ankštoji g. 11)";"1 klasė";1158895670;Ne;0;1;0;1
20353;"Dainorėliai (Ankštoji g. 11)";"1 klasė";73649870571;Taip;0;1;0;1
20354;"Dainorėliai (Ankštoji g. 11)";"1 klasė";19286303769;Taip;0;1;0;1
20355;"Dainorėliai (Ankštoji g. 11)";"1 klasė";73386013083;Taip;7;1;0;8
20356;"Dainorėliai (Ankštoji g. 11)";"1 klasė";27521381629;Taip;2;1;0;3
20357;"Dainorėliai (Ankštoji g. 11)";"1 klasė";53935690864;Taip;1;1;0;2
20358;"Dainorėliai (Ankštoji g. 11)";"1 klasė";6411939690;Taip;6;1;0;7
20359;"Dainorėliai (Ankštoji g. 11)";"1 klasė";2287353933;Taip;6;1;0;7
20360;"Dainorėliai (Ankštoji g. 11)";"1 klasė";36313982965;Taip;0;1;0;1
20361;"Dainorėliai (Ankštoji g. 11)";"1 klasė";86659723162;Taip;0;1;0;1
20362;"Dainorėliai (Ankštoji g. 11)";"1 klasė";5479496104;Taip;1;1;0;2
20363;"Dainorėliai (Ankštoji g. 11)";"1 klasė";94480397292;Ne;0;1;0;1
20364;"Dainorėliai (Ankštoji g. 11)";"1 klasė";6404337541;Taip;0;1;0;1
20365;"Dainorėliai (Ankštoji g. 11)";"1 klasė";49483881135;Taip;6;1;0;7
20366;"Dainorėliai (Ankštoji g. 11)";"1 klasė";86187568203;Taip;9;1;0;10
20367;"Dainorėliai (Ankštoji g. 11)";"1 klasė";1015870220;Taip;6;1;0;7
20368;"Dainorėliai (Ankštoji g. 11)";"1 klasė";1515552402;Taip;0;1;0;1
20369;"Dainorėliai (Ankštoji g. 11)";"1 klasė";7114409929;Taip;2;1;0;3
20370;"Dainorėliai (Ankštoji g. 11)";"1 klasė";1084400276;Ne;12;1;0;13
20371;"Dainorėliai (Ankštoji g. 11)";"1 klasė";1531362555;Ne;4;1;0;5
20372;"Dainorėliai (Ankštoji g. 11)";"1 klasė";6195426672;Taip;0;1;0;1
20373;"Dainorėliai (Ankštoji g. 11)";"2 klasė";67124516230;Ne;17;1;0;18
20374;"Dainorėliai (Ankštoji g. 11)";"2 klasė";7506194777;Taip;0;1;0;1
20375;"Dainorėliai (Ankštoji g. 11)";"2 klasė";1829858221;Taip;6;1;0;7
20376;"Dainorėliai (Ankštoji g. 11)";"2 klasė";1470784692;Taip;0;1;0;1
20377;"Dainorėliai (Ankštoji g. 11)";"2 klasė";7569146994;Taip;10;1;0;11
20378;"Dainorėliai (Ankštoji g. 11)";"2 klasė";45577031767;Taip;0;1;0;1
20379;"Dainorėliai (Ankštoji g. 11)";"2 klasė";58071607976;Ne;12;1;0;13
20380;"Dainorėliai (Ankštoji g. 11)";"2 klasė";1646521870;Taip;10;1;0;11
20381;"Dainorėliai (Ankštoji g. 11)";"2 klasė";29132059636;Taip;0;1;0;1
20382;"Dainorėliai (Ankštoji g. 11)";"2 klasė";32573583030;Taip;4;1;0;5
20383;"Dainorėliai (Ankštoji g. 11)";"2 klasė";97947842490;Ne;1;1;0;2
20384;"Dainorėliai (Ankštoji g. 11)";"2 klasė";63211091321;Taip;5;1;0;6
20385;"Dainorėliai (Ankštoji g. 11)";"2 klasė";87717571411;Taip;0;1;0;1
20386;"Dainorėliai (Ankštoji g. 11)";"2 klasė";18936645521;Ne;0;1;0;1
20387;"Dainorėliai (Ankštoji g. 11)";"2 klasė";80499999855;Taip;1;1;0;2
20388;"Dainorėliai (Ankštoji g. 11)";"2 klasė";6948863728;Taip;6;1;0;7
20389;"Dainorėliai (Ankštoji g. 11)";"2 klasė";2531690903;Taip;3;1;0;4
20390;"Dainorėliai (Ankštoji g. 11)";"2 klasė";35134511946;Taip;4;1;0;5
20391;"Dainorėliai (Ankštoji g. 11)";"2 klasė";1121139222;Taip;0;1;0;1
20392;"Dainorėliai (Ankštoji g. 11)";"2 klasė";99597416067;Taip;0;1;0;1
20393;"Dainorėliai (Ankštoji g. 11)";"2 klasė";77718940253;Taip;0;1;0;1
20394;"Dainorėliai (Ankštoji g. 11)";"2 klasė";5236797727;Taip;7;1;0;8
20395;"Dainorėliai (Ankštoji g. 11)";"3 klasė";2045625141;Taip;9;1;0;10
20396;"Dainorėliai (Ankštoji g. 11)";"3 klasė";84084897419;Taip;5;1;0;6
20397;"Dainorėliai (Ankštoji g. 11)";"3 klasė";34219208558;Taip;5;1;0;6
20398;"Dainorėliai (Ankštoji g. 11)";"3 klasė";13138644060;Taip;0;1;0;1
20399;"Dainorėliai (Ankštoji g. 11)";"3 klasė";49342277188;Taip;9;1;0;10
20400;"Dainorėliai (Ankštoji g. 11)";"3 klasė";42402953271;Taip;5;1;0;6
20401;"Dainorėliai (Ankštoji g. 11)";"3 klasė";2441164154;Taip;3;1;0;4
20402;"Dainorėliai (Ankštoji g. 11)";"3 klasė";69556449215;Ne;0;1;0;1
20403;"Dainorėliai (Ankštoji g. 11)";"3 klasė";8244355193;Taip;0;1;0;1
20404;"Dainorėliai (Ankštoji g. 11)";"3 klasė";2142553899;Taip;4;1;0;5
20405;"Dainorėliai (Ankštoji g. 11)";"3 klasė";37660372564;Taip;9;1;0;10
20406;"Dainorėliai (Ankštoji g. 11)";"3 klasė";1889037823;Taip;4;1;0;5
20407;"Dainorėliai (Ankštoji g. 11)";"3 klasė";98796240124;Ne;12;1;0;13
20408;"Dainorėliai (Ankštoji g. 11)";"3 klasė";98830139164;Taip;9;1;0;10
20409;"Dainorėliai (Ankštoji g. 11)";"3 klasė";37708779599;Taip;5;1;0;6
20410;"Dainorėliai (Ankštoji g. 11)";"3 klasė";18741625569;Taip;0;1;0;1
20411;"Dainorėliai (Ankštoji g. 11)";"3 klasė";84424772471;Taip;0;1;0;1
20412;"Dainorėliai (Ankštoji g. 11)";"3 klasė";34686211072;Taip;9;1;0;10
20413;"Dainorėliai (Ankštoji g. 11)";"3 klasė";79461209783;Taip;6;1;0;7
20414;"Dainorėliai (Ankštoji g. 11)";"3 klasė";47323045857;Taip;7;1;0;8
20415;"Dainorėliai (Ankštoji g. 11)";"3 klasė";10679627657;Taip;0;1;0;1
20416;"Dainorėliai (Ankštoji g. 11)";"3 klasė";25073134850;Taip;5;1;0;6
20417;"Dainorėliai (Ankštoji g. 11)";"3 klasė";65118883315;Taip;4;1;0;5
20418;"Dainorėliai (Ankštoji g. 11)";"3 klasė";84999972369;Taip;0;1;0;1
20419;"Dainorėliai (Ankštoji g. 11)";"3 klasė";1209781483;Taip;0;1;0;1
20420;"Dainorėliai (Ankštoji g. 11)";"3 klasė";69732047046;Taip;7;1;0;8
20421;"Dainorėliai (Ankštoji g. 11)";"4 klasė";29726515194;Taip;1;1;0;2
20422;"Dainorėliai (Ankštoji g. 11)";"4 klasė";8562371599;Taip;0;1;0;1
20423;"Dainorėliai (Ankštoji g. 11)";"4 klasė";19292860218;Taip;0;1;0;1
20424;"Dainorėliai (Ankštoji g. 11)";"4 klasė";97182565649;Taip;0;1;0;1
20425;"Dainorėliai (Ankštoji g. 11)";"4 klasė";65982869126;Taip;1;1;0;2
20426;"Dainorėliai (Ankštoji g. 11)";"4 klasė";93738984644;Taip;0;4;0;4
20427;"Dainorėliai (Ankštoji g. 11)";"4 klasė";69409530494;Taip;0;1;0;1
20428;"Dainorėliai (Ankštoji g. 11)";"4 klasė";57179351170;Taip;4;1;0;5
20429;"Dainorėliai (Ankštoji g. 11)";"4 klasė";77907054102;Taip;4;1;0;5
20430;"Dainorėliai (Ankštoji g. 11)";"4 klasė";24048489264;Ne;5;1;0;6
20431;"Dainorėliai (Ankštoji g. 11)";"4 klasė";4773358825;Taip;0;1;0;1
20432;"Dainorėliai (Ankštoji g. 11)";"4 klasė";91457137356;Ne;0;1;0;1
20433;"Dainorėliai (Ankštoji g. 11)";"4 klasė";5010994621;Taip;0;1;0;1
20434;"Dainorėliai (Ankštoji g. 11)";"4 klasė";13846131820;Taip;2;1;0;3
20435;"Dainorėliai (Ankštoji g. 11)";"4 klasė";23144978287;Taip;0;1;0;1
20436;"Dainorėliai (Ankštoji g. 11)";"4 klasė";6203511535;Taip;8;1;0;9
20437;"Dainorėliai (Ankštoji g. 11)";"4 klasė";81956978417;Taip;2;1;0;3
20438;"Dainorėliai (Ankštoji g. 11)";"4 klasė";3018657993;Taip;4;1;0;5
20439;"Dainorėliai (Ankštoji g. 11)";"4 klasė";48245075123;Taip;3;1;0;4
20440;"Dainorėliai (Ankštoji g. 11)";"4 klasė";57618865048;Taip;0;1;0;1
20441;"Dainorėliai (Ankštoji g. 11)";"4 klasė";84749521489;Taip;0;1;0;1
20442;"Dainorėliai (Ankštoji g. 11)";"4 klasė";26315465923;Taip;0;1;0;1
20443;"Dainorėliai (Ankštoji g. 11)";SAULUTĖS;9130473411;Taip;3;5;0;8
20444;"Dainorėliai (Ankštoji g. 11)";SAULUTĖS;8857018998;Taip;11;0;0;11
20445;"Dainorėliai (Ankštoji g. 11)";SAULUTĖS;4612995336;Ne;13;1;0;14
20446;"Dainorėliai (Ankštoji g. 11)";SAULUTĖS;6704354150;Taip;4;2;0;6
20447;"Dainorėliai (Ankštoji g. 11)";SAULUTĖS;5632663846;Taip;2;2;0;4
20448;"Dainorėliai (Ankštoji g. 11)";SAULUTĖS;1547686786;Ne;5;0;0;5
20449;"Dainorėliai (Ankštoji g. 11)";SAULUTĖS;4307591123;Taip;10;1;0;11
20450;"Dainorėliai (Ankštoji g. 11)";SAULUTĖS;6385439136;Taip;0;2;0;2
20451;"Dainorėliai (Ankštoji g. 11)";SAULUTĖS;1552829080;Taip;0;3;0;3
20452;"Dainorėliai (Ankštoji g. 11)";SAULUTĖS;5410183494;Taip;7;3;0;10
20453;"Dainorėliai (Ankštoji g. 11)";SAULUTĖS;5587907483;Ne;16;0;0;16
20454;"Dainorėliai (Ankštoji g. 11)";SAULUTĖS;2064843848;Taip;8;3;0;11
20455;"Dainorėliai (Ankštoji g. 11)";SAULUTĖS;5687390372;Taip;2;4;0;6
20456;"Dainorėliai (Ankštoji g. 11)";SAULUTĖS;7804441689;Taip;10;0;1;11
20457;"Dainorėliai (Ankštoji g. 11)";SAULUTĖS;6090746954;Taip;7;2;1;10
20458;"Dainorėliai (Ankštoji g. 11)";SAULUTĖS;5102030168;Ne;2;0;0;2
20459;"Dainorėliai (Ankštoji g. 11)";SAULUTĖS;7118473669;Taip;10;8;0;18
20460;"Dainorėliai (Ankštoji g. 11)";SAULUTĖS;4431804759;Taip;0;7;0;7
20461;"Dainorėliai (Ankštoji g. 11)";SAULUTĖS;6697149560;Taip;12;1;0;13
20462;Lokiukas;BITUTĖS;3329205450;Taip;8;1;3;12
20463;Lokiukas;BITUTĖS;7920238202;Taip;0;0;5;5
20464;Lokiukas;BITUTĖS;1376124245;Taip;0;22;0;22
20465;Lokiukas;BITUTĖS;2181315008;Taip;5;0;3;8
20466;Lokiukas;BITUTĖS;3896883842;Taip;14;0;0;14
20467;Lokiukas;BITUTĖS;8656751314;Taip;13;1;5;19
20468;Lokiukas;BITUTĖS;4551069961;Taip;6;1;0;7
20469;Lokiukas;BITUTĖS;5794303981;Taip;7;1;5;13
20470;Lokiukas;BITUTĖS;2671053309;Ne;9;1;1;11
20471;Lokiukas;BITUTĖS;5217458476;Taip;10;0;0;10
20472;Lokiukas;BITUTĖS;6883994020;Taip;26;0;0;26
20473;Lokiukas;BITUTĖS;8209165996;Taip;5;5;0;10
20474;Lokiukas;BITUTĖS;1647778939;Taip;9;0;4;13
20475;Lokiukas;BITUTĖS;9480025132;Taip;10;1;1;12
20476;Lokiukas;BITUTĖS;6260486656;Taip;0;18;1;19
20477;Lokiukas;BITUTĖS;2126391728;Taip;6;0;1;7
20478;Lokiukas;BITUTĖS;8334800302;Taip;9;1;3;13
20479;Lokiukas;BITUTĖS;1987485885;Ne;12;0;0;12
20480;Lokiukas;BITUTĖS;8378138411;Ne;13;1;0;14
20481;Lokiukas;BITUTĖS;3397999534;Taip;5;0;0;5
20482;Lokiukas;BITUTĖS;8059759103;Taip;15;0;2;17
20483;Lokiukas;BITUTĖS;8994257898;Taip;13;1;3;17
20484;Lokiukas;"1 B klasė";14605095801;Taip;9;1;0;10
20485;Lokiukas;"1 B klasė";8036643654;Taip;5;1;0;6
20486;Lokiukas;"1 B klasė";5879386524;Taip;17;1;0;18
20487;Lokiukas;"1 B klasė";9625041533;Ne;13;1;0;14
20488;Lokiukas;"1 B klasė";2476231041;Ne;9;1;0;10
20489;Lokiukas;"1 B klasė";2548712970;Taip;10;1;0;11
20490;Lokiukas;"1 B klasė";1570438208;Taip;21;1;0;22
20491;Lokiukas;"1 B klasė";2673522432;Taip;25;1;0;26
20492;Lokiukas;"1 B klasė";47399326083;Taip;3;1;0;4
20493;Lokiukas;"1 B klasė";7591418969;Ne;8;1;0;9
20494;Lokiukas;"1 B klasė";4569798381;Taip;21;1;0;22
20495;Lokiukas;"1 B klasė";8399364170;Taip;12;1;0;13
20496;Lokiukas;"1 B klasė";97284171512;Taip;6;1;0;7
20497;Lokiukas;"1 B klasė";5943583254;Taip;4;1;0;5
20498;Lokiukas;"1 B klasė";3070998871;Taip;6;1;0;7
20499;Lokiukas;"1 B klasė";5453470660;Taip;6;1;0;7
20500;Lokiukas;"1 B klasė";4427448272;Taip;21;1;0;22
20501;Lokiukas;"1 B klasė";20659573470;Taip;21;1;0;22
20502;Lokiukas;"1 B klasė";5437008837;Taip;6;1;0;7
20503;Lokiukas;"1 B klasė";4580716838;Taip;2;1;0;3
20504;Lokiukas;"1 B klasė";39975872119;Taip;1;1;0;2
20505;Lokiukas;"1 B klasė";8568285232;Taip;13;1;0;14
20506;Lokiukas;"1 B klasė";9501202273;Taip;8;1;0;9
20507;Lokiukas;"1 B klasė";8943496964;Ne;21;1;0;22
20508;Lokiukas;"1 A klasė";56069293343;Taip;7;1;0;8
20509;Lokiukas;"1 A klasė";69364831994;Ne;6;1;0;7
20510;Lokiukas;"1 A klasė";1230490562;Ne;10;1;0;11
20511;Lokiukas;"1 A klasė";8452600632;Taip;0;1;0;1
20512;Lokiukas;"1 A klasė";39222094073;Taip;12;1;0;13
20513;Lokiukas;"1 A klasė";74169282323;Taip;0;1;0;1
20514;Lokiukas;"1 A klasė";35890122494;Taip;2;1;0;3
20515;Lokiukas;"1 A klasė";1626698185;Taip;12;1;0;13
20516;Lokiukas;"1 A klasė";8455869600;Taip;10;1;0;11
20517;Lokiukas;"1 A klasė";1625137322;Taip;4;1;0;5
20518;Lokiukas;"1 A klasė";2170176922;Ne;13;1;0;14
20519;Lokiukas;"1 A klasė";8270572748;Ne;4;1;0;5
20520;Lokiukas;"1 A klasė";34800098950;Taip;6;1;0;7
20521;Lokiukas;"1 A klasė";3825101647;Ne;21;1;0;22
20522;Lokiukas;"1 A klasė";8618280811;Ne;21;1;0;22
20523;Lokiukas;"1 A klasė";8323172347;Taip;4;1;0;5
20524;Lokiukas;"1 A klasė";7844351275;Ne;3;1;0;4
20525;Lokiukas;"1 A klasė";2045735700;Taip;1;1;0;2
20526;Lokiukas;"1 A klasė";3981653153;Ne;2;1;0;3
20527;Lokiukas;"1 A klasė";6318538591;Taip;0;1;0;1
20528;Lokiukas;"1 A klasė";43500434912;Taip;5;1;0;6
20529;Lokiukas;"1 A klasė";25141529581;Taip;14;1;0;15
20530;Lokiukas;"1 A klasė";3369746590;Taip;9;1;0;10
20531;Lokiukas;"1 A klasė";3004895246;Ne;21;1;0;22
20532;Lokiukas;"1 A klasė";3061816821;Ne;15;1;0;16
20533;Lokiukas;GUDRUČIAI;1604886863;Ne;6;1;3;10
20534;Lokiukas;GUDRUČIAI;3826815202;Taip;11;1;0;12
20535;Lokiukas;GUDRUČIAI;8687864179;Ne;4;1;1;6
20536;Lokiukas;GUDRUČIAI;5446430319;Taip;6;1;3;10
20537;Lokiukas;GUDRUČIAI;5995034919;Ne;10;3;1;14
20538;Lokiukas;GUDRUČIAI;2354942164;Ne;12;1;0;13
20539;Lokiukas;GUDRUČIAI;35364823312;Taip;12;1;0;13
20540;Lokiukas;GUDRUČIAI;5076773045;Taip;7;1;2;10
20541;Lokiukas;GUDRUČIAI;1188049956;Taip;5;1;0;6
20542;Lokiukas;GUDRUČIAI;1620856143;Ne;4;4;1;9
20543;Lokiukas;GUDRUČIAI;1733486244;Taip;14;1;0;15
20544;Lokiukas;GUDRUČIAI;4633366779;Taip;2;1;4;7
20545;Lokiukas;GUDRUČIAI;3485639108;Taip;0;4;1;5
20546;Lokiukas;GUDRUČIAI;3991821717;Taip;10;4;0;14
20547;Lokiukas;GUDRUČIAI;1606617694;Ne;14;0;0;14
20548;Lokiukas;GUDRUČIAI;8243342948;Taip;5;1;0;6
20549;Lokiukas;GUDRUČIAI;1210407640;Taip;14;3;0;17
20550;Lokiukas;BORUŽĖLĖS;4849031542;Taip;11;1;0;12
20551;Lokiukas;BORUŽĖLĖS;2625981190;Taip;0;1;0;1
20552;Lokiukas;BORUŽĖLĖS;4585621105;Taip;1;1;0;2
20553;Lokiukas;BORUŽĖLĖS;8576418875;Taip;0;22;0;22
20554;Lokiukas;BORUŽĖLĖS;4617372387;Taip;6;2;1;9
20555;Lokiukas;BORUŽĖLĖS;6869785650;Taip;18;3;0;21
20556;Lokiukas;BORUŽĖLĖS;8630112458;Taip;0;11;0;11
20557;Lokiukas;BORUŽĖLĖS;3930463578;Taip;11;1;2;14
20558;Lokiukas;BORUŽĖLĖS;6277388612;Taip;10;1;0;11
20559;Lokiukas;BORUŽĖLĖS;2660616022;Ne;0;2;0;2
20560;Lokiukas;BORUŽĖLĖS;9798351980;Taip;0;1;1;2
20561;Lokiukas;BORUŽĖLĖS;5401463671;Ne;5;6;0;11
20562;Lokiukas;BORUŽĖLĖS;9996442005;Ne;5;6;0;11
20563;Lokiukas;BORUŽĖLĖS;4317453894;Taip;3;1;1;5
20564;Lokiukas;BORUŽĖLĖS;1226376844;Taip;0;6;0;6
20565;Lokiukas;BORUŽĖLĖS;4840187188;Taip;21;1;0;22
20566;Lokiukas;BORUŽĖLĖS;1724976098;Taip;6;7;0;13
20567;Lokiukas;BORUŽĖLĖS;7426579018;Taip;7;2;0;9
20568;Lokiukas;BORUŽĖLĖS;1974049743;Ne;10;2;1;13
20569;Lokiukas;BORUŽĖLĖS;3733581089;Taip;0;3;2;5
20570;Lokiukas;BORUŽĖLĖS;3876368364;Taip;0;20;0;20
20571;Lokiukas;BORUŽĖLĖS;9354491312;Taip;21;1;0;22
20572;Lokiukas;BORUŽĖLĖS;6091878190;Taip;3;1;1;5
20573;Lokiukas;BORUŽĖLĖS;1076719080;Taip;4;2;1;7
20574;Lokiukas;ANČIUKAI;5473316050;Taip;3;0;0;3
20575;Lokiukas;ANČIUKAI;5670185948;Ne;0;0;6;6
20576;Lokiukas;ANČIUKAI;5843699073;Taip;4;0;3;7
20577;Lokiukas;ANČIUKAI;4788062781;Ne;19;1;0;20
20578;Lokiukas;ANČIUKAI;8758248334;Taip;20;1;1;22
20579;Lokiukas;ANČIUKAI;2466354050;Ne;25;0;0;25
20580;Lokiukas;ANČIUKAI;3849212461;Taip;12;1;2;15
20581;Lokiukas;ANČIUKAI;1756658146;Taip;1;1;6;8
20582;Lokiukas;ANČIUKAI;3668903653;Taip;4;0;2;6
20583;Lokiukas;ANČIUKAI;7509043689;Taip;20;0;2;22
20584;Lokiukas;ANČIUKAI;9673257342;Taip;9;0;1;10
20585;Lokiukas;ANČIUKAI;2266747745;Taip;14;1;0;15
20586;Lokiukas;ANČIUKAI;4417116107;Taip;8;0;1;9
20587;Lokiukas;ANČIUKAI;5893844708;Taip;12;0;0;12
20588;Lokiukas;ANČIUKAI;3015119335;Taip;0;1;3;4
20589;Lokiukas;ANČIUKAI;1712365476;Taip;0;22;0;22
20590;Lokiukas;ANČIUKAI;6827710384;Taip;0;22;0;22
20591;Lokiukas;KODĖLČIUKAI;2642065594;Taip;0;6;0;6
20592;Lokiukas;KODĖLČIUKAI;5943412920;Taip;10;4;0;14
20593;Lokiukas;KODĖLČIUKAI;6758550653;Taip;7;11;0;18
20594;Lokiukas;KODĖLČIUKAI;6336140882;Taip;18;1;2;21
20595;Lokiukas;KODĖLČIUKAI;8796640190;Taip;7;1;0;8
20596;Lokiukas;KODĖLČIUKAI;8775608581;Taip;7;1;0;8
20597;Lokiukas;KODĖLČIUKAI;8915504279;Taip;6;4;0;10
20598;Lokiukas;KODĖLČIUKAI;4379238557;Taip;4;3;0;7
20599;Lokiukas;KODĖLČIUKAI;3694653020;Ne;0;9;0;9
20600;Lokiukas;KODĖLČIUKAI;4060641736;Ne;0;6;2;8
20601;Lokiukas;KODĖLČIUKAI;1025576053;Taip;10;0;0;10
20602;Lokiukas;KODĖLČIUKAI;1040288021;Taip;18;1;3;22
20603;Lokiukas;KODĖLČIUKAI;34546519642;Taip;0;3;1;4
20604;Lokiukas;KODĖLČIUKAI;9336617879;Taip;5;0;0;5
20605;Lokiukas;KODĖLČIUKAI;7943213321;Taip;2;3;0;5
20606;Lokiukas;KODĖLČIUKAI;6069516217;Taip;15;6;0;21
20607;Lokiukas;KODĖLČIUKAI;1752784666;Taip;10;3;1;14
20608;Lokiukas;KODĖLČIUKAI;4007839265;Taip;4;1;0;5
20609;Lokiukas;KODĖLČIUKAI;5467387832;Taip;8;1;0;9
20610;Lokiukas;KODĖLČIUKAI;9307491947;Taip;3;1;0;4
20611;Lokiukas;KODĖLČIUKAI;3744484616;Ne;4;1;0;5
20612;Lokiukas;KODĖLČIUKAI;8286358519;Taip;6;1;3;10
20613;Lokiukas;KODĖLČIUKAI;1886540733;Taip;5;2;0;7
20614;Lokiukas;KODĖLČIUKAI;8902619265;Taip;12;1;2;15
20615;Lokiukas;DRUGELIAI;1170293017;Taip;9;0;1;10
20616;Lokiukas;DRUGELIAI;4442073527;Taip;10;2;0;12
20617;Lokiukas;DRUGELIAI;2021477393;Taip;9;0;0;9
20618;Lokiukas;DRUGELIAI;4206181176;Taip;0;1;0;1
20619;Lokiukas;DRUGELIAI;7006828256;Taip;10;0;0;10
20620;Lokiukas;DRUGELIAI;7532603655;Taip;6;3;0;9
20621;Lokiukas;DRUGELIAI;4858829710;Taip;5;0;0;5
20622;Lokiukas;DRUGELIAI;8329540746;Taip;4;0;0;4
20623;Lokiukas;DRUGELIAI;2782818158;Ne;5;0;0;5
20624;Lokiukas;DRUGELIAI;4197547631;Taip;19;4;0;23
20625;Lokiukas;DRUGELIAI;8596706753;Taip;9;2;0;11
20626;Lokiukas;DRUGELIAI;4272205822;Ne;10;1;0;11
20627;Lokiukas;DRUGELIAI;2374601283;Taip;9;1;0;10
20628;Lokiukas;DRUGELIAI;7195184433;Taip;0;2;0;2
20629;Lokiukas;DRUGELIAI;4919744559;Taip;32;0;0;32
20630;Lokiukas;DRUGELIAI;6226281752;Taip;3;3;0;6
20631;Lokiukas;DRUGELIAI;1390586527;Taip;16;0;1;17
20632;Lokiukas;DRUGELIAI;8266708371;Taip;7;1;0;8
20633;Lokiukas;DRUGELIAI;2093224908;Taip;6;3;0;9
20634;Lokiukas;DRUGELIAI;1341265560;Taip;9;3;0;12
20635;Lokiukas;DRUGELIAI;5131662172;Ne;3;0;0;3
20636;Lokiukas;DRUGELIAI;1913742619;Ne;4;5;0;9
20637;Lokiukas;DRUGELIAI;4284574166;Ne;8;0;1;9
20638;Lokiukas;"2 A klasė";1201125655;Taip;3;1;0;4
20639;Lokiukas;"2 A klasė";2502465398;Taip;12;1;0;13
20640;Lokiukas;"2 A klasė";67133709394;Taip;12;1;0;13
20641;Lokiukas;"2 A klasė";73696992182;Ne;12;1;0;13
20642;Lokiukas;"2 A klasė";1056075876;Taip;7;1;0;8
20643;Lokiukas;"2 A klasė";9890308887;Taip;6;1;0;7
20644;Lokiukas;"2 A klasė";82025637099;Ne;8;1;0;9
20645;Lokiukas;"2 A klasė";8846527481;Taip;20;1;0;21
20646;Lokiukas;"2 A klasė";4353695640;Ne;7;1;0;8
20647;Lokiukas;"2 A klasė";73515179103;Taip;11;1;0;12
20648;Lokiukas;"2 A klasė";36677665098;Taip;3;1;0;4
20649;Lokiukas;"2 A klasė";131300206;Taip;3;1;0;4
20650;Lokiukas;"2 A klasė";77512682081;Taip;3;1;0;4
20651;Lokiukas;"2 A klasė";66528256040;Taip;3;1;0;4
20652;Lokiukas;"2 A klasė";86120193313;Taip;7;1;0;8
20653;Lokiukas;"2 A klasė";45028887854;Taip;2;1;0;3
20654;Lokiukas;"2 A klasė";83528495608;Taip;3;1;0;4
20655;Lokiukas;"2 A klasė";51237034253;Taip;4;1;0;5
20656;Lokiukas;"2 A klasė";52940830874;Taip;9;1;0;10
20657;Lokiukas;"2 A klasė";8240261104;Taip;3;1;0;4
20658;Lokiukas;"2 A klasė";27403835292;Taip;2;1;0;3
20659;Lokiukas;"2 A klasė";5104259667;Ne;11;1;0;12
20660;Lokiukas;"2 A klasė";83086633109;Taip;5;1;0;6
20661;Lokiukas;"2 A klasė";38884246104;Taip;3;1;0;4
20662;Lokiukas;"2 B klasė";7235277422;Taip;7;1;0;8
20663;Lokiukas;"2 B klasė";1133294157;Taip;0;1;0;1
20664;Lokiukas;"2 B klasė";1072148409;Taip;8;1;0;9
20665;Lokiukas;"2 B klasė";92373834478;Ne;14;1;0;15
20666;Lokiukas;"2 B klasė";2054450461;Taip;1;1;0;2
20667;Lokiukas;"2 B klasė";3255141230;Taip;21;1;0;22
20668;Lokiukas;"2 B klasė";3255141230;Taip;21;1;0;22
20669;Lokiukas;"2 B klasė";14234831040;Taip;9;1;0;10
20670;Lokiukas;"2 B klasė";57505829630;Taip;0;1;0;1
20671;Lokiukas;"2 B klasė";7334971595;Taip;10;1;0;11
20672;Lokiukas;"2 B klasė";51059574159;Taip;8;1;0;9
20673;Lokiukas;"2 B klasė";4662981914;Taip;3;1;0;4
20674;Lokiukas;"2 B klasė";2959877846;Taip;24;1;0;25
20675;Lokiukas;"2 B klasė";6414861823;Taip;21;1;0;22
20676;Lokiukas;"2 B klasė";7130407913;Taip;21;1;0;22
20677;Lokiukas;"2 B klasė";98045145204;Taip;2;1;0;3
20678;Lokiukas;"2 B klasė";68390568000;Taip;0;1;0;1
20679;Lokiukas;"2 B klasė";8980902068;Taip;9;1;0;10
20680;Lokiukas;"2 B klasė";4164426360;Taip;8;1;0;9
20681;Lokiukas;"2 B klasė";14937983736;Taip;9;1;0;10
20682;Lokiukas;"2 B klasė";8996622650;Taip;8;1;0;9
20683;Lokiukas;"2 B klasė";61807094999;Taip;12;1;0;13
20684;Lokiukas;"2 B klasė";2078673522;Taip;2;1;0;3
20685;Lokiukas;"2 B klasė";40006848965;Taip;12;1;0;13
20686;Lokiukas;"2 B klasė";32714964224;Taip;5;1;0;6
20687;Lokiukas;"2 B klasė";8920359311;Taip;3;1;0;4
20688;Lokiukas;"2 B klasė";38001876942;Ne;10;1;0;11
20689;Lokiukas;"3 A klasė";25170045140;Taip;22;0;0;22
20690;Lokiukas;"3 A klasė";15406362908;Taip;18;1;0;19
20691;Lokiukas;"3 A klasė";45122233067;Taip;7;1;0;8
20692;Lokiukas;"3 A klasė";15685936471;Taip;2;1;0;3
20693;Lokiukas;"3 A klasė";10948160841;Taip;21;1;0;22
20694;Lokiukas;"3 A klasė";21802863853;Taip;7;1;0;8
20695;Lokiukas;"3 A klasė";29577495646;Taip;5;1;0;6
20696;Lokiukas;"3 A klasė";22979689191;Taip;12;1;0;13
20697;Lokiukas;"3 A klasė";80754592972;Taip;11;1;0;12
20698;Lokiukas;"3 A klasė";14903100496;Taip;3;1;0;4
20699;Lokiukas;"3 A klasė";97609897018;Taip;3;1;0;4
20700;Lokiukas;"3 A klasė";4608275224;Taip;7;1;0;8
20701;Lokiukas;"3 A klasė";99706061553;Taip;8;1;0;9
20702;Lokiukas;"3 A klasė";7785940412;Taip;1;1;0;2
20703;Lokiukas;"3 A klasė";24099693663;Taip;21;1;0;22
20704;Lokiukas;"3 A klasė";72092394330;Taip;6;1;0;7
20705;Lokiukas;"3 A klasė";35769782473;Taip;2;1;0;3
20706;Lokiukas;"3 A klasė";23688235312;Taip;5;1;0;6
20707;Lokiukas;"3 A klasė";43070670534;Taip;6;1;0;7
20708;Lokiukas;"3 A klasė";38531751377;Taip;10;1;0;11
20709;Lokiukas;"3 A klasė";15574258138;Taip;10;1;0;11
20710;Lokiukas;"3 A klasė";59840033826;Taip;8;1;0;9
20711;Lokiukas;"3 A klasė";24523198513;Taip;21;1;0;22
20712;Lokiukas;"3 A klasė";84273668685;Taip;6;1;0;7
20713;Lokiukas;"3 A klasė";9077016953;Taip;2;1;0;3
20714;Lokiukas;"3 A klasė";9747265775;Taip;21;1;0;22
20715;Lokiukas;"3 A klasė";5198408183;Taip;5;1;0;6
20716;Lokiukas;"3 A klasė";80793623068;Ne;7;1;0;8
20717;Lokiukas;"3 A klasė";93374754851;Taip;0;1;0;1
20718;Lokiukas;"3 B klasė";5311341721;Taip;21;1;0;22
20719;Lokiukas;"3 B klasė";61890775725;Taip;15;1;0;16
20720;Lokiukas;"3 B klasė";32506466236;Taip;8;1;0;9
20721;Lokiukas;"3 B klasė";24221829774;Taip;8;1;0;9
20722;Lokiukas;"3 B klasė";96046361641;Taip;8;1;0;9
20723;Lokiukas;"3 B klasė";7324496782;Taip;9;1;0;10
20724;Lokiukas;"3 B klasė";95910336503;Taip;20;1;0;21
20725;Lokiukas;"3 B klasė";58513885211;Taip;4;1;0;5
20726;Lokiukas;"3 B klasė";57958699478;Taip;2;1;0;3
20727;Lokiukas;"3 B klasė";10811780420;Taip;5;1;0;6
20728;Lokiukas;"3 B klasė";18646642032;Taip;2;1;0;3
20729;Lokiukas;"3 B klasė";79109699217;Taip;2;1;0;3
20730;Lokiukas;"3 B klasė";50713289266;Taip;21;1;0;22
20731;Lokiukas;"3 B klasė";20231469825;Taip;7;1;0;8
20732;Lokiukas;"3 B klasė";18336619115;Ne;3;1;0;4
20733;Lokiukas;"3 B klasė";2105377652;Taip;6;1;0;7
20734;Lokiukas;"3 B klasė";39867459515;Taip;9;1;0;10
20735;Lokiukas;"3 B klasė";1146878499;Taip;10;1;0;11
20736;Lokiukas;"3 B klasė";46587243900;Taip;9;1;0;10
20737;Lokiukas;"3 B klasė";62268017779;Taip;12;1;0;13
20738;Lokiukas;"3 B klasė";28796727185;Taip;20;1;0;21
20739;Lokiukas;"3 B klasė";88415635113;Taip;17;1;0;18
20740;Lokiukas;"3 B klasė";9141446821;Taip;7;1;0;8
20741;Lokiukas;"3 B klasė";7497324442;Taip;21;1;0;22
20742;Lokiukas;"3 B klasė";7903535850;Taip;9;1;0;10
20743;Lokiukas;"3 B klasė";75507005694;Taip;4;1;0;5
20744;Lokiukas;"3 B klasė";73426072972;Taip;5;1;0;6
20745;Lokiukas;"3 B klasė";59913848400;Taip;5;1;0;6
20746;Lokiukas;"4 A klasė";67818191566;Ne;6;1;0;7
20747;Lokiukas;"4 A klasė";45280536946;Taip;21;1;0;22
20748;Lokiukas;"4 A klasė";53087036306;Taip;0;1;0;1
20749;Lokiukas;"4 A klasė";79223457439;Taip;13;1;0;14
20750;Lokiukas;"4 A klasė";75613665040;Taip;0;1;0;1
20751;Lokiukas;"4 A klasė";10240586503;Taip;4;1;0;5
20752;Lokiukas;"4 A klasė";86623153797;Taip;2;1;0;3
20753;Lokiukas;"4 A klasė";27050402360;Taip;1;1;0;2
20754;Lokiukas;"4 A klasė";43389930516;Taip;6;1;0;7
20755;Lokiukas;"4 A klasė";23222644824;Taip;8;1;0;9
20756;Lokiukas;"4 A klasė";52296454506;Taip;6;1;0;7
20757;Lokiukas;"4 A klasė";66999644935;Taip;21;1;0;22
20758;Lokiukas;"4 A klasė";72167964645;Taip;17;1;0;18
20759;Lokiukas;"4 A klasė";2143040924;Taip;27;1;0;28
20760;Lokiukas;"4 A klasė";3206276637;Ne;21;1;0;22
20761;Lokiukas;"4 A klasė";5775631777;Taip;12;1;0;13
20762;Lokiukas;"4 A klasė";3703002168;Taip;7;1;0;8
20763;Lokiukas;"4 A klasė";38636200254;Taip;5;1;0;6
20764;Lokiukas;"4 A klasė";47410036889;Taip;1;1;0;2
20765;Lokiukas;"4 A klasė";53544600623;Taip;2;1;0;3
20766;Lokiukas;"4 A klasė";6702448475;Taip;3;1;0;4
20767;Lokiukas;"4 A klasė";82966541165;Taip;11;1;0;12
20768;Lokiukas;"4 A klasė";42292408557;Taip;21;1;0;22
20769;Lokiukas;"4 B klasė";35018370441;Taip;11;1;0;12
20770;Lokiukas;"4 B klasė";60370754283;Taip;1;1;0;2
20771;Lokiukas;"4 B klasė";98289469398;Taip;5;1;0;6
20772;Lokiukas;"4 B klasė";15445053855;Taip;14;1;0;15
20773;Lokiukas;"4 B klasė";3262579895;Taip;7;1;0;8
20774;Lokiukas;"4 B klasė";51554951703;Taip;21;1;0;22
20775;Lokiukas;"4 B klasė";88947878548;Taip;11;1;0;12
20776;Lokiukas;"4 B klasė";29198900240;Taip;5;1;0;6
20777;Lokiukas;"4 B klasė";77441549037;Taip;3;1;0;4
20778;Lokiukas;"4 B klasė";79301547085;Taip;8;1;0;9
20779;Lokiukas;"4 B klasė";10897713744;Taip;0;1;0;1
20780;Lokiukas;"4 B klasė";16889795010;Taip;21;1;0;22
20781;Lokiukas;"4 B klasė";5067673212;Taip;5;1;0;6
20782;Lokiukas;"4 B klasė";1424195731;Taip;21;1;0;22
20783;Lokiukas;"4 B klasė";1104333637;Taip;5;1;0;6
20784;Lokiukas;"4 B klasė";69089214980;Taip;6;1;0;7
20785;Lokiukas;"4 B klasė";45735190114;Taip;21;1;0;22
20786;Lokiukas;"4 B klasė";2353550739;Taip;9;1;0;10
20787;Lokiukas;"4 B klasė";15004419516;Taip;6;1;0;7
20788;Lokiukas;"4 B klasė";2388111003;Taip;0;1;0;1
20789;Lokiukas;"4 B klasė";1245850082;Taip;25;1;0;26
20790;Šaltinėlis;Ančiukų;3901200729;Taip;26;0;0;26
20791;Šaltinėlis;Ančiukų;1312785137;Taip;8;4;0;12
20792;Šaltinėlis;Ančiukų;9209105445;Taip;15;3;0;18
20793;Šaltinėlis;Ančiukų;9112527921;Taip;16;0;0;16
20794;Šaltinėlis;Ančiukų;9398488555;Taip;5;1;0;6
20795;Šaltinėlis;Ančiukų;2027779524;Taip;7;1;0;8
20796;Šaltinėlis;Ančiukų;5498764523;Taip;6;2;0;8
20797;Šaltinėlis;Ančiukų;4226929875;Taip;13;3;0;16
20798;Šaltinėlis;Ančiukų;1489377928;Taip;19;1;0;20
20799;Šaltinėlis;Ančiukų;7325258256;Ne;0;8;0;8
20800;Šaltinėlis;Ančiukų;5005394548;Taip;18;1;0;19
20801;Šaltinėlis;Ančiukų;1102861619;Taip;10;3;0;13
20802;Šaltinėlis;Ančiukų;1928794692;Taip;10;3;0;13
20803;Šaltinėlis;Ančiukų;1742421427;Taip;6;1;0;7
20804;Šaltinėlis;Ančiukų;9581384663;Taip;18;0;0;18
20805;Šaltinėlis;Ančiukų;9465174636;Taip;22;0;0;22
20806;Šaltinėlis;Ančiukų;8034195267;Taip;0;7;0;7
20807;Šaltinėlis;Ančiukų;5455997139;Ne;10;3;0;13
20808;Šaltinėlis;Ančiukų;9588260206;Taip;11;3;0;14
20809;Šaltinėlis;Ančiukų;8116985061;Ne;18;0;0;18
20810;Šaltinėlis;Bitučių;9983153464;Taip;12;0;0;12
20811;Šaltinėlis;Bitučių;6487378225;Taip;26;0;0;26
20812;Šaltinėlis;Bitučių;56396772538;Taip;5;0;0;5
20813;Šaltinėlis;Bitučių;5251390843;Ne;8;1;0;9
20814;Šaltinėlis;Bitučių;8500790262;Taip;12;0;0;12
20815;Šaltinėlis;Bitučių;4332884673;Taip;16;0;0;16
20816;Šaltinėlis;Bitučių;3493429067;Taip;10;1;0;11
20817;Šaltinėlis;Bitučių;9362495172;Taip;4;7;0;11
20818;Šaltinėlis;Bitučių;6462738640;Taip;6;3;0;9
20819;Šaltinėlis;Bitučių;77872075694;Taip;0;2;0;2
20820;Šaltinėlis;Bitučių;7133143923;Taip;10;9;0;19
20821;Šaltinėlis;Bitučių;6887838949;Taip;17;2;0;19
20822;Šaltinėlis;Bitučių;2630875135;Taip;5;2;0;7
20823;Šaltinėlis;Bitučių;9218883174;Taip;6;1;0;7
20824;Šaltinėlis;Bitučių;2973820849;Taip;15;0;0;15
20825;Šaltinėlis;Bitučių;9820788524;Taip;15;1;0;16
20826;Šaltinėlis;Bitučių;9769491789;Taip;10;3;0;13
20827;Šaltinėlis;Bitučių;9274165569;Taip;4;4;0;8
20828;Šaltinėlis;Bitučių;3691635011;Taip;3;1;0;4
20829;Šaltinėlis;Bitučių;2084451705;Taip;15;0;0;15
20830;Šaltinėlis;Bitučių;8555517284;Taip;10;1;0;11
20831;Šaltinėlis;Bitučių;1543331408;Taip;4;2;0;6
20832;Šaltinėlis;Bitučių;7483928256;Taip;5;3;0;8
20833;Šaltinėlis;Bitučių;2646901307;Taip;19;1;0;20
20834;Šaltinėlis;Bitučių;7737797979;Taip;9;3;0;12
20835;Šaltinėlis;Bitučių;3017437426;Taip;0;6;0;6
20836;Šaltinėlis;Saulutės;7311831014;Ne;9;2;0;11
20837;Šaltinėlis;Saulutės;5854723120;Taip;5;9;0;14
20838;Šaltinėlis;Saulutės;5833136956;Taip;5;1;0;6
20839;Šaltinėlis;Saulutės;3483756240;Taip;0;5;0;5
20840;Šaltinėlis;Saulutės;6380346298;Taip;0;2;0;2
20841;Šaltinėlis;Saulutės;5799032398;Taip;20;0;0;20
20842;Šaltinėlis;Saulutės;5525740049;Ne;0;7;0;7
20843;Šaltinėlis;Saulutės;5382567842;Taip;0;1;0;1
20844;Šaltinėlis;Saulutės;4743907195;Taip;15;0;0;15
20845;Šaltinėlis;Saulutės;5343279219;Taip;5;0;0;5
20846;Šaltinėlis;Saulutės;7118672118;Taip;4;3;0;7
20847;Šaltinėlis;Saulutės;2465009553;Taip;5;1;0;6
20848;Šaltinėlis;Saulutės;5345738219;Taip;15;0;0;15
20849;Šaltinėlis;Saulutės;6721510313;Ne;8;0;0;8
20850;Šaltinėlis;Saulutės;7650840990;Taip;18;1;0;19
20851;Šaltinėlis;Saulutės;1678450741;Taip;13;1;0;14
20852;Šaltinėlis;Saulutės;5774391181;Ne;2;1;0;3
20853;Šaltinėlis;Saulutės;4681460322;Taip;6;4;0;10
20854;Šaltinėlis;Saulutės;3968514430;Taip;0;4;0;4
20855;Šaltinėlis;Saulutės;8950694484;Ne;13;0;0;13
20856;Šaltinėlis;Saulutės;2499890317;Taip;7;2;0;9
20857;Šaltinėlis;Saulutės;3579974049;Taip;3;4;0;7
20858;Šaltinėlis;Meškiukų;6915625306;Taip;9;0;0;9
20859;Šaltinėlis;Meškiukų;6645807642;Taip;0;3;0;3
20860;Šaltinėlis;Meškiukų;9759912102;Ne;13;0;0;13
20861;Šaltinėlis;Meškiukų;4664741207;Taip;15;1;1;17
20862;Šaltinėlis;Meškiukų;1400918201;Ne;15;3;0;18
20863;Šaltinėlis;Meškiukų;5420067622;Taip;0;3;0;3
20864;Šaltinėlis;Meškiukų;1656674673;Taip;0;8;0;8
20865;Šaltinėlis;Meškiukų;4248763165;Taip;6;0;0;6
20866;Šaltinėlis;Meškiukų;5982018366;Ne;8;0;0;8
20867;Šaltinėlis;Meškiukų;9922223978;Taip;22;0;0;22
20868;Šaltinėlis;Meškiukų;8995077908;Taip;14;6;0;20
20869;Šaltinėlis;Meškiukų;5982188743;Ne;5;1;0;6
20870;Šaltinėlis;Meškiukų;6586783795;Taip;10;3;1;14
20871;Šaltinėlis;Meškiukų;7468640592;Taip;8;1;0;9
20872;Šaltinėlis;Meškiukų;4064231806;Taip;3;3;0;6
20873;Šaltinėlis;Meškiukų;4159654434;Taip;9;0;0;9
20874;Šaltinėlis;Meškiukų;6688536661;Taip;6;8;0;14
20875;Šaltinėlis;Meškiukų;8880659539;Ne;8;4;0;12
20876;Šaltinėlis;Meškiukų;3228788999;Taip;2;3;0;5
20877;Šaltinėlis;Meškiukų;5905345563;Taip;8;10;0;18
20878;Šaltinėlis;Meškiukų;2332065937;Ne;6;2;1;9
20879;Šaltinėlis;Nykštukai;9766640995;Ne;22;0;0;22
20880;Šaltinėlis;Nykštukai;3356138058;Taip;15;0;0;15
20881;Šaltinėlis;Nykštukai;5434349511;Ne;22;0;0;22
20882;Šaltinėlis;Nykštukai;4226068669;Taip;9;0;0;9
20883;Šaltinėlis;Nykštukai;2976773344;Ne;13;1;0;14
20884;Šaltinėlis;Nykštukai;3687243030;Taip;5;7;0;12
20885;Šaltinėlis;Nykštukai;4364256563;Taip;21;0;0;21
20886;Šaltinėlis;Nykštukai;9333013048;Taip;4;0;0;4
20887;Šaltinėlis;Nykštukai;4029616063;Taip;4;2;0;6
20888;Šaltinėlis;Nykštukai;6530797082;Taip;8;2;0;10
20889;Šaltinėlis;Nykštukai;7534585887;Taip;3;5;0;8
20890;Šaltinėlis;Nykštukai;8977029692;Taip;0;3;0;3
20891;Šaltinėlis;Nykštukai;7120592596;Taip;16;0;0;16
20892;Šaltinėlis;Nykštukai;6244924079;Taip;28;0;0;28
20893;Šaltinėlis;Nykštukai;3806267811;Taip;8;5;0;13
20894;Šaltinėlis;Nykštukai;3497881408;Ne;4;5;0;9
20895;Šaltinėlis;Nykštukai;6383844995;Taip;21;0;0;21
20896;Šaltinėlis;Perliukų;2825412170;Taip;8;3;0;11
20897;Šaltinėlis;Perliukų;1686009371;Taip;18;3;0;21
20898;Šaltinėlis;Perliukų;9522524163;Ne;4;13;0;17
20899;Šaltinėlis;Perliukų;9075507649;Taip;9;0;0;9
20900;Šaltinėlis;Perliukų;7068058767;Taip;0;10;0;10
20901;Šaltinėlis;Perliukų;2189112609;Taip;20;0;0;20
20902;Šaltinėlis;Perliukų;8914777163;Taip;0;9;0;9
20903;Šaltinėlis;Perliukų;7387221265;Taip;18;0;0;18
20904;Šaltinėlis;Perliukų;9674923143;Taip;0;6;0;6
20905;Šaltinėlis;Perliukų;1823048790;Taip;5;0;0;5
20906;Šaltinėlis;Perliukų;3073692882;Taip;3;6;0;9
20907;Šaltinėlis;Perliukų;5325974488;Taip;4;5;0;9
20908;Šaltinėlis;Perliukų;2022956307;Ne;10;1;0;11
20909;Šaltinėlis;Perliukų;2126751248;Taip;18;0;0;18
20910;Šaltinėlis;Perliukų;3271931810;Taip;9;5;0;14
20911;Šaltinėlis;Perliukų;7955094634;Taip;9;0;1;10
20912;Šaltinėlis;Perliukų;1445108285;Taip;8;2;0;10
20913;Šaltinėlis;Perliukų;7133044918;Taip;24;0;0;24
20914;Šaltinėlis;Perliukų;2806453623;Taip;0;6;0;6
20915;Šaltinėlis;Perliukų;9691993251;Taip;0;3;1;4
20916;Šaltinėlis;Perliukų;8695191968;Taip;0;5;0;5
20917;Šaltinėlis;Perliukų;4430546695;Taip;11;3;0;14
20918;Šaltinėlis;BORUŽĖLĖS;9613234759;Taip;13;3;0;16
20919;Šaltinėlis;BORUŽĖLĖS;3505001330;Taip;22;0;0;22
20920;Šaltinėlis;BORUŽĖLĖS;8973369897;Taip;13;5;0;18
20921;Šaltinėlis;BORUŽĖLĖS;3780870805;Taip;0;5;0;5
20922;Šaltinėlis;BORUŽĖLĖS;2157520281;Taip;12;1;0;13
20923;Šaltinėlis;BORUŽĖLĖS;8995954572;Taip;13;0;0;13
20924;Šaltinėlis;BORUŽĖLĖS;4742849747;Taip;3;5;0;8
20925;Šaltinėlis;BORUŽĖLĖS;5996579651;Taip;6;3;0;9
20926;Šaltinėlis;BORUŽĖLĖS;5331397179;Ne;6;2;0;8
20927;Šaltinėlis;BORUŽĖLĖS;1238867065;Taip;11;1;0;12
20928;Šaltinėlis;BORUŽĖLĖS;9218436977;Taip;6;2;0;8
20929;Šaltinėlis;BORUŽĖLĖS;5593692486;Taip;17;0;0;17
20930;Šaltinėlis;BORUŽĖLĖS;1496105338;Taip;5;0;0;5
20931;Šaltinėlis;1A;9188065549;Ne;0;11;0;11
20932;Šaltinėlis;1A;9305706589;Ne;0;2;0;2
20933;Šaltinėlis;1A;1580090516;Taip;0;10;0;10
20934;Šaltinėlis;1A;2034838765;Taip;0;1;0;1
20935;Šaltinėlis;1A;2105963102;Taip;0;9;0;9
20936;Šaltinėlis;1A;3582666579;Taip;0;10;0;10
20937;Šaltinėlis;1A;46569341613;Taip;0;10;0;10
20938;Šaltinėlis;1A;2801321116;Taip;0;9;0;9
20939;Šaltinėlis;1A;1091056386;Taip;0;7;0;7
20940;Šaltinėlis;1A;52142182972;Taip;0;22;0;22
20941;Šaltinėlis;1A;6880337593;Ne;0;6;0;6
20942;Šaltinėlis;1A;3516760367;Taip;0;8;0;8
20943;Šaltinėlis;1A;56542341895;Ne;0;12;0;12
20944;Šaltinėlis;1A;1910670134;Taip;0;9;0;9
20945;Šaltinėlis;1A;9595350871;Taip;0;7;0;7
20946;Šaltinėlis;1A;15925823621;Taip;0;1;0;1
20947;Šaltinėlis;1A;8902634958;Taip;0;2;0;2
20948;Šaltinėlis;1A;9757246434;Taip;0;13;0;13
20949;Šaltinėlis;1A;7262120071;Ne;0;6;0;6
20950;Šaltinėlis;1A;1004445904;Taip;0;7;0;7
20951;Šaltinėlis;"2A klasė";32264290873;Taip;0;4;0;4
20952;Šaltinėlis;"2A klasė";1767635282;Taip;0;10;0;10
20953;Šaltinėlis;"2A klasė";1390316465;Taip;0;4;0;4
20954;Šaltinėlis;"2A klasė";5442943843;Taip;0;2;0;2
20955;Šaltinėlis;"2A klasė";6764006747;Taip;0;1;0;1
20956;Šaltinėlis;"2A klasė";1658370782;Taip;0;1;0;1
20957;Šaltinėlis;"2A klasė";10918276041;Taip;0;1;0;1
20958;Šaltinėlis;"2A klasė";3455754351;Taip;0;22;0;22
20959;Šaltinėlis;"2A klasė";66575684640;Taip;0;1;0;1
20960;Šaltinėlis;"2A klasė";86592374576;Taip;0;22;0;22
20961;Šaltinėlis;"2A klasė";13808708760;Taip;0;6;0;6
20962;Šaltinėlis;"2A klasė";1614411921;Ne;0;10;0;10
20963;Šaltinėlis;"2A klasė";79406746980;Taip;0;19;0;19
20964;Šaltinėlis;"2A klasė";3577137327;Taip;0;8;0;8
20965;Šaltinėlis;"2A klasė";1224027643;Taip;0;2;0;2
20966;Šaltinėlis;"2A klasė";48525545812;Taip;0;3;0;3
20967;Šaltinėlis;"2A klasė";7073644279;Taip;0;15;0;15
20968;Šaltinėlis;"2A klasė";3022926855;Ne;0;2;0;2
20969;Šaltinėlis;"2A klasė";1190394855;Taip;0;9;0;9
20970;Šaltinėlis;"2A klasė";40186714037;Taip;0;1;0;1
20971;Šaltinėlis;"2A klasė";1456486363;Taip;0;2;0;2
20972;Šaltinėlis;"2A klasė";32949623652;Taip;0;3;0;3
20973;Šaltinėlis;"3A klasė";14213856824;Taip;0;1;0;1
20974;Šaltinėlis;"3A klasė";80649337160;Taip;0;1;0;1
20975;Šaltinėlis;"3A klasė";92958012146;Taip;0;10;0;10
20976;Šaltinėlis;"3A klasė";84656960510;Taip;0;10;0;10
20977;Šaltinėlis;"3A klasė";83621946293;Taip;0;22;0;22
20978;Šaltinėlis;"3A klasė";67808618878;Ne;0;22;0;22
20979;Šaltinėlis;"3A klasė";1278910777;Taip;7;1;0;8
20980;Šaltinėlis;"3A klasė";9647785988;Taip;0;22;0;22
20981;Šaltinėlis;"3A klasė";82671662416;Taip;10;1;0;11
20982;Šaltinėlis;"3A klasė";54025577281;Taip;0;6;0;6
20983;Šaltinėlis;"3A klasė";488285764;Taip;0;1;0;1
20984;Šaltinėlis;"3A klasė";29482180151;Taip;0;1;0;1
20985;Šaltinėlis;"3A klasė";54753218491;Taip;0;22;0;22
20986;Šaltinėlis;"3A klasė";86029472773;Taip;0;22;0;22
20987;Šaltinėlis;"3A klasė";64821172553;Taip;0;5;0;5
20988;Šaltinėlis;"3A klasė";5744976843;Taip;0;8;0;8
20989;Šaltinėlis;"3A klasė";25459069972;Ne;0;10;0;10
20990;Šaltinėlis;"3A klasė";6669392157;Taip;0;8;0;8
20991;Šaltinėlis;"3A klasė";89358384113;Taip;0;14;0;14
20992;Šaltinėlis;"3A klasė";28956971978;Taip;0;1;0;1
20993;Šaltinėlis;"3A klasė";4050444191;Taip;0;4;0;4
20994;Šaltinėlis;"3A klasė";89093437170;Taip;0;3;0;3
20995;Šaltinėlis;"3A klasė";51872331010;Taip;0;16;0;16
20996;Šaltinėlis;"4A klasė";83657465071;Taip;0;21;0;21
20997;Šaltinėlis;"4A klasė";86309198604;Taip;0;3;0;3
20998;Šaltinėlis;"4A klasė";9705941341;Taip;0;22;0;22
20999;Šaltinėlis;"4A klasė";38496350161;Taip;0;22;0;22
21000;Šaltinėlis;"4A klasė";62612067151;Ne;0;3;0;3
21001;Šaltinėlis;"4A klasė";96133834896;Taip;0;22;0;22
21002;Šaltinėlis;"4A klasė";73466313766;Taip;0;2;0;2
21003;Šaltinėlis;"4A klasė";2323456393;Taip;0;22;0;22
21004;Šaltinėlis;"4A klasė";56279691365;Taip;0;1;0;1
21005;Šaltinėlis;"4A klasė";4587186145;Taip;10;5;0;15
21006;Šaltinėlis;"4A klasė";70948186548;Taip;0;6;0;6
21007;Šaltinėlis;"4A klasė";47045578599;Ne;10;3;0;13
21008;Šaltinėlis;"4A klasė";36718328105;Taip;0;9;0;9
21009;Šaltinėlis;"4A klasė";86995081866;Taip;0;9;0;9
21010;Šaltinėlis;"4A klasė";7929809205;Ne;0;5;0;5
21011;Šaltinėlis;"4A klasė";29683761586;Ne;0;4;0;4
21012;Šaltinėlis;"4A klasė";9842958341;Ne;0;9;0;9
21013;Šaltinėlis;"4A klasė";40769315138;Taip;0;13;0;13
21014;Šaltinėlis;"4A klasė";7563879445;Taip;0;6;0;6
21015;Šaltinėlis;"4A klasė";66754907606;Ne;0;22;0;22
21016;Šaltinėlis;"4A klasė";35387543586;Taip;0;12;0;12
21017;Šaltinėlis;"4A klasė";6056572441;Ne;0;9;0;9
21018;Šaltinėlis;"4A klasė";9927833966;Ne;0;6;0;6
21019;Šaltinėlis;3B;93256161233;Taip;0;6;0;6
21020;Šaltinėlis;3B;83173349544;Taip;0;3;0;3
21021;Šaltinėlis;3B;39088869084;Taip;0;4;0;4
21022;Šaltinėlis;3B;1422035829;Taip;0;1;0;1
21023;Šaltinėlis;3B;7711903999;Ne;0;3;0;3
21024;Šaltinėlis;3B;95542489944;Ne;0;2;0;2
21025;Šaltinėlis;3B;3072314714;Taip;0;3;0;3
21026;Šaltinėlis;3B;1220687492;Taip;0;1;0;1
21027;Šaltinėlis;3B;74337710550;Taip;0;2;0;2
21028;Šaltinėlis;3B;35401075864;Taip;0;1;0;1
21029;Šaltinėlis;3B;19630605543;Taip;0;9;0;9
21030;Šaltinėlis;3B;84522552145;Taip;0;13;0;13
21031;Šaltinėlis;3B;3626545396;Ne;0;5;0;5
21032;Šaltinėlis;3B;6317111400;Taip;0;1;0;1
21033;Šaltinėlis;3B;4762756751;Ne;0;7;0;7
21034;Šaltinėlis;3B;72372808270;Taip;0;1;0;1
21035;Šaltinėlis;3B;1924418657;Taip;0;3;0;3
21036;Šaltinėlis;3B;77194317310;Taip;0;1;0;1
21037;Šaltinėlis;3B;57847832778;Taip;0;3;0;3
21038;Šaltinėlis;3B;2099800744;Taip;0;1;0;1
21039;Šaltinėlis;3B;70315400705;Taip;0;1;0;1
21040;Šaltinėlis;3B;81082410620;Taip;0;2;0;2
21041;Šaltinėlis;1B;84494627465;Taip;0;1;0;1
21042;Šaltinėlis;1B;2146141461;Taip;0;1;0;1
21043;Šaltinėlis;1B;6068980312;Taip;0;5;0;5
21044;Šaltinėlis;1B;9425353041;Taip;0;3;0;3
21045;Šaltinėlis;1B;17147527171;Taip;0;22;0;22
21046;Šaltinėlis;1B;1935762293;Taip;0;3;0;3
21047;Šaltinėlis;1B;1716801722;Taip;0;1;0;1
21048;Šaltinėlis;1B;2333071711;Taip;0;6;0;6
21049;Šaltinėlis;1B;23301579810;Taip;0;1;0;1
21050;Šaltinėlis;1B;52507085619;Taip;0;1;0;1
21051;Šaltinėlis;1B;1023238509;Taip;0;3;0;3
21052;Šaltinėlis;1B;526307704;Taip;0;13;0;13
21053;Šaltinėlis;1B;1958647188;Taip;0;5;0;5
21054;Šaltinėlis;1B;1583520894;Taip;0;22;0;22
21055;Šaltinėlis;1B;11083638216;Taip;0;6;0;6
21056;Šaltinėlis;PELĖDŽIUKAI;8973208195;Taip;0;1;1;2
21057;Šaltinėlis;PELĖDŽIUKAI;1367082230;Taip;12;1;0;13
21058;Šaltinėlis;PELĖDŽIUKAI;4387568448;Taip;0;3;2;5
21059;Šaltinėlis;PELĖDŽIUKAI;7723290276;Taip;0;14;0;14
21060;Šaltinėlis;PELĖDŽIUKAI;1348724947;Taip;0;22;0;22
21061;Šaltinėlis;PELĖDŽIUKAI;2658414287;Taip;12;2;0;14
21062;Šaltinėlis;PELĖDŽIUKAI;3638565578;Taip;5;3;0;8
21063;Šaltinėlis;PELĖDŽIUKAI;8721116918;Taip;5;3;0;8
21064;Šaltinėlis;PELĖDŽIUKAI;7211267255;Taip;0;3;0;3
21065;Šaltinėlis;PELĖDŽIUKAI;1040333590;Taip;0;5;0;5
21066;Šaltinėlis;PELĖDŽIUKAI;3660687688;Taip;0;8;0;8
21067;Šaltinėlis;PELĖDŽIUKAI;5869977541;Ne;5;3;0;8
21068;Šaltinėlis;PELĖDŽIUKAI;3609939325;Ne;6;0;0;6
21069;Šaltinėlis;PELĖDŽIUKAI;9108653045;Taip;9;2;0;11
21070;Šaltinėlis;PELĖDŽIUKAI;9762392403;Taip;0;3;0;3
21071;Šaltinėlis;PELĖDŽIUKAI;2230403251;Ne;5;3;0;8
21072;Šaltinėlis;PELĖDŽIUKAI;7918995181;Taip;8;3;1;12
21073;Šaltinėlis;PELĖDŽIUKAI;9673105905;Ne;0;3;2;5
21074;Šaltinėlis;PELĖDŽIUKAI;5099997904;Taip;0;3;6;9
21075;Gabijėlė;GANDRIUKŲ;4498088417;Taip;0;1;10;11
21076;Gabijėlė;GANDRIUKŲ;2277489032;Ne;0;0;3;3
21077;Gabijėlė;GANDRIUKŲ;8994076883;Ne;0;0;4;4
21078;Gabijėlė;GANDRIUKŲ;7087892822;Taip;9;1;0;10
21079;Gabijėlė;GANDRIUKŲ;5057272847;Taip;0;3;13;16
21080;Gabijėlė;GANDRIUKŲ;3548399391;Ne;6;1;6;13
21081;Gabijėlė;GANDRIUKŲ;3532989398;Taip;0;2;1;3
21082;Gabijėlė;GANDRIUKŲ;2215880644;Taip;0;1;0;1
21083;Gabijėlė;GANDRIUKŲ;3799003783;Taip;5;3;2;10
21084;Gabijėlė;GANDRIUKŲ;5513530983;Ne;0;0;2;2
21085;Gabijėlė;GANDRIUKŲ;9581539166;Taip;10;1;0;11
21086;Gabijėlė;GANDRIUKŲ;6004026516;Taip;0;4;1;5
21087;Gabijėlė;GANDRIUKŲ;4634029418;Taip;6;3;0;9
21088;Gabijėlė;GANDRIUKŲ;4328252445;Taip;8;1;0;9
21089;Gabijėlė;GANDRIUKŲ;9706026832;Taip;5;2;0;7
21090;Gabijėlė;GANDRIUKŲ;2491503656;Taip;0;7;0;7
21091;Gabijėlė;GANDRIUKŲ;8904768332;Taip;7;0;0;7
21092;Gabijėlė;GANDRIUKŲ;5715645968;Taip;5;0;1;6
21093;Gabijėlė;GANDRIUKŲ;8572833698;Taip;4;0;0;4
21094;Gabijėlė;GANDRIUKŲ;8646572151;Taip;0;0;4;4
21095;Gabijėlė;GANDRIUKŲ;5054419205;Ne;18;2;0;20
21096;Gabijėlė;GANDRIUKŲ;7530976246;Taip;13;0;3;16
21097;Gabijėlė;GANDRIUKŲ;3920525584;Taip;18;0;0;18
21098;Gabijėlė;GANDRIUKŲ;2682112101;Taip;0;3;3;6
21099;Gabijėlė;LAKŠTINGALIUKŲ;7019425859;Taip;0;8;1;9
21100;Gabijėlė;LAKŠTINGALIUKŲ;1611004144;Taip;5;3;2;10
21101;Gabijėlė;LAKŠTINGALIUKŲ;5862882027;Taip;0;1;8;9
21102;Gabijėlė;LAKŠTINGALIUKŲ;8798786098;Taip;15;1;0;16
21103;Gabijėlė;LAKŠTINGALIUKŲ;8035360208;Taip;21;1;0;22
21104;Gabijėlė;LAKŠTINGALIUKŲ;2384469423;Taip;15;3;1;19
21105;Gabijėlė;LAKŠTINGALIUKŲ;8167646385;Taip;0;1;3;4
21106;Gabijėlė;LAKŠTINGALIUKŲ;8926268619;Taip;10;0;5;15
21107;Gabijėlė;LAKŠTINGALIUKŲ;9480021589;Taip;0;9;0;9
21108;Gabijėlė;LAKŠTINGALIUKŲ;3215569531;Ne;0;2;0;2
21109;Gabijėlė;LAKŠTINGALIUKŲ;5992403900;Taip;8;0;0;8
21110;Gabijėlė;LAKŠTINGALIUKŲ;9116943443;Taip;4;1;5;10
21111;Gabijėlė;LAKŠTINGALIUKŲ;8383489040;Taip;7;0;0;7
21112;Gabijėlė;LAKŠTINGALIUKŲ;6927730664;Taip;5;0;0;5
21113;Gabijėlė;LAKŠTINGALIUKŲ;7444385669;Taip;5;0;1;6
21114;Gabijėlė;LAKŠTINGALIUKŲ;9398722388;Taip;0;4;0;4
21115;Gabijėlė;LAKŠTINGALIUKŲ;9491327802;Ne;0;0;6;6
21116;Gabijėlė;LAKŠTINGALIUKŲ;6730947751;Taip;0;0;2;2
21117;Gabijėlė;LAKŠTINGALIUKŲ;2550300871;Taip;0;5;0;5
21118;Gabijėlė;LAKŠTINGALIUKŲ;9324498850;Taip;16;3;1;20
21119;Gabijėlė;LAKŠTINGALIUKŲ;8314088016;Taip;5;0;0;5
21120;Gabijėlė;LAKŠTINGALIUKŲ;6295299651;Taip;7;0;0;7
21121;Gabijėlė;LAKŠTINGALIUKŲ;9694544564;Taip;0;0;5;5
21122;Gabijėlė;LAKŠTINGALIUKŲ;4827797140;Taip;9;2;0;11
21123;Gabijėlė;LAKŠTINGALIUKŲ;6931780900;Taip;9;5;0;14
21124;Gabijėlė;LAKŠTINGALIUKŲ;2030555139;Ne;12;1;0;13
21125;Gabijėlė;ŽVIRBLIUKŲ;7043775905;Taip;13;0;3;16
21126;Gabijėlė;ŽVIRBLIUKŲ;4475530177;Taip;3;0;3;6
21127;Gabijėlė;ŽVIRBLIUKŲ;5743861607;Taip;7;2;5;14
21128;Gabijėlė;ŽVIRBLIUKŲ;7410541320;Taip;10;2;0;12
21129;Gabijėlė;ŽVIRBLIUKŲ;4493192224;Ne;11;3;0;14
21130;Gabijėlė;ŽVIRBLIUKŲ;9259964641;Taip;10;0;0;10
21131;Gabijėlė;ŽVIRBLIUKŲ;3268231136;Taip;0;19;0;19
21132;Gabijėlė;ŽVIRBLIUKŲ;5332825339;Ne;9;0;7;16
21133;Gabijėlė;ŽVIRBLIUKŲ;2264669298;Taip;9;5;0;14
21134;Gabijėlė;ŽVIRBLIUKŲ;5942625633;Taip;11;3;1;15
21135;Gabijėlė;ŽVIRBLIUKŲ;3155403180;Taip;6;0;9;15
21136;Gabijėlė;ŽVIRBLIUKŲ;1158461185;Taip;8;0;7;15
21137;Gabijėlė;ŽVIRBLIUKŲ;3218415151;Taip;15;1;2;18
21138;Gabijėlė;ŽVIRBLIUKŲ;8823299212;Taip;5;2;1;8
21139;Gabijėlė;ŽVIRBLIUKŲ;8879972953;Taip;5;6;0;11
21140;Gabijėlė;ŽVIRBLIUKŲ;9627906252;Taip;0;0;3;3
21141;Gabijėlė;ŽVIRBLIUKŲ;1725665169;Taip;5;2;0;7
21142;Gabijėlė;ŽVIRBLIUKŲ;8292463617;Taip;0;1;2;3
21143;Gabijėlė;ŽVIRBLIUKŲ;6674038058;Taip;0;1;0;1
21144;Gabijėlė;ŽVIRBLIUKŲ;4146051969;Taip;10;0;0;10
21145;Gabijėlė;ŽVIRBLIUKŲ;6604681536;Taip;10;0;0;10
21146;Gabijėlė;ŽVIRBLIUKŲ;1273722177;Ne;13;0;1;14
21147;Gabijėlė;ŽVIRBLIUKŲ;6310234092;Taip;0;1;2;3
21148;Gabijėlė;ŽVIRBLIUKŲ;3209491491;Taip;11;3;0;14
21149;Gabijėlė;GENIUKŲ;3445433386;Taip;0;9;0;9
21150;Gabijėlė;GENIUKŲ;2980295345;Taip;9;1;0;10
21151;Gabijėlė;GENIUKŲ;1862655595;Taip;2;3;0;5
21152;Gabijėlė;GENIUKŲ;7312628876;Taip;0;12;0;12
21153;Gabijėlė;GENIUKŲ;1581688238;Taip;5;1;2;8
21154;Gabijėlė;GENIUKŲ;5301905117;Taip;0;11;0;11
21155;Gabijėlė;GENIUKŲ;3176075887;Taip;0;9;0;9
21156;Gabijėlė;GENIUKŲ;9972967198;Taip;4;2;4;10
21157;Gabijėlė;GENIUKŲ;1589534853;Taip;12;0;0;12
21158;Gabijėlė;GENIUKŲ;6482824000;Taip;0;0;5;5
21159;Gabijėlė;GENIUKŲ;5962852108;Taip;10;0;4;14
21160;Gabijėlė;GENIUKŲ;7178676049;Taip;14;1;0;15
21161;Gabijėlė;GENIUKŲ;1974388885;Ne;0;3;0;3
21162;Gabijėlė;GENIUKŲ;2407507314;Taip;14;3;0;17
21163;Gabijėlė;GENIUKŲ;3827747057;Taip;4;5;0;9
21164;Gabijėlė;GENIUKŲ;8305098808;Taip;7;1;0;8
21165;Gabijėlė;GENIUKŲ;4234733280;Taip;0;5;0;5
21166;Gabijėlė;GENIUKŲ;6375754699;Ne;0;1;2;3
21167;Gabijėlė;GENIUKŲ;2009199650;Taip;0;0;2;2
21168;Gabijėlė;GENIUKŲ;6869951613;Taip;0;1;0;1
21169;Gabijėlė;GENIUKŲ;7173852168;Ne;15;3;0;18
21170;Gabijėlė;GENIUKŲ;8036572198;Taip;0;16;0;16
21171;Gabijėlė;DAGILIUKŲ;9348393550;Taip;0;1;0;1
21172;Gabijėlė;DAGILIUKŲ;4264925447;Taip;0;1;0;1
21173;Gabijėlė;DAGILIUKŲ;9120107749;Taip;0;0;2;2
21174;Gabijėlė;DAGILIUKŲ;9494313873;Taip;3;1;0;4
21175;Gabijėlė;DAGILIUKŲ;9783343968;Taip;1;1;1;3
21176;Gabijėlė;DAGILIUKŲ;3017939983;Taip;7;3;0;10
21177;Gabijėlė;DAGILIUKŲ;4462129182;Taip;8;2;1;11
21178;Gabijėlė;DAGILIUKŲ;9503639471;Ne;8;0;1;9
21179;Gabijėlė;DAGILIUKŲ;1988597157;Taip;17;0;0;17
21180;Gabijėlė;DAGILIUKŲ;9895518740;Taip;12;1;2;15
21181;Gabijėlė;DAGILIUKŲ;9449023766;Taip;0;3;0;3
21182;Gabijėlė;DAGILIUKŲ;1286688629;Taip;12;1;2;15
21183;Gabijėlė;DAGILIUKŲ;8864190314;Taip;0;0;1;1
21184;Gabijėlė;DAGILIUKŲ;1455856766;Ne;0;0;8;8
21185;Gabijėlė;DAGILIUKŲ;6438144206;Ne;9;0;4;13
21186;Gabijėlė;DAGILIUKŲ;8662914262;Taip;0;4;0;4
21187;Gabijėlė;DAGILIUKŲ;9280283478;Taip;10;1;2;13
21188;Gabijėlė;DAGILIUKŲ;2254104149;Taip;0;6;0;6
21189;Gabijėlė;DAGILIUKŲ;8078326688;Taip;0;0;2;2
21190;Gabijėlė;DAGILIUKŲ;4490619514;Taip;4;0;0;4
21191;Gabijėlė;DAGILIUKŲ;2386980295;Taip;0;0;9;9
21192;Gabijėlė;DAGILIUKŲ;4664011011;Taip;5;14;0;19
21193;Gabijėlė;PELEDŽIUKŲ;4170105224;Taip;15;4;0;19
21194;Gabijėlė;PELEDŽIUKŲ;5675574534;Ne;9;0;2;11
21195;Gabijėlė;PELEDŽIUKŲ;5163460269;Taip;20;0;0;20
21196;Gabijėlė;PELEDŽIUKŲ;1356830225;Taip;6;0;3;9
21197;Gabijėlė;PELEDŽIUKŲ;9265103627;Taip;10;0;0;10
21198;Gabijėlė;PELEDŽIUKŲ;9451897367;Taip;15;0;2;17
21199;Gabijėlė;PELEDŽIUKŲ;1583034900;Taip;6;0;5;11
21200;Gabijėlė;PELEDŽIUKŲ;2128428173;Taip;11;0;0;11
21201;Gabijėlė;PELEDŽIUKŲ;7028670164;Taip;10;0;4;14
21202;Gabijėlė;PELEDŽIUKŲ;5481472116;Taip;13;0;0;13
21203;Gabijėlė;PELEDŽIUKŲ;2885913045;Taip;0;9;0;9
21204;Gabijėlė;PELEDŽIUKŲ;5869580147;Taip;0;0;2;2
21205;Gabijėlė;PELEDŽIUKŲ;7096789623;Taip;7;0;3;10
21206;Gabijėlė;PELEDŽIUKŲ;4724322463;Taip;10;0;0;10
21207;Gabijėlė;PELEDŽIUKŲ;1810898809;Taip;9;0;2;11
21208;Gabijėlė;PELEDŽIUKŲ;5801792404;Taip;10;0;2;12
21209;Gabijėlė;PELEDŽIUKŲ;8550877260;Taip;8;2;0;10
21210;Gabijėlė;PELEDŽIUKŲ;5579070948;Taip;7;0;0;7
21211;Gabijėlė;PELEDŽIUKŲ;1076369632;Taip;11;0;0;11
21212;Gabijėlė;PELEDŽIUKŲ;8549800358;Taip;25;0;0;25
21213;Gabijėlė;PELEDŽIUKŲ;8133131896;Ne;10;0;0;10
21214;Gabijėlė;PELEDŽIUKŲ;2048046055;Taip;16;0;0;16
21215;Gabijėlė;PELEDŽIUKŲ;7261932151;Ne;11;0;3;14
21216;Gabijėlė;PELEDŽIUKŲ;8088806507;Taip;9;2;0;11
21217;Gabijėlė;PELEDŽIUKŲ;6728495961;Taip;14;0;0;14
21218;Gabijėlė;KREGZDŽIUKŲ;1759118326;Taip;9;1;0;10
21219;Gabijėlė;KREGZDŽIUKŲ;9533325351;Taip;9;1;0;10
21220;Gabijėlė;KREGZDŽIUKŲ;5407565441;Taip;19;0;1;20
21221;Gabijėlė;KREGZDŽIUKŲ;6845038692;Taip;6;0;0;6
21222;Gabijėlė;KREGZDŽIUKŲ;9683202312;Ne;11;1;2;14
21223;Gabijėlė;KREGZDŽIUKŲ;1574272380;Taip;0;22;0;22
21224;Gabijėlė;KREGZDŽIUKŲ;9675186834;Taip;5;3;4;12
21225;Gabijėlė;KREGZDŽIUKŲ;2634722171;Taip;6;1;0;7
21226;Gabijėlė;KREGZDŽIUKŲ;4317708029;Taip;0;18;0;18
21227;Gabijėlė;KREGZDŽIUKŲ;8555272917;Taip;0;6;0;6
21228;Gabijėlė;KREGZDŽIUKŲ;9676186208;Taip;5;0;0;5
21229;Gabijėlė;KREGZDŽIUKŲ;3584692524;Taip;11;0;0;11
21230;Gabijėlė;KREGZDŽIUKŲ;8613821848;Taip;14;0;0;14
21231;Gabijėlė;KREGZDŽIUKŲ;7038167942;Taip;0;4;0;4
21232;Gabijėlė;KREGZDŽIUKŲ;6570702235;Taip;6;0;0;6
21233;Gabijėlė;KREGZDŽIUKŲ;9528783892;Taip;0;17;0;17
21234;Gabijėlė;KREGZDŽIUKŲ;9030890792;Taip;20;0;0;20
21235;Gabijėlė;KREGZDŽIUKŲ;3031333199;Taip;20;0;0;20
21236;Gabijėlė;KREGZDŽIUKŲ;9116153981;Taip;10;1;2;13
21237;Gabijėlė;KREGZDŽIUKŲ;7447079902;Taip;12;0;2;14
21238;Gabijėlė;KREGZDŽIUKŲ;2289016022;Ne;11;0;1;12
21239;Gabijėlė;KREGZDŽIUKŲ;1230236612;Taip;13;0;0;13
21240;Gabijėlė;KREGZDŽIUKŲ;4575230225;Ne;11;1;0;12
21241;Gabijėlė;KREGZDŽIUKŲ;7224216275;Ne;1;0;0;1
21242;Gabijėlė;ZYLIUKŲ;6154378055;Taip;16;0;0;16
21243;Gabijėlė;ZYLIUKŲ;7700700293;Taip;19;3;0;22
21244;Gabijėlė;ZYLIUKŲ;6759447513;Taip;0;12;0;12
21245;Gabijėlė;ZYLIUKŲ;1090635644;Taip;7;0;1;8
21246;Gabijėlė;ZYLIUKŲ;9893869150;Taip;8;11;0;19
21247;Gabijėlė;ZYLIUKŲ;2764185879;Taip;0;0;3;3
21248;Gabijėlė;ZYLIUKŲ;6463161337;Taip;7;1;1;9
21249;Gabijėlė;ZYLIUKŲ;7921467223;Taip;0;0;6;6
21250;Gabijėlė;ZYLIUKŲ;6446842432;Taip;14;0;3;17
21251;Gabijėlė;ZYLIUKŲ;6562965816;Taip;7;0;3;10
21252;Gabijėlė;ZYLIUKŲ;4376486874;Taip;8;4;2;14
21253;Gabijėlė;ZYLIUKŲ;7047606048;Taip;10;0;0;10
21254;Gabijėlė;ZYLIUKŲ;6983092888;Taip;11;3;1;15
21255;Gabijėlė;ZYLIUKŲ;2727329238;Taip;0;0;2;2
21256;Gabijėlė;ZYLIUKŲ;4267803371;Taip;5;0;4;9
21257;Gabijėlė;ZYLIUKŲ;9259673720;Taip;8;0;0;8
21258;Gabijėlė;ZYLIUKŲ;8362509831;Taip;10;1;3;14
21259;Gabijėlė;ZYLIUKŲ;4907669556;Taip;0;4;0;4
21260;Gabijėlė;ZYLIUKŲ;1947898190;Taip;7;7;0;14
21261;Gabijėlė;ZYLIUKŲ;2384174631;Taip;11;0;4;15
21262;Gabijėlė;ZYLIUKŲ;6393256426;Taip;13;1;4;18
21263;Gabijėlė;ZYLIUKŲ;4166561084;Taip;0;0;1;1
21264;Gabijėlė;ZYLIUKŲ;5736012194;Taip;12;0;2;14
21265;Gabijėlė;ZYLIUKŲ;4712780337;Taip;15;0;0;15
21266;Gabijėlė;ZYLIUKŲ;1004297369;Taip;7;0;3;10
21267;Gabijėlė;ZYLIUKŲ;7180444215;Taip;7;0;7;14
21268;Gabijėlė;ZYLIUKŲ;8965185578;Taip;14;0;0;14
21269;Gabijėlė;VOLUNGĖLIŲ;4000838897;Ne;19;0;0;19
21270;Gabijėlė;VOLUNGĖLIŲ;2099510027;Taip;15;0;0;15
21271;Gabijėlė;VOLUNGĖLIŲ;6842537434;Taip;0;5;0;5
21272;Gabijėlė;VOLUNGĖLIŲ;2227816651;Taip;15;1;0;16
21273;Gabijėlė;VOLUNGĖLIŲ;6956030813;Taip;18;0;0;18
21274;Gabijėlė;VOLUNGĖLIŲ;3902737481;Taip;4;6;0;10
21275;Gabijėlė;VOLUNGĖLIŲ;8733551230;Taip;7;2;6;15
21276;Gabijėlė;VOLUNGĖLIŲ;3763595874;Taip;10;1;0;11
21277;Gabijėlė;VOLUNGĖLIŲ;5360985745;Taip;14;0;0;14
21278;Gabijėlė;VOLUNGĖLIŲ;4580305437;Taip;0;14;0;14
21279;Gabijėlė;VOLUNGĖLIŲ;5737066080;Taip;9;1;0;10
21280;Gabijėlė;VOLUNGĖLIŲ;5972136800;Taip;10;4;4;18
21281;Gabijėlė;VOLUNGĖLIŲ;3972933727;Ne;9;0;3;12
21282;Gabijėlė;VOLUNGĖLIŲ;6643563560;Taip;9;3;0;12
21283;Gabijėlė;VOLUNGĖLIŲ;8312753333;Taip;9;6;0;15
21284;Gabijėlė;VOLUNGĖLIŲ;2523400466;Taip;7;0;0;7
21285;Gabijėlė;VOLUNGĖLIŲ;8569742033;Taip;0;2;5;7
21286;Gabijėlė;VOLUNGĖLIŲ;8327903800;Taip;7;1;2;10
21287;Gabijėlė;VOLUNGĖLIŲ;4160646449;Taip;9;2;0;11
21288;Gabijėlė;VOLUNGĖLIŲ;5060265729;Taip;13;0;0;13
21289;Gabijėlė;VOLUNGĖLIŲ;6960725029;Taip;11;1;1;13
21290;Gabijėlė;VOLUNGĖLIŲ;3098846537;Taip;8;0;0;8
21291;Gabijėlė;VOLUNGĖLIŲ;3995459990;Taip;10;0;0;10
21292;Gabijėlė;VOLUNGĖLIŲ;8320449381;Taip;22;3;0;25
21293;Gabijėlė;ANČIUKŲ;2036978425;Taip;0;14;0;14
21294;Gabijėlė;ANČIUKŲ;5219706067;Taip;0;4;0;4
21295;Gabijėlė;ANČIUKŲ;9822093084;Taip;22;2;0;24
21296;Gabijėlė;ANČIUKŲ;1415184607;Taip;4;1;5;10
21297;Gabijėlė;ANČIUKŲ;85836097485;Taip;6;0;2;8
21298;Gabijėlė;ANČIUKŲ;28017865889;Taip;0;9;0;9
21299;Gabijėlė;ANČIUKŲ;1917587420;Taip;0;22;0;22
21300;Gabijėlė;ANČIUKŲ;1465584524;Taip;6;1;0;7
21301;Gabijėlė;ANČIUKŲ;6198439092;Taip;0;8;0;8
21302;Gabijėlė;ANČIUKŲ;7948343328;Ne;0;7;0;7
21303;Gabijėlė;ANČIUKŲ;2052892422;Taip;9;0;3;12
21304;Gabijėlė;ANČIUKŲ;8111239476;Taip;22;3;0;25
21305;Gabijėlė;ANČIUKŲ;8778396292;Taip;7;1;4;12
21306;Gabijėlė;ANČIUKŲ;4085049535;Taip;0;6;0;6
21307;Gabijėlė;ANČIUKŲ;8893637755;Taip;0;15;0;15
21308;Gabijėlė;ANČIUKŲ;8874692591;Ne;2;0;1;3
21309;Gabijėlė;ANČIUKŲ;5783373671;Taip;0;4;0;4
21310;Gabijėlė;ANČIUKŲ;6766770793;Taip;4;1;0;5
21311;Gabijėlė;ANČIUKŲ;10796114623;Taip;0;5;0;5
21312;Gabijėlė;ANČIUKŲ;43123279348;Taip;0;4;0;4
21313;Gabijėlė;BALANDŽIUKŲ;6719097956;Taip;9;2;2;13
21314;Gabijėlė;BALANDŽIUKŲ;9157819780;Taip;17;5;0;22
21315;Gabijėlė;BALANDŽIUKŲ;1045338865;Taip;0;4;0;4
21316;Gabijėlė;BALANDŽIUKŲ;2097260657;Ne;0;2;6;8
21317;Gabijėlė;BALANDŽIUKŲ;8131229306;Taip;8;0;0;8
21318;Gabijėlė;BALANDŽIUKŲ;8525869648;Taip;0;10;0;10
21319;Gabijėlė;BALANDŽIUKŲ;2070050969;Taip;9;1;0;10
21320;Gabijėlė;BALANDŽIUKŲ;15049855022;Taip;0;5;0;5
21321;Gabijėlė;BALANDŽIUKŲ;2776579713;Ne;10;0;0;10
21322;Gabijėlė;BALANDŽIUKŲ;7977751362;Taip;9;0;0;9
21323;Gabijėlė;BALANDŽIUKŲ;5906952432;Taip;9;0;0;9
21324;Gabijėlė;BALANDŽIUKŲ;9197020006;Taip;0;6;0;6
21325;Gabijėlė;BALANDŽIUKŲ;1615940996;Ne;6;1;0;7
21326;Gabijėlė;BALANDŽIUKŲ;65735862964;Taip;3;1;0;4
21327;Gabijėlė;BALANDŽIUKŲ;6196322537;Taip;0;0;3;3
21328;Gabijėlė;BALANDŽIUKŲ;8746641978;Taip;0;0;3;3
21329;Gabijėlė;BALANDŽIUKŲ;56914218692;Taip;0;0;1;1
21330;Gabijėlė;BALANDŽIUKŲ;4330624300;Taip;0;0;3;3
21331;Gabijėlė;BALANDŽIUKŲ;2921208571;Taip;8;0;1;9
21332;Gabijėlė;BALANDŽIUKŲ;9501202207;Taip;0;2;0;2
21333;Gabijėlė;BALANDŽIUKŲ;6145720452;Ne;0;6;0;6
21334;Gabijėlė;BALANDŽIUKŲ;7563741123;Taip;13;2;0;15
21335;Gabijėlė;BALANDŽIUKŲ;3694447705;Taip;0;2;7;9
21336;Gabijėlė;VYTURIUKŲ;6131649116;Taip;13;0;0;13
21337;Gabijėlė;VYTURIUKŲ;8461048184;Taip;10;0;0;10
21338;Gabijėlė;VYTURIUKŲ;7894667201;Taip;16;0;0;16
21339;Gabijėlė;VYTURIUKŲ;3973977318;Taip;13;0;1;14
21340;Gabijėlė;VYTURIUKŲ;3454061135;Taip;7;0;1;8
21341;Gabijėlė;VYTURIUKŲ;5769331689;Taip;7;0;0;7
21342;Gabijėlė;VYTURIUKŲ;5652244967;Taip;12;0;2;14
21343;Gabijėlė;VYTURIUKŲ;6013482554;Taip;0;3;0;3
21344;Gabijėlė;VYTURIUKŲ;3343196830;Taip;11;0;0;11
21345;Gabijėlė;VYTURIUKŲ;9021225516;Taip;10;0;0;10
21346;Gabijėlė;VYTURIUKŲ;1523190444;Taip;13;0;1;14
21347;Gabijėlė;VYTURIUKŲ;7295985579;Taip;9;0;0;9
21348;Gabijėlė;VYTURIUKŲ;6834871835;Taip;14;0;0;14
21349;Gabijėlė;VYTURIUKŲ;8749080961;Taip;14;0;3;17
21350;Gabijėlė;VYTURIUKŲ;1185216449;Taip;11;5;0;16
21351;Gabijėlė;VYTURIUKŲ;6107630313;Taip;15;0;0;15
21352;Gabijėlė;VYTURIUKŲ;5297866989;Taip;14;0;2;16
21353;Gabijėlė;VYTURIUKŲ;4278783863;Taip;7;0;1;8
21354;Gabijėlė;VYTURIUKŲ;7509112343;Ne;13;0;1;14
21355;Gabijėlė;VYTURIUKŲ;4248856615;Taip;10;0;0;10
21356;Gabijėlė;VYTURIUKŲ;6539078572;Ne;0;8;0;8
21357;Gabijėlė;VYTURIUKŲ;5310270057;Ne;2;0;0;2
21358;Saulėgrąža;Bitutės;8660677159;Taip;0;3;16;19
21359;Saulėgrąža;Bitutės;9437387272;Taip;33;0;0;33
21360;Saulėgrąža;Bitutės;5940167166;Taip;0;0;23;23
21361;Saulėgrąža;Bitutės;4380287979;Taip;4;2;0;6
21362;Saulėgrąža;Bitutės;6641588877;Taip;0;0;5;5
21363;Saulėgrąža;Bitutės;8505655534;Taip;0;2;11;13
21364;Saulėgrąža;Bitutės;2809788049;Taip;13;1;15;29
21365;Saulėgrąža;Bitutės;4733063461;Taip;0;3;0;3
21366;Saulėgrąža;Bitutės;3899237871;Taip;10;3;0;13
21367;Saulėgrąža;Bitutės;1381240000;Taip;5;0;7;12
21368;Saulėgrąža;Bitutės;8766433391;Ne;0;5;0;5
21369;Saulėgrąža;Bitutės;7283302671;Taip;0;0;6;6
21370;Saulėgrąža;Bitutės;4265356484;Ne;6;0;0;6
21371;Saulėgrąža;Bitutės;2042826101;Ne;0;0;5;5
21372;Saulėgrąža;Bitutės;4471740960;Taip;4;0;3;7
21373;Saulėgrąža;Bitutės;8384708422;Taip;5;0;1;6
21374;Saulėgrąža;Bitutės;1345079291;Taip;5;5;0;10
21375;Saulėgrąža;Bitutės;3319538368;Ne;0;1;12;13
21376;Saulėgrąža;Bitutės;8597567633;Taip;0;2;3;5
21377;Saulėgrąža;Bitutės;7387477589;Taip;15;1;0;16
21378;Saulėgrąža;Bitutės;5221286194;Taip;5;1;12;18
21379;Saulėgrąža;Bitutės;9481319116;Taip;10;0;1;11
21380;Saulėgrąža;Bitutės;8531862400;Ne;0;0;2;2
21381;Saulėgrąža;Šnekučiai;5752240936;Taip;7;1;2;10
21382;Saulėgrąža;Šnekučiai;1194417698;Taip;16;0;2;18
21383;Saulėgrąža;Šnekučiai;7605120979;Taip;4;1;0;5
21384;Saulėgrąža;Šnekučiai;7094602327;Taip;10;0;0;10
21385;Saulėgrąža;Šnekučiai;5321867228;Taip;12;0;1;13
21386;Saulėgrąža;Šnekučiai;5593024136;Taip;0;1;0;1
21387;Saulėgrąža;Šnekučiai;4943974662;Taip;11;4;3;18
21388;Saulėgrąža;Šnekučiai;2606475854;Taip;0;0;8;8
21389;Saulėgrąža;Šnekučiai;7666307601;Taip;10;1;1;12
21390;Saulėgrąža;Šnekučiai;6976338513;Taip;0;0;8;8
21391;Saulėgrąža;Šnekučiai;8489738069;Taip;0;0;4;4
21392;Saulėgrąža;Šnekučiai;6582418868;Taip;8;0;0;8
21393;Saulėgrąža;Šnekučiai;7822120516;Ne;7;2;3;12
21394;Saulėgrąža;Šnekučiai;9467190029;Taip;0;0;15;15
21395;Saulėgrąža;Šnekučiai;1128467783;Taip;5;0;3;8
21396;Saulėgrąža;Šnekučiai;1946531018;Taip;2;0;4;6
21397;Saulėgrąža;Šnekučiai;3360745408;Taip;0;3;0;3
21398;Saulėgrąža;Skruzdėliukai;7211562324;Taip;0;8;0;8
21399;Saulėgrąža;Skruzdėliukai;7636592904;Taip;0;1;7;8
21400;Saulėgrąža;Skruzdėliukai;87694187780;Taip;0;0;3;3
21401;Saulėgrąža;Skruzdėliukai;6036373745;Taip;0;5;6;11
21402;Saulėgrąža;Skruzdėliukai;4023911154;Taip;0;0;1;1
21403;Saulėgrąža;Skruzdėliukai;4768918795;Taip;0;0;1;1
21404;Saulėgrąža;Skruzdėliukai;2029367287;Taip;0;0;3;3
21405;Saulėgrąža;Skruzdėliukai;4904157108;Taip;4;0;4;8
21406;Saulėgrąža;Skruzdėliukai;2453261741;Ne;8;0;2;10
21407;Saulėgrąža;Skruzdėliukai;6867062357;Taip;0;7;0;7
21408;Saulėgrąža;Skruzdėliukai;9701242161;Taip;0;0;2;2
21409;Saulėgrąža;Skruzdėliukai;2123441401;Taip;7;0;9;16
21410;Saulėgrąža;Skruzdėliukai;6373141401;Taip;0;7;0;7
21411;Saulėgrąža;Skruzdėliukai;5674402704;Taip;9;7;0;16
21412;Saulėgrąža;Skruzdėliukai;8140258691;Taip;0;4;0;4
21413;Saulėgrąža;Skruzdėliukai;5336463701;Taip;0;0;3;3
21414;Saulėgrąža;Skruzdėliukai;3839880985;Taip;0;0;1;1
21415;Saulėgrąža;Skruzdėliukai;1397888834;Taip;0;0;16;16
21416;Saulėgrąža;Skruzdėliukai;4902990966;Taip;0;0;6;6
21417;Saulėgrąža;Gudručiai;1557512232;Taip;9;0;1;10
21418;Saulėgrąža;Gudručiai;3334830210;Ne;19;0;3;22
21419;Saulėgrąža;Gudručiai;1220044197;Ne;9;0;0;9
21420;Saulėgrąža;Gudručiai;6087243776;Taip;0;1;6;7
21421;Saulėgrąža;Gudručiai;4656827505;Taip;0;5;2;7
21422;Saulėgrąža;Gudručiai;2325641957;Taip;14;0;1;15
21423;Saulėgrąža;Gudručiai;2142393859;Taip;15;1;2;18
21424;Saulėgrąža;Gudručiai;9377753981;Taip;14;0;1;15
21425;Saulėgrąža;Gudručiai;9703861091;Taip;5;0;3;8
21426;Saulėgrąža;Gudručiai;5493928884;Taip;7;2;3;12
21427;Saulėgrąža;Gudručiai;6925730672;Taip;9;1;0;10
21428;Saulėgrąža;Gudručiai;9537997340;Taip;5;3;0;8
21429;Saulėgrąža;Gudručiai;6188169984;Ne;13;1;2;16
21430;Saulėgrąža;Gudručiai;4593109666;Taip;0;4;2;6
21431;Saulėgrąža;Gudručiai;3455052574;Taip;0;1;0;1
21432;Saulėgrąža;Gudručiai;6803731510;Taip;13;0;1;14
21433;Saulėgrąža;Gudručiai;9235493036;Taip;0;0;3;3
21434;Saulėgrąža;Gudručiai;5230565797;Taip;0;1;0;1
21435;Saulėgrąža;Gudručiai;7499997676;Ne;0;0;14;14
21436;Saulėgrąža;Smalsučiai;1507699415;Ne;0;0;3;3
21437;Saulėgrąža;Smalsučiai;6415042057;Taip;11;1;0;12
21438;Saulėgrąža;Smalsučiai;2378071205;Ne;18;1;2;21
21439;Saulėgrąža;Smalsučiai;7374802873;Taip;14;1;0;15
21440;Saulėgrąža;Smalsučiai;2405382490;Taip;0;5;0;5
21441;Saulėgrąža;Smalsučiai;7236623241;Taip;10;1;0;11
21442;Saulėgrąža;Smalsučiai;4204112706;Taip;12;5;0;17
21443;Saulėgrąža;Smalsučiai;7804106261;Taip;17;1;0;18
21444;Saulėgrąža;Smalsučiai;6627868194;Taip;16;0;0;16
21445;Saulėgrąža;Smalsučiai;9859511749;Taip;18;0;0;18
21446;Saulėgrąža;Smalsučiai;3574399274;Taip;0;16;2;18
21447;Saulėgrąža;Smalsučiai;5201590576;Taip;10;0;0;10
21448;Saulėgrąža;Smalsučiai;12350048317;Taip;12;2;0;14
21449;Saulėgrąža;Smalsučiai;3214026239;Taip;23;0;0;23
21450;Saulėgrąža;Smalsučiai;1314754650;Taip;5;12;0;17
21451;Saulėgrąža;Smalsučiai;7964046826;Taip;10;1;0;11
21452;Saulėgrąža;Smalsučiai;4252425680;Taip;9;3;1;13
21453;Saulėgrąža;Smalsučiai;1563002207;Taip;5;10;0;15
21454;Saulėgrąža;Smalsučiai;3551146001;Taip;9;0;0;9
21455;Saulėgrąža;"Boruželės ";3889868838;Taip;0;0;6;6
21456;Saulėgrąža;"Boruželės ";6802366478;Taip;5;0;1;6
21457;Saulėgrąža;"Boruželės ";9604238128;Taip;0;0;9;9
21458;Saulėgrąža;"Boruželės ";4587532777;Ne;5;0;0;5
21459;Saulėgrąža;"Boruželės ";1008547550;Taip;0;0;2;2
21460;Saulėgrąža;"Boruželės ";4930162914;Taip;0;0;5;5
21461;Saulėgrąža;"Boruželės ";8986368849;Taip;0;1;0;1
21462;Saulėgrąža;"Boruželės ";3080026762;Taip;9;0;1;10
21463;Saulėgrąža;"Boruželės ";9328524382;Taip;18;0;0;18
21464;Saulėgrąža;"Boruželės ";2598768766;Taip;18;0;1;19
21465;Saulėgrąža;"Boruželės ";5734857301;Taip;14;0;4;18
21466;Saulėgrąža;"Boruželės ";9658060059;Taip;0;0;22;22
21467;Saulėgrąža;"Boruželės ";3594593787;Taip;16;0;0;16
21468;Saulėgrąža;"Boruželės ";3178867955;Ne;0;0;2;2
21469;Saulėgrąža;"Boruželės ";2934189012;Taip;0;0;1;1
21470;Saulėgrąža;Žiogeliai;7400016718;Taip;23;1;0;24
21471;Saulėgrąža;Žiogeliai;8518372931;Taip;0;0;3;3
21472;Saulėgrąža;Žiogeliai;3540590993;Taip;32;0;0;32
21473;Saulėgrąža;Žiogeliai;6909434851;Taip;8;0;0;8
21474;Saulėgrąža;Žiogeliai;6297303519;Taip;10;0;2;12
21475;Saulėgrąža;Žiogeliai;7399313501;Taip;18;0;3;21
21476;Saulėgrąža;Žiogeliai;8649254574;Taip;13;0;0;13
21477;Saulėgrąža;Žiogeliai;5991261247;Taip;0;0;1;1
21478;Saulėgrąža;Žiogeliai;9609919355;Taip;11;0;0;11
21479;Saulėgrąža;Žiogeliai;2551242973;Taip;0;0;15;15
21480;Saulėgrąža;Žiogeliai;6332380237;Taip;10;0;1;11
21481;Saulėgrąža;Žiogeliai;7881751334;Ne;5;5;3;13
21482;Saulėgrąža;Žiogeliai;4332729441;Ne;3;0;2;5
21483;Saulėgrąža;Žiogeliai;6818436741;Taip;2;13;3;18
21484;Saulėgrąža;Žiogeliai;3290592235;Taip;10;0;0;10
21485;Saulėgrąža;Žiogeliai;3690611746;Taip;0;0;1;1
21486;Saulėgrąža;Žiogeliai;7807068772;Taip;10;0;12;22
21487;Saulėgrąža;Žiogeliai;1961682373;Taip;0;6;4;10
21488;Saulėgrąža;Žiogeliai;5360973768;Ne;1;0;1;2
21489;Saulėgrąža;Žiogeliai;8769720021;Taip;2;0;2;4
21490;Saulėgrąža;Žiogeliai;7329004031;Ne;0;0;2;2
21491;Saulėgrąža;Žiogeliai;5328915059;Taip;5;7;0;12
21492;Saulėgrąža;Žiogeliai;1533696548;Taip;13;0;5;18
21493;Saulėgrąža;Drugeliai;8155080474;Taip;8;0;0;8
21494;Saulėgrąža;Drugeliai;1955944355;Taip;0;1;0;1
21495;Saulėgrąža;Drugeliai;2680631642;Taip;5;0;0;5
21496;Saulėgrąža;Drugeliai;8337203952;Taip;0;0;2;2
21497;Saulėgrąža;Drugeliai;6127496900;Taip;6;0;1;7
21498;Saulėgrąža;Drugeliai;8841882983;Taip;0;5;3;8
21499;Saulėgrąža;Drugeliai;6608001857;Taip;6;8;2;16
21500;Saulėgrąža;Drugeliai;4663169787;Taip;5;0;10;15
21501;Saulėgrąža;Drugeliai;6981928727;Taip;0;0;14;14
21502;Saulėgrąža;Drugeliai;8873608939;Taip;10;1;2;13
21503;Saulėgrąža;Drugeliai;7281353368;Taip;3;0;0;3
21504;Saulėgrąža;Drugeliai;8138991066;Taip;12;0;0;12
21505;Saulėgrąža;Drugeliai;1379283244;Taip;3;4;0;7
21506;Saulėgrąža;Drugeliai;4767744537;Ne;22;0;2;24
21507;Saulėgrąža;Drugeliai;1564385864;Taip;4;0;0;4
21508;Saulėgrąža;Drugeliai;4361365993;Taip;0;0;14;14
21509;Saulėgrąža;Drugeliai;8882080945;Taip;8;0;3;11
21510;Saulėgrąža;Drugeliai;1080500584;Taip;5;1;4;10
21511;Saulėgrąža;Drugeliai;1386348080;Ne;0;0;4;4
21512;Saulėgrąža;Drugeliai;3318222372;Taip;0;3;0;3
21513;Saulėgrąža;Drugeliai;8148900529;Taip;0;0;6;6
21514;Saulėgrąža;Drugeliai;3988854847;Taip;0;0;8;8
21515;Saulėgrąža;Pabiručiai;2570007539;Taip;0;0;3;3
21516;Saulėgrąža;Pabiručiai;1193968905;Taip;5;0;12;17
21517;Saulėgrąža;Pabiručiai;6924492377;Ne;12;0;4;16
21518;Saulėgrąža;Pabiručiai;9812784697;Taip;10;0;3;13
21519;Saulėgrąža;Pabiručiai;1732823416;Taip;20;0;0;20
21520;Saulėgrąža;Pabiručiai;2063366170;Taip;5;0;5;10
21521;Saulėgrąža;Pabiručiai;4687158499;Ne;8;0;0;8
21522;Saulėgrąža;Pabiručiai;4113866451;Taip;10;0;6;16
21523;Saulėgrąža;Pabiručiai;5759064166;Taip;0;2;0;2
21524;Saulėgrąža;Pabiručiai;3014850439;Taip;0;0;23;23
21525;Saulėgrąža;Pabiručiai;7563907981;Taip;15;1;8;24
21526;Saulėgrąža;Pabiručiai;7110805205;Taip;10;0;3;13
21527;Saulėgrąža;Pabiručiai;6489291407;Ne;16;0;0;16
21528;Saulėgrąža;Pabiručiai;5302001715;Taip;13;0;5;18
21529;Saulėgrąža;Pabiručiai;6846627257;Taip;13;0;0;13
21530;Saulėgrąža;Pabiručiai;4869924215;Taip;0;0;15;15
21531;Saulėgrąža;Žvirbliukai;4642639501;Ne;6;0;1;7
21532;Saulėgrąža;Žvirbliukai;2655671127;Taip;9;1;0;10
21533;Saulėgrąža;Žvirbliukai;7136064458;Taip;0;0;17;17
21534;Saulėgrąža;Žvirbliukai;6521035871;Taip;12;0;0;12
21535;Saulėgrąža;Žvirbliukai;2534711249;Taip;3;0;0;3
21536;Saulėgrąža;Žvirbliukai;4022011749;Taip;12;0;0;12
21537;Saulėgrąža;Žvirbliukai;7341460478;Taip;10;0;3;13
21538;Saulėgrąža;Žvirbliukai;6405942596;Taip;0;0;17;17
21539;Saulėgrąža;Žvirbliukai;3611547634;Taip;1;0;0;1
21540;Saulėgrąža;Žvirbliukai;6914492465;Taip;0;0;17;17
21541;Saulėgrąža;Žvirbliukai;4804554877;Taip;19;0;0;19
21542;Saulėgrąža;Žvirbliukai;7772718729;Taip;0;9;0;9
21543;Saulėgrąža;Žvirbliukai;2061821043;Ne;3;0;0;3
21544;Saulėgrąža;Žvirbliukai;2869737300;Ne;8;0;0;8
21545;Saulėgrąža;Žvirbliukai;4154566152;Taip;5;0;10;15
21546;Saulėgrąža;Žvirbliukai;5546123929;Taip;0;0;4;4
21547;Saulėgrąža;Pagrandukai;9226189126;Taip;14;0;0;14
21548;Saulėgrąža;Pagrandukai;7283179482;Taip;9;6;0;15
21549;Saulėgrąža;Pagrandukai;3060727219;Ne;0;10;4;14
21550;Saulėgrąža;Pagrandukai;4405035646;Taip;8;0;1;9
21551;Saulėgrąža;Pagrandukai;4017783391;Taip;3;0;1;4
21552;Saulėgrąža;Pagrandukai;3811142022;Taip;0;0;4;4
21553;Saulėgrąža;Pagrandukai;5584937620;Taip;7;0;2;9
21554;Saulėgrąža;Pagrandukai;3745791935;Taip;22;0;0;22
21555;Saulėgrąža;Pagrandukai;3785206644;Taip;22;0;0;22
21556;Saulėgrąža;Pagrandukai;2395186861;Ne;20;0;1;21
21557;Saulėgrąža;Pagrandukai;6130342214;Taip;5;0;7;12
21558;Saulėgrąža;Pagrandukai;3860139612;Taip;0;0;15;15
21559;Saulėgrąža;Pagrandukai;7545277683;Taip;3;6;0;9
21560;Saulėgrąža;Pagrandukai;5633604322;Taip;13;1;4;18
21561;Saulėgrąža;Pagrandukai;2882565651;Taip;0;0;6;6
21562;Saulėgrąža;Pagrandukai;3270627153;Taip;9;0;3;12
21563;Saulėgrąža;Pagrandukai;3122607003;Taip;0;0;3;3
21564;Saulėgrąža;ŽIRNIUKAI;9048103711;Ne;0;0;1;1
21565;Saulėgrąža;ŽIRNIUKAI;7006151469;Taip;0;0;1;1
21566;Saulėgrąža;ŽIRNIUKAI;7639669608;Taip;3;0;0;3
21567;Saulėgrąža;ŽIRNIUKAI;3406939096;Taip;0;0;1;1
21568;Saulėgrąža;ŽIRNIUKAI;1486025741;Taip;0;0;3;3
21569;Saulėgrąža;ŽIRNIUKAI;8100161189;Taip;0;0;1;1
21570;Saulėgrąža;ŽIRNIUKAI;2320995262;Taip;0;3;0;3
21571;Saulėgrąža;ŽIRNIUKAI;5168679344;Taip;0;0;2;2
21572;Saulėgrąža;ŽIRNIUKAI;3467805481;Ne;8;0;0;8
21573;Saulėgrąža;ŽIRNIUKAI;3898229402;Taip;0;0;1;1
21574;Saulėgrąža;ŽIRNIUKAI;1217899072;Taip;4;0;0;4
21575;Saulėgrąža;ŽIRNIUKAI;7795898798;Taip;3;0;0;3
21576;Saulėgrąža;ŽIRNIUKAI;5263977515;Ne;0;0;3;3
21577;"Pilaitukas (I. Kanto al. 7A)";BITUTĖS;3519198814;Taip;4;1;0;5
21578;"Pilaitukas (I. Kanto al. 7A)";BITUTĖS;8169484415;Taip;0;4;0;4
21579;"Pilaitukas (I. Kanto al. 7A)";BITUTĖS;1253300093;Taip;6;2;0;8
21580;"Pilaitukas (I. Kanto al. 7A)";BITUTĖS;1729494874;Taip;5;1;0;6
21581;"Pilaitukas (I. Kanto al. 7A)";BITUTĖS;2242454299;Taip;9;1;0;10
21582;"Pilaitukas (I. Kanto al. 7A)";BITUTĖS;9793278788;Taip;3;1;0;4
21583;"Pilaitukas (I. Kanto al. 7A)";BITUTĖS;4082490488;Taip;2;4;0;6
21584;"Pilaitukas (I. Kanto al. 7A)";BITUTĖS;3345387791;Taip;14;0;0;14
21585;"Pilaitukas (I. Kanto al. 7A)";BITUTĖS;3913169122;Taip;13;2;0;15
21586;"Pilaitukas (I. Kanto al. 7A)";BITUTĖS;3541354283;Ne;11;0;0;11
21587;"Pilaitukas (I. Kanto al. 7A)";BITUTĖS;5740951665;Taip;21;1;0;22
21588;"Pilaitukas (I. Kanto al. 7A)";BITUTĖS;4591799893;Taip;28;0;0;28
21589;"Pilaitukas (I. Kanto al. 7A)";BITUTĖS;6308557885;Taip;25;0;0;25
21590;"Pilaitukas (I. Kanto al. 7A)";BITUTĖS;6514731102;Taip;25;0;0;25
21591;"Pilaitukas (I. Kanto al. 7A)";BITUTĖS;5988165204;Taip;8;0;0;8
21592;"Pilaitukas (I. Kanto al. 7A)";BITUTĖS;3037850837;Taip;15;0;0;15
21593;"Pilaitukas (I. Kanto al. 7A)";BITUTĖS;9126553732;Taip;12;2;0;14
21594;"Pilaitukas (I. Kanto al. 7A)";BITUTĖS;7438112270;Taip;18;0;0;18
21595;"Pilaitukas (I. Kanto al. 7A)";BITUTĖS;1295215465;Ne;8;2;0;10
21596;"Pilaitukas (I. Kanto al. 7A)";BITUTĖS;5331915157;Taip;3;0;1;4
21597;"Pilaitukas (I. Kanto al. 7A)";BITUTĖS;6099109886;Taip;9;1;0;10
21598;"Pilaitukas (I. Kanto al. 7A)";BITUTĖS;3159733673;Taip;8;3;0;11
21599;"Pilaitukas (I. Kanto al. 7A)";BITUTĖS;2122392982;Ne;10;5;0;15
21600;"Pilaitukas (I. Kanto al. 7A)";BITUTĖS;7082099968;Taip;9;4;0;13
21601;"Pilaitukas (I. Kanto al. 7A)";ZUIKUČIAI;8993885764;Ne;0;3;0;3
21602;"Pilaitukas (I. Kanto al. 7A)";ZUIKUČIAI;5206637809;Taip;0;0;5;5
21603;"Pilaitukas (I. Kanto al. 7A)";ZUIKUČIAI;5288784331;Taip;3;1;1;5
21604;"Pilaitukas (I. Kanto al. 7A)";ZUIKUČIAI;8255398803;Taip;0;8;3;11
21605;"Pilaitukas (I. Kanto al. 7A)";ZUIKUČIAI;2862447956;Taip;8;3;0;11
21606;"Pilaitukas (I. Kanto al. 7A)";ZUIKUČIAI;8727175656;Taip;8;3;0;11
21607;"Pilaitukas (I. Kanto al. 7A)";ZUIKUČIAI;8207194955;Ne;6;0;5;11
21608;"Pilaitukas (I. Kanto al. 7A)";ZUIKUČIAI;5640802570;Taip;8;1;0;9
21609;"Pilaitukas (I. Kanto al. 7A)";ZUIKUČIAI;4623818227;Taip;0;1;1;2
21610;"Pilaitukas (I. Kanto al. 7A)";ZUIKUČIAI;9260893320;Taip;0;2;0;2
21611;"Pilaitukas (I. Kanto al. 7A)";ZUIKUČIAI;9988041515;Ne;11;1;1;13
21612;"Pilaitukas (I. Kanto al. 7A)";ZUIKUČIAI;9108428738;Ne;11;1;1;13
21613;"Pilaitukas (I. Kanto al. 7A)";ZUIKUČIAI;1607454890;Taip;0;0;4;4
21614;"Pilaitukas (I. Kanto al. 7A)";ZUIKUČIAI;9878890346;Taip;3;1;0;4
21615;"Pilaitukas (I. Kanto al. 7A)";ZUIKUČIAI;5710747769;Taip;0;2;4;6
21616;"Pilaitukas (I. Kanto al. 7A)";ZUIKUČIAI;7568744500;Taip;11;1;1;13
21617;"Pilaitukas (I. Kanto al. 7A)";ZUIKUČIAI;5407354218;Taip;6;8;0;14
21618;"Pilaitukas (I. Kanto al. 7A)";ZUIKUČIAI;1704055907;Ne;16;1;6;23
21619;"Pilaitukas (I. Kanto al. 7A)";ZUIKUČIAI;7853910193;Taip;0;0;6;6
21620;"Pilaitukas (I. Kanto al. 7A)";ZUIKUČIAI;6426415533;Taip;0;1;0;1
21621;"Pilaitukas (I. Kanto al. 7A)";ZUIKUČIAI;9735358433;Taip;3;0;0;3
21622;"Pilaitukas (I. Kanto al. 7A)";ZUIKUČIAI;2705235576;Taip;0;13;2;15
21623;"Pilaitukas (I. Kanto al. 7A)";ZUIKUČIAI;9688421636;Taip;0;0;1;1
21624;"Pilaitukas (I. Kanto al. 7A)";ANČIUKAI;3357097410;Taip;0;1;0;1
21625;"Pilaitukas (I. Kanto al. 7A)";ANČIUKAI;7773318230;Taip;0;8;0;8
21626;"Pilaitukas (I. Kanto al. 7A)";ANČIUKAI;4097742120;Ne;0;2;1;3
21627;"Pilaitukas (I. Kanto al. 7A)";ANČIUKAI;2923272767;Ne;0;3;1;4
21628;"Pilaitukas (I. Kanto al. 7A)";ANČIUKAI;8620858011;Taip;12;2;0;14
21629;"Pilaitukas (I. Kanto al. 7A)";ANČIUKAI;4286388920;Taip;0;0;1;1
21630;"Pilaitukas (I. Kanto al. 7A)";ANČIUKAI;3761827714;Taip;0;1;2;3
21631;"Pilaitukas (I. Kanto al. 7A)";ANČIUKAI;8643066116;Taip;5;1;3;9
21632;"Pilaitukas (I. Kanto al. 7A)";ANČIUKAI;1120549352;Taip;1;4;4;9
21633;"Pilaitukas (I. Kanto al. 7A)";ANČIUKAI;6888607864;Taip;9;4;0;13
21634;"Pilaitukas (I. Kanto al. 7A)";ANČIUKAI;5490465905;Taip;0;11;0;11
21635;"Pilaitukas (I. Kanto al. 7A)";ANČIUKAI;7876850509;Taip;12;3;0;15
21636;"Pilaitukas (I. Kanto al. 7A)";ANČIUKAI;3035456834;Taip;0;2;0;2
21637;"Pilaitukas (I. Kanto al. 7A)";ANČIUKAI;2476942319;Taip;0;1;0;1
21638;"Pilaitukas (I. Kanto al. 7A)";ANČIUKAI;8033540052;Taip;13;0;0;13
21639;"Pilaitukas (I. Kanto al. 7A)";ANČIUKAI;1781762820;Taip;5;2;0;7
21640;"Pilaitukas (I. Kanto al. 7A)";ANČIUKAI;3005101776;Taip;3;1;2;6
21641;"Pilaitukas (I. Kanto al. 7A)";ANČIUKAI;8787181006;Taip;0;4;0;4
21642;"Pilaitukas (I. Kanto al. 7A)";ANČIUKAI;7189824054;Ne;8;1;0;9
21643;"Pilaitukas (I. Kanto al. 7A)";ANČIUKAI;9332831979;Taip;0;1;2;3
21644;"Pilaitukas (I. Kanto al. 7A)";ANČIUKAI;5706918634;Taip;15;1;0;16
21645;"Pilaitukas (I. Kanto al. 7A)";ANČIUKAI;8954370321;Taip;8;0;0;8
21646;"Pilaitukas (I. Kanto al. 7A)";ANČIUKAI;1660462256;Taip;16;4;0;20
21647;"Pilaitukas (I. Kanto al. 7A)";MEŠKIUKAI;8577357264;Taip;9;3;0;12
21648;"Pilaitukas (I. Kanto al. 7A)";MEŠKIUKAI;5297214263;Taip;10;1;0;11
21649;"Pilaitukas (I. Kanto al. 7A)";MEŠKIUKAI;8268790017;Ne;8;0;0;8
21650;"Pilaitukas (I. Kanto al. 7A)";MEŠKIUKAI;2054626415;Taip;19;1;0;20
21651;"Pilaitukas (I. Kanto al. 7A)";MEŠKIUKAI;9742268665;Taip;19;0;0;19
21652;"Pilaitukas (I. Kanto al. 7A)";MEŠKIUKAI;8322980583;Taip;2;1;0;3
21653;"Pilaitukas (I. Kanto al. 7A)";MEŠKIUKAI;1610122884;Taip;6;3;0;9
21654;"Pilaitukas (I. Kanto al. 7A)";MEŠKIUKAI;3867660147;Taip;6;3;0;9
21655;"Pilaitukas (I. Kanto al. 7A)";MEŠKIUKAI;2365387089;Taip;4;0;0;4
21656;"Pilaitukas (I. Kanto al. 7A)";MEŠKIUKAI;9670329628;Taip;27;1;0;28
21657;"Pilaitukas (I. Kanto al. 7A)";MEŠKIUKAI;7750575554;Taip;19;0;0;19
21658;"Pilaitukas (I. Kanto al. 7A)";MEŠKIUKAI;9397435605;Taip;2;3;0;5
21659;"Pilaitukas (I. Kanto al. 7A)";MEŠKIUKAI;9187961584;Taip;1;0;0;1
21660;"Pilaitukas (I. Kanto al. 7A)";MEŠKIUKAI;7781507786;Taip;12;3;0;15
21661;"Pilaitukas (I. Kanto al. 7A)";MEŠKIUKAI;4171896175;Taip;11;1;1;13
21662;"Pilaitukas (I. Kanto al. 7A)";MEŠKIUKAI;1362132769;Taip;9;0;0;9
21663;"Pilaitukas (I. Kanto al. 7A)";MEŠKIUKAI;3027792710;Taip;10;0;0;10
21664;"Pilaitukas (I. Kanto al. 7A)";MEŠKIUKAI;6807166920;Taip;0;9;0;9
21665;"Pilaitukas (I. Kanto al. 7A)";MEŠKIUKAI;1591276987;Taip;4;0;0;4
21666;"Pilaitukas (I. Kanto al. 7A)";MEŠKIUKAI;2830212921;Taip;3;0;0;3
21667;"Pilaitukas (I. Kanto al. 7A)";MEŠKIUKAI;9930306085;Ne;22;0;0;22
21668;"Pilaitukas (I. Kanto al. 7A)";MEŠKIUKAI;8279288250;Taip;3;3;0;6
21669;"Pilaitukas (I. Kanto al. 7A)";ŽUVYTĖS;48011638560;Taip;7;1;0;8
21670;"Pilaitukas (I. Kanto al. 7A)";ŽUVYTĖS;8109335587;Taip;0;1;0;1
21671;"Pilaitukas (I. Kanto al. 7A)";ŽUVYTĖS;8319676743;Taip;0;1;0;1
21672;"Pilaitukas (I. Kanto al. 7A)";ŽUVYTĖS;36338976218;Taip;10;2;0;12
21673;"Pilaitukas (I. Kanto al. 7A)";ŽUVYTĖS;9224653856;Taip;10;1;0;11
21674;"Pilaitukas (I. Kanto al. 7A)";ŽUVYTĖS;4694691187;Taip;9;1;0;10
21675;"Pilaitukas (I. Kanto al. 7A)";ŽUVYTĖS;5252233127;Taip;19;1;0;20
21676;"Pilaitukas (I. Kanto al. 7A)";ŽUVYTĖS;5206439753;Taip;0;3;0;3
21677;"Pilaitukas (I. Kanto al. 7A)";ŽUVYTĖS;6222888898;Taip;2;0;2;4
21678;"Pilaitukas (I. Kanto al. 7A)";ŽUVYTĖS;5211988291;Taip;13;0;0;13
21679;"Pilaitukas (I. Kanto al. 7A)";ŽUVYTĖS;1512181401;Taip;0;1;0;1
21680;"Pilaitukas (I. Kanto al. 7A)";ŽUVYTĖS;2298935154;Taip;5;1;0;6
21681;"Pilaitukas (I. Kanto al. 7A)";ŽUVYTĖS;5949185075;Taip;3;0;0;3
21682;"Pilaitukas (I. Kanto al. 7A)";ŽUVYTĖS;2117570444;Taip;4;0;0;4
21683;"Pilaitukas (I. Kanto al. 7A)";ŽUVYTĖS;79485847381;Taip;3;1;0;4
21684;"Pilaitukas (I. Kanto al. 7A)";ŽUVYTĖS;7909465673;Taip;6;0;0;6
21685;"Pilaitukas (I. Kanto al. 7A)";ŽUVYTĖS;92108889661;Taip;0;1;3;4
21686;"Pilaitukas (I. Kanto al. 7A)";ŽUVYTĖS;4505384039;Taip;4;0;0;4
21687;"Pilaitukas (I. Kanto al. 7A)";ŽUVYTĖS;58250008277;Taip;12;2;0;14
21688;"Pilaitukas (I. Kanto al. 7A)";ŽUVYTĖS;1618432877;Taip;0;2;1;3
21689;"Pilaitukas (I. Kanto al. 7A)";ŽUVYTĖS;9724892897;Taip;1;0;0;1
21690;"Pilaitukas (I. Kanto al. 7A)";ŽUVYTĖS;3821748678;Taip;0;2;1;3
21691;"Pilaitukas (I. Kanto al. 7A)";ŽUVYTĖS;1114477688;Taip;1;4;0;5
21692;"Pilaitukas (I. Kanto al. 7A)";PAUKŠTELIAI;3325511140;Taip;3;1;0;4
21693;"Pilaitukas (I. Kanto al. 7A)";PAUKŠTELIAI;6514784647;Taip;0;1;0;1
21694;"Pilaitukas (I. Kanto al. 7A)";PAUKŠTELIAI;4505147961;Taip;0;1;0;1
21695;"Pilaitukas (I. Kanto al. 7A)";PAUKŠTELIAI;18466900688;Taip;3;5;0;8
21696;"Pilaitukas (I. Kanto al. 7A)";PAUKŠTELIAI;4038320896;Taip;3;3;0;6
21697;"Pilaitukas (I. Kanto al. 7A)";PAUKŠTELIAI;3794882532;Taip;8;0;0;8
21698;"Pilaitukas (I. Kanto al. 7A)";PAUKŠTELIAI;5689385925;Taip;2;2;0;4
21699;"Pilaitukas (I. Kanto al. 7A)";PAUKŠTELIAI;5405252621;Taip;2;1;0;3
21700;"Pilaitukas (I. Kanto al. 7A)";PAUKŠTELIAI;5939557073;Taip;1;0;0;1
21701;"Pilaitukas (I. Kanto al. 7A)";PAUKŠTELIAI;39600380611;Taip;2;1;0;3
21702;"Pilaitukas (I. Kanto al. 7A)";PAUKŠTELIAI;3214740183;Taip;0;3;0;3
21703;"Pilaitukas (I. Kanto al. 7A)";PAUKŠTELIAI;2929868229;Ne;4;1;0;5
21704;"Pilaitukas (I. Kanto al. 7A)";PAUKŠTELIAI;9924612250;Taip;5;1;6;12
21705;"Pilaitukas (I. Kanto al. 7A)";PAUKŠTELIAI;6117985788;Taip;2;1;0;3
21706;"Pilaitukas (I. Kanto al. 7A)";PAUKŠTELIAI;57931719105;Taip;10;1;0;11
21707;"Pilaitukas (I. Kanto al. 7A)";PAUKŠTELIAI;9618329726;Taip;0;1;0;1
21708;"Pilaitukas (I. Kanto al. 7A)";PAUKŠTELIAI;1003278169;Taip;0;2;0;2
21709;"Pilaitukas (I. Kanto al. 7A)";PAUKŠTELIAI;9450834035;Taip;9;1;0;10
21710;"Pilaitukas (I. Kanto al. 7A)";PAUKŠTELIAI;5604992163;Taip;9;1;0;10
21711;"Pilaitukas (I. Kanto al. 7A)";PAUKŠTELIAI;1693309238;Taip;0;1;0;1
21712;"Pilaitukas (I. Kanto al. 7A)";BORUŽĖLĖS;8364902911;Taip;0;6;0;6
21713;"Pilaitukas (I. Kanto al. 7A)";BORUŽĖLĖS;5063602139;Taip;4;11;0;15
21714;"Pilaitukas (I. Kanto al. 7A)";BORUŽĖLĖS;5984878126;Taip;0;9;0;9
21715;"Pilaitukas (I. Kanto al. 7A)";BORUŽĖLĖS;6024861998;Taip;5;0;0;5
21716;"Pilaitukas (I. Kanto al. 7A)";BORUŽĖLĖS;9898379569;Taip;0;1;0;1
21717;"Pilaitukas (I. Kanto al. 7A)";BORUŽĖLĖS;5324806808;Ne;5;3;0;8
21718;"Pilaitukas (I. Kanto al. 7A)";BORUŽĖLĖS;5185051301;Taip;4;1;0;5
21719;"Pilaitukas (I. Kanto al. 7A)";BORUŽĖLĖS;5326258755;Taip;6;0;0;6
21720;"Pilaitukas (I. Kanto al. 7A)";BORUŽĖLĖS;6838035491;Taip;8;0;2;10
21721;"Pilaitukas (I. Kanto al. 7A)";BORUŽĖLĖS;1731106179;Taip;13;1;0;14
21722;"Pilaitukas (I. Kanto al. 7A)";BORUŽĖLĖS;3784944532;Taip;0;3;3;6
21723;"Pilaitukas (I. Kanto al. 7A)";BORUŽĖLĖS;5186675623;Taip;0;0;5;5
21724;"Pilaitukas (I. Kanto al. 7A)";BORUŽĖLĖS;4317406707;Taip;6;0;0;6
21725;"Pilaitukas (I. Kanto al. 7A)";BORUŽĖLĖS;8380819975;Taip;0;5;0;5
21726;"Pilaitukas (I. Kanto al. 7A)";BORUŽĖLĖS;1944443723;Taip;18;0;0;18
21727;"Pilaitukas (I. Kanto al. 7A)";DRUGELIAI;1677962644;Ne;8;8;0;16
21728;"Pilaitukas (I. Kanto al. 7A)";DRUGELIAI;4745358362;Ne;8;8;0;16
21729;"Pilaitukas (I. Kanto al. 7A)";DRUGELIAI;2917197418;Ne;11;0;1;12
21730;"Pilaitukas (I. Kanto al. 7A)";DRUGELIAI;6712878938;Taip;14;0;0;14
21731;"Pilaitukas (I. Kanto al. 7A)";DRUGELIAI;3298272815;Taip;8;0;0;8
21732;"Pilaitukas (I. Kanto al. 7A)";DRUGELIAI;3772830210;Taip;10;0;2;12
21733;"Pilaitukas (I. Kanto al. 7A)";DRUGELIAI;4719223490;Taip;10;0;2;12
21734;"Pilaitukas (I. Kanto al. 7A)";DRUGELIAI;9414051187;Ne;8;0;1;9
21735;"Pilaitukas (I. Kanto al. 7A)";DRUGELIAI;6280870972;Taip;19;0;0;19
21736;"Pilaitukas (I. Kanto al. 7A)";DRUGELIAI;9741985709;Ne;8;0;9;17
21737;"Pilaitukas (I. Kanto al. 7A)";DRUGELIAI;7807341574;Taip;9;1;0;10
21738;"Pilaitukas (I. Kanto al. 7A)";DRUGELIAI;5215800828;Taip;8;0;0;8
21739;"Pilaitukas (I. Kanto al. 7A)";DRUGELIAI;2414941263;Ne;5;0;0;5
21740;"Pilaitukas (I. Kanto al. 7A)";DRUGELIAI;2210253038;Taip;19;1;0;20
21741;"Pilaitukas (I. Kanto al. 7A)";DRUGELIAI;7222856683;Taip;11;1;0;12
21742;"Pilaitukas (I. Kanto al. 7A)";DRUGELIAI;8710069256;Ne;11;0;1;12
21743;"Pilaitukas (I. Kanto al. 7A)";DRUGELIAI;7830059468;Taip;25;0;0;25
21744;"Pilaitukas (I. Kanto al. 7A)";DRUGELIAI;7479542200;Taip;11;3;3;17
21745;"Pilaitukas (I. Kanto al. 7A)";DRUGELIAI;5901884512;Taip;16;0;0;16
21746;"Pilaitukas (I. Kanto al. 7A)";DRUGELIAI;1747834520;Ne;9;4;0;13
21747;"Pilaitukas (I. Kanto al. 7A)";PELIUKAI;9246925227;Taip;3;4;0;7
21748;"Pilaitukas (I. Kanto al. 7A)";PELIUKAI;7808204054;Taip;0;1;0;1
21749;"Pilaitukas (I. Kanto al. 7A)";PELIUKAI;4810825253;Taip;17;1;0;18
21750;"Pilaitukas (I. Kanto al. 7A)";PELIUKAI;8769116377;Taip;0;0;2;2
21751;"Pilaitukas (I. Kanto al. 7A)";PELIUKAI;8501376663;Taip;0;0;2;2
21752;"Pilaitukas (I. Kanto al. 7A)";PELIUKAI;5421602723;Ne;9;13;0;22
21753;"Pilaitukas (I. Kanto al. 7A)";PELIUKAI;8168228529;Taip;13;1;0;14
21754;"Pilaitukas (I. Kanto al. 7A)";PELIUKAI;4014329370;Taip;6;0;1;7
21755;"Pilaitukas (I. Kanto al. 7A)";PELIUKAI;6833933586;Taip;0;5;0;5
21756;"Pilaitukas (I. Kanto al. 7A)";PELIUKAI;8877142428;Taip;4;0;1;5
21757;"Pilaitukas (I. Kanto al. 7A)";PELIUKAI;2416277190;Taip;7;3;0;10
21758;"Pilaitukas (I. Kanto al. 7A)";PELIUKAI;9774222130;Taip;6;0;2;8
21759;"Pilaitukas (I. Kanto al. 7A)";PELIUKAI;1270365948;Taip;5;4;0;9
21760;"Pilaitukas (I. Kanto al. 7A)";PELIUKAI;7604004800;Taip;4;0;0;4
21761;"Pilaitukas (I. Kanto al. 7A)";PELIUKAI;9556421129;Taip;8;0;0;8
21762;"Pilaitukas (I. Kanto al. 7A)";PELIUKAI;3954210452;Ne;9;0;0;9
21763;"Pilaitukas (I. Kanto al. 7A)";PELIUKAI;5223336496;Taip;10;0;2;12
21764;"Pilaitukas (I. Kanto al. 7A)";PELIUKAI;3651140874;Taip;14;1;3;18
21765;"Pilaitukas (I. Kanto al. 7A)";PELIUKAI;2823859128;Taip;0;0;1;1
21766;"Pilaitukas (I. Kanto al. 7A)";PELIUKAI;7750936973;Taip;10;0;0;10
21767;"Pilaitukas (I. Kanto al. 7A)";KAČIUKAI;2406183145;Taip;11;0;0;11
21768;"Pilaitukas (I. Kanto al. 7A)";KAČIUKAI;2379660463;Taip;11;0;0;11
21769;"Pilaitukas (I. Kanto al. 7A)";KAČIUKAI;1585341963;Taip;9;2;0;11
21770;"Pilaitukas (I. Kanto al. 7A)";KAČIUKAI;9038324313;Taip;0;1;0;1
21771;"Pilaitukas (I. Kanto al. 7A)";KAČIUKAI;7594484959;Taip;0;1;0;1
21772;"Pilaitukas (I. Kanto al. 7A)";KAČIUKAI;2463482642;Taip;0;3;0;3
21773;"Pilaitukas (I. Kanto al. 7A)";KAČIUKAI;3080014745;Taip;10;4;0;14
21774;"Pilaitukas (I. Kanto al. 7A)";KAČIUKAI;5353687011;Taip;5;11;0;16
21775;"Pilaitukas (I. Kanto al. 7A)";KAČIUKAI;6525191057;Taip;11;0;1;12
21776;"Pilaitukas (I. Kanto al. 7A)";KAČIUKAI;8009040109;Taip;8;0;0;8
21777;"Pilaitukas (I. Kanto al. 7A)";KAČIUKAI;2105380328;Taip;13;0;0;13
21778;"Pilaitukas (I. Kanto al. 7A)";KAČIUKAI;5326689274;Taip;11;3;0;14
21779;"Pilaitukas (I. Kanto al. 7A)";KAČIUKAI;9653647227;Taip;11;3;0;14
21780;"Pilaitukas (I. Kanto al. 7A)";KAČIUKAI;1999942175;Taip;6;1;0;7
21781;"Pilaitukas (I. Kanto al. 7A)";KAČIUKAI;3825942473;Taip;0;15;0;15
21782;"Pilaitukas (I. Kanto al. 7A)";KAČIUKAI;1611371690;Taip;22;0;0;22
21783;"Pilaitukas (I. Kanto al. 7A)";KAČIUKAI;9247501721;Taip;6;0;0;6
21784;"Pilaitukas (I. Kanto al. 7A)";KAČIUKAI;6436694057;Taip;5;0;0;5
21785;"Pilaitukas (I. Kanto al. 7A)";KAČIUKAI;9974310580;Taip;10;0;1;11
21786;"Pilaitukas (I. Kanto al. 7A)";KAČIUKAI;6235375235;Taip;14;0;0;14
21787;"Pilaitukas (I. Kanto al. 7A)";KAČIUKAI;9914575692;Taip;13;0;0;13
21788;"Pilaitukas (I. Kanto al. 7A)";KAČIUKAI;4341157841;Taip;7;0;0;7
21789;"Pilaitukas (I. Kanto al. 7A)";SAULUTĖS;8047683859;Taip;3;1;0;4
21790;"Pilaitukas (I. Kanto al. 7A)";SAULUTĖS;8694369154;Taip;3;1;0;4
21791;"Pilaitukas (I. Kanto al. 7A)";SAULUTĖS;9405479859;Taip;9;0;0;9
21792;"Pilaitukas (I. Kanto al. 7A)";SAULUTĖS;1052452915;Taip;18;0;1;19
21793;"Pilaitukas (I. Kanto al. 7A)";SAULUTĖS;2336933998;Taip;22;0;0;22
21794;"Pilaitukas (I. Kanto al. 7A)";SAULUTĖS;1134083816;Taip;13;0;2;15
21795;"Pilaitukas (I. Kanto al. 7A)";SAULUTĖS;2110996493;Ne;17;0;0;17
21796;"Pilaitukas (I. Kanto al. 7A)";SAULUTĖS;1452645899;Taip;16;0;0;16
21797;"Pilaitukas (I. Kanto al. 7A)";SAULUTĖS;9587140991;Taip;0;22;0;22
21798;"Pilaitukas (I. Kanto al. 7A)";SAULUTĖS;8306015313;Taip;0;22;0;22
21799;"Pilaitukas (I. Kanto al. 7A)";MENULIUKAI;6337917448;Taip;9;1;0;10
21800;"Pilaitukas (I. Kanto al. 7A)";MENULIUKAI;3636976107;Taip;9;1;0;10
21801;"Pilaitukas (I. Kanto al. 7A)";MENULIUKAI;5026344198;Taip;2;1;0;3
21802;"Pilaitukas (I. Kanto al. 7A)";MENULIUKAI;5564784922;Taip;6;0;0;6
21803;"Pilaitukas (I. Kanto al. 7A)";MENULIUKAI;1290017967;Taip;1;5;0;6
21804;"Pilaitukas (I. Kanto al. 7A)";MENULIUKAI;1841240800;Taip;10;1;0;11
21805;"Pilaitukas (I. Kanto al. 7A)";MENULIUKAI;4710865219;Taip;10;1;0;11
21806;"Pilaitukas (I. Kanto al. 7A)";MENULIUKAI;5691854235;Taip;6;0;0;6
21807;"Pilaitukas (I. Kanto al. 7A)";MENULIUKAI;6054821801;Taip;8;1;0;9
21808;"Pilaitukas (I. Kanto al. 7A)";MENULIUKAI;1620231835;Taip;7;0;0;7
21809;"Pilaitukas (I. Kanto al. 7A)";MENULIUKAI;8873155277;Taip;0;22;0;22
21810;"Pilaitukas (I. Kanto al. 7A)";MENULIUKAI;1532252453;Taip;18;1;0;19
21811;"Pilaitukas (I. Kanto al. 7A)";MENULIUKAI;8225571149;Taip;0;22;0;22
21812;"Pilaitukas (I. Kanto al. 7A)";MENULIUKAI;8207648026;Taip;8;3;0;11
21813;"Pilaitukas (I. Kanto al. 7A)";MENULIUKAI;3921932673;Taip;8;3;0;11
21814;"Pilaitukas (I. Kanto al. 7A)";MENULIUKAI;7855892595;Taip;0;22;0;22
21815;"Pilaitukas (I. Kanto al. 7A)";MENULIUKAI;8058057477;Taip;19;0;0;19
21816;"Pilaitukas (I. Kanto al. 7A)";MENULIUKAI;5682244165;Taip;8;0;0;8
21817;"Pilaitukas (I. Kanto al. 7A)";MENULIUKAI;3952708917;Taip;0;22;0;22
21818;"Pilaitukas (I. Kanto al. 7A)";ĖŽIUKAI;1568651642;Taip;3;0;8;11
21819;"Pilaitukas (I. Kanto al. 7A)";ĖŽIUKAI;2892275540;Taip;3;1;0;4
21820;"Pilaitukas (I. Kanto al. 7A)";ĖŽIUKAI;1746050808;Taip;3;1;0;4
21821;"Pilaitukas (I. Kanto al. 7A)";ĖŽIUKAI;2633256935;Taip;18;0;0;18
21822;"Pilaitukas (I. Kanto al. 7A)";ĖŽIUKAI;8747053041;Taip;18;0;0;18
21823;"Pilaitukas (I. Kanto al. 7A)";ĖŽIUKAI;7555601497;Taip;3;0;1;4
21824;"Pilaitukas (I. Kanto al. 7A)";ĖŽIUKAI;6019760696;Taip;0;0;4;4
21825;"Pilaitukas (I. Kanto al. 7A)";ĖŽIUKAI;5979852431;Taip;20;7;0;27
21826;"Pilaitukas (I. Kanto al. 7A)";ĖŽIUKAI;9950619644;Taip;0;22;0;22
21827;"Pilaitukas (I. Kanto al. 7A)";ĖŽIUKAI;8682279246;Ne;0;22;0;22
21828;"Pilaitukas (I. Kanto al. 7A)";ĖŽIUKAI;6271751691;Taip;3;1;3;7
21829;"Pilaitukas (I. Kanto al. 7A)";ĖŽIUKAI;9306169443;Taip;0;1;1;2
21830;"Pilaitukas (I. Kanto al. 7A)";ĖŽIUKAI;5155899628;Taip;0;0;5;5
21831;"Pilaitukas (I. Kanto al. 7A)";ĖŽIUKAI;5340877261;Taip;0;0;5;5
21832;"Pilaitukas (I. Kanto al. 7A)";ĖŽIUKAI;2342453729;Taip;6;0;0;6
21833;"Pilaitukas (I. Kanto al. 7A)";ĖŽIUKAI;6064545501;Taip;13;1;0;14
21834;"Pilaitukas (I. Kanto al. 7A)";ĖŽIUKAI;5904710385;Taip;9;0;1;10
21835;"Pilaitukas (I. Kanto al. 7A)";ĖŽIUKAI;1486895496;Taip;9;0;1;10
21836;"Pilaitukas (I. Kanto al. 7A)";ĖŽIUKAI;9441608677;Taip;0;0;1;1
21837;Vilija;BORUŽĖLĖS;6611278346;Taip;18;0;0;18
21838;Vilija;BORUŽĖLĖS;5979446899;Taip;17;0;0;17
21839;Vilija;BORUŽĖLĖS;3386809866;Taip;5;0;1;6
21840;Vilija;BORUŽĖLĖS;7980759563;Ne;10;0;6;16
21841;Vilija;BORUŽĖLĖS;3301367418;Taip;10;3;0;13
21842;Vilija;BORUŽĖLĖS;6115055683;Taip;5;2;0;7
21843;Vilija;BORUŽĖLĖS;8995800590;Taip;13;0;0;13
21844;Vilija;BORUŽĖLĖS;4577389098;Taip;10;5;2;17
21845;Vilija;BORUŽĖLĖS;9806725516;Taip;11;0;5;16
21846;Vilija;BORUŽĖLĖS;4791053946;Taip;16;3;0;19
21847;Vilija;BORUŽĖLĖS;4755512150;Taip;9;8;2;19
21848;Vilija;BORUŽĖLĖS;3391689045;Taip;15;0;5;20
21849;Vilija;BORUŽĖLĖS;7464020972;Taip;4;3;0;7
21850;Vilija;NYKŠTUKAI;8248774222;Taip;3;3;1;7
21851;Vilija;NYKŠTUKAI;7009463901;Taip;0;4;0;4
21852;Vilija;NYKŠTUKAI;66817455759;Taip;3;3;2;8
21853;Vilija;NYKŠTUKAI;3201809038;Ne;0;3;0;3
21854;Vilija;NYKŠTUKAI;7469836390;Taip;6;5;0;11
21855;Vilija;NYKŠTUKAI;8364033602;Taip;6;3;0;9
21856;Vilija;NYKŠTUKAI;3544848804;Taip;0;3;0;3
21857;Vilija;NYKŠTUKAI;6136579994;Taip;5;0;0;5
21858;Vilija;NYKŠTUKAI;1116822936;Taip;0;1;1;2
21859;Vilija;NYKŠTUKAI;5563356449;Ne;0;3;0;3
21860;Vilija;NYKŠTUKAI;8756465854;Taip;4;3;6;13
21861;Vilija;NYKŠTUKAI;1717847351;Taip;5;4;0;9
21862;Vilija;NYKŠTUKAI;1751533938;Taip;0;3;1;4
21863;Vilija;NYKŠTUKAI;2532658333;Taip;20;0;0;20
21864;Vilija;ANČIUKAI;5776170550;Taip;5;3;0;8
21865;Vilija;ANČIUKAI;5643311237;Taip;0;8;0;8
21866;Vilija;ANČIUKAI;9176710135;Taip;11;3;0;14
21867;Vilija;ANČIUKAI;8073341597;Taip;13;4;0;17
21868;Vilija;ANČIUKAI;8493278100;Taip;7;9;0;16
21869;Vilija;ANČIUKAI;3556336263;Taip;9;0;2;11
21870;Vilija;ANČIUKAI;4291690659;Taip;4;1;0;5
21871;Vilija;ANČIUKAI;3857271014;Taip;0;0;3;3
21872;Vilija;ANČIUKAI;3552472323;Taip;0;8;0;8
21873;Vilija;ANČIUKAI;5683016588;Taip;0;0;5;5
21874;Vilija;ANČIUKAI;3489127587;Taip;0;12;0;12
21875;Vilija;ANČIUKAI;4780760918;Taip;0;3;0;3
21876;Vilija;ANČIUKAI;7012683174;Taip;18;0;0;18
21877;Vilija;ANČIUKAI;6385918522;Taip;0;11;0;11
21878;Vilija;ANČIUKAI;9531574134;Taip;0;1;1;2
21879;Vilija;ANČIUKAI;4400813531;Taip;8;3;0;11
21880;Vilija;ANČIUKAI;5454031929;Taip;22;0;0;22
21881;Vilija;ANČIUKAI;4858617162;Taip;22;0;0;22
21882;Vilija;ANČIUKAI;8318388772;Taip;0;8;0;8
21883;Vilija;ANČIUKAI;3677313088;Taip;0;9;0;9
21884;Vilija;ANČIUKAI;6815408748;Taip;6;0;0;6
21885;Vilija;ANČIUKAI;2371667380;Taip;0;3;1;4
21886;Vilija;DRUGELIAI;2205400512;Taip;0;1;0;1
21887;Vilija;DRUGELIAI;2309358870;Taip;3;0;0;3
21888;Vilija;DRUGELIAI;5530078264;Taip;0;3;0;3
21889;Vilija;DRUGELIAI;3131712783;Taip;0;10;0;10
21890;Vilija;DRUGELIAI;2807100092;Taip;8;7;0;15
21891;Vilija;DRUGELIAI;5340772605;Taip;15;0;1;16
21892;Vilija;DRUGELIAI;8429923120;Taip;2;0;4;6
21893;Vilija;DRUGELIAI;7418104659;Taip;0;0;1;1
21894;Vilija;DRUGELIAI;3667953591;Taip;10;0;0;10
21895;Vilija;DRUGELIAI;7836199284;Taip;9;2;0;11
21896;Vilija;DRUGELIAI;7482818685;Taip;8;0;0;8
21897;Vilija;DRUGELIAI;5455278072;Taip;0;5;0;5
21898;Vilija;DRUGELIAI;3349199472;Taip;16;0;0;16
21899;Vilija;DRUGELIAI;6057668143;Taip;0;3;0;3
21900;Vilija;DRUGELIAI;8420744276;Taip;0;7;0;7
21901;Vilija;SMERFAI;7927617851;Taip;0;4;0;4
21902;Vilija;SMERFAI;5508269515;Ne;4;4;0;8
21903;Vilija;SMERFAI;1270627404;Taip;0;1;6;7
21904;Vilija;SMERFAI;2575398136;Taip;8;1;6;15
21905;Vilija;SMERFAI;2164009051;Taip;3;4;0;7
21906;Vilija;SMERFAI;3021504467;Taip;10;1;0;11
21907;Vilija;SMERFAI;5617568215;Taip;3;2;0;5
21908;Vilija;SMERFAI;5056566642;Taip;6;7;0;13
21909;Vilija;SMERFAI;3058713381;Taip;0;3;3;6
21910;Vilija;SMERFAI;4297107641;Taip;6;3;1;10
21911;Vilija;SMERFAI;6165754839;Taip;5;3;1;9
21912;Vilija;SMERFAI;6477644899;Taip;5;5;0;10
21913;Vilija;SMERFAI;25857686522;Taip;0;3;0;3
21914;Vilija;SMERFAI;6937555692;Taip;0;3;3;6
21915;Vilija;SMERFAI;1580316618;Taip;9;3;0;12
21916;Vilija;SMERFAI;5976988338;Ne;0;3;0;3
21917;Vilija;SMERFAI;7606434084;Taip;0;3;0;3
21918;Vilija;SMERFAI;5825920843;Taip;4;3;0;7
21919;Vilija;SAULUTĖS;1442878380;Taip;10;3;1;14
21920;Vilija;SAULUTĖS;7052024709;Ne;0;3;5;8
21921;Vilija;SAULUTĖS;5075219269;Ne;0;3;0;3
21922;Vilija;SAULUTĖS;1161738361;Taip;0;3;0;3
21923;Vilija;SAULUTĖS;7749592467;Ne;3;3;2;8
21924;Vilija;SAULUTĖS;5653564054;Taip;10;1;4;15
21925;Vilija;SAULUTĖS;6706924324;Taip;0;3;0;3
21926;Vilija;SAULUTĖS;5561043797;Taip;0;7;0;7
21927;Vilija;SAULUTĖS;6825500779;Taip;0;3;0;3
21928;Vilija;SAULUTĖS;7860102120;Taip;0;3;2;5
21929;Vilija;SAULUTĖS;2681253266;Taip;0;3;0;3
21930;Vilija;SAULUTĖS;7673248841;Ne;0;7;0;7
21931;Vilija;SAULUTĖS;4481147539;Taip;13;2;0;15
21932;Vilija;SAULUTĖS;8868519717;Taip;0;3;0;3
21933;Vilija;SAULUTĖS;7915451529;Taip;0;3;1;4
21934;Vilija;SAULUTĖS;4253910558;Taip;0;3;3;6
21935;Vilija;SAULUTĖS;1290880830;Taip;5;3;3;11
21936;Vilija;SAULUTĖS;7880863171;Taip;5;3;0;8
21937;Vilija;SAULUTĖS;6792458439;Taip;0;3;1;4
21938;Vilija;SAULUTĖS;7603226092;Taip;0;6;0;6
21939;Vilija;SAULUTĖS;1015329559;Taip;0;3;0;3
21940;Vilija;SAULUTĖS;2551070326;Taip;0;3;0;3
21941;Vilija;SAULUTĖS;3363035704;Ne;0;3;2;5
21942;Vilija;ZUIKUČIAI;5128863532;Taip;0;0;1;1
21943;Vilija;ZUIKUČIAI;7194803557;Taip;8;4;0;12
21944;Vilija;ZUIKUČIAI;9726826566;Taip;2;6;0;8
21945;Vilija;ZUIKUČIAI;6857688873;Taip;7;0;0;7
21946;Vilija;ZUIKUČIAI;8586835095;Taip;14;0;1;15
21947;Vilija;ZUIKUČIAI;4985952177;Taip;8;0;4;12
21948;Vilija;ZUIKUČIAI;4774836050;Taip;0;0;12;12
21949;Vilija;ZUIKUČIAI;9414667437;Taip;8;4;0;12
21950;Vilija;ZUIKUČIAI;9264550987;Taip;17;0;0;17
21951;Vilija;ZUIKUČIAI;5381198018;Taip;1;3;0;4
21952;Vilija;ZUIKUČIAI;4355138593;Taip;12;3;1;16
21953;Vilija;ZUIKUČIAI;5735417577;Taip;22;0;0;22
21954;Vilija;ZUIKUČIAI;9370046849;Taip;15;3;1;19
21955;Vilija;ZUIKUČIAI;7109895494;Taip;0;1;5;6
21956;Vilija;ZUIKUČIAI;4902127595;Taip;0;0;4;4
21957;Vilija;ZUIKUČIAI;4444129040;Taip;5;4;0;9
21958;Vilija;ZUIKUČIAI;3168061557;Taip;6;3;1;10
21959;Vilija;ZUIKUČIAI;7813580782;Taip;3;0;0;3
21960;Vilija;ZUIKUČIAI;6469187290;Ne;12;3;3;18
21961;Vilija;ZUIKUČIAI;5492194393;Taip;0;9;2;11
21962;Vilija;ZUIKUČIAI;4818901769;Taip;28;0;1;29
21963;Vilija;ZUIKUČIAI;6759928420;Taip;2;3;1;6
21964;Vilija;ZUIKUČIAI;4839841253;Taip;3;3;1;7
21965;Vilija;ZUIKUČIAI;8590755333;Taip;0;0;15;15
21966;Vilija;BITUTĖS;4973314993;Taip;0;5;0;5
21967;Vilija;BITUTĖS;4897301808;Ne;0;3;1;4
21968;Vilija;BITUTĖS;9419794080;Taip;0;3;5;8
21969;Vilija;BITUTĖS;1019420340;Taip;0;0;2;2
21970;Vilija;BITUTĖS;5132828941;Taip;8;3;0;11
21971;Vilija;BITUTĖS;9218278301;Taip;0;5;0;5
21972;Vilija;BITUTĖS;7570776491;Taip;5;0;0;5
21973;Vilija;BITUTĖS;9174484523;Taip;0;3;2;5
21974;Vilija;BITUTĖS;5102754179;Taip;8;3;3;14
21975;Vilija;BITUTĖS;4743123463;Taip;19;3;0;22
21976;Vilija;BITUTĖS;8220360728;Taip;0;1;0;1
21977;Vilija;BITUTĖS;3432349973;Taip;1;3;0;4
21978;Vilija;BITUTĖS;8499318976;Taip;0;5;0;5
21979;Vilija;BITUTĖS;8426011190;Taip;0;3;1;4
21980;Vilija;BITUTĖS;8173954240;Taip;0;0;5;5
21981;Vilija;BITUTĖS;1804898751;Taip;4;3;0;7
21982;Vilija;BITUTĖS;9979578408;Taip;0;8;2;10
21983;Vilija;BITUTĖS;5651708105;Taip;7;0;0;7
21984;Vilija;BITUTĖS;9250902486;Taip;4;3;0;7
21985;Vilija;BITUTĖS;6655890861;Taip;0;4;0;4
21986;Vilija;BITUTĖS;4137025486;Taip;7;2;0;9
21987;Vilija;BITUTĖS;7004389875;Taip;0;4;0;4
21988;Vilija;"Pingviniukai (Laisvės pr. 57)";2731415182;Taip;7;0;1;8
21989;Vilija;"Pingviniukai (Laisvės pr. 57)";7015909066;Ne;0;1;0;1
21990;Vilija;"Pingviniukai (Laisvės pr. 57)";4639407305;Taip;3;0;3;6
21991;Vilija;"Pingviniukai (Laisvės pr. 57)";2859663283;Taip;0;0;3;3
21992;Vilija;"Pingviniukai (Laisvės pr. 57)";2903151334;Taip;0;4;1;5
21993;Vilija;"Pingviniukai (Laisvės pr. 57)";7815069972;Taip;0;3;0;3
21994;Vilija;"Pingviniukai (Laisvės pr. 57)";6625339545;Taip;16;0;5;21
21995;Vilija;"Pingviniukai (Laisvės pr. 57)";1840182282;Taip;0;2;0;2
21996;Vilija;"Pingviniukai (Laisvės pr. 57)";4179106082;Taip;8;0;5;13
21997;Vilija;"Pingviniukai (Laisvės pr. 57)";2442272908;Taip;14;0;0;14
21998;Vilija;"Pingviniukai (Laisvės pr. 57)";1845561597;Taip;5;1;2;8
21999;Vilija;"Pingviniukai (Laisvės pr. 57)";1354769998;Taip;2;1;0;3
22000;Vilija;"Pingviniukai (Laisvės pr. 57)";2872066559;Taip;3;0;2;5
22001;Vilija;"Pingviniukai (Laisvės pr. 57)";7219010961;Taip;0;1;2;3
22002;Vilija;"Pingviniukai (Laisvės pr. 57)";5840005178;Taip;7;0;0;7
22003;Vilija;"Pingviniukai (Laisvės pr. 57)";2012412360;Taip;9;0;0;9
22004;Vilija;"Pingviniukai (Laisvės pr. 57)";6855296751;Taip;18;0;4;22
22005;Vilija;"Pingviniukai (Laisvės pr. 57)";2506766222;Taip;7;3;0;10
22006;Vilija;"Pingviniukai (Laisvės pr. 57)";2076388581;Taip;10;1;1;12
22007;Vilija;"Meškiukai (Laisvės pr. 57)";1337656706;Ne;8;0;0;8
22008;Vilija;"Meškiukai (Laisvės pr. 57)";7518841522;Ne;8;0;0;8
22009;Vilija;"Meškiukai (Laisvės pr. 57)";3225442553;Taip;0;1;10;11
22010;Vilija;"Meškiukai (Laisvės pr. 57)";3700333490;Taip;17;0;2;19
22011;Vilija;"Meškiukai (Laisvės pr. 57)";2725051611;Taip;17;5;0;22
22012;Vilija;"Meškiukai (Laisvės pr. 57)";7889810385;Taip;14;0;0;14
22013;Vilija;"Meškiukai (Laisvės pr. 57)";1233653513;Taip;0;3;0;3
22014;Vilija;"Meškiukai (Laisvės pr. 57)";2294228885;Taip;2;0;3;5
22015;Vilija;"Meškiukai (Laisvės pr. 57)";7735728034;Taip;1;1;0;2
22016;Vilija;"Meškiukai (Laisvės pr. 57)";7947071463;Taip;0;0;4;4
22017;Vilija;"Meškiukai (Laisvės pr. 57)";4921409780;Taip;18;1;0;19
22018;Vilija;"Meškiukai (Laisvės pr. 57)";6557918266;Taip;1;0;3;4
22019;Vilija;"Meškiukai (Laisvės pr. 57)";5698897949;Taip;13;0;0;13
22020;Vilija;"Meškiukai (Laisvės pr. 57)";8165784270;Taip;9;0;2;11
22021;Vilija;"Meškiukai (Laisvės pr. 57)";9163803569;Taip;16;0;6;22
22022;Vilija;"Meškiukai (Laisvės pr. 57)";2501118611;Ne;0;2;0;2
22023;Vilija;"Meškiukai (Laisvės pr. 57)";7001209450;Ne;5;10;4;19
22024;Vilija;"Meškiukai (Laisvės pr. 57)";5166455649;Taip;9;1;1;11
22025;Vilija;"Ramunėlės (Laisvės pr. 57)";7707208780;Ne;21;4;0;25
22026;Vilija;"Ramunėlės (Laisvės pr. 57)";7226615203;Taip;11;0;15;26
22027;Vilija;"Ramunėlės (Laisvės pr. 57)";9261213181;Taip;11;3;4;18
22028;Vilija;"Ramunėlės (Laisvės pr. 57)";5034597412;Taip;14;5;0;19
22029;Vilija;"Ramunėlės (Laisvės pr. 57)";6439233139;Taip;7;0;0;7
22030;Vilija;"Ramunėlės (Laisvės pr. 57)";5999958057;Taip;13;4;0;17
22031;Vilija;"Ramunėlės (Laisvės pr. 57)";6142340523;Taip;8;0;0;8
22032;Vilija;"Ramunėlės (Laisvės pr. 57)";4798370162;Taip;22;0;0;22
22033;Vilija;"Ramunėlės (Laisvės pr. 57)";2036033312;Taip;0;0;1;1
22034;Vilija;"Ramunėlės (Laisvės pr. 57)";1902217772;Taip;5;0;0;5
22035;Vilija;"Ramunėlės (Laisvės pr. 57)";9377088075;Taip;18;0;3;21
22036;Vilija;"Ramunėlės (Laisvės pr. 57)";6177733291;Taip;17;0;0;17
22037;Vilija;"Ramunėlės (Laisvės pr. 57)";2455384784;Taip;11;0;0;11
22038;Vilija;"Ramunėlės (Laisvės pr. 57)";1760083113;Taip;14;0;2;16
22039;Vilija;"Ramunėlės (Laisvės pr. 57)";9278725667;Taip;18;0;0;18
22040;Vilija;"Ramunėlės (Laisvės pr. 57)";7288035130;Taip;9;0;5;14
22041;Vilija;"Varpeliai (Laisvės pr. 57)";6742119549;Taip;16;4;0;20
22042;Vilija;"Varpeliai (Laisvės pr. 57)";9641020899;Ne;6;1;0;7
22043;Vilija;"Varpeliai (Laisvės pr. 57)";2948716989;Ne;0;6;0;6
22044;Vilija;"Varpeliai (Laisvės pr. 57)";6525761466;Taip;4;3;0;7
22045;Vilija;"Varpeliai (Laisvės pr. 57)";5277217733;Taip;17;0;0;17
22046;Vilija;"Varpeliai (Laisvės pr. 57)";3346154143;Taip;0;7;0;7
22047;Vilija;"Varpeliai (Laisvės pr. 57)";1502013942;Taip;22;0;0;22
22048;Vilija;"Varpeliai (Laisvės pr. 57)";2190583964;Ne;3;1;1;5
22049;Vilija;"Varpeliai (Laisvės pr. 57)";3920229653;Taip;0;3;0;3
22050;Vilija;"Varpeliai (Laisvės pr. 57)";4969561425;Taip;18;1;2;21
22051;Vilija;"Varpeliai (Laisvės pr. 57)";8092890260;Ne;7;1;0;8
22052;Vilija;"Varpeliai (Laisvės pr. 57)";3998988004;Taip;7;1;3;11
22053;Vilija;"Varpeliai (Laisvės pr. 57)";6756184787;Taip;17;1;0;18
22054;Vilija;"Varpeliai (Laisvės pr. 57)";4288487063;Taip;9;1;0;10
22055;Vilija;"Varpeliai (Laisvės pr. 57)";5768470608;Ne;11;0;1;12
22056;Vilija;"Varpeliai (Laisvės pr. 57)";3589001032;Taip;9;8;0;17
22057;Vilija;"Varpeliai (Laisvės pr. 57)";4692443164;Taip;20;0;0;20
22058;Vilija;"Varpeliai (Laisvės pr. 57)";7426713153;Ne;0;1;6;7
22059;Vilija;"Varpeliai (Laisvės pr. 57)";5734602455;Ne;0;0;3;3
22060;Vilija;"Varpeliai (Laisvės pr. 57)";1440531672;Ne;0;3;0;3
22061;Vilija;"Varpeliai (Laisvės pr. 57)";4562536818;Ne;9;0;1;10
22062;Vilija;"Varpeliai (Laisvės pr. 57)";6226967695;Ne;0;0;1;1
22063;Vilija;"Varpeliai (Laisvės pr. 57)";3062594197;Taip;10;0;0;10
22064;Vilija;"Varpeliai (Laisvės pr. 57)";9226214856;Taip;0;0;1;1
22065;Vilija;"Voveraitės (Laisvės pr. 57)";5694927471;Taip;8;0;0;8
22066;Vilija;"Voveraitės (Laisvės pr. 57)";4936982698;Taip;11;0;0;11
22067;Vilija;"Voveraitės (Laisvės pr. 57)";5450812526;Taip;6;0;0;6
22068;Vilija;"Pelėdžiukai (Laisvės pr. 57)";3269357241;Ne;16;0;0;16
22069;Vilija;"Pelėdžiukai (Laisvės pr. 57)";2055282010;Taip;0;1;2;3
22070;Vilija;"Pelėdžiukai (Laisvės pr. 57)";7358925256;Taip;1;1;0;2
22071;Vilija;"Pelėdžiukai (Laisvės pr. 57)";2778931038;Taip;22;0;0;22
22072;Vilija;"Pelėdžiukai (Laisvės pr. 57)";8465864375;Taip;4;0;1;5
22073;Vilija;"Pelėdžiukai (Laisvės pr. 57)";7784329873;Taip;0;1;4;5
22074;Vilija;"Pelėdžiukai (Laisvės pr. 57)";4437786689;Ne;15;0;1;16
22075;Vilija;"Pelėdžiukai (Laisvės pr. 57)";7089883250;Taip;0;0;3;3
22076;Vilija;"Pelėdžiukai (Laisvės pr. 57)";5043122065;Taip;3;0;3;6
22077;Vilija;"Pelėdžiukai (Laisvės pr. 57)";3581180895;Taip;0;1;0;1
22078;Vilija;"Pelėdžiukai (Laisvės pr. 57)";1306244736;Ne;2;5;0;7
22079;Vilija;"Pelėdžiukai (Laisvės pr. 57)";8608907350;Taip;3;0;2;5
22080;Vilija;"Pelėdžiukai (Laisvės pr. 57)";9117896572;Taip;0;9;0;9
22081;Vilija;"Pelėdžiukai (Laisvės pr. 57)";5821077318;Taip;19;3;0;22
22082;Vilija;"Pelėdžiukai (Laisvės pr. 57)";9471287834;Taip;0;0;1;1
22083;Vilija;"Pelėdžiukai (Laisvės pr. 57)";8186421282;Taip;3;0;4;7
22084;Vilija;"Pelėdžiukai (Laisvės pr. 57)";8815055819;Taip;0;6;0;6
22085;Vilija;"Pelėdžiukai (Laisvės pr. 57)";9750688419;Taip;0;13;0;13
22086;Vilija;"Pelėdžiukai (Laisvės pr. 57)";1778722493;Taip;10;0;0;10
22087;Vilija;"Pelėdžiukai (Laisvės pr. 57)";9915113607;Taip;0;0;6;6
22088;Vilija;"Pelėdžiukai (Laisvės pr. 57)";6581404954;Ne;0;8;0;8
22089;Vilija;"Pelėdžiukai (Laisvės pr. 57)";7869675895;Taip;18;1;0;19
22090;Vilija;"Pelėdžiukai (Laisvės pr. 57)";7697727530;Ne;0;0;7;7
22091;Vilija;"1 A klasė";3262118748;Taip;6;3;0;9
22092;Vilija;"1 A klasė";1827699755;Taip;0;3;0;3
22093;Vilija;"1 A klasė";9758037935;Ne;0;3;0;3
22094;Vilija;"1 A klasė";34399383738;Ne;0;3;0;3
22095;Vilija;"1 A klasė";25927573409;Taip;0;3;0;3
22096;Vilija;"1 A klasė";3493661563;Taip;0;3;0;3
22097;Vilija;"1 A klasė";12341614604;Taip;0;3;0;3
22098;Vilija;"1 A klasė";57020237912;Taip;0;3;0;3
22099;Vilija;"1 A klasė";60737852345;Taip;0;3;0;3
22100;Vilija;"1 A klasė";93217431744;Taip;0;3;0;3
22101;Vilija;"1 A klasė";96736842214;Taip;0;3;0;3
22102;Vilija;"1 A klasė";1130096158;Taip;0;3;0;3
22103;Vilija;"1 A klasė";4213142957;Taip;0;3;0;3
22104;Vilija;"1 A klasė";61428440730;Taip;0;3;0;3
22105;Vilija;"1 A klasė";5904760231;Taip;0;3;0;3
22106;Vilija;"1 A klasė";3095871096;Taip;0;3;0;3
22107;Vilija;"1 A klasė";5149532651;Taip;0;3;0;3
22108;Vilija;"1 A klasė";1065470806;Taip;5;3;0;8
22109;Vilija;"1 A klasė";2060024184;Taip;0;3;0;3
22110;Vilija;"1 A klasė";1588359395;Taip;0;3;0;3
22111;Vilija;"1 A klasė";2036366726;Taip;0;3;0;3
22112;Vilija;"1 A klasė";6818254942;Taip;0;3;0;3
22113;Vilija;"1 A klasė";6265909152;Taip;0;3;0;3
22114;Vilija;"1 B klasė";9072208117;Taip;0;3;0;3
22115;Vilija;"1 B klasė";9363714015;Taip;0;3;0;3
22116;Vilija;"1 B klasė";50372098009;Taip;0;3;0;3
22117;Vilija;"1 B klasė";96636312334;Taip;0;3;0;3
22118;Vilija;"1 B klasė";2822080648;Taip;0;3;0;3
22119;Vilija;"1 B klasė";1404258594;Taip;0;3;0;3
22120;Vilija;"1 B klasė";46757944454;Taip;0;3;0;3
22121;Vilija;"1 B klasė";20003910788;Ne;0;3;0;3
22122;Vilija;"1 B klasė";3645300574;Taip;0;3;0;3
22123;Vilija;"1 B klasė";6657294393;Taip;0;3;0;3
22124;Vilija;"1 B klasė";40990687217;Taip;0;3;0;3
22125;Vilija;"1 B klasė";6405741006;Taip;6;3;0;9
22126;Vilija;"1 B klasė";2725391251;Taip;6;3;0;9
22127;Vilija;"1 B klasė";1318132922;Taip;0;3;0;3
22128;Vilija;"1 B klasė";1163483318;Taip;0;3;0;3
22129;Vilija;"1 B klasė";8793138240;Taip;0;3;0;3
22130;Vilija;"1 B klasė";7595977304;Taip;0;3;0;3
22131;Vilija;"1 B klasė";22204555252;Taip;0;3;0;3
22132;Vilija;"1 B klasė";3541189470;Taip;5;3;0;8
22133;Vilija;"1 B klasė";1046075234;Taip;0;3;0;3
22134;Vilija;"1 B klasė";42973327518;Taip;0;3;0;3
22135;Vilija;"1 B klasė";1567546511;Taip;0;3;0;3
22136;Vilija;"2 A klasė";25029347324;Taip;0;3;0;3
22137;Vilija;"2 A klasė";25029347324;Taip;0;3;0;3
22138;Vilija;"2 A klasė";25029347324;Taip;0;3;0;3
22139;Vilija;"2 A klasė";25029347324;Taip;0;3;0;3
22140;Vilija;"2 A klasė";33063987306;Taip;0;3;0;3
22141;Vilija;"2 A klasė";33063987306;Taip;0;3;0;3
22142;Vilija;"2 A klasė";1799128848;Taip;0;3;0;3
22143;Vilija;"2 A klasė";38068336379;Taip;19;3;0;22
22144;Vilija;"2 A klasė";38068336379;Taip;19;3;0;22
22145;Vilija;"2 A klasė";98476858512;Taip;0;3;0;3
22146;Vilija;"2 A klasė";98476858512;Taip;0;3;0;3
22147;Vilija;"2 A klasė";1890319177;Taip;0;3;0;3
22148;Vilija;"2 A klasė";1890319177;Taip;0;3;0;3
22149;Vilija;"2 A klasė";45697794473;Taip;0;3;0;3
22150;Vilija;"2 A klasė";3906509026;Taip;0;3;0;3
22151;Vilija;"2 A klasė";88939931199;Taip;4;3;0;7
22152;Vilija;"2 A klasė";98553857685;Taip;5;3;0;8
22153;Vilija;"2 A klasė";98553857685;Taip;5;3;0;8
22154;Vilija;"2 A klasė";6207442135;Taip;0;3;0;3
22155;Vilija;"2 A klasė";13479943342;Taip;0;3;0;3
22156;Vilija;"2 A klasė";13479943342;Taip;0;3;0;3
22157;Vilija;"2 A klasė";83366206408;Taip;0;3;0;3
22158;Vilija;"2 A klasė";1482922709;Taip;0;3;0;3
22159;Vilija;"2 A klasė";1482922709;Taip;0;3;0;3
22160;Vilija;"2 A klasė";18769361005;Taip;0;3;0;3
22161;Vilija;"2 A klasė";18769361005;Taip;0;3;0;3
22162;Vilija;"2 A klasė";18769361005;Taip;0;3;0;3
22163;Vilija;"2 A klasė";18769361005;Taip;0;3;0;3
22164;Vilija;"2 A klasė";24939501245;Taip;0;3;0;3
22165;Vilija;"2 A klasė";1372699042;Taip;0;3;0;3
22166;Vilija;"2 A klasė";1372699042;Taip;0;3;0;3
22167;Vilija;"2 A klasė";9110911745;Taip;0;3;0;3
22168;Vilija;"2 A klasė";8867152773;Taip;0;3;0;3
22169;Vilija;"2 A klasė";89880758183;Taip;0;3;0;3
22170;Vilija;"2 A klasė";89880758183;Taip;0;3;0;3
22171;Vilija;"2 A klasė";69445577844;Taip;0;3;0;3
22172;Vilija;"2 A klasė";69445577844;Taip;0;3;0;3
22173;Vilija;"2 A klasė";61636842808;Taip;0;3;0;3
22174;Vilija;"2 A klasė";3216714595;Taip;0;3;0;3
22175;Vilija;"2 A klasė";3216714595;Taip;0;3;0;3
22176;Vilija;"2 A klasė";4589089474;Ne;0;3;0;3
22177;Vilija;"2 B klasė";9641600096;Taip;0;3;0;3
22178;Vilija;"2 B klasė";9641600096;Taip;0;3;0;3
22179;Vilija;"2 B klasė";9641600096;Taip;0;3;0;3
22180;Vilija;"2 B klasė";96355926476;Taip;0;3;0;3
22181;Vilija;"2 B klasė";96355926476;Taip;0;3;0;3
22182;Vilija;"2 B klasė";77737606304;Taip;0;3;0;3
22183;Vilija;"2 B klasė";1407201614;Taip;0;3;0;3
22184;Vilija;"2 B klasė";1407201614;Taip;0;3;0;3
22185;Vilija;"2 B klasė";9555938324;Taip;0;3;0;3
22186;Vilija;"2 B klasė";9555938324;Taip;0;3;0;3
22187;Vilija;"2 B klasė";9555938324;Taip;0;3;0;3
22188;Vilija;"2 B klasė";1091559795;Taip;0;3;0;3
22189;Vilija;"2 B klasė";1091559795;Taip;0;3;0;3
22190;Vilija;"2 B klasė";1110951690;Ne;0;3;0;3
22191;Vilija;"2 B klasė";1110951690;Ne;0;3;0;3
22192;Vilija;"2 B klasė";72120808860;Taip;0;3;0;3
22193;Vilija;"2 B klasė";72120808860;Taip;0;3;0;3
22194;Vilija;"2 B klasė";72120808860;Taip;0;3;0;3
22195;Vilija;"2 B klasė";72120808860;Taip;0;3;0;3
22196;Vilija;"2 B klasė";5564233235;Taip;0;3;0;3
22197;Vilija;"2 B klasė";5564233235;Taip;0;3;0;3
22198;Vilija;"2 B klasė";1838966160;Taip;0;3;0;3
22199;Vilija;"2 B klasė";1838966160;Taip;0;3;0;3
22200;Vilija;"2 B klasė";1860444886;Taip;0;3;0;3
22201;Vilija;"2 B klasė";1860444886;Taip;0;3;0;3
22202;Vilija;"2 B klasė";73843468623;Taip;0;3;0;3
22203;Vilija;"2 B klasė";73843468623;Taip;0;3;0;3
22204;Vilija;"2 B klasė";14337185731;Taip;0;3;0;3
22205;Vilija;"2 B klasė";14337185731;Taip;0;3;0;3
22206;Vilija;"2 B klasė";2013940932;Taip;0;3;0;3
22207;Vilija;"2 B klasė";2013940932;Taip;0;3;0;3
22208;Vilija;"2 B klasė";6622641059;Taip;0;3;0;3
22209;Vilija;"2 B klasė";1913615370;Taip;0;3;0;3
22210;Vilija;"2 B klasė";9396618279;Ne;0;3;0;3
22211;Vilija;"2 B klasė";8903951955;Taip;0;3;0;3
22212;Vilija;"2 B klasė";8903951955;Taip;0;3;0;3
22213;Vilija;"2 B klasė";7379866222;Ne;0;3;0;3
22214;Vilija;"2 B klasė";2040858735;Taip;0;3;0;3
22215;Vilija;"2 B klasė";2040858735;Taip;0;3;0;3
22216;Vilija;"2 B klasė";8687001991;Taip;0;3;0;3
22217;Vilija;"2 B klasė";8687001991;Taip;0;3;0;3
22218;Vilija;"2 B klasė";3553109625;Ne;0;3;0;3
22219;Vilija;"2 B klasė";48643895669;Taip;0;3;0;3
22220;Vilija;"2 B klasė";40987081532;Taip;0;3;0;3
22221;Vilija;"2 B klasė";40987081532;Taip;0;3;0;3
22222;Vilija;"2 B klasė";40987081532;Taip;0;3;0;3
22223;Vilija;"2 B klasė";40987081532;Taip;0;3;0;3
22224;Vilija;"3 A klasė";86124718200;Taip;0;3;0;3
22225;Vilija;"3 A klasė";86124718200;Taip;0;3;0;3
22226;Vilija;"3 A klasė";86124718200;Taip;0;3;0;3
22227;Vilija;"3 A klasė";86124718200;Taip;0;3;0;3
22228;Vilija;"3 A klasė";19894176979;Taip;0;3;0;3
22229;Vilija;"3 A klasė";19894176979;Taip;0;3;0;3
22230;Vilija;"3 A klasė";19894176979;Taip;0;3;0;3
22231;Vilija;"3 A klasė";19894176979;Taip;0;3;0;3
22232;Vilija;"3 A klasė";35617359110;Taip;0;3;0;3
22233;Vilija;"3 A klasė";53452186167;Taip;0;3;0;3
22234;Vilija;"3 A klasė";42795294834;Taip;0;3;0;3
22235;Vilija;"3 A klasė";99288204344;Taip;0;3;0;3
22236;Vilija;"3 A klasė";99288204344;Taip;0;3;0;3
22237;Vilija;"3 A klasė";1459862887;Taip;0;3;0;3
22238;Vilija;"3 A klasė";22193308946;Taip;0;3;0;3
22239;Vilija;"3 A klasė";22193308946;Taip;0;3;0;3
22240;Vilija;"3 A klasė";8467512804;Taip;0;3;0;3
22241;Vilija;"3 A klasė";8467512804;Taip;0;3;0;3
22242;Vilija;"3 A klasė";8467512804;Taip;0;3;0;3
22243;Vilija;"3 A klasė";8290409889;Taip;0;3;0;3
22244;Vilija;"3 A klasė";8119923809;Ne;0;3;0;3
22245;Vilija;"3 A klasė";29561152625;Taip;0;3;0;3
22246;Vilija;"3 A klasė";82990158209;Ne;0;3;0;3
22247;Vilija;"3 A klasė";18111520082;Taip;0;3;0;3
22248;Vilija;"3 A klasė";18111520082;Taip;0;3;0;3
22249;Vilija;"3 A klasė";18111520082;Taip;0;3;0;3
22250;Vilija;"3 A klasė";4642044129;Taip;0;3;0;3
22251;Vilija;"3 A klasė";4642044129;Taip;0;3;0;3
22252;Vilija;"3 A klasė";4642044129;Taip;0;3;0;3
22253;Vilija;"3 A klasė";4642044129;Taip;0;3;0;3
22254;Vilija;"3 A klasė";1105127733;Taip;0;3;0;3
22255;Vilija;"3 A klasė";1105127733;Taip;0;3;0;3
22256;Vilija;"3 A klasė";73317989147;Taip;0;3;0;3
22257;Vilija;"3 A klasė";2102796663;Taip;0;3;0;3
22258;Vilija;"3 A klasė";96326385935;Taip;0;3;0;3
22259;Vilija;"3 A klasė";96326385935;Taip;0;3;0;3
22260;Vilija;"3 A klasė";96326385935;Taip;0;3;0;3
22261;Vilija;"3 A klasė";86867736047;Ne;0;3;0;3
22262;Vilija;"3 A klasė";1236191042;Taip;0;3;0;3
22263;Vilija;"3 A klasė";2040557798;Taip;0;3;0;3
22264;Vilija;"3 A klasė";2040557798;Taip;0;3;0;3
22265;Vilija;"3 A klasė";45551453665;Taip;0;3;0;3
22266;Vilija;"3 A klasė";45551453665;Taip;0;3;0;3
22267;Vilija;"3 A klasė";28783733910;Taip;0;3;0;3
22268;Vilija;"3 A klasė";28783733910;Taip;0;3;0;3
22269;Vilija;"3 A klasė";28783733910;Taip;0;3;0;3
22270;Vilija;"3 A klasė";28783733910;Taip;0;3;0;3
22271;Vilija;"3 A klasė";22193308946;Taip;0;3;0;3
22272;Vilija;"3 A klasė";22193308946;Taip;0;3;0;3
22273;Vilija;"3 B klasė";1090555980;Taip;0;3;0;3
22274;Vilija;"3 B klasė";1023494497;Taip;0;3;0;3
22275;Vilija;"3 B klasė";1023494497;Taip;0;3;0;3
22276;Vilija;"3 B klasė";45144017584;Taip;0;3;0;3
22277;Vilija;"3 B klasė";45144017584;Taip;0;3;0;3
22278;Vilija;"3 B klasė";48393620450;Taip;0;3;0;3
22279;Vilija;"3 B klasė";48393620450;Taip;0;3;0;3
22280;Vilija;"3 B klasė";94879856163;Taip;0;3;0;3
22281;Vilija;"3 B klasė";94879856163;Taip;0;3;0;3
22282;Vilija;"3 B klasė";36268207929;Taip;0;3;0;3
22283;Vilija;"3 B klasė";36268207929;Taip;0;3;0;3
22284;Vilija;"3 B klasė";48578028107;Taip;0;3;0;3
22285;Vilija;"3 B klasė";48578028107;Taip;0;3;0;3
22286;Vilija;"3 B klasė";48578028107;Taip;0;3;0;3
22287;Vilija;"3 B klasė";1497044775;Taip;0;3;0;3
22288;Vilija;"3 B klasė";1497044775;Taip;0;3;0;3
22289;Vilija;"3 B klasė";72919494405;Taip;0;3;0;3
22290;Vilija;"3 B klasė";65846179652;Taip;0;3;0;3
22291;Vilija;"3 B klasė";65846179652;Taip;0;3;0;3
22292;Vilija;"3 B klasė";64276710131;Ne;0;3;0;3
22293;Vilija;"3 B klasė";64276710131;Ne;0;3;0;3
22294;Vilija;"3 B klasė";81065447875;Taip;0;3;0;3
22295;Vilija;"3 B klasė";81065447875;Taip;0;3;0;3
22296;Vilija;"3 B klasė";75332459876;Taip;0;3;0;3
22297;Vilija;"3 B klasė";75332459876;Taip;0;3;0;3
22298;Vilija;"3 B klasė";56568361276;Taip;0;3;0;3
22299;Vilija;"3 B klasė";43825017559;Taip;0;3;0;3
22300;Vilija;"3 B klasė";43825017559;Taip;0;3;0;3
22301;Vilija;"3 B klasė";26012264791;Ne;0;3;0;3
22302;Vilija;"3 B klasė";26012264791;Ne;0;3;0;3
22303;Vilija;"3 B klasė";59182954538;Taip;0;3;0;3
22304;Vilija;"3 B klasė";22952446246;Taip;0;3;0;3
22305;Vilija;"3 B klasė";1281726023;Ne;0;3;0;3
22306;Vilija;"3 B klasė";42663338876;Taip;0;3;0;3
22307;Vilija;"3 B klasė";42663338876;Taip;0;3;0;3
22308;Vilija;"3 B klasė";42663338876;Taip;0;3;0;3
22309;Vilija;"3 B klasė";42663338876;Taip;0;3;0;3
22310;Vilija;"3 B klasė";65450791871;Ne;0;3;0;3
22311;Vilija;"3 B klasė";65450791871;Ne;0;3;0;3
22312;Vilija;"3 B klasė";65450791871;Ne;0;3;0;3
22313;Vilija;"3 B klasė";65450791871;Ne;0;3;0;3
22314;Vilija;"3 B klasė";44674068414;Taip;0;3;0;3
22315;Vilija;"3 B klasė";44674068414;Taip;0;3;0;3
22316;Vilija;"3 B klasė";44674068414;Taip;0;3;0;3
22317;Vilija;"3 B klasė";98541698293;Ne;0;3;0;3
22318;Vilija;"3 B klasė";98541698293;Ne;0;3;0;3
22319;Vilija;"3 B klasė";2738918883;Taip;0;3;0;3
22320;Vilija;"3 B klasė";2738918883;Taip;0;3;0;3
22321;Vilija;"3 B klasė";2738918883;Taip;0;3;0;3
22322;Vilija;"3 B klasė";2738918883;Taip;0;3;0;3
22323;Vilija;"3 B klasė";81065447875;Taip;0;3;0;3
22324;Vilija;"3 B klasė";81065447875;Taip;0;3;0;3
22325;Vilija;"4 A klasė";70378983845;Taip;3;3;0;6
22326;Vilija;"4 A klasė";70378983845;Taip;3;3;0;6
22327;Vilija;"4 A klasė";24867618982;Ne;0;3;0;3
22328;Vilija;"4 A klasė";11585786511;Taip;0;3;0;3
22329;Vilija;"4 A klasė";45522084009;Taip;0;3;0;3
22330;Vilija;"4 A klasė";45522084009;Taip;0;3;0;3
22331;Vilija;"4 A klasė";28561188828;Taip;0;3;0;3
22332;Vilija;"4 A klasė";28561188828;Taip;0;3;0;3
22333;Vilija;"4 A klasė";82559433799;Taip;0;3;0;3
22334;Vilija;"4 A klasė";72714511237;Ne;0;3;0;3
22335;Vilija;"4 A klasė";8309162906;Taip;0;3;0;3
22336;Vilija;"4 A klasė";43088504714;Ne;0;3;0;3
22337;Vilija;"4 A klasė";43088504714;Ne;0;3;0;3
22338;Vilija;"4 A klasė";43088504714;Ne;0;3;0;3
22339;Vilija;"4 A klasė";43088504714;Ne;0;3;0;3
22340;Vilija;"4 A klasė";24103860100;Taip;0;3;0;3
22341;Vilija;"4 A klasė";24103860100;Taip;0;3;0;3
22342;Vilija;"4 A klasė";72966804906;Taip;0;3;0;3
22343;Vilija;"4 A klasė";88456677238;Ne;0;3;0;3
22344;Vilija;"4 A klasė";37032249703;Taip;0;3;0;3
22345;Vilija;"4 A klasė";37032249703;Taip;0;3;0;3
22346;Vilija;"4 A klasė";52874823568;Taip;0;3;0;3
22347;Vilija;"4 A klasė";52874823568;Taip;0;3;0;3
22348;Vilija;"4 A klasė";5843488337;Taip;0;3;0;3
22349;Vilija;"4 A klasė";5843488337;Taip;0;3;0;3
22350;Vilija;"4 A klasė";5843488337;Taip;0;3;0;3
22351;Vilija;"4 A klasė";5843488337;Taip;0;3;0;3
22352;Vilija;"4 A klasė";5933198621;Ne;0;3;0;3
22353;Vilija;"4 A klasė";3184088380;Taip;0;3;0;3
22354;Vilija;"4 A klasė";3184088380;Taip;0;3;0;3
22355;Vilija;"4 A klasė";92413925752;Taip;0;3;0;3
22356;Vilija;"4 A klasė";92413925752;Taip;0;3;0;3
22357;Vilija;"4 A klasė";8552196328;Ne;0;3;0;3
22358;Vilija;"4 A klasė";8552196328;Ne;0;3;0;3
22359;Vilija;"4 A klasė";6443793437;Taip;0;3;0;3
22360;Vilija;"4 A klasė";1546363831;Taip;0;3;0;3
22361;Vilija;"4 A klasė";24279127852;Taip;0;3;0;3
22362;Vilija;"4 A klasė";24279127852;Taip;0;3;0;3
22363;Vilija;"4 A klasė";24279127852;Taip;0;3;0;3
22364;Vilija;"4 A klasė";24279127852;Taip;0;3;0;3
22365;Vilija;"4 A klasė";59282697879;Taip;0;3;0;3
22366;Vilija;"4 A klasė";42530946821;Ne;0;3;0;3
22367;Vilija;"4 A klasė";42530946821;Ne;0;3;0;3
22368;Vilija;"4 A klasė";42530946821;Ne;0;3;0;3
22369;Vilija;"4 A klasė";42530946821;Ne;0;3;0;3
22370;Vilija;"4 A klasė";55064836651;Taip;0;3;0;3
22371;Vilija;"4 B klasė";5682982350;Taip;0;3;0;3
22372;Vilija;"4 B klasė";40286409640;Taip;0;3;0;3
22373;Vilija;"4 B klasė";40286409640;Taip;0;3;0;3
22374;Vilija;"4 B klasė";30837537401;Taip;0;3;0;3
22375;Vilija;"4 B klasė";35111018435;Taip;0;3;0;3
22376;Vilija;"4 B klasė";8344052767;Ne;0;3;0;3
22377;Vilija;"4 B klasė";85407532912;Taip;0;3;0;3
22378;Vilija;"4 B klasė";86829175389;Taip;0;3;0;3
22379;Vilija;"4 B klasė";74481596266;Taip;0;3;0;3
22380;Vilija;"4 B klasė";21575700026;Taip;0;3;0;3
22381;Vilija;"4 B klasė";21575700026;Taip;0;3;0;3
22382;Vilija;"4 B klasė";61788720593;Taip;0;3;0;3
22383;Vilija;"4 B klasė";61788720593;Taip;0;3;0;3
22384;Vilija;"4 B klasė";61788720593;Taip;0;3;0;3
22385;Vilija;"4 B klasė";24106898816;Taip;0;3;0;3
22386;Vilija;"4 B klasė";24106898816;Taip;0;3;0;3
22387;Vilija;"4 B klasė";24106898816;Taip;0;3;0;3
22388;Vilija;"4 B klasė";24106898816;Taip;0;3;0;3
22389;Vilija;"4 B klasė";3326521933;Taip;0;3;0;3
22390;Vilija;"4 B klasė";3326521933;Taip;0;3;0;3
22391;Vilija;"4 B klasė";85447158165;Taip;0;3;0;3
22392;Vilija;"4 B klasė";14208532169;Taip;0;3;0;3
22393;Vilija;"4 B klasė";14208532169;Taip;0;3;0;3
22394;Vilija;"4 B klasė";38841935509;Taip;0;3;0;3
22395;Vilija;"4 B klasė";6059056944;Ne;0;3;0;3
22396;Vilija;"4 B klasė";11294908682;Taip;0;3;0;3
22397;Vilija;"4 B klasė";11294908682;Taip;0;3;0;3
22398;Vilija;"4 B klasė";11294908682;Taip;0;3;0;3
22399;Vilija;"4 B klasė";11294908682;Taip;0;3;0;3
22400;Vilija;"4 B klasė";68319399217;Taip;0;3;0;3
22401;Vilija;"4 B klasė";68319399217;Taip;0;3;0;3
22402;Vilija;"4 B klasė";46374146554;Taip;0;3;0;3
22403;Vilija;"4 B klasė";46374146554;Taip;0;3;0;3
22404;Vilija;"4 B klasė";70597034584;Taip;0;3;0;3
22405;Vilija;"4 B klasė";70597034584;Taip;0;3;0;3
22406;Vilija;"4 B klasė";96950082618;Taip;0;3;0;3
22407;Vilija;"4 B klasė";96950082618;Taip;0;3;0;3
22408;Vilija;"4 B klasė";96950082618;Taip;0;3;0;3
22409;Vilija;"4 B klasė";96950082618;Taip;0;3;0;3
22410;Švelnukas;Pelėdžiukai;8016531082;Taip;10;6;6;22
22411;Švelnukas;Pelėdžiukai;8219071968;Taip;3;2;3;8
22412;Švelnukas;Pelėdžiukai;3235768013;Taip;0;1;1;2
22413;Švelnukas;Pelėdžiukai;9008722163;Taip;5;7;0;12
22414;Švelnukas;Pelėdžiukai;1116279011;Ne;19;3;0;22
22415;Švelnukas;Pelėdžiukai;3892058023;Ne;19;3;0;22
22416;Švelnukas;Pelėdžiukai;5681611554;Taip;14;0;1;15
22417;Švelnukas;Pelėdžiukai;8589226595;Taip;6;0;6;12
22418;Švelnukas;Pelėdžiukai;9802064955;Taip;0;2;0;2
22419;Švelnukas;Pelėdžiukai;5041138716;Taip;9;0;0;9
22420;Švelnukas;Pelėdžiukai;3804532959;Taip;0;1;0;1
22421;Švelnukas;Pelėdžiukai;1462620951;Taip;0;7;0;7
22422;Švelnukas;Pelėdžiukai;8650902343;Taip;0;6;2;8
22423;Švelnukas;Pelėdžiukai;1409803554;Taip;0;4;0;4
22424;Švelnukas;Pelėdžiukai;1991507109;Ne;0;9;0;9
22425;Švelnukas;Pelėdžiukai;9808833734;Taip;11;8;0;19
22426;Švelnukas;Pelėdžiukai;6318581157;Taip;0;0;1;1
22427;Švelnukas;Pelėdžiukai;6069027553;Taip;10;1;0;11
22428;Švelnukas;Pelėdžiukai;9814032171;Taip;3;0;0;3
22429;Švelnukas;Ežiukai;64192510147;Taip;3;1;0;4
22430;Švelnukas;Ežiukai;25374873288;Taip;0;2;2;4
22431;Švelnukas;Ežiukai;6282389058;Taip;0;2;0;2
22432;Švelnukas;Ežiukai;23795609183;Taip;5;3;0;8
22433;Švelnukas;Ežiukai;4711482287;Taip;14;0;0;14
22434;Švelnukas;Ežiukai;8681264696;Taip;5;3;0;8
22435;Švelnukas;Ežiukai;4373567509;Taip;9;0;0;9
22436;Švelnukas;Ežiukai;2521009631;Taip;10;0;0;10
22437;Švelnukas;Ežiukai;1165172787;Taip;0;1;0;1
22438;Švelnukas;Ežiukai;2892176166;Taip;10;0;0;10
22439;Švelnukas;Ežiukai;7308701231;Taip;0;5;1;6
22440;Švelnukas;Ežiukai;2400781175;Taip;3;0;0;3
22441;Švelnukas;Ežiukai;6209334207;Taip;4;0;2;6
22442;Švelnukas;Ežiukai;1201550386;Taip;6;0;3;9
22443;Švelnukas;Ežiukai;7266255326;Taip;0;1;2;3
22444;Švelnukas;Ežiukai;2348752207;Taip;0;22;0;22
22445;Švelnukas;Ežiukai;1143579276;Taip;1;0;0;1
22446;Švelnukas;Ežiukai;5409130195;Taip;9;0;0;9
22447;Švelnukas;Ežiukai;3645855145;Taip;9;0;0;9
22448;Švelnukas;Ežiukai;9402567487;Ne;15;0;1;16
22449;Švelnukas;Ežiukai;8569985034;Ne;0;11;0;11
22450;Švelnukas;Švelnukai;4681584014;Taip;4;0;2;6
22451;Švelnukas;Švelnukai;6607578153;Taip;3;0;2;5
22452;Švelnukas;Švelnukai;8847738918;Taip;2;0;0;2
22453;Švelnukas;Švelnukai;9766734938;Ne;5;0;1;6
22454;Švelnukas;Švelnukai;3020524039;Taip;0;1;2;3
22455;Švelnukas;Švelnukai;9829912750;Taip;5;0;0;5
22456;Švelnukas;Švelnukai;1411710913;Taip;6;1;2;9
22457;Švelnukas;Švelnukai;2464467471;Taip;5;0;2;7
22458;Švelnukas;Švelnukai;5213589179;Taip;0;6;0;6
22459;Švelnukas;Švelnukai;4544791546;Taip;10;3;0;13
22460;Švelnukas;Švelnukai;1963518457;Taip;0;1;1;2
22461;Švelnukas;Švelnukai;4194249709;Taip;0;5;4;9
22462;Švelnukas;Švelnukai;5936821902;Taip;4;0;2;6
22463;Švelnukas;Švelnukai;3228293160;Taip;3;1;1;5
22464;Švelnukas;Švelnukai;7607215137;Taip;1;0;0;1
22465;Švelnukas;Švelnukai;4629757899;Taip;5;5;0;10
22466;Švelnukas;Švelnukai;6964997767;Taip;9;1;4;14
22467;Švelnukas;Švelnukai;8951810066;Taip;0;0;2;2
22468;Švelnukas;Švelnukai;2663990082;Taip;10;0;1;11
22469;Švelnukas;Švelnukai;6204286255;Taip;7;1;5;13
22470;Švelnukas;Švelnukai;5960966542;Taip;3;1;1;5
22471;Švelnukas;Boružiukai;1951447127;Taip;8;0;3;11
22472;Švelnukas;Boružiukai;3849957906;Ne;11;0;10;21
22473;Švelnukas;Boružiukai;5550841477;Taip;14;3;0;17
22474;Švelnukas;Boružiukai;9722532034;Taip;2;1;0;3
22475;Švelnukas;Boružiukai;1264256177;Taip;7;0;4;11
22476;Švelnukas;Boružiukai;1332533332;Taip;0;0;8;8
22477;Švelnukas;Boružiukai;8787505507;Ne;7;0;0;7
22478;Švelnukas;Boružiukai;4134678301;Taip;0;0;1;1
22479;Švelnukas;Boružiukai;8458233793;Taip;0;0;8;8
22480;Švelnukas;Boružiukai;7967996032;Taip;10;0;1;11
22481;Švelnukas;Boružiukai;8951980999;Taip;4;6;0;10
22482;Švelnukas;Boružiukai;4990399144;Taip;8;6;0;14
22483;Švelnukas;Boružiukai;9575767514;Ne;0;0;14;14
22484;Švelnukas;Boružiukai;6282137936;Taip;10;8;0;18
22485;Švelnukas;Boružiukai;9479536507;Taip;7;0;0;7
22486;Švelnukas;Boružiukai;2088128734;Taip;8;1;0;9
22487;Švelnukas;Boružiukai;2077614498;Ne;10;0;0;10
22488;Švelnukas;Boružiukai;3145935641;Taip;5;0;1;6
22489;Švelnukas;Boružiukai;4404904322;Taip;0;0;9;9
22490;Švelnukas;Boružiukai;3561920685;Taip;2;0;3;5
22491;Švelnukas;Boružiukai;8895028305;Taip;8;0;0;8
22492;Švelnukas;Boružiukai;4961854528;Taip;0;0;9;9
22493;Švelnukas;Boružiukai;4823928859;Taip;3;1;2;6
22494;Švelnukas;Smalsučiai;9558811523;Taip;2;0;4;6
22495;Švelnukas;Smalsučiai;5085517759;Taip;4;0;0;4
22496;Švelnukas;Smalsučiai;1661019352;Taip;6;9;0;15
22497;Švelnukas;Smalsučiai;5554625346;Taip;6;0;0;6
22498;Švelnukas;Smalsučiai;3282020958;Taip;6;0;0;6
22499;Švelnukas;Smalsučiai;2730288544;Taip;5;0;0;5
22500;Švelnukas;Smalsučiai;5805289419;Taip;9;0;2;11
22501;Švelnukas;Smalsučiai;1415899173;Taip;7;1;0;8
22502;Švelnukas;Smalsučiai;7987715134;Taip;13;4;0;17
22503;Švelnukas;Smalsučiai;3455801077;Taip;0;22;0;22
22504;Švelnukas;Smalsučiai;8193690277;Taip;8;1;0;9
22505;Švelnukas;Smalsučiai;9371102717;Taip;0;22;0;22
22506;Švelnukas;Smalsučiai;3472774028;Taip;3;0;1;4
22507;Švelnukas;Smalsučiai;5845744917;Taip;0;1;16;17
22508;Švelnukas;Smalsučiai;6764222588;Taip;0;0;15;15
22509;Švelnukas;Smalsučiai;1840752560;Taip;9;8;2;19
22510;Švelnukas;Smalsučiai;8268391509;Taip;10;0;0;10
22511;Švelnukas;Smalsučiai;4467095100;Taip;6;1;8;15
22512;Švelnukas;Nykštukai;5518267134;Taip;10;3;0;13
22513;Švelnukas;Nykštukai;1293700097;Taip;4;0;3;7
22514;Švelnukas;Nykštukai;8221642452;Taip;5;1;0;6
22515;Švelnukas;Nykštukai;2141519946;Taip;0;8;0;8
22516;Švelnukas;Nykštukai;8771953161;Taip;7;6;3;16
22517;Švelnukas;Nykštukai;5327209876;Taip;6;10;0;16
22518;Švelnukas;Nykštukai;2282356211;Taip;5;1;0;6
22519;Švelnukas;Nykštukai;4697253853;Taip;6;0;1;7
22520;Švelnukas;Nykštukai;7387060610;Taip;0;7;0;7
22521;Švelnukas;Nykštukai;1762528313;Taip;0;1;1;2
22522;Švelnukas;Nykštukai;7380948648;Taip;7;2;1;10
22523;Švelnukas;Nykštukai;3473146893;Taip;0;1;1;2
22524;Švelnukas;Nykštukai;3370028567;Taip;8;2;0;10
22525;Švelnukas;Nykštukai;62969317035;Taip;0;0;1;1
22526;Švelnukas;Nykštukai;6633233824;Taip;9;0;0;9
22527;Švelnukas;Nykštukai;2106591525;Taip;14;1;0;15
22528;Švelnukas;Nykštukai;93497358197;Taip;5;4;0;9
22529;Švelnukas;Nykštukai;2971380970;Taip;5;0;0;5
22530;Švelnukas;Nykštukai;3389897065;Taip;5;0;1;6
22531;Švelnukas;Nykštukai;4302735157;Taip;0;12;2;14
22532;Švelnukas;Nykštukai;2785396019;Taip;4;0;2;6
22533;Švelnukas;Nykštukai;6195335543;Taip;4;0;0;4
22534;Boružėlė;"Nykštukai gudručiai";3340082011;Taip;0;2;0;2
22535;Boružėlė;"Nykštukai gudručiai";7736917485;Taip;17;1;0;18
22536;Boružėlė;"Nykštukai gudručiai";9520696660;Taip;0;18;0;18
22537;Boružėlė;"Nykštukai gudručiai";5691884576;Ne;0;1;0;1
22538;Boružėlė;"Nykštukai gudručiai";9193273478;Taip;19;0;0;19
22539;Boružėlė;"Nykštukai gudručiai";3237771499;Taip;10;3;0;13
22540;Boružėlė;"Nykštukai gudručiai";8359957290;Taip;0;3;2;5
22541;Boružėlė;"Nykštukai gudručiai";8141240094;Taip;0;0;10;10
22542;Boružėlė;"Nykštukai gudručiai";2349571778;Taip;10;0;0;10
22543;Boružėlė;"Nykštukai gudručiai";1894170218;Taip;22;1;0;23
22544;Boružėlė;"Nykštukai gudručiai";3509512899;Taip;24;0;0;24
22545;Boružėlė;"Nykštukai gudručiai";8888151470;Taip;24;0;0;24
22546;Boružėlė;"Nykštukai gudručiai";3430953692;Taip;0;4;0;4
22547;Boružėlė;"Nykštukai gudručiai";8365962523;Taip;7;0;2;9
22548;Boružėlė;"Nykštukai gudručiai";3592853535;Taip;3;2;0;5
22549;Boružėlė;"Nykštukai gudručiai";6876323023;Taip;5;8;0;13
22550;Boružėlė;"Nykštukai gudručiai";2744894565;Taip;10;3;0;13
22551;Boružėlė;"Nykštukai gudručiai";6590829182;Ne;5;2;0;7
22552;Boružėlė;"Nykštukai gudručiai";3129825206;Ne;0;4;0;4
22553;Boružėlė;"Nykštukai gudručiai";9771767352;Taip;2;3;0;5
22554;Boružėlė;"Nykštukai gudručiai";8789209196;Taip;13;0;0;13
22555;Boružėlė;"Nykštukai gudručiai";2571360077;Taip;3;3;1;7
22556;Boružėlė;"Nykštukai gudručiai";9078805020;Taip;6;3;0;9
22557;Boružėlė;"Saulės zuikučiai";4554260776;Taip;10;2;0;12
22558;Boružėlė;"Saulės zuikučiai";5298170118;Taip;9;2;0;11
22559;Boružėlė;"Saulės zuikučiai";2133849514;Taip;4;7;0;11
22560;Boružėlė;"Saulės zuikučiai";1116012068;Taip;11;2;0;13
22561;Boružėlė;"Saulės zuikučiai";1292298259;Taip;0;0;1;1
22562;Boružėlė;"Saulės zuikučiai";3130977416;Taip;0;3;2;5
22563;Boružėlė;"Saulės zuikučiai";7256396576;Taip;0;0;1;1
22564;Boružėlė;"Saulės zuikučiai";4323998138;Taip;0;0;3;3
22565;Boružėlė;"Saulės zuikučiai";3952645542;Ne;0;3;0;3
22566;Boružėlė;"Saulės zuikučiai";5516103398;Taip;0;0;7;7
22567;Boružėlė;"Saulės zuikučiai";8259586236;Taip;9;0;0;9
22568;Boružėlė;"Saulės zuikučiai";3955841578;Taip;9;0;0;9
22569;Boružėlė;"Saulės zuikučiai";1583223569;Taip;11;0;0;11
22570;Boružėlė;"Saulės zuikučiai";4433248526;Taip;5;0;2;7
22571;Boružėlė;"Saulės zuikučiai";1547802140;Taip;7;0;0;7
22572;Boružėlė;"Saulės zuikučiai";4020348640;Taip;12;0;1;13
22573;Boružėlė;"Saulės zuikučiai";2842256033;Taip;3;0;0;3
22574;Boružėlė;"Saulės zuikučiai";2561969142;Taip;12;1;4;17
22575;Boružėlė;"Saulės zuikučiai";7262515868;Taip;5;1;0;6
22576;Boružėlė;"Saulės zuikučiai";6527254253;Taip;9;3;0;12
22577;Boružėlė;"Saulės zuikučiai";7942043844;Taip;0;6;0;6
22578;Boružėlė;Gėlytės;3288141024;Taip;4;2;0;6
22579;Boružėlė;Gėlytės;1166207929;Taip;14;3;0;17
22580;Boružėlė;Gėlytės;7956982615;Ne;4;2;0;6
22581;Boružėlė;Gėlytės;4637656311;Taip;4;0;4;8
22582;Boružėlė;Gėlytės;3226733236;Taip;0;1;0;1
22583;Boružėlė;Gėlytės;6070356395;Taip;4;3;1;8
22584;Boružėlė;Gėlytės;4180537253;Taip;10;0;0;10
22585;Boružėlė;Gėlytės;6722353853;Taip;10;2;4;16
22586;Boružėlė;Gėlytės;8376436755;Taip;13;0;0;13
22587;Boružėlė;Gėlytės;3300678477;Taip;4;2;0;6
22588;Boružėlė;Gėlytės;7763958937;Taip;0;5;2;7
22589;Boružėlė;Gėlytės;9855354210;Taip;3;0;1;4
22590;Boružėlė;Gėlytės;2515608520;Ne;17;0;0;17
22591;Boružėlė;Gėlytės;3354291446;Taip;5;0;5;10
22592;Boružėlė;Gėlytės;8520403894;Taip;11;1;0;12
22593;Boružėlė;Gėlytės;4268486154;Ne;3;0;0;3
22594;Boružėlė;Gėlytės;7614216150;Taip;0;2;1;3
22595;Boružėlė;Gėlytės;4448964310;Taip;0;0;8;8
22596;Boružėlė;Gėlytės;8205706322;Taip;10;2;4;16
22597;Boružėlė;Gėlytės;8834231529;Ne;0;5;8;13
22598;Boružėlė;Gėlytės;8929444125;Taip;7;0;0;7
22599;Boružėlė;Gėlytės;3604658753;Taip;3;0;0;3
22600;Boružėlė;Smalsutis;2086485441;Taip;0;0;5;5
22601;Boružėlė;Smalsutis;5129244830;Taip;6;0;1;7
22602;Boružėlė;Smalsutis;2887130633;Taip;0;19;0;19
22603;Boružėlė;Smalsutis;4947670606;Taip;12;0;4;16
22604;Boružėlė;Smalsutis;2917508421;Taip;10;0;0;10
22605;Boružėlė;Smalsutis;7263730692;Taip;9;0;0;9
22606;Boružėlė;Smalsutis;5708558321;Taip;0;4;2;6
22607;Boružėlė;Smalsutis;2132904457;Taip;0;1;0;1
22608;Boružėlė;Smalsutis;77513300382;Taip;0;1;0;1
22609;Boružėlė;Smalsutis;39553430808;Taip;6;0;4;10
22610;Boružėlė;Smalsutis;4958704459;Taip;11;2;0;13
22611;Boružėlė;Smalsutis;5618586722;Taip;0;0;1;1
22612;Boružėlė;Smalsutis;4283064680;Taip;6;0;2;8
22613;Boružėlė;Smalsutis;2447148171;Ne;0;1;0;1
22614;Boružėlė;Smalsutis;7386694567;Taip;0;1;0;1
22615;Boružėlė;Smalsutis;9634967237;Taip;0;1;6;7
22616;Boružėlė;Smalsutis;3592594142;Taip;0;1;6;7
22617;Boružėlė;Drugeliai;8357946299;Taip;8;2;0;10
22618;Boružėlė;Drugeliai;1130980139;Taip;0;3;2;5
22619;Boružėlė;Drugeliai;6463583187;Taip;5;3;0;8
22620;Boružėlė;Drugeliai;3136028536;Taip;10;2;0;12
22621;Boružėlė;Drugeliai;2211576663;Taip;0;7;0;7
22622;Boružėlė;Drugeliai;1559001916;Taip;8;2;1;11
22623;Boružėlė;Drugeliai;4233602822;Taip;0;2;0;2
22624;Boružėlė;Drugeliai;9463322491;Taip;0;2;0;2
22625;Boružėlė;Drugeliai;8482813204;Taip;0;1;1;2
22626;Boružėlė;Drugeliai;6369070055;Taip;0;3;2;5
22627;Boružėlė;Drugeliai;6902130914;Taip;14;0;0;14
22628;Boružėlė;Drugeliai;3459207879;Taip;4;0;0;4
22629;Boružėlė;Drugeliai;6980022864;Taip;0;3;0;3
22630;Boružėlė;Drugeliai;5726187445;Taip;9;0;0;9
22631;Boružėlė;Drugeliai;6049501362;Taip;0;3;0;3
22632;Boružėlė;Drugeliai;3405184929;Taip;0;0;5;5
22633;Boružėlė;Drugeliai;8213060214;Taip;14;0;0;14
22634;Boružėlė;Drugeliai;2783338563;Taip;0;3;2;5
22635;Boružėlė;Vyturėliai;1913540317;Taip;0;3;0;3
22636;Boružėlė;Vyturėliai;1950269258;Taip;5;1;0;6
22637;Boružėlė;Vyturėliai;1591582954;Taip;0;9;0;9
22638;Boružėlė;Vyturėliai;9180459278;Taip;0;0;1;1
22639;Boružėlė;Vyturėliai;3322567969;Taip;10;1;1;12
22640;Boružėlė;Vyturėliai;8311383437;Ne;0;2;2;4
22641;Boružėlė;Vyturėliai;7534482245;Ne;20;1;0;21
22642;Boružėlė;Vyturėliai;3310676316;Ne;0;2;0;2
22643;Boružėlė;Vyturėliai;87834777247;Ne;5;2;0;7
22644;Boružėlė;Vyturėliai;50071056728;Taip;0;12;0;12
22645;Boružėlė;Vyturėliai;2098408445;Taip;7;3;0;10
22646;Boružėlė;Vyturėliai;8706461730;Ne;0;6;0;6
22647;Boružėlė;Vyturėliai;5337704114;Taip;0;3;0;3
22648;Boružėlė;Vyturėliai;8146684259;Taip;6;3;0;9
22649;Boružėlė;Vyturėliai;8225622711;Taip;0;2;0;2
22650;Boružėlė;Vyturėliai;9150703371;Ne;13;1;0;14
22651;Boružėlė;Vyturėliai;5811751925;Taip;0;3;0;3
22652;Boružėlė;Vyturėliai;7136428795;Taip;4;0;0;4
22653;Boružėlė;Vyturėliai;6978158667;Taip;5;2;0;7
22654;Boružėlė;Vyturėliai;9640681773;Taip;0;1;18;19
22655;Boružėlė;Vyturėliai;5576016171;Taip;9;3;0;12
22656;Boružėlė;Žvaigždutės;4990831292;Taip;15;0;0;15
22657;Boružėlė;Žvaigždutės;9838823214;Taip;12;1;0;13
22658;Boružėlė;Žvaigždutės;7825636053;Taip;0;2;0;2
22659;Boružėlė;Žvaigždutės;7901880926;Taip;0;0;1;1
22660;Boružėlė;Žvaigždutės;6242220139;Taip;5;2;0;7
22661;Boružėlė;Žvaigždutės;3489498503;Taip;11;0;0;11
22662;Boružėlė;Žvaigždutės;5274016839;Taip;0;1;0;1
22663;Boružėlė;Žvaigždutės;9720535449;Taip;0;3;0;3
22664;Boružėlė;Žvaigždutės;6435556131;Taip;0;3;0;3
22665;Boružėlė;Žvaigždutės;5307997577;Taip;0;0;6;6
22666;Boružėlė;Žvaigždutės;8916241914;Taip;0;2;1;3
22667;Boružėlė;Žvaigždutės;6724101421;Taip;8;4;0;12
22668;Boružėlė;Žvaigždutės;7078709057;Taip;4;1;0;5
22669;Boružėlė;Žvaigždutės;8820827882;Taip;4;3;0;7
22670;Boružėlė;Žvaigždutės;2857645329;Taip;0;1;0;1
22671;Boružėlė;Žvaigždutės;5242187638;Taip;0;2;1;3
22672;Boružėlė;Žvaigždutės;1799882790;Taip;0;5;0;5
22673;Boružėlė;Žvaigždutės;5420788580;Taip;0;0;7;7
22674;Boružėlė;Žvaigždutės;6130634131;Taip;7;0;3;10
22675;Boružėlė;Ąžuoliukai;5774358876;Taip;3;2;2;7
22676;Boružėlė;Ąžuoliukai;4519645340;Ne;0;3;0;3
22677;Boružėlė;Ąžuoliukai;24315678618;Taip;11;1;2;14
22678;Boružėlė;Ąžuoliukai;4994696176;Taip;8;0;0;8
22679;Boružėlė;Ąžuoliukai;6439902117;Taip;10;1;0;11
22680;Boružėlė;Ąžuoliukai;3040376382;Taip;0;3;0;3
22681;Boružėlė;Ąžuoliukai;3840860155;Taip;5;0;0;5
22682;Boružėlė;Ąžuoliukai;7722277859;Taip;1;3;0;4
22683;Boružėlė;Ąžuoliukai;6954794465;Taip;2;1;0;3
22684;Boružėlė;Ąžuoliukai;5832223872;Taip;0;9;0;9
22685;Boružėlė;Ąžuoliukai;3695411422;Taip;0;3;0;3
22686;Boružėlė;Ąžuoliukai;45181369655;Taip;3;0;0;3
22687;Boružėlė;Ąžuoliukai;2077228543;Taip;0;0;20;20
22688;Boružėlė;Ąžuoliukai;6022191251;Taip;7;0;0;7
22689;Boružėlė;Ąžuoliukai;3869817904;Taip;0;5;0;5
22690;Boružėlė;Ąžuoliukai;9269501176;Taip;15;0;0;15
22691;Boružėlė;Ąžuoliukai;8029389952;Taip;4;5;0;9
22692;Boružėlė;Ąžuoliukai;8683282162;Taip;0;1;0;1
22693;Boružėlė;Ąžuoliukai;9999252614;Taip;14;0;0;14
22694;Boružėlė;Saulutės;9492548829;Taip;11;2;0;13
22695;Boružėlė;Saulutės;5437943626;Taip;8;1;0;9
22696;Boružėlė;Saulutės;3503931241;Taip;8;1;0;9
22697;Boružėlė;Saulutės;8882070834;Taip;12;0;0;12
22698;Boružėlė;Saulutės;2999335505;Taip;3;0;0;3
22699;Boružėlė;Saulutės;7882386455;Ne;5;2;4;11
22700;Boružėlė;Saulutės;6265279517;Taip;15;0;0;15
22701;Boružėlė;Saulutės;6275425512;Taip;7;0;0;7
22702;Boružėlė;Saulutės;2879726579;Taip;6;0;3;9
22703;Boružėlė;Saulutės;8804878419;Taip;4;1;0;5
22704;Boružėlė;Saulutės;3871593172;Taip;4;1;0;5
22705;Boružėlė;Saulutės;3953507461;Taip;5;2;0;7
22706;Boružėlė;Saulutės;1492091211;Taip;13;0;0;13
22707;Boružėlė;Saulutės;1830043506;Taip;13;0;0;13
22708;Boružėlė;Saulutės;5680510186;Taip;6;2;0;8
22709;Boružėlė;Saulutės;1152697871;Taip;4;4;0;8
22710;Boružėlė;Saulutės;1779839709;Ne;0;6;0;6
22711;Boružėlė;Saulutės;7652740249;Taip;13;1;0;14
22712;Boružėlė;Saulutės;5508064424;Taip;22;0;0;22
22713;Boružėlė;Saulutės;7260471712;Taip;7;5;3;15
22714;Boružėlė;Saulutės;5064892417;Taip;0;2;1;3
22715;Boružėlė;Saulutės;8577301586;Taip;0;4;1;5
22716;Boružėlė;Saulutės;8660954142;Taip;0;4;2;6
22717;Boružėlė;Ežiukai;8195442951;Taip;0;3;6;9
22718;Boružėlė;Ežiukai;6448688592;Taip;3;1;0;4
22719;Boružėlė;Ežiukai;2429696310;Ne;0;2;0;2
22720;Boružėlė;Ežiukai;9893643199;Taip;0;9;0;9
22721;Boružėlė;Ežiukai;3112016309;Taip;3;1;0;4
22722;Boružėlė;Ežiukai;5394149649;Taip;3;1;0;4
22723;Boružėlė;Ežiukai;9391811395;Taip;0;2;0;2
22724;Boružėlė;Ežiukai;8167376712;Taip;9;5;2;16
22725;Boružėlė;Ežiukai;1784594085;Taip;9;1;0;10
22726;Boružėlė;Ežiukai;9423458813;Taip;5;2;0;7
22727;Boružėlė;Ežiukai;5825164520;Taip;3;0;0;3
22728;Boružėlė;Ežiukai;7190980006;Taip;0;3;0;3
22729;Boružėlė;Ežiukai;7459531236;Taip;0;1;0;1
22730;Boružėlė;Ežiukai;8818358360;Taip;0;1;0;1
22731;Boružėlė;Ežiukai;1693082285;Taip;4;0;0;4
22732;Boružėlė;Ežiukai;2926620929;Taip;0;11;0;11
22733;Boružėlė;Ežiukai;6609156790;Taip;0;5;6;11
22734;Boružėlė;Ežiukai;5768415821;Taip;0;1;0;1
22735;Boružėlė;Ežiukai;8291389794;Taip;5;3;0;8
22736;Boružėlė;Ežiukai;5492228053;Taip;6;2;0;8
22737;Boružėlė;Ežiukai;6087811262;Taip;15;3;0;18
22738;Boružėlė;Boružiukai;7068409148;Taip;4;2;0;6
22739;Boružėlė;Boružiukai;8434178580;Taip;6;2;0;8
22740;Boružėlė;Boružiukai;8752343077;Taip;4;2;3;9
22741;Boružėlė;Boružiukai;7065907155;Taip;12;0;0;12
22742;Boružėlė;Boružiukai;4113917886;Taip;22;0;0;22
22743;Boružėlė;Boružiukai;7149439740;Taip;0;5;0;5
22744;Boružėlė;Boružiukai;3005601935;Taip;13;5;0;18
22745;Boružėlė;Boružiukai;4497753570;Taip;4;0;2;6
22746;Boružėlė;Boružiukai;1865891989;Ne;7;1;0;8
22747;Boružėlė;Boružiukai;2298750617;Taip;15;0;0;15
22748;Boružėlė;Boružiukai;8739264310;Taip;16;2;0;18
22749;Boružėlė;Boružiukai;3097874340;Taip;9;0;0;9
22750;Boružėlė;Boružiukai;1551933321;Taip;5;2;0;7
22751;Boružėlė;Boružiukai;3097217902;Taip;9;0;0;9
22752;Boružėlė;Boružiukai;2084361709;Taip;0;1;0;1
22753;Boružėlė;Boružiukai;4727351240;Taip;17;3;0;20
22754;Boružėlė;Nykštukai;3331139963;Taip;0;3;0;3
22755;Boružėlė;Nykštukai;9822629428;Taip;0;2;2;4
22756;Boružėlė;Nykštukai;9663535338;Taip;0;2;2;4
22757;Boružėlė;Nykštukai;1047419932;Taip;2;3;0;5
22758;Boružėlė;Nykštukai;2104101406;Taip;10;0;0;10
22759;Boružėlė;Nykštukai;8377410278;Taip;13;1;2;16
22760;Boružėlė;Nykštukai;4928818565;Taip;4;0;0;4
22761;Boružėlė;Nykštukai;5619719965;Taip;0;5;0;5
22762;Boružėlė;Nykštukai;1966066642;Taip;18;0;0;18
22763;Boružėlė;Nykštukai;6267999965;Taip;9;2;0;11
22764;Boružėlė;Nykštukai;8073918985;Ne;6;0;0;6
22765;Boružėlė;Nykštukai;3595998843;Taip;0;4;0;4
22766;Boružėlė;Nykštukai;1929202434;Taip;10;0;3;13
22767;Boružėlė;Nykštukai;4217116059;Taip;0;3;0;3
22768;Boružėlė;Nykštukai;8165748779;Taip;13;1;5;19
22769;Žaliakalnio;Drugeliai;6379145626;Ne;16;0;0;16
22770;Žaliakalnio;Drugeliai;7094914749;Taip;0;9;0;9
22771;Žaliakalnio;Drugeliai;7449949339;Ne;0;2;0;2
22772;Žaliakalnio;Drugeliai;2607433844;Taip;6;2;0;8
22773;Žaliakalnio;Drugeliai;1413563085;Ne;0;7;0;7
22774;Žaliakalnio;Drugeliai;2432935088;Ne;0;1;0;1
22775;Žaliakalnio;Drugeliai;9032003195;Ne;7;5;0;12
22776;Žaliakalnio;Drugeliai;7566429633;Taip;0;7;0;7
22777;Žaliakalnio;Drugeliai;3835667120;Taip;0;5;0;5
22778;Žaliakalnio;Drugeliai;6341640909;Taip;8;1;0;9
22779;Žaliakalnio;Drugeliai;4059753894;Ne;1;0;0;1
22780;Žaliakalnio;Drugeliai;2305496316;Ne;0;4;1;5
22781;Žaliakalnio;Drugeliai;9984857605;Taip;0;2;0;2
22782;Žaliakalnio;Drugeliai;5764128482;Ne;0;5;0;5
22783;Žaliakalnio;Drugeliai;4497938258;Taip;3;5;1;9
22784;Žaliakalnio;Drugeliai;1673321992;Taip;3;4;0;7
22785;Žaliakalnio;Boružėlių;5843020412;Taip;5;6;0;11
22786;Žaliakalnio;Boružėlių;9625531462;Taip;0;17;0;17
22787;Žaliakalnio;Boružėlių;6699373334;Taip;0;17;0;17
22788;Žaliakalnio;Boružėlių;7087535800;Taip;0;3;0;3
22789;Žaliakalnio;Boružėlių;1528111839;Taip;2;0;0;2
22790;Žaliakalnio;Boružėlių;7023886811;Taip;0;7;0;7
22791;Žaliakalnio;Boružėlių;2284465378;Taip;3;9;0;12
22792;Žaliakalnio;Boružėlių;7977009681;Taip;0;2;0;2
22793;Žaliakalnio;Boružėlių;2808776865;Taip;8;0;2;10
22794;Žaliakalnio;Boružėlių;2278681435;Ne;5;0;6;11
22795;Žaliakalnio;Boružėlių;9421259943;Taip;10;0;0;10
22796;Žaliakalnio;Boružėlių;3445649442;Taip;7;5;0;12
22797;Žaliakalnio;Boružėlių;3105500733;Taip;7;1;1;9
22798;Žaliakalnio;Boružėlių;1200844791;Taip;10;2;0;12
22799;Žaliakalnio;Boružėlių;8052539476;Taip;16;6;0;22
22800;Žaliakalnio;Boružėlių;6590016097;Ne;9;5;0;14
22801;Žaliakalnio;Boružėlių;8304431519;Ne;17;0;0;17
22802;Žaliakalnio;Boružėlių;5488964606;Taip;4;1;1;6
22803;Žaliakalnio;Boružėlių;8429135626;Taip;4;11;0;15
22804;Žaliakalnio;Boružėlių;8073554707;Ne;18;0;0;18
22805;Žaliakalnio;Boružėlių;8534973941;Ne;9;13;0;22
22806;Žaliakalnio;Boružėlių;2987217910;Taip;9;6;0;15
22807;Žaliakalnio;Boružėlių;5157814568;Taip;11;0;0;11
22808;Žaliakalnio;Zuikučiai;1592051491;Taip;0;2;0;2
22809;Žaliakalnio;Zuikučiai;6088333997;Taip;5;5;0;10
22810;Žaliakalnio;Zuikučiai;2673619031;Taip;11;3;0;14
22811;Žaliakalnio;Zuikučiai;5843314345;Taip;0;3;0;3
22812;Žaliakalnio;Zuikučiai;2180165053;Taip;0;6;0;6
22813;Žaliakalnio;Zuikučiai;6823528666;Taip;9;4;0;13
22814;Žaliakalnio;Zuikučiai;3509064089;Taip;4;2;0;6
22815;Žaliakalnio;Zuikučiai;7000429934;Taip;3;8;0;11
22816;Žaliakalnio;Zuikučiai;5730610895;Taip;3;3;0;6
22817;Žaliakalnio;Zuikučiai;6881070397;Taip;3;6;0;9
22818;Žaliakalnio;Zuikučiai;8209559343;Taip;9;3;1;13
22819;Žaliakalnio;Zuikučiai;9799056285;Taip;3;5;0;8
22820;Žaliakalnio;Zuikučiai;1321592040;Ne;0;6;0;6
22821;Žaliakalnio;Zuikučiai;8298313285;Ne;4;3;0;7
22822;Žaliakalnio;Zuikučiai;9331287916;Taip;0;5;0;5
22823;Žaliakalnio;Zuikučiai;6726832258;Ne;0;6;0;6
22824;Žaliakalnio;Zuikučiai;4607456527;Taip;11;3;0;14
22825;Žaliakalnio;Zuikučiai;9363615751;Taip;4;4;0;8
22826;Žaliakalnio;Zuikučiai;6727442688;Ne;17;2;0;19
22827;Žaliakalnio;Bitutė;5744370516;Taip;2;7;0;9
22828;Žaliakalnio;Bitutė;3619817569;Ne;3;2;0;5
22829;Žaliakalnio;Bitutė;3905448562;Taip;18;1;0;19
22830;Žaliakalnio;Bitutė;8481665290;Taip;0;2;2;4
22831;Žaliakalnio;Bitutė;8950583202;Taip;0;8;0;8
22832;Žaliakalnio;Bitutė;6324315523;Taip;13;3;0;16
22833;Žaliakalnio;Bitutė;6877235095;Taip;2;3;0;5
22834;Žaliakalnio;Bitutė;2280683252;Ne;0;2;2;4
22835;Žaliakalnio;Bitutė;7711347723;Taip;14;1;0;15
22836;Žaliakalnio;Bitutė;4561672875;Taip;10;2;0;12
22837;Žaliakalnio;Bitutė;8185190219;Taip;1;2;0;3
22838;Žaliakalnio;Bitutė;7830692152;Taip;1;2;0;3
22839;Žaliakalnio;Bitutė;1423481154;Taip;10;3;0;13
22840;Žaliakalnio;Bitutė;4928400872;Taip;0;7;0;7
22841;Žaliakalnio;Bitutė;2613771302;Taip;0;2;0;2
22842;Žaliakalnio;Bitutė;3976548663;Taip;9;4;0;13
22843;Žaliakalnio;Bitutė;8599646291;Taip;0;3;3;6
22844;Žaliakalnio;Bitutė;1343293430;Taip;0;9;0;9
22845;Žaliakalnio;Bitutė;3721878250;Ne;8;1;1;10
22846;Žaliakalnio;Bitutė;6291287113;Taip;0;2;1;3
22847;Žaliakalnio;Bitutė;4412760433;Taip;2;2;3;7
22848;Žaliakalnio;Bitutė;7989372873;Ne;0;6;0;6
22849;Žaliakalnio;Bitutė;1173977434;Taip;15;3;0;18
22850;Žaliakalnio;Nykštukų;9069518153;Taip;5;13;0;18
22851;Žaliakalnio;Nykštukų;8142435757;Taip;16;3;0;19
22852;Žaliakalnio;Nykštukų;3446593135;Taip;5;5;1;11
22853;Žaliakalnio;Nykštukų;1064854294;Taip;17;4;0;21
22854;Žaliakalnio;Nykštukų;4891656355;Ne;12;2;0;14
22855;Žaliakalnio;Nykštukų;1632465983;Taip;10;4;0;14
22856;Žaliakalnio;Nykštukų;8472945857;Taip;5;2;1;8
22857;Žaliakalnio;Nykštukų;9521104462;Taip;17;1;0;18
22858;Žaliakalnio;Nykštukų;5565027085;Ne;7;2;2;11
22859;Žaliakalnio;Nykštukų;2242604156;Ne;5;8;0;13
22860;Žaliakalnio;Nykštukų;8852165484;Taip;12;2;2;16
22861;Žaliakalnio;Nykštukų;9801618806;Taip;3;7;0;10
22862;Žaliakalnio;Nykštukų;2225778044;Taip;11;0;0;11
22863;Žaliakalnio;Nykštukų;4255734788;Taip;14;1;1;16
22864;Žaliakalnio;Nykštukų;7793937917;Taip;10;4;0;14
22865;Žaliakalnio;Nykštukų;8117013474;Ne;17;1;0;18
22866;Žaliakalnio;Nykštukų;7205368281;Taip;0;11;0;11
22867;Žaliakalnio;Nykštukų;7495990953;Ne;7;0;0;7
22868;Žaliakalnio;Nykštukų;8360480591;Taip;0;1;7;8
22869;Žaliakalnio;Nykštukų;4036239701;Taip;10;2;0;12
22870;Žaliakalnio;Nykštukų;5258266970;Taip;22;0;0;22
22871;Žaliakalnio;Nykštukų;6166482260;Taip;19;0;0;19
22872;Žaliakalnio;Nykštukų;3041002600;Taip;0;15;0;15
22873;Žaliakalnio;ŽIOGELIAI;2426844621;Ne;0;4;0;4
22874;Žaliakalnio;ŽIOGELIAI;5752912101;Ne;3;1;0;4
22875;Žaliakalnio;ŽIOGELIAI;9967098834;Ne;3;7;0;10
22876;Žaliakalnio;ŽIOGELIAI;1133557422;Taip;9;3;0;12
22877;Žaliakalnio;ŽIOGELIAI;3464935314;Ne;0;7;0;7
22878;Žaliakalnio;ŽIOGELIAI;7648422668;Ne;10;4;0;14
22879;Žaliakalnio;ŽIOGELIAI;4702470511;Taip;15;0;0;15
22880;Žaliakalnio;ŽIOGELIAI;2272043654;Taip;3;11;0;14
22881;Žaliakalnio;ŽIOGELIAI;8518422934;Taip;0;7;0;7
22882;Žaliakalnio;ŽIOGELIAI;6674631040;Ne;11;1;0;12
22883;Žaliakalnio;ŽIOGELIAI;8245784590;Taip;22;0;0;22
22884;Žaliakalnio;ŽIOGELIAI;9485995178;Taip;0;5;0;5
22885;Žaliakalnio;ŽIOGELIAI;8179329874;Ne;14;0;0;14
22886;Žaliakalnio;ŽIOGELIAI;8383425712;Ne;17;0;0;17
22887;Žaliakalnio;ŽIOGELIAI;1309236035;Ne;6;1;1;8
22888;Žaliakalnio;ŽIOGELIAI;7025195076;Taip;8;0;0;8
22889;Žaliakalnio;ŽIOGELIAI;2514763739;Ne;0;2;0;2
22890;Žaliakalnio;ŽIOGELIAI;8891815592;Ne;3;5;0;8
22891;Žaliakalnio;ŽIOGELIAI;6294045755;Taip;0;11;0;11
22892;Žaliakalnio;ŽIOGELIAI;8232697563;Taip;9;5;0;14
22893;Žaliakalnio;ŽIOGELIAI;2694424532;Taip;16;1;0;17
22894;Žaliakalnio;ŽIOGELIAI;6136717862;Ne;0;2;1;3
22895;Žaliakalnio;ŽIOGELIAI;8316505307;Taip;0;8;0;8
22896;Žaliakalnio;SAULUTĖS;5602734465;Taip;0;17;0;17
22897;Žaliakalnio;SAULUTĖS;2328766492;Taip;12;3;0;15
22898;Žaliakalnio;SAULUTĖS;1253655689;Taip;3;3;0;6
22899;Žaliakalnio;SAULUTĖS;3016537413;Taip;0;2;0;2
22900;Žaliakalnio;SAULUTĖS;6795532166;Taip;15;2;1;18
22901;Žaliakalnio;SAULUTĖS;4154737541;Ne;7;4;0;11
22902;Žaliakalnio;SAULUTĖS;7913029369;Taip;0;12;0;12
22903;Žaliakalnio;SAULUTĖS;7793917852;Taip;13;2;0;15
22904;Žaliakalnio;SAULUTĖS;3018398546;Taip;13;3;0;16
22905;Žaliakalnio;SAULUTĖS;8765159796;Taip;17;1;0;18
22906;Žaliakalnio;SAULUTĖS;3028921540;Taip;13;4;0;17
22907;Žaliakalnio;SAULUTĖS;7636933790;Taip;5;17;0;22
22908;Žaliakalnio;SAULUTĖS;4355433666;Taip;13;2;0;15
22909;Žaliakalnio;SAULUTĖS;1975313368;Taip;18;0;0;18
22910;Žaliakalnio;SAULUTĖS;9016032548;Taip;3;1;0;4
22911;Žaliakalnio;SAULUTĖS;1715385224;Taip;16;2;0;18
22912;Žaliakalnio;SAULUTĖS;3304186400;Taip;12;6;0;18
22913;Žaliakalnio;SAULUTĖS;3434815790;Taip;7;1;0;8
22914;Žaliakalnio;SAULUTĖS;3832291926;Taip;5;1;0;6
22915;Žaliakalnio;SAULUTĖS;7071209465;Taip;8;1;0;9
22916;Žaliakalnio;SAULUTĖS;7543073516;Taip;8;4;0;12
22917;Žaliakalnio;SAULUTĖS;9379373983;Taip;13;2;0;15
22918;Žaliakalnio;SAULUTĖS;2806386840;Taip;16;1;0;17
22919;Volungė;Bitutės;6661730121;Taip;6;0;4;10
22920;Volungė;Bitutės;5791161943;Taip;0;0;3;3
22921;Volungė;Bitutės;3307326410;Taip;9;0;2;11
22922;Volungė;Bitutės;5300334761;Taip;4;0;0;4
22923;Volungė;Bitutės;6755366051;Taip;5;0;0;5
22924;Volungė;Bitutės;4013639324;Taip;0;6;2;8
22925;Volungė;Bitutės;2599441104;Taip;0;0;1;1
22926;Volungė;Bitutės;5892600735;Taip;0;0;10;10
22927;Volungė;Bitutės;1902122510;Taip;0;0;8;8
22928;Volungė;Bitutės;1752817125;Taip;0;0;22;22
22929;Volungė;Bitutės;3515725398;Taip;6;0;1;7
22930;Volungė;Bitutės;3666364101;Taip;0;1;2;3
22931;Volungė;Bitutės;7151952679;Taip;0;3;3;6
22932;Volungė;Bitutės;5960027749;Taip;0;0;1;1
22933;Volungė;Bitutės;5149291935;Taip;0;1;0;1
22934;Volungė;Bitutės;8166517073;Taip;0;1;0;1
22935;Volungė;Bitutės;3106135598;Taip;2;0;1;3
22936;Volungė;Bitutės;9842009354;Taip;4;0;6;10
22937;Volungė;Bitutės;4437625791;Ne;0;1;0;1
22938;Volungė;Bitutės;9933980783;Taip;0;0;9;9
22939;Volungė;Bitutės;4685227759;Taip;0;0;8;8
22940;Volungė;Boružiukai;6431477042;Taip;0;0;7;7
22941;Volungė;Boružiukai;1137713075;Taip;4;5;0;9
22942;Volungė;Boružiukai;2322594823;Taip;13;4;0;17
22943;Volungė;Boružiukai;7965601199;Taip;0;1;0;1
22944;Volungė;Boružiukai;3746978206;Taip;0;0;3;3
22945;Volungė;Boružiukai;9188994935;Taip;0;12;0;12
22946;Volungė;Boružiukai;8285309230;Taip;10;0;3;13
22947;Volungė;Boružiukai;7149986415;Taip;0;1;0;1
22948;Volungė;Boružiukai;4598763851;Taip;0;1;0;1
22949;Volungė;Boružiukai;7867741556;Taip;13;0;0;13
22950;Volungė;Boružiukai;8459167833;Taip;0;3;0;3
22951;Volungė;Boružiukai;6028582927;Taip;16;1;0;17
22952;Volungė;Boružiukai;3832613221;Taip;8;0;0;8
22953;Volungė;Boružiukai;1757041481;Taip;7;1;1;9
22954;Volungė;Boružiukai;7971287899;Ne;0;8;0;8
22955;Volungė;Boružiukai;2627555750;Taip;0;0;9;9
22956;Volungė;Boružiukai;2068447339;Taip;0;22;0;22
22957;Volungė;Boružiukai;3528581949;Taip;0;0;5;5
22958;Volungė;Žvirbliukai;2360026330;Taip;5;0;5;10
22959;Volungė;Žvirbliukai;8414351815;Ne;11;0;1;12
22960;Volungė;Žvirbliukai;2051410463;Ne;7;0;4;11
22961;Volungė;Žvirbliukai;5074093178;Taip;4;0;0;4
22962;Volungė;Žvirbliukai;9575894080;Ne;0;0;3;3
22963;Volungė;Žvirbliukai;8927595898;Taip;14;0;1;15
22964;Volungė;Žvirbliukai;9384821249;Taip;8;0;1;9
22965;Volungė;Žvirbliukai;5361410157;Taip;17;0;0;17
22966;Volungė;Žvirbliukai;3499045731;Taip;0;0;18;18
22967;Volungė;Žvirbliukai;4235842588;Ne;0;0;1;1
22968;Volungė;Žvirbliukai;3028611395;Taip;0;22;0;22
22969;Volungė;Žvirbliukai;2949033093;Ne;18;0;2;20
22970;Volungė;Žvirbliukai;2159667991;Taip;0;0;6;6
22971;Volungė;Žvirbliukai;3282765504;Taip;0;0;14;14
22972;Volungė;Žvirbliukai;5470252589;Taip;0;2;15;17
22973;Volungė;Žvirbliukai;7923029388;Taip;0;0;1;1
22974;Volungė;Žiogeliai;6360834021;Taip;5;0;1;6
22975;Volungė;Žiogeliai;4856240879;Ne;5;0;9;14
22976;Volungė;Žiogeliai;9816038480;Ne;0;0;2;2
22977;Volungė;Žiogeliai;8640511964;Taip;0;5;2;7
22978;Volungė;Žiogeliai;5170536566;Taip;0;1;1;2
22979;Volungė;Žiogeliai;8421730419;Taip;0;0;11;11
22980;Volungė;Žiogeliai;6532202782;Taip;0;0;1;1
22981;Volungė;Žiogeliai;2712034356;Taip;15;0;1;16
22982;Volungė;Žiogeliai;2246291631;Taip;4;0;0;4
22983;Volungė;Žiogeliai;2456643081;Taip;0;0;10;10
22984;Volungė;Žiogeliai;8299305464;Taip;8;0;7;15
22985;Volungė;Žiogeliai;1781838937;Taip;0;7;0;7
22986;Volungė;Žiogeliai;7859381467;Taip;0;22;0;22
22987;Volungė;Žiogeliai;3091641738;Ne;0;0;2;2
22988;Volungė;Žiogeliai;8578521969;Taip;7;0;0;7
22989;Volungė;Žiogeliai;5710662590;Taip;0;0;1;1
22990;Volungė;Žiogeliai;4839484528;Taip;3;0;0;3
22991;Volungė;Žiogeliai;5174427959;Taip;8;0;0;8
22992;Volungė;Žiogeliai;4726043862;Taip;0;0;3;3
22993;Volungė;Pelėdžiukai;1099216923;Taip;0;1;7;8
22994;Volungė;Pelėdžiukai;3430719834;Taip;0;1;2;3
22995;Volungė;Pelėdžiukai;2566901599;Taip;0;0;2;2
22996;Volungė;Pelėdžiukai;2420242319;Taip;0;1;6;7
22997;Volungė;Pelėdžiukai;7973680488;Taip;0;1;0;1
22998;Volungė;Pelėdžiukai;3356901662;Taip;8;1;8;17
22999;Volungė;Pelėdžiukai;1225378067;Ne;4;1;3;8
23000;Volungė;Pelėdžiukai;7281448136;Taip;0;19;0;19
23001;Volungė;Pelėdžiukai;3215314804;Taip;0;0;3;3
23002;Volungė;Pelėdžiukai;9629567682;Taip;7;13;2;22
23003;Volungė;Pelėdžiukai;1120682487;Taip;3;1;2;6
23004;Volungė;Pelėdžiukai;9082860913;Taip;0;1;3;4
23005;Volungė;Pelėdžiukai;8174587725;Taip;7;1;5;13
23006;Volungė;Pelėdžiukai;17534618616;Taip;5;0;0;5
23007;Volungė;Pelėdžiukai;7521910384;Taip;12;0;1;13
23008;Volungė;Pelėdžiukai;6565522808;Taip;0;1;0;1
23009;Volungė;Pelėdžiukai;9068889427;Taip;0;1;2;3
23010;Volungė;Pelėdžiukai;4123080241;Taip;0;1;9;10
23011;Volungė;Pelėdžiukai;8268202101;Taip;0;1;9;10
23012;Volungė;Pelėdžiukai;1366066359;Taip;6;3;0;9
23013;Volungė;Drugeliai;6280208510;Taip;0;5;0;5
23014;Volungė;Drugeliai;4032261812;Taip;0;1;2;3
23015;Volungė;Drugeliai;6488473384;Taip;3;0;0;3
23016;Volungė;Drugeliai;8045459660;Taip;10;0;1;11
23017;Volungė;Drugeliai;1402200673;Taip;10;0;1;11
23018;Volungė;Drugeliai;7574856429;Taip;9;0;0;9
23019;Volungė;Drugeliai;5284011092;Taip;7;0;4;11
23020;Volungė;Drugeliai;4427076715;Taip;0;0;9;9
23021;Volungė;Drugeliai;9729285419;Ne;0;1;15;16
23022;Volungė;Drugeliai;2686827560;Taip;8;0;0;8
23023;Volungė;Drugeliai;9973604148;Taip;9;0;1;10
23024;Volungė;Drugeliai;8905401944;Taip;4;0;8;12
23025;Volungė;Drugeliai;1164632050;Taip;5;0;0;5
23026;Volungė;Drugeliai;2923810441;Ne;5;1;1;7
23027;Volungė;Drugeliai;6782622442;Taip;10;0;0;10
23028;Volungė;Drugeliai;3020629341;Taip;7;0;0;7
23029;Volungė;Drugeliai;4252713086;Taip;6;0;1;7
23030;Volungė;Drugeliai;5354511593;Taip;3;0;0;3
23031;Volungė;Drugeliai;3150532451;Taip;0;11;0;11
23032;Volungė;Drugeliai;4745609424;Ne;0;0;3;3
23033;Volungė;Drugeliai;7584598377;Taip;9;0;0;9
23034;Volungė;"SKRUZDĖLIUKAI ";3394646139;Taip;8;6;0;14
23035;Volungė;"SKRUZDĖLIUKAI ";6464890465;Taip;9;0;2;11
23036;Volungė;"SKRUZDĖLIUKAI ";2493541457;Taip;4;0;18;22
23037;Volungė;"SKRUZDĖLIUKAI ";1101228927;Taip;6;0;0;6
23038;Volungė;"SKRUZDĖLIUKAI ";5332306628;Taip;5;1;3;9
23039;Volungė;"SKRUZDĖLIUKAI ";9319825151;Ne;0;2;6;8
23040;Volungė;"SKRUZDĖLIUKAI ";6370584522;Taip;4;6;0;10
23041;Volungė;"SKRUZDĖLIUKAI ";8168630107;Taip;0;0;8;8
23042;Volungė;"SKRUZDĖLIUKAI ";8992514683;Taip;1;19;0;20
23043;Volungė;"SKRUZDĖLIUKAI ";5994884455;Ne;4;0;1;5
23044;Volungė;"SKRUZDĖLIUKAI ";3818924175;Taip;3;0;1;4
23045;Volungė;"SKRUZDĖLIUKAI ";8244731771;Taip;5;0;0;5
23046;Volungė;"SKRUZDĖLIUKAI ";6110117105;Taip;4;0;5;9
23047;Volungė;"SKRUZDĖLIUKAI ";4944556574;Taip;0;3;0;3
23048;Volungė;"SKRUZDĖLIUKAI ";2212423676;Taip;10;0;5;15
23049;Volungė;"SKRUZDĖLIUKAI ";5942497397;Taip;22;0;0;22
23050;Volungė;"SKRUZDĖLIUKAI ";8613580206;Taip;2;1;0;3
23051;Volungė;Zylutės;6127398531;Taip;6;1;1;8
23052;Volungė;Zylutės;4664635246;Ne;13;0;1;14
23053;Volungė;Zylutės;9382043452;Taip;6;0;0;6
23054;Volungė;Zylutės;1125730734;Taip;3;11;1;15
23055;Volungė;Zylutės;5650558154;Taip;9;0;3;12
23056;Volungė;Zylutės;5588544003;Taip;2;0;1;3
23057;Volungė;Zylutės;3758750922;Taip;1;1;18;20
23058;Volungė;Zylutės;3460701723;Taip;0;0;1;1
23059;Volungė;Zylutės;9562426487;Taip;8;0;0;8
23060;Volungė;Zylutės;4136178027;Taip;8;1;0;9
23061;Volungė;Zylutės;5882826586;Taip;0;10;10;20
23062;Volungė;Zylutės;6969633765;Taip;10;0;6;16
23063;Volungė;Zylutės;6445614647;Taip;3;0;1;4
23064;Volungė;Zylutės;5561683986;Taip;4;0;2;6
23065;Volungė;Zylutės;5338942678;Taip;12;0;3;15
23066;Volungė;Zylutės;8987748481;Taip;0;5;0;5
23067;Volungė;"2 klasė";7246064765;Ne;5;0;0;5
23068;Volungė;"2 klasė";96547780998;Taip;5;0;0;5
23069;Volungė;"2 klasė";1345284426;Taip;5;0;0;5
23070;Volungė;"2 klasė";1605974968;Taip;3;0;0;3
23071;Volungė;"4 klasė";79347230135;Taip;4;0;0;4
23072;Volungė;"4 klasė";5691714123;Taip;1;0;0;1
23073;Volungė;"4 klasė";85951369760;Taip;4;0;0;4
23074;Giliukas;SMALSUČIAI;9134734376;Taip;0;0;4;4
23075;Giliukas;SMALSUČIAI;3728323646;Taip;10;0;0;10
23076;Giliukas;SMALSUČIAI;6742406486;Taip;8;6;2;16
23077;Giliukas;SMALSUČIAI;9556962586;Ne;7;0;0;7
23078;Giliukas;SMALSUČIAI;2840410579;Taip;4;0;3;7
23079;Giliukas;SMALSUČIAI;2378721717;Taip;10;0;1;11
23080;Giliukas;SMALSUČIAI;7316126011;Taip;5;0;1;6
23081;Giliukas;SMALSUČIAI;6489845832;Taip;10;0;2;12
23082;Giliukas;SMALSUČIAI;6203352124;Taip;10;0;0;10
23083;Giliukas;SMALSUČIAI;9704885611;Taip;1;3;0;4
23084;Giliukas;SMALSUČIAI;7993049824;Ne;11;1;0;12
23085;Giliukas;SMALSUČIAI;2700296404;Taip;4;0;3;7
23086;Giliukas;SMALSUČIAI;7412960823;Taip;4;0;2;6
23087;Giliukas;SMALSUČIAI;9160815037;Taip;0;2;0;2
23088;Giliukas;SMALSUČIAI;8701216181;Taip;8;2;1;11
23089;Giliukas;GUDRUČIAI;2335031800;Taip;0;0;1;1
23090;Giliukas;GUDRUČIAI;3847358328;Taip;20;4;0;24
23091;Giliukas;GUDRUČIAI;6165618131;Ne;7;5;0;12
23092;Giliukas;GUDRUČIAI;9608331265;Taip;8;3;0;11
23093;Giliukas;GUDRUČIAI;1870173947;Taip;18;0;0;18
23094;Giliukas;GUDRUČIAI;9644050818;Taip;19;3;0;22
23095;Giliukas;GUDRUČIAI;3252419072;Ne;1;0;0;1
23096;Giliukas;GUDRUČIAI;3983555939;Taip;7;1;0;8
23097;Giliukas;GUDRUČIAI;2951628295;Ne;0;4;0;4
23098;Giliukas;GUDRUČIAI;9408948207;Ne;4;5;0;9
23099;Giliukas;GUDRUČIAI;2003990493;Taip;0;3;0;3
23100;Giliukas;GUDRUČIAI;4960232685;Taip;4;1;0;5
23101;Giliukas;GUDRUČIAI;4916844983;Taip;3;3;0;6
23102;Giliukas;GUDRUČIAI;5787041097;Taip;9;4;0;13
23103;Giliukas;GUDRUČIAI;9458151965;Taip;0;2;5;7
23104;Giliukas;GUDRUČIAI;7159681896;Taip;14;1;2;17
23105;Giliukas;PABIRUČIAI;4183026763;Taip;9;1;0;10
23106;Giliukas;PABIRUČIAI;2362785562;Ne;16;2;1;19
23107;Giliukas;PABIRUČIAI;4247090684;Taip;6;6;0;12
23108;Giliukas;PABIRUČIAI;3054591644;Taip;5;0;0;5
23109;Giliukas;PABIRUČIAI;3870143024;Taip;5;0;22;27
23110;Giliukas;PABIRUČIAI;6914013230;Taip;15;0;1;16
23111;Giliukas;PABIRUČIAI;2512831288;Taip;9;0;4;13
23112;Giliukas;PABIRUČIAI;7013767174;Ne;2;1;0;3
23113;Giliukas;PABIRUČIAI;4810236703;Ne;5;1;0;6
23114;Giliukas;PABIRUČIAI;4105974682;Taip;7;0;1;8
23115;Giliukas;PABIRUČIAI;8874804636;Taip;7;1;0;8
23116;Giliukas;PABIRUČIAI;9360994563;Taip;7;0;1;8
23117;Giliukas;ŠVELNUKAI;7402797271;Taip;22;0;0;22
23118;Giliukas;ŠVELNUKAI;3839624551;Taip;10;0;0;10
23119;Giliukas;ŠVELNUKAI;2012365132;Taip;0;0;6;6
23120;Giliukas;ŠVELNUKAI;9270743786;Taip;0;0;6;6
23121;Giliukas;ŠVELNUKAI;1710286878;Taip;20;0;5;25
23122;Giliukas;ŠVELNUKAI;4565216956;Taip;15;0;0;15
23123;Giliukas;ŠVELNUKAI;5834233526;Taip;0;0;10;10
23124;Giliukas;ŠVELNUKAI;5000654626;Taip;7;0;0;7
23125;Giliukas;ŠVELNUKAI;8973584424;Taip;10;0;1;11
23126;Giliukas;ŠVELNUKAI;9679421414;Taip;4;0;2;6
23127;Giliukas;ŠVELNUKAI;2881704755;Taip;14;0;0;14
23128;Giliukas;ŠVELNUKAI;3238820351;Taip;8;0;1;9
23129;Giliukas;ŠVELNUKAI;4340602792;Taip;3;0;11;14
23130;Giliukas;ŠVELNUKAI;2229737837;Taip;22;0;0;22
23131;Giliukas;ŽINIUKAI;6422178450;Taip;0;2;0;2
23132;Giliukas;ŽINIUKAI;2502801547;Taip;21;3;0;24
23133;Giliukas;ŽINIUKAI;9617542456;Taip;3;9;0;12
23134;Giliukas;ŽINIUKAI;2562809633;Taip;19;0;0;19
23135;Giliukas;ŽINIUKAI;5326178821;Ne;8;6;0;14
23136;Giliukas;ŽINIUKAI;2692141913;Taip;22;0;0;22
23137;Giliukas;ŽINIUKAI;9152432124;Taip;15;0;1;16
23138;Giliukas;ŽINIUKAI;4854370266;Taip;7;3;0;10
23139;Giliukas;ŽINIUKAI;6703080106;Taip;0;4;0;4
23140;Giliukas;ŽINIUKAI;6942029629;Taip;3;3;0;6
23141;Giliukas;ŽINIUKAI;9274289812;Taip;12;0;0;12
23142;Giliukas;ŽINIUKAI;6956862865;Taip;5;0;0;5
23143;Giliukas;ŽINIUKAI;3150981084;Ne;19;3;0;22
23144;Giliukas;ŽINIUKAI;6134554678;Taip;7;5;0;12
23145;Giliukas;ŽINIUKAI;6338583515;Taip;0;2;1;3
23146;Giliukas;ŽINIUKAI;2064182165;Taip;10;0;4;14
23147;Giliukas;ŽINIUKAI;5201020765;Taip;14;2;0;16
23148;Giliukas;ŽINIUKAI;2042324002;Taip;4;2;0;6
23149;Giliukas;ŽINIUKAI;3137768675;Taip;15;2;0;17
23150;Giliukas;ŽINIUKAI;3718774263;Taip;14;8;0;22
23151;Giliukas;MYLIMUKAI;7205807049;Taip;9;2;2;13
23152;Giliukas;MYLIMUKAI;1165810193;Taip;5;2;6;13
23153;Giliukas;MYLIMUKAI;3055598917;Taip;0;5;0;5
23154;Giliukas;MYLIMUKAI;6953123617;Taip;3;1;0;4
23155;Giliukas;MYLIMUKAI;4207939009;Taip;0;0;3;3
23156;Giliukas;MYLIMUKAI;2742106493;Taip;7;3;0;10
23157;Giliukas;MYLIMUKAI;1916905497;Taip;6;5;0;11
23158;Giliukas;MYLIMUKAI;7053406257;Taip;5;4;1;10
23159;Giliukas;MYLIMUKAI;5222092567;Taip;7;0;0;7
23160;Giliukas;MYLIMUKAI;4581414740;Ne;8;2;0;10
23161;Giliukas;MYLIMUKAI;2226855971;Taip;0;7;7;14
23162;Giliukas;MYLIMUKAI;7431116067;Taip;10;0;2;12
23163;Giliukas;MYLIMUKAI;6748766233;Taip;10;0;0;10
23164;Giliukas;MYLIMUKAI;5298822890;Taip;11;2;0;13
23165;Giliukas;MYLIMUKAI;3726149759;Taip;4;3;0;7
23166;Giliukas;MYLIMUKAI;5300517567;Taip;0;10;0;10
23167;Giliukas;MYLIMUKAI;5625404051;Taip;17;0;0;17
23168;Giliukas;MYLIMUKAI;9224387185;Taip;0;22;0;22
23169;Giliukas;ČIAUŠKUČIAI;1762536884;Taip;12;1;0;13
23170;Giliukas;ČIAUŠKUČIAI;7646966187;Taip;10;0;0;10
23171;Giliukas;ČIAUŠKUČIAI;2801731379;Taip;13;3;1;17
23172;Giliukas;ČIAUŠKUČIAI;8499893356;Ne;10;5;0;15
23173;Giliukas;ČIAUŠKUČIAI;9205911152;Taip;7;0;0;7
23174;Giliukas;ČIAUŠKUČIAI;3720032249;Taip;14;0;1;15
23175;Giliukas;ČIAUŠKUČIAI;3659105022;Taip;0;7;0;7
23176;Giliukas;ČIAUŠKUČIAI;4940718205;Ne;11;0;0;11
23177;Giliukas;ČIAUŠKUČIAI;8491008130;Ne;17;2;1;20
23178;Giliukas;ČIAUŠKUČIAI;4163383707;Taip;8;1;0;9
23179;Giliukas;ČIAUŠKUČIAI;2612551188;Taip;12;0;0;12
23180;Giliukas;ČIAUŠKUČIAI;9366734581;Ne;7;0;0;7
23181;Giliukas;ČIAUŠKUČIAI;9462634699;Taip;2;0;0;2
23182;Giliukas;ČIAUŠKUČIAI;8106782330;Taip;0;0;15;15
23183;Giliukas;ČIAUŠKUČIAI;1332725572;Taip;0;4;0;4
23184;Giliukas;ČIAUŠKUČIAI;4347883309;Taip;0;1;0;1
23185;Giliukas;ČIAUŠKUČIAI;2787116787;Taip;0;2;0;2
23186;Giliukas;ČIAUŠKUČIAI;7012272912;Taip;0;0;5;5
23187;Giliukas;ŠNEKUČIAI;9229086918;Taip;14;0;0;14
23188;Giliukas;ŠNEKUČIAI;3274313536;Ne;0;1;1;2
23189;Giliukas;ŠNEKUČIAI;9287193955;Taip;8;4;0;12
23190;Giliukas;ŠNEKUČIAI;5527212334;Taip;5;0;0;5
23191;Giliukas;ŠNEKUČIAI;9499591494;Taip;11;0;0;11
23192;Giliukas;ŠNEKUČIAI;2099575372;Taip;5;0;0;5
23193;Giliukas;ŠNEKUČIAI;7195772641;Taip;4;0;2;6
23194;Giliukas;ŠNEKUČIAI;4258921446;Taip;7;0;1;8
23195;Giliukas;ŠNEKUČIAI;1439350058;Taip;11;0;3;14
23196;Giliukas;ŠNEKUČIAI;4843920452;Taip;11;0;0;11
23197;Giliukas;ŠNEKUČIAI;2004782696;Ne;0;11;2;13
23198;Giliukas;ŠNEKUČIAI;8977247073;Taip;4;0;0;4
23199;Giliukas;ŠNEKUČIAI;2349166172;Taip;10;0;1;11
23200;Giliukas;ŠNEKUČIAI;8241215831;Taip;10;0;0;10
23201;Giliukas;ŠNEKUČIAI;9475918013;Taip;4;0;0;4
23202;Giliukas;ŠNEKUČIAI;7944198886;Taip;20;0;1;21
23203;"Lazdynų mokykla (Žėručio g. 4)";RUPG;6038907328;Taip;13;1;0;14
23204;"Lazdynų mokykla (Žėručio g. 4)";RUPG;4086774324;Taip;0;22;0;22
23205;"Lazdynų mokykla (Žėručio g. 4)";RUPG;6070629454;Taip;0;22;0;22
23206;"Lazdynų mokykla (Žėručio g. 4)";RUPG;1118653070;Ne;2;6;0;8
23207;"Lazdynų mokykla (Žėručio g. 4)";RUPG;3367804873;Ne;9;1;1;11
23208;"Lazdynų mokykla (Žėručio g. 4)";RUPG;5806696915;Taip;9;1;2;12
23209;"Lazdynų mokykla (Žėručio g. 4)";RUPG;2209697834;Taip;0;22;0;22
23210;"Lazdynų mokykla (Žėručio g. 4)";RUPG;6638804854;Ne;0;22;0;22
23211;"Lazdynų mokykla (Žėručio g. 4)";RUPG;3634678954;Taip;10;3;0;13
23212;"Lazdynų mokykla (Žėručio g. 4)";RUPG;8318567916;Ne;8;3;0;11
23213;"Lazdynų mokykla (Žėručio g. 4)";RUPG;5982019255;Taip;0;1;0;1
23214;"Lazdynų mokykla (Žėručio g. 4)";RUPG;2160440145;Taip;9;1;2;12
23215;"Lazdynų mokykla (Žėručio g. 4)";RUPG;1025406111;Taip;6;4;0;10
23216;"Lazdynų mokykla (Žėručio g. 4)";RUPG;5095782784;Taip;6;1;3;10
23217;"Lazdynų mokykla (Žėručio g. 4)";LEPG;9656050113;Taip;0;1;0;1
23218;"Lazdynų mokykla (Žėručio g. 4)";LEPG;6822686126;Taip;12;1;0;13
23219;"Lazdynų mokykla (Žėručio g. 4)";LEPG;2070196225;Ne;10;1;0;11
23220;"Lazdynų mokykla (Žėručio g. 4)";LEPG;2613078582;Taip;6;4;0;10
23221;"Lazdynų mokykla (Žėručio g. 4)";LEPG;7059075747;Taip;0;1;0;1
23222;"Lazdynų mokykla (Žėručio g. 4)";LEPG;5438716880;Ne;0;1;0;1
23223;"Lazdynų mokykla (Žėručio g. 4)";LEPG;7487278074;Taip;0;1;5;6
23224;"Lazdynų mokykla (Žėručio g. 4)";LEPG;7320049068;Taip;0;1;2;3
23225;"Lazdynų mokykla (Žėručio g. 4)";LEPG;1396367371;Taip;21;1;0;22
23226;"Lazdynų mokykla (Žėručio g. 4)";LEPG;7324846434;Taip;7;1;2;10
23227;"Lazdynų mokykla (Žėručio g. 4)";LEPG;1532248269;Taip;5;1;0;6
23228;"Lazdynų mokykla (Žėručio g. 4)";LEPG;3675401775;Taip;5;1;0;6
23229;"Lazdynų mokykla (Žėručio g. 4)";LEPG;6794153377;Taip;0;1;7;8
23230;"Lazdynų mokykla (Žėručio g. 4)";LEPG;2825614921;Ne;12;1;0;13
23231;"Lazdynų mokykla (Žėručio g. 4)";LEPG;9592456683;Taip;5;1;0;6
23232;"Lazdynų mokykla (Žėručio g. 4)";LEPG;6117542654;Taip;7;1;0;8
23233;"Lazdynų mokykla (Žėručio g. 4)";LEPG;4149212470;Taip;0;1;4;5
23234;"Lazdynų mokykla (Žėručio g. 4)";LEPG;8324750958;Ne;14;1;2;17
23235;"Lazdynų mokykla (Žėručio g. 4)";LEPG;7659209862;Taip;18;1;0;19
23236;"Lazdynų mokykla (Žėručio g. 4)";LEPG;9654428418;Taip;0;1;0;1
23237;"Lazdynų mokykla (Žėručio g. 4)";RUPG;3631150576;Taip;9;1;1;11
23238;"Lazdynų mokykla (Žėručio g. 4)";RUPG;5015519090;Taip;0;1;5;6
23239;"Lazdynų mokykla (Žėručio g. 4)";RUPG;1745679183;Taip;0;1;1;2
23240;"Lazdynų mokykla (Žėručio g. 4)";RUPG;9255723192;Ne;5;1;1;7
23241;"Lazdynų mokykla (Žėručio g. 4)";RUPG;9639587601;Taip;0;1;0;1
23242;"Lazdynų mokykla (Žėručio g. 4)";RUPG;4087148273;Taip;11;1;2;14
23243;"Lazdynų mokykla (Žėručio g. 4)";RUPG;2740942924;Taip;0;1;3;4
23244;"Lazdynų mokykla (Žėručio g. 4)";RUPG;2700475528;Taip;8;1;0;9
23245;"Lazdynų mokykla (Žėručio g. 4)";RUPG;7180617984;Ne;12;1;1;14
23246;"Lazdynų mokykla (Žėručio g. 4)";RUPG;4023257875;Taip;0;1;3;4
23247;"Lazdynų mokykla (Žėručio g. 4)";RUPG;2308739823;Taip;11;1;0;12
23248;"Lazdynų mokykla (Žėručio g. 4)";RUPG;9123178095;Taip;0;9;0;9
23249;"Lazdynų mokykla (Žėručio g. 4)";RUPG;3000676765;Taip;14;1;0;15
23250;"Lazdynų mokykla (Žėručio g. 4)";RUPG;9968637187;Taip;10;1;5;16
23251;"Lazdynų mokykla (Žėručio g. 4)";RUPG;8886654664;Taip;4;1;3;8
23252;Santariškių;Serbentukai;2334347228;Taip;15;0;0;15
23253;Santariškių;Serbentukai;8588954285;Taip;11;0;0;11
23254;Santariškių;Kankorėžiukai;2246467353;Ne;5;0;0;5
23255;Santariškių;Kriaušiukai;7264402009;Ne;6;0;0;6
23256;Santariškių;Giliukai;9738449732;Taip;7;0;0;7
23257;Santariškių;Giliukai;8969667023;Taip;17;0;0;17
23258;Santariškių;Giliukai;4942285041;Taip;5;0;0;5
23259;Santariškių;Šermukšniukai;7825266216;Ne;5;0;0;5
23260;Santariškių;Riešutukai;1694479021;Taip;11;0;0;11
23261;Santariškių;Avietėlės;2938170758;Ne;8;0;0;8
23262;Santariškių;Avietėlės;2558541975;Taip;3;0;0;3
23263;Santariškių;Vyšniukai;9819079431;Taip;5;0;0;5
23264;Santariškių;Vyšniukai;8749265990;Taip;5;0;0;5
23265;Santariškių;Agrastukai;5952329323;Taip;5;0;0;5
23266;Santariškių;Agrastukai;4209718263;Taip;6;0;0;6
23267;"Vilnios pagrindinė mokykla";BITUTĖS;4516507512;Ne;6;0;0;6
23268;"Vilnios pagrindinė mokykla";EŽIUKAI;5939264188;Taip;10;0;0;10
23269;"„Atžalyno” mokykla-darželis";Giliukai;1209960122;Taip;6;0;2;8
23270;"„Atžalyno” mokykla-darželis";Giliukai;1579954367;Taip;6;1;1;8
23271;"„Atžalyno” mokykla-darželis";Giliukai;9655000018;Taip;16;1;1;18
23272;"„Atžalyno” mokykla-darželis";Giliukai;8826921260;Ne;24;1;0;25
23273;"„Atžalyno” mokykla-darželis";Giliukai;2773253032;Taip;7;1;1;9
23274;"„Atžalyno” mokykla-darželis";Giliukai;3170216428;Taip;8;1;1;10
23275;"„Atžalyno” mokykla-darželis";Giliukai;4345420422;Taip;4;0;1;5
23276;"„Atžalyno” mokykla-darželis";Giliukai;2772290605;Taip;10;1;0;11
23277;"„Atžalyno” mokykla-darželis";Giliukai;4422345256;Taip;0;0;2;2
23278;"„Atžalyno” mokykla-darželis";Giliukai;5596753512;Taip;9;0;0;9
23279;"„Atžalyno” mokykla-darželis";Giliukai;1958519966;Ne;15;0;0;15
23280;"„Atžalyno” mokykla-darželis";Giliukai;9806203065;Ne;14;1;0;15
23281;"„Atžalyno” mokykla-darželis";Giliukai;8688627865;Taip;13;1;1;15
23282;"„Atžalyno” mokykla-darželis";Giliukai;2601122166;Taip;27;1;0;28
23283;"„Atžalyno” mokykla-darželis";Giliukai;3529875728;Taip;7;1;0;8
23284;"„Atžalyno” mokykla-darželis";Giliukai;1311162040;Taip;9;1;0;10
23285;"„Atžalyno” mokykla-darželis";Giliukai;4427232735;Taip;10;1;7;18
23286;"„Atžalyno” mokykla-darželis";Giliukai;9013323901;Ne;16;1;1;18
23287;"„Atžalyno” mokykla-darželis";Giliukai;5503766544;Taip;0;6;0;6
23288;"„Atžalyno” mokykla-darželis";Giliukai;8254801574;Taip;2;1;0;3
23289;"„Atžalyno” mokykla-darželis";Giliukai;9215658103;Taip;7;0;0;7
23290;"„Atžalyno” mokykla-darželis";Giliukai;5030879885;Taip;18;1;2;21
23291;"„Atžalyno” mokykla-darželis";Giliukai;3484401937;Taip;11;1;2;14
23292;"„Atžalyno” mokykla-darželis";Riešutėliai;4360099345;Taip;14;2;2;18
23293;"„Atžalyno” mokykla-darželis";Riešutėliai;5947938371;Ne;0;0;17;17
23294;"„Atžalyno” mokykla-darželis";Riešutėliai;5384245347;Taip;0;12;0;12
23295;"„Atžalyno” mokykla-darželis";Riešutėliai;4246430352;Taip;8;0;13;21
23296;"„Atžalyno” mokykla-darželis";Riešutėliai;8574494664;Ne;10;4;0;14
23297;"„Atžalyno” mokykla-darželis";Riešutėliai;5815412814;Taip;0;4;0;4
23298;"„Atžalyno” mokykla-darželis";Riešutėliai;4161658496;Ne;0;1;6;7
23299;"„Atžalyno” mokykla-darželis";Riešutėliai;8942132574;Ne;4;3;0;7
23300;"„Atžalyno” mokykla-darželis";Riešutėliai;7109850241;Taip;15;7;0;22
23301;"„Atžalyno” mokykla-darželis";Riešutėliai;7368616441;Ne;0;0;11;11
23302;"„Atžalyno” mokykla-darželis";Riešutėliai;5242752663;Taip;7;0;3;10
23303;"„Atžalyno” mokykla-darželis";Riešutėliai;5709028342;Taip;2;4;0;6
23304;"„Atžalyno” mokykla-darželis";Riešutėliai;8803555426;Ne;0;1;2;3
23305;"„Atžalyno” mokykla-darželis";Riešutėliai;5994983369;Ne;10;1;0;11
23306;"„Atžalyno” mokykla-darželis";Riešutėliai;1041363325;Taip;0;0;15;15
23307;"„Atžalyno” mokykla-darželis";Riešutėliai;7676614240;Taip;0;0;6;6
23308;"„Atžalyno” mokykla-darželis";Riešutėliai;3751729666;Taip;0;0;7;7
23309;"„Atžalyno” mokykla-darželis";Riešutėliai;3441950153;Taip;10;0;7;17
23310;"„Atžalyno” mokykla-darželis";Riešutėliai;4223591454;Ne;11;1;4;16
23311;"„Atžalyno” mokykla-darželis";Žirniukai;6903825217;Taip;5;13;1;19
23312;"„Atžalyno” mokykla-darželis";Žirniukai;9101301819;Ne;0;0;9;9
23313;"„Atžalyno” mokykla-darželis";Žirniukai;6602037942;Taip;10;0;0;10
23314;"„Atžalyno” mokykla-darželis";Žirniukai;7579781779;Taip;12;1;0;13
23315;"„Atžalyno” mokykla-darželis";Žirniukai;1915676392;Ne;0;0;5;5
23316;"„Atžalyno” mokykla-darželis";Žirniukai;7669725276;Taip;0;19;2;21
23317;"„Atžalyno” mokykla-darželis";Žirniukai;5986664970;Taip;6;10;1;17
23318;"„Atžalyno” mokykla-darželis";Žirniukai;9913048992;Taip;4;10;0;14
23319;"„Atžalyno” mokykla-darželis";Žirniukai;4616870552;Taip;0;1;6;7
23320;"„Atžalyno” mokykla-darželis";Žirniukai;4107946143;Taip;15;1;2;18
23321;"„Atžalyno” mokykla-darželis";Žirniukai;7883570492;Ne;14;5;0;19
23322;"„Atžalyno” mokykla-darželis";Žirniukai;8320161812;Taip;10;6;0;16
23323;"„Atžalyno” mokykla-darželis";Žirniukai;5335059675;Taip;10;6;0;16
23324;"„Atžalyno” mokykla-darželis";Žirniukai;6922776405;Taip;0;0;28;28
23325;"„Atžalyno” mokykla-darželis";Žirniukai;9690554753;Taip;0;0;18;18
23326;"„Atžalyno” mokykla-darželis";Žirniukai;1961428224;Ne;5;0;9;14
23327;"„Atžalyno” mokykla-darželis";Žirniukai;8070499557;Taip;6;8;1;15
23328;"„Atžalyno” mokykla-darželis";Žirniukai;2446697763;Taip;0;0;8;8
23329;"„Atžalyno” mokykla-darželis";Žirniukai;2462839180;Taip;10;1;3;14
23330;"„Atžalyno” mokykla-darželis";Žirniukai;4784990018;Taip;4;14;1;19
23331;"„Atžalyno” mokykla-darželis";VYŠNIUKAI;6120955217;Ne;22;1;0;23
23332;"„Atžalyno” mokykla-darželis";VYŠNIUKAI;1787256844;Ne;23;0;0;23
23333;"„Atžalyno” mokykla-darželis";VYŠNIUKAI;2547003287;Ne;23;0;0;23
23334;"„Atžalyno” mokykla-darželis";VYŠNIUKAI;4503448206;Taip;20;1;0;21
23335;"„Atžalyno” mokykla-darželis";VYŠNIUKAI;3664056583;Taip;2;12;0;14
23336;"„Atžalyno” mokykla-darželis";VYŠNIUKAI;5456248305;Taip;21;0;0;21
23337;"„Atžalyno” mokykla-darželis";VYŠNIUKAI;3719072139;Taip;25;1;0;26
23338;"„Atžalyno” mokykla-darželis";VYŠNIUKAI;9245994735;Taip;26;3;0;29
23339;"„Atžalyno” mokykla-darželis";VYŠNIUKAI;3770167696;Taip;5;0;20;25
23340;"„Atžalyno” mokykla-darželis";VYŠNIUKAI;2000352986;Taip;10;0;0;10
23341;"„Atžalyno” mokykla-darželis";VYŠNIUKAI;2177213062;Taip;15;0;1;16
23342;"„Atžalyno” mokykla-darželis";VYŠNIUKAI;4635394632;Ne;6;0;4;10
23343;"„Atžalyno” mokykla-darželis";VYŠNIUKAI;3524131672;Taip;22;0;0;22
23344;"„Atžalyno” mokykla-darželis";VYŠNIUKAI;4840490901;Taip;25;1;1;27
23345;"„Atžalyno” mokykla-darželis";VYŠNIUKAI;4796052680;Taip;21;0;0;21
23346;"„Atžalyno” mokykla-darželis";VYŠNIUKAI;3181675972;Taip;14;0;1;15
23347;"„Atžalyno” mokykla-darželis";VYŠNIUKAI;8163063211;Taip;23;0;0;23
23348;"„Atžalyno” mokykla-darželis";VYŠNIUKAI;4431437971;Taip;11;1;2;14
23349;"„Atžalyno” mokykla-darželis";PIPIRIUKAI;8357021249;Ne;14;7;0;21
23350;"„Atžalyno” mokykla-darželis";PIPIRIUKAI;4582284727;Taip;2;1;10;13
23351;"„Atžalyno” mokykla-darželis";PIPIRIUKAI;4785607785;Ne;9;0;2;11
23352;"„Atžalyno” mokykla-darželis";PIPIRIUKAI;5615246040;Taip;10;1;7;18
23353;"„Atžalyno” mokykla-darželis";PIPIRIUKAI;1988657552;Taip;28;0;0;28
23354;"„Atžalyno” mokykla-darželis";PIPIRIUKAI;6721771665;Ne;28;1;1;30
23355;"„Atžalyno” mokykla-darželis";PIPIRIUKAI;7946139474;Taip;0;8;2;10
23356;"„Atžalyno” mokykla-darželis";PIPIRIUKAI;2921181385;Ne;0;0;12;12
23357;"„Atžalyno” mokykla-darželis";PIPIRIUKAI;2108706876;Taip;0;0;21;21
23358;"„Atžalyno” mokykla-darželis";PIPIRIUKAI;1228919159;Taip;13;9;0;22
23359;"„Atžalyno” mokykla-darželis";PIPIRIUKAI;3919301151;Taip;0;0;11;11
23360;"„Atžalyno” mokykla-darželis";PIPIRIUKAI;3624299098;Taip;4;4;0;8
23361;"„Atžalyno” mokykla-darželis";PIPIRIUKAI;2537063401;Taip;0;1;8;9
23362;"„Atžalyno” mokykla-darželis";PIPIRIUKAI;4166521512;Taip;5;5;2;12
23363;"„Atžalyno” mokykla-darželis";PIPIRIUKAI;8372179128;Taip;2;0;3;5
23364;"„Atžalyno” mokykla-darželis";PIPIRIUKAI;3204191459;Taip;18;7;0;25
23365;"„Atžalyno” mokykla-darželis";PIPIRIUKAI;5321475187;Taip;12;0;2;14
23366;"„Atžalyno” mokykla-darželis";PIPIRIUKAI;3015863723;Taip;23;5;0;28
23367;"„Atžalyno” mokykla-darželis";PIPIRIUKAI;3323233525;Taip;23;5;0;28
23368;"„Atžalyno” mokykla-darželis";PIPIRIUKAI;4596770586;Taip;0;3;7;10
23369;"„Atžalyno” mokykla-darželis";PIPIRIUKAI;7652421432;Taip;12;0;0;12
23370;"Vilniaus Naujininkų mokykla";"SAULĖS ZUIKUČIAI";1096474672;Taip;10;6;0;16
23371;"Vilniaus Naujininkų mokykla";"SAULĖS ZUIKUČIAI";9856315057;Taip;8;6;0;14
23372;"Vilniaus Naujininkų mokykla";"SAULĖS ZUIKUČIAI";1901250406;Ne;8;9;0;17
23373;"Vilniaus Naujininkų mokykla";"SAULĖS ZUIKUČIAI";9427388681;Taip;14;6;0;20
23374;"Vilniaus Naujininkų mokykla";"SAULĖS ZUIKUČIAI";5512321795;Taip;0;10;0;10
23375;"Vilniaus Naujininkų mokykla";"SAULĖS ZUIKUČIAI";9411054207;Ne;0;15;0;15
23376;"Vilniaus Naujininkų mokykla";"SAULĖS ZUIKUČIAI";3810550099;Taip;0;18;0;18
23377;"Vilniaus Naujininkų mokykla";"SAULĖS ZUIKUČIAI";7692387379;Taip;6;6;1;13
23378;"Vilniaus Naujininkų mokykla";"SAULĖS ZUIKUČIAI";8935072613;Ne;20;6;0;26
23379;"Vilniaus Naujininkų mokykla";"SAULĖS ZUIKUČIAI";9544088525;Ne;15;0;0;15
23380;"Vilniaus Naujininkų mokykla";"SAULĖS ZUIKUČIAI";9488762308;Taip;13;6;7;26
23381;"Vilniaus Naujininkų mokykla";"SAULĖS ZUIKUČIAI";2437553321;Ne;0;6;22;28
23382;"Vilniaus Naujininkų mokykla";"SAULĖS ZUIKUČIAI";5148002236;Taip;15;7;0;22
23383;"Vilniaus Naujininkų mokykla";SMALSUČIAI;2428447892;Taip;3;7;0;10
23384;"Vilniaus Naujininkų mokykla";SMALSUČIAI;1224054771;Taip;0;7;1;8
23385;"Vilniaus Naujininkų mokykla";SMALSUČIAI;79174984189;Taip;10;6;0;16
23386;"Vilniaus Naujininkų mokykla";SMALSUČIAI;1662993666;Taip;0;7;3;10
23387;"Vilniaus Naujininkų mokykla";SMALSUČIAI;7144596269;Ne;0;11;5;16
23388;"Vilniaus Naujininkų mokykla";SMALSUČIAI;6362889550;Taip;0;7;14;21
23389;"Vilniaus Naujininkų mokykla";SMALSUČIAI;1980755137;Taip;0;14;0;14
23390;"Vilniaus Naujininkų mokykla";SMALSUČIAI;1920917916;Taip;9;9;0;18
23391;"Vilniaus Naujininkų mokykla";SMALSUČIAI;8828658544;Ne;9;1;1;11
23392;"Vilniaus Naujininkų mokykla";SMALSUČIAI;5633127620;Taip;5;7;2;14
23393;"Vilniaus Naujininkų mokykla";SMALSUČIAI;3867799187;Taip;7;7;1;15
23394;"Vilniaus Naujininkų mokykla";SMALSUČIAI;1350744949;Taip;23;1;1;25
23395;"Vilniaus Naujininkų mokykla";SMALSUČIAI;63557632023;Taip;7;9;0;16
23396;"Vilniaus Naujininkų mokykla";SMALSUČIAI;8280826634;Ne;0;7;1;8
23397;"Vilniaus Naujininkų mokykla";SMALSUČIAI;5302103644;Ne;14;12;0;26
23398;"Vilniaus Naujininkų mokykla";SMALSUČIAI;5638817349;Ne;0;7;1;8
23399;"Vilniaus Naujininkų mokykla";SMALSUČIAI;1880254518;Taip;8;7;0;15
23400;"Vilniaus Naujininkų mokykla";SMALSUČIAI;2113295854;Taip;0;3;0;3
23401;"Vilniaus Naujininkų mokykla";SMALSUČIAI;8352550813;Taip;0;0;2;2
23402;"Vilniaus Emilijos Pliaterytės progimnazija";BITUTĖS;6763073659;Ne;11;0;0;11
23403;"Vilniaus Emilijos Pliaterytės progimnazija";BITUTĖS;40696452801;Taip;7;0;0;7
23404;"Vilniaus Karaliaus Mindaugo pagrindinė mokykla";"PUG 2";8957131694;Taip;10;0;0;10
23405;"Vilniaus Karaliaus Mindaugo pagrindinė mokykla";"PUG 2";1146561649;Taip;6;0;1;7
23406;"Vilniaus Karaliaus Mindaugo pagrindinė mokykla";"PUG 2";1159232792;Taip;0;0;4;4
23407;"Vilniaus Karaliaus Mindaugo pagrindinė mokykla";"PUG 2";6754580614;Taip;0;0;1;1
23408;"Vilniaus Karaliaus Mindaugo pagrindinė mokykla";"PUG 2";2248658930;Taip;3;0;4;7
23409;"Vilniaus Karaliaus Mindaugo pagrindinė mokykla";"PUG 2";47454787439;Taip;0;0;1;1
23410;"Vilniaus Karaliaus Mindaugo pagrindinė mokykla";"PUG 2";2092637040;Taip;7;0;4;11
23411;"Vilniaus Karaliaus Mindaugo pagrindinė mokykla";"PUG 2";6196554287;Taip;9;1;0;10
23412;"Vilniaus Karaliaus Mindaugo pagrindinė mokykla";"PUG 2";4661051023;Taip;5;8;3;16
23413;"Vilniaus Karaliaus Mindaugo pagrindinė mokykla";"PUG 2";1507200600;Taip;0;1;5;6
23414;"Vilniaus Karaliaus Mindaugo pagrindinė mokykla";"PUG 2";7440474403;Taip;7;0;6;13
23415;"Vilniaus Karaliaus Mindaugo pagrindinė mokykla";"PUG 2";8860314164;Taip;11;0;2;13
23416;"Vilniaus Karaliaus Mindaugo pagrindinė mokykla";"PUG 2";4684525618;Taip;8;0;1;9
23417;"Vilniaus Karaliaus Mindaugo pagrindinė mokykla";"PUG 2";2876837284;Ne;0;0;1;1
23418;"Vilniaus Karaliaus Mindaugo pagrindinė mokykla";"PUG 1";8879549409;Taip;0;0;4;4
23419;"Vilniaus Karaliaus Mindaugo pagrindinė mokykla";"PUG 1";3860781857;Taip;6;0;2;8
23420;"Vilniaus Karaliaus Mindaugo pagrindinė mokykla";"PUG 1";1904462840;Taip;0;0;2;2
23421;"Vilniaus Karaliaus Mindaugo pagrindinė mokykla";"PUG 1";6299298199;Taip;0;0;1;1
23422;"Vilniaus Karaliaus Mindaugo pagrindinė mokykla";"PUG 1";35830862363;Taip;4;0;0;4
23423;"Vilniaus Karaliaus Mindaugo pagrindinė mokykla";"PUG 1";1830572633;Taip;0;0;2;2
23424;"Vilniaus Karaliaus Mindaugo pagrindinė mokykla";"PUG 1";4143153535;Taip;0;0;4;4
23425;"Vilniaus Karaliaus Mindaugo pagrindinė mokykla";"PUG 1";9329518124;Taip;4;0;0;4
23426;"Vilniaus Karaliaus Mindaugo pagrindinė mokykla";"PUG 1";1505918280;Taip;0;0;3;3
23427;"Vilniaus Karaliaus Mindaugo pagrindinė mokykla";"PUG 1";1445657342;Taip;0;1;1;2
23428;"Vilniaus Karaliaus Mindaugo pagrindinė mokykla";"PUG 1";9313380552;Taip;0;1;2;3
23429;"Vilniaus Karaliaus Mindaugo pagrindinė mokykla";"PUG 1";7782678159;Ne;0;6;2;8
23430;"Vilniaus Karaliaus Mindaugo pagrindinė mokykla";"PUG 1";14043704729;Taip;6;0;0;6
23431;"Vilniaus Karaliaus Mindaugo pagrindinė mokykla";"PUG 1";7876029445;Taip;9;0;0;9
23432;"Vilniaus Karaliaus Mindaugo pagrindinė mokykla";"PUG 1";1376514473;Taip;0;0;12;12
23433;"Vilniaus Karaliaus Mindaugo pagrindinė mokykla";"PUG 1";7543795007;Taip;0;6;0;6
23434;"Vilniaus Karaliaus Mindaugo pagrindinė mokykla";"PUG 1";9522269582;Taip;6;1;0;7
23435;"Vilniaus Karaliaus Mindaugo pagrindinė mokykla";"PUG 3";23638266708;Taip;0;10;1;11
23436;"Vilniaus Karaliaus Mindaugo pagrindinė mokykla";"PUG 3";1799477959;Taip;5;1;7;13
23437;"Vilniaus Karaliaus Mindaugo pagrindinė mokykla";"PUG 3";3490705425;Taip;0;0;3;3
23438;"Vilniaus Karaliaus Mindaugo pagrindinė mokykla";"PUG 3";7433354196;Ne;0;0;2;2
23439;"Vilniaus Karaliaus Mindaugo pagrindinė mokykla";"PUG 3";2836206893;Taip;10;0;0;10
23440;"Vilniaus Karaliaus Mindaugo pagrindinė mokykla";"PUG 3";38426234048;Taip;3;0;1;4
23441;"Vilniaus Karaliaus Mindaugo pagrindinė mokykla";"PUG 3";1502213914;Taip;0;3;0;3
23442;"Vilniaus Karaliaus Mindaugo pagrindinė mokykla";"PUG 3";1929838733;Ne;8;0;1;9
23443;"Vilniaus Karaliaus Mindaugo pagrindinė mokykla";"PUG 3";3344717003;Taip;0;0;2;2
23444;"Vilniaus Karaliaus Mindaugo pagrindinė mokykla";"PUG 3";9638976786;Taip;9;0;0;9
23445;"Vilniaus Karaliaus Mindaugo pagrindinė mokykla";"PUG 3";6406285034;Taip;0;0;7;7
23446;"Vilniaus Karaliaus Mindaugo pagrindinė mokykla";"PUG 3";7132574496;Taip;5;1;1;7
23447;"Vilniaus Karaliaus Mindaugo pagrindinė mokykla";"PUG 3";2776004276;Ne;0;0;4;4
23448;Ąžuolas;Nykštukų;2444496734;Taip;3;0;0;3
23449;Ąžuolas;Nykštukų;7514774129;Taip;1;0;0;1
23450;Ąžuolas;Nykštukų;1596434943;Taip;10;0;0;10
23451;Ąžuolas;Nykštukų;1346657303;Taip;11;0;0;11
23452;Ąžuolas;Boružiukų;3776024233;Taip;4;0;0;4
23453;Ąžuolas;Boružiukų;1551807768;Taip;0;7;0;7
23454;Ąžuolas;Boružiukų;7227391471;Taip;1;0;0;1
23455;Ąžuolas;Boružiukų;7318553736;Taip;5;0;0;5
23456;Ąžuolas;Spinduliukų;4980309462;Taip;7;0;0;7
23457;Ąžuolas;Spinduliukų;9562970518;Taip;5;0;0;5
23458;Ąžuolas;Zuikučių;1874874608;Taip;1;0;0;1
23459;Ąžuolas;Zuikučių;6802405421;Taip;19;0;0;19
23460;Ąžuolas;Lašiukų;2943917913;Taip;15;0;0;15
23461;Ąžuolas;Žemuogėlių;1543797429;Taip;5;0;0;5
23462;Ąžuolas;Žemuogėlių;6458441977;Ne;5;0;0;5
23463;Ąžuolas;Žemuogėlių;6041698323;Taip;8;0;0;8
23464;Ąžuolas;Žvaigždučių;5825221172;Taip;1;0;0;1
23465;Ąžuolas;Žvaigždučių;9900656991;Ne;5;0;0;5
23466;Ąžuolas;Žvaigždučių;4766617696;Taip;13;0;0;13
23467;Ąžuolas;Žvaigždučių;1908411527;Taip;13;0;0;13
23468;Ąžuolas;Žvaigždučių;8159667094;Taip;4;0;0;4
23469;Ąžuolas;Paukštelių;3811173394;Taip;5;0;0;5
23470;Ąžuolas;Bitučių;1087056237;Taip;20;0;0;20
23471;Ąžuolas;Bitučių;8703116268;Ne;1;0;0;1
23472;Ąžuolas;Voveriukų;8013693801;Taip;5;0;0;5
23473;Ąžuolas;Giliukų;3395238839;Taip;7;0;0;7
23474;"Vilniaus Levo Karsavino vidurinė mokykla";PELEDŽIUKAI;2149830021;Taip;14;3;0;17
23475;"Vilniaus Levo Karsavino vidurinė mokykla";PELEDŽIUKAI;2718046390;Taip;0;3;2;5
23476;"Vilniaus Levo Karsavino vidurinė mokykla";PELEDŽIUKAI;9094287056;Taip;0;3;3;6
23477;"Vilniaus Levo Karsavino vidurinė mokykla";PELEDŽIUKAI;8721423900;Taip;0;3;5;8
23478;"Vilniaus Levo Karsavino vidurinė mokykla";PELEDŽIUKAI;6917007871;Taip;12;3;0;15
23479;"Vilniaus Levo Karsavino vidurinė mokykla";PELEDŽIUKAI;3452236805;Taip;9;19;0;28
23480;"Vilniaus Levo Karsavino vidurinė mokykla";PELEDŽIUKAI;4066969586;Taip;5;3;2;10
23481;"Vilniaus Levo Karsavino vidurinė mokykla";PELEDŽIUKAI;8564433463;Ne;0;3;6;9
23482;"Vilniaus Levo Karsavino vidurinė mokykla";PELEDŽIUKAI;1067737206;Taip;0;11;0;11
23483;"Vilniaus Levo Karsavino vidurinė mokykla";PELEDŽIUKAI;1288690113;Taip;0;10;0;10
23484;"Vilniaus Levo Karsavino vidurinė mokykla";PELEDŽIUKAI;55396452032;Taip;6;3;0;9
23485;"Vilniaus Levo Karsavino vidurinė mokykla";PELEDŽIUKAI;2276463136;Taip;0;11;1;12
23486;"Vilniaus Levo Karsavino vidurinė mokykla";PELEDŽIUKAI;43259107285;Taip;0;7;0;7
23487;"Vilniaus Levo Karsavino vidurinė mokykla";PELEDŽIUKAI;9947263640;Taip;12;3;1;16
23488;"Vilniaus Levo Karsavino vidurinė mokykla";PELEDŽIUKAI;3641595127;Taip;5;3;5;13
23489;"Vilniaus Levo Karsavino vidurinė mokykla";PELEDŽIUKAI;3254847545;Taip;0;22;0;22
23490;"Vilniaus Levo Karsavino vidurinė mokykla";PELEDŽIUKAI;3381954095;Taip;2;3;1;6
23491;"Vilniaus Levo Karsavino vidurinė mokykla";PELEDŽIUKAI;7227603702;Taip;10;3;0;13
23492;"Vilniaus Levo Karsavino vidurinė mokykla";PELEDŽIUKAI;57138305703;Taip;0;3;6;9
23493;"Vilniaus Levo Karsavino vidurinė mokykla";PELEDŽIUKAI;5768653399;Taip;1;0;0;1
23494;"Vilniaus Levo Karsavino vidurinė mokykla";Žiniukai;3333990952;Taip;0;3;0;3
23495;"Vilniaus Levo Karsavino vidurinė mokykla";Žiniukai;5548875714;Taip;0;3;0;3
23496;"Vilniaus Levo Karsavino vidurinė mokykla";Žiniukai;5452659798;Taip;4;3;1;8
23497;"Vilniaus Levo Karsavino vidurinė mokykla";Žiniukai;5803032683;Taip;13;3;0;16
23498;"Vilniaus Levo Karsavino vidurinė mokykla";Žiniukai;2306517891;Taip;0;22;0;22
23499;"Vilniaus Levo Karsavino vidurinė mokykla";Žiniukai;1428614163;Taip;3;3;4;10
23500;"Vilniaus Levo Karsavino vidurinė mokykla";Žiniukai;9801214344;Ne;0;22;0;22
23501;"Vilniaus Levo Karsavino vidurinė mokykla";Žiniukai;8180889070;Ne;4;3;5;12
23502;"Vilniaus Levo Karsavino vidurinė mokykla";Žiniukai;7023565057;Taip;9;3;1;13
23503;"Vilniaus Levo Karsavino vidurinė mokykla";Žiniukai;2157398751;Taip;0;3;0;3
23504;"Vilniaus Levo Karsavino vidurinė mokykla";Žiniukai;7804533930;Taip;0;3;0;3
23505;"Vilniaus Levo Karsavino vidurinė mokykla";Žiniukai;3379725202;Taip;0;3;1;4
23506;"Vilniaus Levo Karsavino vidurinė mokykla";Žiniukai;7298260831;Taip;0;3;0;3
23507;"Vilniaus Levo Karsavino vidurinė mokykla";Žiniukai;4302751308;Taip;9;3;2;14
23508;"Vilniaus Levo Karsavino vidurinė mokykla";Žiniukai;7920182730;Taip;6;3;0;9
23509;"Vilniaus Levo Karsavino vidurinė mokykla";Žiniukai;12377363480;Taip;0;3;0;3
23510;"Vilniaus Levo Karsavino vidurinė mokykla";Žiniukai;8199573104;Taip;13;3;2;18
23511;"Vilniaus Levo Karsavino vidurinė mokykla";Žiniukai;9589810356;Taip;6;3;1;10
23512;"Vilniaus Levo Karsavino vidurinė mokykla";Žiniukai;64214150955;Taip;0;3;1;4
23513;"Vilniaus Levo Karsavino vidurinė mokykla";Žiniukai;6340289012;Taip;5;3;1;9
23514;"Vilniaus Liepkalnio Pagrindinė Mokykla";Bitutės;5597152556;Taip;16;1;0;17
23515;"Vilniaus Liepkalnio Pagrindinė Mokykla";Bitutės;4115995882;Ne;0;1;9;10
23516;"Vilniaus Liepkalnio Pagrindinė Mokykla";Bitutės;6136792125;Ne;0;8;0;8
23517;"Vilniaus Liepkalnio Pagrindinė Mokykla";Bitutės;9293634828;Taip;0;1;5;6
23518;"Vilniaus Liepkalnio Pagrindinė Mokykla";Bitutės;8324581018;Ne;0;1;5;6
23519;"Vilniaus Liepkalnio Pagrindinė Mokykla";Bitutės;1599633295;Taip;0;1;3;4
23520;"Vilniaus Liepkalnio Pagrindinė Mokykla";Bitutės;9589525954;Taip;0;1;1;2
23521;"Vilniaus Liepkalnio Pagrindinė Mokykla";Bitutės;7052487356;Taip;0;1;6;7
23522;"Vilniaus Liepkalnio Pagrindinė Mokykla";Bitutės;2080390421;Ne;9;1;2;12
23523;"Vilniaus Liepkalnio Pagrindinė Mokykla";Bitutės;5323726165;Taip;6;1;0;7
23524;"Vilniaus Liepkalnio Pagrindinė Mokykla";Bitutės;7922755136;Taip;0;1;0;1
23525;"Vilniaus Liepkalnio Pagrindinė Mokykla";Bitutės;1578956182;Taip;0;1;4;5
23526;"Vilniaus Liepkalnio Pagrindinė Mokykla";Bitutės;3721504364;Taip;0;1;7;8
23527;"Vilniaus Liepkalnio Pagrindinė Mokykla";Bitutės;1795366502;Taip;5;1;8;14
23528;"Vilniaus Liepkalnio Pagrindinė Mokykla";Bitutės;9211966929;Taip;0;1;10;11
23529;"Vilniaus Liepkalnio Pagrindinė Mokykla";Bitutės;4112888719;Taip;0;1;6;7
23530;"Vilniaus Liepkalnio Pagrindinė Mokykla";Bitutės;8809471063;Taip;0;1;5;6
23531;"Vilniaus Liepkalnio Pagrindinė Mokykla";Bitutės;5197037585;Ne;10;1;2;13
23532;"Vilniaus Liepkalnio Pagrindinė Mokykla";Bitutės;9771780358;Taip;10;1;5;16
23533;"Vilniaus Liepkalnio Pagrindinė Mokykla";Bitutės;4973569038;Taip;0;1;2;3
23534;"Vilniaus Pranciškaus Skorinos gimnazija";Saulytė;5194059497;Taip;5;3;4;12
23535;"Vilniaus Pranciškaus Skorinos gimnazija";Saulytė;5034268767;Taip;3;7;7;17
23536;"Vilniaus Pranciškaus Skorinos gimnazija";Saulytė;3036582121;Taip;0;4;0;4
23537;"Vilniaus Pranciškaus Skorinos gimnazija";Saulytė;5304082676;Ne;2;4;2;8
23538;"Vilniaus Pranciškaus Skorinos gimnazija";Saulytė;7055894770;Taip;5;4;0;9
23539;"Vilniaus Pranciškaus Skorinos gimnazija";Saulytė;6995285377;Ne;9;4;0;13
23540;"Vilniaus Pranciškaus Skorinos gimnazija";Saulytė;6336168033;Taip;0;1;0;1
23541;"Vilniaus Pranciškaus Skorinos gimnazija";Saulytė;3984446381;Taip;11;4;0;15
23542;"Vilniaus Pranciškaus Skorinos gimnazija";Saulytė;8641919789;Ne;5;3;3;11
23543;"Vilniaus Pranciškaus Skorinos gimnazija";Saulytė;5733610359;Taip;0;3;12;15
23544;"Vilniaus Pranciškaus Skorinos gimnazija";Saulytė;4501408366;Taip;3;6;0;9
23545;"Vilniaus Pranciškaus Skorinos gimnazija";Saulytė;4705514590;Ne;0;3;0;3
23546;"Vilniaus Pranciškaus Skorinos gimnazija";Saulytė;4165354124;Taip;0;5;1;6
23547;"Vilniaus Pranciškaus Skorinos gimnazija";Saulytė;6940231858;Ne;8;4;0;12
23548;"Vilniaus Pranciškaus Skorinos gimnazija";Saulytė;8572069816;Taip;3;2;0;5
23549;"Vilniaus Pranciškaus Skorinos gimnazija";Saulytė;4810459063;Taip;3;2;0;5
23550;"Vilniaus Pranciškaus Skorinos gimnazija";Saulytė;3354419392;Ne;0;30;0;30
23551;"Vilniaus Pranciškaus Skorinos gimnazija";Saulytė;9176198859;Ne;0;1;2;3
23552;"Vilniaus Pranciškaus Skorinos gimnazija";Saulytė;3234612149;Taip;13;7;0;20
23553;"Vilniaus Pranciškaus Skorinos gimnazija";Saulytė;6233673622;Taip;6;3;0;9
23554;"Vilniaus Simono Konarskio mokykla";"1 GR.";1464992631;Taip;5;1;0;6
23555;"Vilniaus Simono Konarskio mokykla";"1 GR.";7375004714;Taip;4;1;0;5
23556;"Vilniaus Simono Konarskio mokykla";"1 GR.";9822287576;Taip;6;1;0;7
23557;"Vilniaus Simono Konarskio mokykla";"1 GR.";7052198958;Taip;0;1;0;1
23558;"Vilniaus Simono Konarskio mokykla";"1 GR.";1498329448;Taip;2;1;0;3
23559;"Vilniaus Simono Konarskio mokykla";"1 GR.";3593323270;Taip;0;1;0;1
23560;"Vilniaus Simono Konarskio mokykla";"1 GR.";4463822099;Ne;0;1;0;1
23561;"Vilniaus Simono Konarskio mokykla";"1 GR.";9079781265;Taip;5;1;0;6
23562;"Vilniaus Simono Konarskio mokykla";"1 GR.";1048630061;Taip;2;1;0;3
23563;"Vilniaus Simono Konarskio mokykla";"1 GR.";4286223155;Taip;0;1;0;1
23564;"Vilniaus Simono Konarskio mokykla";"1 GR.";5073378325;Taip;0;1;0;1
23565;"Vilniaus Simono Konarskio mokykla";"1 GR.";8552079735;Ne;0;1;0;1
23566;"Vilniaus Simono Konarskio mokykla";"1 GR.";9093492513;Ne;0;1;0;1
23567;"Vilniaus Simono Konarskio mokykla";"1 GR.";7701956270;Taip;0;1;0;1
23568;"Vilniaus Trakų Vokės gimnazija";Priešmokyklinė;5299428924;Taip;0;1;1;2
23569;"Vilniaus Trakų Vokės gimnazija";Priešmokyklinė;9386629495;Taip;11;8;0;19
23570;"Vilniaus Trakų Vokės gimnazija";Priešmokyklinė;6209271043;Taip;0;1;1;2
23571;"Vilniaus Trakų Vokės gimnazija";Priešmokyklinė;3406479364;Taip;0;0;1;1
23572;"Vilniaus Trakų Vokės gimnazija";Priešmokyklinė;4849992906;Taip;8;2;0;10
23573;"Vilniaus Trakų Vokės gimnazija";Priešmokyklinė;3098390989;Taip;3;0;0;3
23574;"Vilniaus Trakų Vokės gimnazija";Priešmokyklinė;2672165297;Ne;0;0;1;1
23575;"Vilniaus Trakų Vokės gimnazija";Priešmokyklinė;2955411131;Taip;8;0;1;9
23576;"Vilniaus Trakų Vokės gimnazija";Priešmokyklinė;4846130117;Taip;0;1;0;1
23577;"Vilniaus Trakų Vokės gimnazija";Priešmokyklinė;1433982328;Taip;13;1;0;14
23578;"Vilniaus Trakų Vokės gimnazija";Priešmokyklinė;8658085249;Taip;0;33;0;33
23579;"Vilniaus Trakų Vokės gimnazija";Priešmokyklinė;39255784762;Taip;0;0;2;2
23580;"Vilniaus Trakų Vokės gimnazija";Priešmokyklinė;4599632235;Taip;0;4;3;7
23581;"Vilniaus Trakų Vokės gimnazija";Priešmokyklinė;2839396687;Taip;1;1;1;3
23582;"Vilniaus Trakų Vokės gimnazija";Priešmokyklinė;8857529726;Taip;0;0;2;2
23583;"Vilniaus Trakų Vokės gimnazija";Priešmokyklinė;7566567901;Taip;0;0;10;10
23584;"Vilniaus Trakų Vokės gimnazija";"Priešmokyklinė 2";4362066941;Taip;0;10;0;10
23585;"Vilniaus Trakų Vokės gimnazija";"Priešmokyklinė 2";1074730366;Ne;10;1;0;11
23586;"Vilniaus Trakų Vokės gimnazija";"Priešmokyklinė 2";6593654477;Taip;0;1;2;3
23587;"Vilniaus Trakų Vokės gimnazija";"Priešmokyklinė 2";9582511053;Taip;0;14;0;14
23588;"Vilniaus Trakų Vokės gimnazija";"Priešmokyklinė 2";3775081619;Taip;0;1;0;1
23589;"Vilniaus Trakų Vokės gimnazija";"Priešmokyklinė 2";4615315809;Taip;0;2;3;5
23590;"Vilniaus Trakų Vokės gimnazija";"Priešmokyklinė 2";25106446270;Taip;0;4;0;4
23591;"Vilniaus Trakų Vokės gimnazija";"Priešmokyklinė 2";18963190527;Taip;0;1;0;1
23592;"Vilniaus Trakų Vokės gimnazija";"Priešmokyklinė 2";4914675622;Taip;0;1;4;5
23593;"Vilniaus Trakų Vokės gimnazija";"Priešmokyklinė 2";5251929660;Taip;7;8;0;15
23594;"Vilniaus Trakų Vokės gimnazija";"Priešmokyklinė 2";3690179876;Taip;2;1;5;8
23595;"Vilniaus Trakų Vokės gimnazija";"Priešmokyklinė 2";8218370873;Ne;12;6;0;18
23596;"Vilniaus Trakų Vokės gimnazija";"Priešmokyklinė 2";6615724604;Taip;3;4;0;7
23597;"Vilniaus Trakų Vokės gimnazija";"Priešmokyklinė 2";4720226790;Taip;5;1;6;12
23598;"Vilniaus Trakų Vokės gimnazija";"Priešmokyklinė 2";1057189769;Taip;0;1;5;6
23599;"Vilniaus Trakų Vokės gimnazija";"Priešmokyklinė 2";2149804129;Ne;0;1;6;7
23600;"Vilniaus Trakų Vokės gimnazija";"Priešmokyklinė 2";1590598232;Taip;13;1;4;18
23601;"Vilniaus Trakų Vokės gimnazija";"Priešmokyklinė 2";8168960897;Ne;11;5;0;16
23602;"Vilniaus Trakų Vokės gimnazija";"Priešmokyklinė 2";9960520926;Ne;0;4;0;4
23603;"Vilniaus Trakų Vokės gimnazija";"Priešmokyklinė 2";9039274775;Taip;3;6;0;9
23604;"Vilniaus Trakų Vokės gimnazija";"Priešmokyklinė 3";7547303829;Taip;0;1;9;10
23605;"Vilniaus Trakų Vokės gimnazija";"Priešmokyklinė 3";2301758912;Taip;0;6;0;6
23606;"Vilniaus Trakų Vokės gimnazija";"Priešmokyklinė 3";7792654474;Taip;8;1;0;9
23607;"Vilniaus Trakų Vokės gimnazija";"Priešmokyklinė 3";3449317958;Ne;0;0;1;1
23608;"Vilniaus Trakų Vokės gimnazija";"Priešmokyklinė 3";9268558715;Taip;10;1;8;19
23609;"Vilniaus Trakų Vokės gimnazija";"Priešmokyklinė 3";9668538340;Taip;0;1;11;12
23610;"Vilniaus Trakų Vokės gimnazija";"Priešmokyklinė 3";2469486746;Taip;0;5;2;7
23611;"Vilniaus Trakų Vokės gimnazija";"Priešmokyklinė 3";95320712086;Taip;0;0;5;5
23612;"Vilniaus Trakų Vokės gimnazija";"Priešmokyklinė 3";1053286928;Taip;13;3;3;19
23613;"Vilniaus Trakų Vokės gimnazija";"Priešmokyklinė 3";5115117246;Ne;12;1;7;20
23614;"Vilniaus Trakų Vokės gimnazija";"Priešmokyklinė 3";6765094662;Taip;0;5;0;5
23615;"Vilniaus Trakų Vokės gimnazija";"Priešmokyklinė 3";6835150864;Taip;4;4;0;8
23616;"Vilniaus Trakų Vokės gimnazija";"Priešmokyklinė 3";1940148622;Taip;7;1;3;11
23617;"Vilniaus Trakų Vokės gimnazija";"Priešmokyklinė 3";8929514493;Taip;0;1;2;3
23618;"Vilniaus Trakų Vokės gimnazija";"Priešmokyklinė 3";9051697544;Ne;3;0;4;7
23619;"Vilniaus Trakų Vokės gimnazija";"Priešmokyklinė 3";1398572100;Taip;6;0;4;10
23620;"Vilniaus Trakų Vokės gimnazija";"Priešmokyklinė 3";2730385281;Taip;0;0;1;1
23621;"Vilniaus Trakų Vokės gimnazija";"Priešmokyklinė 3";2906094725;Ne;0;0;3;3
23622;"Vilniaus Trakų Vokės gimnazija";"Priešmokyklinė 3";9819489467;Ne;0;0;3;3
23623;"Vilniaus Salininkų gimnazija";"Priešmokyklinė A";22167560908;Taip;0;1;0;1
23624;"Vilniaus Salininkų gimnazija";"Priešmokyklinė A";10335028421;Ne;0;3;0;3
23625;"Vilniaus Salininkų gimnazija";"Priešmokyklinė A";8683841956;Taip;13;3;0;16
23626;"Vilniaus Salininkų gimnazija";"Priešmokyklinė A";1180792335;Taip;0;1;0;1
23627;"Vilniaus Salininkų gimnazija";"Priešmokyklinė A";5063792784;Taip;0;3;0;3
23628;"Vilniaus Salininkų gimnazija";"Priešmokyklinė A";1704033440;Taip;0;1;0;1
23629;"Vilniaus Salininkų gimnazija";"Priešmokyklinė A";46867660097;Taip;0;3;0;3
23630;"Vilniaus Salininkų gimnazija";"Priešmokyklinė A";3692008687;Taip;2;8;0;10
23631;"Vilniaus Salininkų gimnazija";"Priešmokyklinė A";2292919406;Taip;20;1;0;21
23632;"Vilniaus Salininkų gimnazija";"Priešmokyklinė A";35611320012;Taip;0;4;0;4
23633;"Vilniaus Salininkų gimnazija";"Priešmokyklinė A";4269202761;Taip;22;1;0;23
23634;"Vilniaus Salininkų gimnazija";"Priešmokyklinė A";9375550172;Taip;0;2;0;2
23635;"Vilniaus Salininkų gimnazija";"Priešmokyklinė A";7160091629;Taip;3;8;0;11
23636;"Vilniaus Salininkų gimnazija";"Priešmokyklinė A";41023354439;Taip;4;1;0;5
23637;"Vilniaus Salininkų gimnazija";"Priešmokyklinė A";1642658060;Taip;4;8;0;12
23638;"Vilniaus Salininkų gimnazija";"Priešmokyklinė A";3848448401;Taip;0;1;0;1
23639;"Vilniaus Salininkų gimnazija";"Priešmokyklinė A";3737786832;Ne;0;2;0;2
23640;"Vilniaus Salininkų gimnazija";"Priešmokyklinė A";8025611655;Taip;0;3;0;3
23641;"Vilniaus Salininkų gimnazija";"Priešmokyklinė A";4939261324;Taip;3;3;0;6
23642;"Vilniaus Salininkų gimnazija";"Priešmokyklinė A";6738902611;Taip;0;21;0;21
23643;"Vilniaus Salininkų gimnazija";"Priešmokyklinė A";2989580886;Taip;4;1;0;5
23644;"Vilniaus Salininkų gimnazija";"Priešmokyklinė A";3661928980;Taip;0;4;0;4
23645;"Vilniaus Salininkų gimnazija";"PRIEŠMOKYKLINĖ B";7378039370;Taip;9;1;0;10
23646;"Vilniaus Salininkų gimnazija";"PRIEŠMOKYKLINĖ B";98941037508;Taip;0;21;0;21
23647;"Vilniaus Salininkų gimnazija";"PRIEŠMOKYKLINĖ B";1355032282;Taip;3;1;0;4
23648;"Vilniaus Salininkų gimnazija";"PRIEŠMOKYKLINĖ B";8018093186;Ne;5;1;0;6
23649;"Vilniaus Salininkų gimnazija";"PRIEŠMOKYKLINĖ B";9216372353;Taip;1;1;0;2
23650;"Vilniaus Salininkų gimnazija";"PRIEŠMOKYKLINĖ B";3015424614;Taip;9;1;0;10
23651;"Vilniaus Salininkų gimnazija";"PRIEŠMOKYKLINĖ B";8488127476;Ne;14;1;0;15
23652;"Vilniaus Salininkų gimnazija";"PRIEŠMOKYKLINĖ B";8410624264;Taip;7;1;0;8
23653;"Vilniaus Salininkų gimnazija";"PRIEŠMOKYKLINĖ B";1544346282;Taip;1;1;0;2
23654;"Vilniaus Salininkų gimnazija";"PRIEŠMOKYKLINĖ B";2066091911;Taip;8;1;0;9
23655;"Vilniaus Salininkų gimnazija";"PRIEŠMOKYKLINĖ B";1723241116;Taip;5;1;0;6
23656;"Vilniaus Salininkų gimnazija";"PRIEŠMOKYKLINĖ B";30123603107;Taip;3;1;0;4
23657;"Vilniaus Salininkų gimnazija";"PRIEŠMOKYKLINĖ B";8659656902;Taip;1;1;0;2
23658;"Vilniaus Salininkų gimnazija";"PRIEŠMOKYKLINĖ B";8288199783;Taip;0;1;0;1
23659;"Vilniaus Salininkų gimnazija";"PRIEŠMOKYKLINĖ B";1065549119;Ne;0;1;0;1
23660;"Vilniaus Salininkų gimnazija";"PRIEŠMOKYKLINĖ B";1460694577;Taip;0;1;0;1
23661;"Vilniaus Salininkų gimnazija";"PRIEŠMOKYKLINĖ B";2786775879;Taip;1;1;0;2
23662;"Vilniaus Salininkų gimnazija";"PRIEŠMOKYKLINĖ B";5689344488;Taip;0;1;0;1
23663;"Vilniaus Salininkų gimnazija";"PRIEŠMOKYKLINĖ B";9513785510;Taip;1;1;0;2
23664;"Vilniaus Salininkų gimnazija";"PRIEŠMOKYKLINĖ B";91859774311;Taip;3;1;0;4
23665;"Vilniaus Salininkų gimnazija";"PRIEŠMOKYKLINĖ B";9026612929;Taip;0;21;0;21
23666;"Vilniaus Salininkų gimnazija";"PRIEŠMOKYKLINĖ B";4271670413;Ne;6;1;0;7
23667;"Vilniaus „Spindulio“ progimnazija";PM2;3093606855;Taip;8;1;0;9
23668;"Vilniaus „Spindulio“ progimnazija";PM2;6304295422;Taip;7;1;2;10
23669;"Vilniaus „Spindulio“ progimnazija";PM2;5078945984;Taip;0;2;0;2
23670;"Vilniaus „Spindulio“ progimnazija";PM2;9099945815;Taip;0;2;0;2
23671;"Vilniaus „Spindulio“ progimnazija";PM2;75538036055;Taip;0;1;0;1
23672;"Vilniaus „Spindulio“ progimnazija";PM2;15583558585;Taip;9;2;0;11
23673;"Vilniaus „Spindulio“ progimnazija";PM2;2427349194;Ne;7;6;0;13
23674;"Vilniaus „Spindulio“ progimnazija";PM2;7445566160;Taip;0;2;0;2
23675;"Vilniaus „Spindulio“ progimnazija";PM2;6561536457;Taip;0;1;0;1
23676;"Vilniaus „Spindulio“ progimnazija";PM2;8023936861;Ne;4;1;0;5
23677;"Vilniaus „Spindulio“ progimnazija";PM2;7277680544;Taip;2;2;2;6
23678;"Vilniaus „Spindulio“ progimnazija";PM2;6479094819;Taip;14;1;0;15
23679;"Vilniaus „Spindulio“ progimnazija";PM2;6016791282;Taip;0;1;1;2
23680;"Vilniaus „Spindulio“ progimnazija";PM2;2356833740;Ne;4;4;1;9
23681;"Vilniaus „Spindulio“ progimnazija";PM2;1338287524;Taip;0;1;0;1
23682;"Vilniaus „Spindulio“ progimnazija";PM2;9516852657;Taip;0;1;2;3
23683;"Vilniaus „Spindulio“ progimnazija";PM2;1364873935;Taip;0;6;2;8
23684;"Vilniaus „Spindulio“ progimnazija";PM2;7528505426;Taip;3;3;0;6
23685;"Vilniaus „Spindulio“ progimnazija";PM2;7120717682;Taip;0;4;0;4
23686;"Vilniaus „Spindulio“ progimnazija";PM2;1183272346;Taip;0;1;1;2
23687;"Vilniaus „Spindulio“ progimnazija";PM2;6201567680;Taip;3;1;3;7
23688;"Vilniaus „Spindulio“ progimnazija";PM2;8012626513;Taip;2;2;0;4
23689;"Vilniaus „Spindulio“ progimnazija";PM2;52216192635;Taip;0;1;4;5
23690;"Vilniaus „Spindulio“ progimnazija";PM2;4791752179;Taip;4;2;3;9
23691;"Vilniaus „Spindulio“ progimnazija";PM1;1948438336;Taip;0;2;0;2
23692;"Vilniaus „Spindulio“ progimnazija";PM1;43859975789;Taip;0;3;2;5
23693;"Vilniaus „Spindulio“ progimnazija";PM1;4701887030;Taip;3;3;1;7
23694;"Vilniaus „Spindulio“ progimnazija";PM1;60320557464;Taip;4;1;0;5
23695;"Vilniaus „Spindulio“ progimnazija";PM1;2531571615;Taip;0;5;0;5
23696;"Vilniaus „Spindulio“ progimnazija";PM1;1421633312;Ne;0;7;0;7
23697;"Vilniaus „Spindulio“ progimnazija";PM1;3678131609;Taip;0;2;0;2
23698;"Vilniaus „Spindulio“ progimnazija";PM1;1194444282;Taip;0;1;0;1
23699;"Vilniaus „Spindulio“ progimnazija";PM1;56885383122;Taip;2;4;0;6
23700;"Vilniaus „Spindulio“ progimnazija";PM1;1338476746;Taip;0;2;0;2
23701;"Vilniaus „Spindulio“ progimnazija";PM1;1251961268;Taip;0;2;0;2
23702;"Vilniaus „Spindulio“ progimnazija";PM1;2402204674;Taip;2;8;0;10
23703;"Vilniaus „Spindulio“ progimnazija";PM1;6700068320;Taip;7;3;0;10
23704;"Vilniaus „Spindulio“ progimnazija";PM1;9347513042;Taip;0;6;0;6
23705;"Vilniaus „Spindulio“ progimnazija";PM1;1153333591;Taip;0;3;0;3
23706;"Vilniaus „Spindulio“ progimnazija";PM1;1650166115;Taip;0;6;0;6
23707;"Vilniaus „Spindulio“ progimnazija";PM1;9573336239;Taip;2;1;0;3
23708;"Vilniaus „Spindulio“ progimnazija";PM1;4239224971;Taip;0;1;3;4
23709;"Vilniaus „Spindulio“ progimnazija";PM1;9502789660;Taip;0;1;0;1
23710;"Vilniaus „Spindulio“ progimnazija";PM1;1454101129;Taip;0;5;0;5
23711;"Vilniaus „Spindulio“ progimnazija";PM1;1325054642;Taip;0;3;0;3
23712;"Vilniaus „Spindulio“ progimnazija";PM1;1160537966;Taip;13;3;0;16
23713;"Vilniaus „Spindulio“ progimnazija";PM1;91028452879;Taip;0;1;1;2
23714;"Vilniaus „Spindulio“ progimnazija";PM1;1789047913;Taip;0;3;0;3
23715;"Vilniaus Vladislavo Sirokomlės gimnazija";Nykštukai;1797237248;Taip;3;8;0;11
23716;"Vilniaus Vladislavo Sirokomlės gimnazija";Nykštukai;6031408197;Taip;0;7;1;8
23717;"Vilniaus Vladislavo Sirokomlės gimnazija";Nykštukai;1947403400;Taip;0;9;0;9
23718;"Vilniaus Vladislavo Sirokomlės gimnazija";Nykštukai;1499061139;Taip;0;33;0;33
23719;"Vilniaus Vladislavo Sirokomlės gimnazija";Nykštukai;2219712757;Taip;0;8;0;8
23720;"Vilniaus Vladislavo Sirokomlės gimnazija";Nykštukai;5544613599;Taip;4;10;0;14
23721;"Vilniaus Vladislavo Sirokomlės gimnazija";Nykštukai;25415760747;Taip;0;8;0;8
23722;"Vilniaus Vladislavo Sirokomlės gimnazija";Nykštukai;17201639406;Taip;0;7;0;7
23723;"Vilniaus Vladislavo Sirokomlės gimnazija";Nykštukai;8302624354;Taip;5;9;0;14
23724;"Vilniaus Vladislavo Sirokomlės gimnazija";Nykštukai;1492328724;Taip;8;7;0;15
23725;"Vilniaus Vladislavo Sirokomlės gimnazija";Nykštukai;4436165764;Taip;8;7;0;15
23726;"Vilniaus Vladislavo Sirokomlės gimnazija";Nykštukai;1837566431;Ne;0;8;0;8
23727;"Vilniaus Vladislavo Sirokomlės gimnazija";Nykštukai;8016643568;Taip;0;7;0;7
23728;"Vilniaus Vladislavo Sirokomlės gimnazija";Nykštukai;4534828670;Taip;0;33;0;33
23729;"Vilniaus Vladislavo Sirokomlės gimnazija";Nykštukai;4069044269;Taip;0;7;0;7
23730;"Vilniaus Vladislavo Sirokomlės gimnazija";Nykštukai;9391697537;Taip;0;8;3;11
23731;"Vilniaus Vladislavo Sirokomlės gimnazija";Nykštukai;5422289286;Taip;3;8;2;13
23732;"Vilniaus Vladislavo Sirokomlės gimnazija";Nykštukai;5625943720;Taip;4;9;0;13
23733;"Vilniaus Vladislavo Sirokomlės gimnazija";Nykštukai;2946297529;Taip;0;7;0;7
23734;"Vilniaus Vladislavo Sirokomlės gimnazija";Smurfai;5844437769;Taip;12;4;0;16
23735;"Vilniaus Vladislavo Sirokomlės gimnazija";Smurfai;9751494612;Taip;3;4;0;7
23736;"Vilniaus Vladislavo Sirokomlės gimnazija";Smurfai;4727265555;Taip;10;5;0;15
23737;"Vilniaus Vladislavo Sirokomlės gimnazija";Smurfai;7071043164;Taip;5;4;0;9
23738;"Vilniaus Vladislavo Sirokomlės gimnazija";Smurfai;1493604303;Taip;0;4;0;4
23739;"Vilniaus Vladislavo Sirokomlės gimnazija";Smurfai;4830374546;Taip;9;7;0;16
23740;"Vilniaus Vladislavo Sirokomlės gimnazija";Smurfai;4506651162;Taip;11;4;0;15
23741;"Vilniaus Vladislavo Sirokomlės gimnazija";Smurfai;1817869518;Taip;6;5;0;11
23742;"Vilniaus Vladislavo Sirokomlės gimnazija";Smurfai;1512245903;Taip;2;5;0;7
23743;"Vilniaus Vladislavo Sirokomlės gimnazija";Smurfai;7904983228;Ne;3;5;0;8
23744;"Vilniaus Vladislavo Sirokomlės gimnazija";Smurfai;1570206034;Ne;7;5;0;12
23745;"Vilniaus Vladislavo Sirokomlės gimnazija";Smurfai;1820583792;Taip;13;5;0;18
23746;"Vilniaus Vladislavo Sirokomlės gimnazija";Smurfai;2386927970;Taip;8;4;0;12
23747;"Vilniaus Vladislavo Sirokomlės gimnazija";Smurfai;92356998180;Taip;1;3;0;4
23748;"Vilniaus Vladislavo Sirokomlės gimnazija";Smurfai;4990982790;Taip;0;5;0;5
23749;"Vilniaus Vladislavo Sirokomlės gimnazija";Smurfai;3795927209;Taip;5;5;0;10
23750;"Vilniaus Vladislavo Sirokomlės gimnazija";Smurfai;3880578523;Taip;9;4;0;13
23751;"Vilniaus Vladislavo Sirokomlės gimnazija";Smurfai;9868386182;Taip;2;5;0;7
23752;"Vilniaus Vladislavo Sirokomlės gimnazija";Smurfai;1090204906;Ne;2;4;0;6
23753;"Vilniaus „Pelėdos” pradinė mokykla";Bitutės;3131930907;Taip;0;1;5;6
23754;"Vilniaus „Pelėdos” pradinė mokykla";Bitutės;2023718424;Taip;0;1;0;1
23755;"Vilniaus „Pelėdos” pradinė mokykla";Bitutės;13170636069;Taip;0;1;8;9
23756;"Vilniaus „Pelėdos” pradinė mokykla";Bitutės;1627717901;Taip;0;1;0;1
23757;"Vilniaus „Pelėdos” pradinė mokykla";Bitutės;49343952061;Taip;0;1;0;1
23758;"Vilniaus „Pelėdos” pradinė mokykla";Bitutės;8281005516;Ne;0;0;3;3
23759;"Vilniaus „Pelėdos” pradinė mokykla";Bitutės;7678062264;Taip;5;1;7;13
23760;"Vilniaus „Pelėdos” pradinė mokykla";Bitutės;20602164053;Taip;0;2;1;3
23761;"Vilniaus „Pelėdos” pradinė mokykla";Bitutės;6610166355;Taip;3;0;0;3
23762;"Vilniaus „Pelėdos” pradinė mokykla";Bitutės;5282345380;Taip;0;0;1;1
23763;"Vilniaus „Pelėdos” pradinė mokykla";Bitutės;4427123314;Taip;2;1;2;5
23764;"Vilniaus „Pelėdos” pradinė mokykla";Bitutės;5610993611;Taip;7;1;1;9
23765;"Vilniaus „Pelėdos” pradinė mokykla";Bitutės;1121936989;Taip;0;1;1;2
23766;"Vilniaus „Pelėdos” pradinė mokykla";Bitutės;4268531240;Taip;6;1;5;12
23767;"Vilniaus „Pelėdos” pradinė mokykla";Bitutės;3312575449;Taip;5;0;0;5
23768;"Vilniaus „Pelėdos” pradinė mokykla";Bitutės;7907026349;Ne;0;1;1;2
23769;"Vilniaus „Pelėdos” pradinė mokykla";Bitutės;9343761295;Taip;1;1;0;2
23770;"Vilniaus „Pelėdos” pradinė mokykla";Bitutės;7006338378;Taip;2;2;1;5
23771;"Vilniaus „Pelėdos” pradinė mokykla";Bitutės;3030820917;Ne;9;1;1;11
23772;"Vilniaus „Pelėdos” pradinė mokykla";Bitutės;3768735503;Taip;5;1;5;11
23773;"Vilniaus „Pelėdos” pradinė mokykla";Bitutės;6597383913;Taip;5;1;2;8
23774;"Vilniaus „Pelėdos” pradinė mokykla";Bitutės;7972395014;Taip;0;1;8;9
23775;"Vilniaus „Pelėdos” pradinė mokykla";Boružėlės;3284613284;Taip;5;0;0;5
23776;"Vilniaus „Pelėdos” pradinė mokykla";Boružėlės;1032549174;Taip;7;1;0;8
23777;"Vilniaus „Pelėdos” pradinė mokykla";Boružėlės;1314392095;Ne;6;1;0;7
23778;"Vilniaus „Pelėdos” pradinė mokykla";Boružėlės;1398976932;Taip;5;0;0;5
23779;"Vilniaus „Pelėdos” pradinė mokykla";Boružėlės;1249227477;Taip;0;1;0;1
23780;"Vilniaus „Pelėdos” pradinė mokykla";Boružėlės;6897988246;Taip;2;0;0;2
23781;"Vilniaus „Pelėdos” pradinė mokykla";Boružėlės;1830060403;Taip;8;1;0;9
23782;"Vilniaus „Pelėdos” pradinė mokykla";Boružėlės;4347647695;Taip;11;1;0;12
23783;"Vilniaus „Pelėdos” pradinė mokykla";Boružėlės;9823188609;Taip;0;1;0;1
23784;"Vilniaus „Pelėdos” pradinė mokykla";Boružėlės;1153781469;Taip;0;0;22;22
23785;"Vilniaus „Pelėdos” pradinė mokykla";Boružėlės;93600065957;Taip;0;1;0;1
23786;"Vilniaus „Pelėdos” pradinė mokykla";Boružėlės;3970413055;Taip;0;1;0;1
23787;"Vilniaus „Pelėdos” pradinė mokykla";Boružėlės;9279913053;Ne;4;1;0;5
23788;"Vilniaus „Pelėdos” pradinė mokykla";Boružėlės;1616324236;Ne;9;1;0;10
23789;"Vilniaus „Pelėdos” pradinė mokykla";Boružėlės;1704933971;Taip;0;1;0;1
23790;"Vilniaus „Pelėdos” pradinė mokykla";Boružėlės;3790209561;Ne;3;0;0;3
23791;"Vilniaus „Pelėdos” pradinė mokykla";Boružėlės;6623852620;Ne;0;1;0;1
23792;"Vilniaus „Pelėdos” pradinė mokykla";Boružėlės;3118698712;Taip;0;1;0;1
23793;"Vilniaus „Pelėdos” pradinė mokykla";Boružėlės;5140876051;Ne;0;10;0;10
23794;"Vilniaus „Pelėdos” pradinė mokykla";Boružėlės;8086378912;Taip;6;0;0;6
23795;"Vilniaus „Pelėdos” pradinė mokykla";1a;1206482166;Taip;11;0;0;11
23796;"Vilniaus „Pelėdos” pradinė mokykla";1c;1585412975;Taip;11;0;0;11
23797;"Vilniaus Joachimo Lelevelio inžinerijos mokykla";0A;1694423628;Taip;0;3;0;3
23798;"Vilniaus Joachimo Lelevelio inžinerijos mokykla";0A;19420482998;Taip;4;2;0;6
23799;"Vilniaus Joachimo Lelevelio inžinerijos mokykla";0A;1546251543;Taip;0;22;0;22
23800;"Vilniaus Joachimo Lelevelio inžinerijos mokykla";0A;9130637883;Taip;8;4;1;13
23801;"Vilniaus Joachimo Lelevelio inžinerijos mokykla";0A;6217540064;Taip;5;2;0;7
23802;"Vilniaus Joachimo Lelevelio inžinerijos mokykla";0A;1954888655;Taip;0;0;10;10
23803;"Vilniaus Joachimo Lelevelio inžinerijos mokykla";0A;7776071299;Taip;3;2;0;5
23804;"Vilniaus Joachimo Lelevelio inžinerijos mokykla";0A;9215070593;Taip;6;0;0;6
23805;"Vilniaus Joachimo Lelevelio inžinerijos mokykla";0A;3039980710;Taip;6;2;0;8
23806;"Vilniaus Joachimo Lelevelio inžinerijos mokykla";0A;1826015013;Taip;9;0;0;9
23807;"Vilniaus Joachimo Lelevelio inžinerijos mokykla";0A;5630659056;Taip;5;6;0;11
23808;"Vilniaus Joachimo Lelevelio inžinerijos mokykla";0A;9171690612;Taip;0;3;0;3
23809;"Vilniaus Joachimo Lelevelio inžinerijos mokykla";0A;3271832822;Taip;4;2;0;6
23810;"Vilniaus Joachimo Lelevelio inžinerijos mokykla";0A;2797443202;Ne;5;0;2;7
23811;"Vilniaus Joachimo Lelevelio inžinerijos mokykla";0B;6404064049;Taip;1;1;1;3
23812;"Vilniaus Joachimo Lelevelio inžinerijos mokykla";0B;2324578741;Taip;0;5;0;5
23813;"Vilniaus Joachimo Lelevelio inžinerijos mokykla";0B;6132569107;Taip;0;1;1;2
23814;"Vilniaus Joachimo Lelevelio inžinerijos mokykla";0B;64247830728;Taip;0;20;0;20
23815;"Vilniaus Joachimo Lelevelio inžinerijos mokykla";0B;2601103834;Taip;12;1;0;13
23816;"Vilniaus Joachimo Lelevelio inžinerijos mokykla";0B;65960895249;Taip;0;8;0;8
23817;"Vilniaus Joachimo Lelevelio inžinerijos mokykla";0B;5722934228;Taip;0;2;0;2
23818;"Vilniaus Joachimo Lelevelio inžinerijos mokykla";0B;1385352925;Taip;0;3;0;3
23819;"Vilniaus Joachimo Lelevelio inžinerijos mokykla";0B;4209118353;Taip;7;1;1;9
23820;"Vilniaus Joachimo Lelevelio inžinerijos mokykla";0B;6883982889;Taip;7;3;0;10
23821;"Vilniaus Joachimo Lelevelio inžinerijos mokykla";0B;9595277597;Taip;8;1;0;9
23822;"Vilniaus Joachimo Lelevelio inžinerijos mokykla";0B;2842587194;Taip;1;1;0;2
23823;"Vilniaus Joachimo Lelevelio inžinerijos mokykla";0B;8042807487;Taip;1;2;0;3
23824;"Vilniaus Joachimo Lelevelio inžinerijos mokykla";0B;6501930436;Taip;1;4;1;6
23825;"Vilniaus Joachimo Lelevelio inžinerijos mokykla";0B;71081903240;Taip;0;1;0;1
23826;"Vilniaus Juzefo Ignacijaus Kraševskio gimnazija";Priešmokyklinė;2201538495;Taip;5;1;4;10
23827;"Vilniaus Juzefo Ignacijaus Kraševskio gimnazija";Priešmokyklinė;9114472645;Ne;0;5;0;5
23828;"Vilniaus Juzefo Ignacijaus Kraševskio gimnazija";Priešmokyklinė;5261769707;Taip;5;2;0;7
23829;"Vilniaus Juzefo Ignacijaus Kraševskio gimnazija";Priešmokyklinė;5255617339;Ne;10;1;0;11
23830;"Vilniaus Juzefo Ignacijaus Kraševskio gimnazija";Priešmokyklinė;1600495468;Taip;0;4;0;4
23831;"Vilniaus Juzefo Ignacijaus Kraševskio gimnazija";Priešmokyklinė;3733665122;Taip;8;4;0;12
23832;"Vilniaus Juzefo Ignacijaus Kraševskio gimnazija";Priešmokyklinė;2168987649;Taip;3;1;0;4
23833;"Vilniaus Juzefo Ignacijaus Kraševskio gimnazija";Priešmokyklinė;4499924331;Taip;0;1;0;1
23834;"Vilniaus Juzefo Ignacijaus Kraševskio gimnazija";Priešmokyklinė;6048337545;Taip;0;1;1;2
23835;"Vilniaus Juzefo Ignacijaus Kraševskio gimnazija";Priešmokyklinė;9948555227;Taip;14;1;1;16
23836;"Vilniaus Juzefo Ignacijaus Kraševskio gimnazija";Priešmokyklinė;7993975989;Taip;0;9;0;9
23837;"Vilniaus Juzefo Ignacijaus Kraševskio gimnazija";Priešmokyklinė;2684151591;Ne;8;2;0;10
23838;"Vilniaus Juzefo Ignacijaus Kraševskio gimnazija";Priešmokyklinė;7670166244;Taip;5;1;2;8
23839;"Vilniaus Juzefo Ignacijaus Kraševskio gimnazija";Priešmokyklinė;4864834075;Taip;6;4;0;10
23840;"Vilniaus Juzefo Ignacijaus Kraševskio gimnazija";Priešmokyklinė;1837140329;Ne;7;1;2;10
23841;"Vilniaus Juzefo Ignacijaus Kraševskio gimnazija";Priešmokyklinė;1460429651;Taip;2;3;0;5
23842;"Vilniaus Juzefo Ignacijaus Kraševskio gimnazija";Priešmokyklinė;9501262918;Ne;0;1;3;4
23843;"Vilniaus Juzefo Ignacijaus Kraševskio gimnazija";Priešmokyklinė;9333766622;Ne;8;9;0;17
23844;"Vilniaus Juzefo Ignacijaus Kraševskio gimnazija";Priešmokyklinė;3507672150;Taip;3;10;0;13
23845;"Vilniaus Juzefo Ignacijaus Kraševskio gimnazija";Priešmokyklinė;7305350540;Taip;4;4;0;8
23846;"Vilniaus Juzefo Ignacijaus Kraševskio gimnazija";Priešmokyklinė;3698808100;Taip;0;8;0;8
23847;"Vilniaus Juzefo Ignacijaus Kraševskio gimnazija";Priešmokyklinė;9754373141;Taip;0;10;5;15
23848;"Vilniaus Jono Pauliaus II progimnazija";Nykštukai;2055530718;Taip;10;1;0;11
23849;"Vilniaus Jono Pauliaus II progimnazija";Nykštukai;7140223126;Taip;6;1;1;8
23850;"Vilniaus Jono Pauliaus II progimnazija";Nykštukai;48694326383;Taip;0;1;0;1
23851;"Vilniaus Jono Pauliaus II progimnazija";Nykštukai;4831426440;Taip;0;1;10;11
23852;"Vilniaus Jono Pauliaus II progimnazija";Nykštukai;3762141936;Taip;1;2;0;3
23853;"Vilniaus Jono Pauliaus II progimnazija";Nykštukai;8703046661;Taip;6;1;0;7
23854;"Vilniaus Jono Pauliaus II progimnazija";Nykštukai;6724813553;Taip;11;1;0;12
23855;"Vilniaus Jono Pauliaus II progimnazija";Nykštukai;51629266891;Taip;4;1;0;5
23856;"Vilniaus Jono Pauliaus II progimnazija";Nykštukai;7268811782;Ne;4;1;0;5
23857;"Vilniaus Jono Pauliaus II progimnazija";Nykštukai;8998452731;Taip;11;1;0;12
23858;"Vilniaus Jono Pauliaus II progimnazija";Nykštukai;4071338645;Taip;7;4;0;11
23859;"Vilniaus Jono Pauliaus II progimnazija";Nykštukai;3637409607;Taip;11;5;0;16
23860;"Vilniaus Jono Pauliaus II progimnazija";Nykštukai;6988819614;Taip;9;1;0;10
23861;"Vilniaus Jono Pauliaus II progimnazija";Nykštukai;9672929606;Taip;13;1;2;16
23862;"Vilniaus Jono Pauliaus II progimnazija";Nykštukai;9457189905;Taip;13;1;0;14
23863;"Vilniaus Jono Pauliaus II progimnazija";Nykštukai;2013905907;Taip;0;6;0;6
23864;"Vilniaus Jono Pauliaus II progimnazija";Nykštukai;2095972347;Ne;0;1;0;1
23865;"Vilniaus Jono Pauliaus II progimnazija";Nykštukai;1624125024;Taip;1;2;0;3
23866;"Vilniaus Jono Pauliaus II progimnazija";Nykštukai;8796557675;Taip;3;4;0;7
23867;"Vilniaus Jono Pauliaus II progimnazija";Nykštukai;5902455219;Taip;0;2;0;2
23868;"Vilniaus Jono Pauliaus II progimnazija";Žiniukai;36350993825;Taip;15;4;0;19
23869;"Vilniaus Jono Pauliaus II progimnazija";Žiniukai;8607110629;Ne;11;4;1;16
23870;"Vilniaus Jono Pauliaus II progimnazija";Žiniukai;6779413882;Taip;21;3;1;25
23871;"Vilniaus Jono Pauliaus II progimnazija";Žiniukai;1897451825;Taip;0;12;0;12
23872;"Vilniaus Jono Pauliaus II progimnazija";Žiniukai;49110267692;Taip;8;4;2;14
23873;"Vilniaus Jono Pauliaus II progimnazija";Žiniukai;7947148051;Taip;4;6;0;10
23874;"Vilniaus Jono Pauliaus II progimnazija";Žiniukai;9246391309;Taip;5;4;0;9
23875;"Vilniaus Jono Pauliaus II progimnazija";Žiniukai;35673258175;Taip;0;4;4;8
23876;"Vilniaus Jono Pauliaus II progimnazija";Žiniukai;4472742569;Taip;4;4;0;8
23877;"Vilniaus Jono Pauliaus II progimnazija";Žiniukai;69245659818;Taip;5;10;0;15
23878;"Vilniaus Jono Pauliaus II progimnazija";Žiniukai;9664467134;Taip;10;4;0;14
23879;"Vilniaus Jono Pauliaus II progimnazija";Žiniukai;7838787153;Taip;14;3;0;17
23880;"Vilniaus Jono Pauliaus II progimnazija";Žiniukai;8922195998;Taip;12;3;0;15
23881;"Vilniaus Jono Pauliaus II progimnazija";Žiniukai;1429139157;Taip;20;4;0;24
23882;"Vilniaus Jono Pauliaus II progimnazija";Žiniukai;3042409414;Taip;0;12;0;12
23883;"Vilniaus Jono Pauliaus II progimnazija";Žiniukai;8245310502;Ne;13;5;0;18
23884;"Vilniaus Jono Pauliaus II progimnazija";Žiniukai;5593546668;Taip;0;16;0;16
23885;"Vilniaus Jono Pauliaus II progimnazija";Žiniukai;1460444785;Taip;20;6;0;26
23886;"Vilniaus Jono Pauliaus II progimnazija";Žiniukai;9262869284;Ne;9;4;0;13
23887;"Vilniaus Jono Pauliaus II progimnazija";Žiniukai;38456484551;Taip;5;5;0;10
23888;"Vilniaus Jono Pauliaus II progimnazija";Žiniukai;6646474196;Taip;12;4;0;16
23889;"Vilniaus Jono Pauliaus II progimnazija";Spindulėlis;2391924358;Taip;0;1;0;1
23890;"Vilniaus Jono Pauliaus II progimnazija";Spindulėlis;9953834483;Taip;1;2;0;3
23891;"Vilniaus Jono Pauliaus II progimnazija";Spindulėlis;1950514819;Taip;0;23;0;23
23892;"Vilniaus Jono Pauliaus II progimnazija";Spindulėlis;1298127839;Ne;4;1;0;5
23893;"Vilniaus Jono Pauliaus II progimnazija";Spindulėlis;4034847901;Taip;0;3;0;3
23894;"Vilniaus Jono Pauliaus II progimnazija";Spindulėlis;8980788109;Taip;8;3;0;11
23895;"Vilniaus Jono Pauliaus II progimnazija";Spindulėlis;1009453682;Taip;1;4;0;5
23896;"Vilniaus Jono Pauliaus II progimnazija";Spindulėlis;4579700769;Taip;1;1;0;2
23897;"Vilniaus Jono Pauliaus II progimnazija";Spindulėlis;7136135394;Taip;5;2;0;7
23898;"Vilniaus Jono Pauliaus II progimnazija";Spindulėlis;2244921301;Taip;10;1;0;11
23899;"Vilniaus Jono Pauliaus II progimnazija";Spindulėlis;1133359254;Taip;15;1;0;16
23900;"Vilniaus Jono Pauliaus II progimnazija";Spindulėlis;8336138549;Taip;0;2;0;2
23901;"Vilniaus Jono Pauliaus II progimnazija";Spindulėlis;1831094707;Taip;5;1;0;6
23902;"Vilniaus Jono Pauliaus II progimnazija";Spindulėlis;5036549574;Taip;3;2;0;5
23903;"Vilniaus Jono Pauliaus II progimnazija";Spindulėlis;5451923881;Taip;10;1;0;11
23904;"Vilniaus Jono Pauliaus II progimnazija";Spindulėlis;8100789958;Taip;5;3;0;8
23905;"Vilniaus Jono Pauliaus II progimnazija";Spindulėlis;6964047214;Taip;0;1;0;1
23906;"Vilniaus Jono Pauliaus II progimnazija";Spindulėlis;2445444641;Taip;10;1;0;11
23907;"Vilniaus Jono Pauliaus II progimnazija";Spindulėlis;5079107907;Taip;0;2;0;2
23908;"Vilniaus Jono Pauliaus II progimnazija";Spindulėlis;9908198854;Taip;0;2;0;2
23909;"Vilniaus Jono Pauliaus II progimnazija";Spindulėlis;6595165722;Taip;8;1;0;9
23910;"Vilniaus Verkių mokykla-daugiafunkcis centras";"5L, 6L, 6LK, 7L, 7LK klasė ";1503792026;Taip;10;0;0;10
23911;"Vilniaus Verkių mokykla-daugiafunkcis centras";"8S, 8SK, 9S, 9SK klasė";9420292538;Taip;1;0;0;1
23912;"Vilniaus Sausio 13-osios mokykla";GUDRUČIAI;6551966837;Taip;3;0;0;3
23913;"Vilniaus Sausio 13-osios mokykla";GUDRUČIAI;2086546195;Taip;9;0;0;9
23914;"Vilniaus Sausio 13-osios mokykla";GUDRUČIAI;2153133102;Ne;2;0;0;2
23915;"Vilniaus Sausio 13-osios mokykla";GUDRUČIAI;9652807467;Taip;2;0;0;2
23916;"Vilniaus Sausio 13-osios mokykla";SMALSUČIAI;1833543299;Taip;5;0;0;5
23917;"Vilniaus Sausio 13-osios mokykla";SMALSUČIAI;4835765774;Taip;3;0;0;3
23918;"Vilniaus Sausio 13-osios mokykla";SMALSUČIAI;8377745793;Taip;9;0;0;9
23919;"Vilniaus Sausio 13-osios mokykla";SMALSUČIAI;1874574001;Ne;12;0;0;12
23920;"Vilniaus Sausio 13-osios mokykla";SMALSUČIAI;6693601673;Taip;10;0;0;10
23921;"Vilniaus Sausio 13-osios mokykla";SMALSUČIAI;5960204860;Taip;8;0;0;8
23922;"Vilniaus savivaldybės Grigiškių gimnazija";"Priešmokyklinio ugdymo (lenkų kalba)";9259436243;Ne;5;0;0;5
23923;"Vilniaus Viršuliškių mokykla";BITUČIŲ;3893693567;Taip;10;0;0;10
23924;Gluosnis;KIŠKUČIAI;2984134115;Taip;9;0;1;10
23925;Gluosnis;KIŠKUČIAI;6955695422;Taip;7;0;1;8
23926;Gluosnis;KIŠKUČIAI;1305651237;Taip;1;0;0;1
23927;Gluosnis;KIŠKUČIAI;4285562600;Taip;0;5;0;5
23928;Gluosnis;KIŠKUČIAI;5432102004;Taip;8;0;0;8
23929;Gluosnis;KIŠKUČIAI;8009719622;Taip;4;0;0;4
23930;Gluosnis;KIŠKUČIAI;9833971809;Taip;10;0;0;10
23931;Gluosnis;KIŠKUČIAI;6883663577;Taip;10;0;0;10
23932;Gluosnis;KIŠKUČIAI;1512855055;Taip;1;3;2;6
23933;Gluosnis;KIŠKUČIAI;8337313448;Taip;7;0;0;7
23934;Gluosnis;KIŠKUČIAI;4632419177;Taip;4;0;7;11
23935;Gluosnis;KIŠKUČIAI;6113153127;Taip;6;0;0;6
23936;Gluosnis;KIŠKUČIAI;7769522093;Taip;13;0;0;13
23937;Gluosnis;KIŠKUČIAI;8928597187;Taip;8;0;2;10
23938;Gluosnis;KIŠKUČIAI;9993638596;Taip;0;5;0;5
23939;Gluosnis;KIŠKUČIAI;6994005000;Ne;0;1;1;2
23940;Gluosnis;KIŠKUČIAI;9221983318;Taip;13;0;1;14
23941;Gluosnis;KIŠKUČIAI;2187312618;Taip;6;0;2;8
23942;Gluosnis;KIŠKUČIAI;5664156894;Taip;7;0;0;7
23943;Gluosnis;KIŠKUČIAI;7073637619;Ne;14;0;0;14
23944;Gluosnis;KIŠKUČIAI;1391404073;Taip;11;0;0;11
23945;Gluosnis;KIŠKUČIAI;4591550636;Taip;9;6;1;16
23946;Gluosnis;EŽIUKAI;4153713911;Ne;1;0;5;6
23947;Gluosnis;EŽIUKAI;4493877427;Taip;5;0;3;8
23948;Gluosnis;EŽIUKAI;5350702449;Taip;15;0;0;15
23949;Gluosnis;EŽIUKAI;8577271806;Taip;6;0;0;6
23950;Gluosnis;EŽIUKAI;6622415563;Taip;0;2;3;5
23951;Gluosnis;EŽIUKAI;3988305400;Taip;5;0;0;5
23952;Gluosnis;EŽIUKAI;9788278155;Taip;22;0;0;22
23953;Gluosnis;EŽIUKAI;7974944779;Taip;3;0;2;5
23954;Gluosnis;EŽIUKAI;7526020668;Taip;0;1;0;1
23955;Gluosnis;EŽIUKAI;5522411084;Taip;8;1;0;9
23956;Gluosnis;EŽIUKAI;5392759654;Ne;3;0;0;3
23957;Gluosnis;EŽIUKAI;6681653921;Taip;8;4;0;12
23958;Gluosnis;EŽIUKAI;4902627153;Taip;14;1;0;15
23959;Gluosnis;EŽIUKAI;2525780494;Taip;7;0;0;7
23960;Gluosnis;EŽIUKAI;9389736360;Taip;9;0;1;10
23961;Gluosnis;EŽIUKAI;2707855273;Taip;17;1;0;18
23962;Gluosnis;EŽIUKAI;7523459118;Taip;5;7;2;14
23963;Gluosnis;EŽIUKAI;2794163383;Ne;8;0;0;8
23964;Gluosnis;EŽIUKAI;7264550578;Taip;0;1;8;9
23965;Gluosnis;EŽIUKAI;5368171142;Taip;8;6;0;14
23966;Gluosnis;EŽIUKAI;6754799196;Taip;13;0;9;22
23967;Gluosnis;EŽIUKAI;9888037899;Taip;13;0;1;14
23968;Gluosnis;MEŠKIUKAI;8981904827;Taip;6;0;3;9
23969;Gluosnis;MEŠKIUKAI;8998776286;Taip;7;0;1;8
23970;Gluosnis;MEŠKIUKAI;1846499141;Taip;13;0;1;14
23971;Gluosnis;MEŠKIUKAI;7935750427;Taip;9;1;1;11
23972;Gluosnis;MEŠKIUKAI;4905002832;Taip;8;4;0;12
23973;Gluosnis;MEŠKIUKAI;9102081648;Ne;1;0;3;4
23974;Gluosnis;MEŠKIUKAI;4498429439;Taip;9;0;1;10
23975;Gluosnis;MEŠKIUKAI;8259160584;Taip;4;0;0;4
23976;Gluosnis;MEŠKIUKAI;1235091885;Taip;0;12;0;12
23977;Gluosnis;MEŠKIUKAI;1165636758;Taip;1;0;1;2
23978;Gluosnis;MEŠKIUKAI;8499748544;Taip;9;0;0;9
23979;Gluosnis;MEŠKIUKAI;2867319899;Taip;6;4;0;10
23980;Gluosnis;MEŠKIUKAI;9699577397;Taip;12;0;4;16
23981;Gluosnis;MEŠKIUKAI;4107344313;Taip;4;0;5;9
23982;Gluosnis;MEŠKIUKAI;1101472999;Taip;5;2;1;8
23983;Gluosnis;MEŠKIUKAI;7995558671;Taip;6;0;0;6
23984;Gluosnis;MEŠKIUKAI;1602556462;Taip;0;12;2;14
23985;Gluosnis;MEŠKIUKAI;6428753580;Taip;7;0;0;7
23986;Gluosnis;MEŠKIUKAI;3323237449;Taip;6;1;0;7
23987;Gluosnis;MEŠKIUKAI;3038732180;Taip;14;1;2;17
23988;Gluosnis;MEŠKIUKAI;1712795835;Taip;4;5;0;9
23989;Gluosnis;BORUŽĖLĖS;8840658383;Ne;0;1;0;1
23990;Gluosnis;BORUŽĖLĖS;1102935178;Taip;0;0;7;7
23991;Gluosnis;BORUŽĖLĖS;2167312808;Taip;10;7;0;17
23992;Gluosnis;BORUŽĖLĖS;4204797742;Taip;4;8;0;12
23993;Gluosnis;BORUŽĖLĖS;6302765948;Taip;23;0;5;28
23994;Gluosnis;BORUŽĖLĖS;9938235476;Taip;9;3;0;12
23995;Gluosnis;BORUŽĖLĖS;2945796648;Taip;7;0;1;8
23996;Gluosnis;BORUŽĖLĖS;2173191971;Taip;0;0;1;1
23997;Gluosnis;BORUŽĖLĖS;4237053702;Ne;18;0;0;18
23998;Gluosnis;BORUŽĖLĖS;6320411660;Taip;5;0;0;5
23999;Gluosnis;BORUŽĖLĖS;7731887361;Taip;14;0;7;21
24000;Gluosnis;BORUŽĖLĖS;8502947568;Taip;6;0;5;11
24001;Gluosnis;BORUŽĖLĖS;9664090375;Taip;12;0;0;12
24002;Gluosnis;BORUŽĖLĖS;1335152703;Taip;0;5;0;5
24003;Gluosnis;BORUŽĖLĖS;1314992969;Ne;3;1;9;13
24004;Gluosnis;BORUŽĖLĖS;7833136455;Taip;4;0;0;4
24005;Gluosnis;BORUŽĖLĖS;5556821953;Ne;3;0;0;3
24006;Gluosnis;BORUŽĖLĖS;2515646510;Ne;8;0;6;14
24007;Gluosnis;BORUŽĖLĖS;3212658311;Taip;13;0;2;15
24008;Gluosnis;BORUŽĖLĖS;2603201633;Taip;9;0;1;10
24009;Gluosnis;BORUŽĖLĖS;6086258054;Taip;6;4;0;10
24010;Gluosnis;BORUŽĖLĖS;1351519995;Taip;14;2;2;18
24011;Gluosnis;BORUŽĖLĖS;6960673767;Taip;18;0;0;18
24012;Gluosnis;LAPIUKAI;7025815772;Taip;0;1;3;4
24013;Gluosnis;LAPIUKAI;5266206726;Taip;20;0;0;20
24014;Gluosnis;LAPIUKAI;2968946946;Taip;0;4;0;4
24015;Gluosnis;LAPIUKAI;8976032500;Taip;0;13;2;15
24016;Gluosnis;LAPIUKAI;3190331209;Taip;27;0;0;27
24017;Gluosnis;LAPIUKAI;5376108804;Taip;13;0;0;13
24018;Gluosnis;LAPIUKAI;2258921960;Taip;5;18;2;25
24019;Gluosnis;LAPIUKAI;9386396460;Taip;21;0;0;21
24020;Gluosnis;LAPIUKAI;1664508998;Taip;14;0;4;18
24021;Gluosnis;LAPIUKAI;1296975213;Taip;16;0;1;17
24022;Gluosnis;LAPIUKAI;8227732558;Taip;15;0;0;15
24023;Gluosnis;LAPIUKAI;6518579198;Taip;0;0;4;4
24024;Gluosnis;LAPIUKAI;5633386146;Taip;12;0;0;12
24025;Gluosnis;LAPIUKAI;4146877525;Taip;8;11;2;21
24026;Gluosnis;LAPIUKAI;4616132460;Taip;0;1;0;1
24027;Gluosnis;LAPIUKAI;4280829038;Ne;0;4;0;4
24028;Gluosnis;LAPIUKAI;6273179300;Taip;8;13;1;22
24029;Gluosnis;LAPIUKAI;7090336454;Taip;0;2;0;2
24030;Gluosnis;PELĖDŽIUKAI;1933496033;Taip;2;1;0;3
24031;Gluosnis;PELĖDŽIUKAI;8259035822;Taip;7;5;0;12
24032;Gluosnis;PELĖDŽIUKAI;4960167173;Taip;2;2;2;6
24033;Gluosnis;PELĖDŽIUKAI;2181550091;Taip;4;0;0;4
24034;Gluosnis;PELĖDŽIUKAI;6163009686;Taip;13;2;0;15
24035;Gluosnis;PELĖDŽIUKAI;1671693932;Taip;2;1;0;3
24036;Gluosnis;PELĖDŽIUKAI;4005023841;Ne;3;1;7;11
24037;Gluosnis;PELĖDŽIUKAI;9497547057;Taip;0;2;1;3
24038;Gluosnis;PELĖDŽIUKAI;6865973084;Taip;14;0;0;14
24039;Gluosnis;PELĖDŽIUKAI;1298724775;Ne;3;1;0;4
24040;Gluosnis;PELĖDŽIUKAI;1185903576;Ne;4;1;3;8
24041;Gluosnis;PELĖDŽIUKAI;7537587118;Taip;4;1;4;9
24042;Gluosnis;PELĖDŽIUKAI;7075070566;Taip;3;3;0;6
24043;Gluosnis;PELĖDŽIUKAI;7761376910;Ne;3;1;2;6
24044;Gluosnis;PELĖDŽIUKAI;3434902234;Taip;3;0;0;3
24045;Gluosnis;PELĖDŽIUKAI;6944918504;Taip;2;6;0;8
24046;Gluosnis;PELĖDŽIUKAI;94487630173;Ne;0;2;1;3
24047;Gluosnis;PELĖDŽIUKAI;1076538028;Taip;2;1;0;3
24048;Gluosnis;VOVERIUKAI;6747244713;Taip;5;0;1;6
24049;Gluosnis;VOVERIUKAI;3900322680;Taip;20;0;0;20
24050;Gluosnis;VOVERIUKAI;2423433989;Taip;12;3;1;16
24051;Gluosnis;VOVERIUKAI;1263019496;Taip;19;1;0;20
24052;Gluosnis;VOVERIUKAI;4564193030;Taip;15;1;0;16
24053;Gluosnis;VOVERIUKAI;4224637208;Taip;14;0;0;14
24054;Gluosnis;VOVERIUKAI;1144177849;Taip;10;0;0;10
24055;Gluosnis;VOVERIUKAI;6729016081;Taip;15;0;1;16
24056;Gluosnis;VOVERIUKAI;4069584911;Taip;0;0;4;4
24057;Gluosnis;VOVERIUKAI;6119618742;Taip;7;0;0;7
24058;Gluosnis;VOVERIUKAI;2794080237;Taip;11;0;0;11
24059;Gluosnis;VOVERIUKAI;5623135790;Taip;13;7;0;20
24060;Gluosnis;VOVERIUKAI;2310874591;Taip;7;0;0;7
24061;Gluosnis;VOVERIUKAI;5210930032;Taip;0;0;1;1
24062;Gluosnis;VOVERIUKAI;5008836118;Taip;11;0;6;17
24063;Gluosnis;VOVERIUKAI;4361177196;Taip;20;0;0;20
24064;Gluosnis;VOVERIUKAI;9484423786;Taip;17;0;0;17
24065;Gluosnis;VOVERIUKAI;8109714321;Ne;14;0;0;14
24066;Gluosnis;DRUGELIAI;5949954525;Taip;13;0;0;13
24067;Gluosnis;DRUGELIAI;1716235604;Taip;13;1;0;14
24068;Gluosnis;DRUGELIAI;7642311375;Taip;0;5;1;6
24069;Gluosnis;DRUGELIAI;8430102757;Taip;7;0;0;7
24070;Gluosnis;DRUGELIAI;4125830926;Ne;7;4;0;11
24071;Gluosnis;DRUGELIAI;6358187113;Taip;12;0;0;12
24072;Gluosnis;DRUGELIAI;9084785666;Taip;14;2;0;16
24073;Gluosnis;DRUGELIAI;4940563623;Taip;13;0;0;13
24074;Gluosnis;DRUGELIAI;1113731535;Taip;5;3;0;8
24075;Gluosnis;DRUGELIAI;4653963373;Taip;20;0;0;20
24076;Gluosnis;DRUGELIAI;2458662117;Taip;9;0;0;9
24077;Gluosnis;DRUGELIAI;8314366921;Taip;0;0;6;6
24078;Gluosnis;DRUGELIAI;4220504133;Taip;12;0;0;12
24079;Gluosnis;DRUGELIAI;9931766935;Taip;0;13;0;13
24080;Gluosnis;DRUGELIAI;3527418865;Taip;8;1;0;9
24081;Gluosnis;DRUGELIAI;6914171069;Taip;8;0;2;10
24082;Gluosnis;DRUGELIAI;1848647593;Taip;8;5;0;13
24083;Gluosnis;DRUGELIAI;7756397778;Taip;6;0;0;6
24084;Gluosnis;DRUGELIAI;5943955268;Taip;8;0;7;15
24085;Gluosnis;DRUGELIAI;8690911930;Taip;14;3;2;19
24086;Gluosnis;DRUGELIAI;1543842220;Taip;6;0;2;8
24087;Gluosnis;DRUGELIAI;1787206205;Taip;15;1;0;16
24088;Gluosnis;DRUGELIAI;5264930854;Taip;4;4;0;8
24089;Gluosnis;BITUTĖS;4176300773;Taip;9;0;1;10
24090;Gluosnis;BITUTĖS;2554790908;Taip;10;1;0;11
24091;Gluosnis;BITUTĖS;8281499182;Taip;17;0;0;17
24092;Gluosnis;BITUTĖS;2403029153;Taip;0;1;0;1
24093;Gluosnis;BITUTĖS;6432475763;Taip;7;0;0;7
24094;Gluosnis;BITUTĖS;9542889575;Taip;9;1;0;10
24095;Gluosnis;BITUTĖS;1966484574;Taip;4;1;1;6
24096;Gluosnis;BITUTĖS;4353195155;Ne;14;2;1;17
24097;Gluosnis;BITUTĖS;5889360726;Taip;4;1;3;8
24098;Gluosnis;BITUTĖS;8035097045;Ne;23;0;0;23
24099;Gluosnis;BITUTĖS;3362089746;Taip;5;0;1;6
24100;Gluosnis;BITUTĖS;7390361159;Taip;12;1;0;13
24101;Gluosnis;BITUTĖS;8380310240;Taip;9;1;2;12
24102;Gluosnis;BITUTĖS;4481544177;Taip;0;0;3;3
24103;Gluosnis;BITUTĖS;3673702157;Taip;20;0;0;20
24104;Gluosnis;BITUTĖS;9098141563;Taip;11;3;4;18
24105;Gluosnis;BITUTĖS;9201769624;Taip;9;1;0;10
24106;Gluosnis;BITUTĖS;6767500085;Ne;9;0;1;10
24107;Gluosnis;BITUTĖS;6001358241;Taip;0;0;8;8
24108;Gluosnis;BITUTĖS;5380755693;Ne;4;1;0;5
24109;Gluosnis;BITUTĖS;6197840105;Taip;17;1;0;18
24110;Gluosnis;BITUTĖS;5204445760;Ne;11;0;0;11
24111;"Vilniaus Aleksandro Puškino mokykla";PRIEŠMOKYKLINĖ;5215180667;Taip;10;0;0;10
24112;"Vilniaus Simono Stanevičiaus progimnazija";KATINĖLIAI;4766719000;Taip;7;0;0;7
24113;"Vilniaus Saulėtekio mokykla-daugiafunkcinis centras";Priešmokyklinė;1029813471;Taip;0;1;1;2
24114;"Vilniaus Saulėtekio mokykla-daugiafunkcinis centras";Priešmokyklinė;8760467524;Taip;5;1;0;6
24115;"Vilniaus Saulėtekio mokykla-daugiafunkcinis centras";Priešmokyklinė;6738279023;Taip;9;7;0;16
24116;"Vilniaus Saulėtekio mokykla-daugiafunkcinis centras";Priešmokyklinė;1739797553;Taip;0;5;0;5
24117;"Vilniaus Saulėtekio mokykla-daugiafunkcinis centras";Priešmokyklinė;2159833613;Taip;3;4;0;7
24118;"Vilniaus Saulėtekio mokykla-daugiafunkcinis centras";Priešmokyklinė;1193336600;Taip;5;9;0;14
24119;"Vilniaus Saulėtekio mokykla-daugiafunkcinis centras";Priešmokyklinė;5914721966;Taip;8;1;2;11
24120;"Vilniaus Saulėtekio mokykla-daugiafunkcinis centras";Priešmokyklinė;8852228006;Ne;0;1;20;21
24121;"Vilniaus Saulėtekio mokykla-daugiafunkcinis centras";Priešmokyklinė;4159716896;Taip;5;1;0;6
24122;"Vilniaus Saulėtekio mokykla-daugiafunkcinis centras";Priešmokyklinė;1667714484;Taip;0;1;15;16
24123;"Vilniaus Saulėtekio mokykla-daugiafunkcinis centras";Priešmokyklinė;6589058061;Taip;5;1;3;9
24124;"Vilniaus Saulėtekio mokykla-daugiafunkcinis centras";Priešmokyklinė;3048310276;Taip;0;1;13;14
24125;"Vilniaus Saulėtekio mokykla-daugiafunkcinis centras";Priešmokyklinė;6991187086;Ne;7;1;1;9
24126;"Vilniaus Saulėtekio mokykla-daugiafunkcinis centras";Priešmokyklinė;1698381959;Taip;0;5;0;5
24127;"Vilniaus Saulėtekio mokykla-daugiafunkcinis centras";Priešmokyklinė;2500332755;Taip;0;1;0;1
24128;"Vilniaus Saulėtekio mokykla-daugiafunkcinis centras";Priešmokyklinė;2074102166;Taip;14;1;0;15
24129;"Vilniaus Saulėtekio mokykla-daugiafunkcinis centras";Priešmokyklinė;2906786855;Taip;0;1;2;3
24130;"Vilniaus Saulėtekio mokykla-daugiafunkcinis centras";Priešmokyklinė;3108520221;Ne;0;14;0;14
24131;"Vilniaus Saulėtekio mokykla-daugiafunkcinis centras";Priešmokyklinė;8815534200;Taip;0;1;5;6
24132;"Vilniaus Saulėtekio mokykla-daugiafunkcinis centras";Priešmokyklinė;4751570183;Taip;8;1;0;9
24133;"Vilniaus Saulėtekio mokykla-daugiafunkcinis centras";Priešmokyklinė;9164075226;Ne;5;8;0;13
24134;"Vilniaus Saulėtekio mokykla-daugiafunkcinis centras";Priešmokyklinė;2020364455;Taip;9;2;0;11
24135;"Vilniaus Saulėtekio mokykla-daugiafunkcinis centras";Priešmokyklinė;4787974814;Taip;0;1;8;9
24136;"Vilniaus Saulėtekio mokykla-daugiafunkcinis centras";Priešmokyklinė;6553762186;Taip;0;12;0;12
24137;"Vilniaus Saulėtekio mokykla-daugiafunkcinis centras";Priešmokyklinė;9057726203;Taip;9;4;0;13
24138;"Vilniaus Saulėtekio mokykla-daugiafunkcinis centras";Priešmokyklinė;6492909546;Taip;0;4;0;4
24139;"Vilniaus Saulėtekio mokykla-daugiafunkcinis centras";"PRIEŠMOKYKLINĖ 2";9963290362;Ne;6;1;4;11
24140;"Vilniaus Saulėtekio mokykla-daugiafunkcinis centras";"PRIEŠMOKYKLINĖ 2";1342094235;Taip;0;1;1;2
24141;"Vilniaus Saulėtekio mokykla-daugiafunkcinis centras";"PRIEŠMOKYKLINĖ 2";2628936055;Taip;0;5;0;5
24142;"Vilniaus Saulėtekio mokykla-daugiafunkcinis centras";"PRIEŠMOKYKLINĖ 2";1224648193;Taip;5;1;2;8
24143;"Vilniaus Saulėtekio mokykla-daugiafunkcinis centras";"PRIEŠMOKYKLINĖ 2";4542122478;Taip;22;1;1;24
24144;"Vilniaus Saulėtekio mokykla-daugiafunkcinis centras";"PRIEŠMOKYKLINĖ 2";4010917080;Taip;11;1;4;16
24145;"Vilniaus Saulėtekio mokykla-daugiafunkcinis centras";"PRIEŠMOKYKLINĖ 2";5927071864;Taip;10;1;1;12
24146;"Vilniaus Saulėtekio mokykla-daugiafunkcinis centras";"PRIEŠMOKYKLINĖ 2";4970499391;Ne;0;1;4;5
24147;"Vilniaus Saulėtekio mokykla-daugiafunkcinis centras";"PRIEŠMOKYKLINĖ 2";6593824471;Ne;21;1;3;25
24148;"Vilniaus Saulėtekio mokykla-daugiafunkcinis centras";"PRIEŠMOKYKLINĖ 2";8669346247;Taip;0;1;6;7
24149;"Vilniaus Saulėtekio mokykla-daugiafunkcinis centras";"PRIEŠMOKYKLINĖ 2";1924079984;Taip;2;1;1;4
24150;"Vilniaus Saulėtekio mokykla-daugiafunkcinis centras";"PRIEŠMOKYKLINĖ 2";5590376570;Ne;2;1;6;9
24151;"Vilniaus Saulėtekio mokykla-daugiafunkcinis centras";"PRIEŠMOKYKLINĖ 2";8766410254;Taip;12;1;0;13
24152;"Vilniaus Saulėtekio mokykla-daugiafunkcinis centras";"PRIEŠMOKYKLINĖ 2";4151582358;Taip;10;1;1;12
24153;"Vilniaus Saulėtekio mokykla-daugiafunkcinis centras";"PRIEŠMOKYKLINĖ 2";1376656872;Taip;12;1;8;21
24154;"Vilniaus Saulėtekio mokykla-daugiafunkcinis centras";"PRIEŠMOKYKLINĖ 2";3639632543;Taip;9;6;0;15
24155;"Vilniaus Saulėtekio mokykla-daugiafunkcinis centras";"PRIEŠMOKYKLINĖ 2";6865962441;Taip;9;7;0;16
24156;"Vilniaus Saulėtekio mokykla-daugiafunkcinis centras";"PRIEŠMOKYKLINĖ 2";3982877012;Taip;18;1;3;22
24157;"Vilniaus Saulėtekio mokykla-daugiafunkcinis centras";"PRIEŠMOKYKLINĖ 2";1660650556;Taip;19;6;0;25
24158;"Vilniaus Saulėtekio mokykla-daugiafunkcinis centras";"PRIEŠMOKYKLINĖ 2";4890393582;Taip;14;1;6;21
24159;"Vilniaus Saulėtekio mokykla-daugiafunkcinis centras";"PRIEŠMOKYKLINĖ 2";5304096806;Taip;10;1;2;13
24160;"Vilniaus Saulėtekio mokykla-daugiafunkcinis centras";"PRIEŠMOKYKLINĖ 2";1648983304;Taip;0;1;3;4
24161;"Vilniaus Saulėtekio mokykla-daugiafunkcinis centras";"PRIEŠMOKYKLINĖ 2";1913663230;Taip;14;1;0;15
24162;"Vilniaus Saulėtekio mokykla-daugiafunkcinis centras";"PRIEŠMOKYKLINĖ 2";1543123485;Taip;9;1;3;13
24163;"Vilniaus Saulėtekio mokykla-daugiafunkcinis centras";"PRIEŠMOKYKLINĖ 2";4176208765;Taip;0;11;0;11
24164;"Vilniaus Saulėtekio mokykla-daugiafunkcinis centras";"PRIEŠMOKYKLINĖ 2";8458361084;Taip;28;0;0;28
24165;"Vilniaus Martyno Mažvydo progimnazija";PRIEŠMOKYKLINĖ;1409464952;Taip;5;0;0;5
24166;Žolynas;Dobiliukai;3278086723;Taip;3;0;0;3
24167;Žolynas;Žemuogėlės;2434270419;Taip;10;0;0;10
24168;Žolynas;Žemuogėlės;2896775639;Taip;1;0;0;1
24169;Žolynas;Žemuogėlės;3094296949;Taip;1;0;0;1
24170;Žolynas;Ramunėlės;8891438678;Taip;13;0;0;13
24171;Žolynas;Ramunėlės;9186222508;Taip;7;0;0;7
24172;Žolynas;Šlamučiai;9730317666;Taip;8;0;0;8
24173;Žolynas;Šlamučiai;8153606853;Taip;1;0;0;1
24174;Žolynas;Aguonėles;5651628204;Ne;11;0;0;11
24175;Žolynas;Aguonėles;7723064420;Taip;11;0;0;11
24176;Žolynas;Rugiagėlės;3249208907;Taip;4;0;0;4
24177;Žolynas;Čiobreliai;7870236961;Taip;5;0;0;5
24178;"Vilniaus „Genio“ progimnazija";NYKŠTUKAI;6545116373;Taip;5;6;0;11
24179;"Vilniaus „Genio“ progimnazija";NYKŠTUKAI;1666616466;Taip;0;7;0;7
24180;"Vilniaus „Genio“ progimnazija";NYKŠTUKAI;3008272979;Taip;7;12;0;19
24181;"Vilniaus „Genio“ progimnazija";NYKŠTUKAI;96416364735;Taip;2;6;0;8
24182;"Vilniaus „Genio“ progimnazija";NYKŠTUKAI;2036966277;Taip;0;6;0;6
24183;"Vilniaus „Genio“ progimnazija";NYKŠTUKAI;1807466584;Taip;4;11;0;15
24184;"Vilniaus „Genio“ progimnazija";NYKŠTUKAI;4680264973;Taip;0;8;0;8
24185;"Vilniaus „Genio“ progimnazija";NYKŠTUKAI;5850506831;Taip;0;16;0;16
24186;"Vilniaus „Genio“ progimnazija";NYKŠTUKAI;3667800006;Taip;0;6;0;6
24187;"Vilniaus „Genio“ progimnazija";NYKŠTUKAI;2176438968;Taip;0;7;0;7
24188;"Vilniaus „Genio“ progimnazija";NYKŠTUKAI;7509276953;Taip;0;6;0;6
24189;"Vilniaus „Genio“ progimnazija";NYKŠTUKAI;1258769646;Taip;0;8;0;8
24190;"Vilniaus „Genio“ progimnazija";NYKŠTUKAI;2593226897;Ne;4;12;0;16
24191;"Vilniaus „Genio“ progimnazija";NYKŠTUKAI;7005815238;Ne;7;6;0;13
24192;"Vilniaus „Genio“ progimnazija";NYKŠTUKAI;3333552585;Taip;0;6;0;6
24193;"Vilniaus „Genio“ progimnazija";NYKŠTUKAI;5372809413;Taip;0;13;0;13
24194;"Vilniaus „Genio“ progimnazija";NYKŠTUKAI;1089753966;Taip;0;6;0;6
24195;"Vilniaus „Genio“ progimnazija";NYKŠTUKAI;6154837614;Taip;5;13;0;18
24196;"Vilniaus „Genio“ progimnazija";NYKŠTUKAI;2865995680;Taip;13;8;0;21
24197;"Vilniaus „Genio“ progimnazija";NYKŠTUKAI;1432694920;Taip;8;7;0;15
24198;"Vilniaus „Genio“ progimnazija";NYKŠTUKAI;1663216529;Taip;0;11;0;11
24199;"Gintarėlis (Popieriaus g. 46A)";SKRUZDĖLIUKAI;6162836315;Taip;7;0;0;7
24200;"Gintarėlis (Popieriaus g. 46A)";SKRUZDĖLIUKAI;5738933125;Taip;0;11;0;11
24201;"Gintarėlis (Popieriaus g. 46A)";SKRUZDĖLIUKAI;1994856959;Taip;0;3;0;3
24202;"Gintarėlis (Popieriaus g. 46A)";SKRUZDĖLIUKAI;8223747534;Taip;11;1;0;12
24203;"Gintarėlis (Popieriaus g. 46A)";SKRUZDĖLIUKAI;1045355492;Taip;1;3;6;10
24204;"Gintarėlis (Popieriaus g. 46A)";SKRUZDĖLIUKAI;6193540660;Ne;16;2;0;18
24205;"Gintarėlis (Popieriaus g. 46A)";SKRUZDĖLIUKAI;3459439843;Taip;4;3;0;7
24206;"Gintarėlis (Popieriaus g. 46A)";SKRUZDĖLIUKAI;7916257692;Taip;8;0;0;8
24207;"Gintarėlis (Popieriaus g. 46A)";SKRUZDĖLIUKAI;7510541192;Taip;10;2;0;12
24208;"Gintarėlis (Popieriaus g. 46A)";SKRUZDĖLIUKAI;9045108717;Taip;0;17;0;17
24209;"Gintarėlis (Popieriaus g. 46A)";SKRUZDĖLIUKAI;1955719034;Taip;4;3;3;10
24210;"Gintarėlis (Popieriaus g. 46A)";SKRUZDĖLIUKAI;1215549844;Taip;4;2;1;7
24211;"Gintarėlis (Popieriaus g. 46A)";SKRUZDĖLIUKAI;5379858630;Taip;0;0;11;11
24212;"Gintarėlis (Popieriaus g. 46A)";SKRUZDĖLIUKAI;5961603860;Taip;8;6;0;14
24213;"Gintarėlis (Popieriaus g. 46A)";SKRUZDĖLIUKAI;8068499156;Taip;0;4;0;4
24214;"Gintarėlis (Popieriaus g. 46A)";SKRUZDĖLIUKAI;5190355636;Taip;6;0;0;6
24215;"Gintarėlis (Popieriaus g. 46A)";SKRUZDĖLIUKAI;4290033336;Taip;5;2;0;7
24216;"Gintarėlis (Popieriaus g. 46A)";PELĖDŽIUKAI;6506180216;Ne;4;4;0;8
24217;"Gintarėlis (Popieriaus g. 46A)";PELĖDŽIUKAI;9200073539;Taip;18;1;0;19
24218;"Gintarėlis (Popieriaus g. 46A)";PELĖDŽIUKAI;3254739432;Taip;0;0;3;3
24219;"Gintarėlis (Popieriaus g. 46A)";PELĖDŽIUKAI;8019543081;Taip;0;5;0;5
24220;"Gintarėlis (Popieriaus g. 46A)";PELĖDŽIUKAI;1628276472;Ne;0;2;0;2
24221;"Gintarėlis (Popieriaus g. 46A)";PELĖDŽIUKAI;5223116373;Taip;19;1;0;20
24222;"Gintarėlis (Popieriaus g. 46A)";PELĖDŽIUKAI;8792175474;Ne;12;2;0;14
24223;"Gintarėlis (Popieriaus g. 46A)";PELĖDŽIUKAI;3304191482;Taip;10;5;0;15
24224;"Gintarėlis (Popieriaus g. 46A)";PELĖDŽIUKAI;2731865977;Taip;0;2;0;2
24225;"Gintarėlis (Popieriaus g. 46A)";PELĖDŽIUKAI;4181430769;Taip;0;9;0;9
24226;"Gintarėlis (Popieriaus g. 46A)";PELĖDŽIUKAI;3202819190;Taip;16;0;2;18
24227;"Gintarėlis (Popieriaus g. 46A)";PELĖDŽIUKAI;9807784148;Ne;11;0;6;17
24228;"Gintarėlis (Popieriaus g. 46A)";PELĖDŽIUKAI;2546360134;Taip;8;1;0;9
24229;"Gintarėlis (Popieriaus g. 46A)";PELĖDŽIUKAI;2308673417;Taip;5;1;0;6
24230;"Gintarėlis (Popieriaus g. 46A)";PELĖDŽIUKAI;6883573289;Taip;3;0;16;19
24231;"Gintarėlis (Popieriaus g. 46A)";PELĖDŽIUKAI;3127881266;Ne;16;0;2;18
24232;"Gintarėlis (Popieriaus g. 46A)";PELĖDŽIUKAI;2052962147;Taip;8;0;7;15
24233;"Gintarėlis (Popieriaus g. 46A)";"LINKSMASIS AVILYS";7872515649;Taip;11;3;2;16
24234;"Gintarėlis (Popieriaus g. 46A)";"LINKSMASIS AVILYS";7256557310;Taip;0;5;0;5
24235;"Gintarėlis (Popieriaus g. 46A)";"LINKSMASIS AVILYS";6425840559;Taip;6;0;11;17
24236;"Gintarėlis (Popieriaus g. 46A)";"LINKSMASIS AVILYS";3572188688;Taip;10;0;2;12
24237;"Gintarėlis (Popieriaus g. 46A)";"LINKSMASIS AVILYS";7010430969;Taip;0;8;2;10
24238;"Gintarėlis (Popieriaus g. 46A)";"LINKSMASIS AVILYS";7734802846;Taip;0;3;0;3
24239;"Gintarėlis (Popieriaus g. 46A)";"LINKSMASIS AVILYS";1070119148;Taip;0;9;0;9
24240;"Gintarėlis (Popieriaus g. 46A)";"LINKSMASIS AVILYS";9182625265;Taip;8;1;0;9
24241;"Gintarėlis (Popieriaus g. 46A)";"LINKSMASIS AVILYS";3738678648;Taip;7;5;0;12
24242;"Gintarėlis (Popieriaus g. 46A)";"LINKSMASIS AVILYS";77906464117;Taip;0;1;0;1
24243;"Gintarėlis (Popieriaus g. 46A)";"LINKSMASIS AVILYS";2737144359;Taip;8;1;0;9
24244;"Gintarėlis (Popieriaus g. 46A)";"LINKSMASIS AVILYS";8680339493;Ne;0;6;0;6
24245;"Gintarėlis (Popieriaus g. 46A)";Varliukai;6821929306;Taip;6;10;0;16
24246;"Gintarėlis (Popieriaus g. 46A)";Varliukai;7274616480;Taip;4;8;0;12
24247;"Gintarėlis (Popieriaus g. 46A)";Varliukai;1362980885;Taip;0;20;0;20
24248;"Gintarėlis (Popieriaus g. 46A)";Varliukai;9762364250;Taip;0;14;0;14
24249;"Gintarėlis (Popieriaus g. 46A)";Varliukai;6849227110;Taip;6;0;0;6
24250;"Gintarėlis (Popieriaus g. 46A)";Varliukai;4263315669;Taip;15;0;0;15
24251;"Gintarėlis (Popieriaus g. 46A)";Varliukai;7206593645;Ne;0;0;20;20
24252;"Gintarėlis (Popieriaus g. 46A)";Varliukai;7400455090;Taip;0;13;0;13
24253;"Gintarėlis (Popieriaus g. 46A)";Varliukai;3702588434;Taip;19;0;0;19
24254;"Gintarėlis (Popieriaus g. 46A)";Varliukai;7413074674;Ne;13;1;0;14
24255;"Gintarėlis (Popieriaus g. 46A)";Varliukai;7031945895;Taip;10;5;0;15
24256;"Gintarėlis (Popieriaus g. 46A)";Varliukai;6514247750;Taip;12;5;0;17
24257;"Gintarėlis (Popieriaus g. 46A)";Varliukai;1166720069;Taip;9;0;0;9
24258;"Gintarėlis (Popieriaus g. 46A)";Varliukai;4556644354;Taip;1;8;0;9
24259;"Gintarėlis (Popieriaus g. 46A)";Varliukai;7510641510;Taip;12;0;0;12
24260;"Gintarėlis (Popieriaus g. 46A)";Varliukai;5478441530;Taip;4;0;0;4
24261;"Pušynėlis (A. Mickevičiaus g. 21)";DAIGIUKAI;5317547220;Taip;13;0;1;14
24262;"Pušynėlis (A. Mickevičiaus g. 21)";DAIGIUKAI;9025539389;Taip;22;0;0;22
24263;"Pušynėlis (A. Mickevičiaus g. 21)";DAIGIUKAI;5512586591;Taip;22;0;0;22
24264;"Pušynėlis (A. Mickevičiaus g. 21)";DAIGIUKAI;6594473055;Taip;15;1;0;16
24265;"Pušynėlis (A. Mickevičiaus g. 21)";DAIGIUKAI;8211464695;Taip;3;0;0;3
24266;"Pušynėlis (A. Mickevičiaus g. 21)";DAIGIUKAI;6321178561;Taip;13;0;0;13
24267;"Pušynėlis (A. Mickevičiaus g. 21)";DAIGIUKAI;6606436348;Taip;18;0;0;18
24268;"Pušynėlis (A. Mickevičiaus g. 21)";DAIGIUKAI;8457384507;Ne;0;0;9;9
24269;"Pušynėlis (A. Mickevičiaus g. 21)";DAIGIUKAI;1085678424;Taip;22;0;0;22
24270;"Pušynėlis (A. Mickevičiaus g. 21)";DAIGIUKAI;9710499937;Taip;0;18;0;18
24271;"Pušynėlis (A. Mickevičiaus g. 21)";DAIGIUKAI;4685125111;Ne;2;0;0;2
24272;"Pušynėlis (A. Mickevičiaus g. 21)";DAIGIUKAI;9717473430;Taip;8;3;0;11
24273;"Pušynėlis (A. Mickevičiaus g. 21)";DAIGIUKAI;2763762463;Taip;0;6;0;6
24274;"Pušynėlis (A. Mickevičiaus g. 21)";NYKŠTUKAI;1050710006;Ne;18;0;0;18
24275;"Pušynėlis (A. Mickevičiaus g. 21)";NYKŠTUKAI;1758632291;Ne;9;0;0;9
24276;"Pušynėlis (A. Mickevičiaus g. 21)";NYKŠTUKAI;8699085292;Taip;11;6;0;17
24277;"Pušynėlis (A. Mickevičiaus g. 21)";NYKŠTUKAI;8327830781;Taip;8;0;5;13
24278;"Pušynėlis (A. Mickevičiaus g. 21)";NYKŠTUKAI;8820865805;Taip;0;22;0;22
24279;"Pušynėlis (A. Mickevičiaus g. 21)";NYKŠTUKAI;9520423020;Taip;15;4;2;21
24280;"Pušynėlis (A. Mickevičiaus g. 21)";NYKŠTUKAI;1177938753;Taip;5;2;5;12
24281;"Pušynėlis (A. Mickevičiaus g. 21)";NYKŠTUKAI;9450347140;Taip;10;1;0;11
24282;"Pušynėlis (A. Mickevičiaus g. 21)";NYKŠTUKAI;2222790161;Taip;0;4;0;4
24283;"Pušynėlis (A. Mickevičiaus g. 21)";NYKŠTUKAI;7596876368;Taip;16;0;0;16
24284;"Pušynėlis (A. Mickevičiaus g. 21)";NYKŠTUKAI;2892213973;Taip;0;3;2;5
24285;"Pušynėlis (A. Mickevičiaus g. 21)";NYKŠTUKAI;7429853563;Ne;9;7;0;16
24286;"Pušynėlis (A. Mickevičiaus g. 21)";NYKŠTUKAI;8464672994;Taip;0;0;10;10
24287;"Pušynėlis (A. Mickevičiaus g. 21)";NYKŠTUKAI;1904434730;Taip;11;0;0;11
24288;"Pušynėlis (A. Mickevičiaus g. 21)";NYKŠTUKAI;3574446664;Ne;6;1;5;12
24289;"Pušynėlis (A. Mickevičiaus g. 21)";NYKŠTUKAI;3362971538;Taip;5;2;0;7
24290;"Pušynėlis (A. Mickevičiaus g. 21)";NYKŠTUKAI;9055713601;Taip;0;0;1;1
24291;"Pušynėlis (A. Mickevičiaus g. 21)";NYKŠTUKAI;5364537212;Taip;16;1;0;17
24292;"Pušynėlis (A. Mickevičiaus g. 21)";NYKŠTUKAI;7172604103;Taip;5;0;2;7
24293;"Pušynėlis (A. Mickevičiaus g. 21)";NYKŠTUKAI;8839614928;Taip;0;4;3;7
24294;"Pušynėlis (A. Mickevičiaus g. 21)";GILIUKAI;9401101407;Taip;0;8;0;8
24295;"Pušynėlis (A. Mickevičiaus g. 21)";GILIUKAI;4997004998;Ne;0;3;0;3
24296;"Pušynėlis (A. Mickevičiaus g. 21)";GILIUKAI;9517319856;Taip;0;1;0;1
24297;"Pušynėlis (A. Mickevičiaus g. 21)";GILIUKAI;9028515427;Taip;7;3;0;10
24298;"Pušynėlis (A. Mickevičiaus g. 21)";GILIUKAI;2825756894;Ne;22;0;0;22
24299;"Pušynėlis (A. Mickevičiaus g. 21)";GILIUKAI;1134325833;Taip;0;5;0;5
24300;"Pušynėlis (A. Mickevičiaus g. 21)";GILIUKAI;3158789663;Ne;0;1;0;1
24301;"Pušynėlis (A. Mickevičiaus g. 21)";GILIUKAI;5668765825;Taip;14;4;0;18
24302;"Pušynėlis (A. Mickevičiaus g. 21)";GILIUKAI;7685809238;Taip;0;4;0;4
24303;"Pušynėlis (A. Mickevičiaus g. 21)";GILIUKAI;2712755125;Taip;0;9;0;9
24304;"Pušynėlis (A. Mickevičiaus g. 21)";GILIUKAI;7011836009;Taip;4;5;0;9
24305;"Pušynėlis (A. Mickevičiaus g. 21)";GILIUKAI;3301741162;Taip;7;1;0;8
24306;"Pušynėlis (A. Mickevičiaus g. 21)";GILIUKAI;6735037523;Taip;8;4;1;13
24307;"Pušynėlis (A. Mickevičiaus g. 21)";GILIUKAI;9147558926;Ne;0;4;1;5
24308;"Pušynėlis (A. Mickevičiaus g. 21)";GILIUKAI;1612049897;Ne;0;3;0;3
24309;"Pušynėlis (A. Mickevičiaus g. 21)";GILIUKAI;4898147530;Taip;3;1;0;4
24310;"Pušynėlis (A. Mickevičiaus g. 21)";GILIUKAI;2228682366;Ne;0;14;0;14
24311;"Pušynėlis (A. Mickevičiaus g. 21)";GILIUKAI;4464615995;Taip;0;5;0;5
24312;"Naminukas (Klinikų g. 5)";VARPELIAI;2089455192;Taip;2;1;0;3
24313;"Naminukas (Klinikų g. 5)";VARPELIAI;3281707263;Ne;10;0;0;10
24314;"Naminukas (Klinikų g. 5)";VARPELIAI;1828220049;Taip;10;0;1;11
24315;"Naminukas (Klinikų g. 5)";VARPELIAI;7328682222;Taip;22;0;0;22
24316;"Naminukas (Klinikų g. 5)";VARPELIAI;7772300667;Taip;21;0;0;21
24317;"Naminukas (Klinikų g. 5)";VARPELIAI;1086919259;Taip;22;0;0;22
24318;"Naminukas (Klinikų g. 5)";VARPELIAI;3497829075;Taip;0;6;0;6
24319;"Naminukas (Klinikų g. 5)";VARPELIAI;5991261279;Taip;9;0;0;9
24320;"Naminukas (Klinikų g. 5)";VARPELIAI;2576516583;Taip;0;2;8;10
24321;"Naminukas (Klinikų g. 5)";VARPELIAI;8694425584;Taip;6;0;7;13
24322;"Naminukas (Klinikų g. 5)";VARPELIAI;8782832803;Taip;6;5;0;11
24323;"Naminukas (Klinikų g. 5)";VARPELIAI;5172385044;Taip;13;0;2;15
24324;"Naminukas (Klinikų g. 5)";VARPELIAI;5465843371;Taip;15;1;0;16
24325;"Naminukas (Klinikų g. 5)";VARPELIAI;6515021073;Taip;0;0;15;15
24326;"Naminukas (Klinikų g. 5)";VARPELIAI;9894306360;Taip;16;0;0;16
24327;"Naminukas (Klinikų g. 5)";SAULUTĖS;9212800864;Ne;7;3;0;10
24328;"Naminukas (Klinikų g. 5)";SAULUTĖS;9215327479;Taip;22;0;0;22
24329;"Naminukas (Klinikų g. 5)";SAULUTĖS;8595804874;Taip;0;0;1;1
24330;"Naminukas (Klinikų g. 5)";SAULUTĖS;7947598191;Taip;7;0;1;8
24331;"Naminukas (Klinikų g. 5)";SAULUTĖS;1635395128;Taip;0;0;3;3
24332;"Naminukas (Klinikų g. 5)";SAULUTĖS;3911352454;Taip;13;0;0;13
24333;"Naminukas (Klinikų g. 5)";SAULUTĖS;7107337857;Taip;14;1;0;15
24334;"Naminukas (Klinikų g. 5)";SAULUTĖS;3079900548;Taip;0;0;22;22
24335;"Naminukas (Klinikų g. 5)";SAULUTĖS;7301768930;Ne;0;0;6;6
24336;"Naminukas (Klinikų g. 5)";SAULUTĖS;2516513740;Taip;0;1;0;1
24337;"Naminukas (Klinikų g. 5)";SAULUTĖS;1879925655;Taip;3;1;1;5
24338;"Naminukas (Klinikų g. 5)";SAULUTĖS;2881576194;Ne;0;0;7;7
24339;"Naminukas (Klinikų g. 5)";SAULUTĖS;4836599508;Taip;9;0;3;12
24340;"Naminukas (Klinikų g. 5)";SAULUTĖS;1563213488;Taip;0;0;3;3
24341;"Naminukas (Klinikų g. 5)";SAULUTĖS;4709625816;Ne;5;1;0;6
24342;"Naminukas (Klinikų g. 5)";SAULUTĖS;6471277755;Taip;0;0;1;1
24343;"Naminukas (Klinikų g. 5)";SAULUTĖS;1932169696;Taip;16;0;0;16
24344;"Naminukas (Klinikų g. 5)";DRUGELIAI;2339599448;Taip;4;5;0;9
24345;"Naminukas (Klinikų g. 5)";DRUGELIAI;4077985773;Taip;9;1;0;10
24346;"Naminukas (Klinikų g. 5)";DRUGELIAI;3276656641;Taip;0;0;7;7
24347;"Naminukas (Klinikų g. 5)";DRUGELIAI;6633031473;Taip;0;0;1;1
24348;"Naminukas (Klinikų g. 5)";DRUGELIAI;4116151797;Taip;7;0;0;7
24349;"Naminukas (Klinikų g. 5)";DRUGELIAI;7033053271;Taip;4;3;1;8
24350;"Naminukas (Klinikų g. 5)";DRUGELIAI;1454039572;Ne;7;0;1;8
24351;"Naminukas (Klinikų g. 5)";DRUGELIAI;9740815635;Taip;7;0;0;7
24352;"Naminukas (Klinikų g. 5)";DRUGELIAI;7184471307;Taip;6;1;0;7
24353;"Naminukas (Klinikų g. 5)";DRUGELIAI;6949857110;Taip;5;0;2;7
24354;"Naminukas (Klinikų g. 5)";DRUGELIAI;8039086094;Taip;0;0;9;9
24355;"Naminukas (Klinikų g. 5)";DRUGELIAI;8432194383;Taip;8;7;0;15
24356;"Naminukas (Klinikų g. 5)";DRUGELIAI;7463647806;Taip;9;0;1;10
24357;"Naminukas (Klinikų g. 5)";DRUGELIAI;4171789569;Taip;0;5;0;5
24358;"Naminukas (Klinikų g. 5)";DRUGELIAI;6880075874;Taip;4;3;0;7
24359;"Naminukas (Klinikų g. 5)";DRUGELIAI;8793327541;Taip;0;1;0;1
24360;"Naminukas (Klinikų g. 5)";DRUGELIAI;9835701381;Ne;5;3;0;8
24361;"Naminukas (Klinikų g. 5)";DRUGELIAI;2004615252;Taip;4;0;0;4
24362;"Naminukas (Klinikų g. 5)";BITUTĖS;21152690883;Taip;3;3;0;6
24363;"Naminukas (Klinikų g. 5)";BITUTĖS;1679106754;Taip;0;2;0;2
24364;"Naminukas (Klinikų g. 5)";BITUTĖS;1528496272;Taip;9;3;0;12
24365;"Naminukas (Klinikų g. 5)";BITUTĖS;92417802345;Taip;4;3;0;7
24366;"Naminukas (Klinikų g. 5)";BITUTĖS;1180176295;Taip;0;2;0;2
24367;"Naminukas (Klinikų g. 5)";BITUTĖS;6592057292;Taip;18;0;0;18
24368;"Naminukas (Klinikų g. 5)";BITUTĖS;5578151523;Taip;3;0;1;4
24369;"Naminukas (Klinikų g. 5)";BITUTĖS;9244494109;Taip;3;0;0;3
24370;"Naminukas (Klinikų g. 5)";BITUTĖS;8923393066;Taip;7;0;0;7
24371;"Naminukas (Klinikų g. 5)";BITUTĖS;9178907705;Taip;3;0;2;5
24372;"Naminukas (Klinikų g. 5)";BITUTĖS;5288557629;Taip;13;4;0;17
24373;"Naminukas (Klinikų g. 5)";BITUTĖS;5233044803;Ne;0;0;1;1
24374;"Naminukas (Klinikų g. 5)";BITUTĖS;1346035733;Ne;0;2;0;2
24375;"Naminukas (Klinikų g. 5)";BITUTĖS;3791118736;Taip;3;0;0;3
24376;"Naminukas (Klinikų g. 5)";BITUTĖS;1394918021;Taip;2;0;0;2
24377;"Naminukas (Klinikų g. 5)";BITUTĖS;7099787230;Taip;1;0;0;1
24378;"Naminukas (Klinikų g. 5)";BITUTĖS;3088386659;Taip;5;0;0;5
24379;"Gervelė (Stadiono g. 5)";BORUŽĖLĖS;6427072260;Taip;7;3;1;11
24380;"Gervelė (Stadiono g. 5)";BORUŽĖLĖS;9777308731;Taip;5;0;0;5
24381;"Gervelė (Stadiono g. 5)";BORUŽĖLĖS;5285868851;Taip;6;0;1;7
24382;"Gervelė (Stadiono g. 5)";BORUŽĖLĖS;2712133300;Taip;7;7;0;14
24383;"Gervelė (Stadiono g. 5)";BORUŽĖLĖS;2622183564;Ne;0;13;0;13
24384;"Gervelė (Stadiono g. 5)";BORUŽĖLĖS;1006720360;Taip;22;0;0;22
24385;"Gervelė (Stadiono g. 5)";BORUŽĖLĖS;8190190100;Taip;22;0;0;22
24386;"Gervelė (Stadiono g. 5)";BORUŽĖLĖS;6338612770;Ne;16;0;0;16
24387;"Gervelė (Stadiono g. 5)";BORUŽĖLĖS;6004269553;Taip;16;0;0;16
24388;"Gervelė (Stadiono g. 5)";BORUŽĖLĖS;2770635568;Taip;12;0;0;12
24389;"Gervelė (Stadiono g. 5)";BORUŽĖLĖS;6573919007;Ne;18;0;0;18
24390;"Gervelė (Stadiono g. 5)";BORUŽĖLĖS;8797608822;Ne;10;3;0;13
24391;"Gervelė (Stadiono g. 5)";PAUKŠTELIAI;7959839478;Ne;6;0;0;6
24392;"Gervelė (Stadiono g. 5)";PAUKŠTELIAI;2031118410;Taip;0;9;0;9
24393;"Gervelė (Stadiono g. 5)";PAUKŠTELIAI;5966215998;Ne;12;0;0;12
24394;"Gervelė (Stadiono g. 5)";PAUKŠTELIAI;7463376031;Taip;3;18;0;21
24395;"Gervelė (Stadiono g. 5)";PAUKŠTELIAI;1751440418;Taip;9;0;0;9
24396;"Gervelė (Stadiono g. 5)";PAUKŠTELIAI;3567687304;Taip;6;3;0;9
24397;"Gervelė (Stadiono g. 5)";PAUKŠTELIAI;6372245141;Taip;11;2;0;13
24398;"Gervelė (Stadiono g. 5)";PAUKŠTELIAI;2892214705;Taip;4;0;1;5
24399;"Gervelė (Stadiono g. 5)";PAUKŠTELIAI;7952102572;Taip;22;0;0;22
24400;"Gervelė (Stadiono g. 5)";PAUKŠTELIAI;2372820133;Taip;11;0;0;11
24401;"Gervelė (Stadiono g. 5)";PAUKŠTELIAI;9154032804;Ne;0;14;0;14
24402;"Gervelė (Stadiono g. 5)";PAUKŠTELIAI;7843800194;Taip;3;0;0;3
24403;"Gervelė (Stadiono g. 5)";PAUKŠTELIAI;3676856569;Taip;9;2;0;11
24404;"Gervelė (Stadiono g. 5)";PAUKŠTELIAI;4588890423;Taip;9;7;0;16
24405;"Gervelė (Stadiono g. 5)";PAUKŠTELIAI;6822089289;Taip;0;0;2;2
24406;"Gervelė (Stadiono g. 5)";SPINDULĖLIAI;4508176017;Taip;0;5;1;6
24407;"Gervelė (Stadiono g. 5)";SPINDULĖLIAI;4051246539;Ne;6;0;0;6
24408;"Gervelė (Stadiono g. 5)";SPINDULĖLIAI;1020095914;Taip;0;0;9;9
24409;"Gervelė (Stadiono g. 5)";SPINDULĖLIAI;3306549764;Taip;7;0;0;7
24410;"Gervelė (Stadiono g. 5)";SPINDULĖLIAI;5705915729;Taip;3;0;1;4
24411;"Gervelė (Stadiono g. 5)";SPINDULĖLIAI;2207041148;Taip;0;0;14;14
24412;"Gervelė (Stadiono g. 5)";SPINDULĖLIAI;1204513844;Taip;0;0;3;3
24413;"Gervelė (Stadiono g. 5)";SPINDULĖLIAI;7419432731;Taip;4;0;3;7
24414;"Gervelė (Stadiono g. 5)";SPINDULĖLIAI;1611114179;Taip;5;0;1;6
24415;"Gervelė (Stadiono g. 5)";SPINDULĖLIAI;8710469480;Taip;8;4;1;13
24416;"Gervelė (Stadiono g. 5)";GĖLYTĖS;6172016747;Taip;0;5;0;5
24417;"Gervelė (Stadiono g. 5)";GĖLYTĖS;3873345138;Ne;22;0;0;22
24418;"Gervelė (Stadiono g. 5)";GĖLYTĖS;5518309115;Taip;16;1;0;17
24419;"Gervelė (Stadiono g. 5)";GĖLYTĖS;2744433344;Taip;22;0;0;22
24420;"Gervelė (Stadiono g. 5)";GĖLYTĖS;4930308435;Taip;0;3;0;3
24421;"Gervelė (Stadiono g. 5)";GĖLYTĖS;6621769160;Taip;7;1;0;8
24422;"Gervelė (Stadiono g. 5)";GĖLYTĖS;7115198351;Taip;5;0;0;5
24423;"Gervelė (Stadiono g. 5)";GĖLYTĖS;4505873061;Ne;6;1;0;7
24424;"Gervelė (Stadiono g. 5)";GĖLYTĖS;9291855374;Taip;0;5;0;5
24425;"Gervelė (Stadiono g. 5)";GĖLYTĖS;4832348492;Taip;0;3;0;3
24426;"Gervelė (Stadiono g. 5)";GĖLYTĖS;7855598075;Taip;12;4;0;16
24427;"Gervelė (Stadiono g. 5)";GĖLYTĖS;8777858708;Ne;0;17;0;17
24428;"Gervelė (Stadiono g. 5)";GĖLYTĖS;6488139414;Taip;2;0;0;2
24429;"Gervelė (Stadiono g. 5)";GĖLYTĖS;3216423543;Ne;9;1;0;10
24430;"Gervelė (Stadiono g. 5)";GĖLYTĖS;4925983616;Taip;2;6;0;8
24431;"Gervelė (Stadiono g. 5)";GĖLYTĖS;4895554383;Taip;0;0;1;1
24432;"Gervelė (Stadiono g. 5)";GĖLYTĖS;7387250891;Taip;15;1;0;16
24433;"Gervelė (Stadiono g. 5)";GĖLYTĖS;3490370918;Ne;0;6;0;6
24434;"Gervelė (Stadiono g. 5)";GĖLYTĖS;9183582003;Ne;0;6;0;6
24435;"Kūlverstukas (Mindaugo g. 7)";GNOMIKI;1720671485;Ne;8;0;0;8
24436;"Kūlverstukas (Mindaugo g. 7)";GNOMIKI;4894478262;Taip;10;0;0;10
24437;"Kūlverstukas (Mindaugo g. 7)";GNOMIKI;2501327054;Ne;3;9;0;12
24438;"Kūlverstukas (Mindaugo g. 7)";GNOMIKI;8348978878;Taip;8;4;0;12
24439;"Kūlverstukas (Mindaugo g. 7)";GNOMIKI;8927489885;Taip;10;7;1;18
24440;"Kūlverstukas (Mindaugo g. 7)";GNOMIKI;2709547427;Taip;0;8;0;8
24441;"Kūlverstukas (Mindaugo g. 7)";GNOMIKI;5532063862;Taip;0;12;5;17
24442;"Kūlverstukas (Mindaugo g. 7)";GNOMIKI;5747277587;Taip;6;7;2;15
24443;"Kūlverstukas (Mindaugo g. 7)";GNOMIKI;1848018684;Taip;5;5;0;10
24444;"Kūlverstukas (Mindaugo g. 7)";GNOMIKI;1166429762;Taip;20;0;0;20
24445;"Kūlverstukas (Mindaugo g. 7)";GNOMIKI;6514730230;Ne;9;5;0;14
24446;"Kūlverstukas (Mindaugo g. 7)";GNOMIKI;5298776235;Ne;0;6;0;6
24447;"Kūlverstukas (Mindaugo g. 7)";GNOMIKI;4116831802;Ne;10;0;0;10
24448;"Kūlverstukas (Mindaugo g. 7)";GNOMIKI;4677564389;Ne;8;0;0;8
24449;"Kūlverstukas (Mindaugo g. 7)";GNOMIKI;1916522637;Taip;7;9;0;16
24450;"Kūlverstukas (Mindaugo g. 7)";GNOMIKI;3239566139;Taip;9;3;0;12
24451;"Kūlverstukas (Mindaugo g. 7)";GNOMIKI;5260820316;Taip;10;0;0;10
24452;"Kūlverstukas (Mindaugo g. 7)";ZAIČIATA;8994705290;Taip;13;2;0;15
24453;"Kūlverstukas (Mindaugo g. 7)";ZAIČIATA;8496678513;Taip;8;0;0;8
24454;"Kūlverstukas (Mindaugo g. 7)";ZAIČIATA;7933156766;Ne;2;13;0;15
24455;"Kūlverstukas (Mindaugo g. 7)";ZAIČIATA;2494202134;Ne;0;5;0;5
24456;"Kūlverstukas (Mindaugo g. 7)";ZAIČIATA;2714297182;Taip;12;1;0;13
24457;"Kūlverstukas (Mindaugo g. 7)";ZAIČIATA;4998847820;Ne;5;0;3;8
24458;"Kūlverstukas (Mindaugo g. 7)";ZAIČIATA;4271185150;Ne;6;0;7;13
24459;"Kūlverstukas (Mindaugo g. 7)";ZAIČIATA;6497373567;Taip;0;1;0;1
24460;"Kūlverstukas (Mindaugo g. 7)";ZAIČIATA;3660002342;Taip;0;0;10;10
24461;"Kūlverstukas (Mindaugo g. 7)";ZAIČIATA;5079635330;Taip;5;3;0;8
24462;"Kūlverstukas (Mindaugo g. 7)";ZAIČIATA;5879283662;Taip;6;0;0;6
24463;"Kūlverstukas (Mindaugo g. 7)";ZAIČIATA;3067918179;Ne;9;1;0;10
24464;"Kūlverstukas (Mindaugo g. 7)";ZAIČIATA;1776176097;Ne;14;2;0;16
24465;"Kūlverstukas (Mindaugo g. 7)";ZAIČIATA;6685524805;Ne;0;11;0;11
24466;"Kūlverstukas (Mindaugo g. 7)";SVETLIAČKI;6219872984;Taip;5;0;0;5
24467;"Kūlverstukas (Mindaugo g. 7)";SVETLIAČKI;9098427210;Taip;0;0;13;13
24468;"Kūlverstukas (Mindaugo g. 7)";SVETLIAČKI;2091204077;Ne;4;1;0;5
24469;"Kūlverstukas (Mindaugo g. 7)";SVETLIAČKI;70033583066;Taip;0;4;0;4
24470;"Kūlverstukas (Mindaugo g. 7)";SVETLIAČKI;2154916232;Taip;9;4;0;13
24471;"Kūlverstukas (Mindaugo g. 7)";SVETLIAČKI;6376189019;Taip;0;22;0;22
24472;"Kūlverstukas (Mindaugo g. 7)";SVETLIAČKI;5794471794;Taip;12;0;0;12
24473;"Kūlverstukas (Mindaugo g. 7)";SVETLIAČKI;1557237011;Taip;0;4;5;9
24474;"Kūlverstukas (Mindaugo g. 7)";SVETLIAČKI;7829384850;Ne;4;0;0;4
24475;"Kūlverstukas (Mindaugo g. 7)";SVETLIAČKI;8577197481;Ne;18;1;0;19
24476;"Kūlverstukas (Mindaugo g. 7)";SVETLIAČKI;3449300504;Taip;18;0;0;18
24477;"Kūlverstukas (Mindaugo g. 7)";SVETLIAČKI;1102996499;Taip;12;1;0;13
24478;"Kūlverstukas (Mindaugo g. 7)";SVETLIAČKI;6311116034;Taip;15;1;0;16
24479;"Kūlverstukas (Mindaugo g. 7)";SVETLIAČKI;5546604017;Taip;0;4;5;9
24480;"Kūlverstukas (Mindaugo g. 7)";SVETLIAČKI;1635418112;Taip;0;10;0;10
24481;"Kūlverstukas (Mindaugo g. 7)";SVETLIAČKI;4352034102;Taip;6;0;0;6
24482;"Kūlverstukas (Mindaugo g. 7)";ZVONOČKI;1486878343;Taip;2;1;1;4
24483;"Kūlverstukas (Mindaugo g. 7)";ZVONOČKI;8835111916;Taip;0;3;6;9
24484;"Kūlverstukas (Mindaugo g. 7)";ZVONOČKI;5724787637;Taip;0;9;0;9
24485;"Kūlverstukas (Mindaugo g. 7)";ZVONOČKI;4377803110;Taip;7;3;0;10
24486;"Kūlverstukas (Mindaugo g. 7)";ZVONOČKI;7898746258;Taip;4;0;0;4
24487;"Kūlverstukas (Mindaugo g. 7)";ZVONOČKI;9835391223;Taip;10;1;0;11
24488;"Kūlverstukas (Mindaugo g. 7)";ZVONOČKI;2429527586;Taip;0;7;12;19
24489;"Kūlverstukas (Mindaugo g. 7)";ZVONOČKI;5217751936;Taip;9;8;0;17
24490;"Kūlverstukas (Mindaugo g. 7)";ZVONOČKI;1566191212;Taip;3;2;1;6
24491;"Kūlverstukas (Mindaugo g. 7)";ZVONOČKI;9569296370;Taip;0;11;5;16
24492;"Kūlverstukas (Mindaugo g. 7)";ZVONOČKI;1047459617;Taip;8;5;0;13
24493;"Kūlverstukas (Mindaugo g. 7)";ZVONOČKI;9756326725;Taip;5;2;3;10
24494;"Kūlverstukas (Mindaugo g. 7)";ZVONOČKI;9156801640;Taip;0;2;20;22
24495;"Kūlverstukas (Mindaugo g. 7)";ZVONOČKI;1125206576;Taip;10;6;0;16
24496;"Kūlverstukas (Mindaugo g. 7)";ZVONOČKI;5938022496;Ne;8;3;0;11
24497;"Kūlverstukas (Mindaugo g. 7)";ZVONOČKI;1641777291;Taip;0;0;15;15
24498;"Vilniaus Pavilnio pagrindinė mokykla";"PRIEŠMOKYKLINĖ PL";2738553283;Taip;11;1;3;15
24499;"Vilniaus Pavilnio pagrindinė mokykla";"PRIEŠMOKYKLINĖ PL";2101902207;Taip;0;3;3;6
24500;"Vilniaus Pavilnio pagrindinė mokykla";"PRIEŠMOKYKLINĖ PL";1957926887;Taip;0;12;6;18
24501;"Vilniaus Pavilnio pagrindinė mokykla";"PRIEŠMOKYKLINĖ PL";1046606022;Taip;0;1;2;3
24502;"Vilniaus Pavilnio pagrindinė mokykla";"PRIEŠMOKYKLINĖ RU";4339607826;Ne;0;1;2;3
24503;"Vilniaus Pavilnio pagrindinė mokykla";"PRIEŠMOKYKLINĖ RU";3609961581;Taip;0;1;2;3
24504;"Vilniaus Pavilnio pagrindinė mokykla";"PRIEŠMOKYKLINĖ RU";1568915914;Taip;0;1;2;3
24505;"Vilniaus Pavilnio pagrindinė mokykla";"PRIEŠMOKYKLINĖ RU";5619763557;Ne;0;22;0;22
24506;"Vilniaus Pavilnio pagrindinė mokykla";"PRIEŠMOKYKLINĖ RU";9759761725;Ne;0;22;0;22
24507;"Vilniaus Pavilnio pagrindinė mokykla";"PRIEŠMOKYKLINĖ RU";3058369504;Ne;0;1;3;4
24508;"Vilniaus Pavilnio pagrindinė mokykla";"PRIEŠMOKYKLINĖ RU";9142513631;Ne;8;1;4;13
24509;"Vilniaus Pavilnio pagrindinė mokykla";"PRIEŠMOKYKLINĖ RU";5972567526;Taip;4;1;3;8
24510;"Vilniaus Pavilnio pagrindinė mokykla";"PRIEŠMOKYKLINĖ RU";2846917348;Taip;0;1;10;11
24511;"Vilniaus Pavilnio pagrindinė mokykla";"PRIEŠMOKYKLINĖ RU";6067622823;Taip;0;1;7;8
24512;"Vilniaus Pavilnio pagrindinė mokykla";"PRIEŠMOKYKLINĖ RU";3243226933;Ne;0;1;8;9
24513;"Vilniaus Pavilnio pagrindinė mokykla";"PRIEŠMOKYKLINĖ RU";7544963724;Taip;0;1;6;7
24514;"Vilniaus Pavilnio pagrindinė mokykla";"PRIEŠMOKYKLINĖ RU";6216663291;Taip;8;1;1;10
24515;"Vilniaus Pavilnio pagrindinė mokykla";"PRIEŠMOKYKLINĖ RU";3282845685;Taip;0;1;13;14
24516;"Lazdynų mokykla (Liudvinavo g.128)";DRUGELIAI;4684618253;Taip;8;0;1;9
24517;"Lazdynų mokykla (Liudvinavo g.128)";DRUGELIAI;7524849851;Taip;4;3;2;9
24518;"Lazdynų mokykla (Liudvinavo g.128)";DRUGELIAI;8650496265;Taip;0;3;1;4
24519;"Lazdynų mokykla (Liudvinavo g.128)";DRUGELIAI;1365362641;Taip;4;4;0;8
24520;"Lazdynų mokykla (Liudvinavo g.128)";DRUGELIAI;9309081745;Taip;14;0;1;15
24521;"Lazdynų mokykla (Liudvinavo g.128)";DRUGELIAI;1951041742;Ne;0;3;0;3
24522;"Lazdynų mokykla (Liudvinavo g.128)";DRUGELIAI;9196184984;Taip;8;0;0;8
24523;"Lazdynų mokykla (Liudvinavo g.128)";DRUGELIAI;2767732459;Ne;5;9;0;14
24524;"Lazdynų mokykla (Liudvinavo g.128)";DRUGELIAI;6394098306;Taip;17;0;2;19
24525;"Lazdynų mokykla (Liudvinavo g.128)";DRUGELIAI;6627809171;Taip;0;22;0;22
24526;"Lazdynų mokykla (Liudvinavo g.128)";DRUGELIAI;4520091712;Taip;0;0;7;7
24527;"Lazdynų mokykla (Liudvinavo g.128)";DRUGELIAI;7074859809;Taip;9;2;3;14
24528;"Lazdynų mokykla (Liudvinavo g.128)";DRUGELIAI;4097980299;Ne;0;2;0;2
24529;"Lazdynų mokykla (Liudvinavo g.128)";DRUGELIAI;8001610972;Ne;0;2;0;2
24530;"Lazdynų mokykla (Liudvinavo g.128)";DRUGELIAI;5902104981;Taip;0;2;0;2
24531;"Lazdynų mokykla (Liudvinavo g.128)";DRUGELIAI;7590111138;Ne;7;5;1;13
24532;"Lazdynų mokykla (Liudvinavo g.128)";DRUGELIAI;8472834181;Ne;4;5;1;10
24533;"Lazdynų mokykla (Liudvinavo g.128)";DRUGELIAI;2027751624;Taip;9;1;0;10
24534;"Lazdynų mokykla (Liudvinavo g.128)";ZUIKUČIAI;7232402011;Taip;0;1;0;1
24535;"Lazdynų mokykla (Liudvinavo g.128)";ZUIKUČIAI;4166599533;Taip;7;0;1;8
24536;"Lazdynų mokykla (Liudvinavo g.128)";ZUIKUČIAI;3435025978;Taip;5;0;5;10
24537;"Lazdynų mokykla (Liudvinavo g.128)";ZUIKUČIAI;3715070791;Taip;12;2;2;16
24538;"Lazdynų mokykla (Liudvinavo g.128)";ZUIKUČIAI;3265099747;Taip;3;0;0;3
24539;"Lazdynų mokykla (Liudvinavo g.128)";ZUIKUČIAI;8669630986;Taip;6;2;1;9
24540;"Lazdynų mokykla (Liudvinavo g.128)";ZUIKUČIAI;1336503878;Taip;0;2;1;3
24541;"Lazdynų mokykla (Liudvinavo g.128)";ZUIKUČIAI;3302443490;Taip;13;1;0;14
24542;"Lazdynų mokykla (Liudvinavo g.128)";ZUIKUČIAI;3268305561;Ne;0;2;2;4
24543;"Lazdynų mokykla (Liudvinavo g.128)";ZUIKUČIAI;7000921682;Ne;0;2;4;6
24544;"Lazdynų mokykla (Liudvinavo g.128)";ZUIKUČIAI;3535244441;Taip;6;3;1;10
24545;"Lazdynų mokykla (Liudvinavo g.128)";ZUIKUČIAI;7594978836;Taip;0;2;3;5
24546;"Lazdynų mokykla (Liudvinavo g.128)";ZUIKUČIAI;7229926614;Taip;13;0;0;13
24547;"Lazdynų mokykla (Liudvinavo g.128)";ZUIKUČIAI;2624013880;Taip;4;0;0;4
24548;"Lazdynų mokykla (Liudvinavo g.128)";ZUIKUČIAI;8899186547;Taip;22;0;0;22
24549;"Lazdynų mokykla (Liudvinavo g.128)";ZUIKUČIAI;5181200460;Taip;17;0;0;17
24550;"Vilniaus Šilo mokykla";Boružėlės;7122041826;Taip;0;1;0;1
24551;"Vilniaus Šilo mokykla";Boružėlės;9967276147;Taip;3;1;0;4
24552;"Vilniaus Šilo mokykla";Boružėlės;5962551687;Ne;14;1;0;15
24553;"Vilniaus Šilo mokykla";Boružėlės;1196172221;Ne;13;1;0;14
24554;"Vilniaus Šilo mokykla";Boružėlės;1538635985;Taip;21;1;0;22
24555;"Vilniaus Šilo mokykla";Boružėlės;6136087920;Taip;0;22;0;22
24556;"Vilniaus Šilo mokykla";Boružėlės;4544126354;Taip;17;1;0;18
24557;"Vilniaus Šilo mokykla";"1 spec.";1153167430;Taip;1;1;0;2
24558;"Vilniaus Šilo mokykla";"1 spec.";8863021708;Taip;5;1;0;6
24559;"Vilniaus Šilo mokykla";"1 spec.";4438939800;Taip;5;1;0;6
24560;"Vilniaus Šilo mokykla";"1 spec.";1971717759;Taip;0;1;0;1
24561;"Vilniaus Šilo mokykla";"1 spec.";2290889395;Taip;0;1;0;1
24562;"Vilniaus Šilo mokykla";"1 spec.";1180183091;Taip;0;22;0;22
24563;"Vilniaus Šilo mokykla";"3-4 kl. RUS";11529512484;Taip;10;1;0;11
24564;"Vilniaus Šilo mokykla";"3-4 kl. RUS";13277011762;Taip;1;1;0;2
24565;"Vilniaus Šilo mokykla";"3-4 kl. RUS";34463714051;Ne;8;1;0;9
24566;"Vilniaus Šilo mokykla";"3-4 kl. RUS";4078721064;Ne;9;1;0;10
24567;"Vilniaus Šilo mokykla";"3-4 kl. RUS";9789373884;Taip;0;22;0;22
24568;"Vilniaus Šilo mokykla";"3-4 kl. RUS";3419495275;Ne;2;0;0;2
24569;"Vilniaus Šilo mokykla";"6 lav.";29353956408;Taip;8;1;0;9
24570;"Vilniaus Šilo mokykla";"6 lav.";83007167743;Ne;2;1;0;3
24571;"Vilniaus Šilo mokykla";"6 lav.";67989956617;Taip;0;22;0;22
24572;"Vilniaus Šilo mokykla";"6 lav.";49892720109;Taip;3;1;0;4
24573;"Vilniaus Šilo mokykla";"6 lav.";3612746646;Taip;16;1;0;17
24574;"Vilniaus Šilo mokykla";"6 lav.";9054390753;Taip;2;1;0;3
24575;"Vilniaus Šilo mokykla";"6 lav.";2862598950;Ne;5;1;0;6
24576;"Vilniaus Šilo mokykla";"SĮ A";6954467869;Taip;0;22;0;22
24577;"Vilniaus Šilo mokykla";"SĮ A";5649950011;Ne;2;1;0;3
24578;"Vilniaus Šilo mokykla";"SĮ A";2755910347;Taip;4;1;0;5
24579;"Vilniaus Šilo mokykla";"SĮ A";1550576460;Taip;2;1;0;3
24580;"Vilniaus Šilo mokykla";"SĮ A";9354191217;Taip;2;1;0;3
24581;"Vilniaus Šilo mokykla";"SĮ A";9471629029;Taip;0;1;0;1
24582;"Vilniaus Šilo mokykla";"SĮ A";6088433049;Taip;1;1;0;2
24583;"Vilniaus Šilo mokykla";"SĮ A";1819519275;Ne;2;1;0;3
24584;"Vilniaus Šilo mokykla";"SĮ A";9050305661;Ne;0;22;0;22
24585;"Vilniaus Šilo mokykla";"SĮ A";8625084837;Taip;0;22;0;22
24586;"Vilniaus Šilo mokykla";"SĮ A";9845575989;Ne;4;1;0;5
24587;"Vilniaus Šilo mokykla";"SĮ A";2504178906;Taip;0;1;0;1
24588;"Vilniaus Šilo mokykla";"SĮ A";3308772529;Taip;0;1;0;1
24589;"Vilniaus Šilo mokykla";"SĮ C";1322335360;Taip;3;1;0;4
24590;"Vilniaus Šilo mokykla";"SĮ C";3808707012;Taip;0;1;0;1
24591;"Vilniaus Šilo mokykla";"SĮ C";8642665550;Taip;5;1;0;6
24592;"Vilniaus Šilo mokykla";"SĮ C";5309862220;Taip;0;22;0;22
24593;"Vilniaus Šilo mokykla";"SĮ C";1010885560;Taip;0;1;0;1
24594;"Vilniaus Šilo mokykla";"SĮ C";8377829773;Taip;7;1;0;8
24595;"Vilniaus Šilo mokykla";"SĮ C";5138513395;Taip;28;1;0;29
24596;"Vilniaus Šilo mokykla";"SĮ C";1969540884;Taip;0;22;0;22
24597;"Vilniaus Šilo mokykla";"Priešmokyklinė grupė";5311183877;Taip;14;1;0;15
24598;"Vilniaus Šilo mokykla";"Priešmokyklinė grupė";1675384533;Taip;11;1;0;12
24599;"Vilniaus Šilo mokykla";"Priešmokyklinė grupė";3237698420;Taip;8;1;0;9
24600;"Vilniaus Šilo mokykla";"Priešmokyklinė grupė";2070454339;Ne;0;22;0;22
24601;"Vilniaus Šilo mokykla";"Priešmokyklinė grupė";8915901727;Taip;11;1;0;12
24602;"Vilniaus Šilo mokykla";"Priešmokyklinė grupė";9906750269;Taip;0;22;0;22
24603;Malūnėlis;BITUTĖS;1001575740;Taip;0;3;3;6
24604;Malūnėlis;BITUTĖS;8618778205;Taip;10;3;0;13
24605;Malūnėlis;BITUTĖS;2545930114;Taip;14;0;0;14
24606;Malūnėlis;BITUTĖS;3329510128;Taip;14;0;0;14
24607;Malūnėlis;BITUTĖS;5402027714;Taip;1;8;0;9
24608;Malūnėlis;BITUTĖS;6199265600;Taip;11;1;0;12
24609;Malūnėlis;BITUTĖS;6863437022;Taip;0;7;0;7
24610;Malūnėlis;BITUTĖS;5244586185;Ne;0;2;0;2
24611;Malūnėlis;BITUTĖS;7144098762;Taip;16;0;0;16
24612;Malūnėlis;BITUTĖS;1146723570;Taip;0;5;0;5
24613;Malūnėlis;BITUTĖS;9891418762;Taip;0;14;0;14
24614;Malūnėlis;BITUTĖS;8642960989;Taip;5;3;0;8
24615;Malūnėlis;BITUTĖS;5959610426;Taip;17;0;0;17
24616;Malūnėlis;BITUTĖS;4367009696;Taip;0;7;0;7
24617;Malūnėlis;BITUTĖS;5770511204;Ne;13;3;0;16
24618;Malūnėlis;BITUTĖS;9936144392;Taip;7;1;0;8
24619;Malūnėlis;BITUTĖS;1944670796;Taip;11;6;0;17
24620;Malūnėlis;BITUTĖS;5421090978;Taip;12;2;0;14
24621;Malūnėlis;BITUTĖS;8643210289;Taip;2;0;0;2
24622;Malūnėlis;BITUTĖS;8440160819;Taip;2;3;0;5
24623;Malūnėlis;BITUTĖS;1528972517;Taip;0;12;0;12
24624;Malūnėlis;BITUTĖS;8007350745;Taip;0;2;0;2
24625;Malūnėlis;BITUTĖS;9257812097;Taip;20;0;0;20
24626;Malūnėlis;VOVERIUKAI;4307232411;Taip;4;2;0;6
24627;Malūnėlis;VOVERIUKAI;3293082023;Taip;2;1;0;3
24628;Malūnėlis;VOVERIUKAI;6575258889;Taip;14;0;0;14
24629;Malūnėlis;VOVERIUKAI;1003043129;Taip;15;0;0;15
24630;Malūnėlis;VOVERIUKAI;3779723692;Taip;9;1;0;10
24631;Malūnėlis;VOVERIUKAI;7983537913;Ne;6;1;0;7
24632;Malūnėlis;VOVERIUKAI;9592117637;Ne;7;0;0;7
24633;Malūnėlis;VOVERIUKAI;9894452403;Ne;7;4;0;11
24634;Malūnėlis;VOVERIUKAI;2029506037;Taip;12;0;0;12
24635;Malūnėlis;VOVERIUKAI;9342720464;Ne;11;3;0;14
24636;Malūnėlis;VOVERIUKAI;2246526281;Taip;9;0;0;9
24637;Malūnėlis;VOVERIUKAI;2192305527;Taip;9;6;0;15
24638;Malūnėlis;VOVERIUKAI;6805587761;Taip;9;6;0;15
24639;Malūnėlis;VOVERIUKAI;3371260811;Taip;5;8;0;13
24640;Malūnėlis;VOVERIUKAI;5061720786;Taip;6;0;2;8
24641;Malūnėlis;VOVERIUKAI;5232728972;Taip;7;0;1;8
24642;Malūnėlis;VOVERIUKAI;2574604828;Taip;0;6;3;9
24643;Malūnėlis;VOVERIUKAI;3898518306;Taip;0;0;14;14
24644;Malūnėlis;VOVERIUKAI;1770049356;Taip;11;2;0;13
24645;Malūnėlis;VOVERIUKAI;5909022614;Taip;2;0;0;2
24646;Malūnėlis;VOVERIUKAI;8751365673;Ne;0;12;8;20
24647;Malūnėlis;VOVERIUKAI;6081634102;Taip;12;0;0;12
24648;Malūnėlis;BORUŽĖLĖS;7556990784;Taip;7;0;0;7
24649;Malūnėlis;BORUŽĖLĖS;1574941416;Taip;14;0;0;14
24650;Malūnėlis;BORUŽĖLĖS;1100719254;Ne;10;0;0;10
24651;Malūnėlis;BORUŽĖLĖS;2525923211;Taip;13;0;4;17
24652;Malūnėlis;BORUŽĖLĖS;9304119075;Taip;9;0;0;9
24653;Malūnėlis;BORUŽĖLĖS;6928976717;Taip;0;5;1;6
24654;Malūnėlis;BORUŽĖLĖS;6531364407;Ne;10;0;0;10
24655;Malūnėlis;BORUŽĖLĖS;2637299307;Taip;18;0;0;18
24656;Malūnėlis;BORUŽĖLĖS;8551271848;Taip;4;0;6;10
24657;Malūnėlis;BORUŽĖLĖS;8277245773;Taip;17;2;0;19
24658;Malūnėlis;BORUŽĖLĖS;5686301875;Taip;11;0;0;11
24659;Malūnėlis;BORUŽĖLĖS;1407908511;Ne;15;0;0;15
24660;Malūnėlis;BORUŽĖLĖS;4787212056;Taip;14;0;3;17
24661;Malūnėlis;BORUŽĖLĖS;7740957549;Taip;0;0;2;2
24662;Malūnėlis;BORUŽĖLĖS;9185138453;Taip;18;0;1;19
24663;Malūnėlis;BORUŽĖLĖS;5727725132;Taip;17;0;0;17
24664;Malūnėlis;BORUŽĖLĖS;9559372808;Ne;15;0;0;15
24665;Malūnėlis;Skruzdėliukų;2093908776;Taip;0;3;0;3
24666;Malūnėlis;Skruzdėliukų;9798968369;Taip;8;0;0;8
24667;Malūnėlis;Skruzdėliukų;4859886340;Taip;8;0;1;9
24668;Malūnėlis;Skruzdėliukų;1213476648;Taip;13;0;0;13
24669;Malūnėlis;Skruzdėliukų;9300944734;Taip;15;2;0;17
24670;Malūnėlis;Skruzdėliukų;5877882690;Taip;13;2;0;15
24671;Malūnėlis;Skruzdėliukų;9153589128;Taip;11;0;0;11
24672;Malūnėlis;Skruzdėliukų;1549241453;Taip;13;0;0;13
24673;Malūnėlis;Skruzdėliukų;5478561852;Ne;9;0;1;10
24674;Malūnėlis;Skruzdėliukų;4802771311;Taip;0;0;1;1
24675;Malūnėlis;Skruzdėliukų;9207327884;Ne;13;0;3;16
24676;Malūnėlis;Skruzdėliukų;6609446450;Taip;8;1;0;9
24677;Malūnėlis;Skruzdėliukų;5687585794;Taip;5;0;2;7
24678;Malūnėlis;Skruzdėliukų;8076487157;Taip;0;0;1;1
24679;Malūnėlis;Skruzdėliukų;3402561453;Ne;0;11;0;11
24680;Malūnėlis;Skruzdėliukų;2495112045;Taip;0;7;0;7
24681;Malūnėlis;Skruzdėliukų;3935474148;Taip;4;0;0;4
24682;Malūnėlis;Žirniukų;3791873303;Taip;10;0;0;10
24683;Malūnėlis;Žirniukų;3031849277;Ne;9;0;0;9
24684;Malūnėlis;Žirniukų;6747286787;Taip;10;1;0;11
24685;Malūnėlis;Žirniukų;4539998453;Taip;7;2;0;9
24686;Malūnėlis;Žirniukų;6943968536;Taip;11;0;0;11
24687;Malūnėlis;Žirniukų;4841028952;Ne;14;0;3;17
24688;Malūnėlis;Žirniukų;7097858329;Taip;13;0;0;13
24689;Malūnėlis;Žirniukų;1398391534;Taip;10;0;0;10
24690;Malūnėlis;Žirniukų;2961972215;Taip;22;0;0;22
24691;Malūnėlis;Žirniukų;5622982984;Taip;5;0;0;5
24692;Malūnėlis;Žirniukų;3315571256;Taip;10;0;0;10
24693;Malūnėlis;Žirniukų;3315571256;Taip;10;0;0;10
24694;Malūnėlis;Žirniukų;3315571256;Taip;10;0;0;10
24695;Malūnėlis;Žirniukų;9941335615;Taip;18;0;0;18
24696;Malūnėlis;Žirniukų;3464224841;Taip;19;0;0;19
24697;Malūnėlis;Žirniukų;6047042736;Ne;14;1;0;15
24698;Malūnėlis;Žirniukų;4875859413;Taip;5;3;0;8
24699;Malūnėlis;Žirniukų;6647872886;Taip;16;0;0;16
24700;"Dainorėliai (Goštauto g. 4)";PUMPURĖLIAI;8015545426;Taip;5;0;0;5
24701;"Dainorėliai (Goštauto g. 4)";PUMPURĖLIAI;5691833295;Taip;9;3;1;13
24702;"Dainorėliai (Goštauto g. 4)";PUMPURĖLIAI;6132543858;Taip;13;3;0;16
24703;"Dainorėliai (Goštauto g. 4)";PUMPURĖLIAI;4560328911;Taip;0;10;13;23
24704;"Dainorėliai (Goštauto g. 4)";PUMPURĖLIAI;4435310580;Taip;0;13;12;25
24705;"Dainorėliai (Goštauto g. 4)";PUMPURĖLIAI;7197089520;Taip;5;19;0;24
24706;"Dainorėliai (Goštauto g. 4)";PUMPURĖLIAI;3999214263;Ne;9;0;0;9
24707;"Dainorėliai (Goštauto g. 4)";PUMPURĖLIAI;6362265057;Taip;0;5;0;5
24708;"Dainorėliai (Goštauto g. 4)";PUMPURĖLIAI;2215481883;Taip;0;4;0;4
24709;"Dainorėliai (Goštauto g. 4)";PUMPURĖLIAI;1233029451;Taip;3;12;0;15
24710;"Dainorėliai (Goštauto g. 4)";PUMPURĖLIAI;3561729784;Taip;0;8;4;12
24711;"Dainorėliai (Goštauto g. 4)";PUMPURĖLIAI;5534783929;Taip;0;8;0;8
24712;"Dainorėliai (Goštauto g. 4)";PUMPURĖLIAI;3705286231;Taip;0;4;0;4
24713;"Dainorėliai (Goštauto g. 4)";PUMPURĖLIAI;4826994208;Taip;6;3;0;9
24714;"Dainorėliai (Goštauto g. 4)";PUMPURĖLIAI;4848146301;Taip;10;1;0;11
24715;"Dainorėliai (Goštauto g. 4)";DEBESĖLIŲ;6513417505;Taip;25;0;0;25
24716;"Dainorėliai (Goštauto g. 4)";DEBESĖLIŲ;3908458280;Taip;11;0;0;11
24717;"Dainorėliai (Goštauto g. 4)";DEBESĖLIŲ;5605084046;Taip;7;0;0;7
24718;"Dainorėliai (Goštauto g. 4)";DEBESĖLIŲ;1873415679;Ne;0;17;0;17
24719;"Dainorėliai (Goštauto g. 4)";DEBESĖLIŲ;4286864865;Taip;8;2;0;10
24720;"Dainorėliai (Goštauto g. 4)";DEBESĖLIŲ;2823401633;Taip;0;1;0;1
24721;"Dainorėliai (Goštauto g. 4)";DEBESĖLIŲ;6832582194;Taip;12;0;0;12
24722;"Dainorėliai (Goštauto g. 4)";DEBESĖLIŲ;2095914442;Taip;0;4;0;4
24723;"Dainorėliai (Goštauto g. 4)";DEBESĖLIŲ;4255893222;Taip;0;2;0;2
24724;"Dainorėliai (Goštauto g. 4)";DEBESĖLIŲ;3271090533;Taip;5;11;0;16
24725;"Dainorėliai (Goštauto g. 4)";DEBESĖLIŲ;4033317616;Taip;10;1;0;11
24726;"Dainorėliai (Goštauto g. 4)";DEBESĖLIŲ;6449332338;Taip;0;3;0;3
24727;"Dainorėliai (Goštauto g. 4)";DEBESĖLIŲ;6284140548;Ne;0;20;0;20
24728;"Dainorėliai (Goštauto g. 4)";DEBESĖLIŲ;2534758615;Taip;16;0;0;16
24729;"Dainorėliai (Goštauto g. 4)";DEBESĖLIŲ;5283566263;Taip;3;2;0;5
24730;"Krivūlė (Vokiečių g. 1)";PABIRUČIAI;9011102232;Taip;3;0;1;4
24731;"Krivūlė (Vokiečių g. 1)";PABIRUČIAI;5535822704;Taip;0;22;0;22
24732;"Krivūlė (Vokiečių g. 1)";PABIRUČIAI;1944288576;Taip;7;0;2;9
24733;"Krivūlė (Vokiečių g. 1)";PABIRUČIAI;3696403149;Ne;0;22;0;22
24734;"Krivūlė (Vokiečių g. 1)";PABIRUČIAI;5721252419;Taip;0;22;0;22
24735;"Krivūlė (Vokiečių g. 1)";PABIRUČIAI;4600688626;Taip;0;0;7;7
24736;"Krivūlė (Vokiečių g. 1)";PABIRUČIAI;4608957977;Taip;9;0;0;9
24737;"Krivūlė (Vokiečių g. 1)";PABIRUČIAI;7308968772;Taip;0;0;2;2
24738;"Krivūlė (Vokiečių g. 1)";PABIRUČIAI;4884789671;Taip;10;0;0;10
24739;"Krivūlė (Vokiečių g. 1)";PABIRUČIAI;8352493729;Ne;0;22;0;22
24740;"Krivūlė (Vokiečių g. 1)";PABIRUČIAI;9401191578;Taip;5;0;7;12
24741;"Krivūlė (Vokiečių g. 1)";PABIRUČIAI;3976974038;Taip;3;0;0;3
24742;"Krivūlė (Vokiečių g. 1)";PABIRUČIAI;2259139771;Taip;0;0;4;4
24743;"Krivūlė (Vokiečių g. 1)";PABIRUČIAI;3138555448;Taip;10;0;12;22
24744;"Krivūlė (Vokiečių g. 1)";PABIRUČIAI;2784118970;Ne;3;0;1;4
24745;"Krivūlė (Vokiečių g. 1)";PABIRUČIAI;3227555647;Taip;3;0;6;9
24746;"Krivūlė (Vokiečių g. 1)";PABIRUČIAI;4261770381;Taip;12;0;5;17
24747;"Krivūlė (Vokiečių g. 1)";SMALSUČIAI;5304221329;Taip;4;1;2;7
24748;"Krivūlė (Vokiečių g. 1)";SMALSUČIAI;7508079584;Taip;0;0;3;3
24749;"Krivūlė (Vokiečių g. 1)";SMALSUČIAI;5199600243;Taip;0;1;2;3
24750;"Krivūlė (Vokiečių g. 1)";SMALSUČIAI;4814488445;Taip;0;1;5;6
24751;"Krivūlė (Vokiečių g. 1)";SMALSUČIAI;3076382863;Taip;4;1;0;5
24752;"Krivūlė (Vokiečių g. 1)";SMALSUČIAI;7997564406;Taip;6;5;0;11
24753;"Krivūlė (Vokiečių g. 1)";SMALSUČIAI;8710938907;Taip;0;2;7;9
24754;"Krivūlė (Vokiečių g. 1)";SMALSUČIAI;4491462086;Ne;9;0;5;14
24755;"Krivūlė (Vokiečių g. 1)";SMALSUČIAI;4773564048;Taip;0;6;0;6
24756;"Krivūlė (Vokiečių g. 1)";SMALSUČIAI;3324090723;Taip;0;0;6;6
24757;"Krivūlė (Vokiečių g. 1)";SMALSUČIAI;4094383258;Taip;0;0;3;3
24758;"Krivūlė (Vokiečių g. 1)";SMALSUČIAI;9229817861;Ne;0;0;5;5
24759;"Krivūlė (Vokiečių g. 1)";SMALSUČIAI;8042469720;Taip;0;15;0;15
24760;"Krivūlė (Vokiečių g. 1)";SMALSUČIAI;4845066055;Taip;0;1;10;11
24761;"Krivūlė (Vokiečių g. 1)";SMALSUČIAI;1815336153;Taip;2;3;3;8
24762;"Krivūlė (Vokiečių g. 1)";SMALSUČIAI;7528273082;Taip;0;6;1;7
24763;"Krivūlė (Vokiečių g. 1)";SMALSUČIAI;6521798502;Taip;0;0;9;9
24764;"Krivūlė (Vokiečių g. 1)";SMALSUČIAI;5790418638;Taip;7;0;6;13
24765;"Krivūlė (Vokiečių g. 1)";SMALSUČIAI;1851097789;Taip;0;0;8;8
24766;"Krivūlė (Vokiečių g. 1)";GUDRUČIAI;4681543921;Taip;4;0;5;9
24767;"Krivūlė (Vokiečių g. 1)";GUDRUČIAI;8520470321;Taip;0;0;2;2
24768;"Krivūlė (Vokiečių g. 1)";GUDRUČIAI;5753204752;Taip;0;0;5;5
24769;"Krivūlė (Vokiečių g. 1)";GUDRUČIAI;2659604299;Taip;12;0;0;12
24770;"Krivūlė (Vokiečių g. 1)";GUDRUČIAI;2536472220;Taip;6;4;0;10
24771;"Krivūlė (Vokiečių g. 1)";GUDRUČIAI;4741154518;Taip;0;0;1;1
24772;"Krivūlė (Vokiečių g. 1)";GUDRUČIAI;7436569684;Taip;5;0;1;6
24773;"Krivūlė (Vokiečių g. 1)";GUDRUČIAI;7727246187;Taip;0;2;2;4
24774;"Krivūlė (Vokiečių g. 1)";GUDRUČIAI;6072261879;Taip;14;0;0;14
24775;"Krivūlė (Vokiečių g. 1)";GUDRUČIAI;7904390075;Taip;0;0;8;8
24776;"Krivūlė (Vokiečių g. 1)";GUDRUČIAI;6931566125;Taip;4;0;1;5
24777;"Krivūlė (Vokiečių g. 1)";GUDRUČIAI;5149419581;Taip;9;0;2;11
24778;"Krivūlė (Vokiečių g. 1)";GUDRUČIAI;7789605738;Taip;0;1;1;2
24779;"Krivūlė (Vokiečių g. 1)";GUDRUČIAI;5097101097;Taip;0;1;5;6
24780;"Krivūlė (Vokiečių g. 1)";GUDRUČIAI;9693693101;Ne;8;0;6;14
24781;"Krivūlė (Vokiečių g. 1)";GUDRUČIAI;5462491857;Taip;0;7;2;9
24782;"Krivūlė (Vokiečių g. 1)";GUDRUČIAI;8871794542;Ne;10;1;5;16
24783;"Krivūlė (Vokiečių g. 1)";GUDRUČIAI;5182563483;Taip;0;1;4;5
24784;"Pumpurėlis (Trinapolio g. 11)";GUDRUČIAI;7002569226;Ne;14;0;2;16
24785;"Pumpurėlis (Trinapolio g. 11)";GUDRUČIAI;9353403057;Taip;6;0;0;6
24786;"Pumpurėlis (Trinapolio g. 11)";GUDRUČIAI;9353403057;Taip;6;0;0;6
24787;"Pumpurėlis (Trinapolio g. 11)";GUDRUČIAI;6920353753;Taip;5;0;2;7
24788;"Pumpurėlis (Trinapolio g. 11)";GUDRUČIAI;6920353753;Taip;5;0;2;7
24789;"Pumpurėlis (Trinapolio g. 11)";GUDRUČIAI;1189960583;Ne;0;0;4;4
24790;"Pumpurėlis (Trinapolio g. 11)";GUDRUČIAI;3841134563;Taip;8;0;5;13
24791;"Pumpurėlis (Trinapolio g. 11)";GUDRUČIAI;3841134563;Taip;8;0;5;13
24792;"Pumpurėlis (Trinapolio g. 11)";GUDRUČIAI;3841134563;Taip;8;0;5;13
24793;"Pumpurėlis (Trinapolio g. 11)";GUDRUČIAI;5187890514;Taip;6;0;2;8
24794;"Pumpurėlis (Trinapolio g. 11)";GUDRUČIAI;9126312869;Taip;4;0;1;5
24795;"Pumpurėlis (Trinapolio g. 11)";GUDRUČIAI;3387386473;Taip;7;0;1;8
24796;"Pumpurėlis (Trinapolio g. 11)";GUDRUČIAI;7177681927;Ne;8;0;0;8
24797;"Pumpurėlis (Trinapolio g. 11)";GUDRUČIAI;2130008026;Taip;11;0;0;11
24798;"Pumpurėlis (Trinapolio g. 11)";GUDRUČIAI;8475215020;Taip;7;0;0;7
24799;"Pumpurėlis (Trinapolio g. 11)";GUDRUČIAI;9550967420;Taip;18;0;0;18
24800;"Pumpurėlis (Trinapolio g. 11)";GUDRUČIAI;8534897580;Taip;4;0;2;6
24801;"Pumpurėlis (Trinapolio g. 11)";GUDRUČIAI;1750311606;Taip;0;0;9;9
24802;"Pumpurėlis (Trinapolio g. 11)";PABIRUČIAI;9824315755;Taip;11;5;0;16
24803;"Pumpurėlis (Trinapolio g. 11)";PABIRUČIAI;4565317498;Taip;0;0;7;7
24804;"Pumpurėlis (Trinapolio g. 11)";PABIRUČIAI;7910361194;Taip;0;0;18;18
24805;"Pumpurėlis (Trinapolio g. 11)";PABIRUČIAI;5249717804;Taip;4;0;0;4
24806;"Pumpurėlis (Trinapolio g. 11)";PABIRUČIAI;5403012236;Taip;5;9;2;16
24807;"Pumpurėlis (Trinapolio g. 11)";PABIRUČIAI;7998027741;Ne;3;0;4;7
24808;"Pumpurėlis (Trinapolio g. 11)";PABIRUČIAI;4955734206;Taip;10;0;0;10
24809;"Pumpurėlis (Trinapolio g. 11)";PABIRUČIAI;8207951541;Taip;10;2;0;12
24810;"Pumpurėlis (Trinapolio g. 11)";PABIRUČIAI;4696006714;Taip;6;6;7;19
24811;"Pumpurėlis (Trinapolio g. 11)";PABIRUČIAI;9597889927;Taip;7;3;0;10
24812;"Pumpurėlis (Trinapolio g. 11)";PABIRUČIAI;2187090934;Taip;14;0;0;14
24813;"Pumpurėlis (Trinapolio g. 11)";PABIRUČIAI;1222204689;Taip;10;0;0;10
24814;"Pumpurėlis (Trinapolio g. 11)";PABIRUČIAI;9395698760;Ne;13;0;0;13
24815;"Gilužis (Įsruties g. 30)";"MEDYNĖLIO 1 GR.";8237963602;Taip;22;0;0;22
24816;"Gilužis (Įsruties g. 30)";"MEDYNĖLIO 1 GR.";9753512366;Taip;22;0;0;22
24817;"Gilužis (Įsruties g. 30)";"MEDYNĖLIO 1 GR.";6914566889;Taip;20;0;0;20
24818;"Gilužis (Įsruties g. 30)";"MEDYNĖLIO 1 GR.";1541283216;Taip;3;0;1;4
24819;"Gilužis (Įsruties g. 30)";"MEDYNĖLIO 1 GR.";5306278297;Taip;20;0;1;21
24820;"Gilužis (Įsruties g. 30)";"MEDYNĖLIO 1 GR.";1054809163;Taip;14;0;4;18
24821;"Gilužis (Įsruties g. 30)";"MEDYNĖLIO 1 GR.";7887970476;Taip;18;0;0;18
24822;"Gilužis (Įsruties g. 30)";"MEDYNĖLIO 1 GR.";6507021182;Taip;0;0;6;6
24823;"Gilužis (Įsruties g. 30)";"MEDYNĖLIO 1 GR.";4652281185;Taip;4;0;0;4
24824;"Gilužis (Įsruties g. 30)";"MEDYNĖLIO 1 GR.";2364391112;Taip;5;0;0;5
24825;"Gilužis (Įsruties g. 30)";"MEDYNĖLIO 1 GR.";7068801003;Taip;5;0;0;5
24826;"Gilužis (Įsruties g. 30)";"MEDYNĖLIO 1 GR.";3081351563;Taip;9;0;0;9
24827;"Gilužis (Įsruties g. 30)";"MEDYNĖLIO 1 GR.";1015379578;Taip;7;0;0;7
24828;"Gilužis (Įsruties g. 30)";"MEDYNĖLIO 2 GR.";4927117901;Taip;7;0;0;7
24829;"Gilužis (Įsruties g. 30)";"MEDYNĖLIO 2 GR.";7247606321;Taip;10;2;2;14
24830;"Gilužis (Įsruties g. 30)";"MEDYNĖLIO 2 GR.";5664892047;Taip;5;0;5;10
24831;"Gilužis (Įsruties g. 30)";"MEDYNĖLIO 2 GR.";3379889899;Taip;22;0;0;22
24832;"Gilužis (Įsruties g. 30)";"MEDYNĖLIO 2 GR.";2915024298;Taip;0;0;5;5
24833;"Gilužis (Įsruties g. 30)";"MEDYNĖLIO 2 GR.";2567788346;Ne;3;0;0;3
24834;"Gilužis (Įsruties g. 30)";"MEDYNĖLIO 2 GR.";8717811266;Taip;0;0;1;1
24835;"Gilužis (Įsruties g. 30)";"MEDYNĖLIO 2 GR.";5769955074;Ne;2;0;0;2
24836;"Gilužis (Įsruties g. 30)";"MEDYNĖLIO 2 GR.";7487731015;Taip;1;0;3;4
24837;"Gilužis (Įsruties g. 30)";"MEDYNĖLIO 2 GR.";5079154238;Taip;16;0;0;16
24838;"Gilužis (Įsruties g. 30)";"MEDYNĖLIO 2 GR.";5490128851;Taip;3;0;3;6
24839;"Gilužis (Įsruties g. 30)";"MEDYNĖLIO 2 GR.";5784201106;Taip;14;0;0;14
24840;"Gilužis (Įsruties g. 30)";"MEDYNĖLIO 2 GR.";8904873416;Taip;6;1;3;10
24841;"Gilužis (Įsruties g. 30)";"MEDYNĖLIO 2 GR.";2851682356;Taip;0;1;0;1
24842;"Gilužis (Įsruties g. 30)";"STRAZDELIO GR.";6485579727;Taip;2;0;0;2
24843;"Gilužis (Įsruties g. 30)";"STRAZDELIO GR.";8477445384;Taip;1;0;2;3
24844;"Gilužis (Įsruties g. 30)";"STRAZDELIO GR.";3194397689;Taip;12;2;0;14
24845;"Gilužis (Įsruties g. 30)";"STRAZDELIO GR.";5737505086;Taip;0;22;0;22
24846;"Gilužis (Įsruties g. 30)";"STRAZDELIO GR.";3414489196;Taip;22;0;0;22
24847;"Gilužis (Įsruties g. 30)";"STRAZDELIO GR.";6586605929;Ne;0;22;0;22
24848;"Gilužis (Įsruties g. 30)";"STRAZDELIO GR.";3331616067;Ne;1;0;2;3
24849;"Gilužis (Įsruties g. 30)";"STRAZDELIO GR.";3729538163;Taip;7;0;0;7
24850;"Gilužis (Įsruties g. 30)";"STRAZDELIO GR.";4325300253;Taip;0;0;1;1
24851;"Gilužis (Įsruties g. 30)";"STRAZDELIO GR.";6207304860;Taip;4;0;1;5
24852;"Gilužis (Įsruties g. 30)";"STRAZDELIO GR.";5921538837;Taip;4;3;0;7
24853;"Gilužis (Įsruties g. 30)";"STRAZDELIO GR.";7053810996;Taip;7;0;0;7
24854;"Gilužis (Įsruties g. 30)";"STRAZDELIO GR.";9846916206;Taip;16;0;0;16
24855;"Gilužis (Įsruties g. 30)";"STRAZDELIO GR.";2398220397;Taip;7;0;1;8
24856;"Gilužis (Įsruties g. 30)";"STRAZDELIO GR.";3187000487;Taip;17;0;0;17
24857;"Gilužis (Įsruties g. 30)";"STRAZDELIO GR.";9325927745;Taip;10;0;12;22
24858;"Pilaitukas (Įsruties g. 27)";ŠNEKUČIAI;5118977299;Taip;0;0;4;4
24859;"Pilaitukas (Įsruties g. 27)";ŠNEKUČIAI;1859101624;Taip;3;0;0;3
24860;"Pilaitukas (Įsruties g. 27)";ŠNEKUČIAI;8479229073;Taip;11;0;0;11
24861;"Pilaitukas (Įsruties g. 27)";ŠNEKUČIAI;9731380502;Taip;0;2;1;3
24862;"Pilaitukas (Įsruties g. 27)";ŠNEKUČIAI;7224121082;Taip;6;0;1;7
24863;"Pilaitukas (Įsruties g. 27)";ŠNEKUČIAI;9115588495;Taip;9;0;1;10
24864;"Pilaitukas (Įsruties g. 27)";ŠNEKUČIAI;1082342063;Taip;5;2;0;7
24865;"Pilaitukas (Įsruties g. 27)";ŠNEKUČIAI;8801482035;Taip;13;0;0;13
24866;"Pilaitukas (Įsruties g. 27)";ŠNEKUČIAI;2894028512;Taip;5;0;0;5
24867;"Pilaitukas (Įsruties g. 27)";ŠNEKUČIAI;9622989196;Taip;0;0;5;5
24868;"Pilaitukas (Įsruties g. 27)";ŠNEKUČIAI;1356473379;Taip;0;22;0;22
24869;"Pilaitukas (Įsruties g. 27)";ŠNEKUČIAI;2883122532;Taip;0;9;3;12
24870;"Pilaitukas (Įsruties g. 27)";ŠNEKUČIAI;2883122532;Taip;0;9;3;12
24871;"Pilaitukas (Įsruties g. 27)";ŠNEKUČIAI;2883122532;Taip;0;9;3;12
24872;"Pilaitukas (Įsruties g. 27)";ŠNEKUČIAI;2939090118;Taip;2;1;0;3
24873;"Pilaitukas (Įsruties g. 27)";ŠNEKUČIAI;1309209771;Taip;7;0;0;7
24874;"Pilaitukas (Įsruties g. 27)";SMALSUČIAI;1815311248;Ne;10;0;0;10
24875;"Pilaitukas (Įsruties g. 27)";SMALSUČIAI;1414751236;Taip;4;0;0;4
24876;"Pilaitukas (Įsruties g. 27)";SMALSUČIAI;3215689222;Ne;0;0;1;1
24877;"Pilaitukas (Įsruties g. 27)";SMALSUČIAI;8755603496;Taip;8;0;2;10
24878;"Pilaitukas (Įsruties g. 27)";SMALSUČIAI;1974429718;Taip;17;0;0;17
24879;"Pilaitukas (Įsruties g. 27)";SMALSUČIAI;4544849086;Taip;18;0;0;18
24880;"Pilaitukas (Įsruties g. 27)";SMALSUČIAI;6934677745;Taip;0;4;0;4
24881;"Pilaitukas (Įsruties g. 27)";SMALSUČIAI;6496708020;Taip;0;0;5;5
24882;"Pilaitukas (Įsruties g. 27)";SMALSUČIAI;4608105047;Taip;14;0;0;14
24883;"Pilaitukas (Įsruties g. 27)";SMALSUČIAI;8698639192;Ne;10;0;0;10
24884;"Pilaitukas (Įsruties g. 27)";SMALSUČIAI;3273127718;Taip;10;0;0;10
24885;"Pilaitukas (Įsruties g. 27)";SMALSUČIAI;3501783231;Ne;9;0;0;9
24886;"Pilaitukas (Įsruties g. 27)";SMALSUČIAI;4898803794;Taip;15;0;0;15
24887;"Pilaitukas (Įsruties g. 27)";SMALSUČIAI;3544734838;Ne;1;0;2;3
24888;"Pilaitukas (Įsruties g. 27)";SMALSUČIAI;7034013577;Taip;17;1;0;18
24889;"Pilaitukas (Įsruties g. 27)";SMALSUČIAI;1793393776;Taip;0;22;0;22
24890;"Pilaitukas (Įsruties g. 27)";SMALSUČIAI;6906821879;Ne;0;0;1;1
24891;"Pilaitukas (Įsruties g. 27)";" GUDRUČIAI";87035008129;Taip;0;1;0;1
24892;"Pilaitukas (Įsruties g. 27)";" GUDRUČIAI";9921730735;Taip;0;4;1;5
24893;"Pilaitukas (Įsruties g. 27)";" GUDRUČIAI";3489297719;Taip;1;0;0;1
24894;"Pilaitukas (Įsruties g. 27)";" GUDRUČIAI";3068325053;Taip;7;0;2;9
24895;"Pilaitukas (Įsruties g. 27)";" GUDRUČIAI";1571691020;Taip;7;0;2;9
24896;"Pilaitukas (Įsruties g. 27)";" GUDRUČIAI";7904142328;Taip;0;1;3;4
24897;"Pilaitukas (Įsruties g. 27)";" GUDRUČIAI";9186679454;Taip;5;4;0;9
24898;"Pilaitukas (Įsruties g. 27)";" GUDRUČIAI";8584321345;Taip;11;0;0;11
24899;"Pilaitukas (Įsruties g. 27)";" GUDRUČIAI";3483758882;Ne;1;0;3;4
24900;"Pilaitukas (Įsruties g. 27)";" GUDRUČIAI";5059528135;Taip;10;0;0;10
24901;"Pilaitukas (Įsruties g. 27)";" GUDRUČIAI";87760608710;Ne;0;0;1;1
24902;"Pilaitukas (Įsruties g. 27)";" GUDRUČIAI";93271260871;Taip;11;6;0;17
24903;"Pilaitukas (Įsruties g. 27)";" GUDRUČIAI";8928237970;Taip;9;0;0;9
24904;"Pilaitukas (Įsruties g. 27)";" GUDRUČIAI";2819283284;Taip;12;0;3;15
24905;"Pilaitukas (Įsruties g. 27)";" GUDRUČIAI";5574732283;Taip;3;1;0;4
24906;"Pilaitukas (Įsruties g. 27)";" GUDRUČIAI";7380303098;Taip;4;7;0;11
24907;"Pilaitukas (Įsruties g. 27)";" GUDRUČIAI";1430155044;Ne;0;0;4;4
24908;"Pilaitukas (Įsruties g. 27)";" GUDRUČIAI";3621245783;Taip;12;0;1;13
24909;"Pilaitukas (Įsruties g. 27)";" GUDRUČIAI";2682252810;Taip;10;1;1;12
24910;"Pilaitukas (Įsruties g. 27)";" GUDRUČIAI";7290732562;Taip;3;1;4;8
24911;"Pilaitukas (Įsruties g. 27)";" GUDRUČIAI";3927118900;Taip;9;0;3;12
24912;"Pilaitukas (Įsruties g. 27)";" GUDRUČIAI";5464065587;Taip;0;4;0;4
