Nr.;"Darželio pavadinimas";"Grupės pavadinimas";"Vaiko Identifikacinis Nr.";"Deklaruotas mieste";"Pateisintos dėl ligos";"Pateisintos dėl kitų priežasčių";"Nepateisintos dienos";"Praleistos dienos Viso"
1;Aitvaras;"VIJURKAI (ALERG.)";6936031222;Taip;5;0;1;6
2;Aitvaras;"VIJURKAI (ALERG.)";6214880713;Taip;3;0;0;3
3;Aitvaras;"VIJURKAI (ALERG.)";2566375128;Ne;0;2;0;2
4;Aitvaras;"VIJURKAI (ALERG.)";1879540041;Taip;0;8;0;8
5;Aitvaras;"VIJURKAI (ALERG.)";1532588441;Taip;0;1;0;1
6;Aitvaras;"VIJURKAI (ALERG.)";8206046301;Taip;0;2;0;2
7;Aitvaras;"VIJURKAI (ALERG.)";1347364985;Taip;5;0;0;5
8;Aitvaras;"VIJURKAI (ALERG.)";9157794193;Taip;4;4;0;8
9;Aitvaras;"VIJURKAI (ALERG.)";9562494357;Taip;7;1;0;8
10;Aitvaras;"VIJURKAI (ALERG.)";6021342178;Taip;14;4;0;18
11;Aitvaras;"VIJURKAI (ALERG.)";2650483861;Taip;3;3;0;6
12;Aitvaras;"VIJURKAI (ALERG.)";2601983670;Taip;0;1;0;1
13;Aitvaras;"VIJURKAI (ALERG.)";2895663259;Taip;0;1;0;1
14;Aitvaras;"VIJURKAI (ALERG.)";6444377924;Taip;3;4;0;7
15;Aitvaras;"VIJURKAI (ALERG.)";4702400490;Taip;0;4;0;4
16;Aitvaras;"VIJURKAI (ALERG.)";8641433486;Taip;4;1;0;5
17;Aitvaras;"VIJURKAI (ALERG.)";5619137905;Taip;1;4;0;5
18;Aitvaras;"SMALSUČIAI (ALERG.)";7109001184;Ne;1;0;0;1
19;Aitvaras;"SMALSUČIAI (ALERG.)";2357399981;Taip;2;1;0;3
20;Aitvaras;"SMALSUČIAI (ALERG.)";2760970218;Taip;0;3;0;3
21;Aitvaras;"SMALSUČIAI (ALERG.)";8666824607;Taip;0;5;0;5
22;Aitvaras;"SMALSUČIAI (ALERG.)";5378212904;Taip;0;4;0;4
23;Aitvaras;"SMALSUČIAI (ALERG.)";5238819066;Taip;0;2;1;3
24;Aitvaras;"SMALSUČIAI (ALERG.)";4176681907;Taip;0;12;0;12
25;Aitvaras;"SMALSUČIAI (ALERG.)";7260577885;Taip;0;4;0;4
26;Aitvaras;"SMALSUČIAI (ALERG.)";5612991255;Taip;2;4;0;6
27;Aitvaras;"SMALSUČIAI (ALERG.)";4120515569;Taip;10;6;0;16
28;Aitvaras;"SMALSUČIAI (ALERG.)";4612994715;Taip;2;0;4;6
29;Aitvaras;"SMALSUČIAI (ALERG.)";9885781306;Taip;0;2;0;2
30;Aitvaras;"SMALSUČIAI (ALERG.)";1091372798;Taip;4;4;0;8
31;Aitvaras;"SMALSUČIAI (ALERG.)";1599183050;Taip;1;0;0;1
32;Aitvaras;"SMALSUČIAI (ALERG.)";2821221241;Taip;0;2;0;2
33;Aitvaras;PADAUŽIUKAI;8065540507;Taip;7;3;1;11
34;Aitvaras;PADAUŽIUKAI;2328771385;Taip;9;9;0;18
35;Aitvaras;PADAUŽIUKAI;6501943902;Taip;8;4;0;12
36;Aitvaras;PADAUŽIUKAI;4350590529;Taip;0;4;0;4
37;Aitvaras;PADAUŽIUKAI;7777235021;Taip;0;1;0;1
38;Aitvaras;PADAUŽIUKAI;5641224483;Taip;0;4;0;4
39;Aitvaras;PADAUŽIUKAI;6214572150;Taip;12;1;0;13
40;Aitvaras;PADAUŽIUKAI;1830134108;Taip;1;1;4;6
41;Aitvaras;PADAUŽIUKAI;3178965623;Taip;0;4;0;4
42;Aitvaras;PADAUŽIUKAI;6739827530;Taip;3;2;0;5
43;Aitvaras;PADAUŽIUKAI;3735941659;Taip;5;0;0;5
44;Aitvaras;PADAUŽIUKAI;3323458595;Taip;0;2;0;2
45;Aitvaras;PADAUŽIUKAI;2807595769;Taip;0;3;0;3
46;Aitvaras;PADAUŽIUKAI;8360380303;Taip;0;2;0;2
47;Aitvaras;PADAUŽIUKAI;1252145346;Taip;5;3;0;8
48;Aitvaras;PADAUŽIUKAI;7455895024;Taip;0;4;1;5
49;Aitvaras;PADAUŽIUKAI;8439586875;Taip;5;5;0;10
50;Aitvaras;PADAUŽIUKAI;1594675221;Taip;0;2;0;2
51;Aitvaras;"AITVARIUKAI (ALERG.)";3639102842;Taip;0;2;0;2
52;Aitvaras;"AITVARIUKAI (ALERG.)";7243387750;Taip;0;3;0;3
53;Aitvaras;"AITVARIUKAI (ALERG.)";7461284958;Taip;0;6;0;6
54;Aitvaras;"AITVARIUKAI (ALERG.)";3394251305;Taip;0;5;0;5
55;Aitvaras;"AITVARIUKAI (ALERG.)";6459307767;Taip;0;1;0;1
56;Aitvaras;"AITVARIUKAI (ALERG.)";5635576679;Taip;0;9;0;9
57;Aitvaras;"AITVARIUKAI (ALERG.)";7988247429;Taip;0;4;0;4
58;Aitvaras;"AITVARIUKAI (ALERG.)";8770777328;Taip;8;0;0;8
59;Aitvaras;"AITVARIUKAI (ALERG.)";3653879553;Taip;0;4;0;4
60;Aitvaras;"AITVARIUKAI (ALERG.)";9721273154;Taip;8;0;0;8
61;Aitvaras;"AITVARIUKAI (ALERG.)";1859647003;Taip;2;0;0;2
62;Aitvaras;"AITVARIUKAI (ALERG.)";4204923580;Taip;0;6;0;6
63;Aitvaras;"AITVARIUKAI (ALERG.)";4777266938;Taip;10;0;0;10
64;Aitvaras;"AITVARIUKAI (ALERG.)";7568388141;Taip;3;1;0;4
65;Aitvaras;"AITVARIUKAI (ALERG.)";3954840915;Taip;0;4;0;4
66;Aitvaras;"AITVARIUKAI (ALERG.)";9763502346;Taip;4;2;0;6
67;Aitvaras;"AITVARIUKAI (ALERG.)";9228736015;Taip;4;1;0;5
68;Aitvaras;"AITVARIUKAI (ALERG.)";3775634117;Taip;6;0;0;6
69;Aitvaras;"AITVARIUKAI (ALERG.)";2615576367;Ne;3;2;0;5
70;Aitvaras;"SAULĖS ZUIKUČIAI  (ALERG.)";5711324951;Taip;0;5;0;5
71;Aitvaras;"SAULĖS ZUIKUČIAI  (ALERG.)";4106097701;Taip;0;4;0;4
72;Aitvaras;"SAULĖS ZUIKUČIAI  (ALERG.)";9659883026;Taip;7;0;0;7
73;Aitvaras;"SAULĖS ZUIKUČIAI  (ALERG.)";2184231202;Ne;0;8;2;10
74;Aitvaras;"SAULĖS ZUIKUČIAI  (ALERG.)";2478737835;Taip;6;2;2;10
75;Aitvaras;"SAULĖS ZUIKUČIAI  (ALERG.)";1136438927;Taip;0;5;0;5
76;Aitvaras;"SAULĖS ZUIKUČIAI  (ALERG.)";8137900398;Taip;6;0;0;6
77;Aitvaras;"SAULĖS ZUIKUČIAI  (ALERG.)";2511844613;Taip;4;1;0;5
78;Aitvaras;"SAULĖS ZUIKUČIAI  (ALERG.)";7907357058;Taip;1;0;0;1
79;Aitvaras;"SAULĖS ZUIKUČIAI  (ALERG.)";9534206000;Taip;8;0;1;9
80;Aitvaras;"SAULĖS ZUIKUČIAI  (ALERG.)";3737054758;Taip;0;1;2;3
81;Aitvaras;"SAULĖS ZUIKUČIAI  (ALERG.)";4646876966;Taip;0;5;0;5
82;Aitvaras;"SAULĖS ZUIKUČIAI  (ALERG.)";9271534775;Taip;0;0;2;2
83;Aitvaras;"SAULĖS ZUIKUČIAI  (ALERG.)";6950820937;Taip;4;0;0;4
84;Aitvaras;"SAULĖS ZUIKUČIAI  (ALERG.)";5283056036;Taip;2;0;0;2
85;Aitvaras;"SAULĖS ZUIKUČIAI  (ALERG.)";2744696131;Taip;0;4;0;4
86;Aitvaras;"SAULĖS ZUIKUČIAI  (ALERG.)";2373509019;Taip;16;0;0;16
87;Aitvaras;"SAULĖS ZUIKUČIAI  (ALERG.)";2624566766;Taip;14;0;0;14
88;Aitvaras;"SAULĖS ZUIKUČIAI  (ALERG.)";3677551059;Ne;3;0;0;3
89;Aitvaras;"SAULĖS ZUIKUČIAI  (ALERG.)";2547934790;Taip;0;5;0;5
90;Aitvaras;"ŽEMYNUKAI (ALERG.)";8567255042;Ne;0;0;1;1
91;Aitvaras;"ŽEMYNUKAI (ALERG.)";6218019092;Taip;0;4;3;7
92;Aitvaras;"ŽEMYNUKAI (ALERG.)";7560642918;Taip;0;3;0;3
93;Aitvaras;"ŽEMYNUKAI (ALERG.)";3820930777;Taip;11;17;0;28
94;Aitvaras;"ŽEMYNUKAI (ALERG.)";6624986090;Taip;7;0;0;7
95;Aitvaras;"ŽEMYNUKAI (ALERG.)";4733627644;Taip;2;3;1;6
96;Aitvaras;"ŽEMYNUKAI (ALERG.)";3104109370;Taip;3;4;2;9
97;Aitvaras;"ŽEMYNUKAI (ALERG.)";7853714142;Taip;16;2;0;18
98;Aitvaras;"ŽEMYNUKAI (ALERG.)";1949144346;Taip;0;3;1;4
99;Aitvaras;"ŽEMYNUKAI (ALERG.)";3961423273;Taip;3;1;0;4
100;Aitvaras;"ŽEMYNUKAI (ALERG.)";9947610763;Taip;0;4;0;4
101;Aitvaras;"ŽEMYNUKAI (ALERG.)";7113016866;Taip;8;6;0;14
102;Aitvaras;"ŽEMYNUKAI (ALERG.)";4377666052;Taip;11;7;4;22
103;Aitvaras;"ŽEMYNUKAI (ALERG.)";8333823078;Taip;0;4;0;4
104;Aitvaras;"ŽEMYNUKAI (ALERG.)";5623106419;Taip;0;5;0;5
105;Aitvaras;"ŽEMYNUKAI (ALERG.)";5351333397;Taip;0;10;0;10
106;Aitvaras;"ŽEMYNUKAI (ALERG.)";2065988478;Taip;9;0;10;19
107;Aitvaras;"ŽEMYNUKAI (ALERG.)";3635354769;Taip;18;2;0;20
108;Aitvaras;"ŽEMYNUKAI (ALERG.)";3851322849;Taip;2;4;1;7
109;Aitvaras;"ŽEMYNUKAI (ALERG.)";7889947603;Taip;15;0;0;15
110;Aitvaras;"ŽEMYNUKAI (ALERG.)";1662289664;Taip;0;0;6;6
111;Aitvaras;"LINKSMUČIAI (ALERG.)";9356533125;Taip;8;0;0;8
112;Aitvaras;"LINKSMUČIAI (ALERG.)";4721229601;Taip;20;0;0;20
113;Aitvaras;"LINKSMUČIAI (ALERG.)";7598319477;Ne;4;0;1;5
114;Aitvaras;"LINKSMUČIAI (ALERG.)";2231465856;Taip;14;0;0;14
115;Aitvaras;"LINKSMUČIAI (ALERG.)";4394700961;Taip;14;0;0;14
116;Aitvaras;"LINKSMUČIAI (ALERG.)";8161320750;Taip;0;2;0;2
117;Aitvaras;"LINKSMUČIAI (ALERG.)";9006105693;Taip;14;0;2;16
118;Aitvaras;"LINKSMUČIAI (ALERG.)";7886218360;Taip;29;0;0;29
119;Aitvaras;"LINKSMUČIAI (ALERG.)";4897595828;Taip;4;0;0;4
120;Aitvaras;"LINKSMUČIAI (ALERG.)";2209078997;Taip;19;1;1;21
121;Aitvaras;"LINKSMUČIAI (ALERG.)";7463592589;Taip;7;0;0;7
122;Aitvaras;"LINKSMUČIAI (ALERG.)";5308153768;Taip;8;0;1;9
123;Aitvaras;"LINKSMUČIAI (ALERG.)";4954780185;Taip;15;0;0;15
124;Aitvaras;NAMINUKAI;3053557807;Taip;9;0;0;9
125;Aitvaras;NAMINUKAI;3347213578;Taip;0;5;0;5
126;Aitvaras;NAMINUKAI;9024245490;Taip;5;5;0;10
127;Aitvaras;NAMINUKAI;9039303562;Taip;1;2;1;4
128;Aitvaras;NAMINUKAI;6080549524;Taip;2;1;1;4
129;Aitvaras;NAMINUKAI;6048701733;Taip;0;4;0;4
130;Aitvaras;NAMINUKAI;4555281655;Ne;0;1;0;1
131;Aitvaras;NAMINUKAI;8043062737;Taip;10;5;0;15
132;Aitvaras;NAMINUKAI;3005447572;Taip;9;4;0;13
133;Aitvaras;NAMINUKAI;1549552392;Taip;5;5;0;10
134;Aitvaras;NAMINUKAI;4498792867;Taip;0;5;0;5
135;Aitvaras;NAMINUKAI;9490714865;Taip;3;1;0;4
136;Aitvaras;NAMINUKAI;1498630458;Taip;0;2;0;2
137;Aitvaras;NAMINUKAI;5967188507;Ne;0;1;0;1
138;Aitvaras;NAMINUKAI;7934344218;Taip;7;1;0;8
139;Aitvaras;NAMINUKAI;6279152796;Taip;0;4;0;4
140;Aitvaras;ŠELMIAI;4984058405;Taip;8;1;0;9
141;Aitvaras;ŠELMIAI;9725401255;Taip;15;0;0;15
142;Aitvaras;ŠELMIAI;4547342872;Taip;0;2;2;4
143;Aitvaras;ŠELMIAI;5684526288;Taip;0;1;0;1
144;Aitvaras;ŠELMIAI;7764574135;Taip;9;0;0;9
145;Aitvaras;ŠELMIAI;5601517340;Taip;0;4;0;4
146;Aitvaras;ŠELMIAI;2185746898;Taip;0;1;0;1
147;Aitvaras;ŠELMIAI;1203732956;Taip;0;5;0;5
148;Aitvaras;ŠELMIAI;5782609781;Taip;7;0;0;7
149;Aitvaras;ŠELMIAI;7805819121;Taip;4;0;0;4
150;Aitvaras;ŠELMIAI;8558414510;Taip;0;1;0;1
151;Aitvaras;ŠELMIAI;4551774368;Taip;0;1;0;1
152;Aitvaras;ŠELMIAI;7352233454;Taip;0;0;1;1
153;Aitvaras;ŠELMIAI;4812423010;Taip;8;5;0;13
154;Aitvaras;ŠELMIAI;8644983502;Taip;5;3;0;8
155;Aitvaras;ŠELMIAI;9295561516;Taip;0;1;0;1
156;Aitvaras;ŠELMIAI;6188186413;Taip;0;2;0;2
157;Aitvaras;KODĖLČIUKAI;1495399113;Taip;0;1;0;1
158;Aitvaras;KODĖLČIUKAI;4613021421;Taip;0;1;0;1
159;Aitvaras;KODĖLČIUKAI;2887681961;Taip;3;3;0;6
160;Aitvaras;KODĖLČIUKAI;4760801928;Taip;10;0;0;10
161;Aitvaras;KODĖLČIUKAI;7136674662;Taip;0;5;0;5
162;Aitvaras;KODĖLČIUKAI;7922937851;Taip;4;1;0;5
163;Aitvaras;KODĖLČIUKAI;4085134058;Taip;8;3;0;11
164;Aitvaras;KODĖLČIUKAI;8746884740;Taip;0;0;2;2
165;Aitvaras;KODĖLČIUKAI;4163871634;Taip;9;1;0;10
166;Aitvaras;KODĖLČIUKAI;3988226974;Taip;9;1;0;10
167;Aitvaras;KODĖLČIUKAI;1070324386;Taip;0;1;0;1
168;Aitvaras;KODĖLČIUKAI;1599296739;Taip;0;14;8;22
169;Aitvaras;KODĖLČIUKAI;2239387580;Taip;4;1;0;5
170;Aitvaras;KODĖLČIUKAI;9949206639;Taip;0;4;0;4
171;Aitvaras;KODĖLČIUKAI;2892898328;Taip;5;1;6;12
172;Aitvaras;KODĖLČIUKAI;3749008647;Taip;0;0;4;4
173;Aitvaras;KODĖLČIUKAI;2871973045;Taip;5;1;0;6
174;Aitvaras;KODĖLČIUKAI;9218287162;Taip;9;0;0;9
175;Aitvaras;KODĖLČIUKAI;5093291829;Taip;0;0;10;10
176;Aitvaras;KODĖLČIUKAI;6119148164;Taip;0;2;0;2
177;Aitvaras;PABIRUČIAI;5563725441;Taip;9;0;0;9
178;Aitvaras;PABIRUČIAI;9081528512;Taip;8;1;0;9
179;Aitvaras;PABIRUČIAI;9494510876;Taip;4;1;0;5
180;Aitvaras;PABIRUČIAI;6689082073;Taip;0;5;10;15
181;Aitvaras;PABIRUČIAI;4816698202;Ne;0;1;0;1
182;Aitvaras;PABIRUČIAI;2817620246;Taip;5;0;0;5
183;Aitvaras;PABIRUČIAI;6906900852;Taip;0;2;0;2
184;Aitvaras;PABIRUČIAI;4560348711;Taip;4;6;8;18
185;Aitvaras;PABIRUČIAI;4251238917;Taip;14;0;0;14
186;Aitvaras;PABIRUČIAI;8003130815;Taip;13;0;0;13
187;Aitvaras;PABIRUČIAI;2045368104;Taip;0;5;2;7
188;Aitvaras;PABIRUČIAI;6660146833;Taip;0;1;2;3
189;Aitvaras;PABIRUČIAI;1026413538;Taip;9;0;14;23
190;Aitvaras;PABIRUČIAI;1020056632;Taip;0;0;1;1
191;Aitvaras;"SVAJOKLIAI  (ALERG.)";3429046261;Taip;0;2;0;2
192;Aitvaras;"SVAJOKLIAI  (ALERG.)";5659897032;Taip;15;1;0;16
193;Aitvaras;"SVAJOKLIAI  (ALERG.)";4618560397;Taip;7;4;0;11
194;Aitvaras;"SVAJOKLIAI  (ALERG.)";9209862610;Taip;5;6;0;11
195;Aitvaras;"SVAJOKLIAI  (ALERG.)";6191938291;Taip;3;0;0;3
196;Aitvaras;"SVAJOKLIAI  (ALERG.)";7006713502;Taip;12;0;0;12
197;Aitvaras;"SVAJOKLIAI  (ALERG.)";3923601422;Taip;0;3;0;3
198;Aitvaras;"SVAJOKLIAI  (ALERG.)";5790551266;Taip;18;0;0;18
199;Aitvaras;"SVAJOKLIAI  (ALERG.)";2975696317;Taip;6;0;0;6
200;Aitvaras;"SVAJOKLIAI  (ALERG.)";8352951885;Taip;4;1;0;5
201;Aitvaras;"SVAJOKLIAI  (ALERG.)";5255843693;Taip;1;0;0;1
202;Aitvaras;"SVAJOKLIAI  (ALERG.)";1448307414;Taip;9;0;0;9
203;Aitvaras;"SVAJOKLIAI  (ALERG.)";5593105541;Taip;9;1;0;10
204;Aitvaras;"SVAJOKLIAI  (ALERG.)";8963214183;Taip;9;0;0;9
205;Aitvaras;"SVAJOKLIAI  (ALERG.)";6319953077;Taip;9;0;0;9
206;Aitvaras;"SVAJOKLIAI  (ALERG.)";4801034095;Taip;2;1;0;3
207;Aitvaras;"SVAJOKLIAI  (ALERG.)";8300788433;Taip;0;12;0;12
208;Atžalėlės;Gėlytės;4284673729;Taip;15;3;0;18
209;Atžalėlės;Gėlytės;2385614957;Taip;1;3;0;4
210;Atžalėlės;Gėlytės;5432433423;Taip;0;1;0;1
211;Atžalėlės;Gėlytės;9715625283;Taip;14;4;0;18
212;Atžalėlės;Gėlytės;4682216852;Taip;0;6;0;6
213;Atžalėlės;Gėlytės;2131592139;Taip;3;1;0;4
214;Atžalėlės;Gėlytės;3191066669;Taip;9;0;0;9
215;Atžalėlės;Gėlytės;1722233272;Taip;0;8;0;8
216;Atžalėlės;Gėlytės;5310990513;Taip;0;4;1;5
217;Atžalėlės;Gėlytės;9189223222;Taip;0;8;0;8
218;Atžalėlės;Gėlytės;3283415814;Taip;0;5;0;5
219;Atžalėlės;Gėlytės;1146492807;Taip;2;0;0;2
220;Atžalėlės;Gėlytės;3870758086;Taip;0;4;0;4
221;Atžalėlės;Gėlytės;6202250600;Taip;0;1;0;1
222;Atžalėlės;Gėlytės;4098210138;Taip;16;0;0;16
223;Atžalėlės;Gėlytės;6177038838;Taip;0;4;3;7
224;Atžalėlės;Gėlytės;5742471497;Taip;0;4;2;6
225;Atžalėlės;Gėlytės;1137741059;Taip;4;0;0;4
226;Atžalėlės;Gėlytės;4238773173;Taip;0;2;0;2
227;Atžalėlės;Gėlytės;1450609695;Taip;0;1;0;1
228;Atžalėlės;Gėlytės;6597540627;Taip;4;0;0;4
229;Atžalėlės;Drugeliai;9481268935;Taip;16;0;0;16
230;Atžalėlės;Drugeliai;3738127350;Taip;5;0;1;6
231;Atžalėlės;Drugeliai;6108989129;Taip;3;0;0;3
232;Atžalėlės;Drugeliai;1423254771;Taip;4;4;2;10
233;Atžalėlės;Drugeliai;1505286928;Taip;3;5;0;8
234;Atžalėlės;Drugeliai;7483616061;Taip;16;2;0;18
235;Atžalėlės;Drugeliai;4227804985;Taip;0;4;0;4
236;Atžalėlės;Drugeliai;9053620501;Taip;5;0;1;6
237;Atžalėlės;Drugeliai;4148412941;Taip;0;11;0;11
238;Atžalėlės;Drugeliai;7501772398;Taip;0;2;0;2
239;Atžalėlės;Drugeliai;9346744866;Taip;7;7;0;14
240;Atžalėlės;Drugeliai;1710646812;Taip;9;0;1;10
241;Atžalėlės;Drugeliai;6447615639;Taip;0;4;1;5
242;Atžalėlės;Drugeliai;5972419628;Taip;0;3;0;3
243;Atžalėlės;Gandriukai;2083260403;Taip;5;16;0;21
244;Atžalėlės;Gandriukai;3692090073;Taip;0;0;1;1
245;Atžalėlės;Gandriukai;5119260525;Taip;14;5;0;19
246;Atžalėlės;Gandriukai;4293557144;Taip;9;8;0;17
247;Atžalėlės;Gandriukai;9201449702;Taip;2;0;0;2
248;Atžalėlės;Gandriukai;2078549599;Taip;3;0;0;3
249;Atžalėlės;Voveriukai;3795729265;Taip;9;5;0;14
250;Atžalėlės;Voveriukai;8201582382;Taip;10;4;0;14
251;Atžalėlės;Voveriukai;4362058013;Taip;10;4;0;14
252;Atžalėlės;Voveriukai;8819893830;Taip;0;4;4;8
253;Atžalėlės;Voveriukai;3069192413;Taip;5;0;2;7
254;Atžalėlės;Voveriukai;5705303891;Taip;5;7;0;12
255;Atžalėlės;Voveriukai;2374624441;Taip;0;4;0;4
256;Atžalėlės;Voveriukai;1212074068;Taip;12;1;0;13
257;Atžalėlės;Voveriukai;9967641617;Taip;6;5;0;11
258;Atžalėlės;Voveriukai;6723689098;Taip;0;5;3;8
259;Atžalėlės;Voveriukai;4661388894;Taip;0;5;0;5
260;Atžalėlės;Voveriukai;9677943321;Taip;0;6;0;6
261;Atžalėlės;Voveriukai;1538643591;Taip;9;2;0;11
262;Atžalėlės;Voveriukai;9085453655;Taip;11;0;0;11
263;Atžalėlės;Voveriukai;7196464328;Taip;10;0;1;11
264;Atžalėlės;Voveriukai;7018297883;Taip;9;4;0;13
265;Atžalėlės;Voveriukai;9508110719;Taip;3;0;0;3
266;Atžalėlės;Voveriukai;5584105084;Taip;10;0;1;11
267;Atžalėlės;Voveriukai;7510951079;Taip;5;7;0;12
268;Atžalėlės;Voveriukai;8547622670;Ne;12;4;1;17
269;Atžalėlės;Voveriukai;3143856911;Taip;0;11;0;11
270;Atžalėlės;Paukšteliai;6537864486;Taip;4;0;1;5
271;Atžalėlės;Paukšteliai;8524244526;Taip;2;0;3;5
272;Atžalėlės;Paukšteliai;6873507667;Taip;0;3;0;3
273;Atžalėlės;Paukšteliai;7321516783;Taip;0;0;4;4
274;Atžalėlės;Paukšteliai;6265777690;Taip;0;8;0;8
275;Atžalėlės;Paukšteliai;1844980319;Taip;3;1;0;4
276;Atžalėlės;Paukšteliai;5997958773;Taip;0;1;0;1
277;Atžalėlės;Paukšteliai;8512283024;Taip;0;4;0;4
278;Atžalėlės;Paukšteliai;2078781673;Taip;8;1;0;9
279;Atžalėlės;Paukšteliai;1520206753;Taip;13;0;1;14
280;Atžalėlės;Paukšteliai;4790322154;Taip;9;1;0;10
281;Atžalėlės;Paukšteliai;4081717007;Taip;0;0;6;6
282;Atžalėlės;Paukšteliai;1089221288;Taip;0;0;1;1
283;Atžalėlės;Paukšteliai;7356877676;Taip;0;1;0;1
284;Atžalėlės;Paukšteliai;4392352210;Taip;4;0;0;4
285;Atžalėlės;Paukšteliai;1774212280;Taip;23;0;0;23
286;Atžalėlės;Meškiukai;9925178685;Taip;0;3;0;3
287;Atžalėlės;Meškiukai;2617568019;Taip;7;1;0;8
288;Atžalėlės;Meškiukai;4233689945;Taip;4;0;0;4
289;Atžalėlės;Meškiukai;8619613890;Taip;0;9;0;9
290;Atžalėlės;Meškiukai;3281114596;Taip;0;8;0;8
291;Atžalėlės;Meškiukai;5466374223;Taip;0;0;5;5
292;Atžalėlės;Meškiukai;2433029299;Taip;3;0;0;3
293;Atžalėlės;Meškiukai;9631336340;Taip;3;1;0;4
294;Atžalėlės;Meškiukai;2930612059;Ne;13;0;3;16
295;Atžalėlės;Meškiukai;6385777303;Ne;3;0;0;3
296;Atžalėlės;Meškiukai;2569491645;Taip;0;4;0;4
297;Atžalėlės;Meškiukai;1431197358;Taip;0;5;0;5
298;Atžalėlės;Meškiukai;4177753994;Taip;0;0;2;2
299;Atžalėlės;Meškiukai;3982090601;Taip;3;0;0;3
300;Atžalėlės;Meškiukai;3743308789;Taip;1;0;0;1
301;Atžalėlės;Meškiukai;7936991925;Taip;2;1;0;3
302;Atžalėlės;Saulutės;8460997063;Taip;4;0;0;4
303;Atžalėlės;Saulutės;6048763811;Taip;8;2;0;10
304;Atžalėlės;Saulutės;5490741021;Taip;0;2;1;3
305;Atžalėlės;Saulutės;8313999012;Taip;9;2;0;11
306;Atžalėlės;Saulutės;2291204010;Taip;3;2;0;5
307;Atžalėlės;Saulutės;2306086573;Ne;13;0;0;13
308;Atžalėlės;Saulutės;8208908249;Taip;0;7;0;7
309;Atžalėlės;Bitutės;8060332402;Taip;0;0;4;4
310;Atžalėlės;Bitutės;8396693160;Taip;0;1;0;1
311;Atžalėlės;Bitutės;1939076303;Ne;0;4;2;6
312;Atžalėlės;Bitutės;7052938312;Taip;0;1;0;1
313;Atžalėlės;Bitutės;8707875125;Ne;17;2;0;19
314;Atžalėlės;Bitutės;3559977339;Taip;5;0;0;5
315;Atžalėlės;Bitutės;2322329918;Taip;0;4;3;7
316;Atžalėlės;Bitutės;6368553568;Taip;0;5;1;6
317;Atžalėlės;Bitutės;5148142239;Taip;0;0;1;1
318;Atžalėlės;Bitutės;5593774275;Taip;15;4;0;19
319;Atžalėlės;Bitutės;5511148178;Ne;5;3;0;8
320;Atžalėlės;Bitutės;6594440062;Taip;4;0;0;4
321;Atžalėlės;Boružiukai;7104671423;Taip;15;0;0;15
322;Atžalėlės;Boružiukai;3119998745;Taip;23;0;0;23
323;Atžalėlės;Boružiukai;3198845538;Taip;9;0;0;9
324;Atžalėlės;Boružiukai;3998483465;Taip;2;0;1;3
325;Atžalėlės;Boružiukai;5582697993;Taip;0;1;0;1
326;Atžalėlės;Boružiukai;7980775632;Taip;0;4;0;4
327;Atžalėlės;Boružiukai;8681809797;Taip;7;4;0;11
328;Atžalėlės;Boružiukai;3590987364;Taip;0;0;1;1
329;Atžalėlės;Boružiukai;6237597328;Taip;10;5;0;15
330;Atžalėlės;Boružiukai;1383944713;Taip;0;1;0;1
331;Atžalėlės;Boružiukai;7091939299;Taip;22;0;0;22
332;Atžalėlės;Šypsenėlės;9736390705;Taip;6;0;0;6
333;Atžalėlės;Šypsenėlės;4071402757;Taip;0;4;1;5
334;Atžalėlės;Šypsenėlės;2032772143;Taip;0;0;5;5
335;Atžalėlės;Šypsenėlės;9487375092;Taip;11;8;0;19
336;Atžalėlės;Šypsenėlės;1943349835;Taip;0;0;4;4
337;Atžalėlės;Šypsenėlės;6828140775;Taip;6;0;4;10
338;Atžalėlės;Šypsenėlės;8564143904;Taip;18;0;3;21
339;Atžalėlės;Šypsenėlės;3299724612;Taip;0;10;0;10
340;Atžalėlės;Šypsenėlės;2271887521;Taip;5;4;4;13
341;Atžalėlės;Šypsenėlės;9707462467;Taip;0;2;0;2
342;Atžalėlės;Šypsenėlės;7159628246;Taip;2;0;1;3
343;Atžalėlės;Šypsenėlės;5822532151;Taip;12;0;1;13
344;Aušrelė;PASAKIUKAI;1754138341;Taip;0;4;0;4
345;Aušrelė;PASAKIUKAI;6913824678;Taip;0;4;0;4
346;Aušrelė;PASAKIUKAI;8542012622;Taip;10;0;0;10
347;Aušrelė;PASAKIUKAI;6463141345;Ne;0;4;0;4
348;Aušrelė;PASAKIUKAI;3713528812;Taip;5;4;0;9
349;Aušrelė;PASAKIUKAI;2221714044;Taip;0;2;1;3
350;Aušrelė;PASAKIUKAI;1949809977;Taip;0;0;1;1
351;Aušrelė;PASAKIUKAI;8126701466;Taip;0;4;2;6
352;Aušrelė;PASAKIUKAI;9733877752;Taip;0;0;1;1
353;Aušrelė;PASAKIUKAI;4591518039;Taip;0;4;0;4
354;Aušrelė;PASAKIUKAI;1798478023;Ne;6;1;0;7
355;Aušrelė;PASAKIUKAI;8573348956;Taip;4;0;0;4
356;Aušrelė;PASAKIUKAI;1607338052;Taip;0;4;1;5
357;Aušrelė;PASAKIUKAI;6577540623;Taip;5;0;0;5
358;Aušrelė;PASAKIUKAI;5460833944;Taip;8;0;0;8
359;Aušrelė;PASAKIUKAI;2311552230;Taip;4;0;0;4
360;Aušrelė;PASAKIUKAI;7130040621;Taip;0;3;5;8
361;Aušrelė;PASAKIUKAI;7208341200;Ne;0;1;0;1
362;Aušrelė;BORUŽĖLĖS;5733298006;Taip;0;10;0;10
363;Aušrelė;BORUŽĖLĖS;4565813136;Taip;5;0;2;7
364;Aušrelė;BORUŽĖLĖS;9877307844;Taip;0;5;0;5
365;Aušrelė;BORUŽĖLĖS;2873845920;Taip;0;5;0;5
366;Aušrelė;BORUŽĖLĖS;1458580523;Taip;10;1;0;11
367;Aušrelė;BORUŽĖLĖS;1463724119;Taip;0;1;0;1
368;Aušrelė;BORUŽĖLĖS;5904797250;Taip;2;0;2;4
369;Aušrelė;BORUŽĖLĖS;1871799626;Taip;17;1;0;18
370;Aušrelė;BORUŽĖLĖS;4924950592;Taip;0;1;0;1
371;Aušrelė;BORUŽĖLĖS;8947695521;Taip;0;1;0;1
372;Aušrelė;BORUŽĖLĖS;6672975558;Taip;10;0;0;10
373;Aušrelė;BORUŽĖLĖS;8799928392;Taip;0;2;0;2
374;Aušrelė;BORUŽĖLĖS;5801943729;Taip;4;5;0;9
375;Aušrelė;BORUŽĖLĖS;5866673884;Taip;0;2;0;2
376;Aušrelė;BORUŽĖLĖS;8835689988;Ne;0;7;0;7
377;Aušrelė;BORUŽĖLĖS;8689174023;Taip;19;0;0;19
378;Aušrelė;BORUŽĖLĖS;7966060521;Taip;5;0;0;5
379;Aušrelė;BORUŽĖLĖS;5358736178;Taip;0;1;5;6
380;Aušrelė;SMALSUČIAI;6761263775;Taip;1;6;0;7
381;Aušrelė;SMALSUČIAI;3015028879;Taip;0;9;0;9
382;Aušrelė;SMALSUČIAI;5935579452;Taip;0;1;0;1
383;Aušrelė;SMALSUČIAI;2863655361;Taip;0;4;0;4
384;Aušrelė;SMALSUČIAI;2390128933;Taip;3;4;1;8
385;Aušrelė;SMALSUČIAI;8503309819;Taip;15;0;0;15
386;Aušrelė;SMALSUČIAI;2827216981;Taip;0;4;0;4
387;Aušrelė;SMALSUČIAI;9443641849;Taip;0;4;0;4
388;Aušrelė;SMALSUČIAI;7930717076;Taip;0;6;3;9
389;Aušrelė;SMALSUČIAI;7609339123;Taip;0;4;0;4
390;Aušrelė;SMALSUČIAI;1556010005;Taip;0;4;1;5
391;Aušrelė;SMALSUČIAI;5478028396;Taip;3;0;0;3
392;Aušrelė;SMALSUČIAI;7070013052;Taip;12;4;0;16
393;Aušrelė;SMALSUČIAI;3581155949;Taip;0;6;1;7
394;Aušrelė;SMALSUČIAI;2266390402;Taip;0;8;0;8
395;Aušrelė;SMALSUČIAI;8032661062;Taip;0;0;1;1
396;Aušrelė;SMALSUČIAI;4262596104;Taip;13;7;0;20
397;Aušrelė;SMALSUČIAI;1976613166;Taip;0;5;0;5
398;Aušrelė;KODĖLČIUKAI;7723159748;Taip;18;1;0;19
399;Aušrelė;KODĖLČIUKAI;7367268748;Taip;5;4;0;9
400;Aušrelė;KODĖLČIUKAI;5712867880;Taip;3;0;0;3
401;Aušrelė;KODĖLČIUKAI;3623813061;Taip;0;7;0;7
402;Aušrelė;KODĖLČIUKAI;4288695809;Taip;5;0;0;5
403;Aušrelė;KODĖLČIUKAI;8693750994;Taip;5;1;0;6
404;Aušrelė;KODĖLČIUKAI;7327544406;Taip;0;5;0;5
405;Aušrelė;KODĖLČIUKAI;9566144610;Taip;0;1;0;1
406;Aušrelė;KODĖLČIUKAI;6308519574;Taip;0;3;0;3
407;Aušrelė;KODĖLČIUKAI;3320399046;Taip;1;4;0;5
408;Aušrelė;KODĖLČIUKAI;6911735462;Taip;13;4;0;17
409;Aušrelė;KODĖLČIUKAI;4248808572;Taip;11;3;0;14
410;Aušrelė;KODĖLČIUKAI;5046027475;Taip;1;4;0;5
411;Aušrelė;KODĖLČIUKAI;8338569001;Taip;8;4;0;12
412;Aušrelė;KODĖLČIUKAI;2766357229;Taip;3;2;0;5
413;Aušrelė;KODĖLČIUKAI;7515666888;Taip;0;2;0;2
414;Aušrelė;KODĖLČIUKAI;8862488358;Taip;0;4;0;4
415;Aušrelė;KODĖLČIUKAI;4882556718;Taip;2;3;0;5
416;Aušrelė;KODĖLČIUKAI;6321332888;Taip;5;4;0;9
417;Aušrelė;KODĖLČIUKAI;8341539501;Taip;0;5;0;5
418;Aušrelė;PELĖDŽIUKAI;4725588671;Taip;0;4;0;4
419;Aušrelė;PELĖDŽIUKAI;3223092149;Taip;0;10;0;10
420;Aušrelė;PELĖDŽIUKAI;8580241126;Taip;9;3;3;15
421;Aušrelė;PELĖDŽIUKAI;4227228548;Taip;0;1;0;1
422;Aušrelė;PELĖDŽIUKAI;8996445434;Taip;0;1;0;1
423;Aušrelė;PELĖDŽIUKAI;8411336992;Taip;0;4;1;5
424;Aušrelė;PELĖDŽIUKAI;8917907028;Taip;6;0;0;6
425;Aušrelė;PELĖDŽIUKAI;7494298336;Taip;9;4;0;13
426;Aušrelė;PELĖDŽIUKAI;1642358593;Ne;5;0;0;5
427;Aušrelė;PELĖDŽIUKAI;2294224426;Taip;0;5;0;5
428;Aušrelė;PELĖDŽIUKAI;1276792874;Taip;0;1;5;6
429;Aušrelė;PELĖDŽIUKAI;8210698019;Taip;5;0;0;5
430;Aušrelė;PELĖDŽIUKAI;5077189153;Taip;3;4;0;7
431;Aušrelė;AITVARIUKAI;6833654667;Taip;0;4;0;4
432;Aušrelė;AITVARIUKAI;8102749675;Taip;11;2;0;13
433;Aušrelė;AITVARIUKAI;4595435635;Taip;3;12;0;15
434;Aušrelė;AITVARIUKAI;9608444990;Taip;1;1;0;2
435;Aušrelė;AITVARIUKAI;6434548772;Taip;5;7;0;12
436;Aušrelė;AITVARIUKAI;7978186455;Taip;0;7;0;7
437;Aušrelė;AITVARIUKAI;5602774323;Taip;0;4;0;4
438;Aušrelė;AITVARIUKAI;5708459561;Taip;0;2;0;2
439;Aušrelė;AITVARIUKAI;1039180129;Taip;4;2;0;6
440;Aušrelė;AITVARIUKAI;5125295651;Taip;0;1;0;1
441;Aušrelė;AITVARIUKAI;3807967685;Taip;3;1;0;4
442;Aušrelė;AITVARIUKAI;6081100604;Taip;0;2;0;2
443;Aušrelė;AITVARIUKAI;7847650967;Taip;0;3;0;3
444;Aušrelė;AITVARIUKAI;5727081833;Taip;0;4;0;4
445;Aušrelė;AITVARIUKAI;4942168388;Taip;0;5;0;5
446;Aušrelė;AITVARIUKAI;7788139791;Taip;2;0;0;2
447;Aušrelė;BITUTĖS;1741716341;Taip;0;2;0;2
448;Aušrelė;BITUTĖS;4989544273;Taip;0;3;0;3
449;Aušrelė;BITUTĖS;9960201865;Taip;0;1;0;1
450;Aušrelė;BITUTĖS;2071674661;Ne;0;19;0;19
451;Aušrelė;BITUTĖS;1450827353;Taip;0;6;0;6
452;Aušrelė;BITUTĖS;5598494461;Taip;0;5;0;5
453;Aušrelė;BITUTĖS;4935192851;Ne;0;1;0;1
454;Aušrelė;BITUTĖS;1931955562;Taip;0;4;0;4
455;Aušrelė;BITUTĖS;6591538425;Taip;10;4;0;14
456;Aušrelė;BITUTĖS;8203256528;Taip;0;23;0;23
457;Aušrelė;BITUTĖS;5741252819;Taip;0;23;0;23
458;Aušrelė;BITUTĖS;1243825974;Taip;0;8;0;8
459;Aušrelė;BITUTĖS;2468245186;Taip;3;0;0;3
460;Aušrelė;BITUTĖS;5266959731;Taip;4;3;0;7
461;Aušrelė;BITUTĖS;2545065554;Taip;0;3;0;3
462;Aušrelė;BITUTĖS;2543313198;Taip;14;0;0;14
463;Aušrelė;BITUTĖS;3288449407;Taip;0;4;0;4
464;Aušrelė;ŽIRNIUKAI;7028068342;Taip;4;0;0;4
465;Aušrelė;ŽIRNIUKAI;9274178180;Taip;4;0;0;4
466;Aušrelė;ŽIRNIUKAI;9859520649;Ne;0;4;0;4
467;Aušrelė;ŽIRNIUKAI;1528883001;Taip;8;0;0;8
468;Aušrelė;ŽIRNIUKAI;3023414781;Taip;0;1;0;1
469;Aušrelė;ŽIRNIUKAI;2582979005;Taip;0;4;0;4
470;Aušrelė;ŽIRNIUKAI;9884818480;Taip;0;2;0;2
471;Aušrelė;ŽIRNIUKAI;5429867368;Ne;0;1;0;1
472;Aušrelė;ŽIRNIUKAI;1138257807;Taip;4;5;0;9
473;Aušrelė;ŽIRNIUKAI;1451587500;Taip;8;0;0;8
474;Aušrelė;ŽIRNIUKAI;5689460984;Taip;3;1;0;4
475;Aušrelė;ŽIRNIUKAI;4260768468;Taip;7;0;0;7
476;Aušrelė;GRYBUKAI;2466858636;Taip;23;0;0;23
477;Aušrelė;GRYBUKAI;4213141410;Taip;0;5;0;5
478;Aušrelė;GRYBUKAI;6287520834;Taip;0;3;0;3
479;Aušrelė;GRYBUKAI;2450164324;Taip;3;0;0;3
480;Aušrelė;GRYBUKAI;2236345596;Taip;3;1;1;5
481;Aušrelė;GRYBUKAI;6902592468;Taip;1;0;0;1
482;Aušrelė;GRYBUKAI;2845543931;Taip;3;3;0;6
483;Aušrelė;GRYBUKAI;4063895292;Ne;0;11;0;11
484;Aušrelė;GRYBUKAI;4719347430;Taip;0;3;0;3
485;Aušrelė;GRYBUKAI;9093567659;Taip;2;0;0;2
486;Aušrelė;GRYBUKAI;5409930406;Taip;3;4;1;8
487;Aušrelė;GRYBUKAI;7058664271;Taip;10;4;0;14
488;Aušrelė;GRYBUKAI;1934623405;Taip;2;0;0;2
489;Aušrelė;GRYBUKAI;8103112254;Taip;14;3;0;17
490;Aušrelė;GRYBUKAI;7670935967;Taip;6;2;0;8
491;Aušrelė;GRYBUKAI;9007129980;Taip;4;4;1;9
492;Aušrelė;GRYBUKAI;9075395810;Ne;13;4;2;19
493;Aušrelė;GRYBUKAI;4840787696;Taip;0;2;0;2
494;Aušrelė;DRUGELIAI;3831695455;Ne;0;1;0;1
495;Aušrelė;DRUGELIAI;2737402297;Ne;10;0;0;10
496;Aušrelė;DRUGELIAI;4464947621;Taip;18;0;0;18
497;Aušrelė;DRUGELIAI;9126040500;Taip;0;4;0;4
498;Aušrelė;DRUGELIAI;7286960315;Taip;0;4;0;4
499;Aušrelė;DRUGELIAI;8102293098;Taip;2;6;0;8
500;Aušrelė;DRUGELIAI;2266835623;Taip;4;1;0;5
501;Aušrelė;DRUGELIAI;1094141305;Taip;0;1;0;1
502;Aušrelė;DRUGELIAI;9514049590;Taip;5;0;1;6
503;Aušrelė;DRUGELIAI;5815844340;Ne;0;1;0;1
504;Aušrelė;DRUGELIAI;5668908532;Taip;0;6;0;6
505;Aušrelė;DRUGELIAI;9819729046;Taip;0;3;0;3
506;Aušrelė;DRUGELIAI;5698248175;Ne;10;0;0;10
507;Aušrelė;NYKŠTUKAI;9914518299;Taip;7;0;0;7
508;Aušrelė;NYKŠTUKAI;4297417711;Taip;5;0;2;7
509;Aušrelė;NYKŠTUKAI;7964156691;Taip;17;1;0;18
510;Aušrelė;NYKŠTUKAI;7140465960;Ne;1;0;0;1
511;Aušrelė;NYKŠTUKAI;7937067384;Taip;11;1;0;12
512;Aušrelė;NYKŠTUKAI;8099338305;Taip;12;0;0;12
513;Aušrelė;NYKŠTUKAI;6513026989;Taip;2;0;0;2
514;Aušrelė;NYKŠTUKAI;4282189556;Taip;0;1;0;1
515;Aušrelė;NYKŠTUKAI;1950091527;Taip;13;0;0;13
516;Aušrelė;NYKŠTUKAI;8378225406;Taip;3;1;1;5
517;Aušrelė;NYKŠTUKAI;3259828075;Taip;4;2;1;7
518;Aušrelė;NYKŠTUKAI;4952876188;Taip;12;0;0;12
519;Aušrelė;NYKŠTUKAI;6474867237;Taip;5;0;0;5
520;Aušrelė;NYKŠTUKAI;2645772675;Taip;15;4;0;19
521;Aušrelė;NYKŠTUKAI;8829298943;Taip;4;4;0;8
522;Aušrelė;NYKŠTUKAI;5018495543;Taip;19;0;0;19
523;Aušrelė;SPINDULIUKAI;3194122285;Taip;6;3;0;9
524;Aušrelė;SPINDULIUKAI;8801906679;Taip;8;1;0;9
525;Aušrelė;SPINDULIUKAI;1446194971;Taip;3;5;0;8
526;Aušrelė;SPINDULIUKAI;8997650487;Taip;5;0;2;7
527;Aušrelė;SPINDULIUKAI;5274919078;Taip;0;5;0;5
528;Aušrelė;SPINDULIUKAI;2981314491;Taip;9;1;0;10
529;Aušrelė;SPINDULIUKAI;8427699400;Taip;0;0;3;3
530;Aušrelė;SPINDULIUKAI;8797157671;Taip;3;0;0;3
531;Aušrelė;SPINDULIUKAI;3646395136;Taip;9;0;0;9
532;Aušrelė;SPINDULIUKAI;9973824348;Taip;11;1;0;12
533;Aušrelė;SPINDULIUKAI;8438945369;Taip;0;8;0;8
534;Aušrelė;SPINDULIUKAI;3072503569;Taip;9;4;0;13
535;Beržynėlis;SVIRPLIUKAI;7360345539;Taip;9;0;0;9
536;Beržynėlis;SVIRPLIUKAI;4134371415;Taip;9;1;0;10
537;Beržynėlis;SVIRPLIUKAI;4013099670;Taip;0;1;0;1
538;Beržynėlis;SVIRPLIUKAI;8404801225;Taip;4;0;0;4
539;Beržynėlis;SVIRPLIUKAI;7953957525;Taip;4;1;0;5
540;Beržynėlis;SVIRPLIUKAI;3418730586;Taip;0;2;0;2
541;Beržynėlis;SVIRPLIUKAI;1468551784;Taip;2;0;0;2
542;Beržynėlis;SVIRPLIUKAI;2221708263;Taip;2;1;0;3
543;Beržynėlis;SVIRPLIUKAI;8880151537;Taip;4;5;0;9
544;Beržynėlis;SVIRPLIUKAI;6516665294;Taip;2;1;0;3
545;Beržynėlis;SVIRPLIUKAI;9580286493;Taip;4;0;0;4
546;Beržynėlis;SVIRPLIUKAI;6673910279;Taip;0;1;0;1
547;Beržynėlis;SVIRPLIUKAI;8701990625;Taip;0;1;0;1
548;Beržynėlis;SVIRPLIUKAI;5027712732;Taip;12;2;0;14
549;Beržynėlis;SVIRPLIUKAI;7555487759;Taip;0;1;0;1
550;Beržynėlis;SVIRPLIUKAI;7788532819;Taip;6;0;0;6
551;Beržynėlis;SVIRPLIUKAI;3315079004;Taip;4;0;0;4
552;Beržynėlis;SVIRPLIUKAI;8533912024;Taip;10;1;0;11
553;Beržynėlis;SVIRPLIUKAI;4978363316;Taip;4;0;0;4
554;Beržynėlis;SVIRPLIUKAI;5864265458;Taip;0;2;0;2
555;Beržynėlis;PELEDŽIUKAI;6837130893;Taip;10;0;0;10
556;Beržynėlis;PELEDŽIUKAI;6337962165;Taip;0;4;0;4
557;Beržynėlis;PELEDŽIUKAI;7589778533;Taip;0;2;0;2
558;Beržynėlis;PELEDŽIUKAI;8591800387;Taip;0;4;0;4
559;Beržynėlis;PELEDŽIUKAI;2971686368;Taip;0;4;0;4
560;Beržynėlis;PELEDŽIUKAI;9409317403;Taip;0;4;0;4
561;Beržynėlis;PELEDŽIUKAI;9305279614;Taip;4;4;0;8
562;Beržynėlis;PELEDŽIUKAI;1325972861;Taip;5;0;0;5
563;Beržynėlis;PELEDŽIUKAI;5856519538;Taip;6;0;0;6
564;Beržynėlis;PELEDŽIUKAI;8114761925;Taip;2;4;0;6
565;Beržynėlis;PELEDŽIUKAI;4970999989;Taip;15;0;0;15
566;Beržynėlis;PELEDŽIUKAI;4035764376;Taip;0;3;0;3
567;Beržynėlis;PELEDŽIUKAI;5308596559;Taip;5;4;0;9
568;Beržynėlis;PELEDŽIUKAI;8881566865;Taip;0;0;1;1
569;Beržynėlis;PELEDŽIUKAI;4161974847;Taip;3;0;0;3
570;Beržynėlis;ŽIOGELIAI;7903644161;Taip;2;0;1;3
571;Beržynėlis;ŽIOGELIAI;3100097647;Taip;8;0;0;8
572;Beržynėlis;ŽIOGELIAI;1707585750;Taip;4;0;0;4
573;Beržynėlis;ŽIOGELIAI;1831776326;Taip;14;0;0;14
574;Beržynėlis;ŽIOGELIAI;1118349439;Taip;13;0;0;13
575;Beržynėlis;ŽIOGELIAI;4369803044;Taip;7;6;0;13
576;Beržynėlis;ŽIOGELIAI;6592330036;Taip;10;2;0;12
577;Beržynėlis;ŽIOGELIAI;1503903200;Taip;6;8;0;14
578;Beržynėlis;ŽIOGELIAI;3593785967;Taip;0;1;0;1
579;Beržynėlis;ŽIOGELIAI;7972993168;Taip;5;2;0;7
580;Beržynėlis;ŽIOGELIAI;5049057730;Taip;7;0;0;7
581;Beržynėlis;ŽIOGELIAI;2583982025;Taip;0;4;0;4
582;Beržynėlis;ŽIOGELIAI;6932094459;Taip;0;1;0;1
583;Beržynėlis;ŽIOGELIAI;2155662035;Taip;0;2;0;2
584;Beržynėlis;ŽIOGELIAI;7870888327;Taip;1;0;0;1
585;Beržynėlis;ŽIOGELIAI;9603272698;Taip;10;13;0;23
586;Beržynėlis;ŽIOGELIAI;9493489114;Taip;10;13;0;23
587;Beržynėlis;ŽIOGELIAI;7806800327;Taip;13;0;10;23
588;Beržynėlis;ŽVIRBLIUKAI;2193460960;Taip;0;3;0;3
589;Beržynėlis;ŽVIRBLIUKAI;2482395208;Taip;0;3;0;3
590;Beržynėlis;ŽVIRBLIUKAI;2892553878;Taip;0;5;0;5
591;Beržynėlis;ŽVIRBLIUKAI;4466393687;Taip;0;1;0;1
592;Beržynėlis;ŽVIRBLIUKAI;4774769217;Taip;0;0;4;4
593;Beržynėlis;ŽVIRBLIUKAI;8280378527;Taip;0;5;0;5
594;Beržynėlis;ŽVIRBLIUKAI;9754455116;Taip;0;4;0;4
595;Beržynėlis;ŽVIRBLIUKAI;3334994408;Taip;2;0;2;4
596;Beržynėlis;ŽVIRBLIUKAI;9777841895;Taip;0;4;0;4
597;Beržynėlis;ŽVIRBLIUKAI;6293884233;Taip;0;1;0;1
598;Beržynėlis;ŽVIRBLIUKAI;3209966996;Taip;0;4;0;4
599;Beržynėlis;ŽVIRBLIUKAI;5194416351;Taip;0;4;0;4
600;Beržynėlis;ŽVIRBLIUKAI;1228384088;Taip;2;0;0;2
601;Beržynėlis;ŽVIRBLIUKAI;5189335842;Taip;0;1;0;1
602;Beržynėlis;ŽVIRBLIUKAI;6864823739;Taip;0;6;2;8
603;Beržynėlis;ŽVIRBLIUKAI;3484188772;Ne;13;0;0;13
604;Beržynėlis;ŽIRNIUKAI;4944466205;Taip;0;1;0;1
605;Beržynėlis;ŽIRNIUKAI;2154631640;Taip;9;0;0;9
606;Beržynėlis;ŽIRNIUKAI;9899702275;Taip;1;0;0;1
607;Beržynėlis;ŽIRNIUKAI;5979829045;Taip;0;1;0;1
608;Beržynėlis;ŽIRNIUKAI;8027685774;Taip;10;2;0;12
609;Beržynėlis;ŽIRNIUKAI;2615367518;Taip;5;0;0;5
610;Beržynėlis;ŽIRNIUKAI;1986523281;Taip;10;0;0;10
611;Beržynėlis;ŽIRNIUKAI;4587584948;Taip;2;0;0;2
612;Beržynėlis;ŽIRNIUKAI;9901466559;Taip;8;0;0;8
613;Beržynėlis;VIŠČIUKAI;9480959071;Taip;8;0;0;8
614;Beržynėlis;VIŠČIUKAI;4248556027;Taip;7;0;1;8
615;Beržynėlis;VIŠČIUKAI;4308655600;Taip;0;1;0;1
616;Beržynėlis;VIŠČIUKAI;8052073990;Taip;4;0;0;4
617;Beržynėlis;VIŠČIUKAI;5630272112;Taip;0;2;1;3
618;Beržynėlis;VIŠČIUKAI;6514295883;Taip;0;0;3;3
619;Beržynėlis;VIŠČIUKAI;1051991834;Taip;9;0;0;9
620;Beržynėlis;VIŠČIUKAI;4786786104;Taip;0;3;0;3
621;Birutės;SKRUZDELIUKŲ;1761065941;Taip;0;6;0;6
622;Birutės;SKRUZDELIUKŲ;4027700332;Taip;1;0;0;1
623;Birutės;SKRUZDELIUKŲ;8636113039;Taip;4;6;0;10
624;Birutės;SKRUZDELIUKŲ;9411016611;Taip;0;4;0;4
625;Birutės;SKRUZDELIUKŲ;7119951690;Taip;3;0;0;3
626;Birutės;SKRUZDELIUKŲ;1945532852;Taip;0;4;0;4
627;Birutės;SKRUZDELIUKŲ;5154903444;Taip;1;0;0;1
628;Birutės;SKRUZDELIUKŲ;9541516589;Taip;9;0;0;9
629;Birutės;SKRUZDELIUKŲ;6815916679;Taip;12;0;0;12
630;Birutės;SKRUZDELIUKŲ;9187671201;Taip;0;3;0;3
631;Birutės;SKRUZDELIUKŲ;2140552221;Taip;0;1;0;1
632;Birutės;SKRUZDELIUKŲ;8413760872;Taip;8;0;0;8
633;Birutės;SKRUZDELIUKŲ;7940403585;Taip;0;2;0;2
634;Birutės;SKRUZDELIUKŲ;4375683234;Taip;2;0;0;2
635;Birutės;SKRUZDELIUKŲ;9904827482;Taip;5;0;0;5
636;Birutės;SKRUZDELIUKŲ;2859160609;Taip;0;4;0;4
637;Birutės;SKRUZDELIUKŲ;9479697733;Taip;0;15;0;15
638;Birutės;SKRUZDELIUKŲ;2329522074;Taip;2;3;0;5
639;Birutės;SKRUZDELIUKŲ;1072357835;Taip;0;8;0;8
640;Birutės;BITUČIŲ;2866807046;Taip;1;0;0;1
641;Birutės;BITUČIŲ;7477555732;Taip;11;0;0;11
642;Birutės;BITUČIŲ;3991168916;Taip;10;0;0;10
643;Birutės;BITUČIŲ;7859284810;Taip;1;0;0;1
644;Birutės;BITUČIŲ;3562960250;Taip;5;0;0;5
645;Birutės;BITUČIŲ;4647941243;Taip;3;10;0;13
646;Birutės;BITUČIŲ;5443447213;Taip;1;0;0;1
647;Birutės;BITUČIŲ;8736343179;Taip;8;0;0;8
648;Birutės;BITUČIŲ;9303655949;Taip;5;4;0;9
649;Birutės;BITUČIŲ;9627882026;Taip;2;0;0;2
650;Birutės;BITUČIŲ;2046634392;Taip;1;0;0;1
651;Birutės;BITUČIŲ;3993249933;Taip;9;0;0;9
652;Birutės;BITUČIŲ;4102490815;Taip;8;0;0;8
653;Birutės;BITUČIŲ;3584029960;Taip;10;0;0;10
654;Birutės;BITUČIŲ;7875884277;Taip;11;1;0;12
655;Birutės;BORUŽIUKAI;5893851353;Ne;7;0;0;7
656;Birutės;BORUŽIUKAI;5457357625;Taip;3;1;0;4
657;Birutės;BORUŽIUKAI;5869137292;Taip;6;0;0;6
658;Birutės;BORUŽIUKAI;5026442722;Taip;4;4;0;8
659;Birutės;BORUŽIUKAI;6977276295;Taip;17;0;0;17
660;Birutės;BORUŽIUKAI;9289922622;Taip;9;0;0;9
661;Birutės;BORUŽIUKAI;9263238557;Taip;0;4;0;4
662;Birutės;BORUŽIUKAI;4488481136;Taip;4;0;2;6
663;Birutės;BORUŽIUKAI;6460415179;Taip;0;4;0;4
664;Birutės;BORUŽIUKAI;6973898557;Taip;0;4;1;5
665;Birutės;BORUŽIUKAI;7033907787;Taip;4;0;0;4
666;Birutės;BORUŽIUKAI;5745377474;Taip;0;1;1;2
667;Birutės;BORUŽIUKAI;5897671273;Taip;9;0;1;10
668;Birutės;BORUŽIUKAI;7494879160;Taip;20;0;0;20
669;Birutės;BORUŽIUKAI;7712882120;Ne;4;0;0;4
670;Birutės;BORUŽIUKAI;7741922416;Taip;7;3;0;10
671;Birutės;BORUŽIUKAI;1400510886;Taip;4;3;0;7
672;Birutės;BORUŽIUKAI;1776142202;Taip;9;0;0;9
673;Birutės;BORUŽIUKAI;4906874758;Taip;0;4;0;4
674;Birutės;BORUŽIUKAI;5875585426;Taip;1;0;2;3
675;Birutės;BORUŽIUKAI;2681370776;Taip;2;5;0;7
676;Birutės;BORUŽIUKAI;7398022393;Taip;2;0;0;2
677;Birutės;DRUGELIAI;8854957814;Taip;10;0;0;10
678;Birutės;DRUGELIAI;6263985683;Taip;14;0;0;14
679;Birutės;DRUGELIAI;5957267018;Taip;9;0;2;11
680;Birutės;DRUGELIAI;1442496209;Taip;12;0;0;12
681;Birutės;DRUGELIAI;2318034045;Taip;10;0;0;10
682;Birutės;DRUGELIAI;9727836236;Ne;10;0;0;10
683;Birutės;DRUGELIAI;3516719248;Taip;5;2;1;8
684;Birutės;DRUGELIAI;5688633357;Ne;9;0;0;9
685;Birutės;DRUGELIAI;8559820030;Taip;20;0;0;20
686;Birutės;DRUGELIAI;9863681147;Taip;5;0;1;6
687;Birutės;DRUGELIAI;9307655828;Ne;7;0;0;7
688;Birutės;DRUGELIAI;3115571205;Taip;8;0;0;8
689;Birutės;DRUGELIAI;4674152995;Taip;8;0;1;9
690;Birutės;DRUGELIAI;5177528200;Taip;9;0;4;13
691;Birutės;DRUGELIAI;7876057712;Taip;7;0;1;8
692;Birutės;DRUGELIAI;6765257633;Taip;8;0;0;8
693;Birutės;DRUGELIAI;2257683802;Taip;5;0;0;5
694;Birutės;DRUGELIAI;7336936451;Taip;0;6;0;6
695;Birutės;DRUGELIAI;4995437657;Ne;4;0;2;6
696;Bitutė;Aitvariukų;5606049201;Taip;10;1;0;11
697;Bitutė;Aitvariukų;6035394425;Taip;18;7;0;25
698;Bitutė;Aitvariukų;7132616264;Taip;14;10;0;24
699;Bitutė;Aitvariukų;6030674568;Taip;15;0;3;18
700;Bitutė;Aitvariukų;9747786638;Taip;8;2;1;11
701;Bitutė;Aitvariukų;8259512455;Taip;5;4;1;10
702;Bitutė;Aitvariukų;2899217019;Taip;11;0;0;11
703;Bitutė;Aitvariukų;8670124052;Taip;6;3;3;12
704;Bitutė;Aitvariukų;1340530611;Taip;0;1;0;1
705;Bitutė;Aitvariukų;4164058783;Taip;18;0;0;18
706;Bitutė;Aitvariukų;8908052679;Taip;8;1;1;10
707;Bitutė;Aitvariukų;4924483609;Taip;0;13;0;13
708;Bitutė;Aitvariukų;7447624247;Taip;0;19;0;19
709;Bitutė;Aitvariukų;5880651175;Taip;1;2;0;3
710;Bitutė;Aitvariukų;7433169909;Taip;11;8;0;19
711;Bitutė;Ežiukų;5126303823;Taip;10;1;0;11
712;Bitutė;Ežiukų;4764586168;Ne;7;4;0;11
713;Bitutė;Ežiukų;8905075899;Taip;4;0;1;5
714;Bitutė;Ežiukų;3600670185;Taip;6;0;0;6
715;Bitutė;Ežiukų;6341806464;Taip;9;0;1;10
716;Bitutė;Ežiukų;2812580726;Taip;2;3;0;5
717;Bitutė;Ežiukų;8186706520;Taip;0;33;0;33
718;Bitutė;Ežiukų;2122052883;Taip;21;0;1;22
719;Bitutė;Ežiukų;4444523140;Taip;2;3;4;9
720;Bitutė;Ežiukų;4024758152;Taip;0;4;0;4
721;Bitutė;Ežiukų;6194712643;Taip;0;4;0;4
722;Bitutė;Ežiukų;4468366941;Taip;5;0;1;6
723;Bitutė;Ežiukų;5188828679;Taip;7;6;0;13
724;Bitutė;Ežiukų;8109028957;Taip;3;6;0;9
725;Bitutė;Ežiukų;3156654672;Ne;4;0;0;4
726;Bitutė;Ežiukų;9106644834;Taip;5;4;3;12
727;Bitutė;Ežiukų;1397711778;Taip;4;0;0;4
728;Bitutė;Ežiukų;5146691157;Taip;3;0;0;3
729;Bitutė;Žvirbliukų;1290146001;Taip;8;2;0;10
730;Bitutė;Žvirbliukų;6226996242;Taip;9;1;0;10
731;Bitutė;Žvirbliukų;1460746240;Taip;0;2;0;2
732;Bitutė;Žvirbliukų;3359918177;Taip;1;0;0;1
733;Bitutė;Žvirbliukų;9352292654;Taip;0;0;5;5
734;Bitutė;Žvirbliukų;2819417600;Taip;5;4;0;9
735;Bitutė;Žvirbliukų;5421744666;Taip;0;0;1;1
736;Bitutė;Žvirbliukų;9780599803;Taip;6;5;0;11
737;Bitutė;Žvirbliukų;7741454857;Taip;5;0;0;5
738;Bitutė;Žvirbliukų;6091108131;Taip;8;0;0;8
739;Bitutė;Žvirbliukų;4617493676;Taip;7;0;2;9
740;Bitutė;Žvirbliukų;3860047703;Taip;11;2;0;13
741;Bitutė;Žvirbliukų;5375847129;Taip;0;3;0;3
742;Bitutė;Žvirbliukų;3806852067;Taip;15;10;0;25
743;Bitutė;Žvirbliukų;3528436838;Taip;5;1;0;6
744;Bitutė;Žvirbliukų;2583001947;Taip;9;0;1;10
745;Bitutė;Žvirbliukų;2129484313;Ne;9;0;0;9
746;Bitutė;Žvirbliukų;2144809294;Ne;10;0;2;12
747;Bitutė;Žvirbliukų;7013249141;Taip;19;0;2;21
748;Bitutė;Žvirbliukų;4524571780;Taip;6;0;0;6
749;Bitutė;Gandriukų;8373296210;Taip;14;0;0;14
750;Bitutė;Gandriukų;8789574593;Taip;13;0;1;14
751;Bitutė;Gandriukų;1985958540;Taip;0;2;0;2
752;Bitutė;Gandriukų;8743960488;Taip;0;3;0;3
753;Bitutė;Gandriukų;9451529077;Taip;4;4;0;8
754;Bitutė;Gandriukų;9217178863;Taip;7;0;0;7
755;Bitutė;Gandriukų;9337144831;Taip;15;4;0;19
756;Bitutė;Gandriukų;4639968278;Taip;2;1;0;3
757;Bitutė;Gandriukų;1907876695;Taip;0;4;0;4
758;Bitutė;Gandriukų;7720798466;Taip;0;4;0;4
759;Bitutė;Gandriukų;1662815358;Taip;0;5;0;5
760;Bitutė;Gandriukų;1733189730;Ne;0;6;0;6
761;Bitutė;Gandriukų;4566919587;Taip;0;7;0;7
762;Bitutė;Gandriukų;9966437881;Taip;0;4;0;4
763;Bitutė;Gandriukų;1241863345;Taip;3;9;0;12
764;Bitutė;Gandriukų;9465186207;Taip;0;3;2;5
765;Bitutė;Pelėdžiukai;2444289145;Taip;0;0;2;2
766;Bitutė;Pelėdžiukai;3517750478;Taip;0;6;0;6
767;Bitutė;Pelėdžiukai;3804171750;Taip;0;4;0;4
768;Bitutė;Pelėdžiukai;8545377054;Taip;5;2;0;7
769;Bitutė;Pelėdžiukai;5406667195;Taip;2;5;0;7
770;Bitutė;Pelėdžiukai;4458990772;Taip;3;1;1;5
771;Bitutė;Pelėdžiukai;3723040682;Taip;0;7;0;7
772;Bitutė;Pelėdžiukai;5291764696;Taip;0;1;1;2
773;Bitutė;Pelėdžiukai;6014726741;Taip;0;2;0;2
774;Bitutė;Pelėdžiukai;4527880105;Taip;2;3;4;9
775;Bitutė;Pelėdžiukai;2190439190;Taip;9;0;0;9
776;Bitutė;Pelėdžiukai;9834697190;Taip;0;19;0;19
777;Bitutė;Pelėdžiukai;7113693496;Taip;16;4;1;21
778;Bitutė;Pelėdžiukai;9523588597;Taip;1;0;0;1
779;Bitutė;Pelėdžiukai;7047262367;Taip;5;1;0;6
780;Bitutė;Pelėdžiukai;4177331531;Taip;1;3;0;4
781;Bitutė;Pelėdžiukai;2483462846;Taip;0;1;0;1
782;Bitutė;Pelėdžiukai;9166624750;Taip;0;3;1;4
783;Bitutė;Pelėdžiukai;8373105196;Taip;9;4;0;13
784;Bitutė;Pelėdžiukai;6044969600;Taip;0;4;0;4
785;Bitutė;Pelėdžiukai;3654065124;Taip;5;0;1;6
786;Bitutė;Boružėlių;8276590981;Ne;22;0;4;26
787;Bitutė;Boružėlių;3026526421;Taip;5;4;0;9
788;Bitutė;Boružėlių;7503203424;Taip;23;0;3;26
789;Bitutė;Boružėlių;1711888057;Taip;11;0;0;11
790;Bitutė;Boružėlių;8355346371;Taip;16;0;0;16
791;Bitutė;Boružėlių;9545405359;Taip;13;0;0;13
792;Bitutė;Boružėlių;9691450767;Taip;6;0;0;6
793;Bitutė;Boružėlių;3170266155;Taip;14;0;5;19
794;Bitutė;Boružėlių;6455582149;Taip;4;0;0;4
795;Bitutė;Boružėlių;8011051470;Taip;12;0;2;14
796;Bitutė;Boružėlių;9521938997;Taip;9;0;1;10
797;Bitutė;Boružėlių;9668365838;Taip;10;7;0;17
798;Bitutė;Boružėlių;3870675531;Taip;2;0;0;2
799;Bitutė;Boružėlių;7095475821;Taip;5;0;0;5
800;Bitutė;Boružėlių;6255439813;Taip;22;0;0;22
801;Bitutė;Boružėlių;2623999429;Taip;5;5;0;10
802;Bitutė;Boružėlių;6840722112;Taip;18;0;1;19
803;Bitutė;Boružėlių;4884898917;Taip;11;0;0;11
804;Bitutė;Boružėlių;4869423833;Taip;16;0;1;17
805;Bitutė;Boružėlių;5071978105;Taip;5;0;0;5
806;Bitutė;Šokliukų;8211710975;Taip;8;1;0;9
807;Bitutė;Šokliukų;8872286273;Taip;0;2;0;2
808;Bitutė;Šokliukų;5169768042;Taip;9;9;0;18
809;Bitutė;Šokliukų;1348548294;Taip;21;4;0;25
810;Bitutė;Šokliukų;7318555933;Taip;5;3;0;8
811;Bitutė;Šokliukų;1012702386;Taip;5;0;0;5
812;Bitutė;Šokliukų;9924340801;Taip;0;9;0;9
813;Bitutė;Šokliukų;7165511381;Taip;6;7;0;13
814;Bitutė;Šokliukų;2853616585;Taip;0;4;0;4
815;Bitutė;Šokliukų;5109258680;Taip;0;1;0;1
816;Bitutė;Šokliukų;8439759353;Ne;0;1;0;1
817;Bitutė;Šokliukų;3417576747;Taip;9;1;0;10
818;Bitutė;Šokliukų;8422448947;Taip;0;2;0;2
819;Bitutė;Šokliukų;7926482326;Taip;0;11;0;11
820;Bitutė;Šokliukų;5876700984;Taip;4;2;0;6
821;Bitutė;Šokliukų;2177537591;Taip;6;3;0;9
822;Bitutė;Šokliukų;5759407291;Ne;6;2;0;8
823;Bitutė;Šokliukų;4471813998;Taip;0;3;0;3
824;Bitutė;Šokliukų;9234090775;Taip;0;9;0;9
825;Bitutė;Drugelių;9094567866;Taip;0;0;3;3
826;Bitutė;Drugelių;5759595005;Taip;23;0;0;23
827;Bitutė;Drugelių;2085899696;Ne;5;0;0;5
828;Bitutė;Drugelių;2029309955;Taip;0;2;0;2
829;Bitutė;Drugelių;7376746010;Taip;9;0;0;9
830;Bitutė;Drugelių;5845408472;Taip;5;2;0;7
831;Bitutė;Drugelių;3611348253;Taip;0;0;3;3
832;Bitutė;Drugelių;8727525320;Taip;0;0;3;3
833;Bitutė;Drugelių;5796600501;Taip;0;0;2;2
834;Bitutė;Drugelių;1558826102;Taip;12;0;0;12
835;Bitutė;Drugelių;6325890676;Taip;29;0;0;29
836;Bitutė;Drugelių;2848732083;Taip;5;1;0;6
837;Bitutė;Drugelių;5278510767;Taip;0;3;0;3
838;Bitutė;Drugelių;8962725357;Taip;3;1;0;4
839;Bitutė;Drugelių;5471241132;Taip;3;1;2;6
840;Bitutė;Drugelių;1218462939;Ne;6;2;0;8
841;Bitutė;Drugelių;8008237092;Taip;13;4;4;21
842;Bitutė;Drugelių;4545188971;Taip;24;1;0;25
843;Bitutė;Kiškučių;3603716923;Taip;9;4;0;13
844;Bitutė;Kiškučių;5181958187;Ne;0;6;0;6
845;Bitutė;Kiškučių;1715987321;Taip;3;0;0;3
846;Bitutė;Kiškučių;4480187618;Taip;9;0;0;9
847;Bitutė;Kiškučių;4926289620;Taip;10;0;1;11
848;Bitutė;Kiškučių;7694916340;Taip;7;0;1;8
849;Bitutė;Kiškučių;5061164237;Taip;12;0;0;12
850;Bitutė;Kiškučių;8130382253;Taip;4;1;0;5
851;Bitutė;Kiškučių;5869737425;Taip;9;0;0;9
852;Bitutė;Kiškučių;5220694242;Taip;0;3;0;3
853;Bitutė;Kiškučių;8303932330;Ne;18;0;0;18
854;Bitutė;Kiškučių;8642411661;Taip;4;8;0;12
855;Bitutė;Kiškučių;1198024852;Taip;11;1;0;12
856;Bitutė;Kiškučių;9909017070;Taip;13;0;0;13
857;Bitutė;Kiškučių;3811028304;Ne;8;9;0;17
858;Bitutė;Kiškučių;9592567172;Taip;7;0;0;7
859;Bitutė;Kiškučių;7535583229;Taip;0;2;0;2
860;Bitutė;Kiškučių;7619112317;Taip;4;4;0;8
861;Bitutė;Kiškučių;8896842164;Taip;5;1;0;6
862;Bitutė;Kiškučių;8561037889;Taip;0;3;0;3
863;Bitutė;"Viščiukų ";2707925569;Taip;5;0;0;5
864;Bitutė;"Viščiukų ";7566001042;Taip;8;0;0;8
865;Bitutė;"Viščiukų ";9872069356;Taip;10;0;0;10
866;Bitutė;"Viščiukų ";7341046095;Taip;10;0;0;10
867;Bitutė;"Viščiukų ";9325422338;Taip;17;9;0;26
868;Bitutė;"Viščiukų ";1147029462;Taip;11;1;0;12
869;Bitutė;"Viščiukų ";9653424274;Ne;12;4;0;16
870;Bitutė;"Viščiukų ";3318389039;Taip;14;0;0;14
871;Bitutė;"Viščiukų ";7301966217;Taip;15;0;0;15
872;Bitutė;"Viščiukų ";4864590214;Taip;18;0;0;18
873;Bitutė;"Viščiukų ";5111232226;Taip;4;9;0;13
874;Bitutė;"Viščiukų ";7384402285;Taip;16;0;0;16
875;Bitutė;"Viščiukų ";6045476884;Taip;8;4;0;12
876;Bitutė;"Viščiukų ";3318389039;Taip;9;0;0;9
877;Bitutė;"Viščiukų ";2368846393;Ne;0;2;0;2
878;Bitutė;"Viščiukų ";4041036896;Taip;2;0;0;2
879;Bitutė;"Skruzdėliukai ";5686278261;Taip;10;2;0;12
880;Bitutė;"Skruzdėliukai ";1423694056;Taip;0;0;1;1
881;Bitutė;"Skruzdėliukai ";5942493696;Taip;2;1;0;3
882;Bitutė;"Skruzdėliukai ";6311396261;Taip;4;5;0;9
883;Bitutė;"Skruzdėliukai ";7145036085;Taip;12;0;1;13
884;Bitutė;"Skruzdėliukai ";2252157473;Taip;9;0;1;10
885;Bitutė;"Skruzdėliukai ";6169426273;Taip;5;0;0;5
886;Bitutė;"Skruzdėliukai ";4513783927;Taip;11;0;0;11
887;Bitutė;"Skruzdėliukai ";8667259778;Taip;13;0;4;17
888;Bitutė;"Skruzdėliukai ";8607718704;Taip;2;0;0;2
889;Bitutė;"Skruzdėliukai ";4413880918;Taip;5;0;0;5
890;Bitutė;"Skruzdėliukai ";9436414962;Taip;12;0;0;12
891;Bitutė;"Skruzdėliukai ";9864771568;Taip;20;0;2;22
892;Bitutė;"Skruzdėliukai ";6353690252;Taip;15;0;0;15
893;Bitutė;"Skruzdėliukai ";2160735504;Taip;9;0;0;9
894;Bitutė;"Skruzdėliukai ";1387310054;Taip;5;0;1;6
895;Bitutė;"Skruzdėliukai ";7245807233;Taip;0;0;5;5
896;Bitutė;"Skruzdėliukai ";5433617195;Taip;0;5;0;5
897;Bitutė;"Skruzdėliukai ";2391170362;Taip;13;0;0;13
898;Bitutė;"Skruzdėliukai ";5490753578;Ne;6;0;1;7
899;Bitutė;"Nykštukų ";1124437382;Taip;5;4;0;9
900;Bitutė;"Nykštukų ";1677780832;Taip;0;4;0;4
901;Bitutė;"Nykštukų ";7093067437;Taip;14;0;0;14
902;Bitutė;"Nykštukų ";7494665747;Taip;0;2;1;3
903;Bitutė;"Nykštukų ";9392119453;Taip;0;31;0;31
904;Bitutė;"Nykštukų ";7618391238;Taip;0;2;0;2
905;Bitutė;"Nykštukų ";7201520408;Taip;0;33;0;33
906;Bitutė;"Nykštukų ";3564872382;Taip;12;0;0;12
907;Bitutė;"Nykštukų ";2779363539;Taip;19;0;0;19
908;Bitutė;"Nykštukų ";1094120235;Taip;11;0;0;11
909;Bitutė;"Nykštukų ";8344844253;Taip;7;0;0;7
910;Bitutė;"Nykštukų ";4341037730;Taip;11;0;0;11
911;Bitutė;"Nykštukų ";6591026369;Taip;3;0;0;3
912;Bitutė;"Nykštukų ";3430153178;Taip;10;2;0;12
913;Bitutė;"Nykštukų ";3938392405;Taip;3;0;0;3
914;Bitutė;"Nykštukų ";5974397461;Taip;0;3;0;3
915;Coliukė;"Bitutės (A.Kojelavičiaus g. 298)";6725408547;Taip;0;1;0;1
916;Coliukė;"Bitutės (A.Kojelavičiaus g. 298)";2167230398;Taip;0;4;0;4
917;Coliukė;"Bitutės (A.Kojelavičiaus g. 298)";5349969025;Taip;2;0;0;2
918;Coliukė;"Bitutės (A.Kojelavičiaus g. 298)";8767261039;Taip;2;1;0;3
919;Coliukė;"Bitutės (A.Kojelavičiaus g. 298)";7345905007;Taip;7;1;0;8
920;Coliukė;"Bitutės (A.Kojelavičiaus g. 298)";1968467455;Taip;0;5;0;5
921;Coliukė;"Bitutės (A.Kojelavičiaus g. 298)";9462610674;Taip;0;6;0;6
922;Coliukė;"Bitutės (A.Kojelavičiaus g. 298)";4188233426;Taip;0;4;0;4
923;Coliukė;"Bitutės (A.Kojelavičiaus g. 298)";9331485675;Taip;0;0;1;1
924;Coliukė;"Bitutės (A.Kojelavičiaus g. 298)";2275327607;Taip;0;1;0;1
925;Coliukė;"Bitutės (A.Kojelavičiaus g. 298)";9879369365;Taip;0;7;0;7
926;Coliukė;"Bitutės (A.Kojelavičiaus g. 298)";4845247006;Taip;4;2;0;6
927;Coliukė;"Bitutės (A.Kojelavičiaus g. 298)";9885547263;Taip;7;0;0;7
928;Coliukė;"Bitutės (A.Kojelavičiaus g. 298)";8149118599;Taip;0;1;0;1
929;Coliukė;"Bitutės (A.Kojelavičiaus g. 298)";7358018315;Taip;16;1;0;17
930;Coliukė;"Bitutės (A.Kojelavičiaus g. 298)";9688432169;Taip;4;4;0;8
931;Coliukė;"Bitutės (A.Kojelavičiaus g. 298)";8478006305;Taip;0;0;11;11
932;Coliukė;"Bitutės (A.Kojelavičiaus g. 298)";9352547729;Taip;8;0;0;8
933;Coliukė;"Bitutės (A.Kojelavičiaus g. 298)";9750447455;Taip;13;0;0;13
934;Coliukė;"Bitutės (A.Kojelavičiaus g. 298)";7621095517;Taip;5;0;0;5
935;Coliukė;"Bitutės (A.Kojelavičiaus g. 298)";2385917598;Taip;12;0;0;12
936;Coliukė;"Bitutės (A.Kojelavičiaus g. 298)";1390751418;Taip;12;0;0;12
937;Coliukė;"Bitutės (A.Kojelavičiaus g. 298)";4881447596;Taip;0;5;0;5
938;Coliukė;"Bitutės (A.Kojelavičiaus g. 298)";2151108735;Taip;15;1;0;16
939;Coliukė;"Boružėlės.spec. (Karklėnų g. 15)";5756690199;Taip;9;0;0;9
940;Coliukė;"Boružėlės.spec. (Karklėnų g. 15)";4422823135;Ne;11;0;0;11
941;Coliukė;"Boružėlės.spec. (Karklėnų g. 15)";2947495861;Ne;13;0;0;13
942;Coliukė;"Boružėlės.spec. (Karklėnų g. 15)";5008183731;Taip;5;2;0;7
943;Coliukė;"Boružėlės.spec. (Karklėnų g. 15)";1134875499;Taip;2;0;0;2
944;Coliukė;"Boružėlės.spec. (Karklėnų g. 15)";2351866339;Taip;1;0;0;1
945;Coliukė;"Boružėlės.spec. (Karklėnų g. 15)";8347206534;Ne;4;0;0;4
946;Coliukė;"Boružėlės.spec. (Karklėnų g. 15)";3270283626;Taip;11;0;0;11
947;Coliukė;"Boružėlės.spec. (Karklėnų g. 15)";1326014786;Taip;23;0;0;23
948;Coliukė;"Boružėlės.spec. (Karklėnų g. 15)";7513522378;Taip;4;3;0;7
949;Coliukė;"Boružėlės.spec. (Karklėnų g. 15)";3905904092;Taip;5;0;0;5
950;Coliukė;"Boružėlės.spec. (Karklėnų g. 15)";6534433593;Taip;8;0;0;8
951;Coliukė;"Nykštukai (A.Kojelavičiaus g. 298)";4149083597;Taip;9;0;0;9
952;Coliukė;"Nykštukai (A.Kojelavičiaus g. 298)";5481656345;Taip;6;5;0;11
953;Coliukė;"Nykštukai (A.Kojelavičiaus g. 298)";2379680426;Taip;9;0;1;10
954;Coliukė;"Nykštukai (A.Kojelavičiaus g. 298)";6483218499;Taip;8;0;0;8
955;Coliukė;"Nykštukai (A.Kojelavičiaus g. 298)";4887837499;Taip;7;0;0;7
956;Coliukė;"Nykštukai (A.Kojelavičiaus g. 298)";1465212393;Taip;13;3;0;16
957;Coliukė;"Nykštukai (A.Kojelavičiaus g. 298)";1516038730;Taip;9;0;0;9
958;Coliukė;"Nykštukai (A.Kojelavičiaus g. 298)";7164457313;Taip;4;0;1;5
959;Coliukė;"Nykštukai (A.Kojelavičiaus g. 298)";6441253648;Taip;0;6;0;6
960;Coliukė;"Nykštukai (A.Kojelavičiaus g. 298)";4537756081;Ne;0;10;0;10
961;Coliukė;"Nykštukai (A.Kojelavičiaus g. 298)";3719547522;Taip;3;4;0;7
962;Coliukė;"Nykštukai (A.Kojelavičiaus g. 298)";5450167562;Taip;2;3;0;5
963;Coliukė;"Nykštukai (A.Kojelavičiaus g. 298)";3384332079;Taip;4;0;1;5
964;Coliukė;"Nykštukai (A.Kojelavičiaus g. 298)";1198781036;Ne;0;4;0;4
965;Coliukė;"Nykštukai (A.Kojelavičiaus g. 298)";9334564869;Taip;6;0;0;6
966;Coliukė;"Nykštukai (A.Kojelavičiaus g. 298)";3140659021;Ne;0;0;17;17
967;Coliukė;"Nykštukai (A.Kojelavičiaus g. 298)";2321127662;Taip;1;0;7;8
968;Coliukė;"Nykštukai (A.Kojelavičiaus g. 298)";1575061659;Taip;2;0;0;2
969;Coliukė;"Nykštukai (A.Kojelavičiaus g. 298)";3908791146;Taip;9;0;0;9
970;Coliukė;"Nykštukai (A.Kojelavičiaus g. 298)";4635299740;Taip;0;11;0;11
971;Coliukė;"Gėlytės (A.Kojelavičiaus g. 304) ";1415007991;Taip;4;0;0;4
972;Coliukė;"Gėlytės (A.Kojelavičiaus g. 304) ";3712638808;Taip;2;0;0;2
973;Coliukė;"Gėlytės (A.Kojelavičiaus g. 304) ";7500857860;Taip;23;0;0;23
974;Coliukė;"Gėlytės (A.Kojelavičiaus g. 304) ";2952029073;Taip;4;0;0;4
975;Coliukė;"Gėlytės (A.Kojelavičiaus g. 304) ";4757165137;Taip;8;0;0;8
976;Coliukė;"Gėlytės (A.Kojelavičiaus g. 304) ";3693899535;Taip;14;0;0;14
977;Coliukė;"Gėlytės (A.Kojelavičiaus g. 304) ";3419764892;Taip;0;3;0;3
978;Coliukė;"Gėlytės (A.Kojelavičiaus g. 304) ";7259282073;Taip;11;0;0;11
979;Coliukė;"Gėlytės (A.Kojelavičiaus g. 304) ";4327259627;Taip;2;4;0;6
980;Coliukė;"Drugeliai  (A.Kojelavičiaus g. 304)  ";6675290003;Taip;22;0;0;22
981;Coliukė;"Drugeliai  (A.Kojelavičiaus g. 304)  ";8202294275;Taip;10;0;0;10
982;Coliukė;"Drugeliai  (A.Kojelavičiaus g. 304)  ";8849541084;Taip;0;6;0;6
983;Coliukė;"Drugeliai  (A.Kojelavičiaus g. 304)  ";8756465257;Taip;0;5;0;5
984;Coliukė;"Drugeliai  (A.Kojelavičiaus g. 304)  ";6102405328;Taip;15;0;0;15
985;Coliukė;"Drugeliai  (A.Kojelavičiaus g. 304)  ";1861955437;Taip;6;0;0;6
986;Coliukė;"Drugeliai  (A.Kojelavičiaus g. 304)  ";1220834062;Taip;0;4;0;4
987;Coliukė;"Drugeliai  (A.Kojelavičiaus g. 304)  ";3392367716;Taip;0;2;0;2
988;Coliukė;"Drugeliai  (A.Kojelavičiaus g. 304)  ";8698370746;Taip;2;1;0;3
989;Coliukė;"Drugeliai  (A.Kojelavičiaus g. 304)  ";6611713551;Taip;8;0;0;8
990;Coliukė;"Drugeliai  (A.Kojelavičiaus g. 304)  ";6755886435;Taip;7;0;0;7
991;Coliukė;"Drugeliai  (A.Kojelavičiaus g. 304)  ";1220385522;Taip;2;0;0;2
992;Coliukė;"Drugeliai  (A.Kojelavičiaus g. 304)  ";1452034828;Taip;0;1;0;1
993;Coliukė;"Drugeliai  (A.Kojelavičiaus g. 304)  ";6816085304;Taip;0;14;0;14
994;Coliukė;"Drugeliai  (A.Kojelavičiaus g. 304)  ";6941719947;Taip;0;1;0;1
995;Coliukė;"Drugeliai  (A.Kojelavičiaus g. 304)  ";5347456579;Taip;6;0;0;6
996;Coliukė;"Drugeliai  (A.Kojelavičiaus g. 304)  ";8606195508;Taip;10;0;0;10
997;Coliukė;"Drugeliai  (A.Kojelavičiaus g. 304)  ";2247086548;Taip;6;0;0;6
998;Čiauškutis;BITUTĖS;7893181156;Taip;2;1;0;3
999;Čiauškutis;BITUTĖS;7976738303;Ne;0;0;2;2
1000;Čiauškutis;BITUTĖS;4026881335;Taip;16;0;0;16
1001;Čiauškutis;BITUTĖS;9753680961;Taip;5;5;0;10
1002;Čiauškutis;BITUTĖS;4852837431;Taip;0;1;1;2
1003;Čiauškutis;BITUTĖS;4652951382;Ne;0;0;10;10
1004;Čiauškutis;BITUTĖS;3837360101;Taip;5;0;0;5
1005;Čiauškutis;BITUTĖS;2319237497;Taip;0;0;5;5
1006;Čiauškutis;BITUTĖS;1765857419;Taip;0;5;0;5
1007;Čiauškutis;BITUTĖS;7282041196;Taip;5;17;1;23
1008;Čiauškutis;ŽVIRBLIUKAI;5125518366;Taip;9;0;10;19
1009;Čiauškutis;ŽVIRBLIUKAI;4962200863;Taip;3;0;1;4
1010;Čiauškutis;ŽVIRBLIUKAI;9759888353;Taip;0;0;1;1
1011;Čiauškutis;ŽVIRBLIUKAI;1032711865;Taip;7;0;0;7
1012;Čiauškutis;ŽVIRBLIUKAI;4599018314;Taip;7;0;3;10
1013;Čiauškutis;ŽVIRBLIUKAI;1288177637;Taip;6;0;2;8
1014;Čiauškutis;ŽVIRBLIUKAI;6103657328;Ne;4;0;0;4
1015;Čiauškutis;ŽVIRBLIUKAI;7359935733;Taip;4;0;0;4
1016;Čiauškutis;ŽVIRBLIUKAI;5368435217;Taip;0;0;5;5
1017;Čiauškutis;SAULUTĖS;1158816422;Taip;0;23;0;23
1018;Čiauškutis;SAULUTĖS;7489733038;Taip;0;0;6;6
1019;Čiauškutis;SAULUTĖS;2237570705;Taip;4;0;1;5
1020;Čiauškutis;SAULUTĖS;3724324861;Taip;0;23;0;23
1021;Čiauškutis;SAULUTĖS;8580034134;Taip;0;0;6;6
1022;Čiauškutis;SAULUTĖS;9410262802;Taip;0;0;2;2
1023;Čiauškutis;SAULUTĖS;2445742257;Taip;9;12;2;23
1024;Čiauškutis;SAULUTĖS;7428833348;Taip;0;0;5;5
1025;Čiauškutis;EŽIUKAI;9565722619;Taip;0;7;0;7
1026;Čiauškutis;EŽIUKAI;7654242839;Taip;3;1;5;9
1027;Čiauškutis;EŽIUKAI;6303770262;Taip;16;0;0;16
1028;Čiauškutis;DRUGELIAI;4681902267;Taip;0;1;5;6
1029;Čiauškutis;DRUGELIAI;1928404791;Taip;4;0;2;6
1030;Čiauškutis;DRUGELIAI;7746580858;Taip;10;0;0;10
1031;Čiauškutis;DRUGELIAI;1234494170;Taip;8;0;0;8
1032;Čiauškutis;DRUGELIAI;5404165993;Taip;4;4;0;8
1033;Čiauškutis;DRUGELIAI;9897499968;Taip;0;21;2;23
1034;Čiauškutis;DRUGELIAI;7630342576;Taip;6;0;0;6
1035;Čiauškutis;DRUGELIAI;7135435979;Ne;2;4;1;7
1036;Čiauškutis;DRUGELIAI;6726124641;Taip;0;3;0;3
1037;Čiauškutis;GENELIAI;5957587644;Taip;4;0;0;4
1038;Čiauškutis;GENELIAI;5052137859;Taip;0;23;0;23
1039;Čiauškutis;GENELIAI;8876608072;Taip;0;0;6;6
1040;Čiauškutis;GENELIAI;3650541072;Taip;0;0;2;2
1041;Čiauškutis;GENELIAI;6785604459;Taip;17;6;0;23
1042;Čiauškutis;GENELIAI;8679018030;Ne;12;4;2;18
1043;Čiauškutis;GENELIAI;7851357992;Ne;9;2;1;12
1044;Čiauškutis;GENELIAI;7928675053;Taip;0;23;0;23
1045;Čiauškutis;GENELIAI;3644842573;Taip;1;0;0;1
1046;Čiauškutis;GENELIAI;1113437256;Taip;6;4;1;11
1047;Čiauškutis;LINKSMUČIAI;8689127061;Taip;5;4;2;11
1048;Čiauškutis;LINKSMUČIAI;9062135043;Taip;0;4;1;5
1049;Čiauškutis;LINKSMUČIAI;5910818962;Ne;10;4;0;14
1050;Čiauškutis;LINKSMUČIAI;4881821738;Taip;14;0;0;14
1051;Čiauškutis;LINKSMUČIAI;4881821738;Taip;14;0;0;14
1052;Čiauškutis;LINKSMUČIAI;6146321785;Taip;0;0;3;3
1053;Čiauškutis;LINKSMUČIAI;6434727608;Taip;6;0;0;6
1054;Čiauškutis;LINKSMUČIAI;1733251156;Taip;0;4;1;5
1055;Čiauškutis;KIŠKUČIAI;1900086424;Taip;0;1;0;1
1056;Čiauškutis;KIŠKUČIAI;3465024013;Taip;11;12;0;23
1057;Čiauškutis;KIŠKUČIAI;2271458332;Taip;10;0;1;11
1058;Čiauškutis;KIŠKUČIAI;9754417066;Taip;5;18;0;23
1059;Čiauškutis;KIŠKUČIAI;5589764935;Taip;12;0;4;16
1060;Čiauškutis;KIŠKUČIAI;4169517353;Taip;3;0;0;3
1061;Čiauškutis;KIŠKUČIAI;3126627913;Taip;3;1;3;7
1062;Čiauškutis;LAPIUKAI;6810906239;Taip;10;13;0;23
1063;Čiauškutis;LAPIUKAI;9460608737;Taip;8;0;0;8
1064;Čiauškutis;LAPIUKAI;9928767253;Taip;2;21;0;23
1065;Čiauškutis;LAPIUKAI;9702568740;Taip;6;17;0;23
1066;Čiauškutis;LAPIUKAI;5427045039;Taip;4;0;0;4
1067;Čiauškutis;LAPIUKAI;8737871477;Taip;5;18;0;23
1068;Čiauškutis;LAPIUKAI;5842585542;Taip;7;16;0;23
1069;Čiauškutis;LAPIUKAI;6940865564;Taip;11;12;0;23
1070;Čiauškutis;MEŠKUČIAI;2172687454;Taip;5;0;0;5
1071;Čiauškutis;MEŠKUČIAI;3660195990;Taip;5;0;1;6
1072;Čiauškutis;MEŠKUČIAI;6109859056;Taip;0;0;1;1
1073;Čiauškutis;MEŠKUČIAI;8910832777;Taip;0;0;1;1
1074;Čiauškutis;MEŠKUČIAI;4213259879;Taip;0;3;0;3
1075;Čiauškutis;MEŠKUČIAI;1515680948;Ne;5;0;1;6
1076;Čiauškutis;MEŠKUČIAI;6608678558;Taip;0;2;3;5
1077;Čiauškutis;MEŠKUČIAI;7714816675;Taip;1;4;0;5
1078;Čiauškutis;MEŠKUČIAI;9684750515;Taip;0;0;1;1
1079;Čiauškutis;PELĖDŽIUKAI;4971788697;Taip;6;0;0;6
1080;Čiauškutis;PELĖDŽIUKAI;1561833758;Taip;3;0;0;3
1081;Čiauškutis;PELĖDŽIUKAI;7931998640;Taip;2;0;3;5
1082;Čiauškutis;PELĖDŽIUKAI;3700692073;Taip;0;1;0;1
1083;Čiauškutis;PELĖDŽIUKAI;6615319751;Taip;19;0;0;19
1084;Čiauškutis;PELĖDŽIUKAI;5446546214;Taip;2;0;1;3
1085;Čiauškutis;PELĖDŽIUKAI;8111541739;Taip;0;0;1;1
1086;Čiauškutis;PELĖDŽIUKAI;3298272815;Taip;15;0;4;19
1087;Čiauškutis;NYKŠTUKAI;8948893335;Taip;14;2;0;16
1088;Čiauškutis;NYKŠTUKAI;2633243682;Taip;2;1;0;3
1089;Čiauškutis;NYKŠTUKAI;4037117222;Taip;5;0;0;5
1090;Čiauškutis;NYKŠTUKAI;6705934636;Taip;6;0;0;6
1091;Čiauškutis;NYKŠTUKAI;2044220236;Taip;5;0;0;5
1092;Čiauškutis;NYKŠTUKAI;7335655769;Ne;2;4;0;6
1093;Čiauškutis;NYKŠTUKAI;5686690700;Taip;23;0;0;23
1094;Čiauškutis;NYKŠTUKAI;5734665607;Taip;6;0;0;6
1095;Čiauškutis;NYKŠTUKAI;6051208732;Taip;9;0;0;9
1096;Delfinukas;Boružėlių;5963440967;Taip;5;0;0;5
1097;Delfinukas;Boružėlių;8444134791;Taip;1;0;0;1
1098;Delfinukas;Boružėlių;6878446154;Taip;6;0;0;6
1099;Delfinukas;Boružėlių;1970318187;Taip;8;0;0;8
1100;Delfinukas;Boružėlių;7752786752;Taip;8;0;0;8
1101;Delfinukas;Boružėlių;2459046463;Taip;15;0;0;15
1102;Delfinukas;Boružėlių;2323767897;Taip;18;0;0;18
1103;Delfinukas;Boružėlių;2830904360;Taip;13;5;0;18
1104;Delfinukas;Boružėlių;2371901540;Taip;10;5;0;15
1105;Delfinukas;Boružėlių;9127076507;Taip;0;5;0;5
1106;Delfinukas;Boružėlių;3015726598;Taip;4;2;0;6
1107;Delfinukas;Boružėlių;1843845065;Taip;11;0;0;11
1108;Delfinukas;Boružėlių;8554498555;Taip;5;0;0;5
1109;Delfinukas;Boružėlių;2716595364;Taip;23;0;0;23
1110;Delfinukas;Boružėlių;2450560824;Taip;19;4;0;23
1111;Delfinukas;Saulytės;8315269427;Taip;2;0;0;2
1112;Delfinukas;Saulytės;4215887291;Taip;1;2;0;3
1113;Delfinukas;Saulytės;3631520143;Taip;7;1;0;8
1114;Delfinukas;Saulytės;9424966984;Taip;4;0;1;5
1115;Delfinukas;Saulytės;6069600728;Taip;3;0;1;4
1116;Delfinukas;Saulytės;9729550922;Taip;0;5;0;5
1117;Delfinukas;Saulytės;1404270345;Taip;3;6;0;9
1118;Delfinukas;Saulytės;8402529296;Taip;9;2;0;11
1119;Delfinukas;Saulytės;5642328792;Taip;0;3;0;3
1120;Delfinukas;Saulytės;8176576958;Taip;9;0;0;9
1121;Delfinukas;Saulytės;8275943176;Taip;2;1;0;3
1122;Delfinukas;Saulytės;8085530134;Taip;5;3;0;8
1123;Delfinukas;Saulytės;8148610460;Taip;1;6;0;7
1124;Delfinukas;Saulytės;8186312409;Taip;6;5;0;11
1125;Delfinukas;Saulytės;1873630966;Taip;0;4;0;4
1126;Delfinukas;Saulytės;1953356983;Taip;5;0;0;5
1127;Delfinukas;Pelėdžiukų;3940838205;Taip;0;8;0;8
1128;Delfinukas;Pelėdžiukų;8774145277;Taip;4;2;0;6
1129;Delfinukas;Pelėdžiukų;6113662246;Taip;18;1;0;19
1130;Delfinukas;Pelėdžiukų;4710894128;Taip;5;1;0;6
1131;Delfinukas;Pelėdžiukų;1526129772;Taip;5;1;0;6
1132;Delfinukas;Pelėdžiukų;8659309242;Taip;0;1;0;1
1133;Delfinukas;Pelėdžiukų;8267992425;Taip;0;8;0;8
1134;Delfinukas;Pelėdžiukų;9319874239;Taip;0;2;0;2
1135;Delfinukas;Pelėdžiukų;2809947323;Ne;5;0;0;5
1136;Delfinukas;Pelėdžiukų;4096274346;Taip;0;2;0;2
1137;Delfinukas;Pelėdžiukų;5246300518;Taip;7;0;0;7
1138;Delfinukas;Pelėdžiukų;2420308954;Taip;5;2;0;7
1139;Delfinukas;Pelėdžiukų;6286748047;Taip;5;6;0;11
1140;Delfinukas;Pelėdžiukų;4465504676;Taip;0;4;0;4
1141;Delfinukas;Pelėdžiukų;6282501549;Taip;8;6;0;14
1142;Delfinukas;Pelėdžiukų;6025384346;Ne;11;0;0;11
1143;Delfinukas;Varliukų;4949220786;Taip;5;4;0;9
1144;Delfinukas;Varliukų;2792051636;Taip;4;0;0;4
1145;Delfinukas;Varliukų;4780352568;Taip;7;0;0;7
1146;Delfinukas;Varliukų;3577180085;Taip;5;0;0;5
1147;Delfinukas;Varliukų;6115370195;Taip;9;0;0;9
1148;Delfinukas;Varliukų;3050258185;Taip;3;0;0;3
1149;Delfinukas;Varliukų;4338259551;Taip;4;0;0;4
1150;Delfinukas;Varliukų;6301601832;Taip;0;2;0;2
1151;Delfinukas;Varliukų;5095713834;Taip;13;1;1;15
1152;Delfinukas;Varliukų;5964021733;Taip;19;0;0;19
1153;Delfinukas;Varliukų;5821591959;Taip;0;9;0;9
1154;Delfinukas;Varliukų;9095895182;Taip;8;0;2;10
1155;Delfinukas;Varliukų;5138840297;Ne;6;0;0;6
1156;Delfinukas;Varliukų;7072060541;Taip;6;11;0;17
1157;Delfinukas;Varliukų;3797355501;Taip;9;4;0;13
1158;Delfinukas;Varliukų;4751611934;Taip;0;6;0;6
1159;Delfinukas;Varliukų;4254414928;Taip;8;0;0;8
1160;Delfinukas;Varliukų;7359531377;Taip;8;0;0;8
1161;Delfinukas;Varpelių;9514189769;Taip;0;4;0;4
1162;Delfinukas;Varpelių;3818558339;Taip;2;0;0;2
1163;Delfinukas;Varpelių;1484123788;Taip;0;1;0;1
1164;Delfinukas;Varpelių;8829835426;Taip;0;0;1;1
1165;Delfinukas;Varpelių;2730512600;Taip;5;6;0;11
1166;Delfinukas;Varpelių;8911433659;Taip;9;0;0;9
1167;Delfinukas;Varpelių;6952314149;Ne;9;1;0;10
1168;Delfinukas;Varpelių;5158297103;Taip;1;0;0;1
1169;Delfinukas;Varpelių;4101463768;Taip;7;0;0;7
1170;Delfinukas;Varpelių;5467211088;Taip;4;4;0;8
1171;Delfinukas;Varpelių;7780893730;Taip;7;0;0;7
1172;Delfinukas;Drugeliai;7615519932;Taip;7;0;0;7
1173;Delfinukas;Drugeliai;6604115681;Taip;11;2;0;13
1174;Delfinukas;Drugeliai;5990192934;Taip;9;5;0;14
1175;Delfinukas;Drugeliai;9635669748;Taip;0;1;0;1
1176;Delfinukas;Drugeliai;8526813977;Taip;0;2;0;2
1177;Delfinukas;Drugeliai;6873181103;Taip;1;9;0;10
1178;Delfinukas;Drugeliai;4484804360;Taip;0;2;0;2
1179;Delfinukas;Drugeliai;8328481987;Taip;6;2;0;8
1180;Delfinukas;Drugeliai;6992505341;Taip;9;2;0;11
1181;Delfinukas;Drugeliai;8129592398;Taip;2;0;0;2
1182;Delfinukas;Drugeliai;9927854348;Taip;5;0;0;5
1183;Delfinukas;Drugeliai;2756574162;Taip;10;1;0;11
1184;Delfinukas;Drugeliai;2985669766;Taip;13;1;0;14
1185;Delfinukas;Drugeliai;7609115506;Taip;0;1;0;1
1186;Delfinukas;Drugeliai;6457042338;Taip;0;8;0;8
1187;Delfinukas;Drugeliai;3134897964;Taip;4;1;0;5
1188;Delfinukas;Drugeliai;8411289299;Taip;0;2;0;2
1189;Delfinukas;Drugeliai;2683746435;Taip;1;0;0;1
1190;Delfinukas;Drugeliai;6623617856;Taip;0;3;0;3
1191;Delfinukas;Žuvytės;4384995354;Taip;0;2;0;2
1192;Delfinukas;Žuvytės;1918878505;Taip;7;0;0;7
1193;Delfinukas;Žuvytės;1575125658;Taip;0;1;1;2
1194;Delfinukas;Žuvytės;7354837777;Taip;14;4;0;18
1195;Delfinukas;Žuvytės;5665463557;Taip;0;1;0;1
1196;Delfinukas;Žuvytės;9686085316;Taip;0;0;1;1
1197;Delfinukas;Žuvytės;7464957954;Taip;11;0;0;11
1198;Delfinukas;Žuvytės;5281161835;Taip;5;0;3;8
1199;Delfinukas;Žuvytės;2425621326;Ne;13;0;0;13
1200;Delfinukas;Žuvytės;4782384361;Ne;15;0;4;19
1201;Delfinukas;Žuvytės;6865463448;Taip;2;1;1;4
1202;Delfinukas;Žuvytės;9773069890;Taip;5;0;1;6
1203;Delfinukas;Žuvytės;5397241026;Taip;0;4;0;4
1204;Delfinukas;Delfinai;8038737019;Taip;4;0;0;4
1205;Delfinukas;Delfinai;5797308373;Taip;0;1;0;1
1206;Delfinukas;Delfinai;5241426445;Taip;0;4;0;4
1207;Delfinukas;Delfinai;8099120371;Taip;0;4;0;4
1208;Delfinukas;Delfinai;7663934825;Taip;0;2;0;2
1209;Delfinukas;Delfinai;2382077576;Taip;8;4;0;12
1210;Delfinukas;Delfinai;7629622746;Taip;0;4;0;4
1211;Delfinukas;Delfinai;1922513830;Taip;0;6;0;6
1212;Delfinukas;Delfinai;6270012707;Taip;0;9;0;9
1213;Delfinukas;Delfinai;8085481968;Taip;4;2;0;6
1214;Delfinukas;Delfinai;3407321091;Taip;4;0;0;4
1215;Delfinukas;Delfinai;8415516743;Taip;10;0;0;10
1216;Delfinukas;Delfinai;4855210424;Taip;0;1;2;3
1217;Delfinukas;Delfinai;2890469172;Taip;0;0;12;12
1218;Delfinukas;Paukšteliai;7366145460;Taip;10;0;0;10
1219;Delfinukas;Paukšteliai;5278689745;Taip;8;5;0;13
1220;Delfinukas;Paukšteliai;6002086491;Taip;0;4;0;4
1221;Delfinukas;Paukšteliai;1164720538;Taip;6;5;0;11
1222;Delfinukas;Paukšteliai;9351906710;Taip;6;1;0;7
1223;Delfinukas;Paukšteliai;9629225917;Taip;9;0;0;9
1224;Delfinukas;Paukšteliai;9332794060;Taip;7;1;0;8
1225;Delfinukas;Paukšteliai;6650725760;Taip;11;1;0;12
1226;Delfinukas;Paukšteliai;9776618488;Taip;1;1;0;2
1227;Delfinukas;Paukšteliai;4561911078;Taip;11;0;0;11
1228;Delfinukas;Paukšteliai;9289866851;Taip;16;0;0;16
1229;Delfinukas;Paukšteliai;1746566943;Taip;0;4;0;4
1230;Delfinukas;Paukšteliai;9073634575;Taip;0;4;0;4
1231;Delfinukas;Paukšteliai;2186801708;Taip;4;12;0;16
1232;Delfinukas;Paukšteliai;6055420223;Taip;23;0;0;23
1233;Delfinukas;Kiškučiai;5585334518;Taip;5;7;0;12
1234;Delfinukas;Kiškučiai;5443027988;Taip;0;4;0;4
1235;Delfinukas;Kiškučiai;6301767635;Taip;0;7;0;7
1236;Delfinukas;Kiškučiai;4488260667;Taip;0;1;0;1
1237;Delfinukas;Kiškučiai;9184207705;Taip;0;2;1;3
1238;Delfinukas;Kiškučiai;2163238846;Taip;8;0;0;8
1239;Delfinukas;Kiškučiai;4327924499;Taip;10;0;0;10
1240;Delfinukas;Kiškučiai;7312438969;Taip;4;0;0;4
1241;Delfinukas;Kiškučiai;6693756145;Taip;2;2;0;4
1242;Delfinukas;Kiškučiai;3205671100;Taip;2;2;0;4
1243;Delfinukas;Kiškučiai;4755699845;Taip;8;4;0;12
1244;Delfinukas;Kiškučiai;5164599763;Taip;5;7;1;13
1245;Delfinukas;Kiškučiai;9586646352;Taip;4;1;0;5
1246;Delfinukas;Kiškučiai;3487670354;Taip;1;0;0;1
1247;Delfinukas;BITUTĖS;9719348837;Taip;0;0;1;1
1248;Delfinukas;BITUTĖS;8896957908;Taip;0;0;1;1
1249;Delfinukas;BITUTĖS;3239635507;Taip;4;0;1;5
1250;Delfinukas;BITUTĖS;5339993544;Taip;0;1;0;1
1251;Delfinukas;BITUTĖS;6929926768;Taip;12;0;0;12
1252;Delfinukas;BITUTĖS;8937594052;Taip;2;1;0;3
1253;Delfinukas;BITUTĖS;5179080544;Taip;0;9;0;9
1254;Delfinukas;BITUTĖS;7727263761;Taip;0;2;0;2
1255;Delfinukas;BITUTĖS;9941631164;Taip;0;3;0;3
1256;Delfinukas;BITUTĖS;4198261848;Taip;6;1;3;10
1257;Delfinukas;BITUTĖS;8081895401;Taip;9;0;0;9
1258;Delfinukas;BITUTĖS;5600320855;Taip;7;8;0;15
1259;Delfinukas;BITUTĖS;9195828884;Taip;4;5;2;11
1260;Delfinukas;BITUTĖS;8552371520;Taip;0;0;3;3
1261;Delfinukas;BITUTĖS;2377204734;Taip;0;1;0;1
1262;Delfinukas;BITUTĖS;6243471374;Taip;5;3;0;8
1263;Delfinukas;BITUTĖS;4303234827;Taip;12;2;0;14
1264;Delfinukas;BITUTĖS;6325092903;Taip;6;0;0;6
1265;Drevinukas;ZUIKUČIAI;1595081335;Taip;0;0;9;9
1266;Drevinukas;ZUIKUČIAI;2646799484;Taip;0;4;3;7
1267;Drevinukas;ZUIKUČIAI;2772424629;Taip;4;4;7;15
1268;Drevinukas;ZUIKUČIAI;5928234487;Taip;0;1;0;1
1269;Drevinukas;ZUIKUČIAI;8873060121;Taip;8;0;0;8
1270;Drevinukas;ZUIKUČIAI;1567790084;Taip;7;0;0;7
1271;Drevinukas;ZUIKUČIAI;3293457412;Taip;0;0;1;1
1272;Drevinukas;ZUIKUČIAI;6243097297;Taip;0;4;10;14
1273;Drevinukas;ZUIKUČIAI;5704489483;Taip;5;2;1;8
1274;Drevinukas;ZUIKUČIAI;5887233286;Taip;0;4;0;4
1275;Drevinukas;ZUIKUČIAI;3381363132;Taip;19;4;0;23
1276;Drevinukas;ZUIKUČIAI;3070518153;Taip;0;0;1;1
1277;Drevinukas;ZUIKUČIAI;9174977150;Taip;0;2;0;2
1278;Drevinukas;ZUIKUČIAI;4243045398;Taip;12;0;0;12
1279;Drevinukas;ZUIKUČIAI;4309475233;Taip;12;0;0;12
1280;Drevinukas;ZUIKUČIAI;5578749226;Taip;8;0;2;10
1281;Drevinukas;AŽUOLIUKŲ;1644656704;Taip;0;6;0;6
1282;Drevinukas;AŽUOLIUKŲ;5721031754;Taip;0;0;3;3
1283;Drevinukas;AŽUOLIUKŲ;4714478955;Taip;6;11;0;17
1284;Drevinukas;AŽUOLIUKŲ;8701250912;Taip;0;7;0;7
1285;Drevinukas;AŽUOLIUKŲ;8143614891;Taip;0;6;0;6
1286;Drevinukas;AŽUOLIUKŲ;5673244101;Taip;6;4;1;11
1287;Drevinukas;AŽUOLIUKŲ;3643007998;Ne;0;3;2;5
1288;Drevinukas;AŽUOLIUKŲ;4262951360;Taip;0;0;5;5
1289;Drevinukas;AŽUOLIUKŲ;4572837478;Taip;4;6;0;10
1290;Drevinukas;AŽUOLIUKŲ;1564065835;Taip;0;0;5;5
1291;Drevinukas;AŽUOLIUKŲ;9289471118;Taip;0;0;1;1
1292;Drevinukas;AŽUOLIUKŲ;9915130747;Ne;5;7;0;12
1293;Drevinukas;AŽUOLIUKŲ;6891793135;Taip;0;1;5;6
1294;Drevinukas;AŽUOLIUKŲ;1058927778;Taip;0;4;0;4
1295;Drevinukas;AŽUOLIUKŲ;9534007163;Ne;5;1;1;7
1296;Drevinukas;AŽUOLIUKŲ;2300338724;Taip;0;1;1;2
1297;Drevinukas;AŽUOLIUKŲ;6165662595;Taip;0;0;8;8
1298;Drevinukas;AŽUOLIUKŲ;2740093399;Taip;0;5;13;18
1299;Drevinukas;PELĖDŽIUKAI;3032536983;Taip;2;1;1;4
1300;Drevinukas;PELĖDŽIUKAI;3392249574;Taip;0;3;0;3
1301;Drevinukas;PELĖDŽIUKAI;5524567803;Taip;0;1;0;1
1302;Drevinukas;PELĖDŽIUKAI;9016985238;Ne;0;1;0;1
1303;Drevinukas;PELĖDŽIUKAI;2929598743;Taip;4;2;0;6
1304;Drevinukas;PELĖDŽIUKAI;4076576850;Taip;12;2;5;19
1305;Drevinukas;PELĖDŽIUKAI;6373230526;Taip;0;4;0;4
1306;Drevinukas;PELĖDŽIUKAI;7642022439;Taip;0;4;0;4
1307;Drevinukas;PELĖDŽIUKAI;6316000019;Taip;2;4;1;7
1308;Drevinukas;PELĖDŽIUKAI;4404254932;Taip;0;1;0;1
1309;Drevinukas;PELĖDŽIUKAI;2378493422;Taip;0;4;0;4
1310;Drevinukas;PELĖDŽIUKAI;1859208322;Taip;8;0;0;8
1311;Drevinukas;PELĖDŽIUKAI;8984653958;Taip;0;12;0;12
1312;Drevinukas;PELĖDŽIUKAI;5620887702;Taip;0;4;0;4
1313;Drevinukas;PELĖDŽIUKAI;2281463885;Taip;0;1;0;1
1314;Drevinukas;PELĖDŽIUKAI;5875459639;Taip;0;8;0;8
1315;Drevinukas;PELĖDŽIUKAI;6582186497;Ne;3;0;0;3
1316;Drevinukas;PELĖDŽIUKAI;7218201733;Taip;0;4;0;4
1317;Drevinukas;BORUŽĖLĖS;6492987985;Taip;0;0;1;1
1318;Drevinukas;BORUŽĖLĖS;6645506336;Taip;6;3;0;9
1319;Drevinukas;BORUŽĖLĖS;9845207619;Taip;7;0;0;7
1320;Drevinukas;BORUŽĖLĖS;9517560132;Taip;7;0;0;7
1321;Drevinukas;BORUŽĖLĖS;6895472558;Taip;4;0;2;6
1322;Drevinukas;BORUŽĖLĖS;2039086829;Taip;10;0;0;10
1323;Drevinukas;BORUŽĖLĖS;4147987057;Taip;4;4;0;8
1324;Drevinukas;BORUŽĖLĖS;6680003214;Taip;2;3;1;6
1325;Drevinukas;BORUŽĖLĖS;9695419813;Taip;4;0;0;4
1326;Drevinukas;BORUŽĖLĖS;8694887879;Taip;0;3;0;3
1327;Drevinukas;BORUŽĖLĖS;3192583690;Ne;2;0;0;2
1328;Drevinukas;BORUŽĖLĖS;6659263391;Ne;2;0;0;2
1329;Drevinukas;BORUŽĖLĖS;8719022482;Taip;0;3;1;4
1330;Drevinukas;BORUŽĖLĖS;4588368596;Ne;23;0;0;23
1331;Drevinukas;BORUŽĖLĖS;2571295179;Taip;0;7;0;7
1332;Drevinukas;BORUŽĖLĖS;2820241608;Taip;5;6;0;11
1333;Drevinukas;BORUŽĖLĖS;8940838262;Taip;0;4;0;4
1334;Drevinukas;BORUŽĖLĖS;2179736991;Taip;4;9;0;13
1335;Drevinukas;BITUTĖS;5348609358;Taip;6;2;0;8
1336;Drevinukas;BITUTĖS;1098647410;Taip;4;0;0;4
1337;Drevinukas;BITUTĖS;2312241894;Taip;7;4;0;11
1338;Drevinukas;BITUTĖS;3871506691;Taip;0;3;0;3
1339;Drevinukas;BITUTĖS;6914111231;Taip;0;3;0;3
1340;Drevinukas;BITUTĖS;2423143170;Taip;2;0;0;2
1341;Drevinukas;BITUTĖS;1343431478;Taip;2;0;0;2
1342;Drevinukas;BITUTĖS;1829421385;Taip;9;0;0;9
1343;Drevinukas;BITUTĖS;8385750920;Taip;1;0;0;1
1344;Drevinukas;BITUTĖS;9513405583;Taip;0;4;0;4
1345;Drevinukas;BITUTĖS;5959004452;Taip;1;0;0;1
1346;Drevinukas;BITUTĖS;8896207423;Taip;0;4;0;4
1347;Drevinukas;BITUTĖS;4662426451;Taip;2;2;0;4
1348;Drevinukas;BITUTĖS;3617533357;Taip;23;0;0;23
1349;Drevinukas;BITUTĖS;4134729710;Taip;1;0;0;1
1350;Drevinukas;NYKŠTUKAI;9105675010;Taip;2;1;1;4
1351;Drevinukas;NYKŠTUKAI;1094428951;Taip;5;0;0;5
1352;Drevinukas;NYKŠTUKAI;9283862598;Taip;2;6;0;8
1353;Drevinukas;NYKŠTUKAI;2201342382;Taip;8;0;1;9
1354;Drevinukas;NYKŠTUKAI;4759293403;Ne;14;0;0;14
1355;Drevinukas;NYKŠTUKAI;9004568476;Taip;4;0;0;4
1356;Drevinukas;NYKŠTUKAI;9715586195;Taip;0;1;0;1
1357;Drevinukas;NYKŠTUKAI;8284025903;Taip;0;7;0;7
1358;Drevinukas;NYKŠTUKAI;8654858364;Taip;8;8;0;16
1359;Drevinukas;NYKŠTUKAI;2662147175;Taip;11;0;0;11
1360;Drevinukas;NYKŠTUKAI;7801920518;Taip;16;4;0;20
1361;Drevinukas;NYKŠTUKAI;1570356979;Taip;3;0;0;3
1362;Drevinukas;NYKŠTUKAI;9123131368;Taip;1;0;0;1
1363;Drevinukas;NYKŠTUKAI;6492711565;Taip;0;6;1;7
1364;Drevinukas;NYKŠTUKAI;7316996793;Taip;0;3;0;3
1365;Drevinukas;NYKŠTUKAI;3408981880;Taip;0;2;0;2
1366;Drevinukas;NYKŠTUKAI;8953871512;Taip;23;0;0;23
1367;Drevinukas;NYKŠTUKAI;3983656958;Ne;2;0;1;3
1368;Drevinukas;SMALSUČIAI;7241671439;Taip;7;5;0;12
1369;Drevinukas;SMALSUČIAI;2246885419;Taip;11;4;0;15
1370;Drevinukas;SMALSUČIAI;4089351543;Taip;0;1;0;1
1371;Drevinukas;SMALSUČIAI;7863529560;Taip;0;12;0;12
1372;Drevinukas;SMALSUČIAI;1757626792;Taip;0;1;0;1
1373;Drevinukas;SMALSUČIAI;5666172450;Taip;8;0;0;8
1374;Drevinukas;SMALSUČIAI;8704592094;Taip;10;0;0;10
1375;Drevinukas;SMALSUČIAI;1478224813;Taip;0;1;0;1
1376;Drevinukas;SMALSUČIAI;9707576704;Taip;17;1;0;18
1377;Drevinukas;SMALSUČIAI;2971775004;Taip;1;0;0;1
1378;Drevinukas;SMALSUČIAI;7466516412;Taip;0;1;0;1
1379;Drevinukas;SMALSUČIAI;5614413092;Taip;11;0;0;11
1380;Drevinukas;SMALSUČIAI;4372760590;Taip;1;0;0;1
1381;Drevinukas;SMALSUČIAI;1934875187;Taip;1;4;0;5
1382;Drevinukas;ŽVIRBLIUKAI;5928679046;Taip;1;0;3;4
1383;Drevinukas;ŽVIRBLIUKAI;5785185025;Taip;1;0;3;4
1384;Drevinukas;ŽVIRBLIUKAI;8482376948;Taip;0;0;1;1
1385;Drevinukas;ŽVIRBLIUKAI;7970286765;Taip;1;3;0;4
1386;Drevinukas;ŽVIRBLIUKAI;3598394850;Taip;11;0;0;11
1387;Drevinukas;ŽVIRBLIUKAI;7639360777;Taip;5;0;0;5
1388;Drevinukas;ŽVIRBLIUKAI;5536448847;Taip;6;0;1;7
1389;Drevinukas;ŽVIRBLIUKAI;1471647820;Taip;0;3;0;3
1390;Drevinukas;ŽVIRBLIUKAI;7600838895;Taip;2;0;0;2
1391;Drevinukas;ŽVIRBLIUKAI;3049662927;Taip;3;0;0;3
1392;Drevinukas;ŽVIRBLIUKAI;4371848878;Taip;3;0;1;4
1393;Drugelis;NYKŠTUKŲ;9316073597;Taip;0;3;0;3
1394;Drugelis;NYKŠTUKŲ;3551095669;Taip;4;6;1;11
1395;Drugelis;NYKŠTUKŲ;1785724340;Taip;0;3;0;3
1396;Drugelis;NYKŠTUKŲ;6594452094;Taip;0;5;0;5
1397;Drugelis;NYKŠTUKŲ;5122256823;Taip;0;4;0;4
1398;Drugelis;NYKŠTUKŲ;4825232236;Taip;0;4;0;4
1399;Drugelis;NYKŠTUKŲ;7477547789;Taip;0;1;0;1
1400;Drugelis;NYKŠTUKŲ;8717445483;Taip;4;0;0;4
1401;Drugelis;NYKŠTUKŲ;4471405682;Taip;0;2;0;2
1402;Drugelis;NYKŠTUKŲ;4867387611;Taip;0;9;0;9
1403;Drugelis;NYKŠTUKŲ;8070030439;Taip;0;4;0;4
1404;Drugelis;NYKŠTUKŲ;3061896520;Taip;0;1;0;1
1405;Drugelis;NYKŠTUKŲ;5692743298;Taip;0;3;0;3
1406;Drugelis;NYKŠTUKŲ;6452921695;Taip;4;2;0;6
1407;Drugelis;NYKŠTUKŲ;8591548746;Taip;0;5;0;5
1408;Drugelis;SMALSUČIŲ;5121351234;Ne;18;2;0;20
1409;Drugelis;SMALSUČIŲ;6626437352;Taip;0;1;0;1
1410;Drugelis;SMALSUČIŲ;5000965458;Taip;0;10;0;10
1411;Drugelis;SMALSUČIŲ;9683350741;Taip;7;3;0;10
1412;Drugelis;SMALSUČIŲ;1617833459;Taip;0;1;0;1
1413;Drugelis;SMALSUČIŲ;4058293462;Taip;0;3;0;3
1414;Drugelis;SMALSUČIŲ;6533325098;Taip;0;4;0;4
1415;Drugelis;SMALSUČIŲ;4805858183;Taip;0;6;0;6
1416;Drugelis;SMALSUČIŲ;9650052415;Taip;12;0;0;12
1417;Drugelis;SMALSUČIŲ;5533529267;Taip;0;5;0;5
1418;Drugelis;SMALSUČIŲ;3733097479;Taip;11;0;0;11
1419;Drugelis;SMALSUČIŲ;2196445523;Taip;4;1;0;5
1420;Drugelis;SMALSUČIŲ;3645668411;Taip;4;3;0;7
1421;Drugelis;SMALSUČIŲ;3261462674;Taip;4;1;0;5
1422;Drugelis;SMALSUČIŲ;8186338261;Taip;5;0;1;6
1423;Drugelis;SMALSUČIŲ;2644563881;Taip;19;1;0;20
1424;Drugelis;SMALSUČIŲ;6613520046;Taip;9;0;1;10
1425;Drugelis;SMALSUČIŲ;6890441262;Taip;2;6;0;8
1426;Drugelis;SMALSUČIŲ;3509593041;Ne;0;1;0;1
1427;Drugelis;SMALSUČIŲ;1417298801;Ne;0;0;1;1
1428;Drugelis;MUMINUKŲ;7390061272;Taip;0;0;1;1
1429;Drugelis;MUMINUKŲ;3311620018;Taip;5;1;0;6
1430;Drugelis;MUMINUKŲ;8812550811;Taip;4;1;0;5
1431;Drugelis;MUMINUKŲ;5661335344;Taip;0;4;0;4
1432;Drugelis;MUMINUKŲ;6038184222;Taip;0;1;0;1
1433;Drugelis;MUMINUKŲ;7253876812;Taip;3;0;0;3
1434;Drugelis;MUMINUKŲ;1666992752;Taip;0;0;1;1
1435;Drugelis;MUMINUKŲ;9510744779;Taip;0;5;0;5
1436;Drugelis;MUMINUKŲ;9907121223;Taip;0;8;0;8
1437;Drugelis;MUMINUKŲ;8500348389;Taip;0;1;0;1
1438;Drugelis;MUMINUKŲ;1858504360;Taip;5;2;0;7
1439;Drugelis;MUMINUKŲ;8107970910;Taip;13;0;0;13
1440;Drugelis;MUMINUKŲ;8282807535;Taip;4;3;0;7
1441;Drugelis;MUMINUKŲ;2256221485;Taip;0;1;0;1
1442;Drugelis;MUMINUKŲ;9588931333;Taip;12;0;0;12
1443;Drugelis;MUMINUKŲ;3176174057;Taip;5;3;0;8
1444;Drugelis;MUMINUKŲ;1761596625;Taip;0;4;0;4
1445;Drugelis;PŪKUOTUKAI;3560294703;Taip;2;0;0;2
1446;Drugelis;PŪKUOTUKAI;1215586620;Taip;5;0;0;5
1447;Drugelis;PŪKUOTUKAI;9005448398;Taip;10;6;0;16
1448;Drugelis;PŪKUOTUKAI;2926662708;Taip;3;0;0;3
1449;Drugelis;PŪKUOTUKAI;6504082488;Taip;5;0;0;5
1450;Drugelis;PŪKUOTUKAI;7321544601;Taip;5;4;0;9
1451;Drugelis;PŪKUOTUKAI;9296067137;Taip;16;1;0;17
1452;Drugelis;PŪKUOTUKAI;9855121078;Taip;0;4;0;4
1453;Drugelis;PŪKUOTUKAI;6068102133;Taip;8;3;0;11
1454;Drugelis;PŪKUOTUKAI;7825151440;Taip;5;0;0;5
1455;Drugelis;PŪKUOTUKAI;4812322553;Taip;0;5;0;5
1456;Drugelis;PŪKUOTUKAI;3081918342;Taip;15;0;0;15
1457;Drugelis;PŪKUOTUKAI;6032568621;Taip;0;1;0;1
1458;Drugelis;PŪKUOTUKAI;4580456500;Taip;16;0;0;16
1459;Drugelis;PŪKUOTUKAI;8259051898;Taip;6;2;0;8
1460;Drugelis;PŪKUOTUKAI;2573357635;Taip;8;0;0;8
1461;Drugelis;PŪKUOTUKAI;3567930528;Taip;0;1;0;1
1462;Drugelis;PŪKUOTUKAI;1808917187;Taip;10;4;0;14
1463;Drugelis;PŪKUOTUKAI;5995208093;Taip;11;2;0;13
1464;Drugelis;PŪKUOTUKAI;6965297550;Taip;6;1;0;7
1465;Drugelis;PŪKUOTUKAI;3800496237;Taip;12;0;2;14
1466;Drugelis;PŪKUOTUKAI;5557284298;Taip;3;0;1;4
1467;Drugelis;SPINDULIUKAI;7775085427;Taip;9;6;0;15
1468;Drugelis;SPINDULIUKAI;2456724368;Taip;11;0;0;11
1469;Drugelis;SPINDULIUKAI;5538435916;Taip;4;0;0;4
1470;Drugelis;SPINDULIUKAI;3473680112;Taip;9;0;0;9
1471;Drugelis;SPINDULIUKAI;9226673535;Taip;5;0;3;8
1472;Drugelis;SPINDULIUKAI;5773336517;Taip;3;1;0;4
1473;Drugelis;SPINDULIUKAI;5276647563;Taip;2;1;0;3
1474;Drugelis;SPINDULIUKAI;3883341684;Taip;10;0;13;23
1475;Drugelis;SPINDULIUKAI;9908380623;Taip;16;0;0;16
1476;Drugelis;KIŠKUČIAI;3603051567;Taip;3;0;1;4
1477;Drugelis;KIŠKUČIAI;4628926113;Taip;0;1;1;2
1478;Drugelis;KIŠKUČIAI;7307032077;Taip;0;1;1;2
1479;Drugelis;KIŠKUČIAI;1213610973;Taip;8;0;0;8
1480;Drugelis;KIŠKUČIAI;9211760307;Taip;0;4;4;8
1481;Drugelis;KIŠKUČIAI;6071997970;Taip;3;7;0;10
1482;Drugelis;KIŠKUČIAI;8819853863;Taip;13;0;0;13
1483;Drugelis;KIŠKUČIAI;9900296726;Taip;4;0;0;4
1484;Drugelis;KIŠKUČIAI;6997707085;Taip;4;1;0;5
1485;Drugelis;KIŠKUČIAI;1375535260;Taip;0;0;2;2
1486;Drugelis;KIŠKUČIAI;5857726963;Ne;0;0;3;3
1487;Drugelis;KIŠKUČIAI;1817932444;Taip;0;5;2;7
1488;Drugelis;KIŠKUČIAI;8891228382;Taip;0;0;1;1
1489;Drugelis;KIŠKUČIAI;2729246397;Taip;19;0;0;19
1490;"Du gaideliai";Uodelių;8624394105;Taip;5;1;0;6
1491;"Du gaideliai";Uodelių;9506572113;Taip;9;5;0;14
1492;"Du gaideliai";Uodelių;6224116229;Taip;0;9;1;10
1493;"Du gaideliai";Uodelių;5514521078;Taip;0;6;0;6
1494;"Du gaideliai";Uodelių;6630053388;Taip;0;1;0;1
1495;"Du gaideliai";Uodelių;3654057453;Taip;4;2;0;6
1496;"Du gaideliai";Uodelių;8921985681;Taip;23;0;0;23
1497;"Du gaideliai";Uodelių;5225949099;Taip;0;1;0;1
1498;"Du gaideliai";Uodelių;2122841302;Taip;9;3;0;12
1499;"Du gaideliai";Uodelių;3206388799;Taip;10;0;0;10
1500;"Du gaideliai";Uodelių;2084660815;Taip;0;4;0;4
1501;"Du gaideliai";Uodelių;7153424410;Taip;0;11;0;11
1502;"Du gaideliai";Uodelių;4799107717;Taip;2;3;0;5
1503;"Du gaideliai";Uodelių;1940981083;Taip;23;0;0;23
1504;"Du gaideliai";Uodelių;5113352673;Taip;0;0;1;1
1505;"Du gaideliai";Uodelių;6054058539;Taip;4;4;0;8
1506;"Du gaideliai";Uodelių;9832883242;Taip;9;0;0;9
1507;"Du gaideliai";Uodelių;5016914497;Taip;7;0;2;9
1508;"Du gaideliai";Uodelių;4759244471;Taip;4;0;2;6
1509;"Du gaideliai";OŽIUKŲ;6942798420;Taip;8;3;0;11
1510;"Du gaideliai";OŽIUKŲ;8174023197;Taip;0;1;0;1
1511;"Du gaideliai";OŽIUKŲ;8420400705;Taip;0;11;0;11
1512;"Du gaideliai";OŽIUKŲ;7372149799;Taip;0;10;0;10
1513;"Du gaideliai";OŽIUKŲ;2826490663;Taip;0;0;4;4
1514;"Du gaideliai";OŽIUKŲ;4157021754;Taip;3;1;4;8
1515;"Du gaideliai";OŽIUKŲ;1968978650;Taip;2;0;0;2
1516;"Du gaideliai";OŽIUKŲ;5291934919;Taip;15;5;0;20
1517;"Du gaideliai";OŽIUKŲ;2564259600;Taip;12;0;0;12
1518;"Du gaideliai";OŽIUKŲ;6132405512;Taip;0;14;0;14
1519;"Du gaideliai";OŽIUKŲ;2756525592;Taip;0;1;0;1
1520;"Du gaideliai";OŽIUKŲ;7563789811;Taip;10;1;0;11
1521;"Du gaideliai";OŽIUKŲ;6704167983;Taip;6;0;1;7
1522;"Du gaideliai";OŽIUKŲ;9126780620;Taip;0;6;2;8
1523;"Du gaideliai";OŽIUKŲ;9374869616;Taip;0;3;0;3
1524;"Du gaideliai";OŽIUKŲ;5726096980;Taip;0;13;0;13
1525;"Du gaideliai";OŽIUKŲ;4408537397;Taip;0;4;0;4
1526;"Du gaideliai";OŽIUKŲ;1527839162;Taip;0;1;4;5
1527;"Du gaideliai";OŽIUKŲ;5809089345;Taip;8;1;0;9
1528;"Du gaideliai";OŽIUKŲ;5867716168;Taip;0;1;0;1
1529;"Du gaideliai";OŽIUKŲ;1882241729;Taip;7;0;0;7
1530;"Du gaideliai";OŽIUKŲ;2616106413;Taip;10;0;0;10
1531;"Du gaideliai";OŽIUKŲ;9934568135;Taip;0;11;0;11
1532;"Du gaideliai";Vištyčių;2100449108;Taip;0;0;3;3
1533;"Du gaideliai";Vištyčių;7033276798;Taip;0;4;1;5
1534;"Du gaideliai";Vištyčių;7575534590;Taip;8;0;0;8
1535;"Du gaideliai";Vištyčių;8744467866;Taip;4;0;0;4
1536;"Du gaideliai";Vištyčių;3019797369;Taip;6;0;0;6
1537;"Du gaideliai";Vištyčių;9356275460;Taip;0;0;1;1
1538;"Du gaideliai";Vištyčių;6204233540;Taip;0;4;0;4
1539;"Du gaideliai";Vištyčių;2845145754;Taip;5;4;0;9
1540;"Du gaideliai";Vištyčių;7726490359;Taip;12;4;0;16
1541;"Du gaideliai";Vištyčių;5788923258;Taip;0;14;0;14
1542;"Du gaideliai";Vištyčių;6762171696;Taip;0;1;0;1
1543;"Du gaideliai";Vištyčių;5611102395;Ne;0;4;0;4
1544;"Du gaideliai";Vištyčių;8410547195;Taip;0;4;0;4
1545;"Du gaideliai";Vištyčių;6120647567;Taip;9;3;0;12
1546;"Du gaideliai";Vištyčių;2905083899;Taip;10;0;0;10
1547;"Du gaideliai";Vištyčių;9585785202;Taip;5;6;0;11
1548;"Du gaideliai";Vištyčių;2151825222;Taip;0;2;0;2
1549;"Du gaideliai";Vištyčių;8043896286;Taip;0;4;0;4
1550;"Du gaideliai";GAIDŽIUKŲ;2635903222;Taip;17;4;0;21
1551;"Du gaideliai";GAIDŽIUKŲ;6669130831;Taip;0;1;0;1
1552;"Du gaideliai";GAIDŽIUKŲ;7537924142;Ne;13;4;0;17
1553;"Du gaideliai";GAIDŽIUKŲ;2240947701;Taip;0;4;0;4
1554;"Du gaideliai";GAIDŽIUKŲ;3507387826;Taip;0;13;0;13
1555;"Du gaideliai";GAIDŽIUKŲ;4144269068;Taip;0;4;2;6
1556;"Du gaideliai";GAIDŽIUKŲ;1785976627;Taip;5;2;0;7
1557;"Du gaideliai";GAIDŽIUKŲ;8047413507;Taip;0;4;2;6
1558;"Du gaideliai";GAIDŽIUKŲ;9568647033;Taip;1;0;0;1
1559;"Du gaideliai";GAIDŽIUKŲ;5894974508;Taip;0;4;0;4
1560;"Du gaideliai";GAIDŽIUKŲ;3370029981;Taip;6;4;0;10
1561;"Du gaideliai";GAIDŽIUKŲ;1751328192;Taip;2;1;0;3
1562;"Du gaideliai";GAIDŽIUKŲ;5652662610;Taip;0;4;0;4
1563;"Du gaideliai";GAIDŽIUKŲ;6870356241;Taip;0;6;0;6
1564;"Du gaideliai";GAIDŽIUKŲ;5103483956;Taip;0;4;0;4
1565;"Du gaideliai";GAIDŽIUKŲ;3854355215;Taip;0;4;5;9
1566;"Du gaideliai";GAIDŽIUKŲ;3849899284;Ne;0;4;0;4
1567;"Du gaideliai";Musyčių;6826558709;Taip;10;1;0;11
1568;"Du gaideliai";Musyčių;3058039700;Taip;6;0;3;9
1569;"Du gaideliai";Musyčių;7556954721;Taip;8;0;0;8
1570;"Du gaideliai";Musyčių;3601150560;Taip;0;4;0;4
1571;"Du gaideliai";Musyčių;3519099395;Taip;6;1;0;7
1572;"Du gaideliai";Musyčių;9561040908;Taip;14;0;0;14
1573;"Du gaideliai";Musyčių;9477645505;Taip;5;4;0;9
1574;"Du gaideliai";Musyčių;7855653537;Taip;11;4;0;15
1575;"Du gaideliai";Musyčių;9619723983;Taip;12;1;0;13
1576;"Du gaideliai";Musyčių;5060904810;Taip;0;1;0;1
1577;"Du gaideliai";Musyčių;2266999698;Taip;0;2;0;2
1578;"Du gaideliai";Musyčių;1048130675;Taip;14;7;0;21
1579;"Du gaideliai";MALŪNO;1706627632;Taip;10;6;0;16
1580;"Du gaideliai";MALŪNO;4995471264;Taip;5;1;0;6
1581;"Du gaideliai";MALŪNO;2135080469;Taip;2;0;0;2
1582;"Du gaideliai";MALŪNO;1025181286;Taip;7;3;0;10
1583;"Du gaideliai";MALŪNO;5028947424;Taip;0;0;3;3
1584;"Du gaideliai";MALŪNO;2613120460;Taip;7;0;0;7
1585;"Du gaideliai";MALŪNO;3469559577;Taip;11;0;4;15
1586;"Du gaideliai";MALŪNO;5625164689;Taip;5;0;0;5
1587;"Du gaideliai";MALŪNO;8197231934;Taip;4;0;0;4
1588;"Du gaideliai";MALŪNO;2261152926;Taip;7;5;0;12
1589;"Du gaideliai";MALŪNO;4792733524;Taip;10;2;0;12
1590;Eglutė;RAMUNĖ;2998190195;Taip;0;1;0;1
1591;Eglutė;RAMUNĖ;4099257155;Taip;0;1;0;1
1592;Eglutė;RAMUNĖ;6009794480;Taip;0;9;0;9
1593;Eglutė;RAMUNĖ;7984911632;Ne;0;6;10;16
1594;Eglutė;RAMUNĖ;6539887315;Taip;4;0;0;4
1595;Eglutė;RAMUNĖ;4252256130;Taip;0;2;0;2
1596;Eglutė;RAMUNĖ;8534997648;Taip;0;2;0;2
1597;Eglutė;RAMUNĖ;7234851379;Taip;7;0;0;7
1598;Eglutė;RAMUNĖ;5636437290;Taip;6;1;1;8
1599;Eglutė;RAMUNĖ;5190045146;Taip;0;10;0;10
1600;Eglutė;RAMUNĖ;3985929379;Taip;2;4;0;6
1601;Eglutė;RAMUNĖ;1842517164;Taip;11;0;0;11
1602;Eglutė;RAMUNĖ;7530638623;Taip;0;1;0;1
1603;Eglutė;RAMUNĖ;2816913563;Taip;0;0;1;1
1604;Eglutė;RAMUNĖ;6146679388;Taip;0;6;0;6
1605;Eglutė;RAMUNĖ;5166183300;Taip;0;17;0;17
1606;Eglutė;PELĖDŽIUKAI;3883122650;Taip;0;4;0;4
1607;Eglutė;PELĖDŽIUKAI;7859815752;Taip;0;5;0;5
1608;Eglutė;PELĖDŽIUKAI;4176597208;Taip;4;6;0;10
1609;Eglutė;PELĖDŽIUKAI;7758643349;Taip;7;3;0;10
1610;Eglutė;PELĖDŽIUKAI;4490295754;Ne;0;4;0;4
1611;Eglutė;PELĖDŽIUKAI;5924994736;Taip;0;8;0;8
1612;Eglutė;PELĖDŽIUKAI;1759383841;Taip;0;3;0;3
1613;Eglutė;PELĖDŽIUKAI;6597261061;Taip;0;9;0;9
1614;Eglutė;PELĖDŽIUKAI;9046652370;Taip;1;4;0;5
1615;Eglutė;PELĖDŽIUKAI;9356785605;Taip;0;1;0;1
1616;Eglutė;PELĖDŽIUKAI;8943684351;Taip;8;1;0;9
1617;Eglutė;PELĖDŽIUKAI;1932785408;Taip;0;0;2;2
1618;Eglutė;PELĖDŽIUKAI;8165126017;Taip;0;4;0;4
1619;Eglutė;PELĖDŽIUKAI;9967488317;Taip;4;4;0;8
1620;Eglutė;PELĖDŽIUKAI;3584247594;Taip;6;4;0;10
1621;Eglutė;PELĖDŽIUKAI;5678727198;Taip;0;4;1;5
1622;Eglutė;PELĖDŽIUKAI;1835565594;Taip;0;4;0;4
1623;Eglutė;PELĖDŽIUKAI;4027143502;Ne;0;6;0;6
1624;Eglutė;PELĖDŽIUKAI;2611896463;Taip;0;9;0;9
1625;Eglutė;KODĖLČIUKAI;7831541089;Ne;5;2;0;7
1626;Eglutė;KODĖLČIUKAI;7735192219;Taip;0;4;0;4
1627;Eglutė;KODĖLČIUKAI;3430016771;Taip;4;19;0;23
1628;Eglutė;KODĖLČIUKAI;6382927775;Taip;2;14;0;16
1629;Eglutė;KODĖLČIUKAI;7919553451;Taip;0;7;0;7
1630;Eglutė;KODĖLČIUKAI;7658345479;Taip;4;0;0;4
1631;Eglutė;KODĖLČIUKAI;7229612001;Ne;6;4;0;10
1632;Eglutė;KODĖLČIUKAI;5779671024;Taip;0;1;0;1
1633;Eglutė;KODĖLČIUKAI;4932945207;Taip;23;0;0;23
1634;Eglutė;KODĖLČIUKAI;4490541539;Taip;0;4;0;4
1635;Eglutė;KODĖLČIUKAI;5407757245;Taip;1;0;0;1
1636;Eglutė;KODĖLČIUKAI;3237476593;Taip;4;0;0;4
1637;Eglutė;KODĖLČIUKAI;9542103745;Taip;0;2;0;2
1638;Eglutė;KODĖLČIUKAI;3848175048;Taip;0;1;0;1
1639;Eglutė;KODĖLČIUKAI;5947727288;Taip;2;0;0;2
1640;Eglutė;KODĖLČIUKAI;1122907387;Taip;19;4;0;23
1641;Eglutė;KODĖLČIUKAI;9686836846;Taip;3;2;0;5
1642;Eglutė;KODĖLČIUKAI;5592515139;Taip;3;0;0;3
1643;Eglutė;OBUOLIUKAI;5704418881;Taip;0;1;0;1
1644;Eglutė;OBUOLIUKAI;3488060437;Taip;0;2;0;2
1645;Eglutė;OBUOLIUKAI;8698242107;Taip;6;2;4;12
1646;Eglutė;OBUOLIUKAI;1630732306;Ne;0;1;0;1
1647;Eglutė;OBUOLIUKAI;9381529574;Taip;2;1;0;3
1648;Eglutė;OBUOLIUKAI;9150254806;Taip;0;4;0;4
1649;Eglutė;OBUOLIUKAI;2107488723;Taip;0;0;3;3
1650;Eglutė;OBUOLIUKAI;4539946535;Taip;0;4;5;9
1651;Eglutė;OBUOLIUKAI;8749425471;Taip;12;0;0;12
1652;Eglutė;OBUOLIUKAI;5103022009;Taip;5;0;0;5
1653;Eglutė;OBUOLIUKAI;1460628870;Taip;3;0;0;3
1654;Eglutė;OBUOLIUKAI;8542684582;Taip;5;0;0;5
1655;Eglutė;OBUOLIUKAI;7313013331;Taip;2;0;0;2
1656;Eglutė;OBUOLIUKAI;3089527202;Taip;1;0;0;1
1657;Eglutė;OBUOLIUKAI;8037564034;Taip;0;1;0;1
1658;Eglutė;OBUOLIUKAI;3051637136;Taip;1;5;1;7
1659;Eglutė;OBUOLIUKAI;2669400743;Taip;0;0;1;1
1660;Eglutė;OBUOLIUKAI;3011330968;Taip;0;4;5;9
1661;Eglutė;OBUOLIUKAI;4823811890;Taip;0;7;0;7
1662;Eglutė;OBUOLIUKAI;4151258155;Taip;0;5;0;5
1663;Eglutė;OBUOLIUKAI;6965837585;Taip;0;2;0;2
1664;Eglutė;OBUOLIUKAI;9292940501;Taip;4;1;0;5
1665;Eglutė;KAŠTONAS;3107823269;Taip;3;5;1;9
1666;Eglutė;KAŠTONAS;3799824061;Taip;0;4;0;4
1667;Eglutė;KAŠTONAS;8655425408;Taip;0;2;1;3
1668;Eglutė;KAŠTONAS;1380219881;Taip;9;0;1;10
1669;Eglutė;KAŠTONAS;3387392137;Taip;0;1;0;1
1670;Eglutė;KAŠTONAS;7027121333;Taip;3;3;0;6
1671;Eglutė;KAŠTONAS;1744942011;Taip;2;1;1;4
1672;Eglutė;KAŠTONAS;8384141923;Taip;10;5;0;15
1673;Eglutė;KAŠTONAS;3112281182;Ne;8;0;1;9
1674;Eglutė;KAŠTONAS;1432716037;Taip;0;1;0;1
1675;Eglutė;KAŠTONAS;9542684993;Taip;0;11;0;11
1676;Eglutė;KAŠTONAS;6967074765;Taip;4;0;0;4
1677;Eglutė;KAŠTONAS;6679186715;Taip;2;0;1;3
1678;Eglutė;KAŠTONAS;9054104040;Taip;0;14;0;14
1679;Eglutė;KAŠTONAS;9193920390;Taip;0;8;0;8
1680;Eglutė;KAŠTONAS;8246870069;Taip;0;1;0;1
1681;Eglutė;KAŠTONAS;8721209423;Taip;7;0;2;9
1682;Eglutė;KAŠTONAS;7789753835;Taip;0;1;0;1
1683;Eglutė;KAŠTONAS;7114040071;Taip;0;6;0;6
1684;Eglutė;KAŠTONAS;7254436716;Taip;11;0;1;12
1685;Eglutė;EŽIUKAI;1422631723;Taip;4;16;0;20
1686;Eglutė;EŽIUKAI;6709551046;Taip;0;1;0;1
1687;Eglutė;EŽIUKAI;6093932811;Taip;0;7;0;7
1688;Eglutė;EŽIUKAI;3473388722;Taip;0;4;0;4
1689;Eglutė;EŽIUKAI;9402686801;Taip;0;15;0;15
1690;Eglutė;EŽIUKAI;2597978713;Taip;0;6;0;6
1691;Eglutė;EŽIUKAI;4451772812;Taip;1;0;0;1
1692;Eglutė;EŽIUKAI;9929681000;Taip;3;0;0;3
1693;Eglutė;EŽIUKAI;6105927493;Taip;1;2;0;3
1694;Eglutė;EŽIUKAI;4560670047;Taip;7;6;0;13
1695;Eglutė;EŽIUKAI;1048451048;Taip;0;3;0;3
1696;Eglutė;EŽIUKAI;6279703448;Ne;0;2;0;2
1697;Eglutė;EŽIUKAI;6142326330;Ne;0;2;0;2
1698;Eglutė;EŽIUKAI;1534556744;Taip;4;0;0;4
1699;Eglutė;EŽIUKAI;7598993411;Taip;15;2;0;17
1700;Eglutė;EŽIUKAI;4047404616;Taip;3;4;0;7
1701;Eglutė;EŽIUKAI;4230594049;Taip;0;8;0;8
1702;Eglutė;EŽIUKAI;8797889347;Taip;0;4;0;4
1703;Eglutė;EŽIUKAI;3006381069;Taip;0;4;0;4
1704;Eglutė;EŽIUKAI;3870885357;Taip;0;6;0;6
1705;Eglutė;GILĖ;6272115803;Taip;0;1;0;1
1706;Eglutė;GILĖ;2857760751;Taip;0;0;2;2
1707;Eglutė;GILĖ;8129230197;Taip;0;2;0;2
1708;Eglutė;GILĖ;1393626624;Taip;0;1;0;1
1709;Eglutė;GILĖ;2917925763;Taip;0;0;1;1
1710;Eglutė;GILĖ;9746021019;Taip;0;4;0;4
1711;Eglutė;GILĖ;5013664843;Taip;1;5;0;6
1712;Eglutė;GILĖ;2276311106;Taip;4;0;0;4
1713;Eglutė;GILĖ;6924344686;Taip;0;3;0;3
1714;Eglutė;GILĖ;5645197324;Taip;0;1;1;2
1715;Eglutė;GILĖ;9098132159;Taip;0;3;0;3
1716;Eglutė;GILĖ;2615824395;Taip;1;6;0;7
1717;Eglutė;GILĖ;1899379269;Taip;0;0;2;2
1718;Eglutė;GILĖ;3605053253;Taip;9;3;0;12
1719;Eglutė;GILĖ;1531942494;Taip;0;7;0;7
1720;Eglutė;GILĖ;5840014240;Taip;0;4;0;4
1721;Eglutė;GILĖ;9758104910;Ne;0;4;5;9
1722;Eglutė;GILĖ;9515238936;Taip;3;0;0;3
1723;Eglutė;GILĖ;6309529738;Taip;3;2;0;5
1724;Eglutė;SAULUTĖ;9741776217;Taip;0;8;0;8
1725;Eglutė;SAULUTĖ;3091324735;Taip;0;4;0;4
1726;Eglutė;SAULUTĖ;8739346084;Taip;0;2;0;2
1727;Eglutė;SAULUTĖ;5518570006;Taip;2;6;0;8
1728;Eglutė;SAULUTĖ;5805450838;Taip;3;2;0;5
1729;Eglutė;SAULUTĖ;9084576953;Ne;0;4;4;8
1730;Eglutė;SAULUTĖ;4489150480;Taip;9;8;0;17
1731;Eglutė;SAULUTĖ;2425927050;Ne;0;6;0;6
1732;Eglutė;SAULUTĖ;5918429438;Taip;0;6;2;8
1733;Eglutė;SAULUTĖ;5006042568;Taip;0;3;0;3
1734;Eglutė;SAULUTĖ;5275306818;Taip;5;0;0;5
1735;Eglutė;SAULUTĖ;2621445549;Taip;10;0;0;10
1736;Eglutė;SAULUTĖ;6328900251;Taip;0;5;0;5
1737;Eglutė;SAULUTĖ;9661883776;Taip;0;11;0;11
1738;Eglutė;SAULUTĖ;8799063905;Taip;0;4;0;4
1739;Eglutė;SAULUTĖ;6572235324;Taip;0;4;0;4
1740;Eglutė;SAULUTĖ;1923176808;Ne;0;1;0;1
1741;Eglutė;SAULUTĖ;2872597971;Taip;0;1;0;1
1742;Eglutė;SAULUTĖ;3690266358;Taip;0;4;0;4
1743;Eglutė;ŠARKELĖ;1667851586;Taip;12;1;0;13
1744;Eglutė;ŠARKELĖ;8410302338;Taip;0;10;0;10
1745;Eglutė;ŠARKELĖ;1715411901;Taip;1;4;0;5
1746;Eglutė;ŠARKELĖ;9875724921;Taip;0;6;0;6
1747;Eglutė;ŠARKELĖ;7564179845;Taip;0;1;0;1
1748;Eglutė;ŠARKELĖ;9178835404;Taip;0;23;0;23
1749;Eglutė;ŠARKELĖ;6773894090;Taip;6;0;0;6
1750;Eglutė;ŠARKELĖ;5146804510;Taip;11;0;0;11
1751;Eglutė;ŠARKELĖ;7231828805;Taip;0;8;0;8
1752;Eglutė;ŠARKELĖ;7618937988;Taip;0;4;0;4
1753;Eglutė;ŠARKELĖ;6805213753;Taip;3;0;0;3
1754;Eglutė;ŠARKELĖ;3368734808;Taip;0;4;19;23
1755;Eglutė;ŠARKELĖ;4465995209;Taip;8;5;0;13
1756;Eglutė;ŠARKELĖ;4697026463;Taip;9;7;0;16
1757;Eglutė;ŠARKELĖ;9795027066;Ne;10;1;0;11
1758;Eglutė;ŠARKELĖ;3974970972;Taip;12;2;0;14
1759;Eglutė;ŠARKELĖ;2950414583;Taip;15;8;0;23
1760;Eglutė;ŠARKELĖ;6171697873;Taip;0;1;0;1
1761;Eglutė;ŠARKELĖ;6631296204;Taip;4;3;0;7
1762;Eglutė;NYKŠTUKAI;3210398495;Taip;4;6;1;11
1763;Eglutė;NYKŠTUKAI;4056836413;Taip;0;2;0;2
1764;Eglutė;NYKŠTUKAI;2546506486;Taip;14;0;2;16
1765;Eglutė;NYKŠTUKAI;6173724448;Taip;0;1;0;1
1766;Eglutė;NYKŠTUKAI;2073980883;Taip;0;8;0;8
1767;Eglutė;NYKŠTUKAI;9415802329;Taip;0;2;2;4
1768;Eglutė;NYKŠTUKAI;2824749988;Taip;8;0;0;8
1769;Eglutė;NYKŠTUKAI;4508182019;Taip;0;3;1;4
1770;Eglutė;NYKŠTUKAI;5840899666;Taip;0;6;5;11
1771;Eglutė;ŽIRNIUKAI;3706904006;Taip;0;0;1;1
1772;Eglutė;ŽIRNIUKAI;1645141463;Taip;1;1;0;2
1773;Eglutė;ŽIRNIUKAI;8640230418;Taip;2;0;0;2
1774;Eglutė;ŽIRNIUKAI;6469399675;Taip;5;0;0;5
1775;Eglutė;ŽIRNIUKAI;5991097138;Taip;0;0;6;6
1776;Eglutė;BORUŽIUKAI;5982037450;Taip;0;7;0;7
1777;Eglutė;BORUŽIUKAI;7994301287;Taip;8;1;0;9
1778;Eglutė;BORUŽIUKAI;9300315869;Taip;3;0;1;4
1779;Eglutė;BORUŽIUKAI;4476918512;Taip;18;0;0;18
1780;Eglutė;BORUŽIUKAI;8751687849;Taip;0;0;1;1
1781;Eglutė;BORUŽIUKAI;3228447710;Taip;0;0;2;2
1782;Eglutė;BORUŽIUKAI;7288367894;Taip;3;0;0;3
1783;Eglutė;BORUŽIUKAI;1446642492;Taip;0;7;0;7
1784;Eglutė;BORUŽIUKAI;9894789541;Taip;23;0;0;23
1785;Eglutė;BORUŽIUKAI;1699040995;Taip;0;0;3;3
1786;Eglutė;BORUŽIUKAI;7184265921;Taip;1;0;0;1
1787;"Geniukų kalvė";SAULUTĖS;9557055841;Taip;6;1;0;7
1788;"Geniukų kalvė";SAULUTĖS;4329782598;Taip;0;20;0;20
1789;"Geniukų kalvė";SAULUTĖS;8932671578;Taip;4;0;2;6
1790;"Geniukų kalvė";SAULUTĖS;9522911738;Taip;3;1;1;5
1791;"Geniukų kalvė";SAULUTĖS;5348211316;Taip;0;2;0;2
1792;"Geniukų kalvė";SAULUTĖS;7886553419;Taip;2;0;0;2
1793;"Geniukų kalvė";SAULUTĖS;4946218794;Taip;0;2;0;2
1794;"Geniukų kalvė";SAULUTĖS;4525874796;Taip;0;1;0;1
1795;"Geniukų kalvė";SAULUTĖS;4745451344;Taip;2;0;0;2
1796;"Geniukų kalvė";SAULUTĖS;9768077014;Taip;0;4;0;4
1797;"Geniukų kalvė";SAULUTĖS;3889643236;Taip;5;13;0;18
1798;"Geniukų kalvė";SAULUTĖS;6102906310;Taip;0;6;0;6
1799;"Geniukų kalvė";SAULUTĖS;6016735700;Taip;8;4;2;14
1800;"Geniukų kalvė";SAULUTĖS;9976423099;Taip;6;1;0;7
1801;"Geniukų kalvė";SAULUTĖS;5180240547;Ne;0;4;1;5
1802;"Geniukų kalvė";SAULUTĖS;7140298387;Taip;7;0;0;7
1803;"Geniukų kalvė";SAULUTĖS;7006566384;Taip;2;0;2;4
1804;"Geniukų kalvė";SAULUTĖS;1571869318;Ne;0;4;0;4
1805;"Geniukų kalvė";BITUTĖS;5587035951;Taip;0;4;0;4
1806;"Geniukų kalvė";BITUTĖS;9323779212;Taip;8;0;0;8
1807;"Geniukų kalvė";BITUTĖS;2110578252;Taip;1;0;0;1
1808;"Geniukų kalvė";BITUTĖS;8577323715;Taip;0;3;0;3
1809;"Geniukų kalvė";BITUTĖS;7453065865;Taip;8;0;0;8
1810;"Geniukų kalvė";BITUTĖS;8570015975;Taip;4;1;0;5
1811;"Geniukų kalvė";BITUTĖS;9455124402;Taip;9;0;0;9
1812;"Geniukų kalvė";BITUTĖS;4633553106;Taip;7;1;0;8
1813;"Geniukų kalvė";BITUTĖS;3669378459;Taip;0;3;0;3
1814;"Geniukų kalvė";BITUTĖS;4201333532;Taip;3;4;2;9
1815;"Geniukų kalvė";BITUTĖS;5102325807;Taip;0;8;0;8
1816;"Geniukų kalvė";BITUTĖS;1492140432;Taip;13;0;0;13
1817;"Geniukų kalvė";BITUTĖS;1426555835;Taip;1;4;0;5
1818;"Geniukų kalvė";BITUTĖS;7747615302;Taip;1;0;0;1
1819;"Geniukų kalvė";BITUTĖS;4691978116;Taip;7;0;0;7
1820;"Geniukų kalvė";BITUTĖS;6111168227;Taip;0;1;0;1
1821;"Geniukų kalvė";BITUTĖS;7744441981;Taip;1;0;0;1
1822;"Geniukų kalvė";BITUTĖS;1209268848;Taip;1;0;0;1
1823;"Geniukų kalvė";BITUTĖS;6351861630;Taip;4;1;0;5
1824;"Geniukų kalvė";BITUTĖS;6214681079;Taip;20;0;0;20
1825;"Geniukų kalvė";BITUTĖS;3221034847;Taip;8;0;1;9
1826;"Geniukų kalvė";BITUTĖS;2813336498;Taip;1;1;0;2
1827;"Geniukų kalvė";KIŠKUČIAI;5253380852;Taip;8;0;2;10
1828;"Geniukų kalvė";KIŠKUČIAI;2684344984;Taip;1;0;0;1
1829;"Geniukų kalvė";KIŠKUČIAI;5078771341;Taip;6;1;0;7
1830;"Geniukų kalvė";KIŠKUČIAI;4849740486;Ne;0;1;0;1
1831;"Geniukų kalvė";KIŠKUČIAI;9730758999;Taip;14;0;0;14
1832;"Geniukų kalvė";KIŠKUČIAI;9579750299;Taip;0;0;1;1
1833;"Geniukų kalvė";KIŠKUČIAI;9543553237;Taip;0;7;0;7
1834;"Geniukų kalvė";KIŠKUČIAI;2032408983;Taip;0;7;0;7
1835;"Geniukų kalvė";KIŠKUČIAI;9386761753;Taip;9;9;0;18
1836;"Geniukų kalvė";KIŠKUČIAI;6188518268;Taip;0;0;3;3
1837;"Geniukų kalvė";KIŠKUČIAI;1945456486;Taip;8;0;0;8
1838;"Geniukų kalvė";KIŠKUČIAI;3887137828;Taip;10;0;0;10
1839;"Geniukų kalvė";KIŠKUČIAI;2396085192;Taip;8;4;0;12
1840;"Geniukų kalvė";KIŠKUČIAI;8760512032;Ne;6;0;0;6
1841;"Geniukų kalvė";KIŠKUČIAI;4249054993;Taip;0;2;0;2
1842;"Geniukų kalvė";KIŠKUČIAI;1642514752;Taip;12;0;3;15
1843;"Geniukų kalvė";KIŠKUČIAI;9199949456;Taip;17;0;0;17
1844;"Geniukų kalvė";KIŠKUČIAI;9368537477;Taip;0;0;3;3
1845;"Geniukų kalvė";KIŠKUČIAI;6022259388;Taip;0;0;2;2
1846;"Geniukų kalvė";KIŠKUČIAI;8340662627;Taip;7;4;0;11
1847;"Geniukų kalvė";VYTURĖLIAI;4958738745;Taip;0;4;4;8
1848;"Geniukų kalvė";VYTURĖLIAI;9069256760;Taip;14;0;0;14
1849;"Geniukų kalvė";VYTURĖLIAI;2665955524;Taip;0;2;0;2
1850;"Geniukų kalvė";VYTURĖLIAI;5161535756;Taip;0;8;0;8
1851;"Geniukų kalvė";VYTURĖLIAI;3493492581;Taip;0;2;0;2
1852;"Geniukų kalvė";VYTURĖLIAI;3193006249;Taip;0;3;0;3
1853;"Geniukų kalvė";VYTURĖLIAI;6828079735;Taip;0;4;0;4
1854;"Geniukų kalvė";VYTURĖLIAI;2205515766;Taip;3;1;0;4
1855;"Geniukų kalvė";VYTURĖLIAI;1891205998;Taip;2;8;0;10
1856;"Geniukų kalvė";VYTURĖLIAI;3085228868;Taip;3;4;0;7
1857;"Geniukų kalvė";VYTURĖLIAI;3297360222;Taip;5;0;0;5
1858;"Geniukų kalvė";VYTURĖLIAI;6794151223;Taip;0;4;0;4
1859;"Geniukų kalvė";VYTURĖLIAI;4777155321;Taip;1;4;0;5
1860;"Geniukų kalvė";VYTURĖLIAI;1037854104;Taip;4;0;0;4
1861;"Geniukų kalvė";VYTURĖLIAI;9643242164;Taip;0;6;0;6
1862;"Geniukų kalvė";VYTURĖLIAI;5684792148;Ne;8;0;0;8
1863;"Geniukų kalvė";DRUGELIAI;2217221922;Taip;6;5;0;11
1864;"Geniukų kalvė";DRUGELIAI;1811866428;Taip;0;3;0;3
1865;"Geniukų kalvė";DRUGELIAI;8271041553;Taip;0;4;0;4
1866;"Geniukų kalvė";DRUGELIAI;1237228692;Taip;5;4;0;9
1867;"Geniukų kalvė";DRUGELIAI;6410008429;Taip;10;0;0;10
1868;"Geniukų kalvė";DRUGELIAI;3055777730;Taip;0;7;0;7
1869;"Geniukų kalvė";DRUGELIAI;8770345339;Taip;14;0;0;14
1870;"Geniukų kalvė";DRUGELIAI;1051563985;Taip;0;6;0;6
1871;"Geniukų kalvė";DRUGELIAI;5146141771;Taip;0;1;0;1
1872;"Geniukų kalvė";DRUGELIAI;6174114461;Taip;2;5;0;7
1873;"Geniukų kalvė";DRUGELIAI;1611845627;Taip;4;2;0;6
1874;"Geniukų kalvė";DRUGELIAI;2659298240;Taip;0;4;0;4
1875;"Geniukų kalvė";DRUGELIAI;9677583445;Taip;6;4;0;10
1876;"Geniukų kalvė";DRUGELIAI;6737863183;Taip;7;4;0;11
1877;"Geniukų kalvė";DRUGELIAI;5704223824;Taip;7;1;0;8
1878;"Geniukų kalvė";DRUGELIAI;3166309530;Taip;0;6;0;6
1879;"Geniukų kalvė";"SAULĖS ZUIKUČIAI";7033628178;Taip;7;0;0;7
1880;"Geniukų kalvė";"SAULĖS ZUIKUČIAI";7082945033;Taip;6;4;0;10
1881;"Geniukų kalvė";"SAULĖS ZUIKUČIAI";2313382307;Taip;4;1;1;6
1882;"Geniukų kalvė";"SAULĖS ZUIKUČIAI";8309953586;Taip;1;0;0;1
1883;"Geniukų kalvė";"SAULĖS ZUIKUČIAI";7500079028;Taip;6;0;2;8
1884;"Geniukų kalvė";"SAULĖS ZUIKUČIAI";8071493871;Taip;15;4;0;19
1885;"Geniukų kalvė";"SAULĖS ZUIKUČIAI";1718428600;Taip;2;0;0;2
1886;"Geniukų kalvė";"SAULĖS ZUIKUČIAI";8914605154;Taip;0;4;0;4
1887;"Geniukų kalvė";"SAULĖS ZUIKUČIAI";6016585056;Taip;9;0;0;9
1888;"Geniukų kalvė";"SAULĖS ZUIKUČIAI";2816691996;Taip;5;0;0;5
1889;"Geniukų kalvė";"SAULĖS ZUIKUČIAI";5512172533;Taip;0;5;0;5
1890;"Geniukų kalvė";"SAULĖS ZUIKUČIAI";1375674317;Taip;11;0;0;11
1891;"Geniukų kalvė";"SAULĖS ZUIKUČIAI";4722801116;Taip;1;2;0;3
1892;"Geniukų kalvė";"SAULĖS ZUIKUČIAI";5763009912;Taip;0;4;2;6
1893;"Geniukų kalvė";"SAULĖS ZUIKUČIAI";5245434552;Taip;0;4;1;5
1894;"Geniukų kalvė";"SAULĖS ZUIKUČIAI";2952604528;Taip;7;0;0;7
1895;"Geniukų kalvė";"SAULĖS ZUIKUČIAI";5725034297;Taip;0;3;0;3
1896;"Geniukų kalvė";"SAULĖS ZUIKUČIAI";1499735818;Taip;3;1;1;5
1897;"Geniukų kalvė";"SAULĖS ZUIKUČIAI";4186376527;Taip;10;4;0;14
1898;"Geniukų kalvė";"SAULĖS ZUIKUČIAI";5161600326;Taip;0;0;4;4
1899;"Geniukų kalvė";"SAULĖS ZUIKUČIAI";4975437036;Taip;4;0;1;5
1900;"Geniukų kalvė";"SAULĖS ZUIKUČIAI";1277485419;Taip;11;0;2;13
1901;"Geniukų kalvė";SMALSUČIAI;2499796674;Taip;6;0;0;6
1902;"Geniukų kalvė";SMALSUČIAI;5974481787;Taip;2;6;0;8
1903;"Geniukų kalvė";SMALSUČIAI;7915720190;Taip;3;0;0;3
1904;"Geniukų kalvė";SMALSUČIAI;7384802397;Taip;11;0;0;11
1905;"Geniukų kalvė";SMALSUČIAI;8985466295;Taip;0;4;0;4
1906;"Geniukų kalvė";SMALSUČIAI;5129841490;Taip;5;1;0;6
1907;"Geniukų kalvė";SMALSUČIAI;5705917381;Taip;4;0;0;4
1908;"Geniukų kalvė";SMALSUČIAI;4231659246;Taip;9;0;0;9
1909;"Geniukų kalvė";SMALSUČIAI;2300947427;Taip;3;0;0;3
1910;"Geniukų kalvė";SMALSUČIAI;1028242614;Taip;0;2;0;2
1911;"Geniukų kalvė";SMALSUČIAI;2596680448;Taip;0;1;0;1
1912;"Geniukų kalvė";SMALSUČIAI;4405381922;Taip;14;0;0;14
1913;"Geniukų kalvė";SMALSUČIAI;6473724074;Taip;11;0;0;11
1914;"Geniukų kalvė";SMALSUČIAI;3627418555;Taip;0;8;0;8
1915;"Geniukų kalvė";SMALSUČIAI;9155681194;Taip;7;2;0;9
1916;"Geniukų kalvė";SMALSUČIAI;7440029486;Taip;3;3;0;6
1917;"Geniukų kalvė";SMALSUČIAI;6168422514;Taip;21;0;0;21
1918;"Geniukų kalvė";SMALSUČIAI;6514696294;Taip;0;3;0;3
1919;"Geniukų kalvė";SMALSUČIAI;6757580298;Taip;8;0;0;8
1920;"Geniukų kalvė";SMALSUČIAI;1573612317;Taip;0;7;0;7
1921;"Geniukų kalvė";SMALSUČIAI;6138451393;Taip;4;1;0;5
1922;"Geniukų kalvė";RUDNOSIUKAI;7079072084;Taip;4;0;0;4
1923;"Geniukų kalvė";RUDNOSIUKAI;6060825704;Taip;2;0;0;2
1924;"Geniukų kalvė";RUDNOSIUKAI;6149037133;Taip;7;6;0;13
1925;"Geniukų kalvė";RUDNOSIUKAI;5883913787;Taip;0;4;0;4
1926;"Geniukų kalvė";RUDNOSIUKAI;9696452101;Taip;1;4;0;5
1927;"Geniukų kalvė";RUDNOSIUKAI;2426186771;Taip;11;0;0;11
1928;"Geniukų kalvė";RUDNOSIUKAI;2836282651;Taip;6;0;0;6
1929;"Geniukų kalvė";RUDNOSIUKAI;9847003556;Taip;4;0;0;4
1930;"Geniukų kalvė";RUDNOSIUKAI;7300853810;Ne;8;0;0;8
1931;"Geniukų kalvė";RUDNOSIUKAI;3852896932;Taip;3;1;0;4
1932;"Geniukų kalvė";RUDNOSIUKAI;2165793561;Taip;0;13;0;13
1933;"Geniukų kalvė";RUDNOSIUKAI;8973285553;Taip;7;0;0;7
1934;"Geniukų kalvė";RUDNOSIUKAI;5559324196;Taip;0;0;5;5
1935;"Geniukų kalvė";RUDNOSIUKAI;4985606198;Taip;7;0;4;11
1936;"Geniukų kalvė";RUDNOSIUKAI;3631181701;Taip;0;0;1;1
1937;"Geniukų kalvė";RUDNOSIUKAI;2798750158;Taip;2;5;0;7
1938;"Geniukų kalvė";RUDNOSIUKAI;6373989816;Taip;1;1;0;2
1939;"Geniukų kalvė";PELĖDŽIUKAI;6783296167;Taip;0;1;1;2
1940;"Geniukų kalvė";PELĖDŽIUKAI;1844495906;Taip;5;0;0;5
1941;"Geniukų kalvė";PELĖDŽIUKAI;5744371590;Taip;0;0;4;4
1942;"Geniukų kalvė";PELĖDŽIUKAI;5847488152;Taip;0;6;0;6
1943;"Geniukų kalvė";PELĖDŽIUKAI;4890413509;Taip;10;0;0;10
1944;"Geniukų kalvė";PELĖDŽIUKAI;3676717541;Taip;0;0;1;1
1945;"Geniukų kalvė";PELĖDŽIUKAI;9319251542;Taip;10;0;0;10
1946;"Geniukų kalvė";PELĖDŽIUKAI;7310171451;Taip;4;6;0;10
1947;"Geniukų kalvė";PELĖDŽIUKAI;8653679467;Taip;1;2;0;3
1948;"Geniukų kalvė";PELĖDŽIUKAI;9820642056;Taip;4;6;0;10
1949;"Geniukų kalvė";PELĖDŽIUKAI;1179440839;Taip;3;0;1;4
1950;"Geniukų kalvė";PELĖDŽIUKAI;8277880528;Taip;5;0;0;5
1951;"Geniukų kalvė";PELĖDŽIUKAI;4037514656;Taip;7;0;0;7
1952;"Geniukų kalvė";PELĖDŽIUKAI;2448906549;Taip;5;0;0;5
1953;"Geniukų kalvė";PELĖDŽIUKAI;2884835744;Taip;9;0;0;9
1954;"Geniukų kalvė";PELĖDŽIUKAI;9958205266;Taip;11;0;1;12
1955;"Geniukų kalvė";PELĖDŽIUKAI;9107673658;Taip;4;0;0;4
1956;"Geniukų kalvė";BORUŽĖLĖS;7561521903;Taip;6;0;0;6
1957;"Geniukų kalvė";BORUŽĖLĖS;2312298671;Taip;5;4;0;9
1958;"Geniukų kalvė";BORUŽĖLĖS;8217855034;Taip;6;4;0;10
1959;"Geniukų kalvė";BORUŽĖLĖS;1068112116;Taip;15;0;0;15
1960;"Geniukų kalvė";BORUŽĖLĖS;1421857914;Taip;4;1;0;5
1961;"Geniukų kalvė";BORUŽĖLĖS;1558977259;Taip;5;0;0;5
1962;"Geniukų kalvė";BORUŽĖLĖS;7736527608;Taip;2;3;0;5
1963;"Geniukų kalvė";BORUŽĖLĖS;4805806745;Taip;4;0;0;4
1964;"Geniukų kalvė";BORUŽĖLĖS;1383717352;Taip;4;0;0;4
1965;"Geniukų kalvė";BORUŽĖLĖS;3071724778;Taip;0;1;0;1
1966;"Geniukų kalvė";BORUŽĖLĖS;2302465593;Taip;1;1;0;2
1967;"Geniukų kalvė";BORUŽĖLĖS;3024701779;Taip;3;0;0;3
1968;"Geniukų kalvė";BORUŽĖLĖS;1822730314;Taip;9;0;0;9
1969;"Geniukų kalvė";BORUŽĖLĖS;3015544833;Taip;16;2;0;18
1970;"Geniukų kalvė";BORUŽĖLĖS;9264121921;Taip;3;0;0;3
1971;"Geniukų kalvė";BORUŽĖLĖS;3071147714;Taip;4;1;0;5
1972;"Geniukų kalvė";BORUŽĖLĖS;7776771879;Taip;1;0;0;1
1973;"Geniukų kalvė";BORUŽĖLĖS;9446649021;Taip;2;0;0;2
1974;"Geniukų kalvė";BORUŽĖLĖS;1733621845;Taip;14;0;0;14
1975;"Geniukų kalvė";BORUŽĖLĖS;9445669807;Taip;3;0;0;3
1976;"Geniukų kalvė";PAGRANDUKAI;8525540366;Taip;11;0;0;11
1977;"Geniukų kalvė";PAGRANDUKAI;8214399001;Taip;2;1;0;3
1978;"Geniukų kalvė";PAGRANDUKAI;4651934103;Taip;4;0;0;4
1979;"Geniukų kalvė";PAGRANDUKAI;2905400583;Taip;1;1;0;2
1980;"Geniukų kalvė";PAGRANDUKAI;2584997232;Taip;11;0;0;11
1981;"Geniukų kalvė";PAGRANDUKAI;3430336639;Taip;7;4;0;11
1982;"Geniukų kalvė";PAGRANDUKAI;1330046867;Taip;6;0;0;6
1983;"Geniukų kalvė";PAGRANDUKAI;9669738771;Taip;1;0;0;1
1984;"Geniukų kalvė";PAGRANDUKAI;9483545114;Taip;8;4;0;12
1985;"Geniukų kalvė";PAGRANDUKAI;8987495724;Taip;1;4;0;5
1986;"Geniukų kalvė";PAGRANDUKAI;1060081499;Taip;10;1;0;11
1987;"Geniukų kalvė";PAGRANDUKAI;3961089171;Taip;1;0;0;1
1988;"Geniukų kalvė";PAGRANDUKAI;9261284850;Taip;5;0;0;5
1989;"Geniukų kalvė";NYKŠTUKAI;9322790214;Taip;0;1;0;1
1990;"Geniukų kalvė";NYKŠTUKAI;6680434763;Ne;0;5;1;6
1991;"Geniukų kalvė";NYKŠTUKAI;7161460256;Taip;7;4;5;16
1992;"Geniukų kalvė";NYKŠTUKAI;3484288126;Taip;13;0;0;13
1993;"Geniukų kalvė";NYKŠTUKAI;9111691146;Taip;2;0;0;2
1994;"Geniukų kalvė";NYKŠTUKAI;7093135374;Taip;1;0;0;1
1995;"Geniukų kalvė";NYKŠTUKAI;3227799882;Taip;16;0;0;16
1996;"Geniukų kalvė";NYKŠTUKAI;1639585179;Taip;6;0;0;6
1997;"Geniukų kalvė";NYKŠTUKAI;5102755395;Taip;0;0;3;3
1998;"Geniukų kalvė";NYKŠTUKAI;4251353237;Taip;10;0;0;10
1999;"Geniukų kalvė";NYKŠTUKAI;1828348351;Taip;9;0;2;11
2000;"Geniukų kalvė";NYKŠTUKAI;1842445148;Taip;0;0;5;5
2001;Gelvonėlis;ĄŽUOLIUKAI;2329699993;Taip;4;2;0;6
2002;Gelvonėlis;ĄŽUOLIUKAI;9058956012;Taip;19;0;0;19
2003;Gelvonėlis;ĄŽUOLIUKAI;4111774915;Taip;0;5;0;5
2004;Gelvonėlis;ĄŽUOLIUKAI;3677100165;Taip;9;0;1;10
2005;Gelvonėlis;ĄŽUOLIUKAI;7449710008;Taip;0;7;0;7
2006;Gelvonėlis;ĄŽUOLIUKAI;8163855482;Taip;0;5;0;5
2007;Gelvonėlis;ĄŽUOLIUKAI;3942630720;Taip;0;8;0;8
2008;Gelvonėlis;ĄŽUOLIUKAI;1453271708;Taip;5;1;0;6
2009;Gelvonėlis;ĄŽUOLIUKAI;9756155028;Taip;10;5;0;15
2010;Gelvonėlis;ĄŽUOLIUKAI;8206816148;Taip;14;0;0;14
2011;Gelvonėlis;ĄŽUOLIUKAI;1274119900;Taip;0;12;0;12
2012;Gelvonėlis;ĄŽUOLIUKAI;5901499708;Taip;8;0;0;8
2013;Gelvonėlis;ĄŽUOLIUKAI;1403890893;Taip;0;0;2;2
2014;Gelvonėlis;ĄŽUOLIUKAI;2519955694;Taip;5;0;2;7
2015;Gelvonėlis;ĄŽUOLIUKAI;6620102515;Taip;2;0;3;5
2016;Gelvonėlis;ĄŽUOLIUKAI;6451006729;Taip;1;0;0;1
2017;Gelvonėlis;ĄŽUOLIUKAI;4190673346;Ne;10;6;0;16
2018;Gelvonėlis;ĄŽUOLIUKAI;2289745479;Taip;10;0;2;12
2019;Gelvonėlis;ŽVIRBLIUKAI;5024860112;Taip;0;2;0;2
2020;Gelvonėlis;ŽVIRBLIUKAI;8987012601;Taip;9;0;0;9
2021;Gelvonėlis;ŽVIRBLIUKAI;7632523330;Taip;0;0;3;3
2022;Gelvonėlis;ŽVIRBLIUKAI;1112841066;Taip;0;14;0;14
2023;Gelvonėlis;ŽVIRBLIUKAI;4156493586;Taip;0;0;3;3
2024;Gelvonėlis;ŽVIRBLIUKAI;2553846157;Taip;5;0;0;5
2025;Gelvonėlis;ŽVIRBLIUKAI;8003522011;Taip;7;5;0;12
2026;Gelvonėlis;ŽVIRBLIUKAI;9900244859;Taip;14;0;0;14
2027;Gelvonėlis;ŽVIRBLIUKAI;4027647695;Ne;10;0;0;10
2028;Gelvonėlis;ŽVIRBLIUKAI;5713586282;Taip;0;0;1;1
2029;Gelvonėlis;ŽVIRBLIUKAI;5874473596;Taip;0;7;0;7
2030;Gelvonėlis;ŽVIRBLIUKAI;5305480599;Taip;0;4;0;4
2031;Gelvonėlis;ŽVIRBLIUKAI;5124211917;Taip;0;6;1;7
2032;Gelvonėlis;ŽVIRBLIUKAI;8540204705;Taip;0;4;0;4
2033;Gelvonėlis;ŽVIRBLIUKAI;8124516993;Taip;9;0;0;9
2034;Gelvonėlis;ŽVIRBLIUKAI;9751580494;Taip;0;0;1;1
2035;Gelvonėlis;RASELĖS;1925203042;Ne;5;4;0;9
2036;Gelvonėlis;RASELĖS;5996128423;Taip;3;4;0;7
2037;Gelvonėlis;RASELĖS;9149117970;Taip;3;2;0;5
2038;Gelvonėlis;RASELĖS;6451557430;Taip;0;2;0;2
2039;Gelvonėlis;RASELĖS;1802520150;Taip;5;0;0;5
2040;Gelvonėlis;RASELĖS;3192542909;Taip;9;9;0;18
2041;Gelvonėlis;RASELĖS;9622818893;Taip;0;4;0;4
2042;Gelvonėlis;RASELĖS;2638430817;Taip;0;4;4;8
2043;Gelvonėlis;RASELĖS;6949090250;Taip;0;4;0;4
2044;Gelvonėlis;RASELĖS;1462716950;Taip;0;3;1;4
2045;Gelvonėlis;RASELĖS;9600526942;Taip;3;4;0;7
2046;Gelvonėlis;RASELĖS;1387948936;Taip;4;3;0;7
2047;Gelvonėlis;RASELĖS;9650922918;Taip;5;3;0;8
2048;Gelvonėlis;RASELĖS;5790038422;Taip;7;0;0;7
2049;Gelvonėlis;RASELĖS;1587584701;Taip;3;0;0;3
2050;Gelvonėlis;SAULUTĖ;7392743619;Taip;0;0;3;3
2051;Gelvonėlis;SAULUTĖ;8228796927;Taip;0;1;0;1
2052;Gelvonėlis;SAULUTĖ;1734685590;Taip;0;0;6;6
2053;Gelvonėlis;SAULUTĖ;7936622964;Taip;0;4;1;5
2054;Gelvonėlis;SAULUTĖ;3719670896;Taip;9;1;0;10
2055;Gelvonėlis;SAULUTĖ;1672409070;Ne;4;0;0;4
2056;Gelvonėlis;SAULUTĖ;3771796903;Taip;9;0;1;10
2057;Gelvonėlis;SAULUTĖ;4268590631;Taip;9;10;0;19
2058;Gelvonėlis;SAULUTĖ;5598186460;Taip;0;3;0;3
2059;Gelvonėlis;SAULUTĖ;9767254134;Taip;6;9;1;16
2060;Gelvonėlis;SAULUTĖ;2452711535;Taip;0;17;2;19
2061;Gelvonėlis;SAULUTĖ;3371560338;Taip;0;5;2;7
2062;Gelvonėlis;SAULUTĖ;2800795052;Taip;7;0;0;7
2063;Gelvonėlis;SAULUTĖ;9980127170;Taip;4;0;0;4
2064;Gelvonėlis;SAULUTĖ;6206837435;Taip;4;0;0;4
2065;Gelvonėlis;PELĖDŽIUKAI;6604992169;Taip;0;13;0;13
2066;Gelvonėlis;PELĖDŽIUKAI;8508450500;Taip;0;16;0;16
2067;Gelvonėlis;PELĖDŽIUKAI;8704971956;Ne;0;0;3;3
2068;Gelvonėlis;PELĖDŽIUKAI;6556472766;Taip;0;3;4;7
2069;Gelvonėlis;PELĖDŽIUKAI;7182180008;Taip;0;5;1;6
2070;Gelvonėlis;PELĖDŽIUKAI;6598178467;Taip;2;7;0;9
2071;Gelvonėlis;PELĖDŽIUKAI;8885088900;Taip;0;4;0;4
2072;Gelvonėlis;PELĖDŽIUKAI;2400289466;Taip;0;4;2;6
2073;Gelvonėlis;PELĖDŽIUKAI;1987204544;Taip;0;5;0;5
2074;Gelvonėlis;PELĖDŽIUKAI;2288951845;Taip;0;0;1;1
2075;Gelvonėlis;PELĖDŽIUKAI;2515471132;Taip;11;0;0;11
2076;Gelvonėlis;PELĖDŽIUKAI;4281431471;Taip;0;3;1;4
2077;Gelvonėlis;PELĖDŽIUKAI;6319058542;Taip;0;4;0;4
2078;Gelvonėlis;PELĖDŽIUKAI;9538571448;Taip;0;8;0;8
2079;Gelvonėlis;PELĖDŽIUKAI;9147186080;Taip;9;5;0;14
2080;Gelvonėlis;PELĖDŽIUKAI;7195164378;Taip;0;4;1;5
2081;Gelvonėlis;DRUGELIAI;2407650243;Taip;0;4;0;4
2082;Gelvonėlis;DRUGELIAI;2407650243;Taip;0;4;0;4
2083;Gelvonėlis;DRUGELIAI;7733244178;Taip;11;0;0;11
2084;Gelvonėlis;DRUGELIAI;1252450619;Taip;1;0;0;1
2085;Gelvonėlis;DRUGELIAI;7811394993;Taip;18;0;0;18
2086;Gelvonėlis;DRUGELIAI;1723279380;Taip;11;0;0;11
2087;Gelvonėlis;DRUGELIAI;4125444433;Taip;5;0;0;5
2088;Gelvonėlis;DRUGELIAI;4738577955;Taip;8;4;0;12
2089;Gelvonėlis;DRUGELIAI;3452557722;Taip;1;0;0;1
2090;Gelvonėlis;DRUGELIAI;2045223350;Taip;0;5;0;5
2091;Gelvonėlis;DRUGELIAI;5850515555;Taip;6;4;0;10
2092;Gelvonėlis;VARPELIAI;6131268672;Ne;7;0;0;7
2093;Gelvonėlis;VARPELIAI;4088437014;Taip;5;0;3;8
2094;Gelvonėlis;VARPELIAI;3150970953;Ne;4;0;4;8
2095;Gelvonėlis;VARPELIAI;2877046472;Taip;3;10;0;13
2096;Gelvonėlis;VARPELIAI;2896360160;Taip;6;0;1;7
2097;Gelvonėlis;VARPELIAI;4162701876;Taip;0;18;0;18
2098;Gelvonėlis;VARPELIAI;8365647638;Taip;0;1;2;3
2099;Gelvonėlis;VARPELIAI;3618681535;Taip;7;0;0;7
2100;Gelvonėlis;VARPELIAI;9386056584;Taip;5;1;0;6
2101;Gelvonėlis;VARPELIAI;2114734415;Taip;23;0;0;23
2102;Gelvonėlis;VARPELIAI;5882430535;Taip;7;0;0;7
2103;Gelvonėlis;VARPELIAI;9140900868;Taip;8;5;0;13
2104;Gelvonėlis;VARPELIAI;2645337382;Taip;2;0;3;5
2105;Gelvonėlis;VARPELIAI;3813000890;Taip;4;0;0;4
2106;Gelvonėlis;VARPELIAI;6662081736;Taip;7;0;0;7
2107;Gelvonėlis;VARPELIAI;5379820728;Taip;5;0;0;5
2108;Gelvonėlis;VARPELIAI;7938324572;Taip;10;0;0;10
2109;Gelvonėlis;VARPELIAI;1984082487;Taip;18;0;0;18
2110;Gelvonėlis;BORUŽĖLĖS;8209225630;Taip;10;4;0;14
2111;Gelvonėlis;BORUŽĖLĖS;6554989142;Ne;8;1;0;9
2112;Gelvonėlis;BORUŽĖLĖS;8056058298;Taip;0;0;1;1
2113;Gelvonėlis;BORUŽĖLĖS;2434789595;Taip;5;0;0;5
2114;Gelvonėlis;BORUŽĖLĖS;4112607183;Taip;0;3;2;5
2115;Gelvonėlis;BORUŽĖLĖS;6243360625;Taip;0;4;0;4
2116;Gelvonėlis;BORUŽĖLĖS;8515746171;Taip;4;0;0;4
2117;Gelvonėlis;BORUŽĖLĖS;1712926391;Taip;0;4;4;8
2118;Gelvonėlis;BORUŽĖLĖS;6647585785;Taip;8;0;0;8
2119;Gelvonėlis;BORUŽĖLĖS;1539850989;Taip;9;0;0;9
2120;Gelvonėlis;BORUŽĖLĖS;8973272332;Taip;5;0;0;5
2121;Gelvonėlis;BORUŽĖLĖS;9849765037;Taip;0;3;0;3
2122;Gelvonėlis;BORUŽĖLĖS;4749071286;Taip;9;1;0;10
2123;Gelvonėlis;BORUŽĖLĖS;3926733474;Taip;0;4;5;9
2124;Gelvonėlis;BORUŽĖLĖS;4620517551;Taip;5;0;5;10
2125;Gelvonėlis;BORUŽĖLĖS;6598688551;Taip;11;0;0;11
2126;Gelvonėlis;NYKŠTUKAI;9150177446;Taip;0;4;4;8
2127;Gelvonėlis;NYKŠTUKAI;5311057148;Taip;7;0;0;7
2128;Gelvonėlis;NYKŠTUKAI;9266138595;Taip;20;0;0;20
2129;Gelvonėlis;NYKŠTUKAI;6740297512;Taip;9;0;0;9
2130;Gelvonėlis;NYKŠTUKAI;2302268767;Taip;14;0;0;14
2131;Gelvonėlis;NYKŠTUKAI;4723497260;Taip;3;10;0;13
2132;Gelvonėlis;NYKŠTUKAI;8962769076;Taip;14;0;0;14
2133;Gelvonėlis;NYKŠTUKAI;3173327297;Taip;9;0;0;9
2134;Gelvonėlis;NYKŠTUKAI;2820416461;Taip;6;0;1;7
2135;Gelvonėlis;NYKŠTUKAI;9529938060;Taip;0;1;0;1
2136;Gelvonėlis;NYKŠTUKAI;6072327798;Taip;3;13;0;16
2137;Gelvonėlis;NYKŠTUKAI;4423931995;Taip;7;0;0;7
2138;Gelvonėlis;NYKŠTUKAI;2195887907;Taip;10;0;0;10
2139;Gelvonėlis;NYKŠTUKAI;4244879840;Taip;8;1;0;9
2140;Gelvonėlis;NYKŠTUKAI;1167713450;Ne;15;0;3;18
2141;Gelvonėlis;NYKŠTUKAI;8863386276;Ne;11;0;0;11
2142;Gelvonėlis;BITUTĖS;6534527571;Taip;0;7;0;7
2143;Gelvonėlis;BITUTĖS;1105838340;Taip;15;0;0;15
2144;Gelvonėlis;BITUTĖS;5865866507;Taip;18;0;0;18
2145;Gelvonėlis;BITUTĖS;5444127599;Taip;5;2;0;7
2146;Gelvonėlis;BITUTĖS;5633162524;Taip;0;2;1;3
2147;Gelvonėlis;BITUTĖS;6330751030;Taip;7;0;0;7
2148;Gelvonėlis;BITUTĖS;6710189985;Taip;6;6;0;12
2149;Gelvonėlis;BITUTĖS;5281400074;Taip;10;0;0;10
2150;Gelvonėlis;BITUTĖS;3514762919;Taip;0;4;1;5
2151;Gelvonėlis;BITUTĖS;8792171281;Taip;0;0;3;3
2152;Gelvonėlis;BITUTĖS;7850553299;Taip;0;1;0;1
2153;Gelvonėlis;BITUTĖS;1730718430;Ne;0;7;3;10
2154;Gelvonėlis;BITUTĖS;8480138654;Taip;0;4;0;4
2155;Gelvonėlis;BITUTĖS;7725313260;Taip;9;4;0;13
2156;Gelvonėlis;BITUTĖS;5816373550;Taip;8;0;2;10
2157;Gelvonėlis;BITUTĖS;4380468764;Taip;13;4;0;17
2158;Gelvonėlis;BITUTĖS;3961569387;Taip;4;0;0;4
2159;Gelvonėlis;RAMUNĖLĖS;1104204810;Taip;6;0;0;6
2160;Gelvonėlis;RAMUNĖLĖS;1355774181;Taip;0;0;1;1
2161;Gelvonėlis;RAMUNĖLĖS;2774170680;Taip;0;11;0;11
2162;Gelvonėlis;RAMUNĖLĖS;9403505858;Taip;7;5;0;12
2163;Gelvonėlis;RAMUNĖLĖS;7686930719;Taip;7;0;0;7
2164;Gelvonėlis;RAMUNĖLĖS;4450990418;Taip;0;7;0;7
2165;Gelvonėlis;RAMUNĖLĖS;7419947442;Taip;10;0;0;10
2166;Gelvonėlis;RAMUNĖLĖS;6883156109;Taip;5;1;0;6
2167;Gelvonėlis;RAMUNĖLĖS;1562829157;Taip;0;4;0;4
2168;Gelvonėlis;RAMUNĖLĖS;4211228746;Taip;0;1;0;1
2169;Gelvonėlis;RAMUNĖLĖS;1661034338;Taip;10;3;0;13
2170;Gelvonėlis;RAMUNĖLĖS;2821485779;Taip;18;0;0;18
2171;Gelvonėlis;RAMUNĖLĖS;7301596834;Taip;20;0;0;20
2172;Gelvonėlis;RAMUNĖLĖS;9046297659;Taip;21;0;0;21
2173;Gelvonėlis;RAMUNĖLĖS;9492898584;Taip;0;8;0;8
2174;Gelvonėlis;RAMUNĖLĖS;7654781219;Taip;1;0;0;1
2175;Gelvonėlis;RAMUNĖLĖS;7464963101;Ne;0;0;3;3
2176;Gelvonėlis;RIEŠUTĖLIAI;3368423382;Taip;12;0;0;12
2177;Gelvonėlis;RIEŠUTĖLIAI;5461812139;Taip;0;13;0;13
2178;Gelvonėlis;RIEŠUTĖLIAI;5986018609;Taip;0;0;6;6
2179;Gelvonėlis;RIEŠUTĖLIAI;8532801167;Ne;0;4;0;4
2180;Gelvonėlis;RIEŠUTĖLIAI;4208103106;Taip;0;11;0;11
2181;Gelvonėlis;RIEŠUTĖLIAI;8766702456;Taip;4;0;0;4
2182;Gelvonėlis;RIEŠUTĖLIAI;6305084811;Taip;7;0;1;8
2183;Gelvonėlis;RIEŠUTĖLIAI;2005647155;Taip;8;0;0;8
2184;Gelvonėlis;RIEŠUTĖLIAI;1266479895;Taip;0;1;0;1
2185;Gelvonėlis;RIEŠUTĖLIAI;5934077931;Taip;0;7;0;7
2186;Gelvonėlis;RIEŠUTĖLIAI;4280463938;Taip;0;1;0;1
2187;Gelvonėlis;RIEŠUTĖLIAI;6471921512;Taip;0;2;0;2
2188;Gelvonėlis;RIEŠUTĖLIAI;3448444552;Taip;0;1;0;1
2189;Gelvonėlis;RIEŠUTĖLIAI;4832167372;Taip;12;1;0;13
2190;Gelvonėlis;RIEŠUTĖLIAI;1466616814;Taip;5;4;1;10
2191;Gelvonėlis;RIEŠUTĖLIAI;2015807805;Taip;6;4;0;10
2192;Gelvonėlis;RIEŠUTĖLIAI;9323228591;Taip;0;0;3;3
2193;Gelvonėlis;RIEŠUTĖLIAI;2360728722;Taip;13;0;1;14
2194;Gelvonėlis;RIEŠUTĖLIAI;9132529216;Taip;0;15;0;15
2195;"Gervelė (Dzūkų g. 32)";ŽIRNIUKAI;7140356352;Taip;3;0;1;4
2196;"Gervelė (Dzūkų g. 32)";ŽIRNIUKAI;3170062234;Taip;4;0;0;4
2197;"Gervelė (Dzūkų g. 32)";ŽIRNIUKAI;9532470407;Taip;4;0;0;4
2198;"Gervelė (Dzūkų g. 32)";ŽIRNIUKAI;5608916470;Taip;0;0;1;1
2199;"Gervelė (Dzūkų g. 32)";ŽIRNIUKAI;8098158634;Taip;4;4;1;9
2200;"Gervelė (Dzūkų g. 32)";ŽIRNIUKAI;7205673717;Taip;8;0;1;9
2201;"Gervelė (Dzūkų g. 32)";ŽIRNIUKAI;3554640994;Taip;7;0;0;7
2202;"Gervelė (Dzūkų g. 32)";ŽIRNIUKAI;1020706652;Taip;4;0;0;4
2203;"Gervelė (Dzūkų g. 32)";ŽIRNIUKAI;4552290778;Taip;2;0;0;2
2204;"Gervelė (Dzūkų g. 32)";ŽIRNIUKAI;9884946783;Taip;16;0;0;16
2205;"Gervelė (Dzūkų g. 32)";ŽIRNIUKAI;4174471780;Ne;15;0;0;15
2206;"Gervelė (Dzūkų g. 32)";ŽIRNIUKAI;6424240375;Ne;23;0;0;23
2207;"Gervelė (Dzūkų g. 32)";ŽIRNIUKAI;2210605017;Ne;15;0;0;15
2208;"Gervelė (Dzūkų g. 32)";ŽIRNIUKAI;8882442987;Taip;10;0;0;10
2209;"Gervelė (Dzūkų g. 32)";ŽIRNIUKAI;1777909973;Taip;8;0;1;9
2210;"Gervelė (Dzūkų g. 32)";ŽIRNIUKAI;1400829693;Ne;4;0;5;9
2211;"Gervelė (Dzūkų g. 32)";ŽIRNIUKAI;4661861470;Taip;23;0;0;23
2212;"Gervelė (Dzūkų g. 32)";LAŠIUKAI;2523056808;Taip;1;4;3;8
2213;"Gervelė (Dzūkų g. 32)";LAŠIUKAI;6844406500;Taip;11;6;0;17
2214;"Gervelė (Dzūkų g. 32)";LAŠIUKAI;8811086908;Taip;0;1;0;1
2215;"Gervelė (Dzūkų g. 32)";LAŠIUKAI;2046282471;Taip;23;0;0;23
2216;"Gervelė (Dzūkų g. 32)";LAŠIUKAI;1573560581;Taip;6;0;0;6
2217;"Gervelė (Dzūkų g. 32)";LAŠIUKAI;7192663882;Taip;5;0;0;5
2218;"Gervelė (Dzūkų g. 32)";LAŠIUKAI;1024397071;Ne;9;0;0;9
2219;"Gervelė (Dzūkų g. 32)";LAŠIUKAI;1783612448;Taip;9;4;0;13
2220;"Gervelė (Dzūkų g. 32)";LAŠIUKAI;7040713170;Ne;13;0;0;13
2221;"Gervelė (Dzūkų g. 32)";LAŠIUKAI;4075328330;Taip;15;0;0;15
2222;"Gervelė (Dzūkų g. 32)";LAŠIUKAI;7394199974;Taip;6;0;0;6
2223;"Gervelė (Dzūkų g. 32)";LAŠIUKAI;5497737178;Taip;11;0;0;11
2224;"Gervelė (Dzūkų g. 32)";LAŠIUKAI;5480025851;Ne;11;0;0;11
2225;"Gervelė (Dzūkų g. 32)";LAŠIUKAI;7363767471;Taip;17;0;0;17
2226;"Gervelė (Dzūkų g. 32)";LAŠIUKAI;4932912245;Taip;11;0;0;11
2227;"Gervelė (Dzūkų g. 32)";PABIRUČIAI;1637204236;Taip;4;2;0;6
2228;"Gervelė (Dzūkų g. 32)";PABIRUČIAI;8157865822;Taip;0;7;0;7
2229;"Gervelė (Dzūkų g. 32)";PABIRUČIAI;7924884022;Taip;10;10;0;20
2230;"Gervelė (Dzūkų g. 32)";PABIRUČIAI;3702908570;Taip;0;1;0;1
2231;"Gervelė (Dzūkų g. 32)";PABIRUČIAI;4899690598;Ne;0;0;21;21
2232;"Gervelė (Dzūkų g. 32)";PABIRUČIAI;5799823801;Taip;4;0;0;4
2233;"Gervelė (Dzūkų g. 32)";PABIRUČIAI;6058944385;Taip;0;5;0;5
2234;"Gervelė (Dzūkų g. 32)";PABIRUČIAI;3647044817;Taip;5;0;1;6
2235;"Gervelė (Dzūkų g. 32)";PABIRUČIAI;6431701403;Taip;1;0;6;7
2236;"Gervelė (Dzūkų g. 32)";PABIRUČIAI;2446758975;Taip;8;5;0;13
2237;"Gervelė (Dzūkų g. 32)";PABIRUČIAI;2413995770;Taip;7;5;0;12
2238;"Gervelė (Dzūkų g. 32)";PABIRUČIAI;8533480337;Taip;0;2;0;2
2239;"Gervelė (Dzūkų g. 32)";PABIRUČIAI;8287867336;Ne;0;16;0;16
2240;"Gervelė (Dzūkų g. 32)";PABIRUČIAI;2186818108;Taip;9;0;0;9
2241;"Gervelė (Dzūkų g. 32)";PABIRUČIAI;8439479958;Taip;2;5;0;7
2242;"Gervelė (Dzūkų g. 32)";BITUTĖS;5360362280;Taip;4;0;1;5
2243;"Gervelė (Dzūkų g. 32)";BITUTĖS;5360362280;Taip;4;0;1;5
2244;"Gervelė (Dzūkų g. 32)";BITUTĖS;7317091881;Taip;3;0;0;3
2245;"Gervelė (Dzūkų g. 32)";BITUTĖS;6951455424;Taip;0;4;2;6
2246;"Gervelė (Dzūkų g. 32)";BITUTĖS;9977349707;Taip;0;2;0;2
2247;"Gervelė (Dzūkų g. 32)";BITUTĖS;3333885493;Taip;8;0;1;9
2248;"Gervelė (Dzūkų g. 32)";BITUTĖS;4295743997;Taip;0;4;0;4
2249;"Gervelė (Dzūkų g. 32)";BITUTĖS;1112844296;Taip;4;0;1;5
2250;"Gervelė (Dzūkų g. 32)";BITUTĖS;7935059565;Taip;0;4;6;10
2251;"Gervelė (Dzūkų g. 32)";BITUTĖS;5267617723;Taip;0;0;3;3
2252;"Gervelė (Dzūkų g. 32)";BITUTĖS;5953552777;Taip;0;4;0;4
2253;"Gervelė (Dzūkų g. 32)";BITUTĖS;4038179503;Taip;0;4;0;4
2254;"Gervelė (Dzūkų g. 32)";BITUTĖS;1160084928;Taip;15;0;0;15
2255;"Gervelė (Dzūkų g. 32)";BITUTĖS;6287806975;Taip;0;3;1;4
2256;"Gervelė (Dzūkų g. 32)";BURATINO;9239897472;Taip;0;0;1;1
2257;"Gervelė (Dzūkų g. 32)";BURATINO;9982951468;Taip;12;1;0;13
2258;"Gervelė (Dzūkų g. 32)";BURATINO;4775822341;Taip;0;13;0;13
2259;"Gervelė (Dzūkų g. 32)";BURATINO;2913622440;Taip;5;9;1;15
2260;"Gervelė (Dzūkų g. 32)";BURATINO;4434618210;Taip;0;2;0;2
2261;"Gervelė (Dzūkų g. 32)";BURATINO;6166476760;Ne;0;0;2;2
2262;"Gervelė (Dzūkų g. 32)";BURATINO;4516538272;Taip;3;3;2;8
2263;"Gervelė (Dzūkų g. 32)";BURATINO;3723783633;Taip;4;4;0;8
2264;"Gervelė (Dzūkų g. 32)";BURATINO;8472436632;Taip;11;0;0;11
2265;"Gervelė (Dzūkų g. 32)";BURATINO;1655678792;Ne;7;0;1;8
2266;"Gervelė (Dzūkų g. 32)";BURATINO;9697299387;Taip;0;3;3;6
2267;"Gervelė (Dzūkų g. 32)";BURATINO;7300458249;Taip;13;4;0;17
2268;"Gervelė (Dzūkų g. 32)";BURATINO;7998812497;Taip;0;4;0;4
2269;"Gervelė (Dzūkų g. 32)";BURATINO;5737517940;Taip;11;4;0;15
2270;"Gervelė (Dzūkų g. 32)";BURATINO;6595410865;Taip;13;0;2;15
2271;"Gervelė (Dzūkų g. 32)";BURATINO;1932916710;Taip;0;6;0;6
2272;"Gervelė (Dzūkų g. 32)";BURATINO;2080374597;Taip;19;0;0;19
2273;"Gervelė (Dzūkų g. 32)";BURATINO;1270020781;Taip;8;0;0;8
2274;"Gervelė (Dzūkų g. 32)";BURATINO;9768014964;Taip;0;0;2;2
2275;"Gervelė (Dzūkų g. 32)";BURATINO;2359854614;Taip;0;5;0;5
2276;"Gervelė (Dzūkų g. 32)";VIŠČIUKŲ;4112178405;Taip;0;0;2;2
2277;"Gervelė (Dzūkų g. 32)";VIŠČIUKŲ;8193126684;Taip;11;0;0;11
2278;"Gervelė (Dzūkų g. 32)";VIŠČIUKŲ;7152159380;Taip;8;0;1;9
2279;"Gervelė (Dzūkų g. 32)";VIŠČIUKŲ;6503715631;Taip;4;0;0;4
2280;"Gervelė (Dzūkų g. 32)";VIŠČIUKŲ;6071962550;Taip;8;0;4;12
2281;"Gervelė (Dzūkų g. 32)";VIŠČIUKŲ;8456221074;Taip;23;0;0;23
2282;"Gervelė (Dzūkų g. 32)";VIŠČIUKŲ;9738262953;Taip;11;4;1;16
2283;"Gervelė (Dzūkų g. 32)";VIŠČIUKŲ;8792240321;Taip;0;0;2;2
2284;"Gervelė (Dzūkų g. 32)";VIŠČIUKŲ;8392147716;Taip;0;0;12;12
2285;"Gervelė (Dzūkų g. 32)";VIŠČIUKŲ;6254125398;Taip;13;0;3;16
2286;"Gilužis (Vydūno g. 11A)";Skruzdėliukų;9707968228;Taip;0;7;0;7
2287;"Gilužis (Vydūno g. 11A)";Skruzdėliukų;8628253655;Taip;4;13;0;17
2288;"Gilužis (Vydūno g. 11A)";Skruzdėliukų;9783700319;Taip;10;2;0;12
2289;"Gilužis (Vydūno g. 11A)";Skruzdėliukų;4509741536;Taip;0;6;0;6
2290;"Gilužis (Vydūno g. 11A)";Skruzdėliukų;3002266577;Taip;0;7;0;7
2291;"Gilužis (Vydūno g. 11A)";Skruzdėliukų;5497242500;Taip;0;4;0;4
2292;"Gilužis (Vydūno g. 11A)";Skruzdėliukų;5190752112;Ne;7;2;0;9
2293;"Gilužis (Vydūno g. 11A)";Skruzdėliukų;2440762487;Ne;7;2;0;9
2294;"Gilužis (Vydūno g. 11A)";Skruzdėliukų;9104005195;Taip;1;2;0;3
2295;"Gilužis (Vydūno g. 11A)";Skruzdėliukų;5394693502;Taip;9;5;0;14
2296;"Gilužis (Vydūno g. 11A)";Skruzdėliukų;4106792355;Taip;0;2;0;2
2297;"Gilužis (Vydūno g. 11A)";Skruzdėliukų;4876074981;Taip;0;10;0;10
2298;"Gilužis (Vydūno g. 11A)";Skruzdėliukų;2633680406;Taip;3;4;0;7
2299;"Gilužis (Vydūno g. 11A)";Skruzdėliukų;4455977087;Taip;0;1;0;1
2300;"Gilužis (Vydūno g. 11A)";Skruzdėliukų;1085130813;Taip;2;6;0;8
2301;"Gilužis (Vydūno g. 11A)";Skruzdėliukų;2615087717;Taip;2;4;0;6
2302;"Gilužis (Vydūno g. 11A)";Skruzdėliukų;2516315604;Taip;5;1;0;6
2303;"Gilužis (Vydūno g. 11A)";Skruzdėliukų;2706629834;Taip;12;3;0;15
2304;"Gilužis (Vydūno g. 11A)";Skruzdėliukų;5556674867;Taip;9;0;0;9
2305;"Gilužis (Vydūno g. 11A)";Skruzdėliukų;6831107153;Taip;6;0;0;6
2306;"Gilužis (Vydūno g. 11A)";Skruzdėliukų;8852862161;Taip;6;0;0;6
2307;"Gilužis (Vydūno g. 11A)";Skruzdėliukų;2955779117;Taip;7;0;0;7
2308;"Gilužis (Vydūno g. 11A)";Nykštukų;3132445117;Taip;0;5;0;5
2309;"Gilužis (Vydūno g. 11A)";Nykštukų;4147821853;Taip;0;10;0;10
2310;"Gilužis (Vydūno g. 11A)";Nykštukų;7937643339;Taip;4;2;0;6
2311;"Gilužis (Vydūno g. 11A)";Nykštukų;3473889426;Taip;0;6;0;6
2312;"Gilužis (Vydūno g. 11A)";Nykštukų;9362581908;Taip;0;6;0;6
2313;"Gilužis (Vydūno g. 11A)";Nykštukų;8899557365;Taip;0;3;0;3
2314;"Gilužis (Vydūno g. 11A)";Nykštukų;2661894041;Taip;0;3;0;3
2315;"Gilužis (Vydūno g. 11A)";Nykštukų;7228498662;Taip;2;0;0;2
2316;"Gilužis (Vydūno g. 11A)";Nykštukų;3335512812;Taip;0;1;0;1
2317;"Gilužis (Vydūno g. 11A)";Nykštukų;1459273692;Taip;0;3;0;3
2318;"Gilužis (Vydūno g. 11A)";Nykštukų;4156613717;Taip;0;11;0;11
2319;"Gilužis (Vydūno g. 11A)";Nykštukų;5713786735;Taip;0;5;0;5
2320;"Gilužis (Vydūno g. 11A)";Nykštukų;4541291716;Taip;0;4;0;4
2321;"Gilužis (Vydūno g. 11A)";Nykštukų;8522552650;Taip;6;5;0;11
2322;"Gilužis (Vydūno g. 11A)";Nykštukų;3176305306;Taip;4;4;0;8
2323;"Gilužis (Vydūno g. 11A)";Nykštukų;4795108770;Ne;0;1;0;1
2324;"Gilužis (Vydūno g. 11A)";Nykštukų;4094486541;Taip;2;4;0;6
2325;"Gilužis (Vydūno g. 11A)";Nykštukų;6493142538;Taip;1;5;0;6
2326;"Gilužis (Vydūno g. 11A)";Nykštukų;5088561405;Taip;9;3;0;12
2327;"Gilužis (Vydūno g. 11A)";Bitučių;4841014668;Taip;1;1;0;2
2328;"Gilužis (Vydūno g. 11A)";Bitučių;3399162399;Taip;5;3;0;8
2329;"Gilužis (Vydūno g. 11A)";Bitučių;5973671038;Taip;4;3;0;7
2330;"Gilužis (Vydūno g. 11A)";Bitučių;1634295583;Taip;0;3;4;7
2331;"Gilužis (Vydūno g. 11A)";Bitučių;4360261750;Taip;0;3;3;6
2332;"Gilužis (Vydūno g. 11A)";Bitučių;5728341732;Taip;8;0;0;8
2333;"Gilužis (Vydūno g. 11A)";Bitučių;2780710383;Taip;0;7;0;7
2334;"Gilužis (Vydūno g. 11A)";Bitučių;6931726275;Taip;0;7;0;7
2335;"Gilužis (Vydūno g. 11A)";Bitučių;1867185320;Taip;7;5;0;12
2336;"Gilužis (Vydūno g. 11A)";Bitučių;3429435736;Taip;4;0;0;4
2337;"Gilužis (Vydūno g. 11A)";Bitučių;8539946703;Taip;0;23;0;23
2338;"Gilužis (Vydūno g. 11A)";Bitučių;9000351000;Taip;5;3;0;8
2339;"Gilužis (Vydūno g. 11A)";Bitučių;5366174839;Taip;5;8;0;13
2340;"Gilužis (Vydūno g. 11A)";Bitučių;5162397237;Taip;6;4;0;10
2341;"Gilužis (Vydūno g. 11A)";Bitučių;7250617867;Taip;3;0;0;3
2342;"Gilužis (Vydūno g. 11A)";Bitučių;9053608903;Taip;9;8;0;17
2343;"Gilužis (Vydūno g. 11A)";Bitučių;6115776872;Taip;0;0;2;2
2344;"Gilužis (Vydūno g. 11A)";Bitučių;5651799121;Taip;4;0;2;6
2345;"Gilužis (Vydūno g. 11A)";Bitučių;2950813185;Taip;0;8;0;8
2346;"Gilužis (Vydūno g. 11A)";Bitučių;6515525848;Taip;2;9;0;11
2347;"Gilužis (Vydūno g. 11A)";Bitučių;2345403784;Taip;3;0;4;7
2348;"Gilužis (Vydūno g. 11A)";Kačiukų;1273655212;Taip;0;5;0;5
2349;"Gilužis (Vydūno g. 11A)";Kačiukų;4978922821;Taip;10;1;0;11
2350;"Gilužis (Vydūno g. 11A)";Kačiukų;2945406185;Taip;7;1;0;8
2351;"Gilužis (Vydūno g. 11A)";Kačiukų;1582241363;Taip;6;4;0;10
2352;"Gilužis (Vydūno g. 11A)";Kačiukų;7330938312;Taip;2;0;3;5
2353;"Gilužis (Vydūno g. 11A)";Kačiukų;6571132974;Taip;0;23;0;23
2354;"Gilužis (Vydūno g. 11A)";Kačiukų;7001112696;Taip;2;0;0;2
2355;"Gilužis (Vydūno g. 11A)";Kačiukų;9034842169;Taip;4;0;1;5
2356;"Gilužis (Vydūno g. 11A)";Kačiukų;6966795180;Taip;0;5;0;5
2357;"Gilužis (Vydūno g. 11A)";Kačiukų;5128383851;Taip;0;1;2;3
2358;"Gilužis (Vydūno g. 11A)";Kačiukų;8318405114;Taip;0;3;0;3
2359;"Gilužis (Vydūno g. 11A)";Kačiukų;7826015897;Taip;0;1;0;1
2360;"Gilužis (Vydūno g. 11A)";Kačiukų;4403218878;Taip;5;5;0;10
2361;"Gilužis (Vydūno g. 11A)";Kačiukų;3419281756;Taip;5;1;0;6
2362;"Gilužis (Vydūno g. 11A)";Kačiukų;1862524255;Taip;3;0;0;3
2363;"Gilužis (Vydūno g. 11A)";Kačiukų;9421351780;Taip;0;2;0;2
2364;"Gilužis (Vydūno g. 11A)";Kačiukų;4128387076;Taip;6;0;0;6
2365;"Gilužis (Vydūno g. 11A)";Kačiukų;7042664923;Taip;0;4;0;4
2366;"Gilužis (Vydūno g. 11A)";Kačiukų;9097165155;Taip;10;0;0;10
2367;"Gilužis (Vydūno g. 11A)";Kačiukų;8762534617;Taip;0;14;0;14
2368;"Gilužis (Vydūno g. 11A)";Kačiukų;5641406427;Taip;3;0;0;3
2369;"Gilužis (Vydūno g. 11A)";Pelėdžiukų;5989314494;Taip;4;10;0;14
2370;"Gilužis (Vydūno g. 11A)";Pelėdžiukų;7998695149;Taip;4;0;0;4
2371;"Gilužis (Vydūno g. 11A)";Pelėdžiukų;7742783427;Taip;4;0;0;4
2372;"Gilužis (Vydūno g. 11A)";Pelėdžiukų;7358572344;Taip;4;4;0;8
2373;"Gilužis (Vydūno g. 11A)";Pelėdžiukų;4617259961;Taip;7;0;0;7
2374;"Gilužis (Vydūno g. 11A)";Pelėdžiukų;1222370750;Taip;3;4;0;7
2375;"Gilužis (Vydūno g. 11A)";Pelėdžiukų;9503516686;Taip;1;4;0;5
2376;"Gilužis (Vydūno g. 11A)";Pelėdžiukų;9833451628;Taip;0;2;0;2
2377;"Gilužis (Vydūno g. 11A)";Pelėdžiukų;6270071724;Taip;0;4;0;4
2378;"Gilužis (Vydūno g. 11A)";Pelėdžiukų;4051726208;Taip;5;5;0;10
2379;"Gilužis (Vydūno g. 11A)";Pelėdžiukų;7092060789;Taip;3;2;0;5
2380;"Gilužis (Vydūno g. 11A)";Pelėdžiukų;1804218972;Taip;1;6;2;9
2381;"Gilužis (Vydūno g. 11A)";Pelėdžiukų;2434419240;Taip;3;1;0;4
2382;"Gilužis (Vydūno g. 11A)";Pelėdžiukų;3166161973;Taip;4;0;0;4
2383;"Gilužis (Vydūno g. 11A)";Pelėdžiukų;5070988982;Taip;4;5;0;9
2384;"Gilužis (Vydūno g. 11A)";Pelėdžiukų;7899274495;Taip;0;3;0;3
2385;"Gilužis (Vydūno g. 11A)";Pelėdžiukų;6093514885;Taip;0;2;1;3
2386;"Gilužis (Vydūno g. 11A)";Pelėdžiukų;2869506388;Taip;0;1;0;1
2387;"Gilužis (Vydūno g. 11A)";Pelėdžiukų;9520409342;Taip;4;0;0;4
2388;"Gilužis (Vydūno g. 11A)";Pelėdžiukų;9186274541;Taip;4;0;0;4
2389;"Gilužis (Vydūno g. 11A)";Drugelių;6121625070;Taip;12;1;0;13
2390;"Gilužis (Vydūno g. 11A)";Drugelių;1770064694;Taip;0;2;0;2
2391;"Gilužis (Vydūno g. 11A)";Drugelių;9591229878;Taip;8;5;0;13
2392;"Gilužis (Vydūno g. 11A)";Drugelių;9092013248;Taip;8;7;0;15
2393;"Gilužis (Vydūno g. 11A)";Drugelių;9109883577;Taip;21;0;1;22
2394;"Gilužis (Vydūno g. 11A)";Drugelių;8006465211;Taip;7;0;0;7
2395;"Gilužis (Vydūno g. 11A)";Drugelių;5118401707;Taip;4;1;0;5
2396;"Gilužis (Vydūno g. 11A)";Drugelių;3190597262;Taip;11;6;0;17
2397;"Gilužis (Vydūno g. 11A)";Drugelių;2988856911;Taip;13;5;0;18
2398;"Gilužis (Vydūno g. 11A)";Drugelių;3532863024;Taip;0;23;0;23
2399;"Gilužis (Vydūno g. 11A)";Drugelių;1376645277;Taip;0;2;0;2
2400;"Gilužis (Vydūno g. 11A)";Drugelių;1410870589;Taip;0;4;0;4
2401;"Gilužis (Vydūno g. 11A)";Drugelių;6786334223;Taip;7;1;0;8
2402;"Gilužis (Vydūno g. 11A)";Drugelių;9112993465;Taip;17;0;0;17
2403;"Gilužis (Vydūno g. 11A)";Drugelių;4909329417;Taip;5;2;0;7
2404;"Gilužis (Vydūno g. 11A)";Drugelių;8244385001;Taip;7;2;0;9
2405;"Gilužis (Vydūno g. 11A)";Drugelių;6429142049;Taip;7;0;0;7
2406;"Gilužis (Vydūno g. 11A)";Drugelių;7731169885;Taip;0;1;0;1
2407;"Gilužis (Vydūno g. 11A)";Drugelių;1093643746;Taip;0;2;0;2
2408;"Gilužis (Vydūno g. 11A)";Drugelių;3902713866;Taip;7;0;0;7
2409;"Gilužis (Vydūno g. 11A)";Drugelių;6950139609;Taip;15;0;0;15
2410;"Gilužis (Vydūno g. 11A)";Drugelių;2397231165;Taip;7;0;0;7
2411;"Gilužis (Vydūno g. 11A)";Saulučių;5705945483;Taip;0;9;0;9
2412;"Gilužis (Vydūno g. 11A)";Saulučių;8237963602;Taip;12;0;0;12
2413;"Gilužis (Vydūno g. 11A)";Saulučių;6914566889;Taip;10;4;0;14
2414;"Gilužis (Vydūno g. 11A)";Saulučių;5306278297;Taip;11;0;0;11
2415;"Gilužis (Vydūno g. 11A)";Saulučių;1054809163;Taip;6;0;1;7
2416;"Gilužis (Vydūno g. 11A)";Saulučių;7887970476;Taip;9;0;0;9
2417;"Gilužis (Vydūno g. 11A)";Saulučių;6507021182;Taip;9;4;0;13
2418;"Gilužis (Vydūno g. 11A)";Saulučių;4652281185;Taip;8;0;0;8
2419;"Gilužis (Vydūno g. 11A)";Saulučių;4122073923;Taip;6;0;0;6
2420;"Gilužis (Vydūno g. 11A)";Saulučių;2364391112;Taip;5;0;0;5
2421;"Gilužis (Vydūno g. 11A)";Saulučių;7068801003;Taip;4;0;0;4
2422;"Gilužis (Vydūno g. 11A)";Saulučių;3081351563;Taip;7;0;0;7
2423;"Gilužis (Vydūno g. 11A)";Saulučių;1015379578;Taip;4;0;0;4
2424;"Gilužis (Vydūno g. 11A)";Saulučių;7247606321;Taip;9;3;1;13
2425;"Gilužis (Vydūno g. 11A)";Saulučių;8717811266;Taip;7;0;1;8
2426;"Gilužis (Vydūno g. 11A)";Saulučių;5769955074;Taip;0;1;0;1
2427;"Gilužis (Vydūno g. 11A)";Saulučių;7487731015;Taip;8;0;0;8
2428;"Gilužis (Vydūno g. 11A)";Saulučių;5079154238;Taip;10;0;1;11
2429;"Gilužis (Vydūno g. 11A)";Saulučių;5490128851;Taip;14;0;0;14
2430;"Gilužis (Vydūno g. 11A)";Saulučių;5784201106;Taip;3;0;0;3
2431;"Gilužis (Vydūno g. 11A)";Saulučių;8904873416;Taip;6;0;1;7
2432;"Gilužis (Vydūno g. 11A)";Saulučių;2851682356;Taip;10;0;0;10
2433;"Gilužis (Vydūno g. 11A)";Paukštelių;8662424856;Taip;0;5;0;5
2434;"Gilužis (Vydūno g. 11A)";Paukštelių;9934325492;Taip;3;1;0;4
2435;"Gilužis (Vydūno g. 11A)";Paukštelių;2883959240;Taip;7;2;0;9
2436;"Gilužis (Vydūno g. 11A)";Paukštelių;6322255194;Taip;1;7;0;8
2437;"Gilužis (Vydūno g. 11A)";Paukštelių;6572690788;Taip;6;4;4;14
2438;"Gilužis (Vydūno g. 11A)";Paukštelių;4153834736;Taip;0;8;1;9
2439;"Gilužis (Vydūno g. 11A)";Paukštelių;3646988912;Taip;0;4;0;4
2440;"Gilužis (Vydūno g. 11A)";Paukštelių;5030871828;Taip;0;4;0;4
2441;"Gilužis (Vydūno g. 11A)";Paukštelių;9919631327;Taip;2;3;0;5
2442;"Gilužis (Vydūno g. 11A)";Paukštelių;3954379433;Taip;0;2;0;2
2443;"Gilužis (Vydūno g. 11A)";Paukštelių;6129884232;Taip;4;1;0;5
2444;"Gilužis (Vydūno g. 11A)";Paukštelių;3804996594;Taip;0;1;0;1
2445;"Gilužis (Vydūno g. 11A)";Paukštelių;6478152041;Taip;0;3;0;3
2446;"Gilužis (Vydūno g. 11A)";Paukštelių;2524936605;Taip;5;4;0;9
2447;"Gilužis (Vydūno g. 11A)";Paukštelių;1005178052;Taip;0;5;0;5
2448;"Gilužis (Vydūno g. 11A)";Paukštelių;3141225891;Taip;0;5;0;5
2449;"Gilužis (Vydūno g. 11A)";Obuoliukų;9892608223;Taip;0;5;0;5
2450;"Gilužis (Vydūno g. 11A)";Obuoliukų;4058698645;Taip;0;4;0;4
2451;"Gilužis (Vydūno g. 11A)";Obuoliukų;1540018160;Taip;9;0;0;9
2452;"Gilužis (Vydūno g. 11A)";Obuoliukų;3131597174;Taip;5;0;0;5
2453;"Gilužis (Vydūno g. 11A)";Obuoliukų;6239369861;Taip;3;0;1;4
2454;"Gilužis (Vydūno g. 11A)";Obuoliukų;6172360933;Taip;9;3;0;12
2455;"Gilužis (Vydūno g. 11A)";Obuoliukų;7398446674;Taip;8;3;0;11
2456;"Gilužis (Vydūno g. 11A)";Obuoliukų;4592380105;Taip;6;6;0;12
2457;"Gilužis (Vydūno g. 11A)";Obuoliukų;4242362889;Taip;4;6;0;10
2458;"Gilužis (Vydūno g. 11A)";Obuoliukų;7560732216;Taip;4;6;0;10
2459;"Gilužis (Vydūno g. 11A)";Obuoliukų;5476140202;Taip;0;3;0;3
2460;"Gilužis (Vydūno g. 11A)";Obuoliukų;8194444043;Taip;7;0;0;7
2461;"Gilužis (Vydūno g. 11A)";Obuoliukų;7606394325;Taip;0;1;0;1
2462;"Gilužis (Vydūno g. 11A)";Obuoliukų;6737884137;Taip;0;12;0;12
2463;"Gilužis (Vydūno g. 11A)";Obuoliukų;3458957423;Taip;0;23;0;23
2464;"Gilužis (Vydūno g. 11A)";Obuoliukų;8900414658;Taip;4;4;0;8
2465;"Gilužis (Vydūno g. 11A)";Obuoliukų;3219101391;Taip;9;1;0;10
2466;"Gilužis (Vydūno g. 11A)";Obuoliukų;4528131001;Taip;19;0;0;19
2467;"Gilužis (Vydūno g. 11A)";Obuoliukų;5895659747;Taip;7;10;0;17
2468;"Gilužis (Vydūno g. 11A)";Obuoliukų;3331616067;Taip;4;1;0;5
2469;"Gilužis (Vydūno g. 11A)";KIŠKUČIŲ;5744027226;Taip;3;4;0;7
2470;"Gilužis (Vydūno g. 11A)";KIŠKUČIŲ;8639633038;Taip;0;1;0;1
2471;"Gilužis (Vydūno g. 11A)";KIŠKUČIŲ;5721924532;Taip;4;0;0;4
2472;"Gilužis (Vydūno g. 11A)";KIŠKUČIŲ;6323747855;Taip;4;0;0;4
2473;"Gilužis (Vydūno g. 11A)";KIŠKUČIŲ;2680643896;Taip;3;4;0;7
2474;"Gilužis (Vydūno g. 11A)";KIŠKUČIŲ;5685074731;Taip;0;4;0;4
2475;"Gilužis (Vydūno g. 11A)";KIŠKUČIŲ;3649616461;Taip;2;0;0;2
2476;"Gilužis (Vydūno g. 11A)";KIŠKUČIŲ;7632771776;Taip;6;1;0;7
2477;"Gilužis (Vydūno g. 11A)";KIŠKUČIŲ;7560574633;Taip;16;0;1;17
2478;"Gilužis (Vydūno g. 11A)";KIŠKUČIŲ;4199633620;Taip;9;1;1;11
2479;"Gilužis (Vydūno g. 11A)";KIŠKUČIŲ;9851612698;Taip;9;0;1;10
2480;"Gilužis (Vydūno g. 11A)";KIŠKUČIŲ;1391410955;Taip;9;4;10;23
2481;"Gilužis (Vydūno g. 11A)";KIŠKUČIŲ;6383469680;Taip;10;8;0;18
2482;"Gilužis (Vydūno g. 11A)";KIŠKUČIŲ;8341597766;Taip;7;0;0;7
2483;"Gilužis (Vydūno g. 11A)";KIŠKUČIŲ;4347319425;Taip;2;3;0;5
2484;"Gilužis (Vydūno g. 11A)";KIŠKUČIŲ;8591741716;Taip;4;0;0;4
2485;"Gilužis (Vydūno g. 11A)";KIŠKUČIŲ;8877445672;Taip;15;0;0;15
2486;"Gilužis (Vydūno g. 11A)";KIŠKUČIŲ;9489594782;Taip;1;1;0;2
2487;"Gilužis (Vydūno g. 11A)";KIŠKUČIŲ;7696478568;Taip;6;0;0;6
2488;"Gilužis (Vydūno g. 11A)";Meškučių;7263432152;Taip;4;0;0;4
2489;"Gilužis (Vydūno g. 11A)";Meškučių;4655266106;Taip;4;0;0;4
2490;"Gilužis (Vydūno g. 11A)";Meškučių;3800593189;Taip;9;6;0;15
2491;"Gilužis (Vydūno g. 11A)";Meškučių;4174307847;Taip;11;0;0;11
2492;"Gilužis (Vydūno g. 11A)";Meškučių;8393554697;Taip;3;10;0;13
2493;"Gilužis (Vydūno g. 11A)";Meškučių;8301535013;Taip;18;0;0;18
2494;"Gilužis (Vydūno g. 11A)";Meškučių;2939982311;Taip;10;5;0;15
2495;"Gilužis (Vydūno g. 11A)";Meškučių;3365778697;Taip;9;6;0;15
2496;"Gilužis (Vydūno g. 11A)";Meškučių;7912093880;Taip;6;5;0;11
2497;"Gilužis (Vydūno g. 11A)";Meškučių;2389277783;Taip;0;4;0;4
2498;"Gilužis (Vydūno g. 11A)";Meškučių;2500949029;Taip;0;3;0;3
2499;"Gilužis (Vydūno g. 11A)";Meškučių;4741129495;Taip;19;0;0;19
2500;"Gilužis (Vydūno g. 11A)";Meškučių;7992750316;Taip;0;23;0;23
2501;"Gilužis (Vydūno g. 11A)";Meškučių;5505153657;Taip;5;0;0;5
2502;"Gilužis (Vydūno g. 11A)";Meškučių;2577554894;Taip;11;0;0;11
2503;"Gilužis (Vydūno g. 11A)";Meškučių;3148477315;Taip;6;0;0;6
2504;"Gilužis (Vydūno g. 11A)";Meškučių;1068375927;Taip;6;0;0;6
2505;"Gilužis (Vydūno g. 11A)";Meškučių;8476240141;Taip;2;0;0;2
2506;"Gilužis (Vydūno g. 11A)";Meškučių;6185280967;Taip;15;0;0;15
2507;"Gilužis (Vydūno g. 11A)";Meškučių;5177805719;Taip;9;11;0;20
2508;"Gilužis (Vydūno g. 11A)";Meškučių;5654754316;Taip;16;0;0;16
2509;"Gilužis (Vydūno g. 11A)";Pagrandukai;6884146146;Taip;3;4;0;7
2510;"Gilužis (Vydūno g. 11A)";Pagrandukai;6920910054;Taip;23;0;0;23
2511;"Gilužis (Vydūno g. 11A)";Pagrandukai;6501973647;Taip;9;1;0;10
2512;"Gilužis (Vydūno g. 11A)";Pagrandukai;5397975739;Taip;5;1;0;6
2513;"Gilužis (Vydūno g. 11A)";Pagrandukai;5376639182;Taip;0;2;0;2
2514;"Gilužis (Vydūno g. 11A)";Pagrandukai;5378701300;Taip;4;2;0;6
2515;"Gilužis (Vydūno g. 11A)";Pagrandukai;3366788027;Taip;4;2;0;6
2516;"Gilužis (Vydūno g. 11A)";Pagrandukai;5184511012;Taip;9;3;0;12
2517;"Gilužis (Vydūno g. 11A)";Pagrandukai;9587502317;Taip;9;2;0;11
2518;"Gilužis (Vydūno g. 11A)";Pagrandukai;5334441484;Taip;0;4;0;4
2519;"Gilužis (Vydūno g. 11A)";Pagrandukai;6485579727;Taip;5;0;0;5
2520;"Gilužis (Vydūno g. 11A)";Pagrandukai;8477445384;Taip;11;0;0;11
2521;"Gilužis (Vydūno g. 11A)";Pagrandukai;1758670627;Taip;9;0;0;9
2522;"Gilužis (Vydūno g. 11A)";Pagrandukai;6766559505;Taip;0;1;0;1
2523;"Gilužis (Vydūno g. 11A)";Pagrandukai;5737505086;Taip;2;0;0;2
2524;"Gilužis (Vydūno g. 11A)";Pagrandukai;3729538163;Taip;2;8;0;10
2525;"Gilužis (Vydūno g. 11A)";Pagrandukai;6207304860;Taip;7;0;0;7
2526;"Gilužis (Vydūno g. 11A)";Pagrandukai;5921538837;Taip;18;1;0;19
2527;"Gilužis (Vydūno g. 11A)";Pagrandukai;9846916206;Taip;13;6;0;19
2528;"Gilužis (Vydūno g. 11A)";Pagrandukai;9325927745;Taip;16;2;0;18
2529;"Gilužis (Vydūno g. 11A)";Boružėlių;5581417252;Taip;13;2;0;15
2530;"Gilužis (Vydūno g. 11A)";Boružėlių;2819680099;Taip;0;7;0;7
2531;"Gilužis (Vydūno g. 11A)";Boružėlių;1209632075;Taip;10;3;0;13
2532;"Gilužis (Vydūno g. 11A)";Boružėlių;9753512366;Taip;12;2;0;14
2533;"Gilužis (Vydūno g. 11A)";Boružėlių;1541283216;Taip;2;6;0;8
2534;"Gilužis (Vydūno g. 11A)";Boružėlių;6514483362;Taip;4;0;2;6
2535;"Gilužis (Vydūno g. 11A)";Boružėlių;5664892047;Taip;0;9;0;9
2536;"Gilužis (Vydūno g. 11A)";Boružėlių;3379889899;Taip;4;0;1;5
2537;"Gilužis (Vydūno g. 11A)";Boružėlių;6586605929;Taip;0;4;0;4
2538;"Gilužis (Vydūno g. 11A)";Boružėlių;4325300253;Taip;0;0;1;1
2539;"Gilužis (Vydūno g. 11A)";Boružėlių;1826248450;Taip;2;0;0;2
2540;"Gilužis (Vydūno g. 11A)";Boružėlių;3279830266;Taip;19;0;0;19
2541;"Gilužis (Vydūno g. 11A)";Boružėlių;9676661005;Ne;8;0;0;8
2542;"Gilužis (Vydūno g. 11A)";Boružėlių;1306757860;Ne;8;0;0;8
2543;"Gilužis (Vydūno g. 11A)";Boružėlių;1604096952;Taip;0;1;0;1
2544;"Gilužis (Vydūno g. 11A)";Boružėlių;4266998302;Taip;4;1;0;5
2545;"Gintarėlis (Didlaukio g. 35)";PAPŪGĖLĖS;6558614008;Taip;7;3;0;10
2546;"Gintarėlis (Didlaukio g. 35)";PAPŪGĖLĖS;4348245746;Taip;0;2;1;3
2547;"Gintarėlis (Didlaukio g. 35)";PAPŪGĖLĖS;7372735642;Taip;1;0;1;2
2548;"Gintarėlis (Didlaukio g. 35)";PAPŪGĖLĖS;3091731769;Taip;0;1;0;1
2549;"Gintarėlis (Didlaukio g. 35)";PAPŪGĖLĖS;6484966941;Taip;0;5;0;5
2550;"Gintarėlis (Didlaukio g. 35)";PAPŪGĖLĖS;9476258741;Taip;1;0;0;1
2551;"Gintarėlis (Didlaukio g. 35)";PAPŪGĖLĖS;9004590065;Taip;3;4;1;8
2552;"Gintarėlis (Didlaukio g. 35)";PAPŪGĖLĖS;2624469768;Taip;0;5;0;5
2553;"Gintarėlis (Didlaukio g. 35)";PAPŪGĖLĖS;8784796186;Taip;5;2;0;7
2554;"Gintarėlis (Didlaukio g. 35)";PAPŪGĖLĖS;9622824643;Taip;6;10;0;16
2555;"Gintarėlis (Didlaukio g. 35)";PAPŪGĖLĖS;8410642485;Taip;4;0;0;4
2556;"Gintarėlis (Didlaukio g. 35)";PAPŪGĖLĖS;8516817506;Taip;0;5;0;5
2557;"Gintarėlis (Didlaukio g. 35)";PAPŪGĖLĖS;3235154374;Taip;2;5;2;9
2558;"Gintarėlis (Didlaukio g. 35)";PAPŪGĖLĖS;1371258551;Taip;5;11;2;18
2559;"Gintarėlis (Didlaukio g. 35)";PAPŪGĖLĖS;9970786396;Taip;0;6;2;8
2560;"Gintarėlis (Didlaukio g. 35)";PAPŪGĖLĖS;7118758040;Taip;0;1;0;1
2561;"Gintarėlis (Didlaukio g. 35)";PAPŪGĖLĖS;8355089218;Taip;5;2;1;8
2562;"Gintarėlis (Didlaukio g. 35)";PAPŪGĖLĖS;8471302686;Taip;0;4;0;4
2563;"Gintarėlis (Didlaukio g. 35)";PAPŪGĖLĖS;4266286613;Taip;3;8;3;14
2564;"Gintarėlis (Didlaukio g. 35)";SPINDULIUKAI;8498936096;Taip;0;4;0;4
2565;"Gintarėlis (Didlaukio g. 35)";SPINDULIUKAI;8913652291;Taip;0;1;0;1
2566;"Gintarėlis (Didlaukio g. 35)";SPINDULIUKAI;2485750596;Taip;3;4;0;7
2567;"Gintarėlis (Didlaukio g. 35)";SPINDULIUKAI;8610886062;Taip;0;6;0;6
2568;"Gintarėlis (Didlaukio g. 35)";SPINDULIUKAI;1033624080;Taip;0;3;0;3
2569;"Gintarėlis (Didlaukio g. 35)";SPINDULIUKAI;5811396263;Taip;0;7;0;7
2570;"Gintarėlis (Didlaukio g. 35)";SPINDULIUKAI;2919700367;Ne;5;6;0;11
2571;"Gintarėlis (Didlaukio g. 35)";SPINDULIUKAI;1511718436;Taip;0;9;0;9
2572;"Gintarėlis (Didlaukio g. 35)";SPINDULIUKAI;1768789948;Taip;6;0;0;6
2573;"Gintarėlis (Didlaukio g. 35)";SPINDULIUKAI;2595566032;Taip;0;2;0;2
2574;"Gintarėlis (Didlaukio g. 35)";SPINDULIUKAI;9494521554;Taip;7;5;0;12
2575;"Gintarėlis (Didlaukio g. 35)";SPINDULIUKAI;1648843117;Taip;2;4;0;6
2576;"Gintarėlis (Didlaukio g. 35)";SPINDULIUKAI;7147842224;Taip;0;3;0;3
2577;"Gintarėlis (Didlaukio g. 35)";SPINDULIUKAI;5783939567;Taip;0;0;1;1
2578;"Gintarėlis (Didlaukio g. 35)";SPINDULIUKAI;7674351459;Taip;0;4;0;4
2579;"Gintarėlis (Didlaukio g. 35)";SPINDULIUKAI;1861324153;Taip;0;4;0;4
2580;"Gintarėlis (Didlaukio g. 35)";SPINDULIUKAI;3457974670;Taip;4;1;0;5
2581;"Gintarėlis (Didlaukio g. 35)";SPINDULIUKAI;6080108998;Taip;6;4;0;10
2582;"Gintarėlis (Didlaukio g. 35)";SPINDULIUKAI;6655645997;Taip;11;4;0;15
2583;"Gintarėlis (Didlaukio g. 35)";SPINDULIUKAI;4484711857;Taip;0;4;0;4
2584;"Gintarėlis (Didlaukio g. 35)";SPINDULIUKAI;6292664833;Taip;1;0;0;1
2585;"Gintarėlis (Didlaukio g. 35)";LAŠIUKAI;3820683506;Taip;0;4;0;4
2586;"Gintarėlis (Didlaukio g. 35)";LAŠIUKAI;2904118045;Taip;5;0;0;5
2587;"Gintarėlis (Didlaukio g. 35)";LAŠIUKAI;5717123412;Taip;0;1;0;1
2588;"Gintarėlis (Didlaukio g. 35)";LAŠIUKAI;3794027499;Taip;7;4;0;11
2589;"Gintarėlis (Didlaukio g. 35)";LAŠIUKAI;7813187438;Taip;0;4;0;4
2590;"Gintarėlis (Didlaukio g. 35)";LAŠIUKAI;9234476307;Ne;0;3;0;3
2591;"Gintarėlis (Didlaukio g. 35)";LAŠIUKAI;6561070982;Taip;0;4;0;4
2592;"Gintarėlis (Didlaukio g. 35)";LAŠIUKAI;2203238888;Taip;0;4;0;4
2593;"Gintarėlis (Didlaukio g. 35)";LAŠIUKAI;2256002308;Taip;10;0;0;10
2594;"Gintarėlis (Didlaukio g. 35)";LAŠIUKAI;6607854244;Taip;0;4;0;4
2595;"Gintarėlis (Didlaukio g. 35)";LAŠIUKAI;1327681704;Taip;0;3;0;3
2596;"Gintarėlis (Didlaukio g. 35)";LAŠIUKAI;3987801707;Taip;6;0;0;6
2597;"Gintarėlis (Didlaukio g. 35)";LAŠIUKAI;7123016029;Taip;0;1;0;1
2598;"Gintarėlis (Didlaukio g. 35)";LAŠIUKAI;7976989629;Taip;7;4;1;12
2599;"Gintarėlis (Didlaukio g. 35)";LAŠIUKAI;3444997417;Taip;0;1;0;1
2600;"Gintarėlis (Didlaukio g. 35)";LAŠIUKAI;8982034601;Taip;0;3;0;3
2601;"Gintarėlis (Didlaukio g. 35)";LAŠIUKAI;6545866812;Taip;0;3;0;3
2602;"Gintarėlis (Didlaukio g. 35)";LAŠIUKAI;5467958458;Taip;0;3;0;3
2603;"Gintarėlis (Didlaukio g. 35)";MEŠKUČIAI;2926488239;Taip;0;5;0;5
2604;"Gintarėlis (Didlaukio g. 35)";MEŠKUČIAI;6618240550;Taip;13;4;0;17
2605;"Gintarėlis (Didlaukio g. 35)";MEŠKUČIAI;8790078624;Taip;9;1;0;10
2606;"Gintarėlis (Didlaukio g. 35)";MEŠKUČIAI;2518840573;Taip;3;0;0;3
2607;"Gintarėlis (Didlaukio g. 35)";MEŠKUČIAI;5187894822;Taip;0;4;0;4
2608;"Gintarėlis (Didlaukio g. 35)";MEŠKUČIAI;3630567294;Taip;0;2;0;2
2609;"Gintarėlis (Didlaukio g. 35)";MEŠKUČIAI;5181872438;Taip;0;5;0;5
2610;"Gintarėlis (Didlaukio g. 35)";MEŠKUČIAI;1565802953;Taip;0;23;0;23
2611;"Gintarėlis (Didlaukio g. 35)";MEŠKUČIAI;2072435242;Taip;5;0;0;5
2612;"Gintarėlis (Didlaukio g. 35)";MEŠKUČIAI;7989239799;Taip;0;3;0;3
2613;"Gintarėlis (Didlaukio g. 35)";MEŠKUČIAI;4356211536;Taip;5;0;0;5
2614;"Gintarėlis (Didlaukio g. 35)";MEŠKUČIAI;1502740714;Taip;7;1;0;8
2615;"Gintarėlis (Didlaukio g. 35)";MEŠKUČIAI;6636835034;Taip;0;11;0;11
2616;"Gintarėlis (Didlaukio g. 35)";MEŠKUČIAI;3947405446;Taip;4;10;0;14
2617;"Gintarėlis (Didlaukio g. 35)";MEŠKUČIAI;7948438165;Taip;0;3;0;3
2618;"Gintarėlis (Didlaukio g. 35)";MEŠKUČIAI;4642142931;Taip;0;3;0;3
2619;"Gintarėlis (Didlaukio g. 35)";MEŠKUČIAI;6711753930;Taip;0;4;0;4
2620;"Gintarėlis (Didlaukio g. 35)";MEŠKUČIAI;9017592249;Taip;0;2;0;2
2621;"Gintarėlis (Didlaukio g. 35)";MEŠKUČIAI;8375475174;Taip;0;14;0;14
2622;"Gintarėlis (Didlaukio g. 35)";MEŠKUČIAI;7029401386;Taip;2;1;0;3
2623;"Gintarėlis (Didlaukio g. 35)";MEŠKUČIAI;1790629500;Taip;7;0;0;7
2624;"Gintarėlis (Didlaukio g. 35)";MEŠKUČIAI;7320085613;Taip;0;4;0;4
2625;"Gintarėlis (Didlaukio g. 35)";MEŠKUČIAI;3271736540;Taip;5;4;0;9
2626;"Gintarėlis (Didlaukio g. 35)";KAČIUKAI;3665764153;Taip;7;1;0;8
2627;"Gintarėlis (Didlaukio g. 35)";KAČIUKAI;9774056578;Taip;7;1;0;8
2628;"Gintarėlis (Didlaukio g. 35)";KAČIUKAI;2212296954;Taip;6;0;0;6
2629;"Gintarėlis (Didlaukio g. 35)";KAČIUKAI;3825700024;Taip;0;1;0;1
2630;"Gintarėlis (Didlaukio g. 35)";KAČIUKAI;7057877483;Taip;0;1;0;1
2631;"Gintarėlis (Didlaukio g. 35)";KAČIUKAI;9825811100;Taip;5;0;0;5
2632;"Gintarėlis (Didlaukio g. 35)";KAČIUKAI;7875981690;Taip;6;3;0;9
2633;"Gintarėlis (Didlaukio g. 35)";KAČIUKAI;2544338275;Taip;6;3;0;9
2634;"Gintarėlis (Didlaukio g. 35)";KAČIUKAI;9963329170;Taip;0;1;0;1
2635;"Gintarėlis (Didlaukio g. 35)";KAČIUKAI;1011749698;Taip;4;8;5;17
2636;"Gintarėlis (Didlaukio g. 35)";KAČIUKAI;8261770154;Taip;0;11;0;11
2637;"Gintarėlis (Didlaukio g. 35)";KAČIUKAI;7061545258;Ne;5;1;0;6
2638;"Gintarėlis (Didlaukio g. 35)";KAČIUKAI;5436695400;Ne;2;4;1;7
2639;"Gintarėlis (Didlaukio g. 35)";KAČIUKAI;5921751507;Taip;6;1;0;7
2640;"Gintarėlis (Didlaukio g. 35)";KAČIUKAI;9450900915;Taip;6;0;1;7
2641;"Gintarėlis (Didlaukio g. 35)";KAČIUKAI;5153948767;Taip;0;1;0;1
2642;"Gintarėlis (Didlaukio g. 35)";KAČIUKAI;3814485627;Taip;2;5;1;8
2643;"Gintarėlis (Didlaukio g. 35)";KAČIUKAI;1571260478;Ne;4;3;0;7
2644;"Gintarėlis (Didlaukio g. 35)";KAČIUKAI;9244715396;Taip;12;4;0;16
2645;"Gintarėlis (Didlaukio g. 35)";KIŠKUČIAI;3921015919;Taip;3;0;0;3
2646;"Gintarėlis (Didlaukio g. 35)";KIŠKUČIAI;7143014339;Ne;4;0;0;4
2647;"Gintarėlis (Didlaukio g. 35)";KIŠKUČIAI;1918879534;Taip;15;1;0;16
2648;"Gintarėlis (Didlaukio g. 35)";KIŠKUČIAI;7509100750;Taip;0;4;0;4
2649;"Gintarėlis (Didlaukio g. 35)";KIŠKUČIAI;6239242631;Taip;5;0;0;5
2650;"Gintarėlis (Didlaukio g. 35)";KIŠKUČIAI;5965570522;Ne;6;0;0;6
2651;"Gintarėlis (Didlaukio g. 35)";KIŠKUČIAI;8286814809;Taip;0;1;0;1
2652;"Gintarėlis (Didlaukio g. 35)";KIŠKUČIAI;3839660368;Taip;1;2;1;4
2653;"Gintarėlis (Didlaukio g. 35)";KIŠKUČIAI;5509394003;Taip;6;0;0;6
2654;"Gintarėlis (Didlaukio g. 35)";KIŠKUČIAI;3538300416;Taip;0;1;0;1
2655;"Gintarėlis (Didlaukio g. 35)";KIŠKUČIAI;9501012756;Taip;5;0;0;5
2656;"Gintarėlis (Didlaukio g. 35)";KIŠKUČIAI;7059730814;Taip;2;0;0;2
2657;"Gintarėlis (Didlaukio g. 35)";KIŠKUČIAI;9179216093;Taip;0;1;0;1
2658;"Gintarėlis (Didlaukio g. 35)";VYTURIUKAI;4590343065;Taip;0;2;0;2
2659;"Gintarėlis (Didlaukio g. 35)";VYTURIUKAI;1326797813;Taip;1;4;0;5
2660;"Gintarėlis (Didlaukio g. 35)";VYTURIUKAI;7629635034;Taip;13;0;0;13
2661;"Gintarėlis (Didlaukio g. 35)";VYTURIUKAI;1337062268;Taip;15;0;0;15
2662;"Gintarėlis (Didlaukio g. 35)";VYTURIUKAI;9533972547;Taip;0;0;12;12
2663;"Gintarėlis (Didlaukio g. 35)";VYTURIUKAI;1918458858;Taip;1;0;2;3
2664;"Gintarėlis (Didlaukio g. 35)";BORUŽĖLĖS;9915228593;Taip;3;0;0;3
2665;"Gintarėlis (Didlaukio g. 35)";BORUŽĖLĖS;4278770021;Taip;0;1;0;1
2666;"Gintarėlis (Didlaukio g. 35)";BORUŽĖLĖS;2499727321;Taip;9;7;0;16
2667;"Gintarėlis (Didlaukio g. 35)";BORUŽĖLĖS;2949035147;Taip;10;3;0;13
2668;"Gintarėlis (Didlaukio g. 35)";BORUŽĖLĖS;5991638696;Taip;4;1;0;5
2669;"Gintarėlis (Didlaukio g. 35)";BORUŽĖLĖS;6563281778;Taip;7;3;0;10
2670;"Gintarėlis (Didlaukio g. 35)";BORUŽĖLĖS;6133476137;Taip;18;0;0;18
2671;"Gintarėlis (Didlaukio g. 35)";BORUŽĖLĖS;6751822184;Taip;0;3;0;3
2672;"Gintarėlis (Didlaukio g. 35)";BORUŽĖLĖS;8721340357;Taip;0;0;6;6
2673;"Gintarėlis (Didlaukio g. 35)";BORUŽĖLĖS;1482227839;Ne;5;3;0;8
2674;"Gintarėlis (Didlaukio g. 35)";BORUŽĖLĖS;3876016666;Taip;4;0;1;5
2675;"Gintarėlis (Didlaukio g. 35)";BORUŽĖLĖS;5338409090;Taip;0;2;0;2
2676;"Gintarėlis (Didlaukio g. 35)";BORUŽĖLĖS;8403881160;Taip;0;13;0;13
2677;"Gintarėlis (Didlaukio g. 35)";BORUŽĖLĖS;4462515146;Taip;1;1;0;2
2678;"Gintarėlis (Didlaukio g. 35)";BORUŽĖLĖS;2809388552;Ne;8;0;1;9
2679;"Gintarėlis (Didlaukio g. 35)";BORUŽĖLĖS;4686913324;Taip;2;2;1;5
2680;"Gintarėlis (Didlaukio g. 35)";BORUŽĖLĖS;2488622623;Taip;0;0;1;1
2681;"Gintarėlis (Didlaukio g. 35)";BORUŽĖLĖS;2482981227;Taip;4;0;1;5
2682;"Gintarėlis (Didlaukio g. 35)";EŽIUKAI;1723745668;Taip;2;0;0;2
2683;"Gintarėlis (Didlaukio g. 35)";EŽIUKAI;1082941468;Taip;0;0;1;1
2684;"Gintarėlis (Didlaukio g. 35)";EŽIUKAI;8529974367;Taip;5;2;0;7
2685;"Gintarėlis (Didlaukio g. 35)";EŽIUKAI;6991746305;Taip;4;0;0;4
2686;"Gintarėlis (Didlaukio g. 35)";EŽIUKAI;4623909811;Taip;0;6;0;6
2687;"Gintarėlis (Didlaukio g. 35)";EŽIUKAI;9279399214;Taip;0;3;0;3
2688;"Gintarėlis (Didlaukio g. 35)";EŽIUKAI;3357866319;Taip;0;5;0;5
2689;"Gintarėlis (Didlaukio g. 35)";EŽIUKAI;2814569415;Taip;2;5;0;7
2690;"Gintarėlis (Didlaukio g. 35)";EŽIUKAI;5355691986;Taip;2;10;0;12
2691;"Gintarėlis (Didlaukio g. 35)";EŽIUKAI;5796729245;Taip;0;3;0;3
2692;"Gintarėlis (Didlaukio g. 35)";EŽIUKAI;9915887420;Taip;0;3;0;3
2693;"Gintarėlis (Didlaukio g. 35)";EŽIUKAI;3792697409;Taip;0;4;0;4
2694;"Gintarėlis (Didlaukio g. 35)";EŽIUKAI;8287685690;Taip;0;5;0;5
2695;"Gintarėlis (Didlaukio g. 35)";EŽIUKAI;2165332442;Taip;4;1;0;5
2696;"Gintarėlis (Didlaukio g. 35)";EŽIUKAI;6914904213;Taip;7;1;0;8
2697;"Gintarėlis (Didlaukio g. 35)";EŽIUKAI;1696337909;Taip;0;2;0;2
2698;"Gintarėlis (Didlaukio g. 35)";EŽIUKAI;8116557698;Taip;0;6;0;6
2699;"Gintarėlis (Didlaukio g. 35)";EŽIUKAI;6862629244;Taip;4;0;0;4
2700;"Gintarėlis (Didlaukio g. 35)";EŽIUKAI;8704248985;Taip;0;10;0;10
2701;"Gintarėlis (Didlaukio g. 35)";"SAULĖS ZUIKUČIAI";5336654560;Taip;0;1;0;1
2702;"Gintarėlis (Didlaukio g. 35)";"SAULĖS ZUIKUČIAI";3732252177;Taip;0;1;0;1
2703;"Gintarėlis (Didlaukio g. 35)";"SAULĖS ZUIKUČIAI";4087751760;Taip;0;8;0;8
2704;"Gintarėlis (Didlaukio g. 35)";"SAULĖS ZUIKUČIAI";7004430575;Taip;13;0;0;13
2705;"Gintarėlis (Didlaukio g. 35)";"SAULĖS ZUIKUČIAI";5103780852;Taip;1;0;0;1
2706;"Gintarėlis (Didlaukio g. 35)";"SAULĖS ZUIKUČIAI";4127749930;Taip;9;1;0;10
2707;"Gintarėlis (Didlaukio g. 35)";"SAULĖS ZUIKUČIAI";5594809861;Taip;0;10;0;10
2708;"Gintarėlis (Didlaukio g. 35)";"SAULĖS ZUIKUČIAI";5064767935;Taip;6;0;0;6
2709;"Gintarėlis (Didlaukio g. 35)";"SAULĖS ZUIKUČIAI";8170509526;Taip;9;0;0;9
2710;"Gintarėlis (Didlaukio g. 35)";Pabiručiai;4811778274;Ne;0;4;0;4
2711;"Gintarėlis (Didlaukio g. 35)";Pabiručiai;1474802737;Taip;10;2;0;12
2712;"Gintarėlis (Didlaukio g. 35)";Pabiručiai;4199030732;Taip;14;4;0;18
2713;"Gintarėlis (Didlaukio g. 35)";Šypsenėlės;3575375401;Taip;16;0;0;16
2714;"Gintarėlis (Didlaukio g. 35)";Šypsenėlės;3575375401;Taip;16;0;0;16
2715;"Gintarėlis (Didlaukio g. 35)";Šypsenėlės;3575375401;Taip;16;0;0;16
2716;"Gintarėlis (Didlaukio g. 35)";Šypsenėlės;9020619501;Taip;0;6;0;6
2717;"Gintarėlis (Didlaukio g. 35)";Šypsenėlės;5120761293;Taip;0;2;0;2
2718;"Gintarėlis (Didlaukio g. 35)";Šypsenėlės;9413836091;Taip;0;4;0;4
2719;"Gintarėlis (Didlaukio g. 35)";Šypsenėlės;7337543180;Taip;0;2;0;2
2720;"Gintarėlis (Didlaukio g. 35)";Šypsenėlės;7337543180;Taip;0;2;0;2
2721;"Gintarėlis (Didlaukio g. 35)";Šypsenėlės;7337543180;Taip;0;2;0;2
2722;"Gintarėlis (Didlaukio g. 35)";Šypsenėlės;1567290856;Taip;6;0;0;6
2723;"Gintarėlis (Didlaukio g. 35)";Šypsenėlės;7661638176;Taip;0;1;0;1
2724;"Gintarėlis (Didlaukio g. 35)";Šypsenėlės;3088663209;Taip;7;6;0;13
2725;"Gintarėlis (Didlaukio g. 35)";Šypsenėlės;3459439843;Taip;0;6;0;6
2726;"Gintarėlis (Didlaukio g. 35)";Šypsenėlės;1872534206;Taip;0;1;0;1
2727;"Gintarėlis (Didlaukio g. 35)";Šypsenėlės;4334349824;Taip;2;5;0;7
2728;"Gintarėlis (Didlaukio g. 35)";Šypsenėlės;9954282865;Taip;0;1;0;1
2729;"Gintarėlis (Didlaukio g. 35)";Šypsenėlės;8768094601;Taip;5;2;0;7
2730;"Gintarėlis (Didlaukio g. 35)";Šypsenėlės;5834772263;Taip;10;0;0;10
2731;"Gintarėlis (Didlaukio g. 35)";Šypsenėlės;4915783145;Taip;0;0;2;2
2732;"Gintarėlis (Didlaukio g. 35)";Šypsenėlės;1367305617;Taip;5;0;0;5
2733;"Gintarėlis (Didlaukio g. 35)";Šypsenėlės;7537009709;Taip;3;1;0;4
2734;"Gintarėlis (Didlaukio g. 35)";Smalsučiai;7486822380;Taip;0;2;2;4
2735;"Gintarėlis (Didlaukio g. 35)";Smalsučiai;8387819754;Taip;14;0;0;14
2736;"Gintarėlis (Didlaukio g. 35)";Smalsučiai;8292698645;Taip;5;2;1;8
2737;"Gintarėlis (Didlaukio g. 35)";Smalsučiai;5748677965;Taip;2;9;0;11
2738;"Gintarėlis (Didlaukio g. 35)";Smalsučiai;8279078612;Taip;1;4;1;6
2739;"Gintarėlis (Didlaukio g. 35)";Smalsučiai;4146454470;Taip;10;0;1;11
2740;"Gintarėlis (Didlaukio g. 35)";Smalsučiai;1876292168;Taip;0;11;0;11
2741;"Gintarėlis (Didlaukio g. 35)";Smalsučiai;9980747501;Taip;9;0;2;11
2742;"Gintarėlis (Didlaukio g. 35)";Smalsučiai;8754068506;Taip;2;1;0;3
2743;"Gintarėlis (Didlaukio g. 35)";Smalsučiai;1537528341;Taip;3;2;0;5
2744;"Gintarėlis (Didlaukio g. 35)";Smalsučiai;6578588403;Taip;3;1;0;4
2745;"Gintarėlis (Didlaukio g. 35)";Kodėlčiukai;2234295991;Taip;0;4;0;4
2746;"Gintarėlis (Didlaukio g. 35)";Kodėlčiukai;5824210469;Ne;2;0;0;2
2747;"Gintarėlis (Didlaukio g. 35)";Gintariukai;5109775795;Taip;3;0;0;3
2748;"Gintarėlis (Didlaukio g. 35)";Gintariukai;6244066576;Taip;0;23;0;23
2749;"Gintarėlis (Didlaukio g. 35)";Gintariukai;6056471440;Taip;7;0;0;7
2750;"Gintarėlis (Didlaukio g. 35)";Gintariukai;9374716095;Taip;0;7;0;7
2751;"Gintarėlis (Didlaukio g. 35)";Gintariukai;8999913328;Taip;0;16;0;16
2752;"Gintarėlis (Didlaukio g. 35)";Gintariukai;1359894648;Taip;8;0;0;8
2753;"Gintarėlis (Didlaukio g. 35)";Gintariukai;8815001033;Ne;0;4;1;5
2754;"Gintarėlis (Didlaukio g. 35)";Gintariukai;9787141660;Taip;4;2;1;7
2755;"Gintarėlis (Didlaukio g. 35)";Gintariukai;6357825030;Taip;5;9;0;14
2756;"Gintarėlis (Didlaukio g. 35)";Gintariukai;1433395471;Taip;2;0;0;2
2757;"Gintarėlis (Didlaukio g. 35)";Gintariukai;1766430091;Taip;3;7;2;12
2758;"Gintarėlis (Didlaukio g. 35)";Gintariukai;1848386512;Taip;9;0;0;9
2759;"Gintarėlis (Didlaukio g. 35)";GILIUKAI;3973889495;Taip;8;1;0;9
2760;"Gintarėlis (Didlaukio g. 35)";GILIUKAI;4749559606;Taip;9;1;0;10
2761;"Gintarėlis (Didlaukio g. 35)";GILIUKAI;4458703839;Ne;15;0;0;15
2762;"Gintarėlis (Didlaukio g. 35)";GILIUKAI;2178808286;Taip;18;5;0;23
2763;"Gintarėlis (Didlaukio g. 35)";GILIUKAI;9073499040;Taip;9;2;0;11
2764;"Gintarėlis (Didlaukio g. 35)";GILIUKAI;6711773127;Taip;7;0;0;7
2765;"Gintarėlis (Didlaukio g. 35)";GILIUKAI;6547060300;Taip;3;5;0;8
2766;"Gintarėlis (Didlaukio g. 35)";GILIUKAI;4535071342;Taip;0;2;0;2
2767;"Gintarėlis (Didlaukio g. 35)";GILIUKAI;8448725884;Taip;0;2;0;2
2768;"Gintarėlis (Didlaukio g. 35)";GILIUKAI;6251670953;Taip;0;0;4;4
2769;"Gintarėlis (Didlaukio g. 35)";GILIUKAI;8805356168;Taip;4;5;0;9
2770;"Gintarėlis (Didlaukio g. 35)";GILIUKAI;4751066825;Taip;0;2;0;2
2771;"Gintarėlis (Didlaukio g. 35)";GILIUKAI;7562170082;Taip;4;15;0;19
2772;"Gintarėlis (Didlaukio g. 35)";GILIUKAI;7418672923;Taip;6;0;0;6
2773;"Gintarėlis (Didlaukio g. 35)";GILIUKAI;1039098192;Taip;0;6;0;6
2774;"Gintarėlis (Didlaukio g. 35)";GILIUKAI;9191264261;Taip;8;0;0;8
2775;"Gintarėlis (Didlaukio g. 35)";GILIUKAI;6042885133;Taip;0;2;0;2
2776;"Gintarėlis (Didlaukio g. 35)";GILIUKAI;3232990779;Taip;0;4;0;4
2777;"Gintarėlis (Didlaukio g. 35)";GILIUKAI;2920734274;Taip;3;0;4;7
2778;"Gintarėlis (Didlaukio g. 35)";GILIUKAI;8613554277;Taip;6;3;0;9
2779;"Gintarėlis (Didlaukio g. 35)";GILIUKAI;5202442681;Taip;4;2;0;6
2780;"Gintarėlis (Didlaukio g. 35)";GILIUKAI;7573269886;Taip;5;2;0;7
2781;Giraitė;Aviliukas;4292730355;Taip;5;3;0;8
2782;Giraitė;Aviliukas;7001163828;Taip;2;3;0;5
2783;Giraitė;Aviliukas;6159650070;Taip;3;4;1;8
2784;Giraitė;Aviliukas;5275912609;Taip;5;4;5;14
2785;Giraitė;Aviliukas;4758750245;Taip;5;0;1;6
2786;Giraitė;Aviliukas;2338867192;Taip;0;0;1;1
2787;Giraitė;Aviliukas;3719285343;Taip;0;0;2;2
2788;Giraitė;Aviliukas;3085107071;Taip;0;4;0;4
2789;Giraitė;Aviliukas;7807844145;Taip;3;0;0;3
2790;Giraitė;Aviliukas;3757900478;Taip;11;0;0;11
2791;Giraitė;Aviliukas;7876457529;Taip;7;0;0;7
2792;Giraitė;Aviliukas;3992069614;Taip;3;0;1;4
2793;Giraitė;Aviliukas;6121586335;Taip;0;4;7;11
2794;Giraitė;Aviliukas;4440444700;Taip;0;0;1;1
2795;Giraitė;Aviliukas;6296485105;Taip;0;0;3;3
2796;Giraitė;Aviliukas;5356944812;Taip;4;0;2;6
2797;Giraitė;Aviliukas;4554565631;Ne;0;0;4;4
2798;Giraitė;LapiukaI;6141730004;Taip;0;3;0;3
2799;Giraitė;LapiukaI;6325909670;Taip;1;1;0;2
2800;Giraitė;LapiukaI;7831526566;Taip;11;0;0;11
2801;Giraitė;LapiukaI;2740656695;Ne;14;0;0;14
2802;Giraitė;LapiukaI;5030697729;Taip;6;1;1;8
2803;Giraitė;LapiukaI;1921430434;Taip;10;4;0;14
2804;Giraitė;LapiukaI;5006156109;Taip;0;1;0;1
2805;Giraitė;LapiukaI;4663343304;Taip;7;1;0;8
2806;Giraitė;LapiukaI;5382004098;Taip;0;6;0;6
2807;Giraitė;LapiukaI;4811513778;Taip;6;0;0;6
2808;Giraitė;LapiukaI;4296449093;Taip;0;2;0;2
2809;Giraitė;LapiukaI;1974159110;Taip;2;4;0;6
2810;Giraitė;LapiukaI;5532639133;Taip;6;5;0;11
2811;Giraitė;LapiukaI;5902161665;Taip;0;2;0;2
2812;Giraitė;LapiukaI;4955786826;Taip;0;4;0;4
2813;Giraitė;LapiukaI;4260343903;Taip;1;0;0;1
2814;Giraitė;LapiukaI;9088123796;Taip;11;2;0;13
2815;Giraitė;LapiukaI;7772177095;Taip;0;3;0;3
2816;Giraitė;LapiukaI;8492822889;Ne;6;1;1;8
2817;Giraitė;LapiukaI;2880342138;Taip;3;4;1;8
2818;Giraitė;LapiukaI;9503157590;Taip;2;3;3;8
2819;Giraitė;LapiukaI;5471577047;Taip;0;2;0;2
2820;Giraitė;Voveriukai;8612554184;Taip;5;2;0;7
2821;Giraitė;Voveriukai;1436302175;Taip;2;1;0;3
2822;Giraitė;Voveriukai;2064019596;Taip;0;6;0;6
2823;Giraitė;Voveriukai;3039445733;Taip;15;0;0;15
2824;Giraitė;Voveriukai;8050306951;Taip;14;0;0;14
2825;Giraitė;Voveriukai;1262854023;Taip;8;2;0;10
2826;Giraitė;Voveriukai;7260229442;Taip;7;0;0;7
2827;Giraitė;Voveriukai;1126576745;Taip;5;0;0;5
2828;Giraitė;Voveriukai;4719547384;Taip;1;0;0;1
2829;Giraitė;Voveriukai;1772997796;Taip;19;0;0;19
2830;Giraitė;Voveriukai;4008393576;Taip;0;3;0;3
2831;Giraitė;Voveriukai;9281071794;Taip;2;0;0;2
2832;Giraitė;Voveriukai;9766107773;Taip;20;0;0;20
2833;Giraitė;Voveriukai;9386943162;Taip;7;1;0;8
2834;Giraitė;Voveriukai;4749790368;Taip;0;4;0;4
2835;Giraitė;Voveriukai;3613828494;Taip;14;0;1;15
2836;Giraitė;Voveriukai;2726766768;Taip;6;0;0;6
2837;Giraitė;Voveriukai;6565165993;Ne;0;0;1;1
2838;Giraitė;Voveriukai;7392324344;Taip;12;0;0;12
2839;Giraitė;Grybukai;7354834895;Taip;0;4;1;5
2840;Giraitė;Grybukai;2177856916;Taip;7;1;0;8
2841;Giraitė;Grybukai;4387282125;Taip;2;6;0;8
2842;Giraitė;Grybukai;4137699629;Taip;8;0;1;9
2843;Giraitė;Grybukai;7919088987;Taip;0;4;0;4
2844;Giraitė;Grybukai;4822168634;Taip;0;6;1;7
2845;Giraitė;Grybukai;4773517160;Taip;3;2;0;5
2846;Giraitė;Grybukai;7739516049;Taip;4;3;0;7
2847;Giraitė;Grybukai;5616242311;Taip;0;4;5;9
2848;Giraitė;Grybukai;2074303013;Taip;0;1;0;1
2849;Giraitė;Grybukai;4932174149;Taip;0;4;0;4
2850;Giraitė;Grybukai;2088867630;Taip;0;3;0;3
2851;Giraitė;Grybukai;3875214088;Taip;15;4;0;19
2852;Giraitė;Grybukai;5202562049;Taip;5;1;0;6
2853;Giraitė;Grybukai;7441871219;Taip;0;3;0;3
2854;Giraitė;Grybukai;3607198556;Taip;4;6;0;10
2855;Giraitė;Grybukai;1583733838;Taip;0;4;0;4
2856;Giraitė;Riešutėliai;5365264259;Taip;0;0;13;13
2857;Giraitė;Riešutėliai;7179656901;Ne;4;0;0;4
2858;Giraitė;Riešutėliai;3158451613;Taip;14;0;0;14
2859;Giraitė;Riešutėliai;7910736839;Taip;0;0;1;1
2860;Giraitė;Riešutėliai;3308792461;Taip;0;0;1;1
2861;Giraitė;Riešutėliai;7423115504;Taip;1;0;0;1
2862;Giraitė;Riešutėliai;3116241918;Taip;0;4;2;6
2863;Giraitė;Riešutėliai;6838184704;Taip;2;2;1;5
2864;Giraitė;Riešutėliai;7566944002;Taip;4;3;0;7
2865;Giraitė;Riešutėliai;3839432744;Taip;4;0;2;6
2866;Giraitė;Riešutėliai;7803047658;Taip;3;0;0;3
2867;Giraitė;Riešutėliai;7113991095;Taip;0;1;0;1
2868;Giraitė;Riešutėliai;9144465313;Taip;2;0;0;2
2869;Giraitė;Riešutėliai;6288016799;Taip;1;0;2;3
2870;Giraitė;Riešutėliai;3278871662;Taip;7;1;0;8
2871;Giraitė;Riešutėliai;4168934880;Taip;0;2;0;2
2872;Giraitė;Riešutėliai;6337090583;Taip;0;0;10;10
2873;Giraitė;Riešutėliai;3843211767;Taip;0;0;4;4
2874;Giraitė;Meškiukai;5870376620;Taip;0;12;0;12
2875;Giraitė;Meškiukai;9751078590;Taip;0;1;0;1
2876;Giraitė;Meškiukai;5447466102;Taip;0;5;0;5
2877;Giraitė;Meškiukai;5574589536;Taip;17;0;1;18
2878;Giraitė;Meškiukai;5876711899;Taip;6;0;0;6
2879;Giraitė;Meškiukai;4500393769;Taip;0;2;0;2
2880;Giraitė;Meškiukai;3144724475;Taip;5;0;0;5
2881;Giraitė;Meškiukai;5525538498;Taip;23;0;0;23
2882;Giraitė;Meškiukai;2867735227;Ne;10;0;0;10
2883;Giraitė;Meškiukai;4681342624;Taip;4;12;0;16
2884;Giraitė;Meškiukai;4431964254;Taip;8;0;4;12
2885;Giraitė;Meškiukai;9669849051;Taip;16;0;0;16
2886;Giraitė;Meškiukai;1170698327;Taip;4;0;0;4
2887;Giraitė;Meškiukai;6865072274;Taip;17;0;1;18
2888;Giraitė;Meškiukai;3108521607;Taip;10;3;0;13
2889;Giraitė;Meškiukai;2076989836;Taip;11;0;0;11
2890;Giraitė;Meškiukai;8139743188;Taip;11;0;0;11
2891;Giraitė;Uogelės;4317544803;Taip;0;4;0;4
2892;Giraitė;Uogelės;9927102264;Taip;5;0;0;5
2893;Giraitė;Uogelės;4121361794;Taip;0;0;1;1
2894;Giraitė;Uogelės;2732715332;Taip;0;10;0;10
2895;Giraitė;Uogelės;2102237550;Taip;0;2;0;2
2896;Giraitė;Uogelės;6065010363;Taip;5;4;0;9
2897;Giraitė;Uogelės;7094750784;Taip;0;1;0;1
2898;Giraitė;Uogelės;1356340471;Taip;3;4;2;9
2899;Giraitė;Uogelės;7377939409;Ne;6;0;0;6
2900;Giraitė;Uogelės;4288937528;Taip;0;0;4;4
2901;Giraitė;Uogelės;6293111179;Taip;0;3;0;3
2902;Giraitė;Uogelės;7390702355;Taip;0;1;0;1
2903;Giraitė;Uogelės;3643426944;Taip;4;0;1;5
2904;Giraitė;Uogelės;4680913596;Taip;0;0;2;2
2905;Giraitė;Šaltinėlis;3334974747;Taip;5;0;0;5
2906;Giraitė;Šaltinėlis;2223501723;Taip;5;0;0;5
2907;Giraitė;Šaltinėlis;3262098794;Taip;8;0;0;8
2908;Giraitė;Šaltinėlis;4094300540;Taip;0;4;1;5
2909;Giraitė;Šaltinėlis;3978249830;Taip;8;0;0;8
2910;Giraitė;Šaltinėlis;7831610906;Taip;14;0;4;18
2911;Giraitė;Šaltinėlis;8686898517;Taip;12;0;0;12
2912;Giraitė;Šaltinėlis;9566341270;Taip;5;6;0;11
2913;Giraitė;Šaltinėlis;8928574407;Taip;7;5;0;12
2914;Giraitė;Šaltinėlis;6897620778;Taip;10;0;0;10
2915;Giraitė;Šaltinėlis;2652478107;Taip;0;3;0;3
2916;Giraitė;Boružėlės;5543356573;Taip;1;0;0;1
2917;Giraitė;Boružėlės;8552588816;Taip;10;0;0;10
2918;Giraitė;Boružėlės;4315974617;Taip;7;0;0;7
2919;Giraitė;Boružėlės;2782467129;Taip;19;0;0;19
2920;Giraitė;Boružėlės;7149126803;Taip;4;0;1;5
2921;Giraitė;Boružėlės;6989400181;Taip;20;0;0;20
2922;Giraitė;Boružėlės;8163272129;Taip;6;0;0;6
2923;Giraitė;Boružėlės;2463291913;Taip;9;5;0;14
2924;Giraitė;Boružėlės;9611196852;Taip;0;3;0;3
2925;Giraitė;Boružėlės;2483204684;Taip;16;0;0;16
2926;Giraitė;Boružėlės;3643975279;Taip;4;0;1;5
2927;Giraitė;Boružėlės;3620400530;Taip;12;0;0;12
2928;Giraitė;Boružėlės;3801118082;Taip;5;7;0;12
2929;Giraitė;Boružėlės;4876614491;Taip;8;1;0;9
2930;Giraitė;Boružėlės;3035520579;Taip;2;8;0;10
2931;Giraitė;Boružėlės;2344506210;Taip;17;0;0;17
2932;Giraitė;Gandriukai;8525380061;Taip;14;1;0;15
2933;Giraitė;Gandriukai;4851987149;Taip;3;4;0;7
2934;Giraitė;Gandriukai;7008670489;Taip;0;5;0;5
2935;Giraitė;Gandriukai;6277788515;Taip;0;1;0;1
2936;Giraitė;Gandriukai;7767820565;Taip;0;4;0;4
2937;Giraitė;Gandriukai;8819218663;Taip;7;0;0;7
2938;Giraitė;Gandriukai;7269074498;Taip;1;4;0;5
2939;Giraitė;Gandriukai;1490748887;Taip;8;0;0;8
2940;Giraitė;Gandriukai;7789414361;Taip;20;0;0;20
2941;Giraitė;Gandriukai;9850432917;Taip;12;0;0;12
2942;Giraitė;Gandriukai;2313273738;Taip;0;1;0;1
2943;Giraitė;Gandriukai;9625436756;Taip;0;1;0;1
2944;Giraitė;Gandriukai;8101302584;Taip;13;0;1;14
2945;Giraitė;Gandriukai;9307640828;Taip;0;0;1;1
2946;Giraitė;Gandriukai;3027761044;Taip;10;0;0;10
2947;Giraitė;Gandriukai;4371263826;Taip;5;0;0;5
2948;Giraitė;Gandriukai;1227555563;Taip;9;0;2;11
2949;Giraitė;ŽVIRBLIUKAI;6715354865;Taip;0;1;0;1
2950;Giraitė;ŽVIRBLIUKAI;7395332578;Taip;9;0;0;9
2951;Giraitė;ŽVIRBLIUKAI;5086296808;Taip;0;11;0;11
2952;Giraitė;ŽVIRBLIUKAI;9669916418;Taip;0;0;1;1
2953;Giraitė;ŽVIRBLIUKAI;3481695682;Taip;5;0;0;5
2954;Giraitė;ŽVIRBLIUKAI;9471560738;Taip;0;1;0;1
2955;Giraitė;ŽVIRBLIUKAI;7230351549;Taip;0;6;0;6
2956;Giraitė;ŽVIRBLIUKAI;9728453316;Taip;0;1;0;1
2957;Giraitė;ŽVIRBLIUKAI;9114364139;Taip;0;2;0;2
2958;Giraitė;ŽVIRBLIUKAI;9392127689;Taip;0;2;1;3
2959;Giraitė;ŽVIRBLIUKAI;2416162886;Taip;3;0;1;4
2960;Giraitė;ŽVIRBLIUKAI;7543605905;Taip;4;3;0;7
2961;Giraitė;ŽVIRBLIUKAI;8128401630;Taip;19;0;0;19
2962;Giraitė;ŽVIRBLIUKAI;4233170371;Taip;11;0;0;11
2963;Giraitė;ŽVIRBLIUKAI;8871979627;Taip;0;0;1;1
2964;Giraitė;ŽVIRBLIUKAI;4450822125;Taip;2;0;0;2
2965;Giraitė;Kiškeliai;8259691835;Taip;11;0;0;11
2966;Giraitė;Kiškeliai;3457058930;Taip;3;0;0;3
2967;Giraitė;Kiškeliai;8787203512;Taip;5;0;0;5
2968;Giraitė;Kiškeliai;5364415038;Taip;0;7;0;7
2969;Giraitė;Kiškeliai;9503522932;Taip;4;0;1;5
2970;Giraitė;Kiškeliai;8869418518;Taip;6;0;0;6
2971;Giraitė;Kiškeliai;7227780890;Taip;6;0;1;7
2972;Giraitė;Kiškeliai;4964803735;Taip;6;0;0;6
2973;Giraitė;Kiškeliai;8148626841;Taip;10;5;0;15
2974;Gudrutis;Gandriukų;7143849852;Taip;10;0;0;10
2975;Gudrutis;Gandriukų;4600814480;Taip;0;1;0;1
2976;Gudrutis;Gandriukų;5931281687;Taip;0;3;0;3
2977;Gudrutis;Gandriukų;5498218329;Taip;2;6;0;8
2978;Gudrutis;Gandriukų;9454206104;Taip;6;0;0;6
2979;Gudrutis;Gandriukų;5911423362;Taip;4;0;0;4
2980;Gudrutis;Gandriukų;3316297441;Taip;3;1;0;4
2981;Gudrutis;Gandriukų;1170008457;Taip;2;0;0;2
2982;Gudrutis;Gandriukų;7930414623;Taip;2;0;0;2
2983;Gudrutis;Gandriukų;6307643172;Taip;2;0;0;2
2984;Gudrutis;Gandriukų;7531077386;Taip;0;4;0;4
2985;Gudrutis;Gandriukų;3000289515;Taip;1;0;0;1
2986;Gudrutis;Gandriukų;2256458624;Taip;1;0;0;1
2987;Gudrutis;Gandriukų;2784392885;Taip;1;0;0;1
2988;Gudrutis;Gandriukų;1588396018;Taip;1;3;0;4
2989;Gudrutis;Gandriukų;3136349573;Taip;4;0;0;4
2990;Gudrutis;Gandriukų;5257913623;Taip;4;1;0;5
2991;Gudrutis;"Saulės zuikučių";2199222671;Taip;1;0;0;1
2992;Gudrutis;"Saulės zuikučių";1670550212;Taip;2;0;0;2
2993;Gudrutis;"Saulės zuikučių";1225698076;Taip;0;0;9;9
2994;Gudrutis;"Saulės zuikučių";8500911420;Taip;0;1;0;1
2995;Gudrutis;"Saulės zuikučių";9697445037;Taip;1;0;0;1
2996;Gudrutis;"Saulės zuikučių";6846653547;Taip;9;0;0;9
2997;Gudrutis;"Saulės zuikučių";3281890659;Taip;0;8;0;8
2998;Gudrutis;"Saulės zuikučių";5585248878;Ne;4;9;0;13
2999;Gudrutis;"Saulės zuikučių";1384696362;Taip;4;0;0;4
3000;Gudrutis;"Saulės zuikučių";2666772437;Taip;0;0;1;1
3001;Gudrutis;"Saulės zuikučių";2994309084;Taip;2;0;2;4
3002;Gudrutis;"Saulės zuikučių";1641777291;Taip;13;10;0;23
3003;Gudrutis;"Saulės zuikučių";9044566825;Taip;0;5;2;7
3004;Gudrutis;"Saulės zuikučių";9683107780;Taip;0;9;1;10
3005;Gudrutis;"Saulės zuikučių";1197649093;Taip;7;0;0;7
3006;Gudrutis;Pelėdžiukų;7955353991;Taip;0;5;1;6
3007;Gudrutis;Pelėdžiukų;2197278086;Taip;2;6;0;8
3008;Gudrutis;Pelėdžiukų;6358318238;Taip;0;2;0;2
3009;Gudrutis;Pelėdžiukų;8774935740;Taip;10;4;0;14
3010;Gudrutis;Pelėdžiukų;4844838728;Taip;0;2;1;3
3011;Gudrutis;Pelėdžiukų;1685531183;Taip;0;0;2;2
3012;Gudrutis;Pelėdžiukų;9253468183;Taip;0;2;0;2
3013;Gudrutis;Pelėdžiukų;1051407930;Taip;0;0;4;4
3014;Gudrutis;Pelėdžiukų;7755882832;Taip;0;1;0;1
3015;Gudrutis;Pelėdžiukų;2487363252;Taip;0;0;3;3
3016;Gudrutis;Pelėdžiukų;9297898193;Taip;6;0;0;6
3017;Gudrutis;Pelėdžiukų;7663746093;Taip;3;9;0;12
3018;Gudrutis;Pelėdžiukų;8512130106;Taip;0;6;0;6
3019;Gudrutis;Pelėdžiukų;3919786807;Taip;5;0;0;5
3020;Gudrutis;Pelėdžiukų;1485530468;Taip;2;0;2;4
3021;Gudrutis;Pelėdžiukų;8598450150;Taip;23;0;0;23
3022;Gudrutis;Pelėdžiukų;2484715724;Taip;23;0;0;23
3023;Gudrutis;Pelėdžiukų;5508723821;Taip;14;6;0;20
3024;Gudrutis;BITUČIŲ;6700254479;Taip;0;4;9;13
3025;Gudrutis;BITUČIŲ;7773150642;Taip;0;3;4;7
3026;Gudrutis;BITUČIŲ;2293472716;Taip;0;1;1;2
3027;Gudrutis;BITUČIŲ;6835038962;Taip;5;0;0;5
3028;Gudrutis;BITUČIŲ;6731806925;Taip;0;3;1;4
3029;Gudrutis;BITUČIŲ;2118727861;Taip;0;0;2;2
3030;Gudrutis;BITUČIŲ;9701111916;Taip;3;10;2;15
3031;Gudrutis;BITUČIŲ;1725920873;Taip;1;4;5;10
3032;Gudrutis;BITUČIŲ;1901358996;Taip;10;0;1;11
3033;Gudrutis;BITUČIŲ;7664517480;Taip;2;0;0;2
3034;Gudrutis;BITUČIŲ;9847597133;Taip;0;4;0;4
3035;Gudrutis;BITUČIŲ;3646335609;Taip;0;1;3;4
3036;Gudrutis;BITUČIŲ;7871991275;Taip;2;3;1;6
3037;Gudrutis;BITUČIŲ;5580618896;Taip;1;3;1;5
3038;Gudrutis;BITUČIŲ;3625838131;Taip;0;6;0;6
3039;Gudrutis;BITUČIŲ;2337493193;Taip;0;3;0;3
3040;Gudrutis;BITUČIŲ;2408038213;Taip;0;4;8;12
3041;Gudrutis;BITUČIŲ;2764843216;Taip;4;4;0;8
3042;Gudrutis;BITUČIŲ;1012579870;Taip;0;3;0;3
3043;Gudrutis;BITUČIŲ;8165828215;Taip;2;4;0;6
3044;Gudrutis;BITUČIŲ;8240340213;Taip;0;4;0;4
3045;Gudrutis;Boružėlių;4623428212;Taip;5;0;1;6
3046;Gudrutis;Boružėlių;9893732913;Taip;10;0;0;10
3047;Gudrutis;Boružėlių;2807547699;Taip;6;0;0;6
3048;Gudrutis;Boružėlių;6326258371;Taip;0;9;1;10
3049;Gudrutis;Boružėlių;7033634744;Taip;3;10;1;14
3050;Gudrutis;Boružėlių;5748775407;Taip;9;0;0;9
3051;Gudrutis;Boružėlių;8296416202;Taip;9;0;0;9
3052;Gudrutis;Boružėlių;3959030593;Taip;3;0;1;4
3053;Gudrutis;Boružėlių;4672748361;Taip;7;0;0;7
3054;Gudrutis;Boružėlių;8081931247;Taip;5;0;0;5
3055;Gudrutis;Boružėlių;5382755416;Taip;15;0;1;16
3056;Gudrutis;Boružėlių;9948022627;Taip;9;7;0;16
3057;Gudrutis;Boružėlių;4540855641;Taip;0;0;3;3
3058;Gudrutis;Boružėlių;1277537891;Taip;17;0;0;17
3059;Gudrutis;Boružėlių;5121141955;Taip;5;0;0;5
3060;Gudrutis;Boružėlių;4691454736;Taip;2;0;0;2
3061;Gudrutis;Drugeliai;3797656483;Taip;0;4;0;4
3062;Gudrutis;Drugeliai;9200644104;Taip;0;4;0;4
3063;Gudrutis;Drugeliai;9096764346;Taip;0;1;0;1
3064;Gudrutis;Drugeliai;5306281458;Taip;9;0;3;12
3065;Gudrutis;Drugeliai;8783180638;Taip;9;0;3;12
3066;Gudrutis;Drugeliai;1737001982;Taip;7;0;1;8
3067;Gudrutis;Drugeliai;8525851058;Taip;3;0;0;3
3068;Gudrutis;Drugeliai;8080976400;Taip;0;0;4;4
3069;Gudrutis;Drugeliai;9808350750;Taip;0;1;0;1
3070;Gudrutis;Drugeliai;6101410750;Taip;0;1;0;1
3071;Gudrutis;Drugeliai;5710348070;Taip;0;0;5;5
3072;Gudrutis;Drugeliai;8843761360;Taip;0;0;5;5
3073;Gudrutis;Drugeliai;5590297232;Taip;3;0;1;4
3074;Gudrutis;Drugeliai;5093267385;Taip;1;4;4;9
3075;Gudrutis;Drugeliai;1364145110;Taip;0;4;2;6
3076;Gudrutis;Drugeliai;8803747496;Taip;19;0;1;20
3077;Gudrutis;Drugeliai;9714712791;Taip;8;0;1;9
3078;Gudrutis;Drugeliai;6063661969;Taip;0;0;4;4
3079;Gudrutis;Drugeliai;2435945253;Taip;6;0;9;15
3080;Gudrutis;Drugeliai;6268669142;Taip;2;0;0;2
3081;Jurginėlis;Ąžuoliukai;7309052653;Taip;18;0;0;18
3082;Jurginėlis;Ąžuoliukai;8571054905;Taip;8;0;0;8
3083;Jurginėlis;Ąžuoliukai;6168508647;Taip;17;0;0;17
3084;Jurginėlis;Ąžuoliukai;3933113321;Taip;13;7;0;20
3085;Jurginėlis;Ąžuoliukai;5861418459;Taip;0;13;0;13
3086;Jurginėlis;Ąžuoliukai;3562210465;Taip;4;0;0;4
3087;Jurginėlis;Ąžuoliukai;6202225321;Taip;1;4;0;5
3088;Jurginėlis;Ąžuoliukai;7081618073;Taip;1;1;0;2
3089;Jurginėlis;Ąžuoliukai;6851855147;Taip;12;0;0;12
3090;Jurginėlis;Ąžuoliukai;3324811458;Taip;2;0;0;2
3091;Jurginėlis;Ąžuoliukai;6153432639;Taip;7;0;0;7
3092;Jurginėlis;Ąžuoliukai;9850874714;Taip;5;0;0;5
3093;Jurginėlis;Ąžuoliukai;8174251359;Ne;11;4;0;15
3094;Jurginėlis;Ąžuoliukai;2447025385;Taip;18;0;0;18
3095;Jurginėlis;Ąžuoliukai;5313627252;Taip;17;0;0;17
3096;Jurginėlis;Žiogeliai;8159210242;Taip;0;14;0;14
3097;Jurginėlis;Žiogeliai;7251598691;Taip;0;4;0;4
3098;Jurginėlis;Žiogeliai;6906225772;Taip;8;0;0;8
3099;Jurginėlis;Žiogeliai;7010130915;Taip;6;2;0;8
3100;Jurginėlis;Žiogeliai;7907096012;Taip;2;9;0;11
3101;Jurginėlis;Žiogeliai;7250246853;Taip;0;5;0;5
3102;Jurginėlis;Žiogeliai;5160581631;Ne;2;1;0;3
3103;Jurginėlis;Žiogeliai;7300018733;Taip;0;1;0;1
3104;Jurginėlis;Žiogeliai;4674128568;Taip;0;4;0;4
3105;Jurginėlis;Žiogeliai;9305884152;Taip;9;4;0;13
3106;Jurginėlis;Žiogeliai;9716328349;Taip;17;6;0;23
3107;Jurginėlis;Žiogeliai;4441183185;Taip;4;0;0;4
3108;Jurginėlis;Žiogeliai;4502564783;Ne;6;2;0;8
3109;Jurginėlis;Žiogeliai;1937927553;Taip;4;1;0;5
3110;Jurginėlis;Žiogeliai;7527178332;Taip;2;0;0;2
3111;Jurginėlis;Žiogeliai;4682125116;Taip;10;0;0;10
3112;Jurginėlis;Žiogeliai;3920971621;Taip;8;3;0;11
3113;Jurginėlis;Pelėdžiukų;8844614653;Taip;3;4;0;7
3114;Jurginėlis;Pelėdžiukų;1303323955;Taip;2;0;0;2
3115;Jurginėlis;Pelėdžiukų;4466955830;Taip;0;20;0;20
3116;Jurginėlis;Pelėdžiukų;3675820817;Taip;2;3;0;5
3117;Jurginėlis;Pelėdžiukų;6285599044;Taip;7;4;0;11
3118;Jurginėlis;Pelėdžiukų;5043815909;Taip;4;0;0;4
3119;Jurginėlis;Pelėdžiukų;9901171406;Taip;6;0;0;6
3120;Jurginėlis;Pelėdžiukų;2982526236;Taip;2;0;0;2
3121;Jurginėlis;Pelėdžiukų;4233910766;Taip;0;1;0;1
3122;Jurginėlis;Pelėdžiukų;1537710974;Taip;5;0;0;5
3123;Jurginėlis;Pelėdžiukų;6594025023;Taip;7;0;0;7
3124;Jurginėlis;Pelėdžiukų;6124147401;Taip;3;4;0;7
3125;Jurginėlis;Pelėdžiukų;9139025010;Taip;6;0;0;6
3126;Jurginėlis;Pelėdžiukų;7554346190;Taip;6;0;0;6
3127;Jurginėlis;Pelėdžiukų;4555257132;Taip;6;0;0;6
3128;Jurginėlis;Boružėlių;6806704355;Taip;5;4;0;9
3129;Jurginėlis;Boružėlių;3091019969;Taip;5;2;0;7
3130;Jurginėlis;Boružėlių;9288380246;Taip;1;4;0;5
3131;Jurginėlis;Boružėlių;2548920722;Taip;6;4;0;10
3132;Jurginėlis;Boružėlių;7288921301;Taip;4;0;0;4
3133;Jurginėlis;Boružėlių;2263818210;Taip;2;0;0;2
3134;Jurginėlis;Boružėlių;4827340942;Taip;10;1;0;11
3135;Jurginėlis;Boružėlių;4463258777;Taip;5;4;0;9
3136;Jurginėlis;Boružėlių;2225892248;Taip;8;4;0;12
3137;Jurginėlis;Boružėlių;6579565337;Taip;4;0;0;4
3138;Jurginėlis;Boružėlių;3462969423;Taip;0;6;0;6
3139;Jurginėlis;Boružėlių;7990015623;Taip;5;4;0;9
3140;Jurginėlis;Boružėlių;4158502752;Taip;0;6;0;6
3141;Jurginėlis;Boružėlių;5242359650;Taip;0;4;0;4
3142;Jurginėlis;Boružėlių;3284464951;Taip;5;11;0;16
3143;Jurginėlis;Boružėlių;8144038013;Taip;1;4;0;5
3144;Jurginėlis;Boružėlių;2536744421;Taip;0;23;0;23
3145;Jurginėlis;Bitučių;5984893389;Taip;0;6;0;6
3146;Jurginėlis;Bitučių;3079495897;Ne;3;2;0;5
3147;Jurginėlis;Bitučių;8727844649;Taip;6;4;2;12
3148;Jurginėlis;Bitučių;1455749921;Taip;0;7;0;7
3149;Jurginėlis;Bitučių;7809274980;Taip;0;4;0;4
3150;Jurginėlis;Bitučių;2417314519;Taip;2;1;0;3
3151;Jurginėlis;Bitučių;6968528293;Taip;0;1;0;1
3152;Jurginėlis;Bitučių;9507571301;Taip;3;0;0;3
3153;Jurginėlis;Bitučių;8779807396;Taip;2;3;0;5
3154;Jurginėlis;Bitučių;4967548277;Taip;0;4;2;6
3155;Jurginėlis;Bitučių;2925253653;Taip;0;2;0;2
3156;Jurginėlis;Bitučių;1340689348;Taip;0;4;1;5
3157;Jurginėlis;Bitučių;6181547354;Taip;10;5;0;15
3158;Jurginėlis;Bitučių;2490875633;Taip;9;4;0;13
3159;Jurginėlis;Bitučių;4689913361;Taip;0;0;1;1
3160;Jurginėlis;Skruzdeliukų;1351306981;Taip;16;0;0;16
3161;Jurginėlis;Skruzdeliukų;9146039217;Taip;0;2;0;2
3162;Jurginėlis;Skruzdeliukų;3558752347;Taip;0;9;0;9
3163;Jurginėlis;Skruzdeliukų;5734506036;Ne;0;5;0;5
3164;Jurginėlis;Skruzdeliukų;3699180485;Taip;0;2;0;2
3165;Jurginėlis;Skruzdeliukų;4981043400;Taip;3;0;0;3
3166;Jurginėlis;Skruzdeliukų;1763849354;Taip;14;0;0;14
3167;Jurginėlis;Skruzdeliukų;4944292549;Taip;0;6;0;6
3168;Jurginėlis;Skruzdeliukų;9506129699;Taip;5;1;0;6
3169;Jurginėlis;Skruzdeliukų;9550110246;Taip;4;0;0;4
3170;Jurginėlis;Skruzdeliukų;1204999684;Taip;9;3;0;12
3171;Jurginėlis;Skruzdeliukų;9937405742;Taip;8;0;0;8
3172;Jurginėlis;Skruzdeliukų;1726968598;Taip;0;19;0;19
3173;Jurginėlis;Skruzdeliukų;9961083854;Taip;0;5;0;5
3174;Jurginėlis;Skruzdeliukų;6542567172;Taip;3;4;0;7
3175;Jurginėlis;Drugelių;2025403481;Taip;8;0;0;8
3176;Jurginėlis;Drugelių;9065349248;Taip;9;0;0;9
3177;Jurginėlis;Drugelių;8341951659;Taip;5;5;0;10
3178;Jurginėlis;Drugelių;7795042485;Taip;11;0;0;11
3179;Jurginėlis;Drugelių;5138832895;Taip;5;0;0;5
3180;Jurginėlis;Drugelių;5751977493;Taip;18;0;0;18
3181;Jurginėlis;Drugelių;3466562781;Taip;7;0;0;7
3182;Jurginėlis;Drugelių;6068645621;Taip;0;7;0;7
3183;Jurginėlis;Drugelių;4276237094;Taip;15;1;0;16
3184;Jurginėlis;Drugelių;2689492215;Taip;3;0;0;3
3185;Jurginėlis;Drugelių;9736737788;Taip;1;0;0;1
3186;Jurginėlis;Drugelių;1208882528;Taip;3;0;0;3
3187;Jurginėlis;Drugelių;5874949368;Taip;17;0;0;17
3188;Jurginėlis;Drugelių;7349309693;Taip;1;4;0;5
3189;Jurginėlis;Drugelių;3063084253;Taip;13;0;0;13
3190;Jurginėlis;Drugelių;7409019574;Taip;7;0;0;7
3191;Jurginėlis;Drugelių;5928303681;Taip;10;0;0;10
3192;Jurginėlis;Drugelių;5476486516;Taip;2;0;0;2
3193;Jurginėlis;Drugelių;8536084383;Taip;4;0;0;4
3194;Jurginėlis;Žibučių;4979618298;Taip;4;0;0;4
3195;Jurginėlis;Žibučių;6636147085;Taip;10;4;0;14
3196;Jurginėlis;Žibučių;1438159631;Taip;0;4;0;4
3197;Jurginėlis;Žibučių;1336429135;Taip;5;0;0;5
3198;Jurginėlis;Žibučių;6948834218;Taip;24;4;0;28
3199;Jurginėlis;Žibučių;7721612113;Taip;9;0;1;10
3200;Jurginėlis;Žibučių;6988386438;Taip;4;0;0;4
3201;Jurginėlis;Žibučių;8111158692;Taip;3;0;0;3
3202;Jurginėlis;Žibučių;5936508522;Taip;5;17;0;22
3203;Jurginėlis;Žibučių;6717892969;Taip;12;7;0;19
3204;Jurginėlis;Žibučių;7977676733;Taip;5;0;0;5
3205;Jurginėlis;Žibučių;7530846375;Taip;0;1;0;1
3206;Jurginėlis;Žibučių;3861311860;Taip;2;2;1;5
3207;Jurginėlis;Žibučių;1263601087;Taip;4;0;0;4
3208;Jurginėlis;Žibučių;5549766339;Taip;0;3;0;3
3209;Jurginėlis;Žibučių;4429780802;Taip;0;2;0;2
3210;Jurginėlis;Žibučių;8968718021;Taip;10;0;0;10
3211;Jurginėlis;Žibučių;2782553941;Taip;21;0;0;21
3212;Jurginėlis;Žibučių;6259461257;Taip;1;5;0;6
3213;Jurginėlis;Žibučių;7252041334;Taip;11;0;2;13
3214;Jurginėlis;Zuikučių;5958832413;Taip;0;2;0;2
3215;Jurginėlis;Zuikučių;4432849717;Taip;13;0;0;13
3216;Jurginėlis;Zuikučių;6587382160;Taip;3;5;0;8
3217;Jurginėlis;Zuikučių;8097652962;Taip;4;4;0;8
3218;Jurginėlis;Zuikučių;4763313715;Taip;4;1;0;5
3219;Jurginėlis;Zuikučių;6671759364;Taip;5;4;0;9
3220;Jurginėlis;Zuikučių;8937404520;Taip;7;0;0;7
3221;Jurginėlis;Zuikučių;2820249307;Taip;2;0;0;2
3222;Jurginėlis;Zuikučių;8823175066;Taip;1;0;0;1
3223;Jurginėlis;Zuikučių;8161347781;Taip;7;8;0;15
3224;Jurginėlis;Zuikučių;4113264904;Taip;16;0;0;16
3225;Jurginėlis;Zuikučių;8117563141;Taip;5;0;0;5
3226;Jurginėlis;Zuikučių;5652597514;Taip;0;0;4;4
3227;Jurginėlis;Zuikučių;6341896288;Taip;4;0;0;4
3228;Jurginėlis;Zuikučių;3530906368;Ne;5;3;0;8
3229;Jurginėlis;Zuikučių;4292932046;Taip;4;0;0;4
3230;Jurginėlis;Zuikučių;1582948463;Taip;0;1;0;1
3231;Jurginėlis;Viščiukų;1405338657;Taip;16;0;0;16
3232;Jurginėlis;Viščiukų;9366610698;Taip;11;0;0;11
3233;Jurginėlis;Viščiukų;8050408300;Taip;2;0;3;5
3234;Jurginėlis;Viščiukų;2378007686;Taip;23;0;0;23
3235;Jurginėlis;Viščiukų;3254001601;Taip;7;0;0;7
3236;Jurginėlis;Viščiukų;8050843105;Taip;2;0;0;2
3237;Jurginėlis;Viščiukų;6550401531;Taip;3;0;0;3
3238;Jurginėlis;Viščiukų;7684663210;Taip;11;0;0;11
3239;Jurginėlis;Viščiukų;6135184014;Taip;2;2;0;4
3240;Jurginėlis;Meškiukų;6584048242;Taip;4;0;0;4
3241;Jurginėlis;Meškiukų;2652507538;Taip;14;0;0;14
3242;Jurginėlis;Meškiukų;4645348169;Taip;4;4;0;8
3243;Jurginėlis;Meškiukų;8348637578;Taip;0;1;0;1
3244;Jurginėlis;Meškiukų;6266328957;Taip;16;0;0;16
3245;Jurginėlis;Meškiukų;7424513586;Taip;7;0;0;7
3246;Jurginėlis;Meškiukų;5945075337;Taip;6;1;0;7
3247;Jurginėlis;Meškiukų;5472986119;Taip;16;0;0;16
3248;Jurginėlis;Meškiukų;5105758563;Taip;7;0;0;7
3249;Jurginėlis;Meškiukų;7892411156;Taip;7;0;0;7
3250;Jurginėlis;Meškiukų;2967314352;Taip;13;0;0;13
3251;Jurginėlis;Meškiukų;7053226448;Taip;6;4;0;10
3252;Jurginėlis;Gandriukų;6306274502;Taip;8;0;0;8
3253;Jurginėlis;Gandriukų;9603380131;Taip;10;0;0;10
3254;Jurginėlis;Gandriukų;7193314762;Taip;1;0;0;1
3255;Jurginėlis;Gandriukų;4506484183;Taip;9;0;0;9
3256;Jurginėlis;Gandriukų;5474358669;Taip;23;0;0;23
3257;Jurginėlis;Gandriukų;2595002682;Taip;7;0;0;7
3258;Jurginėlis;Gandriukų;5866358319;Taip;4;0;0;4
3259;Jurginėlis;Gandriukų;4648875524;Taip;6;0;0;6
3260;Jurginėlis;Gandriukų;1598578487;Taip;9;0;0;9
3261;Jurginėlis;Gandriukų;4644476606;Taip;5;0;0;5
3262;Jurginėlis;Gandriukų;3230200231;Taip;1;0;0;1
3263;Jurginėlis;Gandriukų;7636442845;Taip;10;0;0;10
3264;Jurginėlis;Gandriukų;4617952912;Taip;12;0;0;12
3265;Jurginėlis;Gandriukų;3672557409;Taip;0;1;0;1
3266;Jurginėlis;Gandriukų;1043529560;Taip;14;0;0;14
3267;Jurginėlis;Gandriukų;5688209539;Taip;12;0;0;12
3268;Jurginėlis;Gandriukų;2084877917;Taip;4;12;0;16
3269;Karuselė;PAGRANDUKAS;1621482372;Taip;0;5;0;5
3270;Karuselė;PAGRANDUKAS;3330374479;Taip;0;1;0;1
3271;Karuselė;PAGRANDUKAS;6183785840;Taip;2;0;0;2
3272;Karuselė;PAGRANDUKAS;3984262482;Taip;6;0;0;6
3273;Karuselė;PAGRANDUKAS;9130534156;Taip;7;0;0;7
3274;Karuselė;PAGRANDUKAS;3660843696;Taip;0;12;0;12
3275;Karuselė;PAGRANDUKAS;5132581245;Taip;0;6;0;6
3276;Karuselė;PAGRANDUKAS;2412418335;Taip;0;5;0;5
3277;Karuselė;PAGRANDUKAS;5695697634;Taip;0;1;0;1
3278;Karuselė;PAGRANDUKAS;6252613489;Taip;14;1;0;15
3279;Karuselė;PAGRANDUKAS;6004882312;Taip;0;3;0;3
3280;Karuselė;PAGRANDUKAS;6856800484;Taip;6;1;0;7
3281;Karuselė;PAGRANDUKAS;3972815393;Taip;6;2;0;8
3282;Karuselė;PAGRANDUKAS;8157193503;Taip;10;1;0;11
3283;Karuselė;PAGRANDUKAS;9651192437;Taip;0;3;0;3
3284;Karuselė;PAGRANDUKAS;7916589127;Taip;0;4;0;4
3285;Karuselė;PAGRANDUKAS;7564618678;Taip;5;6;0;11
3286;Karuselė;PAGRANDUKAS;6546648346;Taip;0;5;0;5
3287;Karuselė;PAGRANDUKAS;8182071103;Taip;13;3;0;16
3288;Karuselė;NYKŠTUKAS;4966362343;Taip;4;2;0;6
3289;Karuselė;NYKŠTUKAS;9997776739;Taip;4;0;0;4
3290;Karuselė;NYKŠTUKAS;4445214427;Taip;0;12;0;12
3291;Karuselė;NYKŠTUKAS;9354431582;Taip;0;2;0;2
3292;Karuselė;NYKŠTUKAS;5216815933;Taip;0;4;0;4
3293;Karuselė;NYKŠTUKAS;7817417459;Taip;11;2;0;13
3294;Karuselė;NYKŠTUKAS;9654804545;Taip;0;8;0;8
3295;Karuselė;NYKŠTUKAS;6581798125;Taip;0;1;0;1
3296;Karuselė;NYKŠTUKAS;1486577955;Taip;13;0;0;13
3297;Karuselė;NYKŠTUKAS;5697305819;Taip;2;0;0;2
3298;Karuselė;NYKŠTUKAS;8007341411;Taip;0;3;0;3
3299;Karuselė;NYKŠTUKAS;4363388969;Taip;10;0;0;10
3300;Karuselė;NYKŠTUKAS;9243932017;Taip;7;2;0;9
3301;Karuselė;NYKŠTUKAS;5986973796;Taip;5;0;0;5
3302;Karuselė;NYKŠTUKAS;4856589410;Taip;4;1;0;5
3303;Karuselė;NYKŠTUKAS;9999461542;Taip;5;9;0;14
3304;Karuselė;NYKŠTUKAS;9385698812;Taip;3;3;0;6
3305;Karuselė;NYKŠTUKAS;4868770355;Taip;0;5;0;5
3306;Karuselė;BITUTĖ;8175498192;Taip;5;6;2;13
3307;Karuselė;BITUTĖ;5951045233;Taip;0;5;0;5
3308;Karuselė;BITUTĖ;7977133699;Taip;2;4;0;6
3309;Karuselė;BITUTĖ;6165548450;Taip;0;8;0;8
3310;Karuselė;BITUTĖ;4435125556;Taip;0;6;0;6
3311;Karuselė;BITUTĖ;3049506194;Taip;0;2;0;2
3312;Karuselė;BITUTĖ;7733032142;Ne;0;5;0;5
3313;Karuselė;BITUTĖ;1412890120;Taip;0;17;0;17
3314;Karuselė;BITUTĖ;5135054911;Taip;0;6;0;6
3315;Karuselė;BITUTĖ;4130693235;Taip;5;5;0;10
3316;Karuselė;BITUTĖ;8012963667;Taip;0;2;0;2
3317;Karuselė;BITUTĖ;9340167973;Taip;0;5;0;5
3318;Karuselė;BITUTĖ;6826455161;Taip;0;7;0;7
3319;Karuselė;BITUTĖ;3661917922;Taip;0;3;0;3
3320;Karuselė;BITUTĖ;2727440190;Taip;0;1;0;1
3321;Karuselė;BITUTĖ;2306922755;Taip;0;5;0;5
3322;Karuselė;BITUTĖ;6062361348;Ne;0;5;0;5
3323;Karuselė;BITUTĖ;9996567374;Taip;0;4;0;4
3324;Karuselė;BITUTĖ;2529641529;Taip;0;8;0;8
3325;Karuselė;BITUTĖ;4262640017;Taip;0;2;0;2
3326;Karuselė;BITUTĖ;6495631086;Taip;0;2;0;2
3327;Karuselė;BITUTĖ;8406462155;Taip;5;4;0;9
3328;Karuselė;BITUTĖ;2247913568;Taip;0;6;0;6
3329;Karuselė;BORUŽĖLĖ;7030946179;Taip;13;0;1;14
3330;Karuselė;BORUŽĖLĖ;6283563118;Taip;8;0;0;8
3331;Karuselė;BORUŽĖLĖ;9303194274;Taip;6;0;0;6
3332;Karuselė;BORUŽĖLĖ;7817670288;Taip;18;0;0;18
3333;Karuselė;BORUŽĖLĖ;7986277964;Taip;0;10;0;10
3334;Karuselė;BORUŽĖLĖ;5397256562;Taip;13;0;0;13
3335;Karuselė;BORUŽĖLĖ;8004953571;Taip;14;0;0;14
3336;Karuselė;BORUŽĖLĖ;8357973162;Taip;7;0;0;7
3337;Karuselė;BORUŽĖLĖ;8689140295;Taip;16;0;0;16
3338;Karuselė;BORUŽĖLĖ;7430518094;Taip;13;0;0;13
3339;Karuselė;BORUŽĖLĖ;9995800164;Taip;11;0;0;11
3340;Karuselė;BORUŽĖLĖ;8664628232;Taip;23;0;0;23
3341;Karuselė;BORUŽĖLĖ;8234778310;Taip;18;0;0;18
3342;Karuselė;BORUŽĖLĖ;7869324652;Taip;13;0;0;13
3343;Karuselė;BORUŽĖLĖ;5519366758;Taip;14;0;0;14
3344;Karuselė;BORUŽĖLĖ;6669293437;Taip;8;0;0;8
3345;Karuselė;UOGELĖ;1119373532;Taip;18;0;0;18
3346;Karuselė;UOGELĖ;2135332292;Taip;0;12;0;12
3347;Karuselė;UOGELĖ;8441520423;Taip;0;0;1;1
3348;Karuselė;UOGELĖ;9463553056;Taip;0;2;0;2
3349;Karuselė;UOGELĖ;8671884362;Taip;0;12;0;12
3350;Karuselė;UOGELĖ;4871960780;Taip;4;14;0;18
3351;Karuselė;UOGELĖ;3551143062;Taip;2;1;0;3
3352;Karuselė;UOGELĖ;8257771271;Taip;0;10;0;10
3353;Karuselė;UOGELĖ;7749015193;Taip;3;8;0;11
3354;Karuselė;UOGELĖ;2993499990;Taip;18;0;0;18
3355;Karuselė;UOGELĖ;3075592618;Taip;0;0;1;1
3356;Karuselė;UOGELĖ;2450390957;Taip;0;10;0;10
3357;Karuselė;UOGELĖ;7535451590;Taip;0;18;0;18
3358;Karuselė;UOGELĖ;4302662341;Taip;0;18;0;18
3359;Karuselė;UOGELĖ;4865727149;Taip;4;2;0;6
3360;Karuselė;UOGELĖ;8952114853;Ne;3;4;0;7
3361;Karuselė;UOGELĖ;9649615834;Taip;4;0;0;4
3362;Karuselė;UOGELĖ;3885475525;Taip;18;4;0;22
3363;Karuselė;UOGELĖ;6562490670;Taip;1;1;0;2
3364;Karuselė;UOGELĖ;4799230363;Taip;18;0;0;18
3365;Karuselė;GINTARĖLIS;3773170060;Taip;4;0;0;4
3366;Karuselė;GINTARĖLIS;3904453423;Taip;4;2;0;6
3367;Karuselė;GINTARĖLIS;7489136297;Taip;4;1;0;5
3368;Karuselė;GINTARĖLIS;3534074990;Taip;0;13;0;13
3369;Karuselė;GINTARĖLIS;7540323186;Taip;2;3;0;5
3370;Karuselė;GINTARĖLIS;1019322763;Taip;0;4;0;4
3371;Karuselė;GINTARĖLIS;8481143199;Taip;0;3;4;7
3372;Karuselė;GINTARĖLIS;8409412605;Taip;4;6;1;11
3373;Karuselė;GINTARĖLIS;7599328323;Taip;5;0;0;5
3374;Karuselė;GINTARĖLIS;2688863117;Taip;0;5;0;5
3375;Karuselė;GINTARĖLIS;7439791054;Taip;23;0;0;23
3376;Karuselė;GINTARĖLIS;3696384277;Taip;8;3;0;11
3377;Karuselė;GINTARĖLIS;2945027875;Taip;9;10;0;19
3378;Karuselė;GINTARĖLIS;9116238924;Taip;7;0;0;7
3379;Karuselė;GINTARĖLIS;6433987745;Ne;0;3;7;10
3380;Karuselė;GINTARĖLIS;9763326660;Taip;0;4;0;4
3381;Karuselė;GINTARĖLIS;6232570825;Taip;0;1;1;2
3382;Karuselė;GINTARĖLIS;3471091687;Taip;2;6;0;8
3383;Karuselė;GINTARĖLIS;4103816990;Taip;3;1;0;4
3384;Karuselė;GINTARĖLIS;4325959483;Taip;5;0;1;6
3385;Karuselė;GINTARĖLIS;6785226197;Ne;0;1;1;2
3386;Karuselė;SAULUTĖ;5627583683;Taip;10;5;0;15
3387;Karuselė;SAULUTĖ;2242659064;Taip;8;15;0;23
3388;Karuselė;SAULUTĖ;5704218177;Taip;17;5;0;22
3389;Karuselė;SAULUTĖ;5146709341;Taip;0;1;0;1
3390;Karuselė;SAULUTĖ;7814525717;Ne;0;2;0;2
3391;Karuselė;SAULUTĖ;8331985564;Taip;2;0;0;2
3392;Karuselė;SAULUTĖ;9400171357;Taip;2;0;0;2
3393;Karuselė;SAULUTĖ;9656723409;Taip;12;3;0;15
3394;Karuselė;SAULUTĖ;5766390337;Taip;0;5;0;5
3395;Karuselė;SAULUTĖ;4879654321;Taip;3;3;0;6
3396;Karuselė;SAULUTĖ;5803808409;Taip;0;1;0;1
3397;Karuselė;SAULUTĖ;2269840705;Taip;3;0;0;3
3398;Karuselė;SAULUTĖ;3149575456;Taip;4;1;0;5
3399;Karuselė;SAULUTĖ;5640656442;Taip;0;2;0;2
3400;Karuselė;SAULUTĖ;9451789237;Taip;3;2;0;5
3401;Karuselė;SAULUTĖ;9450841251;Taip;5;3;0;8
3402;Karuselė;SAULUTĖ;6338379641;Taip;10;0;0;10
3403;Karuselė;SAULUTĖ;8830559511;Taip;10;0;0;10
3404;Karuselė;SAULUTĖ;3228100488;Taip;1;1;0;2
3405;Karuselė;SAULUTĖ;5830080035;Ne;6;0;0;6
3406;Karuselė;SAULUTĖ;9985033530;Taip;2;1;0;3
3407;Karuselė;SAULUTĖ;4211688032;Taip;7;0;0;7
3408;Karuselė;SAULUTĖ;5802996641;Taip;4;1;0;5
3409;Karuselė;SAULUTĖ;3271464159;Taip;17;1;0;18
3410;Karuselė;SAULUTĖ;7501323454;Taip;11;0;0;11
3411;Karuselė;TIGRIUKAS;9561892809;Taip;14;0;0;14
3412;Karuselė;TIGRIUKAS;9726299722;Taip;0;7;0;7
3413;Karuselė;TIGRIUKAS;1576201225;Taip;13;1;0;14
3414;Karuselė;TIGRIUKAS;9344514262;Taip;4;0;1;5
3415;Karuselė;TIGRIUKAS;7131255599;Taip;19;0;0;19
3416;Karuselė;TIGRIUKAS;4180604225;Taip;19;0;0;19
3417;Karuselė;TIGRIUKAS;2397938004;Taip;5;2;0;7
3418;Karuselė;TIGRIUKAS;3605966015;Taip;9;0;0;9
3419;Karuselė;TIGRIUKAS;9252093125;Taip;0;5;0;5
3420;Karuselė;TIGRIUKAS;5176597751;Taip;0;4;0;4
3421;Karuselė;TIGRIUKAS;8474027736;Taip;11;0;1;12
3422;Karuselė;TIGRIUKAS;2549599594;Taip;15;0;0;15
3423;Karuselė;TIGRIUKAS;9394220081;Taip;7;1;0;8
3424;Karuselė;TIGRIUKAS;7618984957;Taip;13;1;0;14
3425;Karuselė;TIGRIUKAS;6678283260;Taip;1;2;0;3
3426;Karuselė;TIGRIUKAS;5964942317;Ne;10;6;0;16
3427;Karuselė;VAIVORYKŠTĖ;1289442716;Taip;0;1;1;2
3428;Karuselė;VAIVORYKŠTĖ;9855242602;Taip;0;0;4;4
3429;Karuselė;VAIVORYKŠTĖ;8063412271;Taip;0;1;0;1
3430;Karuselė;VAIVORYKŠTĖ;3514315636;Taip;3;1;0;4
3431;Karuselė;VAIVORYKŠTĖ;8085919723;Taip;3;1;0;4
3432;Karuselė;VAIVORYKŠTĖ;1581504806;Taip;0;0;1;1
3433;Karuselė;VAIVORYKŠTĖ;2215367063;Taip;1;4;0;5
3434;Karuselė;VAIVORYKŠTĖ;6424622497;Taip;14;1;1;16
3435;Karuselė;VAIVORYKŠTĖ;5128774216;Taip;0;1;0;1
3436;Karuselė;VAIVORYKŠTĖ;1604997207;Ne;0;4;0;4
3437;Karuselė;VAIVORYKŠTĖ;2757263085;Taip;0;2;0;2
3438;Karuselė;VAIVORYKŠTĖ;4110024673;Taip;0;4;1;5
3439;Karuselė;VAIVORYKŠTĖ;9400856559;Taip;0;4;0;4
3440;Karuselė;VAIVORYKŠTĖ;1083786182;Taip;0;4;0;4
3441;Karuselė;VAIVORYKŠTĖ;5998868204;Taip;0;1;0;1
3442;Karuselė;VAIVORYKŠTĖ;6734936247;Taip;0;1;0;1
3443;Karuselė;VAIVORYKŠTĖ;3082636224;Ne;0;1;0;1
3444;Karuselė;VAIVORYKŠTĖ;4749086136;Taip;1;1;0;2
3445;Karuselė;VAIVORYKŠTĖ;8371081106;Taip;0;0;1;1
3446;Karuselė;"AUKSINĖ ŽUVELĖ";1344025242;Taip;14;0;0;14
3447;Karuselė;"AUKSINĖ ŽUVELĖ";6048980111;Taip;10;0;0;10
3448;Karuselė;"AUKSINĖ ŽUVELĖ";9535490329;Taip;10;0;0;10
3449;Karuselė;"AUKSINĖ ŽUVELĖ";5313839511;Taip;14;1;0;15
3450;Karuselė;"AUKSINĖ ŽUVELĖ";8074453862;Taip;11;0;0;11
3451;Karuselė;"AUKSINĖ ŽUVELĖ";5912561598;Ne;13;0;0;13
3452;Karuselė;"AUKSINĖ ŽUVELĖ";3728662112;Taip;6;2;0;8
3453;Karuselė;"AUKSINĖ ŽUVELĖ";9170947196;Taip;15;0;0;15
3454;Karuselė;"AUKSINĖ ŽUVELĖ";4982029137;Taip;18;0;0;18
3455;Karuselė;"AUKSINĖ ŽUVELĖ";3408146969;Taip;20;0;0;20
3456;Karuselė;"AUKSINĖ ŽUVELĖ";3464711958;Taip;0;33;0;33
3457;Karuselė;RAMUNĖ;6319361312;Ne;7;1;0;8
3458;Karuselė;RAMUNĖ;5666333470;Taip;0;14;0;14
3459;Karuselė;RAMUNĖ;6370060620;Taip;10;0;0;10
3460;Karuselė;RAMUNĖ;6844148347;Taip;11;0;0;11
3461;Karuselė;RAMUNĖ;7250708607;Taip;12;0;0;12
3462;Karuselė;RAMUNĖ;3890681011;Taip;9;1;0;10
3463;Karuselė;RAMUNĖ;6469579272;Taip;19;0;0;19
3464;Karuselė;RAMUNĖ;4707292159;Taip;14;0;0;14
3465;Karuselė;RAMUNĖ;5926712250;Taip;6;0;1;7
3466;Karuselė;RAMUNĖ;1427836663;Taip;10;0;1;11
3467;Karuselė;RAMUNĖ;3008219926;Taip;9;0;0;9
3468;Karuselė;RAMUNĖ;5736966465;Taip;5;0;0;5
3469;Karuselė;RAMUNĖ;9789687336;Taip;20;0;0;20
3470;Karuselė;RAMUNĖ;2843226066;Taip;10;0;3;13
3471;Karuselė;RAMUNĖ;8590035431;Taip;9;0;0;9
3472;Karuselė;RAMUNĖ;3276397300;Taip;18;0;0;18
3473;Karuselė;VILKELIS;7721986618;Taip;6;0;0;6
3474;Karuselė;VILKELIS;8238334389;Taip;0;2;0;2
3475;Karuselė;VILKELIS;5036757881;Taip;8;1;0;9
3476;Karuselė;VILKELIS;7794320463;Taip;8;0;0;8
3477;Karuselė;VILKELIS;7052993128;Taip;6;0;1;7
3478;Karuselė;VILKELIS;7480485777;Taip;3;0;0;3
3479;Karuselė;VILKELIS;6341570221;Taip;5;0;1;6
3480;Karuselė;VILKELIS;4566201460;Taip;0;1;0;1
3481;Karuselė;VILKELIS;8848085495;Ne;0;15;0;15
3482;Karuselė;VILKELIS;8362740639;Taip;0;1;0;1
3483;Karuselė;VILKELIS;2842034472;Taip;16;0;0;16
3484;Karuselė;VILKELIS;8531556390;Taip;0;2;0;2
3485;Karuselė;VILKELIS;4757820179;Taip;4;5;0;9
3486;Karuselė;VILKELIS;9415377698;Taip;0;4;0;4
3487;Karuselė;VILKELIS;2260731421;Taip;6;1;0;7
3488;Karuselė;VILKELIS;4196250786;Taip;13;0;0;13
3489;Kaštonas;NYKŠTUKAI;7703842464;Taip;18;0;0;18
3490;Kaštonas;NYKŠTUKAI;8145965849;Taip;3;0;0;3
3491;Kaštonas;NYKŠTUKAI;2178971789;Taip;1;0;0;1
3492;Kaštonas;NYKŠTUKAI;2361839733;Taip;0;4;0;4
3493;Kaštonas;NYKŠTUKAI;4782280933;Taip;6;0;0;6
3494;Kaštonas;NYKŠTUKAI;1258105498;Taip;5;0;0;5
3495;Kaštonas;NYKŠTUKAI;8766848385;Taip;4;0;0;4
3496;Kaštonas;NYKŠTUKAI;3251132542;Taip;2;0;0;2
3497;Kaštonas;NYKŠTUKAI;1501441973;Ne;17;0;0;17
3498;Kaštonas;NYKŠTUKAI;5948707303;Taip;14;0;0;14
3499;Kaštonas;DRUGELIAI;8486955652;Taip;5;4;0;9
3500;Kaštonas;DRUGELIAI;2106924435;Taip;0;4;0;4
3501;Kaštonas;DRUGELIAI;8483888152;Taip;2;11;0;13
3502;Kaštonas;DRUGELIAI;7408901858;Taip;14;2;0;16
3503;Kaštonas;DRUGELIAI;2832688622;Ne;8;3;0;11
3504;Kaštonas;DRUGELIAI;9061158412;Ne;0;8;0;8
3505;Kaštonas;DRUGELIAI;5884427036;Taip;2;4;0;6
3506;Kaštonas;DRUGELIAI;1141693073;Taip;1;2;0;3
3507;Kaštonas;DRUGELIAI;6251564828;Taip;3;1;0;4
3508;Kaštonas;DRUGELIAI;8166925991;Taip;0;3;0;3
3509;Kaštonas;DRUGELIAI;4215759647;Taip;0;4;0;4
3510;Kaštonas;DRUGELIAI;5307755844;Taip;0;8;0;8
3511;Kaštonas;DRUGELIAI;8257643251;Taip;15;0;0;15
3512;Kaštonas;DRUGELIAI;4384907654;Taip;4;2;0;6
3513;Kaštonas;DRUGELIAI;1976138680;Taip;3;2;0;5
3514;Kaštonas;DRUGELIAI;7992154554;Taip;2;1;0;3
3515;Kaštonas;DRUGELIAI;7698074598;Taip;15;1;0;16
3516;Kaštonas;KIŠKUČIAI;9807554365;Taip;0;5;0;5
3517;Kaštonas;KIŠKUČIAI;4552007726;Ne;9;0;0;9
3518;Kaštonas;KIŠKUČIAI;2020612346;Taip;0;14;0;14
3519;Kaštonas;KIŠKUČIAI;6585977073;Taip;0;4;0;4
3520;Kaštonas;KIŠKUČIAI;7383219978;Taip;0;5;0;5
3521;Kaštonas;KIŠKUČIAI;4641535612;Taip;9;5;0;14
3522;Kaštonas;KIŠKUČIAI;2057499534;Taip;0;3;0;3
3523;Kaštonas;KIŠKUČIAI;6749679348;Taip;0;3;0;3
3524;Kaštonas;KIŠKUČIAI;3860613494;Taip;0;23;0;23
3525;Kaštonas;KIŠKUČIAI;9778140363;Ne;10;1;0;11
3526;Kaštonas;KIŠKUČIAI;7290414209;Taip;9;14;0;23
3527;Kaštonas;KIŠKUČIAI;9356018629;Taip;0;1;0;1
3528;Kaštonas;KIŠKUČIAI;9320223622;Taip;0;13;0;13
3529;Kaštonas;KIŠKUČIAI;6425908247;Taip;0;8;0;8
3530;Kaštonas;KIŠKUČIAI;2874873326;Ne;4;2;0;6
3531;Kaštonas;KIŠKUČIAI;6934262510;Taip;0;13;0;13
3532;Kaštonas;KIŠKUČIAI;9034859988;Taip;19;0;0;19
3533;Kaštonas;KIŠKUČIAI;9249007247;Taip;18;0;0;18
3534;Kaštonas;BITUTĖS;2898327157;Taip;9;0;0;9
3535;Kaštonas;BITUTĖS;1207372235;Ne;0;4;0;4
3536;Kaštonas;BITUTĖS;9298372326;Ne;9;5;0;14
3537;Kaštonas;BITUTĖS;4115242811;Taip;0;10;0;10
3538;Kaštonas;BITUTĖS;6896372095;Taip;0;2;0;2
3539;Kaštonas;BITUTĖS;1684641447;Taip;0;12;0;12
3540;Kaštonas;BITUTĖS;1761520786;Taip;8;0;0;8
3541;Kaštonas;BITUTĖS;8250964197;Taip;0;19;0;19
3542;Kaštonas;BITUTĖS;4095137806;Taip;5;0;0;5
3543;Kaštonas;BITUTĖS;9285927858;Taip;2;14;0;16
3544;Kaštonas;BITUTĖS;9903176616;Taip;3;1;0;4
3545;Kaštonas;BITUTĖS;8275673303;Taip;0;1;0;1
3546;Kaštonas;BITUTĖS;1614180834;Taip;0;0;1;1
3547;Kaštonas;BITUTĖS;2877124424;Taip;2;10;0;12
3548;Kaštonas;BITUTĖS;1031628633;Taip;5;2;0;7
3549;Kaštonas;BITUTĖS;4551111709;Taip;5;2;0;7
3550;Kaštonas;BITUTĖS;7291448857;Taip;0;2;0;2
3551;Kaštonas;BITUTĖS;4837002666;Taip;0;15;0;15
3552;Kaštonas;BITUTĖS;6175014441;Taip;0;14;0;14
3553;Kaštonas;BITUTĖS;1748975865;Taip;0;3;0;3
3554;Kaštonas;MEŠKIUKAI;2228759708;Taip;0;5;0;5
3555;Kaštonas;MEŠKIUKAI;6263544162;Taip;0;8;0;8
3556;Kaštonas;MEŠKIUKAI;8775608339;Taip;0;3;0;3
3557;Kaštonas;MEŠKIUKAI;6289073634;Taip;0;11;0;11
3558;Kaštonas;MEŠKIUKAI;4616084852;Ne;0;5;0;5
3559;Kaštonas;MEŠKIUKAI;5157500600;Taip;0;4;0;4
3560;Kaštonas;MEŠKIUKAI;6967725663;Taip;0;3;0;3
3561;Kaštonas;MEŠKIUKAI;4308169582;Taip;2;2;0;4
3562;Kaštonas;MEŠKIUKAI;6589898580;Taip;1;8;0;9
3563;Kaštonas;MEŠKIUKAI;4824511567;Taip;0;5;0;5
3564;Kaštonas;MEŠKIUKAI;3961661158;Taip;16;3;0;19
3565;Kaštonas;MEŠKIUKAI;8318869054;Taip;0;1;0;1
3566;Kaštonas;MEŠKIUKAI;2434765663;Taip;0;2;0;2
3567;Kaštonas;MEŠKIUKAI;4444087861;Taip;4;4;0;8
3568;Kaštonas;MEŠKIUKAI;9379171183;Taip;4;2;3;9
3569;Kaštonas;MEŠKIUKAI;9014726465;Taip;0;6;0;6
3570;Kaštonas;BORUŽĖLĖS;8637978949;Taip;5;0;0;5
3571;Kaštonas;BORUŽĖLĖS;6891429484;Taip;14;0;0;14
3572;Kaštonas;BORUŽĖLĖS;6442448667;Taip;0;2;0;2
3573;Kaštonas;BORUŽĖLĖS;2345742465;Taip;8;0;0;8
3574;Kaštonas;BORUŽĖLĖS;5060824071;Taip;0;4;0;4
3575;Kaštonas;BORUŽĖLĖS;3279850526;Taip;1;2;0;3
3576;Kaštonas;BORUŽĖLĖS;8151333699;Taip;14;0;0;14
3577;Kaštonas;BORUŽĖLĖS;4285107537;Ne;9;0;0;9
3578;Kaštonas;BORUŽĖLĖS;3153834010;Ne;9;0;0;9
3579;Kaštonas;BORUŽĖLĖS;3839816548;Taip;0;11;0;11
3580;Kaštonas;BORUŽĖLĖS;5329898590;Taip;6;0;0;6
3581;"Krivūlė (Lydos g. 5)";SPINDULIUKAI;1937803301;Taip;18;0;0;18
3582;"Krivūlė (Lydos g. 5)";SPINDULIUKAI;9865192795;Taip;0;0;1;1
3583;"Krivūlė (Lydos g. 5)";SPINDULIUKAI;3913058095;Taip;0;0;9;9
3584;"Krivūlė (Lydos g. 5)";SPINDULIUKAI;1840809151;Taip;0;0;2;2
3585;"Krivūlė (Lydos g. 5)";SPINDULIUKAI;7335245963;Taip;0;0;10;10
3586;"Krivūlė (Lydos g. 5)";SPINDULIUKAI;5802739148;Taip;0;2;4;6
3587;"Krivūlė (Lydos g. 5)";SPINDULIUKAI;5667934115;Taip;0;4;1;5
3588;"Krivūlė (Lydos g. 5)";SPINDULIUKAI;7155162698;Taip;0;4;0;4
3589;"Krivūlė (Lydos g. 5)";SPINDULIUKAI;1151179495;Taip;0;0;4;4
3590;"Krivūlė (Lydos g. 5)";SPINDULIUKAI;9320613086;Taip;1;0;6;7
3591;"Krivūlė (Lydos g. 5)";SPINDULIUKAI;4750075323;Taip;0;0;1;1
3592;"Krivūlė (Lydos g. 5)";SPINDULIUKAI;3852793979;Taip;10;3;0;13
3593;"Krivūlė (Lydos g. 5)";SPINDULIUKAI;3184820008;Taip;0;0;4;4
3594;"Krivūlė (Lydos g. 5)";SPINDULIUKAI;7149268223;Taip;0;0;9;9
3595;"Krivūlė (Lydos g. 5)";SPINDULIUKAI;4943482123;Taip;6;0;10;16
3596;"Krivūlė (Lydos g. 5)";SPINDULIUKAI;9815421737;Taip;0;0;5;5
3597;"Krivūlė (Lydos g. 5)";SPINDULIUKAI;4619224314;Taip;7;4;2;13
3598;"Krivūlė (Lydos g. 5)";BORUŽĖLĖS;3357889614;Taip;3;0;0;3
3599;"Krivūlė (Lydos g. 5)";BORUŽĖLĖS;8711082048;Taip;0;0;13;13
3600;"Krivūlė (Lydos g. 5)";BORUŽĖLĖS;2915437387;Taip;0;0;6;6
3601;"Krivūlė (Lydos g. 5)";BORUŽĖLĖS;8304613793;Taip;0;0;4;4
3602;"Krivūlė (Lydos g. 5)";BORUŽĖLĖS;3588408699;Taip;0;0;5;5
3603;"Krivūlė (Lydos g. 5)";BORUŽĖLĖS;7102769750;Taip;0;9;1;10
3604;"Krivūlė (Lydos g. 5)";BORUŽĖLĖS;6854278025;Taip;0;0;9;9
3605;"Krivūlė (Lydos g. 5)";BORUŽĖLĖS;4944001828;Taip;0;0;5;5
3606;"Krivūlė (Lydos g. 5)";BORUŽĖLĖS;2240949291;Taip;0;0;8;8
3607;"Krivūlė (Lydos g. 5)";BORUŽĖLĖS;3368847042;Taip;7;0;0;7
3608;"Krivūlė (Lydos g. 5)";BORUŽĖLĖS;3230340284;Taip;0;0;1;1
3609;"Krivūlė (Lydos g. 5)";BORUŽĖLĖS;6283777399;Taip;0;9;11;20
3610;"Krivūlė (Lydos g. 5)";BORUŽĖLĖS;4454327278;Taip;0;0;9;9
3611;"Krivūlė (Lydos g. 5)";DRUGELIŲ;6004925249;Taip;0;4;0;4
3612;"Krivūlė (Lydos g. 5)";DRUGELIŲ;5113297248;Taip;0;4;7;11
3613;"Krivūlė (Lydos g. 5)";DRUGELIŲ;9306686488;Taip;0;2;1;3
3614;"Krivūlė (Lydos g. 5)";DRUGELIŲ;5596874303;Taip;0;7;2;9
3615;"Krivūlė (Lydos g. 5)";DRUGELIŲ;4297876008;Taip;4;0;3;7
3616;"Krivūlė (Lydos g. 5)";DRUGELIŲ;2138125571;Taip;0;4;0;4
3617;"Krivūlė (Lydos g. 5)";DRUGELIŲ;2711010212;Taip;0;6;0;6
3618;"Krivūlė (Lydos g. 5)";DRUGELIŲ;7781918674;Taip;0;1;0;1
3619;"Krivūlė (Lydos g. 5)";DRUGELIŲ;3246787504;Taip;0;0;5;5
3620;"Krivūlė (Lydos g. 5)";DRUGELIŲ;5531566792;Taip;0;0;1;1
3621;"Krivūlė (Lydos g. 5)";DRUGELIŲ;1171226193;Taip;4;0;4;8
3622;"Krivūlė (Lydos g. 5)";DRUGELIŲ;5683183310;Taip;5;4;1;10
3623;"Krivūlė (Lydos g. 5)";DRUGELIŲ;1815336153;Taip;5;2;1;8
3624;"Krivūlė (Lydos g. 5)";"BITUTĖS (VALDOFRO)";3769812444;Taip;10;0;0;10
3625;"Krivūlė (Lydos g. 5)";"BITUTĖS (VALDOFRO)";5128760019;Taip;7;1;0;8
3626;"Krivūlė (Lydos g. 5)";"BITUTĖS (VALDOFRO)";2647149927;Taip;6;4;0;10
3627;"Krivūlė (Lydos g. 5)";"BITUTĖS (VALDOFRO)";9632352765;Taip;5;4;0;9
3628;"Krivūlė (Lydos g. 5)";"BITUTĖS (VALDOFRO)";7848471009;Taip;0;0;1;1
3629;"Krivūlė (Lydos g. 5)";"BITUTĖS (VALDOFRO)";8834855616;Taip;0;2;3;5
3630;"Krivūlė (Lydos g. 5)";"BITUTĖS (VALDOFRO)";3655576855;Taip;0;3;0;3
3631;"Krivūlė (Lydos g. 5)";"BITUTĖS (VALDOFRO)";1561180871;Taip;0;12;0;12
3632;"Krivūlė (Lydos g. 5)";"BITUTĖS (VALDOFRO)";9702372816;Taip;4;0;0;4
3633;"Krivūlė (Lydos g. 5)";"BITUTĖS (VALDOFRO)";8105688948;Taip;1;9;0;10
3634;"Krivūlė (Lydos g. 5)";"BITUTĖS (VALDOFRO)";1932209134;Taip;0;0;5;5
3635;"Krivūlė (Lydos g. 5)";"BITUTĖS (VALDOFRO)";7768827505;Taip;7;0;0;7
3636;"Krivūlė (Lydos g. 5)";"BITUTĖS (VALDOFRO)";7199431924;Taip;0;4;0;4
3637;"Krivūlė (Lydos g. 5)";"BITUTĖS (VALDOFRO)";7714519095;Taip;7;0;1;8
3638;"Krivūlė (Lydos g. 5)";"BITUTĖS (VALDOFRO)";9409899522;Taip;5;0;1;6
3639;"Krivūlė (Lydos g. 5)";"BITUTĖS (VALDOFRO)";8748668583;Taip;3;0;1;4
3640;"Krivūlė (Lydos g. 5)";"BITUTĖS (VALDOFRO)";6830712749;Taip;0;0;1;1
3641;"Krivūlė (Lydos g. 5)";"BITUTĖS (VALDOFRO)";5600651110;Taip;2;9;0;11
3642;"Krivūlė (Lydos g. 5)";"BITUTĖS (VALDOFRO)";8352493729;Taip;0;0;2;2
3643;"Krivūlė (Lydos g. 5)";"BITUTĖS (VALDOFRO)";9229817861;Taip;0;0;1;1
3644;"Krivūlė (Lydos g. 5)";"BITUTĖS (VALDOFRO)";9388352593;Taip;4;0;1;5
3645;"Krivūlė (Lydos g. 5)";EŽIUKAI;8042185027;Taip;4;0;1;5
3646;"Krivūlė (Lydos g. 5)";EŽIUKAI;5664892835;Taip;7;0;0;7
3647;"Krivūlė (Lydos g. 5)";EŽIUKAI;8399607572;Taip;7;0;0;7
3648;"Krivūlė (Lydos g. 5)";EŽIUKAI;5369083173;Taip;9;0;1;10
3649;"Krivūlė (Lydos g. 5)";EŽIUKAI;9051038248;Taip;23;0;0;23
3650;"Krivūlė (Lydos g. 5)";EŽIUKAI;3144577262;Taip;0;0;3;3
3651;"Krivūlė (Lydos g. 5)";EŽIUKAI;1898389557;Taip;0;0;6;6
3652;"Krivūlė (Lydos g. 5)";EŽIUKAI;2607716072;Taip;0;0;1;1
3653;"Krivūlė (Lydos g. 5)";EŽIUKAI;3836712448;Taip;0;0;1;1
3654;"Krivūlė (Lydos g. 5)";EŽIUKAI;8873132189;Taip;9;0;2;11
3655;"Krivūlė (Lydos g. 5)";EŽIUKAI;2430372719;Taip;0;4;0;4
3656;"Krivūlė (Lydos g. 5)";EŽIUKAI;1893542120;Taip;15;0;0;15
3657;"Krivūlė (Lydos g. 5)";EŽIUKAI;1622229289;Taip;0;1;7;8
3658;"Krivūlė (Lydos g. 5)";EŽIUKAI;2157856704;Taip;4;5;0;9
3659;"Krivūlė (Lydos g. 5)";EŽIUKAI;4547087565;Taip;0;0;2;2
3660;"Krivūlė (Lydos g. 5)";EŽIUKAI;1189206089;Taip;0;0;4;4
3661;"Krivūlė (Lydos g. 5)";EŽIUKAI;1125863541;Taip;0;0;2;2
3662;"Krivūlė (Lydos g. 5)";NYKŠTUKAI;9820383193;Taip;0;4;0;4
3663;"Krivūlė (Lydos g. 5)";NYKŠTUKAI;9401810791;Taip;7;0;0;7
3664;"Krivūlė (Lydos g. 5)";NYKŠTUKAI;8767554721;Taip;3;1;0;4
3665;"Krivūlė (Lydos g. 5)";NYKŠTUKAI;9529242858;Taip;5;0;1;6
3666;"Krivūlė (Lydos g. 5)";NYKŠTUKAI;8898023612;Taip;0;4;0;4
3667;"Krivūlė (Lydos g. 5)";NYKŠTUKAI;5768244312;Taip;0;3;0;3
3668;"Krivūlė (Lydos g. 5)";NYKŠTUKAI;7540940063;Taip;0;4;0;4
3669;"Krivūlė (Lydos g. 5)";NYKŠTUKAI;7262017017;Taip;2;4;0;6
3670;"Krivūlė (Lydos g. 5)";NYKŠTUKAI;6548893885;Taip;3;7;2;12
3671;"Krivūlė (Lydos g. 5)";NYKŠTUKAI;8674468359;Taip;0;0;8;8
3672;"Krivūlė (Lydos g. 5)";NYKŠTUKAI;8047735389;Taip;0;0;4;4
3673;"Krivūlė (Lydos g. 5)";NYKŠTUKAI;1374452129;Taip;0;0;2;2
3674;"Krivūlė (Lydos g. 5)";NYKŠTUKAI;6466188552;Taip;16;0;1;17
3675;"Kodėlčiukas (Laisvės pr. 59)";Saulutės;1725624698;Taip;3;1;0;4
3676;"Kodėlčiukas (Laisvės pr. 59)";Saulutės;7509476161;Taip;10;0;0;10
3677;"Kodėlčiukas (Laisvės pr. 59)";Saulutės;7327247516;Taip;6;1;0;7
3678;"Kodėlčiukas (Laisvės pr. 59)";Saulutės;1645680526;Taip;0;3;0;3
3679;"Kodėlčiukas (Laisvės pr. 59)";Saulutės;8992265000;Taip;0;0;4;4
3680;"Kodėlčiukas (Laisvės pr. 59)";Saulutės;6285018663;Taip;0;1;0;1
3681;"Kodėlčiukas (Laisvės pr. 59)";Saulutės;1033969800;Ne;3;1;0;4
3682;"Kodėlčiukas (Laisvės pr. 59)";Saulutės;2433094435;Ne;1;0;0;1
3683;"Kodėlčiukas (Laisvės pr. 59)";Saulutės;9042404309;Taip;2;3;0;5
3684;"Kodėlčiukas (Laisvės pr. 59)";Saulutės;7611485881;Taip;0;2;0;2
3685;"Kodėlčiukas (Laisvės pr. 59)";Saulutės;7561763602;Taip;0;1;0;1
3686;"Kodėlčiukas (Laisvės pr. 59)";Saulutės;2289687766;Taip;3;0;0;3
3687;"Kodėlčiukas (Laisvės pr. 59)";Saulutės;1992569595;Ne;9;4;1;14
3688;"Kodėlčiukas (Laisvės pr. 59)";Saulutės;9527296531;Taip;0;3;5;8
3689;"Kodėlčiukas (Laisvės pr. 59)";Saulutės;8070400563;Taip;0;8;0;8
3690;"Kodėlčiukas (Laisvės pr. 59)";Saulutės;2542104903;Taip;4;2;0;6
3691;"Kodėlčiukas (Laisvės pr. 59)";Saulutės;2162480212;Taip;1;2;0;3
3692;"Kodėlčiukas (Laisvės pr. 59)";Nežiniukai;4896921433;Taip;5;0;0;5
3693;"Kodėlčiukas (Laisvės pr. 59)";Nežiniukai;9226992006;Taip;0;0;1;1
3694;"Kodėlčiukas (Laisvės pr. 59)";Nežiniukai;9404369378;Taip;5;0;1;6
3695;"Kodėlčiukas (Laisvės pr. 59)";Nežiniukai;2301454083;Taip;2;0;0;2
3696;"Kodėlčiukas (Laisvės pr. 59)";Nežiniukai;6041087039;Taip;7;0;2;9
3697;"Kodėlčiukas (Laisvės pr. 59)";Nežiniukai;8439867734;Taip;0;0;1;1
3698;"Kodėlčiukas (Laisvės pr. 59)";Nežiniukai;8734412840;Taip;5;0;0;5
3699;"Kodėlčiukas (Laisvės pr. 59)";Nežiniukai;3060543464;Taip;2;0;0;2
3700;"Kodėlčiukas (Laisvės pr. 59)";Nežiniukai;8475052982;Ne;0;0;1;1
3701;"Kodėlčiukas (Laisvės pr. 59)";Nežiniukai;6631435446;Taip;14;0;0;14
3702;"Kodėlčiukas (Laisvės pr. 59)";Nežiniukai;7167508091;Taip;1;0;0;1
3703;"Kodėlčiukas (Laisvės pr. 59)";Nežiniukai;2350656752;Taip;0;2;0;2
3704;"Kodėlčiukas (Laisvės pr. 59)";Nežiniukai;8644416746;Taip;5;0;9;14
3705;"Kodėlčiukas (Laisvės pr. 59)";Nežiniukai;6164851553;Taip;0;0;2;2
3706;"Kodėlčiukas (Laisvės pr. 59)";Nežiniukai;8435298904;Taip;8;1;1;10
3707;"Kodėlčiukas (Laisvės pr. 59)";Gintarėliai;5891546827;Taip;5;0;1;6
3708;"Kodėlčiukas (Laisvės pr. 59)";Gintarėliai;6409157827;Taip;5;0;0;5
3709;"Kodėlčiukas (Laisvės pr. 59)";Gintarėliai;8101197864;Taip;0;6;0;6
3710;"Kodėlčiukas (Laisvės pr. 59)";Gintarėliai;2543628770;Taip;6;0;0;6
3711;"Kodėlčiukas (Laisvės pr. 59)";Gintarėliai;8911944991;Taip;11;0;2;13
3712;"Kodėlčiukas (Laisvės pr. 59)";Gintarėliai;6670171992;Taip;3;1;0;4
3713;"Kodėlčiukas (Laisvės pr. 59)";Gintarėliai;2465920649;Taip;6;0;0;6
3714;"Kodėlčiukas (Laisvės pr. 59)";Gintarėliai;8348024909;Taip;6;0;0;6
3715;"Kodėlčiukas (Laisvės pr. 59)";Gintarėliai;4293763647;Taip;0;0;2;2
3716;"Kodėlčiukas (Laisvės pr. 59)";Gintarėliai;3878358193;Taip;0;0;1;1
3717;"Kodėlčiukas (Laisvės pr. 59)";Gintarėliai;6935233288;Taip;20;0;0;20
3718;"Kodėlčiukas (Laisvės pr. 59)";Gintarėliai;1835522972;Taip;2;0;0;2
3719;"Kodėlčiukas (Laisvės pr. 59)";Gintarėliai;5541555127;Taip;7;0;0;7
3720;"Kodėlčiukas (Laisvės pr. 59)";Gintarėliai;8759498015;Taip;6;0;0;6
3721;"Kodėlčiukas (Laisvės pr. 59)";Gintarėliai;4986413731;Taip;7;0;0;7
3722;"Kodėlčiukas (Laisvės pr. 59)";Gintarėliai;2802895479;Taip;0;7;0;7
3723;"Kodėlčiukas (Laisvės pr. 59)";Gintarėliai;9914565606;Taip;8;3;0;11
3724;"Kodėlčiukas (Laisvės pr. 59)";Gintarėliai;7686420784;Taip;9;1;0;10
3725;"Kodėlčiukas (Laisvės pr. 59)";Gintarėliai;3037267215;Taip;10;0;0;10
3726;"Kodėlčiukas (Laisvės pr. 59)";Šnekučiai;6761903865;Ne;0;1;0;1
3727;"Kodėlčiukas (Laisvės pr. 59)";Šnekučiai;3778271049;Taip;6;4;0;10
3728;"Kodėlčiukas (Laisvės pr. 59)";Šnekučiai;7510273691;Taip;0;2;0;2
3729;"Kodėlčiukas (Laisvės pr. 59)";Šnekučiai;5075801618;Taip;0;4;3;7
3730;"Kodėlčiukas (Laisvės pr. 59)";Šnekučiai;4490196764;Taip;0;1;0;1
3731;"Kodėlčiukas (Laisvės pr. 59)";Šnekučiai;5952121209;Taip;3;7;0;10
3732;"Kodėlčiukas (Laisvės pr. 59)";Šnekučiai;9208137169;Ne;0;3;0;3
3733;"Kodėlčiukas (Laisvės pr. 59)";Šnekučiai;5876187643;Taip;5;4;0;9
3734;"Kodėlčiukas (Laisvės pr. 59)";Šnekučiai;4866089623;Taip;5;2;0;7
3735;"Kodėlčiukas (Laisvės pr. 59)";Šnekučiai;1206798597;Taip;0;1;5;6
3736;"Kodėlčiukas (Laisvės pr. 59)";Šnekučiai;9169500252;Taip;0;4;0;4
3737;"Kodėlčiukas (Laisvės pr. 59)";Šnekučiai;4941186694;Taip;7;5;0;12
3738;"Kodėlčiukas (Laisvės pr. 59)";Šnekučiai;9109362006;Taip;0;3;0;3
3739;"Kodėlčiukas (Laisvės pr. 59)";Šnekučiai;9724373368;Taip;6;8;0;14
3740;"Kodėlčiukas (Laisvės pr. 59)";Šnekučiai;2819860331;Taip;6;0;0;6
3741;"Kodėlčiukas (Laisvės pr. 59)";Šnekučiai;9252478832;Taip;3;0;0;3
3742;"Kodėlčiukas (Laisvės pr. 59)";Šnekučiai;3403889915;Taip;0;3;0;3
3743;"Kodėlčiukas (Laisvės pr. 59)";Šnekučiai;4230906452;Taip;7;0;1;8
3744;"Kodėlčiukas (Laisvės pr. 59)";Pabiručiai;9278139998;Taip;7;0;0;7
3745;"Kodėlčiukas (Laisvės pr. 59)";Pabiručiai;6008027505;Taip;0;3;0;3
3746;"Kodėlčiukas (Laisvės pr. 59)";Pabiručiai;5894631257;Ne;3;0;0;3
3747;"Kodėlčiukas (Laisvės pr. 59)";Pabiručiai;6065858518;Taip;4;1;0;5
3748;"Kodėlčiukas (Laisvės pr. 59)";Pabiručiai;8586746296;Taip;0;1;0;1
3749;"Kodėlčiukas (Laisvės pr. 59)";Pabiručiai;9480926599;Taip;5;4;0;9
3750;"Kodėlčiukas (Laisvės pr. 59)";Pabiručiai;7246943802;Taip;0;14;2;16
3751;"Kodėlčiukas (Laisvės pr. 59)";Pabiručiai;8189938439;Taip;3;4;0;7
3752;"Kodėlčiukas (Laisvės pr. 59)";Pabiručiai;5587200800;Taip;9;0;1;10
3753;"Kodėlčiukas (Laisvės pr. 59)";Pabiručiai;1433623973;Taip;10;0;0;10
3754;"Kodėlčiukas (Laisvės pr. 59)";Pabiručiai;1087808091;Ne;9;3;0;12
3755;"Kodėlčiukas (Laisvės pr. 59)";Pabiručiai;7570122834;Taip;0;4;0;4
3756;"Kodėlčiukas (Laisvės pr. 59)";Pabiručiai;5801430256;Taip;4;5;0;9
3757;"Kodėlčiukas (Laisvės pr. 59)";Pabiručiai;7455949617;Taip;7;0;2;9
3758;"Kodėlčiukas (Laisvės pr. 59)";Pabiručiai;1039982141;Taip;2;0;0;2
3759;"Kodėlčiukas (Laisvės pr. 59)";Pabiručiai;4507928289;Taip;5;0;0;5
3760;"Kodėlčiukas (Laisvės pr. 59)";Pabiručiai;9830842598;Ne;0;0;3;3
3761;"Kodėlčiukas (Laisvės pr. 59)";Pabiručiai;8291672306;Taip;0;10;1;11
3762;"Kodėlčiukas (Laisvės pr. 59)";Pabiručiai;3882838712;Taip;3;3;0;6
3763;"Kodėlčiukas (Laisvės pr. 59)";Pabiručiai;8635107742;Taip;0;0;2;2
3764;"Kodėlčiukas (Laisvės pr. 59)";Pabiručiai;5064526349;Taip;9;1;0;10
3765;"Kodėlčiukas (Laisvės pr. 59)";Smalsučiai;6950802941;Taip;9;4;0;13
3766;"Kodėlčiukas (Laisvės pr. 59)";Smalsučiai;6045564826;Taip;5;0;0;5
3767;"Kodėlčiukas (Laisvės pr. 59)";Smalsučiai;7136890681;Taip;5;0;0;5
3768;"Kodėlčiukas (Laisvės pr. 59)";Smalsučiai;7971932716;Taip;6;0;0;6
3769;"Kodėlčiukas (Laisvės pr. 59)";Smalsučiai;7282579315;Taip;0;0;1;1
3770;"Kodėlčiukas (Laisvės pr. 59)";Smalsučiai;6905424567;Taip;0;1;0;1
3771;"Kodėlčiukas (Laisvės pr. 59)";Smalsučiai;5443377251;Taip;0;2;0;2
3772;"Kodėlčiukas (Laisvės pr. 59)";Smalsučiai;6074758814;Ne;0;5;0;5
3773;"Kodėlčiukas (Laisvės pr. 59)";Smalsučiai;3150006441;Taip;0;0;1;1
3774;"Kodėlčiukas (Laisvės pr. 59)";Smalsučiai;1302383608;Taip;9;0;1;10
3775;"Kodėlčiukas (Laisvės pr. 59)";Smalsučiai;7626940433;Taip;0;0;1;1
3776;"Kodėlčiukas (Laisvės pr. 59)";Smalsučiai;5729391456;Taip;7;2;1;10
3777;"Kodėlčiukas (Laisvės pr. 59)";Smalsučiai;7286497455;Taip;0;0;1;1
3778;"Kodėlčiukas (Laisvės pr. 59)";Smalsučiai;1699358514;Ne;7;4;0;11
3779;"Kodėlčiukas (Laisvės pr. 59)";Smalsučiai;3473981974;Taip;0;1;1;2
3780;"Kodėlčiukas (Laisvės pr. 59)";Smalsučiai;4038168647;Taip;0;6;0;6
3781;"Kodėlčiukas (Laisvės pr. 59)";Smalsučiai;6000831611;Taip;0;4;1;5
3782;"Kodėlčiukas (Laisvės pr. 59)";Smalsučiai;1160612316;Taip;9;2;0;11
3783;"Kodėlčiukas (Laisvės pr. 59)";Smalsučiai;3470151604;Taip;0;4;1;5
3784;"Kodėlčiukas (Laisvės pr. 59)";Smalsučiai;5921714669;Taip;5;3;0;8
3785;"Kodėlčiukas (Laisvės pr. 59)";Smalsučiai;6764015170;Taip;4;7;0;11
3786;"Kodėlčiukas (Laisvės pr. 59)";Giliukai;9754425363;Ne;2;1;0;3
3787;"Kodėlčiukas (Laisvės pr. 59)";Giliukai;5587782917;Taip;5;0;0;5
3788;"Kodėlčiukas (Laisvės pr. 59)";Giliukai;8100861190;Taip;6;1;0;7
3789;"Kodėlčiukas (Laisvės pr. 59)";Giliukai;7639341503;Taip;5;1;0;6
3790;"Kodėlčiukas (Laisvės pr. 59)";Giliukai;8017465692;Taip;0;9;0;9
3791;"Kodėlčiukas (Laisvės pr. 59)";Giliukai;7937365710;Taip;6;0;1;7
3792;"Kodėlčiukas (Laisvės pr. 59)";Giliukai;1937181137;Taip;9;0;0;9
3793;"Kodėlčiukas (Laisvės pr. 59)";Giliukai;9733831323;Taip;5;0;2;7
3794;"Kodėlčiukas (Laisvės pr. 59)";Giliukai;7007386353;Taip;0;3;0;3
3795;"Kodėlčiukas (Laisvės pr. 59)";Giliukai;9721353724;Taip;7;0;0;7
3796;"Kodėlčiukas (Laisvės pr. 59)";Giliukai;5573845415;Taip;4;0;0;4
3797;"Kodėlčiukas (Laisvės pr. 59)";Giliukai;2122779530;Taip;4;5;0;9
3798;"Kodėlčiukas (Laisvės pr. 59)";Giliukai;8785157050;Taip;10;10;0;20
3799;"Kodėlčiukas (Laisvės pr. 59)";Giliukai;5770748359;Taip;0;1;0;1
3800;"Kodėlčiukas (Laisvės pr. 59)";Giliukai;6643473339;Taip;0;6;0;6
3801;"Kodėlčiukas (Laisvės pr. 59)";Giliukai;3130715310;Taip;9;2;0;11
3802;"Kodėlčiukas (Laisvės pr. 59)";Giliukai;3686259290;Taip;2;0;1;3
3803;"Kodėlčiukas (Laisvės pr. 59)";Giliukai;2928885561;Taip;11;0;0;11
3804;"Kodėlčiukas (Laisvės pr. 59)";Giliukai;5909222351;Taip;19;0;0;19
3805;"Kodėlčiukas (Laisvės pr. 59)";Gudručiai;1191430672;Taip;2;0;0;2
3806;"Kodėlčiukas (Laisvės pr. 59)";Gudručiai;6988515253;Taip;4;5;0;9
3807;"Kodėlčiukas (Laisvės pr. 59)";Gudručiai;3385551650;Taip;5;0;0;5
3808;"Kodėlčiukas (Laisvės pr. 59)";Gudručiai;7318908956;Taip;4;3;0;7
3809;"Kodėlčiukas (Laisvės pr. 59)";Gudručiai;9865803714;Taip;1;0;0;1
3810;"Kodėlčiukas (Laisvės pr. 59)";Gudručiai;7430239198;Taip;0;3;4;7
3811;"Kodėlčiukas (Laisvės pr. 59)";Gudručiai;8400610717;Taip;0;0;2;2
3812;"Kodėlčiukas (Laisvės pr. 59)";Gudručiai;7116594055;Taip;0;0;3;3
3813;"Kodėlčiukas (Laisvės pr. 59)";Gudručiai;1801366890;Taip;0;0;1;1
3814;"Kodėlčiukas (Laisvės pr. 59)";Gudručiai;9483378853;Taip;0;3;0;3
3815;"Kodėlčiukas (Laisvės pr. 59)";Gudručiai;8890987483;Taip;0;1;0;1
3816;"Kodėlčiukas (Laisvės pr. 59)";Gudručiai;4687333060;Taip;0;3;0;3
3817;"Kodėlčiukas (Laisvės pr. 59)";Gudručiai;1491160730;Taip;0;1;0;1
3818;"Kodėlčiukas (Laisvės pr. 59)";Gudručiai;4543838852;Taip;0;1;0;1
3819;"Kodėlčiukas (Laisvės pr. 59)";Gudručiai;2216791610;Taip;0;1;1;2
3820;"Kodėlčiukas (Laisvės pr. 59)";Gudručiai;2987907651;Taip;0;4;1;5
3821;"Kodėlčiukas (Laisvės pr. 59)";Gudručiai;1588132166;Taip;0;4;0;4
3822;"Kodėlčiukas (Laisvės pr. 59)";Gudručiai;6014084915;Taip;0;5;1;6
3823;"Kodėlčiukas (Laisvės pr. 59)";Gudručiai;3068084704;Taip;0;4;1;5
3824;"Kodėlčiukas (Laisvės pr. 59)";Gudručiai;3427610168;Taip;0;0;1;1
3825;"Kodėlčiukas (Laisvės pr. 59)";Žirniukai;2402290604;Taip;8;0;0;8
3826;"Kodėlčiukas (Laisvės pr. 59)";Žirniukai;6522019070;Taip;9;0;0;9
3827;"Kodėlčiukas (Laisvės pr. 59)";Žirniukai;1050905569;Taip;0;1;0;1
3828;"Kodėlčiukas (Laisvės pr. 59)";Žirniukai;3053949510;Taip;6;0;1;7
3829;"Kodėlčiukas (Laisvės pr. 59)";Žirniukai;5325660102;Taip;0;4;0;4
3830;"Kodėlčiukas (Laisvės pr. 59)";Žirniukai;8429572505;Taip;0;0;2;2
3831;"Kodėlčiukas (Laisvės pr. 59)";Žirniukai;4321485862;Taip;7;0;0;7
3832;"Kodėlčiukas (Laisvės pr. 59)";Žirniukai;1550287298;Taip;0;1;0;1
3833;"Kodėlčiukas (Laisvės pr. 59)";Žirniukai;4341694264;Taip;5;9;0;14
3834;"Kodėlčiukas (Laisvės pr. 59)";Žirniukai;4597473929;Taip;10;0;0;10
3835;"Kodėlčiukas (Laisvės pr. 59)";Žirniukai;9702236745;Taip;5;5;0;10
3836;"Kodėlčiukas (Laisvės pr. 59)";Žirniukai;7189930025;Taip;0;4;0;4
3837;"Kodėlčiukas (Laisvės pr. 59)";Žirniukai;2002468844;Taip;0;0;1;1
3838;"Kodėlčiukas (Laisvės pr. 59)";Žirniukai;4530733149;Taip;4;0;0;4
3839;"Kodėlčiukas (Laisvės pr. 59)";Katinėliai;4730433849;Taip;11;0;2;13
3840;"Kodėlčiukas (Laisvės pr. 59)";Katinėliai;4995538090;Ne;5;0;0;5
3841;"Kodėlčiukas (Laisvės pr. 59)";Katinėliai;8045906704;Taip;1;0;0;1
3842;"Kodėlčiukas (Laisvės pr. 59)";Katinėliai;6576466300;Taip;5;0;0;5
3843;"Kodėlčiukas (Laisvės pr. 59)";Katinėliai;5650077893;Taip;0;0;1;1
3844;"Kodėlčiukas (Laisvės pr. 59)";Katinėliai;3239314295;Taip;9;0;0;9
3845;"Kodėlčiukas (Laisvės pr. 59)";Katinėliai;9221561862;Taip;7;0;0;7
3846;"Kodėlčiukas (Laisvės pr. 59)";Katinėliai;6355536268;Taip;0;0;2;2
3847;"Kodėlčiukas (Laisvės pr. 59)";Katinėliai;2147517344;Taip;0;11;0;11
3848;"Kodėlčiukas (Laisvės pr. 59)";Katinėliai;2119041584;Taip;13;0;0;13
3849;"Kodėlčiukas (Laisvės pr. 59)";Katinėliai;9826174805;Taip;0;0;3;3
3850;"Kodėlčiukas (Laisvės pr. 59)";Katinėliai;1570599010;Taip;12;5;0;17
3851;"Kodėlčiukas (Laisvės pr. 59)";Katinėliai;9670055064;Taip;0;1;0;1
3852;"Kodėlčiukas (Laisvės pr. 59)";Katinėliai;4727546035;Taip;4;0;5;9
3853;"Kodėlčiukas (Laisvės pr. 59)";Katinėliai;6011097577;Taip;11;0;0;11
3854;"Kodėlčiukas (Laisvės pr. 59)";Katinėliai;6334889816;Taip;18;0;0;18
3855;"Kodėlčiukas (Laisvės pr. 59)";Katinėliai;6135628975;Taip;18;0;0;18
3856;"Kodėlčiukas (Laisvės pr. 59)";Katinėliai;4028114251;Taip;17;0;0;17
3857;"Kodėlčiukas (Laisvės pr. 59)";Nykštukai;2722591942;Taip;0;3;0;3
3858;"Kodėlčiukas (Laisvės pr. 59)";Nykštukai;5719244938;Taip;14;0;0;14
3859;"Kodėlčiukas (Laisvės pr. 59)";Nykštukai;4643616472;Taip;5;0;0;5
3860;"Kodėlčiukas (Laisvės pr. 59)";Nykštukai;6498584861;Taip;3;4;1;8
3861;"Kodėlčiukas (Laisvės pr. 59)";Nykštukai;8324804944;Taip;6;0;0;6
3862;"Kodėlčiukas (Laisvės pr. 59)";Nykštukai;1776582488;Taip;1;1;1;3
3863;"Kodėlčiukas (Laisvės pr. 59)";Nykštukai;2394070354;Taip;6;0;0;6
3864;"Kodėlčiukas (Laisvės pr. 59)";Nykštukai;3018381817;Taip;17;0;0;17
3865;"Kodėlčiukas (Laisvės pr. 59)";Nykštukai;9330345860;Taip;7;4;0;11
3866;"Kodėlčiukas (Laisvės pr. 59)";Nykštukai;9645711345;Taip;4;0;1;5
3867;"Kodėlčiukas (Laisvės pr. 59)";Nykštukai;3663726193;Taip;4;0;0;4
3868;"Kodėlčiukas (Laisvės pr. 59)";Nykštukai;3509994698;Taip;13;0;0;13
3869;"Kodėlčiukas (Laisvės pr. 59)";Nykštukai;3737512833;Taip;6;0;0;6
3870;"Kodėlčiukas (Laisvės pr. 59)";Nykštukai;8399334364;Taip;15;0;0;15
3871;"Kodėlčiukas (Laisvės pr. 59)";Nykštukai;1498607108;Taip;3;0;0;3
3872;"Kodėlčiukas (Laisvės pr. 59)";Nykštukai;7963235116;Taip;7;0;1;8
3873;"Kodėlčiukas (Laisvės pr. 59)";ŽIOGELIAI;8769409404;Taip;1;0;0;1
3874;"Kodėlčiukas (Laisvės pr. 59)";ŽIOGELIAI;5189091564;Taip;1;0;0;1
3875;"Kodėlčiukas (Laisvės pr. 59)";ŽIOGELIAI;9055399463;Taip;4;0;4;8
3876;"Kodėlčiukas (Laisvės pr. 59)";ŽIOGELIAI;2081199093;Taip;23;0;0;23
3877;"Kodėlčiukas (Laisvės pr. 59)";ŽIOGELIAI;5115939251;Taip;0;0;4;4
3878;"Kodėlčiukas (Laisvės pr. 59)";ŽIOGELIAI;3603781385;Taip;7;0;7;14
3879;"Kodėlčiukas (Laisvės pr. 59)";ŽIOGELIAI;6749972956;Taip;13;0;0;13
3880;"Kodėlčiukas (Laisvės pr. 59)";ŽIOGELIAI;7497358286;Taip;7;1;3;11
3881;"Kodėlčiukas (Laisvės pr. 59)";ŽIOGELIAI;2990546939;Taip;7;0;1;8
3882;"Kodėlčiukas (Laisvės pr. 59)";ŽIOGELIAI;4089558399;Taip;7;0;0;7
3883;"Kodėlčiukas (Laisvės pr. 59)";ŽIOGELIAI;6843492891;Taip;7;0;0;7
3884;"Kodėlčiukas (Laisvės pr. 59)";ŽIOGELIAI;2933909503;Taip;13;0;0;13
3885;"Kodėlčiukas (Laisvės pr. 59)";ŽIOGELIAI;4969181023;Taip;7;0;0;7
3886;"Kodėlčiukas (Laisvės pr. 59)";BITUTĖS;9844479346;Taip;20;0;0;20
3887;"Kodėlčiukas (Laisvės pr. 59)";BITUTĖS;7251390043;Taip;4;0;1;5
3888;"Kodėlčiukas (Laisvės pr. 59)";BITUTĖS;6800848383;Taip;1;0;0;1
3889;"Kodėlčiukas (Laisvės pr. 59)";BITUTĖS;5023273477;Taip;5;0;0;5
3890;"Kodėlčiukas (Laisvės pr. 59)";BITUTĖS;3970337050;Taip;8;3;0;11
3891;"Kodėlčiukas (Laisvės pr. 59)";BITUTĖS;7539430546;Taip;12;0;0;12
3892;"Kodėlčiukas (Laisvės pr. 59)";BITUTĖS;6436603293;Taip;23;0;0;23
3893;"Kodėlčiukas (Laisvės pr. 59)";BITUTĖS;7148837596;Taip;10;0;0;10
3894;"Kodėlčiukas (Laisvės pr. 59)";BITUTĖS;5474194439;Ne;3;0;0;3
3895;"Kodėlčiukas (Laisvės pr. 59)";BITUTĖS;2272657477;Taip;1;0;0;1
3896;"Kodėlčiukas (Laisvės pr. 59)";VYŠNIUKAI;7705057116;Taip;0;1;0;1
3897;"Kodėlčiukas (Laisvės pr. 59)";VYŠNIUKAI;7643398934;Taip;0;4;1;5
3898;"Kodėlčiukas (Laisvės pr. 59)";VYŠNIUKAI;8799798070;Taip;0;0;1;1
3899;"Kodėlčiukas (Laisvės pr. 59)";VYŠNIUKAI;7119815662;Taip;11;1;0;12
3900;"Kodėlčiukas (Laisvės pr. 59)";VYŠNIUKAI;9398732476;Taip;15;0;1;16
3901;"Kodėlčiukas (Laisvės pr. 59)";VYŠNIUKAI;2720748563;Taip;7;0;0;7
3902;"Kodėlčiukas (Laisvės pr. 59)";VYŠNIUKAI;2871111867;Taip;0;0;1;1
3903;"Kodėlčiukas (Laisvės pr. 59)";VYŠNIUKAI;9914322177;Taip;3;0;0;3
3904;"Kodėlčiukas (Laisvės pr. 59)";VYŠNIUKAI;1925590099;Taip;0;2;1;3
3905;"Kodėlčiukas (Laisvės pr. 59)";VYŠNIUKAI;2298734536;Taip;0;2;0;2
3906;"Kodėlčiukas (Laisvės pr. 59)";VYŠNIUKAI;6261333618;Taip;0;2;0;2
3907;"Kodėlčiukas (Laisvės pr. 59)";VYŠNIUKAI;2549153581;Taip;19;4;0;23
3908;"Kodėlčiukas (Laisvės pr. 59)";VYŠNIUKAI;1808211253;Taip;0;2;0;2
3909;"Kodėlčiukas (Laisvės pr. 59)";VYŠNIUKAI;5178305435;Taip;1;0;1;2
3910;"Kodėlčiukas (Laisvės pr. 59)";VYŠNIUKAI;4782931414;Taip;0;3;0;3
3911;"Kodėlčiukas (Laisvės pr. 59)";VYŠNIUKAI;1803320085;Taip;1;0;2;3
3912;"Kodėlčiukas (Laisvės pr. 59)";VYŠNIUKAI;3938536446;Taip;0;0;5;5
3913;"Kodėlčiukas (Laisvės pr. 59)";BORUŽĖLĖS;2340866110;Taip;2;0;2;4
3914;"Kodėlčiukas (Laisvės pr. 59)";BORUŽĖLĖS;6726383331;Ne;0;4;0;4
3915;"Kodėlčiukas (Laisvės pr. 59)";BORUŽĖLĖS;1568628843;Taip;0;8;0;8
3916;"Kodėlčiukas (Laisvės pr. 59)";BORUŽĖLĖS;2438891967;Taip;2;0;0;2
3917;"Kodėlčiukas (Laisvės pr. 59)";BORUŽĖLĖS;8037386529;Taip;1;0;0;1
3918;"Kodėlčiukas (Laisvės pr. 59)";BORUŽĖLĖS;8829986201;Taip;0;4;0;4
3919;"Kodėlčiukas (Laisvės pr. 59)";BORUŽĖLĖS;4529565626;Taip;9;0;0;9
3920;"Kodėlčiukas (Laisvės pr. 59)";BORUŽĖLĖS;9020265248;Taip;2;0;1;3
3921;"Kodėlčiukas (Laisvės pr. 59)";BORUŽĖLĖS;9209671311;Ne;1;0;0;1
3922;"Kodėlčiukas (Laisvės pr. 59)";BORUŽĖLĖS;9736751250;Taip;3;3;1;7
3923;"Kodėlčiukas (Laisvės pr. 59)";BORUŽĖLĖS;7227149646;Taip;6;0;0;6
3924;"Kodėlčiukas (Laisvės pr. 59)";BORUŽĖLĖS;1197049907;Ne;1;0;0;1
3925;"Kodėlčiukas (Laisvės pr. 59)";BORUŽĖLĖS;3985455729;Taip;0;12;0;12
3926;"Kodėlčiukas (Laisvės pr. 59)";BORUŽĖLĖS;5068611716;Taip;3;0;0;3
3927;"Kodėlčiukas (Laisvės pr. 59)";BORUŽĖLĖS;7910205296;Taip;2;4;2;8
3928;"Kodėlčiukas (Laisvės pr. 59)";BORUŽĖLĖS;1047209628;Taip;6;0;3;9
3929;"Kodėlčiukas (Laisvės pr. 59)";VYTURĖLIAI;6714818379;Taip;0;4;0;4
3930;"Kodėlčiukas (Laisvės pr. 59)";VYTURĖLIAI;4218096561;Taip;5;6;0;11
3931;"Kodėlčiukas (Laisvės pr. 59)";VYTURĖLIAI;4514764005;Taip;4;4;0;8
3932;"Kodėlčiukas (Laisvės pr. 59)";VYTURĖLIAI;2169307879;Taip;17;0;0;17
3933;"Kodėlčiukas (Laisvės pr. 59)";VYTURĖLIAI;4585226357;Taip;4;0;0;4
3934;"Kodėlčiukas (Laisvės pr. 59)";VYTURĖLIAI;8263945732;Taip;8;0;0;8
3935;"Kodėlčiukas (Laisvės pr. 59)";VYTURĖLIAI;7612531087;Taip;7;0;0;7
3936;"Kodėlčiukas (Laisvės pr. 59)";VYTURĖLIAI;2904858964;Taip;8;4;0;12
3937;"Kodėlčiukas (Laisvės pr. 59)";VYTURĖLIAI;3413659259;Taip;4;0;0;4
3938;"Kodėlčiukas (Laisvės pr. 59)";VYTURĖLIAI;9673271313;Taip;1;0;0;1
3939;"Kodėlčiukas (Laisvės pr. 59)";VYTURĖLIAI;5710301153;Taip;11;0;1;12
3940;"Kodėlčiukas (Laisvės pr. 59)";VYTURĖLIAI;1746835627;Taip;1;0;0;1
3941;"Kodėlčiukas (Laisvės pr. 59)";VYTURĖLIAI;5474125905;Taip;6;4;0;10
3942;"Kodėlčiukas (Laisvės pr. 59)";VYTURĖLIAI;2298099102;Taip;14;0;0;14
3943;"Kodėlčiukas (Laisvės pr. 59)";VYTURĖLIAI;5181211722;Taip;9;0;0;9
3944;"Kodėlčiukas (Laisvės pr. 59)";VYTURĖLIAI;3472862544;Taip;6;0;0;6
3945;"Kodėlčiukas (Laisvės pr. 59)";VYTURĖLIAI;6476445296;Taip;7;1;0;8
3946;"Kodėlčiukas (Laisvės pr. 59)";DRUGELIAI;4165123345;Taip;0;0;1;1
3947;"Kodėlčiukas (Laisvės pr. 59)";DRUGELIAI;1149682376;Taip;0;5;0;5
3948;"Kodėlčiukas (Laisvės pr. 59)";DRUGELIAI;7587203481;Taip;0;3;1;4
3949;"Kodėlčiukas (Laisvės pr. 59)";DRUGELIAI;2353960861;Taip;4;4;0;8
3950;"Kodėlčiukas (Laisvės pr. 59)";DRUGELIAI;5505788210;Taip;2;0;0;2
3951;"Kodėlčiukas (Laisvės pr. 59)";DRUGELIAI;5577154148;Taip;0;2;0;2
3952;"Kodėlčiukas (Laisvės pr. 59)";DRUGELIAI;8547039654;Taip;4;0;2;6
3953;"Kodėlčiukas (Laisvės pr. 59)";DRUGELIAI;4202423480;Taip;0;0;2;2
3954;"Kodėlčiukas (Laisvės pr. 59)";DRUGELIAI;9979034031;Taip;3;5;0;8
3955;"Kodėlčiukas (Laisvės pr. 59)";DRUGELIAI;3240221130;Ne;0;5;0;5
3956;"Kodėlčiukas (Laisvės pr. 59)";DRUGELIAI;9139424911;Taip;2;0;0;2
3957;"Kodėlčiukas (Laisvės pr. 59)";DRUGELIAI;9664432781;Taip;0;8;1;9
3958;"Kodėlčiukas (Laisvės pr. 59)";DRUGELIAI;5197946954;Taip;2;11;0;13
3959;"Kodėlčiukas (Laisvės pr. 59)";DRUGELIAI;3651073383;Taip;0;0;1;1
3960;"Kodėlčiukas (Laisvės pr. 59)";DRUGELIAI;3854719881;Taip;0;8;0;8
3961;"Kodėlčiukas (Laisvės pr. 59)";DRUGELIAI;1889809198;Taip;0;0;1;1
3962;"Kodėlčiukas (Laisvės pr. 59)";DRUGELIAI;8315176054;Taip;0;3;0;3
3963;"Kodėlčiukas (Laisvės pr. 59)";DRUGELIAI;7908217415;Taip;5;0;1;6
3964;"Kodėlčiukas (Laisvės pr. 59)";OBUOLIUKAI;1289342844;Taip;5;4;0;9
3965;"Kodėlčiukas (Laisvės pr. 59)";OBUOLIUKAI;7318196860;Taip;0;7;0;7
3966;"Kodėlčiukas (Laisvės pr. 59)";OBUOLIUKAI;8208448849;Taip;8;0;0;8
3967;"Kodėlčiukas (Laisvės pr. 59)";OBUOLIUKAI;1683506414;Taip;4;0;1;5
3968;"Kodėlčiukas (Laisvės pr. 59)";OBUOLIUKAI;3315862631;Taip;0;4;0;4
3969;"Kodėlčiukas (Laisvės pr. 59)";OBUOLIUKAI;3168418461;Taip;17;2;0;19
3970;"Kodėlčiukas (Laisvės pr. 59)";OBUOLIUKAI;9645987751;Taip;3;4;0;7
3971;"Kodėlčiukas (Laisvės pr. 59)";OBUOLIUKAI;5860975805;Taip;3;0;1;4
3972;"Kodėlčiukas (Laisvės pr. 59)";OBUOLIUKAI;8782155591;Taip;4;2;3;9
3973;"Kodėlčiukas (Laisvės pr. 59)";OBUOLIUKAI;2005453189;Taip;0;4;0;4
3974;"Kodėlčiukas (Laisvės pr. 59)";OBUOLIUKAI;5173730926;Taip;8;4;0;12
3975;"Kodėlčiukas (Laisvės pr. 59)";OBUOLIUKAI;7946010973;Taip;3;7;0;10
3976;"Kodėlčiukas (Laisvės pr. 59)";OBUOLIUKAI;5342852235;Taip;5;6;0;11
3977;"Kodėlčiukas (Laisvės pr. 59)";OBUOLIUKAI;4026784012;Taip;0;2;1;3
3978;"Kodėlčiukas (Laisvės pr. 59)";OBUOLIUKAI;2114176689;Taip;2;0;1;3
3979;"Kodėlčiukas (Laisvės pr. 59)";OBUOLIUKAI;3033687110;Taip;0;4;0;4
3980;"Kodėlčiukas (Laisvės pr. 59)";OBUOLIUKAI;5252261660;Taip;14;2;0;16
3981;"Kodėlčiukas (Laisvės pr. 59)";AITVARIUKAI;9573073973;Taip;4;0;0;4
3982;"Kodėlčiukas (Laisvės pr. 59)";AITVARIUKAI;1029573241;Taip;14;0;1;15
3983;"Kodėlčiukas (Laisvės pr. 59)";AITVARIUKAI;1029573241;Taip;14;0;1;15
3984;"Kodėlčiukas (Laisvės pr. 59)";AITVARIUKAI;2892318767;Taip;13;0;0;13
3985;"Kodėlčiukas (Laisvės pr. 59)";AITVARIUKAI;2892318767;Taip;13;0;0;13
3986;"Kodėlčiukas (Laisvės pr. 59)";AITVARIUKAI;6809202793;Taip;7;0;0;7
3987;"Kodėlčiukas (Laisvės pr. 59)";AITVARIUKAI;6809202793;Taip;7;0;0;7
3988;"Kodėlčiukas (Laisvės pr. 59)";AITVARIUKAI;9389125350;Taip;6;0;0;6
3989;"Kodėlčiukas (Laisvės pr. 59)";AITVARIUKAI;9389125350;Taip;6;0;0;6
3990;"Kodėlčiukas (Laisvės pr. 59)";AITVARIUKAI;2429997257;Taip;2;0;1;3
3991;"Kodėlčiukas (Laisvės pr. 59)";AITVARIUKAI;2429997257;Taip;2;0;1;3
3992;"Kodėlčiukas (Laisvės pr. 59)";AITVARIUKAI;1775864846;Taip;0;0;1;1
3993;"Kodėlčiukas (Laisvės pr. 59)";AITVARIUKAI;1775864846;Taip;0;0;1;1
3994;"Kodėlčiukas (Laisvės pr. 59)";AITVARIUKAI;8707777661;Taip;18;0;0;18
3995;"Kodėlčiukas (Laisvės pr. 59)";AITVARIUKAI;8707777661;Taip;18;0;0;18
3996;"Kodėlčiukas (Laisvės pr. 59)";AITVARIUKAI;4366942357;Taip;10;0;0;10
3997;"Kodėlčiukas (Laisvės pr. 59)";AITVARIUKAI;4366942357;Taip;10;0;0;10
3998;"Kodėlčiukas (Laisvės pr. 59)";AITVARIUKAI;2601561338;Taip;4;0;0;4
3999;"Kodėlčiukas (Laisvės pr. 59)";AITVARIUKAI;3735299373;Taip;6;0;0;6
4000;"Kodėlčiukas (Laisvės pr. 59)";AITVARIUKAI;3071951746;Taip;6;0;0;6
4001;"Kodėlčiukas (Laisvės pr. 59)";DEBESĖLIAI;2048119857;Taip;14;0;0;14
4002;"Kodėlčiukas (Laisvės pr. 59)";DEBESĖLIAI;7141979862;Taip;15;0;0;15
4003;"Kodėlčiukas (Laisvės pr. 59)";DEBESĖLIAI;7141979862;Taip;15;0;0;15
4004;"Kodėlčiukas (Laisvės pr. 59)";DEBESĖLIAI;1725192281;Taip;9;0;1;10
4005;"Kodėlčiukas (Laisvės pr. 59)";DEBESĖLIAI;1725192281;Taip;9;0;1;10
4006;"Kodėlčiukas (Laisvės pr. 59)";DEBESĖLIAI;7242480118;Taip;9;0;0;9
4007;"Kodėlčiukas (Laisvės pr. 59)";DEBESĖLIAI;7242480118;Taip;9;0;0;9
4008;"Kodėlčiukas (Laisvės pr. 59)";DEBESĖLIAI;2914410829;Taip;14;0;1;15
4009;"Kodėlčiukas (Laisvės pr. 59)";DEBESĖLIAI;3662576624;Taip;0;11;0;11
4010;"Kodėlčiukas (Laisvės pr. 59)";DEBESĖLIAI;9370078535;Taip;3;0;0;3
4011;"Kodėlčiukas (Laisvės pr. 59)";DEBESĖLIAI;9370078535;Taip;3;0;0;3
4012;"Kodėlčiukas (Laisvės pr. 59)";DEBESĖLIAI;6567146331;Taip;0;1;0;1
4013;"Kodėlčiukas (Laisvės pr. 59)";DEBESĖLIAI;6567146331;Taip;0;1;0;1
4014;"Kodėlčiukas (Laisvės pr. 59)";DEBESĖLIAI;5786431452;Ne;15;0;0;15
4015;"Kodėlčiukas (Laisvės pr. 59)";DEBESĖLIAI;1056383365;Taip;5;0;0;5
4016;"Kodėlčiukas (Laisvės pr. 59)";DEBESĖLIAI;3609685477;Taip;3;0;0;3
4017;"Kodėlčiukas (Laisvės pr. 59)";EŽIUKAI;3869434109;Taip;1;0;0;1
4018;"Kodėlčiukas (Laisvės pr. 59)";EŽIUKAI;1906930504;Taip;2;0;0;2
4019;"Kodėlčiukas (Laisvės pr. 59)";EŽIUKAI;5925818434;Taip;16;0;0;16
4020;"Kodėlčiukas (Laisvės pr. 59)";EŽIUKAI;5925818434;Taip;16;0;0;16
4021;"Kodėlčiukas (Laisvės pr. 59)";EŽIUKAI;7107700885;Taip;0;1;0;1
4022;"Kodėlčiukas (Laisvės pr. 59)";EŽIUKAI;7107700885;Taip;0;1;0;1
4023;"Kodėlčiukas (Laisvės pr. 59)";EŽIUKAI;4842829705;Taip;0;1;0;1
4024;"Kodėlčiukas (Laisvės pr. 59)";EŽIUKAI;4842829705;Taip;0;1;0;1
4025;"Kodėlčiukas (Laisvės pr. 59)";EŽIUKAI;3529385544;Taip;1;0;0;1
4026;"Kodėlčiukas (Laisvės pr. 59)";EŽIUKAI;2728038596;Ne;8;1;0;9
4027;"Kodėlčiukas (Laisvės pr. 59)";EŽIUKAI;6373705667;Taip;0;3;0;3
4028;"Kodėlčiukas (Laisvės pr. 59)";EŽIUKAI;6373705667;Taip;0;3;0;3
4029;"Kodėlčiukas (Laisvės pr. 59)";EŽIUKAI;7035441207;Taip;15;0;0;15
4030;"Kodėlčiukas (Laisvės pr. 59)";EŽIUKAI;2999381333;Taip;14;0;0;14
4031;"Kodėlčiukas (Laisvės pr. 59)";EŽIUKAI;2999381333;Taip;14;0;0;14
4032;"Kodėlčiukas (Laisvės pr. 59)";EŽIUKAI;5540660080;Taip;13;0;0;13
4033;"Kodėlčiukas (Laisvės pr. 59)";EŽIUKAI;4795230461;Taip;3;4;0;7
4034;"Kodėlčiukas (Laisvės pr. 59)";EŽIUKAI;9092413482;Taip;1;0;0;1
4035;"Kodėlčiukas (Laisvės pr. 59)";EŽIUKAI;9424975662;Taip;0;6;0;6
4036;"Kodėlčiukas (Laisvės pr. 59)";EŽIUKAI;9424975662;Taip;0;6;0;6
4037;"Kodėlčiukas (Laisvės pr. 59)";EŽIUKAI;3598405258;Taip;11;0;0;11
4038;"Kodėlčiukas (Laisvės pr. 59)";EŽIUKAI;3598405258;Taip;11;0;0;11
4039;"Kodėlčiukas (Laisvės pr. 59)";EŽIUKAI;5025581128;Taip;1;0;0;1
4040;"Kodėlčiukas (Laisvės pr. 59)";EŽIUKAI;5025581128;Taip;1;0;0;1
4041;"Kodėlčiukas (Laisvės pr. 59)";EŽIUKAI;1761109453;Taip;2;0;0;2
4042;Kurpaitė;Viščiukų;4572559234;Taip;18;0;0;18
4043;Kurpaitė;Viščiukų;6453256555;Ne;14;0;0;14
4044;Kurpaitė;Viščiukų;9299294437;Taip;15;0;0;15
4045;Kurpaitė;Viščiukų;9761100202;Ne;19;0;0;19
4046;Kurpaitė;Viščiukų;1558096975;Taip;0;15;0;15
4047;Kurpaitė;Viščiukų;7973054986;Taip;0;10;0;10
4048;Kurpaitė;Viščiukų;2233142424;Taip;2;0;0;2
4049;Kurpaitė;Viščiukų;5629017875;Taip;7;0;0;7
4050;Kurpaitė;Viščiukų;8655912398;Taip;3;0;0;3
4051;Kurpaitė;Viščiukų;5234784564;Taip;0;20;0;20
4052;Kurpaitė;Viščiukų;2772566963;Taip;4;0;0;4
4053;Kurpaitė;Gėlyčių;5952306163;Taip;0;8;0;8
4054;Kurpaitė;Gėlyčių;3139272175;Taip;0;19;0;19
4055;Kurpaitė;Gėlyčių;4769611100;Taip;1;0;0;1
4056;Kurpaitė;Gėlyčių;2629958613;Taip;2;0;0;2
4057;Kurpaitė;Gėlyčių;2629958613;Taip;2;0;0;2
4058;Kurpaitė;Gėlyčių;4687182527;Taip;4;0;0;4
4059;Kurpaitė;Gėlyčių;2373582223;Taip;0;23;0;23
4060;Kurpaitė;Gėlyčių;2157581956;Taip;0;9;0;9
4061;Kurpaitė;Gėlyčių;5175919323;Taip;0;13;0;13
4062;Kurpaitė;Gėlyčių;7194351335;Taip;10;0;0;10
4063;Kurpaitė;Gėlyčių;5701318496;Taip;0;5;0;5
4064;Kurpaitė;Gėlyčių;2744439309;Ne;0;3;0;3
4065;Kurpaitė;Gėlyčių;5923694769;Taip;4;0;0;4
4066;Kurpaitė;Gėlyčių;3481813493;Taip;0;4;0;4
4067;Kurpaitė;Gėlyčių;8402747029;Taip;0;6;0;6
4068;Kurpaitė;Gėlyčių;5557028481;Ne;0;4;0;4
4069;Kurpaitė;Gėlyčių;5447826458;Taip;0;7;0;7
4070;Kurpaitė;Gėlyčių;4657523142;Taip;0;1;0;1
4071;Kurpaitė;Gėlyčių;2867842844;Taip;10;0;0;10
4072;Kurpaitė;Drugelių;8868415451;Taip;5;4;0;9
4073;Kurpaitė;Drugelių;1273426668;Taip;0;8;0;8
4074;Kurpaitė;Drugelių;5220314051;Taip;3;0;0;3
4075;Kurpaitė;Drugelių;1413326858;Taip;10;0;0;10
4076;Kurpaitė;Drugelių;6568580994;Taip;0;7;0;7
4077;Kurpaitė;Drugelių;5396599834;Taip;7;0;0;7
4078;Kurpaitė;Drugelių;1752006477;Taip;13;4;0;17
4079;Kurpaitė;Drugelių;2757100599;Taip;4;0;0;4
4080;Kurpaitė;Drugelių;9922582884;Ne;2;0;0;2
4081;Kurpaitė;Drugelių;3989274600;Taip;5;0;0;5
4082;Kurpaitė;Drugelių;4426311033;Taip;3;0;0;3
4083;Kurpaitė;Drugelių;1927773278;Taip;0;9;0;9
4084;Kurpaitė;Drugelių;9221882007;Taip;0;1;0;1
4085;Kurpaitė;Drugelių;8361612709;Taip;0;7;0;7
4086;Kurpaitė;Drugelių;4754807319;Taip;0;1;0;1
4087;Kurpaitė;Drugelių;4607835570;Taip;5;0;0;5
4088;Kurpaitė;Pelyčių;7546409044;Taip;0;11;0;11
4089;Kurpaitė;Pelyčių;1209441106;Taip;0;4;9;13
4090;Kurpaitė;Pelyčių;4519369081;Taip;1;4;0;5
4091;Kurpaitė;Pelyčių;7897713994;Taip;0;3;0;3
4092;Kurpaitė;Pelyčių;5064875626;Taip;1;0;0;1
4093;Kurpaitė;Pelyčių;5609161523;Taip;0;1;0;1
4094;Kurpaitė;Pelyčių;9480290430;Taip;1;3;0;4
4095;Kurpaitė;Pelyčių;4188925256;Taip;0;1;0;1
4096;Kurpaitė;Pelyčių;3634641300;Taip;0;1;0;1
4097;Kurpaitė;Pelyčių;9915241987;Taip;0;2;0;2
4098;Kurpaitė;Pelyčių;5844470373;Taip;7;2;0;9
4099;Kurpaitė;Pelyčių;1864484931;Taip;15;0;0;15
4100;Kurpaitė;Pelyčių;8069116180;Taip;14;0;0;14
4101;Kurpaitė;Pelyčių;9384218589;Taip;5;17;0;22
4102;Kurpaitė;Pelyčių;6309468728;Taip;4;4;0;8
4103;Kurpaitė;Pelyčių;4964063637;Taip;0;4;0;4
4104;Kurpaitė;Pelyčių;2827617670;Taip;0;7;0;7
4105;Kurpaitė;Pelyčių;4168882748;Taip;0;15;0;15
4106;"Kūlverstukas (Suvalkų g. 6)";Saulutės;4846324136;Taip;0;2;0;2
4107;"Kūlverstukas (Suvalkų g. 6)";Saulutės;7505926208;Taip;5;9;0;14
4108;"Kūlverstukas (Suvalkų g. 6)";Saulutės;1014630718;Taip;5;9;0;14
4109;"Kūlverstukas (Suvalkų g. 6)";Saulutės;5340239466;Taip;2;0;0;2
4110;"Kūlverstukas (Suvalkų g. 6)";Saulutės;8294873714;Taip;7;1;0;8
4111;"Kūlverstukas (Suvalkų g. 6)";Saulutės;8353856412;Taip;5;0;0;5
4112;"Kūlverstukas (Suvalkų g. 6)";Saulutės;5391554530;Taip;0;1;0;1
4113;"Kūlverstukas (Suvalkų g. 6)";Saulutės;4111966910;Taip;2;2;0;4
4114;"Kūlverstukas (Suvalkų g. 6)";Saulutės;8964753108;Taip;5;4;0;9
4115;"Kūlverstukas (Suvalkų g. 6)";Saulutės;2389231051;Taip;5;4;0;9
4116;"Kūlverstukas (Suvalkų g. 6)";Saulutės;6710735721;Taip;5;6;0;11
4117;"Kūlverstukas (Suvalkų g. 6)";Saulutės;1067182820;Taip;3;0;0;3
4118;"Kūlverstukas (Suvalkų g. 6)";Saulutės;3196099819;Taip;3;0;0;3
4119;"Kūlverstukas (Suvalkų g. 6)";Saulutės;8333084277;Taip;0;6;0;6
4120;"Kūlverstukas (Suvalkų g. 6)";Peledžiukai;8853848991;Taip;2;0;0;2
4121;"Kūlverstukas (Suvalkų g. 6)";Peledžiukai;4073233921;Taip;0;1;2;3
4122;"Kūlverstukas (Suvalkų g. 6)";Peledžiukai;3238807604;Taip;3;10;0;13
4123;"Kūlverstukas (Suvalkų g. 6)";Peledžiukai;1932066021;Taip;0;0;1;1
4124;"Kūlverstukas (Suvalkų g. 6)";Peledžiukai;5345423038;Taip;0;7;0;7
4125;"Kūlverstukas (Suvalkų g. 6)";Peledžiukai;3270176280;Taip;0;1;0;1
4126;"Kūlverstukas (Suvalkų g. 6)";Peledžiukai;4285624305;Taip;3;2;0;5
4127;"Kūlverstukas (Suvalkų g. 6)";Peledžiukai;6894291912;Taip;0;6;0;6
4128;"Kūlverstukas (Suvalkų g. 6)";Peledžiukai;3224736003;Taip;3;0;0;3
4129;"Kūlverstukas (Suvalkų g. 6)";Peledžiukai;2762230590;Taip;2;4;4;10
4130;"Kūlverstukas (Suvalkų g. 6)";Peledžiukai;2450625415;Taip;7;9;0;16
4131;"Kūlverstukas (Suvalkų g. 6)";Peledžiukai;2101490038;Taip;7;9;0;16
4132;"Kūlverstukas (Suvalkų g. 6)";Peledžiukai;9096819614;Taip;0;4;1;5
4133;"Kūlverstukas (Suvalkų g. 6)";Peledžiukai;8319255735;Taip;0;4;5;9
4134;"Kūlverstukas (Suvalkų g. 6)";Peledžiukai;1795306946;Taip;0;4;0;4
4135;"Kūlverstukas (Suvalkų g. 6)";Peledžiukai;4173514390;Taip;0;0;8;8
4136;"Kūlverstukas (Suvalkų g. 6)";Peledžiukai;3448880105;Ne;5;4;2;11
4137;"Kūlverstukas (Suvalkų g. 6)";Peledžiukai;4532151103;Taip;6;0;0;6
4138;"Kūlverstukas (Suvalkų g. 6)";Gelytės;3811616695;Taip;9;0;0;9
4139;"Kūlverstukas (Suvalkų g. 6)";Gelytės;1939668692;Taip;7;0;0;7
4140;"Kūlverstukas (Suvalkų g. 6)";Gelytės;8618967238;Taip;4;0;0;4
4141;"Kūlverstukas (Suvalkų g. 6)";Gelytės;9777005699;Taip;0;3;0;3
4142;"Kūlverstukas (Suvalkų g. 6)";Gelytės;4694784301;Taip;1;0;0;1
4143;"Kūlverstukas (Suvalkų g. 6)";Gelytės;8599785196;Taip;10;5;0;15
4144;"Kūlverstukas (Suvalkų g. 6)";Gelytės;2082087440;Taip;0;5;0;5
4145;"Kūlverstukas (Suvalkų g. 6)";Gelytės;6916013898;Taip;3;0;0;3
4146;"Kūlverstukas (Suvalkų g. 6)";Gelytės;1985177751;Taip;5;4;0;9
4147;"Kūlverstukas (Suvalkų g. 6)";Gelytės;2924333435;Taip;4;0;0;4
4148;"Kūlverstukas (Suvalkų g. 6)";Bitutės;8510004509;Taip;6;4;0;10
4149;"Kūlverstukas (Suvalkų g. 6)";Bitutės;1710691463;Taip;7;8;0;15
4150;"Kūlverstukas (Suvalkų g. 6)";Bitutės;5359152614;Taip;4;0;0;4
4151;"Kūlverstukas (Suvalkų g. 6)";Bitutės;7536805404;Taip;9;0;0;9
4152;"Kūlverstukas (Suvalkų g. 6)";Bitutės;3603297769;Taip;3;2;0;5
4153;"Kūlverstukas (Suvalkų g. 6)";Bitutės;1651670859;Taip;8;0;0;8
4154;"Kūlverstukas (Suvalkų g. 6)";Bitutės;3667698628;Taip;10;0;0;10
4155;"Kūlverstukas (Suvalkų g. 6)";Bitutės;4211069122;Taip;8;1;0;9
4156;"Kūlverstukas (Suvalkų g. 6)";Bitutės;5401016434;Taip;9;0;0;9
4157;"Kūlverstukas (Suvalkų g. 6)";Bitutės;3348354269;Taip;6;0;0;6
4158;Lakštingala;Saulutės;2156571482;Taip;0;6;0;6
4159;Lakštingala;Saulutės;2084960114;Taip;7;0;0;7
4160;Lakštingala;Saulutės;3911509979;Taip;3;1;0;4
4161;Lakštingala;Saulutės;1598639284;Taip;0;4;1;5
4162;Lakštingala;Saulutės;3723986383;Taip;0;4;0;4
4163;Lakštingala;Saulutės;1243254166;Taip;0;6;0;6
4164;Lakštingala;Saulutės;9457533516;Taip;0;3;1;4
4165;Lakštingala;Saulutės;9495341480;Taip;0;13;0;13
4166;Lakštingala;Saulutės;2543779273;Taip;3;2;3;8
4167;Lakštingala;Saulutės;2093953744;Taip;6;0;0;6
4168;Lakštingala;Saulutės;1074616528;Taip;9;0;1;10
4169;Lakštingala;Saulutės;5432816139;Taip;0;2;0;2
4170;Lakštingala;Saulutės;8679582358;Taip;23;0;0;23
4171;Lakštingala;Saulutės;5815240975;Taip;5;0;1;6
4172;Lakštingala;Saulutės;3520592784;Taip;0;0;1;1
4173;Lakštingala;Saulutės;3369263112;Taip;4;5;1;10
4174;Lakštingala;Saulutės;8717764626;Taip;1;0;0;1
4175;Lakštingala;Saulutės;8160825203;Taip;0;1;0;1
4176;Lakštingala;Saulutės;6780591792;Taip;4;1;0;5
4177;Lakštingala;Saulutės;1220858944;Taip;0;3;0;3
4178;Lakštingala;Saulutės;4032030375;Taip;0;6;0;6
4179;Lakštingala;Saulutės;3839016986;Taip;0;1;0;1
4180;Lakštingala;Saulutės;4344553248;Taip;15;0;0;15
4181;Lakštingala;Nykštukai;6861300785;Taip;9;0;0;9
4182;Lakštingala;Nykštukai;5943711793;Taip;0;2;21;23
4183;Lakštingala;Nykštukai;9420187643;Taip;4;0;1;5
4184;Lakštingala;Nykštukai;9339816191;Taip;0;0;1;1
4185;Lakštingala;Nykštukai;4045740078;Taip;9;0;0;9
4186;Lakštingala;Nykštukai;8310446552;Taip;4;0;0;4
4187;Lakštingala;Nykštukai;8063735934;Taip;0;6;0;6
4188;Lakštingala;Nykštukai;7396235662;Taip;0;6;0;6
4189;Lakštingala;Nykštukai;4725848201;Taip;0;0;1;1
4190;Lakštingala;Nykštukai;2165808562;Taip;4;4;7;15
4191;Lakštingala;Nykštukai;5539054769;Taip;0;0;2;2
4192;Lakštingala;Nykštukai;6974936332;Taip;9;0;3;12
4193;Lakštingala;Nykštukai;8764728846;Taip;2;0;0;2
4194;Lakštingala;Nykštukai;8663938939;Taip;1;0;0;1
4195;Lakštingala;Nykštukai;5165517709;Taip;0;1;0;1
4196;Lakštingala;Nykštukai;5965026791;Taip;9;4;0;13
4197;Lakštingala;Bitutės;6234559044;Taip;0;4;0;4
4198;Lakštingala;Bitutės;5727308039;Taip;0;5;0;5
4199;Lakštingala;Bitutės;5051773825;Taip;5;2;0;7
4200;Lakštingala;Bitutės;9390342572;Taip;9;4;0;13
4201;Lakštingala;Bitutės;8171357606;Taip;0;4;0;4
4202;Lakštingala;Bitutės;8165998647;Taip;6;2;0;8
4203;Lakštingala;Bitutės;9774836470;Taip;4;4;0;8
4204;Lakštingala;Bitutės;1958696382;Taip;1;3;0;4
4205;Lakštingala;Bitutės;1458348357;Taip;4;4;0;8
4206;Lakštingala;Bitutės;4542992319;Taip;0;4;0;4
4207;Lakštingala;Bitutės;7272454093;Taip;0;5;0;5
4208;Lakštingala;Bitutės;5949665703;Taip;6;0;1;7
4209;Lakštingala;Bitutės;4465752871;Taip;3;0;0;3
4210;Lakštingala;Bitutės;2593030897;Taip;0;6;0;6
4211;Lakštingala;Bitutės;6565318145;Taip;0;5;0;5
4212;Lakštingala;Bitutės;4384468922;Taip;0;9;0;9
4213;Lakštingala;Bitutės;6908873466;Taip;0;4;0;4
4214;Lakštingala;Bitutės;7929034243;Taip;5;1;0;6
4215;Lakštingala;Bitutės;5854794141;Taip;6;4;0;10
4216;Lakštingala;Bitutės;5920907667;Taip;0;14;0;14
4217;Lakštingala;Pūkeliai;9093654437;Taip;8;0;0;8
4218;Lakštingala;Pūkeliai;3877448215;Taip;4;9;0;13
4219;Lakštingala;Pūkeliai;6148942052;Taip;9;0;1;10
4220;Lakštingala;Pūkeliai;7623917384;Taip;5;0;0;5
4221;Lakštingala;Pūkeliai;6011421835;Taip;1;0;4;5
4222;Lakštingala;Pūkeliai;2673030043;Taip;1;0;0;1
4223;Lakštingala;Pūkeliai;2346497467;Taip;6;0;1;7
4224;Lakštingala;Pūkeliai;2010478542;Ne;18;0;1;19
4225;Lakštingala;Pūkeliai;1903292595;Taip;9;4;0;13
4226;Lakštingala;Pūkeliai;6764453371;Taip;0;1;0;1
4227;Lakštingala;Pūkeliai;9894103692;Taip;7;0;0;7
4228;Lakštingala;Pūkeliai;1371422364;Taip;13;0;0;13
4229;Lakštingala;Pūkeliai;8800538473;Taip;8;0;0;8
4230;Lakštingala;Pūkeliai;6285766353;Taip;7;9;0;16
4231;Lakštingala;Pūkeliai;3752408599;Taip;1;0;0;1
4232;Lakštingala;Pūkeliai;9183206191;Taip;2;0;2;4
4233;Lakštingala;Pūkeliai;2611117446;Taip;8;4;0;12
4234;Lakštingala;Pūkeliai;5524522038;Taip;8;4;0;12
4235;Lakštingala;Pūkeliai;5890760362;Taip;10;0;0;10
4236;Lakštingala;Pūkeliai;5583075385;Taip;5;0;3;8
4237;Lakštingala;Pūkeliai;4234177812;Taip;7;3;0;10
4238;Lakštingala;Pūkeliai;5903339111;Taip;16;0;0;16
4239;Lakštingala;Aitvariukai;1474796466;Taip;0;0;5;5
4240;Lakštingala;Aitvariukai;4546036762;Taip;5;2;1;8
4241;Lakštingala;Aitvariukai;7876311404;Taip;0;0;1;1
4242;Lakštingala;Aitvariukai;1248909711;Taip;9;0;0;9
4243;Lakštingala;Aitvariukai;7879280198;Taip;0;7;0;7
4244;Lakštingala;Aitvariukai;4403673558;Taip;14;4;0;18
4245;Lakštingala;Aitvariukai;5693413287;Taip;0;0;3;3
4246;Lakštingala;Aitvariukai;7240426529;Taip;4;0;2;6
4247;Lakštingala;Aitvariukai;8558000223;Taip;10;0;0;10
4248;Lakštingala;Aitvariukai;5244646855;Taip;1;0;0;1
4249;Lakštingala;Aitvariukai;5602079341;Taip;14;0;0;14
4250;Lakštingala;Aitvariukai;7404386777;Taip;0;0;1;1
4251;Lakštingala;Aitvariukai;3166474163;Taip;3;0;0;3
4252;Lakštingala;Aitvariukai;6180443056;Taip;7;0;0;7
4253;Lakštingala;Aitvariukai;6389721877;Taip;18;0;0;18
4254;Lakštingala;Aitvariukai;4211861355;Taip;2;4;2;8
4255;Lakštingala;Aitvariukai;6872095965;Taip;0;0;3;3
4256;Lakštingala;Boružiukai;1898853302;Taip;0;2;0;2
4257;Lakštingala;Boružiukai;8284565948;Taip;0;4;0;4
4258;Lakštingala;Boružiukai;4857448665;Taip;2;3;0;5
4259;Lakštingala;Boružiukai;1863034132;Taip;1;0;0;1
4260;Lakštingala;Boružiukai;9879064676;Taip;0;4;0;4
4261;Lakštingala;Boružiukai;2941128360;Taip;0;1;0;1
4262;Lakštingala;Boružiukai;8217315818;Taip;0;3;0;3
4263;Lakštingala;Boružiukai;9912622093;Taip;0;1;0;1
4264;Lakštingala;Boružiukai;6292331193;Taip;0;1;0;1
4265;Lakštingala;Boružiukai;3509165175;Taip;0;4;0;4
4266;Lakštingala;Boružiukai;4179366572;Taip;9;4;0;13
4267;Lakštingala;Boružiukai;9489982241;Taip;0;6;0;6
4268;Lakštingala;Boružiukai;3993759015;Taip;16;0;0;16
4269;Lakštingala;Boružiukai;5445945319;Taip;5;5;0;10
4270;Lakštingala;Boružiukai;2652305131;Taip;0;1;1;2
4271;Lakštingala;Boružiukai;9725851433;Taip;0;1;0;1
4272;Lakštingala;Boružiukai;1655202909;Taip;2;2;0;4
4273;Lakštingala;Boružiukai;6009631424;Taip;3;0;0;3
4274;Lakštingala;Boružiukai;9375002191;Taip;2;5;1;8
4275;Lakštingala;Boružiukai;7963839249;Taip;4;7;0;11
4276;Lakštingala;Boružiukai;5162605666;Taip;7;7;0;14
4277;Lakštingala;Boružiukai;2073818724;Taip;0;4;0;4
4278;Lakštingala;Boružiukai;7994475429;Taip;0;3;0;3
4279;Lakštingala;Boružiukai;2266870318;Taip;0;1;0;1
4280;Lakštingala;Boružiukai;9346986726;Taip;7;4;0;11
4281;Lakštingala;Žiogeliai;8404025659;Taip;11;0;2;13
4282;Lakštingala;Žiogeliai;4113993067;Taip;0;6;0;6
4283;Lakštingala;Žiogeliai;6981178960;Taip;0;4;0;4
4284;Lakštingala;Žiogeliai;3908175786;Taip;11;0;7;18
4285;Lakštingala;Žiogeliai;4935753482;Taip;0;0;3;3
4286;Lakštingala;Žiogeliai;3439681068;Taip;0;4;0;4
4287;Lakštingala;Žiogeliai;3766986041;Taip;9;0;2;11
4288;Lakštingala;Žiogeliai;1226908540;Taip;4;0;1;5
4289;Lakštingala;Žiogeliai;3951057865;Taip;3;0;1;4
4290;Lakštingala;Žiogeliai;1494530289;Taip;0;0;7;7
4291;Lakštingala;Žiogeliai;7661973162;Taip;0;9;0;9
4292;Lakštingala;Žiogeliai;7104398627;Taip;2;0;0;2
4293;Lakštingala;Žiogeliai;7361353346;Taip;0;5;0;5
4294;Lakštingala;Žiogeliai;4790291839;Taip;0;1;1;2
4295;Lakštingala;Žiogeliai;8351970017;Taip;0;1;1;2
4296;Lakštingala;Žiogeliai;8333832673;Taip;0;1;0;1
4297;Lakštingala;Žiogeliai;5849662446;Taip;5;0;3;8
4298;Lakštingala;Žiogeliai;5854343571;Taip;0;1;4;5
4299;Lakštingala;SPINDULIUKAI;4365413054;Taip;6;0;2;8
4300;Lakštingala;SPINDULIUKAI;9762500668;Taip;0;6;0;6
4301;Lakštingala;SPINDULIUKAI;7640007392;Taip;0;12;0;12
4302;Lakštingala;SPINDULIUKAI;4784677514;Taip;0;2;0;2
4303;Lakštingala;SPINDULIUKAI;1619201521;Taip;4;0;0;4
4304;Lakštingala;SPINDULIUKAI;8429523368;Ne;0;4;1;5
4305;Lakštingala;SPINDULIUKAI;6668075753;Taip;1;8;2;11
4306;Lakštingala;SPINDULIUKAI;9081653166;Taip;0;0;1;1
4307;Lakštingala;SPINDULIUKAI;8722490845;Taip;4;0;1;5
4308;Lakštingala;SPINDULIUKAI;3823860988;Taip;0;0;2;2
4309;Lakštingala;SPINDULIUKAI;7141840160;Taip;0;5;0;5
4310;Lakštingala;SPINDULIUKAI;3282771613;Taip;0;5;0;5
4311;Lakštingala;SPINDULIUKAI;2795341401;Taip;0;6;3;9
4312;Lakštingala;SPINDULIUKAI;4651600682;Taip;9;0;0;9
4313;Lakštingala;SPINDULIUKAI;8130468345;Taip;0;5;0;5
4314;Lakštingala;SPINDULIUKAI;2626498928;Taip;0;5;0;5
4315;Lakštingala;SPINDULIUKAI;9441296489;Taip;0;2;0;2
4316;Lakštingala;SPINDULIUKAI;6606640383;Taip;0;2;1;3
4317;Lakštingala;Pėledžiukai;6135103377;Taip;0;5;0;5
4318;Lakštingala;Pėledžiukai;4774354751;Taip;18;1;1;20
4319;Lakštingala;Pėledžiukai;8375506323;Taip;4;1;0;5
4320;Lakštingala;Pėledžiukai;2738882466;Taip;3;2;0;5
4321;Lakštingala;Pėledžiukai;8075192528;Taip;9;6;1;16
4322;Lakštingala;Pėledžiukai;4270513515;Taip;4;1;0;5
4323;Lakštingala;Pėledžiukai;2514377385;Taip;8;0;0;8
4324;Lakštingala;Pėledžiukai;6161860331;Taip;8;0;0;8
4325;Lakštingala;Pėledžiukai;6866935290;Taip;23;0;0;23
4326;Lakštingala;Pėledžiukai;8787118512;Taip;0;6;2;8
4327;Lakštingala;Pėledžiukai;6805882038;Taip;6;1;0;7
4328;Lakštingala;Pėledžiukai;7139669240;Taip;0;6;4;10
4329;Lakštingala;Pėledžiukai;9502994399;Taip;0;22;1;23
4330;Lakštingala;Pėledžiukai;9431022632;Taip;3;4;0;7
4331;Lakštingala;Pėledžiukai;9856189053;Taip;5;1;0;6
4332;Lakštingala;Pėledžiukai;5391954600;Taip;3;0;0;3
4333;Lakštingala;Pėledžiukai;4608719006;Ne;0;0;2;2
4334;Lakštingala;Pėledžiukai;5812491783;Taip;11;0;1;12
4335;Lakštingala;Pėledžiukai;9899997020;Taip;10;0;0;10
4336;Lakštingala;Pėledžiukai;6369696598;Taip;7;1;0;8
4337;Lakštingala;Pėledžiukai;9297542026;Taip;0;9;0;9
4338;Lakštingala;Pėledžiukai;3618452008;Taip;2;0;0;2
4339;Lakštingala;Katinėliai;7351891043;Taip;7;1;0;8
4340;Lakštingala;Katinėliai;2610113024;Taip;0;0;3;3
4341;Lakštingala;Katinėliai;6685195244;Taip;6;0;1;7
4342;Lakštingala;Katinėliai;8444696089;Taip;8;0;0;8
4343;Lakštingala;Katinėliai;4896401452;Taip;0;0;2;2
4344;Lakštingala;Katinėliai;7987187638;Taip;8;4;0;12
4345;Lakštingala;Katinėliai;8900191763;Taip;8;4;0;12
4346;Lakštingala;Katinėliai;9923491804;Taip;0;1;1;2
4347;Lakštingala;Katinėliai;2599217481;Taip;0;10;0;10
4348;Lakštingala;Katinėliai;2029350217;Taip;11;0;2;13
4349;Lakštingala;Katinėliai;6180366812;Taip;0;0;2;2
4350;Lakštingala;Katinėliai;3899425918;Taip;6;4;0;10
4351;Lakštingala;Katinėliai;4165688458;Taip;13;0;0;13
4352;Lakštingala;Katinėliai;2841048627;Taip;0;5;0;5
4353;Lakštingala;Katinėliai;1279172936;Taip;0;0;10;10
4354;Lakštingala;Katinėliai;2333102026;Taip;0;1;2;3
4355;Lakštingala;Katinėliai;2662167519;Taip;5;2;0;7
4356;Lakštingala;Katinėliai;3227628813;Taip;11;4;1;16
4357;Lakštingala;Katinėliai;2770661353;Taip;14;0;1;15
4358;Lakštingala;Deimantėliai;2114708431;Taip;9;0;2;11
4359;Lakštingala;Deimantėliai;8074211850;Taip;6;0;0;6
4360;Lakštingala;Deimantėliai;6749980386;Taip;2;0;0;2
4361;Lakštingala;Deimantėliai;9072843429;Taip;0;1;1;2
4362;Lakštingala;Deimantėliai;8938720617;Taip;0;2;0;2
4363;Lakštingala;Deimantėliai;4903094629;Taip;0;3;4;7
4364;Lakštingala;Deimantėliai;7853382073;Taip;0;0;1;1
4365;Lakštingala;Deimantėliai;1276857151;Taip;10;2;0;12
4366;Lakštingala;Deimantėliai;6971655647;Taip;3;4;1;8
4367;Lakštingala;Deimantėliai;7043519686;Taip;4;0;0;4
4368;Lakštingala;Deimantėliai;4976683143;Taip;4;2;0;6
4369;Lakštingala;Deimantėliai;7078051438;Taip;0;1;0;1
4370;Lakštingala;Deimantėliai;8571415914;Taip;0;0;4;4
4371;Lakštingala;Deimantėliai;8711116860;Taip;0;3;1;4
4372;Lakštingala;Deimantėliai;2886415541;Taip;0;6;0;6
4373;Lakštingala;Deimantėliai;5980402440;Taip;0;5;0;5
4374;Lakštingala;Deimantėliai;1661358666;Taip;0;0;2;2
4375;Lakštingala;Deimantėliai;9312563560;Taip;4;0;0;4
4376;Lakštingala;Deimantėliai;4199371972;Taip;0;0;1;1
4377;Lakštingala;KIŠKUČIAI;6520436055;Taip;5;1;0;6
4378;Lakštingala;KIŠKUČIAI;3208321841;Taip;15;2;0;17
4379;Lakštingala;KIŠKUČIAI;5464460112;Taip;0;1;0;1
4380;Lakštingala;KIŠKUČIAI;6970022417;Taip;13;0;0;13
4381;Lakštingala;KIŠKUČIAI;5730122965;Taip;0;5;0;5
4382;Lakštingala;KIŠKUČIAI;4140403601;Taip;4;0;0;4
4383;Lakštingala;KIŠKUČIAI;6689018476;Taip;14;4;0;18
4384;Lakštingala;KIŠKUČIAI;7017047366;Taip;0;5;0;5
4385;Lakštingala;KIŠKUČIAI;9539081376;Taip;9;0;1;10
4386;Lakštingala;KIŠKUČIAI;4854843534;Taip;9;1;0;10
4387;Lakštingala;KIŠKUČIAI;9162902701;Taip;2;0;5;7
4388;Lakštingala;KIŠKUČIAI;5455119187;Taip;0;0;2;2
4389;Lakštingala;KIŠKUČIAI;1113674539;Taip;16;0;0;16
4390;Lakštingala;KIŠKUČIAI;4370431439;Taip;7;0;0;7
4391;Lakštingala;KIŠKUČIAI;1898108870;Taip;16;3;0;19
4392;Lakštingala;KIŠKUČIAI;6652822827;Taip;0;0;1;1
4393;Lakštingala;KIŠKUČIAI;2998581623;Taip;9;2;0;11
4394;Lakštingala;KIŠKUČIAI;8414220381;Taip;3;0;1;4
4395;Lakštingala;KIŠKUČIAI;7817830649;Taip;0;12;0;12
4396;Lakštingala;KIŠKUČIAI;1831078544;Taip;7;0;0;7
4397;Lakštingala;KIŠKUČIAI;4184814075;Taip;1;0;0;1
4398;Lašelis;VIŠČIUKAI;6477439886;Taip;8;0;0;8
4399;Lašelis;VIŠČIUKAI;6912802425;Taip;10;0;0;10
4400;Lašelis;VIŠČIUKAI;6857428142;Taip;5;4;0;9
4401;Lašelis;VIŠČIUKAI;5759317067;Ne;9;1;0;10
4402;Lašelis;VIŠČIUKAI;1367955273;Ne;0;6;0;6
4403;Lašelis;VIŠČIUKAI;2702582486;Taip;14;0;0;14
4404;Lašelis;VIŠČIUKAI;2824852871;Taip;19;1;0;20
4405;Lašelis;VIŠČIUKAI;1294930990;Taip;0;5;0;5
4406;Lašelis;VIŠČIUKAI;2121080776;Taip;1;0;0;1
4407;Lašelis;VIŠČIUKAI;3003679103;Taip;4;0;0;4
4408;Lašelis;VIŠČIUKAI;4427263877;Taip;11;4;0;15
4409;Lašelis;VIŠČIUKAI;1168408482;Taip;5;0;0;5
4410;Lašelis;VIŠČIUKAI;4748156580;Taip;3;2;0;5
4411;Lašelis;VIŠČIUKAI;4860925464;Ne;6;0;0;6
4412;Lašelis;VIŠČIUKAI;2915806799;Taip;2;7;0;9
4413;Lašelis;VIŠČIUKAI;2900106941;Taip;8;0;3;11
4414;Lašelis;VIŠČIUKAI;2748888134;Ne;13;0;0;13
4415;Lašelis;ŠYPSENA;6317716501;Taip;0;0;5;5
4416;Lašelis;ŠYPSENA;7502668870;Taip;0;8;0;8
4417;Lašelis;ŠYPSENA;8905080707;Taip;0;0;1;1
4418;Lašelis;ŠYPSENA;7784416134;Taip;5;0;0;5
4419;Lašelis;ŠYPSENA;4051058266;Taip;5;0;0;5
4420;Lašelis;ŠYPSENA;7418586100;Taip;5;0;1;6
4421;Lašelis;ŠYPSENA;1429188137;Taip;0;0;4;4
4422;Lašelis;ŠYPSENA;1131591230;Taip;6;0;1;7
4423;Lašelis;ŠYPSENA;7811809908;Taip;0;3;0;3
4424;Lašelis;ŠYPSENA;1882188961;Taip;14;0;0;14
4425;Lašelis;ŠYPSENA;4893073148;Taip;0;0;1;1
4426;Lašelis;ŠYPSENA;2210081848;Taip;0;0;2;2
4427;Lašelis;ŠYPSENA;8834899622;Taip;12;0;1;13
4428;Lašelis;ŠYPSENA;1070067484;Taip;10;0;1;11
4429;Lašelis;ŠYPSENA;4805028666;Taip;6;0;1;7
4430;Lašelis;ŠYPSENA;1511922965;Taip;1;0;0;1
4431;Lašelis;NYKŠTUKAI;1426555166;Taip;23;0;0;23
4432;Lašelis;NYKŠTUKAI;2509469243;Taip;0;11;0;11
4433;Lašelis;NYKŠTUKAI;4832223461;Taip;3;0;1;4
4434;Lašelis;NYKŠTUKAI;5416590600;Taip;0;11;0;11
4435;Lašelis;NYKŠTUKAI;1490179832;Ne;0;6;0;6
4436;Lašelis;NYKŠTUKAI;3995905195;Taip;0;23;0;23
4437;Lašelis;NYKŠTUKAI;1808067249;Ne;11;2;0;13
4438;Lašelis;NYKŠTUKAI;1060784180;Taip;0;1;0;1
4439;Lašelis;NYKŠTUKAI;6137626795;Ne;5;0;0;5
4440;Lašelis;NYKŠTUKAI;1635921119;Ne;0;1;0;1
4441;Lašelis;NYKŠTUKAI;4933598046;Taip;6;0;1;7
4442;Lašelis;NYKŠTUKAI;9664015801;Taip;0;5;0;5
4443;Lašelis;NYKŠTUKAI;1983312896;Taip;4;2;0;6
4444;Lašelis;NYKŠTUKAI;1279052767;Ne;7;0;1;8
4445;Lašelis;NYKŠTUKAI;8906479495;Taip;15;0;2;17
4446;Lašelis;NYKŠTUKAI;2606193652;Ne;0;1;0;1
4447;Lašelis;NYKŠTUKAI;9434932943;Taip;14;3;0;17
4448;Lašelis;NYKŠTUKAI;2593126568;Taip;0;0;6;6
4449;Lašelis;SAULUTĖ;3495676199;Taip;1;0;0;1
4450;Lašelis;SAULUTĖ;1085950130;Taip;0;0;1;1
4451;Lašelis;SAULUTĖ;1175045927;Taip;0;5;0;5
4452;Lašelis;SAULUTĖ;5931015581;Taip;2;0;0;2
4453;Lašelis;SAULUTĖ;1244168190;Taip;1;0;0;1
4454;Lašelis;SAULUTĖ;4566547120;Taip;0;2;0;2
4455;Lašelis;SAULUTĖ;9647340725;Ne;9;1;0;10
4456;Lašelis;SAULUTĖ;1042560186;Taip;0;9;0;9
4457;Lašelis;SAULUTĖ;1035888733;Taip;3;0;0;3
4458;Lašelis;SAULUTĖ;1926439959;Taip;2;2;0;4
4459;Lašelis;SAULUTĖ;4508779926;Taip;1;4;1;6
4460;Lašelis;SAULUTĖ;1415345442;Taip;8;1;0;9
4461;Lašelis;SAULUTĖ;8318512396;Taip;0;5;0;5
4462;Lašelis;SAULUTĖ;2223293390;Taip;2;0;1;3
4463;Lašelis;SAULUTĖ;3805049682;Taip;19;0;0;19
4464;Lašelis;SAULUTĖ;3675606390;Taip;5;7;0;12
4465;Lašelis;BORUŽĖLĖS;3180139334;Taip;0;2;0;2
4466;Lašelis;BORUŽĖLĖS;5000188106;Ne;13;0;0;13
4467;Lašelis;BORUŽĖLĖS;6203027620;Taip;7;0;0;7
4468;Lašelis;BORUŽĖLĖS;7619426839;Ne;15;0;0;15
4469;Lašelis;BORUŽĖLĖS;8718481664;Taip;9;0;0;9
4470;Lašelis;BORUŽĖLĖS;2871149756;Taip;13;0;0;13
4471;Lašelis;BORUŽĖLĖS;7920615797;Ne;10;0;0;10
4472;Lašelis;BORUŽĖLĖS;8212250478;Taip;4;9;0;13
4473;Lašelis;BORUŽĖLĖS;1675784376;Taip;14;0;0;14
4474;Lašelis;BORUŽĖLĖS;6275226824;Taip;2;0;0;2
4475;Lašelis;BORUŽĖLĖS;6751223169;Taip;3;0;0;3
4476;Lašelis;BORUŽĖLĖS;7432843976;Taip;9;0;0;9
4477;Lašelis;BORUŽĖLĖS;3567172061;Ne;13;0;0;13
4478;Lašelis;BORUŽĖLĖS;3183193902;Ne;10;2;0;12
4479;Lašelis;BORUŽĖLĖS;8063361528;Taip;8;0;0;8
4480;Lašelis;BORUŽĖLĖS;9879208797;Ne;14;0;0;14
4481;Lašelis;SKRUZDELIUKAI;5535348173;Taip;5;0;0;5
4482;Lašelis;SKRUZDELIUKAI;7704247097;Taip;10;0;0;10
4483;Lašelis;SKRUZDELIUKAI;4571213887;Taip;7;0;0;7
4484;Lašelis;SKRUZDELIUKAI;7367252046;Taip;2;0;0;2
4485;Lašelis;SKRUZDELIUKAI;9364834089;Taip;17;0;0;17
4486;Lašelis;SKRUZDELIUKAI;2200081600;Taip;15;0;0;15
4487;Lašelis;SKRUZDELIUKAI;6130824517;Taip;7;4;0;11
4488;Lašelis;SKRUZDELIUKAI;9905868465;Taip;7;0;0;7
4489;Lašelis;SKRUZDELIUKAI;6947939251;Taip;13;0;1;14
4490;Lašelis;SKRUZDELIUKAI;9394906598;Taip;9;0;0;9
4491;Lašelis;SKRUZDELIUKAI;9976394850;Ne;13;2;0;15
4492;Lašelis;SKRUZDELIUKAI;7610658433;Taip;15;0;0;15
4493;Lašelis;SKRUZDELIUKAI;4802629905;Ne;9;0;0;9
4494;Lašelis;SKRUZDELIUKAI;4487717519;Taip;8;0;0;8
4495;Lazdynėlis;BITUTĖS;1748260780;Taip;8;4;0;12
4496;Lazdynėlis;BITUTĖS;2044188250;Taip;4;4;0;8
4497;Lazdynėlis;BITUTĖS;2032759165;Taip;4;2;0;6
4498;Lazdynėlis;BITUTĖS;4545757725;Taip;5;1;0;6
4499;Lazdynėlis;BITUTĖS;4153294595;Taip;1;0;0;1
4500;Lazdynėlis;BITUTĖS;7910561870;Taip;8;4;0;12
4501;Lazdynėlis;BITUTĖS;6963058612;Taip;0;2;0;2
4502;Lazdynėlis;BITUTĖS;9761942869;Taip;0;4;0;4
4503;Lazdynėlis;BITUTĖS;6276697479;Taip;0;1;0;1
4504;Lazdynėlis;BITUTĖS;9886856760;Taip;0;23;0;23
4505;Lazdynėlis;BITUTĖS;2998606948;Taip;0;23;0;23
4506;Lazdynėlis;BITUTĖS;6415858184;Taip;3;0;0;3
4507;Lazdynėlis;BITUTĖS;5796381191;Ne;12;4;0;16
4508;Lazdynėlis;BITUTĖS;4771173060;Taip;10;0;0;10
4509;Lazdynėlis;BITUTĖS;1355954767;Taip;1;1;0;2
4510;Lazdynėlis;BITUTĖS;1070172991;Taip;0;4;0;4
4511;Lazdynėlis;EŽIUKAI;3040417651;Taip;1;4;0;5
4512;Lazdynėlis;EŽIUKAI;6021387236;Taip;0;0;3;3
4513;Lazdynėlis;EŽIUKAI;7945472048;Taip;8;0;0;8
4514;Lazdynėlis;EŽIUKAI;1168433014;Taip;0;17;1;18
4515;Lazdynėlis;EŽIUKAI;7655218276;Taip;7;2;0;9
4516;Lazdynėlis;EŽIUKAI;6031442797;Taip;0;9;0;9
4517;Lazdynėlis;EŽIUKAI;3764854654;Taip;0;0;3;3
4518;Lazdynėlis;EŽIUKAI;5832624944;Taip;7;6;0;13
4519;Lazdynėlis;EŽIUKAI;1499729462;Taip;7;1;0;8
4520;Lazdynėlis;EŽIUKAI;2294873565;Taip;0;4;0;4
4521;Lazdynėlis;EŽIUKAI;2911152510;Taip;2;2;0;4
4522;Lazdynėlis;EŽIUKAI;4745610579;Taip;0;0;1;1
4523;Lazdynėlis;EŽIUKAI;6817162699;Taip;3;0;2;5
4524;Lazdynėlis;EŽIUKAI;7552873109;Taip;17;5;0;22
4525;Lazdynėlis;EŽIUKAI;2933025284;Taip;0;5;0;5
4526;Lazdynėlis;EŽIUKAI;1961540377;Taip;0;0;1;1
4527;Lazdynėlis;BORUŽIUKAI;8337458289;Taip;0;23;0;23
4528;Lazdynėlis;BORUŽIUKAI;7692056055;Taip;8;4;0;12
4529;Lazdynėlis;BORUŽIUKAI;6394994841;Taip;2;1;0;3
4530;Lazdynėlis;BORUŽIUKAI;2009941344;Taip;5;3;0;8
4531;Lazdynėlis;BORUŽIUKAI;1653216959;Taip;7;0;0;7
4532;Lazdynėlis;BORUŽIUKAI;4190852647;Taip;13;0;0;13
4533;Lazdynėlis;BORUŽIUKAI;2058909635;Taip;0;23;0;23
4534;Lazdynėlis;BORUŽIUKAI;3105363578;Taip;0;23;0;23
4535;Lazdynėlis;BORUŽIUKAI;5622254334;Taip;8;0;0;8
4536;Lazdynėlis;BORUŽIUKAI;7587041613;Taip;14;0;0;14
4537;Lazdynėlis;BORUŽIUKAI;2632078843;Taip;21;0;0;21
4538;Lazdynėlis;BORUŽIUKAI;5756228709;Taip;11;2;0;13
4539;Lazdynėlis;BORUŽIUKAI;6824473598;Taip;0;6;0;6
4540;Lazdynėlis;BORUŽIUKAI;1707231039;Taip;0;23;0;23
4541;Lazdynėlis;BORUŽIUKAI;6413861274;Taip;9;0;0;9
4542;Lazdynėlis;BORUŽIUKAI;8030743153;Taip;3;0;0;3
4543;Lazdynėlis;BORUŽIUKAI;4642875037;Taip;7;3;0;10
4544;Lazdynėlis;BORUŽIUKAI;1722503577;Taip;0;1;0;1
4545;Lazdynėlis;BORUŽIUKAI;4595080695;Taip;0;23;0;23
4546;Lazdynėlis;BORUŽIUKAI;4958640516;Taip;9;0;0;9
4547;Lazdynėlis;BORUŽIUKAI;3351966091;Taip;0;23;0;23
4548;Lazdynėlis;BORUŽIUKAI;9548866880;Taip;0;1;0;1
4549;Lazdynėlis;BORUŽIUKAI;4266414341;Taip;0;1;0;1
4550;Lazdynėlis;BORUŽIUKAI;6633585181;Taip;5;0;0;5
4551;Lazdynėlis;KAČIUKAI;2958520599;Taip;4;3;0;7
4552;Lazdynėlis;KAČIUKAI;2013752858;Taip;0;1;1;2
4553;Lazdynėlis;KAČIUKAI;2586187455;Taip;4;2;0;6
4554;Lazdynėlis;KAČIUKAI;1450181711;Ne;0;0;3;3
4555;Lazdynėlis;KAČIUKAI;7911328294;Taip;0;1;0;1
4556;Lazdynėlis;KAČIUKAI;5562900372;Taip;0;0;4;4
4557;Lazdynėlis;KAČIUKAI;4881322530;Taip;0;4;3;7
4558;Lazdynėlis;KAČIUKAI;8159928299;Taip;0;0;2;2
4559;Lazdynėlis;KAČIUKAI;1574847460;Taip;0;2;0;2
4560;Lazdynėlis;KAČIUKAI;4462819848;Taip;0;9;0;9
4561;Lazdynėlis;KAČIUKAI;9693153118;Taip;5;4;1;10
4562;Lazdynėlis;KAČIUKAI;7719697394;Taip;0;6;0;6
4563;Lazdynėlis;KAČIUKAI;4055450300;Taip;5;1;0;6
4564;Lazdynėlis;KAČIUKAI;3362193379;Taip;0;4;2;6
4565;Lazdynėlis;KAČIUKAI;6056618348;Taip;0;1;0;1
4566;Lazdynėlis;KAČIUKAI;3667994076;Taip;0;3;1;4
4567;Lazdynėlis;KAČIUKAI;1668899344;Taip;4;3;0;7
4568;Lazdynėlis;VOVERIUKAI;4747688220;Taip;0;1;0;1
4569;Lazdynėlis;VOVERIUKAI;1312649234;Taip;0;4;0;4
4570;Lazdynėlis;VOVERIUKAI;9362249595;Taip;0;2;1;3
4571;Lazdynėlis;VOVERIUKAI;3097254722;Taip;6;10;0;16
4572;Lazdynėlis;VOVERIUKAI;6352480127;Taip;0;0;1;1
4573;Lazdynėlis;VOVERIUKAI;6814362584;Taip;0;1;1;2
4574;Lazdynėlis;VOVERIUKAI;4293473176;Taip;0;4;0;4
4575;Lazdynėlis;VOVERIUKAI;2723284353;Taip;6;1;0;7
4576;Lazdynėlis;VOVERIUKAI;9219327706;Taip;0;5;0;5
4577;Lazdynėlis;VOVERIUKAI;9548653584;Taip;0;3;0;3
4578;Lazdynėlis;VOVERIUKAI;6008610525;Taip;0;5;0;5
4579;Lazdynėlis;VOVERIUKAI;3879017767;Taip;0;1;0;1
4580;Lazdynėlis;VOVERIUKAI;4031719765;Taip;0;1;0;1
4581;Lazdynėlis;VOVERIUKAI;7006931682;Taip;4;4;1;9
4582;Lazdynėlis;VOVERIUKAI;6582898708;Taip;4;0;0;4
4583;Lazdynėlis;RIEŠUTĖLIAI;3086059608;Taip;7;1;1;9
4584;Lazdynėlis;RIEŠUTĖLIAI;5987500024;Taip;5;0;0;5
4585;Lazdynėlis;RIEŠUTĖLIAI;2453740823;Taip;5;1;0;6
4586;Lazdynėlis;RIEŠUTĖLIAI;4552505857;Taip;0;4;0;4
4587;Lazdynėlis;RIEŠUTĖLIAI;7545621720;Taip;4;1;0;5
4588;Lazdynėlis;RIEŠUTĖLIAI;9810842975;Taip;4;0;0;4
4589;Lazdynėlis;RIEŠUTĖLIAI;8179584161;Taip;4;0;0;4
4590;Lazdynėlis;RIEŠUTĖLIAI;3239107488;Ne;0;1;0;1
4591;Lazdynėlis;RIEŠUTĖLIAI;8942906327;Taip;3;1;0;4
4592;Lazdynėlis;RIEŠUTĖLIAI;9582702244;Taip;4;0;0;4
4593;Lazdynėlis;RIEŠUTĖLIAI;7523052754;Taip;0;1;0;1
4594;Lazdynėlis;RIEŠUTĖLIAI;4092363029;Taip;0;2;0;2
4595;Lazdynėlis;RIEŠUTĖLIAI;3250913116;Taip;2;1;0;3
4596;Lazdynėlis;RIEŠUTĖLIAI;8529192130;Taip;0;1;6;7
4597;Lazdynėlis;RIEŠUTĖLIAI;5354852979;Taip;6;0;0;6
4598;Lazdynėlis;RIEŠUTĖLIAI;6831456807;Taip;7;0;0;7
4599;Lazdynėlis;RIEŠUTĖLIAI;7754329238;Taip;4;1;0;5
4600;Lazdynėlis;RIEŠUTĖLIAI;1488371861;Taip;8;1;0;9
4601;Lazdynėlis;ANČIUKAI;3587681925;Taip;9;0;0;9
4602;Lazdynėlis;ANČIUKAI;4183342119;Taip;10;0;0;10
4603;Lazdynėlis;ANČIUKAI;8978670259;Taip;6;0;0;6
4604;Lazdynėlis;ANČIUKAI;4189563297;Taip;3;0;1;4
4605;Lazdynėlis;ANČIUKAI;2416662141;Taip;1;2;0;3
4606;Lazdynėlis;ANČIUKAI;6575706614;Taip;3;0;0;3
4607;Lazdynėlis;ANČIUKAI;6284781209;Taip;8;0;0;8
4608;Lazdynėlis;ANČIUKAI;7646625115;Taip;10;0;0;10
4609;Lazdynėlis;ANČIUKAI;1246581188;Taip;2;7;0;9
4610;Lazdynėlis;ANČIUKAI;7261983723;Taip;12;4;0;16
4611;Lazdynėlis;ANČIUKAI;7386794107;Taip;12;0;0;12
4612;Lazdynėlis;ANČIUKAI;9724741469;Taip;13;0;0;13
4613;Lazdynėlis;ANČIUKAI;3060705012;Taip;8;1;0;9
4614;Lazdynėlis;GUDRUČIAI;9407743178;Taip;0;0;1;1
4615;Lazdynėlis;GUDRUČIAI;3357092509;Taip;6;1;1;8
4616;Lazdynėlis;GUDRUČIAI;6994408527;Taip;1;4;0;5
4617;Lazdynėlis;GUDRUČIAI;2514035189;Taip;2;2;0;4
4618;Lazdynėlis;GUDRUČIAI;5889772626;Taip;0;4;3;7
4619;Lazdynėlis;GUDRUČIAI;6559543013;Taip;5;3;1;9
4620;Lazdynėlis;GUDRUČIAI;9231049001;Taip;0;4;0;4
4621;Lazdynėlis;GUDRUČIAI;6164180360;Taip;0;4;1;5
4622;Lazdynėlis;GUDRUČIAI;8159724466;Taip;0;0;1;1
4623;Lazdynėlis;GUDRUČIAI;3062408541;Taip;0;2;0;2
4624;Lazdynėlis;GUDRUČIAI;3779983775;Taip;0;12;0;12
4625;Lazdynėlis;GUDRUČIAI;5051632567;Ne;4;0;0;4
4626;Lazdynėlis;GUDRUČIAI;4550819172;Taip;0;1;0;1
4627;Lazdynėlis;GUDRUČIAI;8314002741;Taip;2;0;0;2
4628;Lazdynėlis;GUDRUČIAI;3365726271;Taip;3;0;0;3
4629;Lazdynėlis;GUDRUČIAI;7941793866;Taip;0;7;0;7
4630;Lazdynėlis;MEŠKIUKAI;4094713096;Taip;7;0;0;7
4631;Lazdynėlis;MEŠKIUKAI;3427972329;Taip;4;4;0;8
4632;Lazdynėlis;MEŠKIUKAI;6941986839;Taip;9;0;0;9
4633;Lazdynėlis;MEŠKIUKAI;3697808826;Taip;0;2;1;3
4634;Lazdynėlis;MEŠKIUKAI;9590507486;Taip;2;0;0;2
4635;Lazdynėlis;MEŠKIUKAI;5982766841;Taip;0;23;0;23
4636;Lazdynėlis;MEŠKIUKAI;1984546310;Taip;0;3;0;3
4637;Lazdynėlis;MEŠKIUKAI;4408660083;Taip;2;0;1;3
4638;Lazdynėlis;MEŠKIUKAI;8567304224;Taip;3;0;0;3
4639;Lazdynėlis;MEŠKIUKAI;4366502064;Taip;3;0;0;3
4640;Lazdynėlis;MEŠKIUKAI;8473007295;Taip;15;0;0;15
4641;Liepsnelė;"NAUJA NYKŠTUKAI";1924079984;Ne;4;0;0;4
4642;Markučiai;Žirniukų;3525681034;Taip;4;0;0;4
4643;Markučiai;Žirniukų;7312533881;Taip;4;0;0;4
4644;Markučiai;Žirniukų;8934965409;Taip;4;5;0;9
4645;Markučiai;Žirniukų;8360526946;Taip;8;8;0;16
4646;Markučiai;Žirniukų;7244815252;Taip;7;4;0;11
4647;Markučiai;Žirniukų;2096169972;Taip;1;4;0;5
4648;Markučiai;Žirniukų;3073404128;Taip;0;1;0;1
4649;Markučiai;Žirniukų;5614488534;Taip;8;5;0;13
4650;Markučiai;Žirniukų;2367999201;Taip;5;0;0;5
4651;Markučiai;Žirniukų;4242575616;Taip;1;0;0;1
4652;Markučiai;Žirniukų;2099285475;Taip;6;4;0;10
4653;Markučiai;Žirniukų;2344252204;Ne;12;1;0;13
4654;Markučiai;Žirniukų;9576412366;Taip;10;4;0;14
4655;Markučiai;Žirniukų;1395241501;Taip;18;0;0;18
4656;Markučiai;Žirniukų;2539486337;Taip;7;0;0;7
4657;Markučiai;Žirniukų;8046320044;Ne;14;0;0;14
4658;Markučiai;Žirniukų;2060024771;Taip;14;0;0;14
4659;Markučiai;Žirniukų;6815286823;Taip;9;0;0;9
4660;Markučiai;Nykštukų;7507551844;Taip;1;0;0;1
4661;Markučiai;Nykštukų;9545967631;Taip;0;4;0;4
4662;Markučiai;Nykštukų;6121911851;Taip;1;0;0;1
4663;Markučiai;Nykštukų;6898055631;Taip;4;1;0;5
4664;Markučiai;Nykštukų;3378749042;Taip;7;8;0;15
4665;Markučiai;Nykštukų;4485929800;Taip;1;0;0;1
4666;Markučiai;Nykštukų;5183244346;Taip;0;1;0;1
4667;Markučiai;Nykštukų;7624913025;Taip;0;11;0;11
4668;Markučiai;Nykštukų;4679710493;Taip;1;0;0;1
4669;Markučiai;Nykštukų;2994895532;Taip;2;4;0;6
4670;Markučiai;Nykštukų;4846899377;Taip;6;1;0;7
4671;Markučiai;Nykštukų;4150956779;Taip;0;4;0;4
4672;Markučiai;Nykštukų;7680126946;Ne;16;0;0;16
4673;Markučiai;Nykštukų;4222017733;Taip;4;0;0;4
4674;Markučiai;Nykštukų;3414015064;Taip;5;0;0;5
4675;Markučiai;Nykštukų;7642401516;Taip;0;5;0;5
4676;Markučiai;Nykštukų;8055783293;Taip;0;6;0;6
4677;Markučiai;Pelėdžiukų;9180404247;Taip;2;0;0;2
4678;Markučiai;Pelėdžiukų;3386071459;Taip;0;8;0;8
4679;Markučiai;Pelėdžiukų;4653663237;Taip;0;0;1;1
4680;Markučiai;Pelėdžiukų;5727655114;Taip;1;0;0;1
4681;Markučiai;Pelėdžiukų;7947287013;Taip;0;0;1;1
4682;Markučiai;Pelėdžiukų;4418580273;Taip;18;0;0;18
4683;Markučiai;Pelėdžiukų;5522654429;Taip;5;0;0;5
4684;Markučiai;Pelėdžiukų;9219710045;Taip;2;0;1;3
4685;Markučiai;Pelėdžiukų;7539605426;Taip;2;0;1;3
4686;Markučiai;Pelėdžiukų;8888538915;Taip;0;0;2;2
4687;Markučiai;Pelėdžiukų;1799946177;Taip;2;0;0;2
4688;Markučiai;Pelėdžiukų;7809719827;Taip;0;1;1;2
4689;Markučiai;Pelėdžiukų;4860961508;Taip;2;4;0;6
4690;Markučiai;Pelėdžiukų;6569807889;Taip;5;0;3;8
4691;Markučiai;Pelėdžiukų;5269411010;Taip;3;0;0;3
4692;Markučiai;Pelėdžiukų;1524727903;Taip;9;0;0;9
4693;Markučiai;Pelėdžiukų;1622197135;Ne;4;0;4;8
4694;Markučiai;Pelėdžiukų;8839679529;Taip;5;0;2;7
4695;Markučiai;Boružėlių;1171899107;Taip;5;9;0;14
4696;Markučiai;Boružėlių;8078777204;Taip;9;8;0;17
4697;Markučiai;Boružėlių;8244065962;Taip;0;1;0;1
4698;Markučiai;Boružėlių;5981692282;Taip;8;4;0;12
4699;Markučiai;Boružėlių;3739566642;Taip;20;2;0;22
4700;Markučiai;Boružėlių;6868394315;Taip;0;4;0;4
4701;Markučiai;Boružėlių;7634475536;Ne;4;2;0;6
4702;Markučiai;Boružėlių;5663147778;Taip;7;4;0;11
4703;Markučiai;Boružėlių;8271830626;Taip;2;4;0;6
4704;Markučiai;Boružėlių;3315824027;Taip;20;4;0;24
4705;Markučiai;Boružėlių;5562960498;Taip;13;4;0;17
4706;Markučiai;Boružėlių;6260010822;Taip;4;4;0;8
4707;Markučiai;Boružėlių;6740434675;Taip;4;0;0;4
4708;Markučiai;Boružėlių;6707310242;Taip;2;2;1;5
4709;Markučiai;Boružėlių;9631684972;Taip;0;1;0;1
4710;Markučiai;Boružėlių;4911787595;Taip;1;4;0;5
4711;Markučiai;Boružėlių;1587323435;Taip;0;33;0;33
4712;Markučiai;Bitučių;8792524832;Taip;0;6;0;6
4713;Markučiai;Bitučių;9518247571;Taip;0;5;0;5
4714;Markučiai;Bitučių;4836298058;Taip;0;6;1;7
4715;Markučiai;Bitučių;9027071539;Taip;0;5;0;5
4716;Markučiai;Bitučių;8748794886;Taip;0;4;2;6
4717;Markučiai;Bitučių;7387460586;Taip;6;2;0;8
4718;Markučiai;Bitučių;8950442843;Taip;4;4;1;9
4719;Markučiai;Bitučių;3926993383;Taip;7;3;0;10
4720;Markučiai;Bitučių;6530101961;Taip;4;2;3;9
4721;Markučiai;Bitučių;1908302738;Taip;0;4;2;6
4722;Markučiai;Bitučių;7056367646;Taip;9;4;1;14
4723;Markučiai;Bitučių;8195584468;Taip;0;4;0;4
4724;Markučiai;Bitučių;2049497686;Taip;0;4;0;4
4725;Markučiai;Bitučių;8541042547;Taip;0;4;1;5
4726;Markučiai;Bitučių;1447116821;Taip;0;3;3;6
4727;Markučiai;Bitučių;2931958829;Taip;0;4;1;5
4728;Markučiai;Bitučių;9303448709;Taip;0;4;6;10
4729;Markučiai;Drugelių;2537459830;Taip;4;0;1;5
4730;Markučiai;Drugelių;2288910885;Taip;9;1;0;10
4731;Markučiai;Drugelių;3544565354;Taip;12;0;1;13
4732;Markučiai;Drugelių;6992161129;Taip;4;0;0;4
4733;Markučiai;Drugelių;9412129807;Taip;13;3;0;16
4734;Markučiai;Drugelių;6979218594;Taip;7;0;0;7
4735;Markučiai;Drugelių;3491734422;Taip;0;0;5;5
4736;Markučiai;Drugelių;3491734422;Taip;0;0;5;5
4737;Markučiai;Drugelių;3491734422;Taip;0;0;5;5
4738;Markučiai;Drugelių;3832641521;Taip;14;0;2;16
4739;Markučiai;Drugelių;4520724770;Taip;8;0;0;8
4740;Markučiai;Drugelių;8050852518;Taip;0;0;1;1
4741;Markučiai;Drugelių;9391866085;Taip;13;0;1;14
4742;Markučiai;Drugelių;9073616238;Taip;8;0;0;8
4743;Markučiai;Drugelių;2967726802;Taip;14;0;0;14
4744;Markučiai;Drugelių;6684544229;Taip;5;0;0;5
4745;Markučiai;Drugelių;3487571241;Taip;9;0;1;10
4746;Markučiai;Drugelių;1433469476;Taip;1;9;0;10
4747;Markučiai;Drugelių;7110705287;Taip;7;0;1;8
4748;Markučiai;Drugelių;6055822200;Taip;2;0;0;2
4749;Markučiai;Skruzdėliukų;5566529492;Taip;1;0;0;1
4750;Markučiai;Skruzdėliukų;8105747904;Taip;10;0;0;10
4751;Markučiai;Skruzdėliukų;6617799980;Taip;0;8;0;8
4752;Markučiai;Skruzdėliukų;7580249913;Taip;4;0;0;4
4753;Markučiai;Skruzdėliukų;2246646548;Taip;12;0;0;12
4754;Markučiai;Skruzdėliukų;9921530582;Taip;2;0;0;2
4755;Markučiai;Skruzdėliukų;6759427415;Taip;0;23;0;23
4756;Markučiai;Skruzdėliukų;4820576711;Taip;5;0;0;5
4757;Markučiai;Skruzdėliukų;1527620947;Taip;19;0;0;19
4758;Markučiai;Skruzdėliukų;8774323234;Taip;1;0;0;1
4759;Markučiai;Skruzdėliukų;7881183912;Taip;3;4;0;7
4760;Markučiai;Skruzdėliukų;9338996275;Taip;14;0;0;14
4761;Markučiai;Skruzdėliukų;4383128686;Taip;1;0;0;1
4762;Markučiai;Skruzdėliukų;8679791696;Taip;9;4;0;13
4763;Markučiai;Skruzdėliukų;2647189399;Taip;9;0;0;9
4764;Markučiai;Skruzdėliukų;3077125574;Taip;5;4;0;9
4765;Markučiai;Skruzdėliukų;1711102751;Taip;7;0;0;7
4766;Markučiai;ZUIKUČIŲ;8722494948;Taip;11;0;0;11
4767;Markučiai;ZUIKUČIŲ;8649978914;Taip;14;5;0;19
4768;Markučiai;ZUIKUČIŲ;6415773081;Taip;4;0;0;4
4769;Markučiai;ZUIKUČIŲ;5027052978;Taip;1;0;0;1
4770;Markučiai;ZUIKUČIŲ;9143465340;Taip;2;0;0;2
4771;Markučiai;ZUIKUČIŲ;8921802809;Taip;10;0;0;10
4772;Markučiai;ZUIKUČIŲ;8811544042;Taip;8;0;0;8
4773;Markučiai;ZUIKUČIŲ;7307805203;Taip;4;0;0;4
4774;Markučiai;ZUIKUČIŲ;1632196228;Taip;1;0;0;1
4775;Markučiai;ZUIKUČIŲ;7704433720;Taip;8;0;0;8
4776;Markučiai;ZUIKUČIŲ;2937486382;Taip;6;1;0;7
4777;Markučiai;ŽIOGELIŲ;3859363657;Taip;7;0;0;7
4778;Markučiai;ŽIOGELIŲ;3306931221;Taip;0;1;1;2
4779;Markučiai;ŽIOGELIŲ;9249362647;Taip;2;0;0;2
4780;Markučiai;ŽIOGELIŲ;7425442727;Taip;10;0;0;10
4781;Markučiai;ŽIOGELIŲ;3918398890;Taip;14;0;0;14
4782;Markučiai;ŽIOGELIŲ;6293219533;Taip;2;0;1;3
4783;Markučiai;ŽIOGELIŲ;9395009057;Taip;3;0;3;6
4784;Markučiai;ŽIOGELIŲ;4306059458;Taip;9;0;1;10
4785;Markučiai;ŽIOGELIŲ;5934853242;Taip;10;0;1;11
4786;Markučiai;ŽIOGELIŲ;1989450429;Taip;2;0;4;6
4787;Markučiai;ŽIOGELIŲ;6469869116;Ne;4;1;0;5
4788;Markučiai;ŽIOGELIŲ;7299207983;Taip;0;4;1;5
4789;Markučiai;ŽIOGELIŲ;5429666204;Taip;4;0;2;6
4790;Markučiai;Ežiukių;5474990334;Taip;18;0;0;18
4791;Markučiai;Ežiukių;4829322890;Taip;20;0;0;20
4792;Markučiai;Ežiukių;8045995558;Taip;19;0;0;19
4793;Markučiai;Ežiukių;3864391517;Taip;13;0;0;13
4794;Markučiai;Ežiukių;9448972984;Taip;13;0;1;14
4795;Markučiai;Ežiukių;9462937261;Taip;4;0;3;7
4796;Markučiai;Ežiukių;2109460312;Taip;2;0;1;3
4797;Markučiai;Ežiukių;2222934026;Ne;13;0;0;13
4798;Markučiai;Ežiukių;5096397215;Taip;9;0;0;9
4799;Markučiai;Ežiukių;7266459848;Taip;9;0;0;9
4800;Markučiai;Ežiukių;3942674807;Taip;8;0;1;9
4801;Markučiai;Ežiukių;8338320308;Taip;4;0;2;6
4802;Mažylis;"2 DARŽELIO GR.";8259994523;Taip;0;0;6;6
4803;Mažylis;"2 DARŽELIO GR.";4347489809;Taip;4;0;1;5
4804;Mažylis;"2 DARŽELIO GR.";4985161657;Taip;3;1;0;4
4805;Mažylis;"2 DARŽELIO GR.";5297935198;Taip;2;1;4;7
4806;Mažylis;"2 DARŽELIO GR.";1993916098;Taip;2;0;0;2
4807;Mažylis;"2 DARŽELIO GR.";8871998701;Taip;0;0;1;1
4808;Mažylis;"2 DARŽELIO GR.";3064367996;Taip;0;9;0;9
4809;Mažylis;"2 DARŽELIO GR.";6500577246;Taip;1;0;1;2
4810;Mažylis;"2 DARŽELIO GR.";4557902728;Taip;13;0;0;13
4811;Mažylis;"2 DARŽELIO GR.";3098913589;Taip;0;0;1;1
4812;Mažylis;"2 DARŽELIO GR.";4201114033;Taip;4;0;9;13
4813;Mažylis;"2 DARŽELIO GR.";3911343193;Taip;0;0;7;7
4814;Mažylis;"2 DARŽELIO GR.";5225388496;Taip;0;4;0;4
4815;Mažylis;"4 PRIEŠMOKYKLINĖ GR.";2979849055;Taip;0;0;1;1
4816;Mažylis;"4 PRIEŠMOKYKLINĖ GR.";6162880220;Taip;0;4;4;8
4817;Mažylis;"4 PRIEŠMOKYKLINĖ GR.";6009637985;Taip;0;0;3;3
4818;Mažylis;"4 PRIEŠMOKYKLINĖ GR.";1762105763;Taip;0;4;0;4
4819;Mažylis;"4 PRIEŠMOKYKLINĖ GR.";2672500259;Taip;0;0;2;2
4820;Mažylis;"4 PRIEŠMOKYKLINĖ GR.";2935175014;Taip;8;0;1;9
4821;Mažylis;"4 PRIEŠMOKYKLINĖ GR.";8135596731;Taip;0;0;2;2
4822;Mažylis;"4 PRIEŠMOKYKLINĖ GR.";8866980930;Taip;5;1;0;6
4823;Mažylis;"4 PRIEŠMOKYKLINĖ GR.";2704741847;Taip;0;4;0;4
4824;Mažylis;"4 PRIEŠMOKYKLINĖ GR.";8297427176;Taip;0;1;2;3
4825;Mažylis;"4 PRIEŠMOKYKLINĖ GR.";5870983755;Taip;1;0;1;2
4826;Mažylis;"4 PRIEŠMOKYKLINĖ GR.";3327673298;Taip;0;0;1;1
4827;Mažylis;"4 PRIEŠMOKYKLINĖ GR.";4280547746;Taip;3;4;3;10
4828;Mažylis;"4 PRIEŠMOKYKLINĖ GR.";9447747294;Taip;0;0;10;10
4829;Mažylis;"4 PRIEŠMOKYKLINĖ GR.";4542742002;Taip;0;0;4;4
4830;Mažylis;"4 PRIEŠMOKYKLINĖ GR.";2031457519;Taip;0;3;1;4
4831;Mažylis;"4 PRIEŠMOKYKLINĖ GR.";3308427647;Ne;6;4;1;11
4832;Mažylis;"4 PRIEŠMOKYKLINĖ GR.";7923522942;Taip;0;0;3;3
4833;Mažylis;"3 DARŽELIO GR.";6100650710;Taip;0;0;1;1
4834;Mažylis;"3 DARŽELIO GR.";9401388775;Taip;0;0;7;7
4835;Mažylis;"3 DARŽELIO GR.";4817146074;Taip;1;0;0;1
4836;Mažylis;"3 DARŽELIO GR.";7106648054;Taip;5;0;0;5
4837;Mažylis;"3 DARŽELIO GR.";6809320247;Taip;0;3;2;5
4838;Mažylis;"3 DARŽELIO GR.";2006289999;Taip;3;0;1;4
4839;Mažylis;"3 DARŽELIO GR.";7652390515;Taip;0;0;9;9
4840;Mažylis;"3 DARŽELIO GR.";8639480781;Taip;0;4;0;4
4841;Mažylis;"3 DARŽELIO GR.";9341935211;Taip;0;0;3;3
4842;Mažylis;"3 DARŽELIO GR.";2989562406;Taip;10;0;1;11
4843;Mažylis;"3 DARŽELIO GR.";1151737098;Taip;6;4;1;11
4844;Mažylis;"3 DARŽELIO GR.";7642914458;Taip;1;4;0;5
4845;Mažylis;"3 DARŽELIO GR.";5938312001;Taip;7;0;0;7
4846;Mažylis;"3 DARŽELIO GR.";2119733659;Taip;21;0;0;21
4847;Mažylis;"3 DARŽELIO GR.";2319506343;Taip;0;0;6;6
4848;Mažylis;"3 DARŽELIO GR.";9416161833;Taip;2;0;0;2
4849;Mažylis;"3 DARŽELIO GR.";9807376076;Ne;4;0;0;4
4850;Mažylis;"3 DARŽELIO GR.";4592795281;Taip;10;0;2;12
4851;Mažylis;"6 DARŽELIO GR.";5388105083;Taip;5;0;1;6
4852;Mažylis;"6 DARŽELIO GR.";8589124394;Taip;10;0;2;12
4853;Mažylis;"6 DARŽELIO GR.";3641990617;Taip;0;4;0;4
4854;Mažylis;"6 DARŽELIO GR.";1892136590;Taip;0;4;1;5
4855;Mažylis;"6 DARŽELIO GR.";9479398581;Taip;0;4;0;4
4856;Mažylis;"6 DARŽELIO GR.";1381828313;Taip;0;0;3;3
4857;Mažylis;"6 DARŽELIO GR.";7725286603;Taip;0;4;4;8
4858;Mažylis;"6 DARŽELIO GR.";3615636349;Taip;0;0;1;1
4859;Mažylis;"6 DARŽELIO GR.";9894955253;Taip;0;0;10;10
4860;Mažylis;"6 DARŽELIO GR.";3400122626;Taip;0;0;2;2
4861;Mažylis;"6 DARŽELIO GR.";4100492642;Taip;5;0;3;8
4862;Mažylis;"6 DARŽELIO GR.";5569913242;Taip;4;0;0;4
4863;Mažylis;"6 DARŽELIO GR.";7841955949;Taip;0;0;12;12
4864;Mažylis;"6 DARŽELIO GR.";6492768766;Ne;10;0;0;10
4865;Mažylis;"6 DARŽELIO GR.";6423910850;Taip;0;2;3;5
4866;Mažylis;"6 DARŽELIO GR.";1555305826;Taip;0;0;4;4
4867;Mažylis;"6 DARŽELIO GR.";5977423702;Taip;4;0;1;5
4868;Mažylis;"6 DARŽELIO GR.";9562863405;Taip;0;0;7;7
4869;Mažylis;"6 DARŽELIO GR.";5990843024;Taip;0;0;12;12
4870;Mažylis;"6 DARŽELIO GR.";9981751097;Taip;10;0;0;10
4871;Mažylis;"6 DARŽELIO GR.";5137132420;Taip;2;0;0;2
4872;Mažylis;"1 NAUJA (LOPŠELIS)";1233510409;Taip;5;0;1;6
4873;Mažylis;"1 NAUJA (LOPŠELIS)";4688933880;Taip;3;0;3;6
4874;Mažylis;"1 NAUJA (LOPŠELIS)";5683455589;Taip;0;0;4;4
4875;Mažylis;"1 NAUJA (LOPŠELIS)";6441787213;Taip;5;0;1;6
4876;Mažylis;"1 NAUJA (LOPŠELIS)";1578050891;Taip;0;0;21;21
4877;Mažylis;"1 NAUJA (LOPŠELIS)";4828287511;Taip;0;0;5;5
4878;Mažylis;"1 NAUJA (LOPŠELIS)";8084695989;Taip;0;0;5;5
4879;Mažylis;"1 NAUJA (LOPŠELIS)";9416048380;Taip;10;0;0;10
4880;Mažylis;"1 NAUJA (LOPŠELIS)";2159387617;Taip;0;0;2;2
4881;Mažylis;"1 NAUJA (LOPŠELIS)";1174743283;Taip;0;0;1;1
4882;Mažylis;"1 NAUJA (LOPŠELIS)";3898781037;Taip;0;4;13;17
4883;Mažylis;"1 NAUJA (LOPŠELIS)";7940550309;Taip;5;0;4;9
4884;Mažylis;"1 NAUJA (LOPŠELIS)";2331014727;Taip;7;0;0;7
4885;Mažylis;"5 DARŽELIO GR.";8655053217;Taip;15;0;0;15
4886;Mažylis;"5 DARŽELIO GR.";1058725505;Taip;6;2;1;9
4887;Mažylis;"5 DARŽELIO GR.";4880415881;Taip;0;0;9;9
4888;Mažylis;"5 DARŽELIO GR.";9111101357;Taip;7;0;2;9
4889;Mažylis;"5 DARŽELIO GR.";6728351360;Taip;5;0;0;5
4890;Mažylis;"5 DARŽELIO GR.";6272047137;Taip;0;1;1;2
4891;Mažylis;"5 DARŽELIO GR.";7255856938;Taip;6;0;4;10
4892;Mažylis;"5 DARŽELIO GR.";2795618410;Taip;3;0;1;4
4893;Mažylis;"5 DARŽELIO GR.";4987487972;Taip;12;0;4;16
4894;Mažylis;"5 DARŽELIO GR.";2723677422;Taip;0;0;8;8
4895;Mažylis;"5 DARŽELIO GR.";7252955092;Taip;8;0;6;14
4896;Mažylis;"5 DARŽELIO GR.";3072841295;Taip;7;0;1;8
4897;Mažylis;"5 DARŽELIO GR.";4796712246;Taip;0;0;3;3
4898;Mažylis;"5 DARŽELIO GR.";3079202929;Taip;0;0;2;2
4899;Mažylis;"5 DARŽELIO GR.";7933156766;Taip;10;0;0;10
4900;Mažylis;"5 DARŽELIO GR.";7419432731;Taip;8;0;0;8
4901;Mažylis;"5 DARŽELIO GR.";2425437724;Taip;0;0;4;4
4902;Medynėlis;BITUTĖS;6238256156;Ne;0;6;0;6
4903;Medynėlis;BITUTĖS;8711567312;Taip;0;0;2;2
4904;Medynėlis;BITUTĖS;2993705115;Taip;0;6;1;7
4905;Medynėlis;BITUTĖS;1504612730;Taip;4;2;0;6
4906;Medynėlis;BITUTĖS;5522261530;Taip;0;2;0;2
4907;Medynėlis;BITUTĖS;6576401514;Taip;2;0;1;3
4908;Medynėlis;BITUTĖS;4107846958;Taip;0;5;2;7
4909;Medynėlis;BITUTĖS;7296044569;Taip;9;0;0;9
4910;Medynėlis;BITUTĖS;4418330478;Taip;2;0;0;2
4911;Medynėlis;BITUTĖS;7042766873;Taip;5;5;0;10
4912;Medynėlis;BITUTĖS;6074296305;Taip;3;0;0;3
4913;Medynėlis;BITUTĖS;6815521895;Taip;0;2;2;4
4914;Medynėlis;BITUTĖS;4374464298;Taip;0;2;0;2
4915;Medynėlis;BITUTĖS;8107171123;Taip;5;6;0;11
4916;Medynėlis;BITUTĖS;4545707752;Taip;6;0;1;7
4917;Medynėlis;BITUTĖS;4419503239;Taip;0;0;1;1
4918;Medynėlis;BITUTĖS;7870261906;Taip;4;2;0;6
4919;Medynėlis;BITUTĖS;6466874318;Taip;1;6;0;7
4920;Medynėlis;BITUTĖS;2798305000;Taip;2;3;0;5
4921;Medynėlis;BITUTĖS;4598267411;Taip;0;1;0;1
4922;Medynėlis;BITUTĖS;5194220650;Taip;15;0;0;15
4923;Medynėlis;DRUGELIAI;5551121950;Taip;2;2;0;4
4924;Medynėlis;DRUGELIAI;2627421550;Taip;1;4;0;5
4925;Medynėlis;DRUGELIAI;2794274146;Taip;2;0;0;2
4926;Medynėlis;DRUGELIAI;2932544910;Taip;7;0;0;7
4927;Medynėlis;DRUGELIAI;9079900803;Taip;5;0;0;5
4928;Medynėlis;DRUGELIAI;5571641847;Ne;1;0;0;1
4929;Medynėlis;DRUGELIAI;9355165862;Taip;3;2;0;5
4930;Medynėlis;DRUGELIAI;9184868565;Taip;0;1;0;1
4931;Medynėlis;DRUGELIAI;6706028300;Taip;2;0;0;2
4932;Medynėlis;DRUGELIAI;5785463517;Taip;1;0;0;1
4933;Medynėlis;DRUGELIAI;4468967036;Taip;0;4;0;4
4934;Medynėlis;DRUGELIAI;9438854582;Taip;1;4;0;5
4935;Medynėlis;DRUGELIAI;7501831333;Taip;0;6;0;6
4936;Medynėlis;DRUGELIAI;2097758483;Taip;2;0;0;2
4937;Medynėlis;DRUGELIAI;4267654911;Taip;1;1;0;2
4938;Medynėlis;SKRUZDĖLIUKAI;2218838971;Taip;9;0;0;9
4939;Medynėlis;SKRUZDĖLIUKAI;1206480760;Taip;20;0;0;20
4940;Medynėlis;SKRUZDĖLIUKAI;3790099536;Taip;5;0;0;5
4941;Medynėlis;SKRUZDĖLIUKAI;7085226543;Taip;6;0;1;7
4942;Medynėlis;SKRUZDĖLIUKAI;5049081242;Taip;3;0;2;5
4943;Medynėlis;SKRUZDĖLIUKAI;4910857912;Taip;8;0;0;8
4944;Medynėlis;SKRUZDĖLIUKAI;6824842361;Taip;5;0;0;5
4945;Medynėlis;SKRUZDĖLIUKAI;1283602655;Taip;0;1;0;1
4946;Medynėlis;SKRUZDĖLIUKAI;4817353132;Taip;9;0;0;9
4947;Medynėlis;SKRUZDĖLIUKAI;7613699868;Taip;6;0;0;6
4948;Medynėlis;SKRUZDĖLIUKAI;3556203620;Taip;10;0;1;11
4949;Medynėlis;SKRUZDĖLIUKAI;4626655069;Taip;13;0;0;13
4950;Medynėlis;SKRUZDĖLIUKAI;5677747582;Taip;0;11;0;11
4951;Medynėlis;SKRUZDĖLIUKAI;3480190692;Taip;7;0;0;7
4952;Medynėlis;VOVERIUKAI;8275097931;Taip;4;4;0;8
4953;Medynėlis;VOVERIUKAI;1026253778;Taip;11;0;0;11
4954;Medynėlis;VOVERIUKAI;2523474347;Taip;20;0;0;20
4955;Medynėlis;VOVERIUKAI;5302122600;Taip;9;0;1;10
4956;Medynėlis;VOVERIUKAI;6609111216;Ne;0;0;1;1
4957;Medynėlis;VOVERIUKAI;2160081492;Taip;0;2;0;2
4958;Medynėlis;VOVERIUKAI;4035587227;Taip;8;0;0;8
4959;Medynėlis;VOVERIUKAI;8162771849;Ne;10;0;2;12
4960;Medynėlis;VOVERIUKAI;9725019515;Taip;2;0;1;3
4961;Medynėlis;VOVERIUKAI;3185760752;Taip;7;0;0;7
4962;Medynėlis;VOVERIUKAI;1404831377;Ne;16;0;1;17
4963;Medynėlis;VOVERIUKAI;7814008588;Taip;10;0;6;16
4964;Medynėlis;VOVERIUKAI;5610660982;Ne;3;4;1;8
4965;Medynėlis;VOVERIUKAI;4153545500;Taip;3;1;0;4
4966;Medynėlis;VOVERIUKAI;8299034970;Taip;10;0;0;10
4967;Medynėlis;VOVERIUKAI;7675101600;Taip;0;2;0;2
4968;Medynėlis;VOVERIUKAI;1668143166;Taip;0;6;3;9
4969;Medynėlis;VOVERIUKAI;1608019909;Taip;8;1;0;9
4970;Medynėlis;VOVERIUKAI;4010058673;Taip;0;5;0;5
4971;Medynėlis;VOVERIUKAI;6502531749;Taip;0;0;9;9
4972;Medynėlis;VOVERIUKAI;9076139419;Taip;3;0;0;3
4973;Medynėlis;MEŠKIUKAI;7140184593;Taip;1;1;0;2
4974;Medynėlis;MEŠKIUKAI;5114554577;Taip;0;4;0;4
4975;Medynėlis;MEŠKIUKAI;3365026025;Taip;6;0;0;6
4976;Medynėlis;MEŠKIUKAI;6107849795;Taip;0;3;0;3
4977;Medynėlis;MEŠKIUKAI;4488439037;Taip;0;4;0;4
4978;Medynėlis;MEŠKIUKAI;4100792567;Taip;1;0;0;1
4979;Medynėlis;MEŠKIUKAI;6101613567;Taip;0;4;0;4
4980;Medynėlis;MEŠKIUKAI;1056744101;Taip;0;6;1;7
4981;Medynėlis;MEŠKIUKAI;6485314750;Taip;5;4;0;9
4982;Medynėlis;MEŠKIUKAI;7455041214;Ne;0;6;0;6
4983;Medynėlis;MEŠKIUKAI;5028189785;Taip;3;0;0;3
4984;Medynėlis;MEŠKIUKAI;3761845905;Taip;2;4;0;6
4985;Medynėlis;MEŠKIUKAI;9825580191;Taip;0;4;0;4
4986;Medynėlis;MEŠKIUKAI;7272017225;Taip;0;7;0;7
4987;Medynėlis;MEŠKIUKAI;2784942324;Taip;0;2;0;2
4988;Medynėlis;MEŠKIUKAI;4092824377;Taip;0;8;0;8
4989;Medynėlis;MEŠKIUKAI;1475701065;Taip;0;7;0;7
4990;Medynėlis;MEŠKIUKAI;3674134340;Taip;0;2;0;2
4991;Medynėlis;MEŠKIUKAI;4645171858;Taip;0;4;0;4
4992;Medynėlis;PELĖDŽIUKAI;4222917765;Taip;0;4;0;4
4993;Medynėlis;PELĖDŽIUKAI;1621499650;Taip;0;4;0;4
4994;Medynėlis;PELĖDŽIUKAI;6681155625;Taip;0;4;0;4
4995;Medynėlis;PELĖDŽIUKAI;2702814930;Taip;0;0;1;1
4996;Medynėlis;PELĖDŽIUKAI;6211076154;Taip;5;0;0;5
4997;Medynėlis;PELĖDŽIUKAI;5658868407;Taip;3;0;1;4
4998;Medynėlis;PELĖDŽIUKAI;6975191449;Taip;23;0;0;23
4999;Medynėlis;PELĖDŽIUKAI;3905440176;Taip;0;2;0;2
5000;Medynėlis;PELĖDŽIUKAI;8441629302;Taip;1;4;0;5
5001;Medynėlis;PELĖDŽIUKAI;4783894465;Taip;3;9;0;12
5002;Medynėlis;PELĖDŽIUKAI;3761140697;Taip;8;0;3;11
5003;Medynėlis;PELĖDŽIUKAI;5330900656;Taip;19;0;1;20
5004;Medynėlis;PELĖDŽIUKAI;1142044361;Taip;0;4;0;4
5005;Medynėlis;PELĖDŽIUKAI;8719860414;Taip;5;0;0;5
5006;Medynėlis;PELĖDŽIUKAI;4897227188;Taip;10;4;2;16
5007;Medynėlis;PELĖDŽIUKAI;9873696787;Taip;10;0;0;10
5008;Medynėlis;PELĖDŽIUKAI;6802308420;Taip;10;0;0;10
5009;Medynėlis;PELĖDŽIUKAI;2339692406;Taip;2;0;0;2
5010;Medynėlis;PELĖDŽIUKAI;3947494044;Taip;1;0;0;1
5011;Medynėlis;PELĖDŽIUKAI;3295727210;Taip;5;4;0;9
5012;Medynėlis;PELĖDŽIUKAI;2234994999;Taip;4;3;0;7
5013;Medynėlis;BORUŽIUKAI;6622963662;Taip;4;0;1;5
5014;Medynėlis;BORUŽIUKAI;3638155321;Taip;0;4;0;4
5015;Medynėlis;BORUŽIUKAI;9290099536;Taip;7;4;0;11
5016;Medynėlis;BORUŽIUKAI;6924524346;Taip;0;4;0;4
5017;Medynėlis;BORUŽIUKAI;2877881247;Taip;5;14;0;19
5018;Medynėlis;BORUŽIUKAI;3709984586;Taip;5;0;0;5
5019;Medynėlis;BORUŽIUKAI;6470879334;Ne;0;4;0;4
5020;Medynėlis;BORUŽIUKAI;2379829985;Taip;4;4;0;8
5021;Medynėlis;BORUŽIUKAI;4145591997;Taip;5;4;0;9
5022;Medynėlis;BORUŽIUKAI;5391199861;Taip;14;4;0;18
5023;Medynėlis;BORUŽIUKAI;9485498942;Taip;0;4;0;4
5024;Medynėlis;BORUŽIUKAI;7914358405;Taip;0;4;0;4
5025;Medynėlis;BORUŽIUKAI;7695626630;Taip;0;2;0;2
5026;Medynėlis;BORUŽIUKAI;2816510180;Taip;9;0;0;9
5027;Medynėlis;BORUŽIUKAI;3538656650;Taip;0;5;0;5
5028;Medynėlis;BORUŽIUKAI;5389909872;Taip;2;2;0;4
5029;Medynėlis;BORUŽIUKAI;9418978658;Ne;1;4;0;5
5030;Medynėlis;BORUŽIUKAI;9705185906;Taip;2;0;0;2
5031;Medynėlis;EŽIUKAI;8125271445;Taip;10;1;0;11
5032;Medynėlis;EŽIUKAI;9847006679;Taip;9;0;0;9
5033;Medynėlis;EŽIUKAI;7317307957;Taip;2;0;1;3
5034;Medynėlis;EŽIUKAI;7860869675;Taip;6;10;0;16
5035;Medynėlis;EŽIUKAI;4471168173;Taip;10;0;0;10
5036;Medynėlis;EŽIUKAI;1062269215;Taip;1;0;2;3
5037;Medynėlis;EŽIUKAI;5197757730;Taip;6;4;1;11
5038;Medynėlis;EŽIUKAI;5333502849;Taip;3;3;4;10
5039;Medynėlis;EŽIUKAI;6536626390;Taip;5;0;2;7
5040;Medynėlis;EŽIUKAI;8953622684;Taip;0;8;0;8
5041;Medynėlis;EŽIUKAI;3230747109;Ne;12;0;0;12
5042;Medynėlis;EŽIUKAI;9175884049;Taip;5;6;0;11
5043;Medynėlis;EŽIUKAI;8609650186;Taip;4;0;1;5
5044;Medynėlis;EŽIUKAI;6826409129;Taip;14;0;0;14
5045;Medynėlis;EŽIUKAI;2929100410;Taip;14;0;0;14
5046;Medynėlis;EŽIUKAI;6359536923;Taip;0;1;0;1
5047;Medynėlis;EŽIUKAI;2676262920;Taip;0;0;14;14
5048;Medynėlis;EŽIUKAI;5339084041;Taip;18;0;0;18
5049;Medynėlis;EŽIUKAI;5766492584;Taip;4;0;0;4
5050;Medynėlis;EŽIUKAI;6561927001;Taip;1;4;0;5
5051;Medynėlis;EŽIUKAI;8838774666;Taip;21;0;0;21
5052;Medynėlis;EŽIUKAI;6349817783;Taip;16;0;0;16
5053;Medynėlis;ZUIKUČIAI;9857514451;Taip;17;0;0;17
5054;Medynėlis;ZUIKUČIAI;4498233742;Taip;6;0;1;7
5055;Medynėlis;ZUIKUČIAI;6641009653;Taip;12;2;0;14
5056;Medynėlis;ZUIKUČIAI;2896713695;Taip;3;0;0;3
5057;Medynėlis;ZUIKUČIAI;2512917914;Taip;11;0;1;12
5058;Medynėlis;ZUIKUČIAI;6888812634;Taip;12;0;0;12
5059;Medynėlis;ZUIKUČIAI;8904493539;Taip;13;0;0;13
5060;Medynėlis;ZUIKUČIAI;1260839046;Taip;3;1;0;4
5061;Medynėlis;ZUIKUČIAI;8390857710;Taip;0;0;1;1
5062;Medynėlis;ZUIKUČIAI;8542591286;Taip;6;0;0;6
5063;Medynėlis;ZUIKUČIAI;7312016138;Taip;17;0;0;17
5064;Medynėlis;ZUIKUČIAI;6847727830;Taip;12;0;0;12
5065;Medynėlis;ZUIKUČIAI;3048797634;Taip;5;0;0;5
5066;Medynėlis;ZUIKUČIAI;3446378114;Taip;14;0;2;16
5067;Medynėlis;KAČIUKAI;2735961000;Taip;0;4;5;9
5068;Medynėlis;KAČIUKAI;3187000487;Taip;2;4;0;6
5069;Medynėlis;KAČIUKAI;3079549158;Taip;8;0;0;8
5070;Medynėlis;KAČIUKAI;1616551970;Taip;12;0;0;12
5071;Medynėlis;KAČIUKAI;1840127319;Taip;15;0;0;15
5072;Medynėlis;KAČIUKAI;2259408744;Taip;10;0;0;10
5073;Medynėlis;KAČIUKAI;5096386323;Taip;4;6;0;10
5074;Medynėlis;KAČIUKAI;2322666023;Taip;4;0;0;4
5075;Medynėlis;KAČIUKAI;9352913210;Taip;0;3;0;3
5076;Medynėlis;KAČIUKAI;4328794578;Taip;4;0;0;4
5077;Medynėlis;KAČIUKAI;9389418983;Taip;16;0;0;16
5078;Medynėlis;KAČIUKAI;2032064340;Taip;0;0;1;1
5079;Medynėlis;KAČIUKAI;2507106460;Taip;7;0;0;7
5080;Medynėlis;KAČIUKAI;7488521058;Taip;13;0;0;13
5081;Medynėlis;KAČIUKAI;8382537735;Taip;12;0;2;14
5082;Medynėlis;KAČIUKAI;7268418306;Taip;8;0;0;8
5083;Medynėlis;KAČIUKAI;2028112718;Taip;10;0;0;10
5084;Medynėlis;PELIUKAI;6614028601;Taip;14;0;0;14
5085;Medynėlis;PELIUKAI;8439619837;Taip;15;0;1;16
5086;Medynėlis;PELIUKAI;9352391583;Taip;5;4;1;10
5087;Medynėlis;PELIUKAI;4040542730;Taip;0;5;0;5
5088;Medynėlis;PELIUKAI;6989524053;Taip;0;6;4;10
5089;Medynėlis;PELIUKAI;9774213537;Taip;2;0;3;5
5090;Medynėlis;PELIUKAI;7129951535;Taip;2;4;0;6
5091;Medynėlis;PELIUKAI;9977590259;Taip;7;1;0;8
5092;Medynėlis;PELIUKAI;7170801214;Taip;9;0;2;11
5093;Medynėlis;PELIUKAI;9373849916;Taip;12;0;1;13
5094;Medynėlis;PELIUKAI;8678054784;Taip;3;0;4;7
5095;Medynėlis;PELIUKAI;6569938649;Taip;2;0;2;4
5096;Medynėlis;PELIUKAI;6462589513;Taip;0;3;0;3
5097;Medynėlis;PELIUKAI;4204366008;Taip;0;4;0;4
5098;Medynėlis;PELIUKAI;3348520838;Taip;4;0;0;4
5099;Medynėlis;PELIUKAI;4444555055;Taip;3;0;2;5
5100;Medynėlis;PELIUKAI;2231990831;Taip;6;0;0;6
5101;Medynėlis;PELIUKAI;8887092965;Taip;7;1;0;8
5102;Medynėlis;PELIUKAI;3299495310;Taip;12;0;7;19
5103;Medynėlis;ANČIUKAI;8175602822;Taip;0;3;0;3
5104;Medynėlis;ANČIUKAI;9975663209;Taip;0;1;0;1
5105;Medynėlis;ANČIUKAI;9536473088;Taip;2;2;0;4
5106;Medynėlis;ANČIUKAI;8994120910;Taip;11;0;0;11
5107;Medynėlis;ANČIUKAI;6948059114;Taip;11;0;0;11
5108;Medynėlis;ANČIUKAI;9288258906;Taip;5;6;0;11
5109;Medynėlis;ANČIUKAI;4869007055;Taip;17;0;0;17
5110;Medynėlis;ANČIUKAI;9025913427;Taip;17;0;0;17
5111;Medynėlis;ANČIUKAI;7661220337;Taip;13;0;0;13
5112;Medynėlis;ANČIUKAI;3739441317;Taip;9;0;0;9
5113;Medynėlis;ANČIUKAI;6208391418;Taip;4;0;0;4
5114;Medynėlis;ANČIUKAI;1936512553;Taip;1;0;0;1
5115;Medynėlis;ANČIUKAI;1864754712;Taip;14;0;0;14
5116;Molinukas;NYKŠTUKAI;4974513900;Taip;0;12;0;12
5117;Molinukas;NYKŠTUKAI;8313486714;Taip;7;5;0;12
5118;Molinukas;NYKŠTUKAI;8608465121;Taip;0;18;0;18
5119;Molinukas;NYKŠTUKAI;1826463800;Taip;0;4;0;4
5120;Molinukas;NYKŠTUKAI;3043679624;Taip;13;4;0;17
5121;Molinukas;NYKŠTUKAI;4992887072;Taip;6;2;0;8
5122;Molinukas;NYKŠTUKAI;8769667823;Taip;2;3;0;5
5123;Molinukas;NYKŠTUKAI;1651103318;Taip;4;4;0;8
5124;Molinukas;NYKŠTUKAI;1970929144;Taip;5;4;0;9
5125;Molinukas;NYKŠTUKAI;1292778118;Taip;1;0;2;3
5126;Molinukas;NYKŠTUKAI;3510936830;Taip;0;1;0;1
5127;Molinukas;NYKŠTUKAI;1907287249;Taip;4;0;0;4
5128;Molinukas;NYKŠTUKAI;5172948843;Taip;3;4;0;7
5129;Molinukas;NYKŠTUKAI;6190443233;Taip;5;11;0;16
5130;Molinukas;NYKŠTUKAI;6531106368;Taip;1;0;0;1
5131;Molinukas;NYKŠTUKAI;4122429163;Taip;2;4;0;6
5132;Molinukas;NYKŠTUKAI;8660958288;Taip;0;1;0;1
5133;Molinukas;NYKŠTUKAI;2862680065;Taip;9;0;0;9
5134;Molinukas;NYKŠTUKAI;3382913312;Taip;1;0;0;1
5135;Molinukas;NYKŠTUKAI;2842168450;Taip;4;4;0;8
5136;Molinukas;NYKŠTUKAI;4044289280;Taip;8;0;0;8
5137;Molinukas;ZUIKUČIŲ;9203375647;Taip;0;4;0;4
5138;Molinukas;ZUIKUČIŲ;2982968605;Taip;1;4;0;5
5139;Molinukas;ZUIKUČIŲ;8479427729;Taip;0;1;0;1
5140;Molinukas;ZUIKUČIŲ;4225457772;Taip;3;0;0;3
5141;Molinukas;ZUIKUČIŲ;8114735116;Taip;0;4;0;4
5142;Molinukas;ZUIKUČIŲ;5597119459;Taip;3;11;0;14
5143;Molinukas;ZUIKUČIŲ;8582985479;Taip;13;0;0;13
5144;Molinukas;ZUIKUČIŲ;8490020853;Taip;13;0;0;13
5145;Molinukas;ZUIKUČIŲ;2651732418;Taip;0;4;0;4
5146;Molinukas;ZUIKUČIŲ;8988478990;Taip;5;2;0;7
5147;Molinukas;ZUIKUČIŲ;1059002689;Taip;3;0;0;3
5148;Molinukas;ZUIKUČIŲ;5302191209;Taip;10;0;0;10
5149;Molinukas;ZUIKUČIŲ;1605039166;Taip;0;2;0;2
5150;Molinukas;ZUIKUČIŲ;6804127471;Taip;0;2;0;2
5151;Molinukas;ZUIKUČIŲ;7441251480;Taip;3;1;0;4
5152;Molinukas;ZUIKUČIŲ;4733315902;Taip;0;4;0;4
5153;Molinukas;ZUIKUČIŲ;2595941277;Taip;3;0;0;3
5154;Molinukas;ZUIKUČIŲ;2706981559;Taip;5;0;0;5
5155;Molinukas;ZUIKUČIŲ;6638634402;Taip;1;0;0;1
5156;Molinukas;ZUIKUČIŲ;4718396549;Taip;10;1;0;11
5157;Molinukas;ZUIKUČIŲ;3577613732;Taip;2;0;0;2
5158;Molinukas;ZUIKUČIŲ;9972204424;Taip;10;1;0;11
5159;Molinukas;ZUIKUČIŲ;2789279432;Taip;1;0;0;1
5160;Molinukas;SRAIGIUKŲ;4806350914;Taip;7;3;0;10
5161;Molinukas;SRAIGIUKŲ;2757744826;Taip;3;0;0;3
5162;Molinukas;SRAIGIUKŲ;7451224160;Taip;0;1;2;3
5163;Molinukas;SRAIGIUKŲ;4475594896;Taip;0;8;0;8
5164;Molinukas;SRAIGIUKŲ;2348120316;Taip;0;11;0;11
5165;Molinukas;SRAIGIUKŲ;7623051674;Taip;0;1;0;1
5166;Molinukas;SRAIGIUKŲ;9448910819;Taip;0;1;0;1
5167;Molinukas;SRAIGIUKŲ;4101644021;Taip;0;2;2;4
5168;Molinukas;SRAIGIUKŲ;1651650182;Taip;0;1;0;1
5169;Molinukas;SRAIGIUKŲ;7248705010;Taip;13;0;1;14
5170;Molinukas;SRAIGIUKŲ;5580968328;Taip;0;4;0;4
5171;Molinukas;SRAIGIUKŲ;6353165459;Taip;0;6;0;6
5172;Molinukas;SRAIGIUKŲ;9293819449;Taip;2;4;1;7
5173;Molinukas;SRAIGIUKŲ;8536615996;Taip;4;0;0;4
5174;Molinukas;SRAIGIUKŲ;6087698882;Taip;0;4;0;4
5175;Molinukas;SRAIGIUKŲ;1849018608;Taip;0;9;0;9
5176;Molinukas;SRAIGIUKŲ;4171978721;Taip;6;4;0;10
5177;Molinukas;SRAIGIUKŲ;6681397435;Taip;4;4;1;9
5178;Molinukas;SRAIGIUKŲ;7134802574;Taip;0;3;0;3
5179;Molinukas;SRAIGIUKŲ;8260101075;Taip;0;3;0;3
5180;Molinukas;SRAIGIUKŲ;5525772579;Taip;1;0;0;1
5181;Molinukas;SRAIGIUKŲ;5876669121;Taip;7;4;0;11
5182;Molinukas;SRAIGIUKŲ;8053608348;Taip;0;4;1;5
5183;Molinukas;SRAIGIUKŲ;6014990150;Taip;0;0;1;1
5184;Molinukas;VOVERIUKAI;3469196411;Taip;5;0;0;5
5185;Molinukas;VOVERIUKAI;8541456847;Taip;0;6;4;10
5186;Molinukas;VOVERIUKAI;2286586693;Taip;14;0;0;14
5187;Molinukas;VOVERIUKAI;9413396859;Taip;0;2;1;3
5188;Molinukas;VOVERIUKAI;6898958282;Taip;0;0;2;2
5189;Molinukas;VOVERIUKAI;5685582215;Taip;8;2;0;10
5190;Molinukas;VOVERIUKAI;2356814145;Taip;0;3;3;6
5191;Molinukas;VOVERIUKAI;7446607510;Taip;4;11;0;15
5192;Molinukas;VOVERIUKAI;9667704959;Taip;11;0;2;13
5193;Molinukas;VOVERIUKAI;8516451290;Taip;0;0;4;4
5194;Molinukas;VOVERIUKAI;3030169626;Taip;7;4;1;12
5195;Molinukas;VOVERIUKAI;1865748733;Taip;0;1;0;1
5196;Molinukas;VOVERIUKAI;4209143136;Taip;9;0;2;11
5197;Molinukas;VOVERIUKAI;5648861702;Taip;9;0;2;11
5198;Molinukas;VOVERIUKAI;4957226547;Taip;1;0;0;1
5199;Molinukas;VOVERIUKAI;4950808381;Taip;0;9;3;12
5200;Molinukas;VOVERIUKAI;7378643086;Taip;0;3;0;3
5201;Molinukas;VOVERIUKAI;2779700726;Taip;0;1;1;2
5202;Molinukas;VOVERIUKAI;6832647220;Taip;10;0;2;12
5203;Molinukas;VOVERIUKAI;9318837973;Taip;0;4;2;6
5204;Molinukas;VOVERIUKAI;8247270556;Taip;0;1;0;1
5205;Molinukas;ŽVIRBLIUKŲ;2935945686;Taip;0;4;2;6
5206;Molinukas;ŽVIRBLIUKŲ;2090783609;Taip;5;0;0;5
5207;Molinukas;ŽVIRBLIUKŲ;9850656596;Taip;10;0;0;10
5208;Molinukas;ŽVIRBLIUKŲ;7052683028;Taip;17;1;0;18
5209;Molinukas;ŽVIRBLIUKŲ;6324308817;Taip;8;0;0;8
5210;Molinukas;ŽVIRBLIUKŲ;8578781383;Taip;4;0;0;4
5211;Molinukas;ŽVIRBLIUKŲ;1768984445;Taip;11;0;1;12
5212;Molinukas;ŽVIRBLIUKŲ;5040258188;Taip;10;0;0;10
5213;Molinukas;ŽVIRBLIUKŲ;9936048965;Taip;8;0;2;10
5214;Molinukas;KAČIUKŲ;8973341322;Taip;6;0;0;6
5215;Molinukas;KAČIUKŲ;4356610282;Taip;11;0;1;12
5216;Molinukas;KAČIUKŲ;5166540248;Taip;13;0;1;14
5217;Molinukas;KAČIUKŲ;5834614345;Taip;13;0;1;14
5218;Molinukas;KAČIUKŲ;5665993086;Taip;2;0;1;3
5219;Molinukas;KAČIUKŲ;7349691727;Taip;0;5;0;5
5220;Molinukas;KAČIUKŲ;7192221243;Taip;14;4;1;19
5221;Molinukas;KAČIUKŲ;2866461509;Taip;22;0;0;22
5222;Molinukas;KAČIUKŲ;6096244346;Taip;14;0;0;14
5223;Molinukas;KAČIUKŲ;2537694744;Taip;8;0;1;9
5224;"Naminukas (Smėlio g. 13)";Drugeliai;6776805494;Taip;0;4;0;4
5225;"Naminukas (Smėlio g. 13)";Drugeliai;2395070574;Taip;0;2;0;2
5226;"Naminukas (Smėlio g. 13)";Drugeliai;5534073614;Taip;1;1;0;2
5227;"Naminukas (Smėlio g. 13)";Drugeliai;2132345627;Taip;5;0;0;5
5228;"Naminukas (Smėlio g. 13)";Drugeliai;1302119260;Taip;0;6;0;6
5229;"Naminukas (Smėlio g. 13)";Drugeliai;2864905392;Taip;3;13;0;16
5230;"Naminukas (Smėlio g. 13)";Drugeliai;7406775925;Taip;9;4;0;13
5231;"Naminukas (Smėlio g. 13)";Drugeliai;1333462200;Taip;10;4;1;15
5232;"Naminukas (Smėlio g. 13)";Drugeliai;5468218968;Taip;2;4;0;6
5233;"Naminukas (Smėlio g. 13)";Drugeliai;5713661641;Taip;4;2;0;6
5234;"Naminukas (Smėlio g. 13)";Drugeliai;6581925461;Taip;0;3;0;3
5235;"Naminukas (Smėlio g. 13)";Drugeliai;8141324449;Taip;5;4;1;10
5236;"Naminukas (Smėlio g. 13)";Drugeliai;3236525642;Taip;0;2;2;4
5237;"Naminukas (Smėlio g. 13)";Drugeliai;7347998152;Taip;0;0;3;3
5238;"Naminukas (Smėlio g. 13)";Drugeliai;7272465847;Taip;11;1;0;12
5239;"Naminukas (Smėlio g. 13)";Drugeliai;7471964981;Taip;3;7;0;10
5240;"Naminukas (Smėlio g. 13)";Drugeliai;8760638670;Taip;3;4;2;9
5241;"Naminukas (Smėlio g. 13)";Drugeliai;1648466517;Taip;0;3;0;3
5242;"Naminukas (Smėlio g. 13)";Bitutės;6057391542;Taip;11;4;2;17
5243;"Naminukas (Smėlio g. 13)";Bitutės;3546140753;Taip;10;0;0;10
5244;"Naminukas (Smėlio g. 13)";Bitutės;6351199828;Taip;8;0;0;8
5245;"Naminukas (Smėlio g. 13)";Bitutės;4624191456;Taip;15;0;0;15
5246;"Naminukas (Smėlio g. 13)";Bitutės;4671626416;Taip;4;6;0;10
5247;"Naminukas (Smėlio g. 13)";Bitutės;4941814027;Taip;0;1;0;1
5248;"Naminukas (Smėlio g. 13)";Bitutės;2179061425;Taip;0;4;0;4
5249;"Naminukas (Smėlio g. 13)";Bitutės;2270868598;Taip;0;6;1;7
5250;"Naminukas (Smėlio g. 13)";Bitutės;1095955939;Taip;9;9;0;18
5251;"Naminukas (Smėlio g. 13)";Bitutės;4422173848;Taip;11;1;4;16
5252;"Naminukas (Smėlio g. 13)";Bitutės;5741698937;Taip;0;1;0;1
5253;"Naminukas (Smėlio g. 13)";Bitutės;7717132979;Taip;0;12;5;17
5254;"Naminukas (Smėlio g. 13)";Bitutės;9357758815;Taip;0;0;11;11
5255;"Naminukas (Smėlio g. 13)";Bitutės;7807791056;Taip;3;2;3;8
5256;"Naminukas (Smėlio g. 13)";Bitutės;1217359876;Taip;0;8;0;8
5257;"Naminukas (Smėlio g. 13)";Bitutės;5465843371;Taip;6;0;0;6
5258;"Naminukas (Smėlio g. 13)";Paukšteliai;3501921619;Taip;12;9;0;21
5259;"Naminukas (Smėlio g. 13)";Paukšteliai;7297661383;Taip;8;0;0;8
5260;"Naminukas (Smėlio g. 13)";Paukšteliai;5056487802;Taip;3;2;0;5
5261;"Naminukas (Smėlio g. 13)";Paukšteliai;3438010199;Taip;13;0;2;15
5262;"Naminukas (Smėlio g. 13)";Paukšteliai;4998565160;Taip;6;13;0;19
5263;"Naminukas (Smėlio g. 13)";Paukšteliai;9405784626;Taip;7;4;2;13
5264;"Naminukas (Smėlio g. 13)";Paukšteliai;2583886896;Taip;5;2;0;7
5265;"Naminukas (Smėlio g. 13)";Paukšteliai;4778385421;Taip;10;4;3;17
5266;"Naminukas (Smėlio g. 13)";Paukšteliai;6178500478;Taip;11;4;0;15
5267;"Naminukas (Smėlio g. 13)";Paukšteliai;9440685520;Taip;0;1;0;1
5268;"Naminukas (Smėlio g. 13)";Paukšteliai;1406418130;Taip;9;0;2;11
5269;"Naminukas (Smėlio g. 13)";Paukšteliai;2012656186;Ne;5;0;1;6
5270;"Naminukas (Smėlio g. 13)";Paukšteliai;8470716196;Taip;0;4;1;5
5271;"Naminukas (Smėlio g. 13)";Paukšteliai;3727828033;Ne;17;1;0;18
5272;"Naminukas (Smėlio g. 13)";Paukšteliai;2652538212;Taip;0;1;0;1
5273;"Naminukas (Smėlio g. 13)";Paukšteliai;5280419144;Taip;9;0;0;9
5274;"Naminukas (Smėlio g. 13)";Paukšteliai;7107752795;Taip;0;1;0;1
5275;"Naminukas (Smėlio g. 13)";Paukšteliai;3018465520;Taip;7;1;0;8
5276;"Naminukas (Smėlio g. 13)";Paukšteliai;2551242973;Taip;2;4;1;7
5277;"Naminukas (Smėlio g. 13)";Paukšteliai;2113378945;Taip;4;10;0;14
5278;"Naminukas (Smėlio g. 13)";Paukšteliai;7450368045;Taip;14;4;0;18
5279;"Naminukas (Smėlio g. 13)";"NYKŠTUKAI ";7646186458;Taip;7;4;0;11
5280;"Naminukas (Smėlio g. 13)";"NYKŠTUKAI ";5519447152;Taip;12;7;0;19
5281;"Naminukas (Smėlio g. 13)";"NYKŠTUKAI ";1286329245;Taip;12;2;0;14
5282;"Naminukas (Smėlio g. 13)";"NYKŠTUKAI ";1618802271;Taip;9;0;0;9
5283;"Naminukas (Smėlio g. 13)";"NYKŠTUKAI ";1591540165;Taip;0;0;4;4
5284;"Naminukas (Smėlio g. 13)";"NYKŠTUKAI ";1118193598;Ne;6;0;2;8
5285;"Naminukas (Smėlio g. 13)";"NYKŠTUKAI ";8102805098;Taip;0;3;0;3
5286;"Naminukas (Smėlio g. 13)";"NYKŠTUKAI ";2168486597;Taip;5;0;2;7
5287;"Naminukas (Smėlio g. 13)";"NYKŠTUKAI ";5498798560;Taip;0;4;0;4
5288;"Naminukas (Smėlio g. 13)";"NYKŠTUKAI ";5984789325;Taip;6;3;1;10
5289;"Naminukas (Smėlio g. 13)";"NYKŠTUKAI ";3120516850;Taip;23;0;0;23
5290;"Naminukas (Smėlio g. 13)";"NYKŠTUKAI ";9891722891;Taip;14;0;0;14
5291;Nykštukas;SMAGURIAI;1148800623;Taip;0;1;0;1
5292;Nykštukas;SMAGURIAI;7320458031;Taip;0;4;0;4
5293;Nykštukas;SMAGURIAI;7432373335;Ne;0;4;0;4
5294;Nykštukas;SMAGURIAI;6337924089;Taip;19;0;0;19
5295;Nykštukas;SMAGURIAI;2748970206;Taip;2;0;0;2
5296;Nykštukas;SMAGURIAI;3441133631;Ne;0;2;0;2
5297;Nykštukas;SMAGURIAI;7562216310;Taip;0;7;0;7
5298;Nykštukas;SMAGURIAI;6594118834;Taip;9;0;0;9
5299;Nykštukas;SMAGURIAI;2455221957;Taip;10;0;0;10
5300;Nykštukas;SMAGURIAI;5429377807;Taip;6;0;0;6
5301;Nykštukas;SMAGURIAI;2910587300;Taip;4;0;0;4
5302;Nykštukas;SMAGURIAI;2770385957;Taip;3;1;0;4
5303;Nykštukas;SMAGURIAI;2052451745;Ne;6;0;0;6
5304;Nykštukas;SMAGURIAI;8695794490;Taip;3;4;0;7
5305;Nykštukas;SMAGURIAI;5085577592;Taip;1;1;0;2
5306;Nykštukas;SMAGURIAI;5281616311;Taip;0;1;0;1
5307;Nykštukas;SMAGURIAI;8372380734;Taip;6;6;0;12
5308;Nykštukas;SMAGURIAI;6672148719;Taip;4;4;0;8
5309;Nykštukas;SMAGURIAI;9790322329;Taip;0;4;0;4
5310;Nykštukas;SMAGURIAI;5718555692;Ne;0;3;0;3
5311;Nykštukas;SMALSIUKAI;6285425127;Taip;18;0;0;18
5312;Nykštukas;SMALSIUKAI;6786896381;Taip;0;2;0;2
5313;Nykštukas;SMALSIUKAI;4490310109;Ne;5;5;0;10
5314;Nykštukas;SMALSIUKAI;2947976429;Taip;9;0;0;9
5315;Nykštukas;SMALSIUKAI;6883272732;Ne;10;0;0;10
5316;Nykštukas;SMALSIUKAI;8919778025;Taip;0;10;0;10
5317;Nykštukas;SMALSIUKAI;8827094160;Taip;1;4;0;5
5318;Nykštukas;SMALSIUKAI;9887096503;Taip;8;4;0;12
5319;Nykštukas;SMALSIUKAI;4323166473;Taip;4;0;1;5
5320;Nykštukas;SMALSIUKAI;4622095064;Taip;0;3;0;3
5321;Nykštukas;SMALSIUKAI;4955003100;Taip;7;4;0;11
5322;Nykštukas;SMALSIUKAI;5103512898;Ne;11;0;0;11
5323;Nykštukas;SMALSIUKAI;8667489439;Taip;2;0;0;2
5324;Nykštukas;SMALSIUKAI;7603500691;Ne;0;2;0;2
5325;Nykštukas;SMALSIUKAI;7266550834;Taip;6;0;2;8
5326;Nykštukas;SMALSIUKAI;6563871327;Taip;6;0;0;6
5327;Nykštukas;SMALSIUKAI;8819485547;Taip;14;0;0;14
5328;Nykštukas;SMALSIUKAI;5010715255;Taip;4;0;0;4
5329;Nykštukas;SMALSIUKAI;8047072198;Taip;5;0;0;5
5330;Nykštukas;SMALSIUKAI;4499337321;Taip;6;0;0;6
5331;Nykštukas;SMALSIUKAI;4445045176;Taip;7;4;0;11
5332;Nykštukas;SMALSIUKAI;5359280641;Taip;0;1;0;1
5333;Nykštukas;AITVARIUKAI;6923345088;Taip;0;4;0;4
5334;Nykštukas;AITVARIUKAI;8580777381;Ne;5;0;0;5
5335;Nykštukas;AITVARIUKAI;9319066179;Taip;9;0;0;9
5336;Nykštukas;AITVARIUKAI;2177539882;Taip;12;0;0;12
5337;Nykštukas;AITVARIUKAI;9595654681;Ne;10;0;1;11
5338;Nykštukas;AITVARIUKAI;9894698453;Taip;3;0;0;3
5339;Nykštukas;AITVARIUKAI;2232317366;Taip;10;0;0;10
5340;Nykštukas;AITVARIUKAI;7332769878;Taip;2;4;0;6
5341;Nykštukas;AITVARIUKAI;7896338372;Taip;10;0;0;10
5342;Nykštukas;AITVARIUKAI;2208319289;Taip;4;3;0;7
5343;Nykštukas;AITVARIUKAI;5285669371;Taip;1;0;0;1
5344;Nykštukas;AITVARIUKAI;8548820023;Ne;11;4;0;15
5345;Nykštukas;AITVARIUKAI;9545178064;Taip;18;0;0;18
5346;Nykštukas;AITVARIUKAI;3561627809;Ne;5;1;0;6
5347;Nykštukas;AITVARIUKAI;5972246871;Ne;0;1;0;1
5348;Nykštukas;AITVARIUKAI;4822304386;Taip;5;0;0;5
5349;Nykštukas;AITVARIUKAI;4177690371;Taip;2;0;0;2
5350;Nykštukas;AITVARIUKAI;5292127770;Ne;10;0;0;10
5351;Nykštukas;DAINORĖLIAI;7730918105;Taip;6;0;0;6
5352;Nykštukas;DAINORĖLIAI;8475127245;Taip;5;0;0;5
5353;Nykštukas;DAINORĖLIAI;5434220008;Taip;0;7;0;7
5354;Nykštukas;DAINORĖLIAI;1122600949;Taip;0;5;0;5
5355;Nykštukas;DAINORĖLIAI;3853935568;Taip;0;3;0;3
5356;Nykštukas;DAINORĖLIAI;9776630115;Ne;8;1;0;9
5357;Nykštukas;DAINORĖLIAI;9524639831;Ne;2;2;0;4
5358;Nykštukas;DAINORĖLIAI;3367348573;Ne;9;4;0;13
5359;Nykštukas;DAINORĖLIAI;5961945345;Taip;3;0;0;3
5360;Nykštukas;DAINORĖLIAI;6561696818;Taip;9;0;0;9
5361;Nykštukas;DAINORĖLIAI;1283453188;Taip;13;1;0;14
5362;Nykštukas;DAINORĖLIAI;1167614164;Taip;0;4;0;4
5363;Nykštukas;DAINORĖLIAI;7473124310;Taip;8;0;0;8
5364;Nykštukas;DAINORĖLIAI;1174618721;Ne;0;4;0;4
5365;Nykštukas;DAINORĖLIAI;8681884252;Taip;3;4;0;7
5366;Nykštukas;DAINORĖLIAI;5255726742;Taip;2;1;0;3
5367;Nykštukas;DAINORĖLIAI;9027355399;Taip;0;9;0;9
5368;Nykštukas;DAINORĖLIAI;4893494144;Taip;0;2;0;2
5369;Nykštukas;DAINORĖLIAI;8318089070;Taip;4;0;0;4
5370;Nykštukas;DAINORĖLIAI;2727074729;Taip;0;4;0;4
5371;Nykštukas;DAINORĖLIAI;9437700329;Taip;0;3;0;3
5372;Nykštukas;POKŠTUKAI;1655428422;Taip;9;0;0;9
5373;Nykštukas;POKŠTUKAI;2649916049;Taip;0;13;0;13
5374;Nykštukas;POKŠTUKAI;1796016501;Ne;0;17;0;17
5375;Nykštukas;POKŠTUKAI;5958711585;Ne;4;6;0;10
5376;Nykštukas;POKŠTUKAI;3999004312;Taip;0;5;0;5
5377;Nykštukas;POKŠTUKAI;6719999304;Taip;0;9;0;9
5378;Nykštukas;POKŠTUKAI;8148163137;Ne;0;4;0;4
5379;Nykštukas;POKŠTUKAI;8708184278;Taip;0;1;0;1
5380;Nykštukas;POKŠTUKAI;3843163586;Taip;0;16;0;16
5381;Nykštukas;POKŠTUKAI;1316018865;Taip;4;0;0;4
5382;Nykštukas;POKŠTUKAI;3507649457;Taip;4;1;0;5
5383;Nykštukas;POKŠTUKAI;3428031037;Taip;0;3;0;3
5384;Nykštukas;POKŠTUKAI;4508625009;Taip;8;1;0;9
5385;Nykštukas;POKŠTUKAI;6698622575;Taip;0;4;0;4
5386;Nykštukas;POKŠTUKAI;2982662650;Taip;0;3;0;3
5387;Nykštukas;POKŠTUKAI;2627736026;Taip;0;17;0;17
5388;Nykštukas;POKŠTUKAI;4401103119;Taip;0;1;0;1
5389;Nykštukas;POKŠTUKAI;9703895923;Taip;11;0;0;11
5390;Nykštukas;KODĖLČIUKAI;8168579152;Taip;6;1;0;7
5391;Nykštukas;KODĖLČIUKAI;9285820767;Taip;11;0;0;11
5392;Nykštukas;KODĖLČIUKAI;2685400939;Ne;0;1;3;4
5393;Nykštukas;KODĖLČIUKAI;3278960733;Ne;0;0;1;1
5394;Nykštukas;KODĖLČIUKAI;5934979528;Taip;0;1;2;3
5395;Nykštukas;KODĖLČIUKAI;3760617860;Ne;3;6;0;9
5396;Nykštukas;KODĖLČIUKAI;6927545099;Taip;1;0;1;2
5397;Nykštukas;KODĖLČIUKAI;8042479133;Taip;13;0;0;13
5398;Nykštukas;KODĖLČIUKAI;6345791450;Ne;4;0;0;4
5399;Nykštukas;KODĖLČIUKAI;6999380958;Taip;1;0;0;1
5400;Nykštukas;KODĖLČIUKAI;6794885966;Taip;5;3;0;8
5401;Nykštukas;KODĖLČIUKAI;7616459970;Taip;0;5;0;5
5402;Nykštukas;KODĖLČIUKAI;2623254163;Taip;15;1;0;16
5403;Nykštukas;KODĖLČIUKAI;9296449928;Taip;2;0;0;2
5404;Nykštukas;KODĖLČIUKAI;2992219360;Ne;23;0;0;23
5405;Nykštukas;KODĖLČIUKAI;4667303597;Taip;4;0;0;4
5406;Nykštukas;KODĖLČIUKAI;8804969886;Taip;6;0;0;6
5407;Nykštukas;KODĖLČIUKAI;3552386621;Taip;3;1;0;4
5408;Nykštukas;KODĖLČIUKAI;3990260342;Taip;0;10;0;10
5409;Nykštukas;KODĖLČIUKAI;2692551262;Ne;0;2;0;2
5410;Nykštukas;KODĖLČIUKAI;6607025451;Taip;0;1;5;6
5411;Nykštukas;PASAKORIAI;2661110617;Taip;0;8;0;8
5412;Nykštukas;PASAKORIAI;3040001373;Taip;11;1;0;12
5413;Nykštukas;PASAKORIAI;8640715657;Taip;0;4;0;4
5414;Nykštukas;PASAKORIAI;5504584349;Taip;4;1;0;5
5415;Nykštukas;PASAKORIAI;7990462246;Taip;5;4;0;9
5416;Nykštukas;PASAKORIAI;1379378120;Taip;1;0;0;1
5417;Nykštukas;PASAKORIAI;9413198245;Taip;3;0;0;3
5418;Nykštukas;PASAKORIAI;2518342041;Taip;0;5;0;5
5419;Nykštukas;PASAKORIAI;7828733135;Taip;10;2;0;12
5420;Nykštukas;PASAKORIAI;4090494707;Taip;0;3;0;3
5421;Nykštukas;PASAKORIAI;3026598985;Taip;11;0;0;11
5422;Nykštukas;PASAKORIAI;9714310539;Taip;0;4;0;4
5423;Nykštukas;PASAKORIAI;4795301170;Taip;0;4;0;4
5424;Nykštukas;PASAKORIAI;1579064341;Taip;10;1;0;11
5425;Nykštukas;PASAKORIAI;4992654449;Taip;10;0;1;11
5426;Nykštukas;PASAKORIAI;5337728911;Taip;5;0;3;8
5427;Nykštukas;PASAKORIAI;3496434361;Taip;4;0;0;4
5428;Nykštukas;GUDRUČIAI;9871410323;Ne;0;4;0;4
5429;Nykštukas;GUDRUČIAI;4559818614;Ne;0;14;0;14
5430;Nykštukas;GUDRUČIAI;7447202642;Taip;0;7;0;7
5431;Nykštukas;GUDRUČIAI;1714708754;Taip;0;3;0;3
5432;Nykštukas;GUDRUČIAI;5157799354;Taip;5;4;0;9
5433;Nykštukas;GUDRUČIAI;4325369395;Ne;0;20;0;20
5434;Nykštukas;GUDRUČIAI;6630804505;Taip;0;7;0;7
5435;Nykštukas;GUDRUČIAI;8363202198;Taip;0;1;0;1
5436;Nykštukas;GUDRUČIAI;7326535810;Taip;0;7;0;7
5437;Nykštukas;GUDRUČIAI;9712596180;Taip;0;4;0;4
5438;Nykštukas;GUDRUČIAI;9941937734;Taip;4;0;0;4
5439;Nykštukas;GUDRUČIAI;3619459404;Taip;0;1;0;1
5440;Nykštukas;GUDRUČIAI;1934596739;Taip;4;2;0;6
5441;Nykštukas;GUDRUČIAI;7604740418;Taip;1;2;0;3
5442;Nykštukas;GUDRUČIAI;2970293467;Taip;5;12;0;17
5443;Nykštukas;GUDRUČIAI;2881323571;Ne;2;5;0;7
5444;Nykštukas;GUDRUČIAI;2872277381;Taip;0;5;0;5
5445;Nykštukas;GUDRUČIAI;9940519259;Taip;0;3;0;3
5446;Nykštukas;GUDRUČIAI;8361758895;Taip;0;5;0;5
5447;Nykštukas;NAMINUKAI;7456007276;Taip;2;0;0;2
5448;Nykštukas;NAMINUKAI;7176519994;Taip;6;4;0;10
5449;Nykštukas;NAMINUKAI;2440574056;Taip;0;11;0;11
5450;Nykštukas;NAMINUKAI;4064016871;Ne;0;3;0;3
5451;Nykštukas;NAMINUKAI;9054070492;Ne;3;6;0;9
5452;Nykštukas;NAMINUKAI;6519078450;Taip;4;0;0;4
5453;Nykštukas;NAMINUKAI;6106373554;Ne;11;0;0;11
5454;Nykštukas;NAMINUKAI;4925214655;Taip;0;2;0;2
5455;Nykštukas;NAMINUKAI;5032283848;Taip;4;1;0;5
5456;Nykštukas;NAMINUKAI;7494444468;Taip;1;1;0;2
5457;Nykštukas;NAMINUKAI;3925958632;Taip;1;1;0;2
5458;Nykštukas;NAMINUKAI;6338717583;Taip;4;5;0;9
5459;Nykštukas;NAMINUKAI;7976689381;Taip;0;4;0;4
5460;Nykštukas;NAMINUKAI;9686815141;Ne;0;3;0;3
5461;Nykštukas;NAMINUKAI;9575291096;Taip;0;4;0;4
5462;Nykštukas;NAMINUKAI;4503830456;Taip;5;1;0;6
5463;Nykštukas;NAMINUKAI;4040123876;Taip;0;9;0;9
5464;Nykštukas;NAMINUKAI;1088633575;Taip;0;8;0;8
5465;Nykštukas;NAMINUKAI;8874850019;Ne;0;5;0;5
5466;Nykštukas;NAMINUKAI;1510338621;Taip;3;1;0;4
5467;Nykštukas;NAMINUKAI;9067774103;Ne;0;11;0;11
5468;Nykštukas;NAMINUKAI;3405633312;Taip;0;3;0;3
5469;Nykštukas;KŪLVERSTUKAI;7078264994;Taip;0;5;0;5
5470;Nykštukas;KŪLVERSTUKAI;3660330885;Taip;0;4;0;4
5471;Nykštukas;KŪLVERSTUKAI;4897443402;Ne;0;1;0;1
5472;Nykštukas;KŪLVERSTUKAI;6778384400;Ne;6;1;0;7
5473;Nykštukas;KŪLVERSTUKAI;6888025109;Taip;17;3;0;20
5474;Nykštukas;KŪLVERSTUKAI;6071938183;Taip;5;0;0;5
5475;Nykštukas;KŪLVERSTUKAI;7310647095;Taip;10;9;0;19
5476;Nykštukas;KŪLVERSTUKAI;6693597888;Taip;1;0;0;1
5477;Nykštukas;KŪLVERSTUKAI;5297046545;Taip;2;0;0;2
5478;Nykštukas;KŪLVERSTUKAI;8414521116;Taip;5;0;0;5
5479;Nykštukas;KŪLVERSTUKAI;1666098441;Taip;0;2;0;2
5480;Nykštukas;KŪLVERSTUKAI;9177683618;Taip;11;0;0;11
5481;Nykštukas;KŪLVERSTUKAI;1077620433;Taip;9;5;0;14
5482;Nykštukas;TREPSIUKAI;8701731017;Taip;10;1;0;11
5483;Nykštukas;TREPSIUKAI;8820983001;Taip;12;0;0;12
5484;Nykštukas;TREPSIUKAI;2995258838;Taip;0;1;0;1
5485;Nykštukas;TREPSIUKAI;1355881784;Taip;4;0;0;4
5486;Nykštukas;TREPSIUKAI;2974110726;Taip;5;0;0;5
5487;Nykštukas;TREPSIUKAI;7311244803;Taip;0;7;0;7
5488;Nykštukas;TREPSIUKAI;5183022629;Taip;2;0;0;2
5489;Nykštukas;ŽIRNIUKAI;9661862689;Taip;19;0;0;19
5490;Nykštukas;ŽIRNIUKAI;1594734231;Taip;1;0;0;1
5491;Nykštukas;ŽIRNIUKAI;3339707558;Taip;1;0;0;1
5492;Nykštukas;ŽIRNIUKAI;7299329150;Taip;5;0;0;5
5493;Nykštukas;ŽIRNIUKAI;2670682135;Taip;9;0;0;9
5494;Nykštukas;ŽIRNIUKAI;1202614927;Taip;12;0;0;12
5495;Nykštukas;ŽIRNIUKAI;2800783215;Taip;23;0;0;23
5496;Nykštukas;ŽIRNIUKAI;2620150024;Taip;15;0;0;15
5497;Nykštukas;ŽIRNIUKAI;3032028847;Taip;14;0;0;14
5498;Nykštukas;ŽIRNIUKAI;6884714823;Taip;13;2;0;15
5499;Nykštukas;ŽIRNIUKAI;1616644404;Taip;9;0;0;9
5500;Nykštukas;ŽIRNIUKAI;9270615518;Taip;1;0;0;1
5501;Nykštukas;ŽIRNIUKAI;2078586374;Taip;15;0;0;15
5502;Nykštukas;ŽIRNIUKAI;1102203704;Taip;0;6;0;6
5503;Ozas;Smalsučiai;4066900299;Taip;5;0;1;6
5504;Ozas;Smalsučiai;4694561135;Taip;3;0;0;3
5505;Ozas;Smalsučiai;4792735767;Taip;0;1;0;1
5506;Ozas;Smalsučiai;5651665799;Taip;4;0;3;7
5507;Ozas;Smalsučiai;7756424421;Taip;7;0;0;7
5508;Ozas;Smalsučiai;4334162942;Taip;2;0;0;2
5509;Ozas;Smalsučiai;1507372220;Taip;8;0;0;8
5510;Ozas;Smalsučiai;7884934528;Taip;19;0;0;19
5511;Ozas;Smalsučiai;7298628220;Taip;0;9;0;9
5512;Ozas;Smalsučiai;1112829748;Taip;16;0;0;16
5513;Ozas;Smalsučiai;1699412266;Taip;0;0;1;1
5514;Ozas;Smalsučiai;8833452950;Taip;2;0;0;2
5515;Ozas;Smalsučiai;2189280675;Taip;17;2;0;19
5516;Ozas;Smalsučiai;6922447926;Taip;1;0;0;1
5517;Ozas;Smalsučiai;8860029000;Taip;9;0;0;9
5518;Ozas;Smalsučiai;4022390983;Taip;5;0;0;5
5519;Ozas;Smalsučiai;7786745329;Taip;7;0;0;7
5520;Ozas;Smalsučiai;1398871402;Taip;11;0;0;11
5521;Ozas;Drugeliai;6419221599;Taip;6;0;0;6
5522;Ozas;Drugeliai;1866535603;Taip;0;4;0;4
5523;Ozas;Drugeliai;4673128698;Taip;5;0;0;5
5524;Ozas;Drugeliai;7870419810;Ne;16;0;0;16
5525;Ozas;Drugeliai;2869987587;Taip;13;1;0;14
5526;Ozas;Drugeliai;9178967858;Taip;10;0;0;10
5527;Ozas;Drugeliai;2454569369;Taip;1;0;4;5
5528;Ozas;Drugeliai;1803782282;Taip;2;5;0;7
5529;Ozas;Drugeliai;2819545359;Taip;15;0;0;15
5530;Ozas;Drugeliai;3994760698;Taip;10;0;0;10
5531;Ozas;Drugeliai;7922667688;Taip;6;0;0;6
5532;Ozas;Drugeliai;1536889312;Taip;9;0;0;9
5533;Ozas;Drugeliai;8897904793;Taip;4;0;0;4
5534;Ozas;Drugeliai;3723247420;Taip;11;0;0;11
5535;Ozas;Drugeliai;1489355274;Taip;1;5;0;6
5536;Ozas;Drugeliai;9655492678;Taip;9;0;5;14
5537;Ozas;Drugeliai;1062591107;Taip;2;4;0;6
5538;Ozas;Drugeliai;3967307153;Taip;10;0;1;11
5539;Ozas;Boružėlės;3037323341;Taip;0;2;0;2
5540;Ozas;Boružėlės;6346123124;Taip;10;0;1;11
5541;Ozas;Boružėlės;2248812743;Taip;0;0;3;3
5542;Ozas;Boružėlės;3133776891;Ne;2;0;0;2
5543;Ozas;Boružėlės;2139224651;Taip;3;0;0;3
5544;Ozas;Boružėlės;9506090620;Taip;0;4;0;4
5545;Ozas;Boružėlės;5172367556;Taip;0;4;0;4
5546;Ozas;Boružėlės;7617839839;Taip;3;8;0;11
5547;Ozas;Boružėlės;6392066805;Taip;7;0;0;7
5548;Ozas;Boružėlės;8781771299;Taip;0;6;0;6
5549;Ozas;Boružėlės;3817138493;Taip;0;1;0;1
5550;Ozas;Boružėlės;8371368881;Taip;0;0;1;1
5551;Ozas;Boružėlės;6476147361;Taip;2;0;0;2
5552;Ozas;Boružėlės;4994121247;Taip;4;4;0;8
5553;Ozas;Boružėlės;3902722274;Taip;3;0;0;3
5554;Ozas;Boružėlės;7585213159;Taip;0;5;0;5
5555;Ozas;Boružėlės;6315443248;Taip;0;4;0;4
5556;Ozas;Boružėlės;6186850614;Taip;5;5;0;10
5557;Ozas;Boružėlės;6318419889;Taip;0;5;0;5
5558;Ozas;Boružėlės;7787473586;Taip;7;0;1;8
5559;Ozas;Žiogeliai;7461521320;Taip;0;0;1;1
5560;Ozas;Žiogeliai;6257625501;Taip;4;4;0;8
5561;Ozas;Žiogeliai;7402290524;Taip;0;3;0;3
5562;Ozas;Žiogeliai;1562277866;Taip;0;0;5;5
5563;Ozas;Žiogeliai;4571583671;Taip;0;4;0;4
5564;Ozas;Žiogeliai;5682027094;Taip;7;13;3;23
5565;Ozas;Žiogeliai;4966355020;Taip;0;3;1;4
5566;Ozas;Žiogeliai;4942550213;Taip;13;0;1;14
5567;Ozas;Žiogeliai;8676986286;Taip;0;0;2;2
5568;Ozas;Žiogeliai;5420952391;Taip;0;3;3;6
5569;Ozas;Žiogeliai;2837228320;Taip;5;0;0;5
5570;Ozas;Žiogeliai;2617258206;Ne;6;7;0;13
5571;Ozas;Žiogeliai;4030056504;Taip;6;1;0;7
5572;Ozas;Žiogeliai;5156383727;Taip;0;4;1;5
5573;Ozas;Žiogeliai;3770045761;Taip;0;1;0;1
5574;Ozas;Žiogeliai;9768754737;Taip;1;0;0;1
5575;Ozas;Žiogeliai;7264789334;Taip;0;4;0;4
5576;Ozas;Žiogeliai;7165299220;Taip;3;4;1;8
5577;Ozas;Bitutės;4220780257;Taip;0;4;0;4
5578;Ozas;Bitutės;1161776624;Taip;0;4;0;4
5579;Ozas;Bitutės;4227555342;Taip;10;1;0;11
5580;Ozas;Bitutės;7499756171;Taip;10;4;0;14
5581;Ozas;Bitutės;2705294874;Taip;1;0;0;1
5582;Ozas;Bitutės;2369544599;Taip;0;5;0;5
5583;Ozas;Bitutės;3329391600;Taip;0;1;0;1
5584;Ozas;Bitutės;4254601638;Taip;0;2;0;2
5585;Ozas;Bitutės;4699369567;Taip;0;4;0;4
5586;Ozas;Bitutės;8304671844;Taip;8;4;0;12
5587;Ozas;Bitutės;9772085405;Taip;5;4;1;10
5588;Ozas;Bitutės;7051699003;Taip;1;4;0;5
5589;Ozas;Bitutės;5383877034;Taip;0;1;2;3
5590;Ozas;Bitutės;1117208248;Taip;1;4;0;5
5591;Ozas;Bitutės;6811181735;Taip;10;5;0;15
5592;Ozas;Bitutės;8622621570;Taip;5;0;0;5
5593;Ozas;Bitutės;4260123123;Ne;2;1;0;3
5594;Ozas;Bitutės;7494307084;Taip;0;4;0;4
5595;Ozas;Bitutės;1895519949;Taip;0;1;0;1
5596;Ozas;Bitutės;5968428143;Taip;2;2;0;4
5597;Ozas;Bitutės;4286058360;Taip;7;3;0;10
5598;Ozas;Aitvarėliai;1144679735;Taip;9;0;0;9
5599;Ozas;Aitvarėliai;2773182934;Taip;2;0;1;3
5600;Ozas;Aitvarėliai;4357737538;Taip;4;9;0;13
5601;Ozas;Aitvarėliai;5642468671;Taip;4;2;0;6
5602;Ozas;Aitvarėliai;1045890394;Taip;0;4;0;4
5603;Ozas;Aitvarėliai;7686706482;Taip;0;1;0;1
5604;Ozas;Aitvarėliai;2395567376;Taip;0;4;2;6
5605;Ozas;Aitvarėliai;5383739203;Taip;3;4;0;7
5606;Ozas;Aitvarėliai;4583818638;Taip;17;0;0;17
5607;Ozas;Aitvarėliai;1543683077;Ne;1;0;1;2
5608;Ozas;Aitvarėliai;2165291778;Ne;0;11;0;11
5609;Ozas;Aitvarėliai;8754244281;Taip;16;1;0;17
5610;Ozas;Aitvarėliai;6646671212;Taip;7;0;0;7
5611;Ozas;Aitvarėliai;9443843603;Taip;9;1;0;10
5612;Ozas;Aitvarėliai;3238019756;Taip;14;1;0;15
5613;Ozas;Aitvarėliai;8987796218;Taip;3;0;0;3
5614;Ozas;Aitvarėliai;3783477511;Taip;8;0;0;8
5615;Ozas;Aitvarėliai;6778987483;Taip;6;0;0;6
5616;Ozas;Aitvarėliai;4891451748;Ne;20;0;0;20
5617;Ozas;Aitvarėliai;9813020279;Taip;1;0;0;1
5618;Ozas;Aitvarėliai;2922370952;Taip;2;0;1;3
5619;Ozas;Aitvarėliai;2544858937;Taip;0;4;0;4
5620;Ozas;Voveraitės;8178298861;Taip;8;0;0;8
5621;Ozas;Voveraitės;9195536968;Taip;4;0;0;4
5622;Ozas;Voveraitės;2991511872;Taip;1;3;0;4
5623;Ozas;Voveraitės;5016547315;Taip;1;6;0;7
5624;Ozas;Voveraitės;1564826076;Taip;6;0;0;6
5625;Ozas;Voveraitės;2511477658;Taip;0;4;0;4
5626;Ozas;Voveraitės;1240233169;Taip;4;0;0;4
5627;Ozas;Voveraitės;6088757991;Taip;0;4;0;4
5628;Ozas;Voveraitės;5822871838;Taip;0;4;0;4
5629;Ozas;Voveraitės;2635045515;Taip;0;2;0;2
5630;Ozas;Voveraitės;6499549095;Taip;4;4;0;8
5631;Ozas;Voveraitės;6666591428;Taip;10;0;0;10
5632;Ozas;Voveraitės;2297650260;Taip;10;4;0;14
5633;Ozas;Voveraitės;7908028909;Taip;0;2;0;2
5634;Ozas;Voveraitės;9762737217;Taip;6;4;0;10
5635;Ozas;Voveraitės;7421484648;Taip;17;0;0;17
5636;Ozas;Voveraitės;1997125531;Taip;0;4;0;4
5637;Ozas;Voveraitės;4556076744;Ne;16;0;0;16
5638;Ozas;Voveraitės;8503041003;Taip;0;0;1;1
5639;Ozas;Voveraitės;6053885086;Taip;8;0;0;8
5640;Ozas;Voveraitės;7978092840;Taip;0;2;0;2
5641;Ozas;Kodelčiukai;8743467101;Taip;4;3;0;7
5642;Ozas;Kodelčiukai;2964318343;Taip;4;4;0;8
5643;Ozas;Kodelčiukai;8696127374;Taip;5;0;0;5
5644;Ozas;Kodelčiukai;3704303636;Taip;0;2;0;2
5645;Ozas;Kodelčiukai;2573702751;Taip;8;0;0;8
5646;Ozas;Kodelčiukai;2951875705;Taip;0;2;0;2
5647;Ozas;Kodelčiukai;7305274617;Taip;7;0;0;7
5648;Ozas;Kodelčiukai;9306887706;Taip;13;0;0;13
5649;Ozas;Kodelčiukai;9084187344;Taip;7;0;0;7
5650;Ozas;Kodelčiukai;1348751454;Taip;13;1;0;14
5651;Ozas;Kodelčiukai;9322080266;Taip;5;4;0;9
5652;Ozas;Kodelčiukai;6809992664;Taip;14;0;0;14
5653;Ozas;Kodelčiukai;4516291572;Taip;1;7;0;8
5654;Ozas;Kodelčiukai;4287719751;Taip;6;6;0;12
5655;Ozas;Kodelčiukai;9620747099;Taip;0;1;0;1
5656;Ozas;Kodelčiukai;5216695220;Taip;9;3;0;12
5657;Ozas;Kodelčiukai;8779047802;Taip;8;1;0;9
5658;Ozas;Kodelčiukai;6783755555;Taip;0;8;0;8
5659;Ozas;Kodelčiukai;8222112564;Taip;3;1;0;4
5660;Ozas;Kodelčiukai;8797919230;Taip;3;3;0;6
5661;Ozas;Kodelčiukai;4573329075;Taip;10;0;2;12
5662;Ozas;Pelėdžiukai;4640897674;Taip;0;1;0;1
5663;Ozas;Pelėdžiukai;9277208213;Taip;0;4;0;4
5664;Ozas;Pelėdžiukai;8040293681;Taip;0;0;1;1
5665;Ozas;Pelėdžiukai;1856258542;Taip;1;0;0;1
5666;Ozas;Pelėdžiukai;5922569280;Taip;0;4;2;6
5667;Ozas;Pelėdžiukai;7640409923;Taip;9;0;0;9
5668;Ozas;Pelėdžiukai;4601869799;Taip;5;4;0;9
5669;Ozas;Pelėdžiukai;5958055645;Ne;0;0;1;1
5670;Ozas;Pelėdžiukai;7125754645;Ne;0;0;4;4
5671;Ozas;Pelėdžiukai;2824133388;Taip;4;4;0;8
5672;Ozas;Pelėdžiukai;2637531106;Taip;3;1;0;4
5673;Ozas;Pelėdžiukai;6819000895;Taip;5;4;5;14
5674;Ozas;Pelėdžiukai;5950860889;Taip;1;1;0;2
5675;Ozas;Pelėdžiukai;4886045470;Taip;1;0;0;1
5676;Ozas;Pelėdžiukai;3212050416;Taip;0;4;0;4
5677;Ozas;Pelėdžiukai;3725141591;Taip;1;0;0;1
5678;Ozas;Pelėdžiukai;3711403511;Taip;1;2;2;5
5679;Ozas;Pelėdžiukai;5392929222;Taip;23;0;0;23
5680;Ozas;Pelėdžiukai;2281337233;Taip;2;0;0;2
5681;Ozas;Pelėdžiukai;9334268998;Taip;4;0;0;4
5682;Ozas;"Kačiukai ";7776754188;Taip;16;0;0;16
5683;Ozas;"Kačiukai ";5097380041;Taip;1;0;4;5
5684;Ozas;"Kačiukai ";3109261153;Taip;0;4;0;4
5685;Ozas;"Kačiukai ";9781398468;Taip;13;0;0;13
5686;Ozas;"Kačiukai ";9781527964;Taip;0;20;0;20
5687;Ozas;"Kačiukai ";4514798132;Taip;13;0;5;18
5688;Ozas;"Kačiukai ";2729524188;Taip;0;0;4;4
5689;Ozas;"Kačiukai ";2522810593;Taip;1;0;0;1
5690;Ozas;"Kačiukai ";3269417874;Taip;2;2;0;4
5691;Ozas;"Kačiukai ";5866709636;Ne;5;10;0;15
5692;Ozas;"Kačiukai ";6632795981;Taip;5;0;1;6
5693;Ozas;"Kačiukai ";2599175140;Taip;5;0;0;5
5694;Ozas;"Kačiukai ";7885855133;Taip;0;0;3;3
5695;Ozas;Ančiukų;3472468379;Taip;4;0;0;4
5696;Ozas;Ančiukų;6512655578;Taip;19;0;0;19
5697;Ozas;Ančiukų;1092988354;Taip;16;0;0;16
5698;Ozas;Ančiukų;5811261087;Taip;5;0;0;5
5699;Ozas;Ančiukų;4424628807;Taip;5;0;0;5
5700;Ozas;Ančiukų;6894358457;Taip;10;0;0;10
5701;Ozas;Ančiukų;1671756798;Taip;10;0;0;10
5702;Ozas;Ančiukų;5163358861;Taip;7;0;0;7
5703;Ozas;Ančiukų;7611417346;Taip;2;0;0;2
5704;Ozas;Ančiukų;6305438823;Taip;5;3;0;8
5705;Ozas;Ančiukų;4941588023;Taip;1;4;0;5
5706;Ozas;Ančiukų;8772165816;Taip;6;0;0;6
5707;Ozas;Ančiukų;4910534724;Taip;1;0;0;1
5708;Ozas;Nykškukų;9319720476;Taip;15;0;0;15
5709;Ozas;Nykškukų;3540922740;Taip;11;0;0;11
5710;Ozas;Nykškukų;2794839285;Taip;8;1;0;9
5711;Ozas;Nykškukų;2326431805;Taip;3;2;0;5
5712;Ozas;Nykškukų;2334870680;Taip;9;0;0;9
5713;Ozas;Nykškukų;7005571081;Taip;9;0;0;9
5714;Ozas;Nykškukų;3201905363;Taip;1;0;0;1
5715;Ozas;Nykškukų;1760627703;Taip;11;1;0;12
5716;Ozas;Nykškukų;5126356120;Taip;7;2;0;9
5717;Ozas;Nykškukų;2490578190;Taip;8;2;0;10
5718;Ozas;Nykškukų;7789232957;Taip;15;0;0;15
5719;Ozas;Nykškukų;2531635671;Taip;4;1;0;5
5720;Ozas;Nykškukų;9685593404;Taip;15;0;0;15
5721;Pabiručiai;Voveriukų;4539246865;Taip;0;3;0;3
5722;Pabiručiai;Voveriukų;9564303781;Taip;2;4;2;8
5723;Pabiručiai;Voveriukų;4312364951;Taip;15;4;0;19
5724;Pabiručiai;Voveriukų;3756731363;Taip;0;5;1;6
5725;Pabiručiai;Voveriukų;7985360502;Taip;3;0;2;5
5726;Pabiručiai;Voveriukų;3936426174;Taip;0;0;1;1
5727;Pabiručiai;Voveriukų;4069564285;Taip;4;4;0;8
5728;Pabiručiai;Voveriukų;7278334800;Taip;0;3;0;3
5729;Pabiručiai;Voveriukų;9468698553;Taip;2;9;0;11
5730;Pabiručiai;Voveriukų;7066037017;Taip;0;1;0;1
5731;Pabiručiai;Voveriukų;5549851164;Taip;0;4;0;4
5732;Pabiručiai;Voveriukų;4040533883;Taip;0;5;0;5
5733;Pabiručiai;Voveriukų;2514312233;Taip;2;1;0;3
5734;Pabiručiai;Voveriukų;7606274875;Taip;2;0;0;2
5735;Pabiručiai;Voveriukų;9356327400;Taip;0;3;0;3
5736;Pabiručiai;Voveriukų;4813206044;Taip;0;7;0;7
5737;Pabiručiai;Boružiukų;6401188653;Taip;1;2;0;3
5738;Pabiručiai;Boružiukų;1673473814;Taip;6;3;0;9
5739;Pabiručiai;Boružiukų;5686769648;Taip;4;10;0;14
5740;Pabiručiai;Boružiukų;5708597471;Taip;10;0;0;10
5741;Pabiručiai;Boružiukų;4006783343;Taip;0;1;0;1
5742;Pabiručiai;Boružiukų;7046122545;Taip;11;0;0;11
5743;Pabiručiai;Boružiukų;3096466200;Taip;0;4;0;4
5744;Pabiručiai;Boružiukų;4301904533;Taip;0;5;0;5
5745;Pabiručiai;Boružiukų;8236964683;Taip;0;6;0;6
5746;Pabiručiai;Boružiukų;1240057541;Taip;0;8;0;8
5747;Pabiručiai;Boružiukų;1671027282;Taip;7;2;0;9
5748;Pabiručiai;Boružiukų;3759350345;Taip;5;0;0;5
5749;Pabiručiai;Boružiukų;3151360288;Taip;0;6;0;6
5750;Pabiručiai;Boružiukų;9299393363;Taip;0;5;0;5
5751;Pabiručiai;Boružiukų;1484291546;Taip;0;5;0;5
5752;Pabiručiai;Boružiukų;2771769336;Taip;0;4;0;4
5753;Pabiručiai;Boružiukų;2607840684;Taip;8;4;0;12
5754;Pabiručiai;Boružiukų;4681771534;Taip;10;1;0;11
5755;Pabiručiai;Boružiukų;7050339198;Taip;10;6;0;16
5756;Pabiručiai;Boružiukų;4798503931;Taip;8;0;0;8
5757;Pabiručiai;Katinėlių;8649685325;Taip;8;3;0;11
5758;Pabiručiai;Katinėlių;5737214746;Taip;5;4;0;9
5759;Pabiručiai;Katinėlių;4929129093;Ne;15;3;0;18
5760;Pabiručiai;Katinėlių;2141365015;Taip;4;0;0;4
5761;Pabiručiai;Katinėlių;7914642744;Taip;4;0;0;4
5762;Pabiručiai;Katinėlių;1099080685;Taip;0;17;0;17
5763;Pabiručiai;Katinėlių;3011601512;Taip;9;0;0;9
5764;Pabiručiai;Katinėlių;4852287574;Taip;5;0;0;5
5765;Pabiručiai;Katinėlių;3826505104;Taip;6;1;0;7
5766;Pabiručiai;Katinėlių;6678717039;Taip;8;2;0;10
5767;Pabiručiai;Katinėlių;7798837336;Taip;8;4;0;12
5768;Pabiručiai;Katinėlių;6742744014;Taip;0;10;0;10
5769;Pabiručiai;Katinėlių;1206012259;Taip;0;11;0;11
5770;Pabiručiai;Katinėlių;9790360371;Taip;3;7;0;10
5771;Pabiručiai;Katinėlių;9890225918;Taip;5;7;0;12
5772;Pabiručiai;Katinėlių;5923385276;Taip;4;2;0;6
5773;Pabiručiai;Katinėlių;1138743823;Ne;7;7;0;14
5774;Pabiručiai;Katinėlių;1652633130;Taip;5;1;0;6
5775;Pabiručiai;Katinėlių;9813153308;Taip;3;0;0;3
5776;Pabiručiai;Katinėlių;6508093808;Ne;0;4;0;4
5777;Pabiručiai;Žiogelių;3531292373;Taip;0;9;0;9
5778;Pabiručiai;Žiogelių;1247522345;Taip;17;0;0;17
5779;Pabiručiai;Žiogelių;9878655387;Taip;11;0;0;11
5780;Pabiručiai;Žiogelių;8092886420;Ne;10;1;0;11
5781;Pabiručiai;Žiogelių;4012537474;Taip;6;0;0;6
5782;Pabiručiai;Žiogelių;7561916887;Taip;5;0;0;5
5783;Pabiručiai;Žiogelių;9651695086;Taip;0;5;0;5
5784;Pabiručiai;Žiogelių;5050966784;Taip;14;4;0;18
5785;Pabiručiai;Žiogelių;3262687187;Taip;0;1;0;1
5786;Pabiručiai;Žiogelių;4096412988;Taip;7;0;0;7
5787;Pabiručiai;Žiogelių;4876140467;Taip;7;2;0;9
5788;Pabiručiai;Žiogelių;5862643827;Ne;9;4;0;13
5789;Pabiručiai;Žiogelių;6014791534;Taip;4;0;0;4
5790;Pabiručiai;Žiogelių;5704073222;Taip;5;0;0;5
5791;Pabiručiai;Žiogelių;5019580409;Taip;4;0;0;4
5792;Pabiručiai;Žiogelių;8870657682;Ne;5;0;0;5
5793;Pabiručiai;Žiogelių;2924005478;Taip;13;0;0;13
5794;Pabiručiai;Žiogelių;8668524776;Taip;0;4;0;4
5795;Pabiručiai;Žiogelių;6513943228;Ne;13;0;0;13
5796;Pabiručiai;Žiogelių;4755427277;Taip;3;0;0;3
5797;Pabiručiai;Žiogelių;7873575929;Ne;7;0;0;7
5798;Pabiručiai;Smalsiukai;2869383175;Taip;0;0;1;1
5799;Pabiručiai;Smalsiukai;7677235214;Taip;0;0;1;1
5800;Pabiručiai;Smalsiukai;9676561758;Taip;0;3;0;3
5801;Pabiručiai;Smalsiukai;7090116276;Taip;0;9;1;10
5802;Pabiručiai;Smalsiukai;4408666547;Taip;0;0;1;1
5803;Pabiručiai;Smalsiukai;9093137227;Taip;0;5;0;5
5804;Pabiručiai;Smalsiukai;6935913132;Ne;0;2;0;2
5805;Pabiručiai;Smalsiukai;7663581089;Taip;4;9;0;13
5806;Pabiručiai;Smalsiukai;7248314871;Taip;2;0;0;2
5807;Pabiručiai;Smalsiukai;9610623364;Taip;0;1;0;1
5808;Pabiručiai;Smalsiukai;8897462614;Taip;0;6;0;6
5809;Pabiručiai;Smalsiukai;2332338995;Ne;16;0;0;16
5810;Pabiručiai;Smalsiukai;4258226042;Ne;0;1;0;1
5811;Pabiručiai;Smalsiukai;3511851810;Taip;4;5;2;11
5812;Pabiručiai;Smalsiukai;6686039601;Taip;12;4;2;18
5813;Pabiručiai;Smalsiukai;5420231066;Taip;0;1;0;1
5814;Pabiručiai;Smalsiukai;8840885039;Taip;0;0;2;2
5815;Pabiručiai;Smalsiukai;2771891999;Taip;2;0;4;6
5816;Pabiručiai;Smalsiukai;7295052694;Ne;0;4;0;4
5817;Pabiručiai;Smalsiukai;6834663627;Taip;0;11;0;11
5818;Pabiručiai;Kiškučiai;9589005897;Taip;12;0;0;12
5819;Pabiručiai;Kiškučiai;9353062804;Taip;18;0;0;18
5820;Pabiručiai;Kiškučiai;1582754284;Taip;23;0;0;23
5821;Pabiručiai;Kiškučiai;4462744848;Ne;5;13;0;18
5822;Pabiručiai;Kiškučiai;5621183663;Taip;2;1;0;3
5823;Pabiručiai;Kiškučiai;5497318373;Taip;5;0;0;5
5824;Pabiručiai;Kiškučiai;9417138573;Taip;6;0;0;6
5825;Pabiručiai;Kiškučiai;1515270273;Taip;9;5;0;14
5826;Pabiručiai;Kiškučiai;2688728915;Taip;9;7;0;16
5827;Pabiručiai;Kiškučiai;5166525832;Taip;14;0;0;14
5828;Pabiručiai;Kiškučiai;8409455566;Taip;9;3;0;12
5829;Pabiručiai;Kiškučiai;1028312285;Taip;5;0;0;5
5830;Pabiručiai;Kiškučiai;5346249456;Taip;15;0;0;15
5831;Pabiručiai;Kiškučiai;5717534175;Taip;0;2;0;2
5832;Pabiručiai;Kiškučiai;3408518493;Taip;8;4;0;12
5833;Pabiručiai;Kiškučiai;7653129291;Taip;12;0;0;12
5834;Pabiručiai;Kiškučiai;7073230645;Taip;15;0;0;15
5835;Pabiručiai;Kiškučiai;8820585407;Taip;0;7;0;7
5836;Pabiručiai;Kiškučiai;7572077461;Taip;0;6;0;6
5837;Pabiručiai;Kiškučiai;5767879226;Taip;0;4;0;4
5838;Pabiručiai;Kiškučiai;6073797962;Taip;0;5;0;5
5839;Pabiručiai;"Pėledžiukai ";9834824219;Taip;14;4;0;18
5840;Pabiručiai;"Pėledžiukai ";1683369842;Ne;2;0;0;2
5841;Pabiručiai;"Pėledžiukai ";7961879916;Taip;7;0;0;7
5842;Pabiručiai;"Pėledžiukai ";9050994322;Taip;12;0;0;12
5843;Pabiručiai;"Pėledžiukai ";1049154287;Taip;5;0;0;5
5844;Pabiručiai;"Pėledžiukai ";6697518151;Taip;8;4;0;12
5845;Pabiručiai;"Pėledžiukai ";2596301235;Taip;0;2;0;2
5846;Pabiručiai;"Pėledžiukai ";4333645528;Taip;0;6;0;6
5847;Pabiručiai;"Pėledžiukai ";6289025538;Taip;0;12;0;12
5848;Pabiručiai;"Pėledžiukai ";2812291058;Taip;0;0;1;1
5849;Pabiručiai;"Pėledžiukai ";2343561322;Taip;0;5;0;5
5850;Pabiručiai;"Pėledžiukai ";3674583662;Taip;8;4;0;12
5851;Pabiručiai;"Pėledžiukai ";8268101318;Taip;7;4;0;11
5852;Pabiručiai;"Pėledžiukai ";2147165934;Taip;3;1;0;4
5853;Pabiručiai;"Pėledžiukai ";7385149524;Taip;6;0;0;6
5854;Pabiručiai;"Pėledžiukai ";3224195892;Taip;0;2;1;3
5855;Pabiručiai;"Pėledžiukai ";1852744763;Taip;17;0;0;17
5856;Pabiručiai;"Pėledžiukai ";5165268747;Taip;0;4;0;4
5857;Pabiručiai;"Pėledžiukai ";1971996148;Taip;0;3;0;3
5858;Pabiručiai;"Kodelčiūkai ";5950654594;Taip;2;0;0;2
5859;Pabiručiai;"Kodelčiūkai ";8775727677;Taip;0;3;0;3
5860;Pabiručiai;"Kodelčiūkai ";2295503584;Ne;8;8;0;16
5861;Pabiručiai;"Kodelčiūkai ";4595458527;Taip;7;0;0;7
5862;Pabiručiai;"Kodelčiūkai ";8716879106;Taip;3;9;0;12
5863;Pabiručiai;"Kodelčiūkai ";9067653417;Taip;4;0;0;4
5864;Pabiručiai;"Kodelčiūkai ";5247780866;Taip;4;3;0;7
5865;Pabiručiai;"Kodelčiūkai ";3433419710;Taip;18;0;0;18
5866;Pabiručiai;"Kodelčiūkai ";6386335808;Taip;13;0;0;13
5867;Pabiručiai;"Kodelčiūkai ";5010271037;Taip;3;0;0;3
5868;Pabiručiai;"Kodelčiūkai ";9538339883;Taip;1;0;0;1
5869;Pabiručiai;"Kodelčiūkai ";8149732126;Taip;6;0;0;6
5870;Pabiručiai;"Kodelčiūkai ";6209553290;Taip;2;0;0;2
5871;Pabiručiai;"Kodelčiūkai ";3497466298;Taip;0;3;0;3
5872;Pabiručiai;"Kodelčiūkai ";8179285338;Taip;0;8;0;8
5873;Pabiručiai;"Kodelčiūkai ";1234230729;Taip;3;0;0;3
5874;Pabiručiai;"Kodelčiūkai ";2519371211;Taip;14;0;0;14
5875;Pabiručiai;"Kodelčiūkai ";5211115955;Taip;10;0;0;10
5876;Pabiručiai;"Kodelčiūkai ";2433997383;Taip;17;0;0;17
5877;Pabiručiai;"Peliukų ";3702521810;Taip;5;4;0;9
5878;Pabiručiai;"Peliukų ";1947729077;Taip;6;0;0;6
5879;Pabiručiai;"Peliukų ";1776325000;Taip;12;0;0;12
5880;Pabiručiai;"Peliukų ";7644854044;Taip;5;15;0;20
5881;Pabiručiai;"Peliukų ";9806520732;Taip;11;0;0;11
5882;Pabiručiai;"Peliukų ";2765716248;Taip;13;0;0;13
5883;Pabiručiai;"Peliukų ";8551913254;Taip;19;0;0;19
5884;Pabiručiai;"Peliukų ";1638037202;Taip;9;0;0;9
5885;Pabiručiai;"Peliukų ";6603404126;Taip;10;0;0;10
5886;Pabiručiai;"Peliukų ";1414752034;Ne;0;1;0;1
5887;Pabiručiai;"Peliukų ";2860703696;Taip;9;0;0;9
5888;Pabiručiai;"Peliukų ";3128998397;Taip;3;0;0;3
5889;Pabiručiai;"Peliukų ";1707526401;Taip;9;0;0;9
5890;Pabiručiai;"Peliukų ";5980457097;Taip;12;0;0;12
5891;Pabiručiai;"Viščiukų ";8048012241;Taip;3;0;0;3
5892;Pabiručiai;"Viščiukų ";2757879842;Taip;11;0;0;11
5893;Pabiručiai;"Viščiukų ";7101741906;Taip;23;0;0;23
5894;Pabiručiai;"Viščiukų ";3372218487;Taip;8;0;0;8
5895;Pabiručiai;"Viščiukų ";6044682613;Taip;4;0;0;4
5896;Pabiručiai;"Viščiukų ";7537470611;Taip;9;0;0;9
5897;Pabiručiai;"Viščiukų ";6581286069;Taip;13;0;0;13
5898;Pabiručiai;"Viščiukų ";3400423825;Taip;9;0;0;9
5899;Pabiručiai;"Viščiukų ";4078487035;Taip;9;0;0;9
5900;Pabiručiai;"Viščiukų ";7183696280;Taip;3;1;0;4
5901;Pabiručiai;"Viščiukų ";6547174468;Taip;4;0;0;4
5902;Pabiručiai;"Viščiukų ";4554910957;Taip;6;0;0;6
5903;Pabiručiai;"Viščiukų ";8571325340;Taip;7;9;0;16
5904;Pabiručiai;"Drugelių ";9890868992;Ne;14;0;0;14
5905;Pabiručiai;"Drugelių ";2556330147;Taip;0;11;0;11
5906;Pabiručiai;"Drugelių ";3004152898;Taip;5;5;0;10
5907;Pabiručiai;"Drugelių ";4701982784;Taip;6;0;0;6
5908;Pabiručiai;"Drugelių ";5147367745;Taip;6;0;0;6
5909;Pabiručiai;"Drugelių ";7469111351;Taip;13;0;0;13
5910;Pabiručiai;"Drugelių ";3189763918;Taip;13;3;0;16
5911;Pabiručiai;"Drugelių ";8268444485;Taip;2;0;0;2
5912;Pabiručiai;"Drugelių ";8066935182;Taip;13;0;1;14
5913;Pabiručiai;"Drugelių ";6831781849;Taip;5;0;0;5
5914;Pabiručiai;"Drugelių ";9297511341;Taip;9;0;0;9
5915;Pabiručiai;ŽIRNIUKŲ;9507212682;Taip;0;4;0;4
5916;Pabiručiai;ŽIRNIUKŲ;3239143202;Taip;9;0;2;11
5917;Pabiručiai;ŽIRNIUKŲ;8756826405;Taip;9;4;0;13
5918;Pabiručiai;ŽIRNIUKŲ;6059282085;Taip;4;3;0;7
5919;Pabiručiai;ŽIRNIUKŲ;4600476221;Taip;3;2;0;5
5920;Pabiručiai;ŽIRNIUKŲ;9042431134;Taip;13;0;1;14
5921;Pabiručiai;ŽIRNIUKŲ;1537534207;Taip;7;0;0;7
5922;Pabiručiai;ŽIRNIUKŲ;2142523078;Taip;0;2;0;2
5923;Pabiručiai;ŽIRNIUKŲ;3370660254;Taip;19;0;2;21
5924;Pabiručiai;ŽIRNIUKŲ;4229089612;Taip;15;0;0;15
5925;Pabiručiai;ŽIRNIUKŲ;8834001928;Taip;12;1;0;13
5926;Pabiručiai;ŽIRNIUKŲ;9185016818;Taip;15;4;0;19
5927;Pabiručiai;ŽIRNIUKŲ;2141466782;Taip;9;0;0;9
5928;Pabiručiai;ŽIRNIUKŲ;9748002526;Taip;4;0;0;4
5929;Pabiručiai;ŽIRNIUKŲ;5436055219;Taip;3;2;0;5
5930;Pabiručiai;ŽIRNIUKŲ;6601800828;Taip;16;0;0;16
5931;Pabiručiai;ŽIRNIUKŲ;8074555646;Taip;0;6;0;6
5932;Pagrandukas;Saulytės;6915087488;Taip;0;2;0;2
5933;Pagrandukas;Saulytės;6349387692;Taip;14;0;0;14
5934;Pagrandukas;Saulytės;8186092469;Taip;0;4;0;4
5935;Pagrandukas;Saulytės;2934300533;Taip;0;11;0;11
5936;Pagrandukas;Saulytės;1548697124;Taip;0;7;0;7
5937;Pagrandukas;Saulytės;6711830251;Taip;4;3;0;7
5938;Pagrandukas;Saulytės;7146697128;Taip;5;2;0;7
5939;Pagrandukas;Saulytės;3157676207;Taip;0;4;0;4
5940;Pagrandukas;Saulytės;7511097160;Taip;1;9;0;10
5941;Pagrandukas;Saulytės;3783160018;Taip;0;4;0;4
5942;Pagrandukas;Saulytės;7454863899;Taip;4;1;0;5
5943;Pagrandukas;Saulytės;5560372136;Taip;2;2;0;4
5944;Pagrandukas;Saulytės;1766912463;Taip;4;1;0;5
5945;Pagrandukas;Saulytės;9849054467;Taip;5;5;0;10
5946;Pagrandukas;Saulytės;8024910647;Taip;0;4;0;4
5947;Pagrandukas;Saulytės;8481502330;Taip;3;2;0;5
5948;Pagrandukas;Saulytės;7160305478;Taip;0;3;0;3
5949;Pagrandukas;Saulytės;3008997793;Taip;1;7;0;8
5950;Pagrandukas;Saulytės;6388805960;Taip;7;7;0;14
5951;Pagrandukas;Saulytės;3050207849;Taip;0;1;0;1
5952;Pagrandukas;Saulytės;8836178193;Taip;7;8;0;15
5953;Pagrandukas;Saulytės;7157549179;Taip;1;2;0;3
5954;Pagrandukas;Zuikučiai;7834436515;Taip;0;10;0;10
5955;Pagrandukas;Zuikučiai;7435609306;Taip;5;0;0;5
5956;Pagrandukas;Zuikučiai;5903416384;Taip;4;4;1;9
5957;Pagrandukas;Zuikučiai;2439891231;Taip;0;3;6;9
5958;Pagrandukas;Zuikučiai;6710887776;Taip;0;3;6;9
5959;Pagrandukas;Zuikučiai;7665811353;Taip;0;0;1;1
5960;Pagrandukas;Zuikučiai;2212787835;Taip;0;5;0;5
5961;Pagrandukas;Zuikučiai;2711590019;Taip;0;0;11;11
5962;Pagrandukas;Zuikučiai;6449029299;Ne;0;0;1;1
5963;Pagrandukas;Zuikučiai;1405820070;Taip;6;1;0;7
5964;Pagrandukas;Zuikučiai;1054107640;Taip;0;5;3;8
5965;Pagrandukas;Zuikučiai;1885539883;Taip;0;4;0;4
5966;Pagrandukas;Zuikučiai;1795582354;Taip;0;5;0;5
5967;Pagrandukas;Zuikučiai;2822538227;Taip;0;0;2;2
5968;Pagrandukas;Zuikučiai;1587839122;Taip;8;0;0;8
5969;Pagrandukas;Zuikučiai;2101505576;Taip;0;1;5;6
5970;Pagrandukas;Zuikučiai;6765346578;Taip;0;1;1;2
5971;Pagrandukas;Zuikučiai;5922595170;Taip;0;2;0;2
5972;Pagrandukas;Zuikučiai;5030928303;Taip;0;3;1;4
5973;Pagrandukas;Zuikučiai;9139212151;Taip;0;10;1;11
5974;Pagrandukas;Zuikučiai;8643993939;Taip;0;1;2;3
5975;Pagrandukas;Zuikučiai;5021106231;Taip;2;4;1;7
5976;Pagrandukas;Boružėlių;5330598431;Taip;10;0;0;10
5977;Pagrandukas;Boružėlių;9141829963;Taip;0;9;1;10
5978;Pagrandukas;Boružėlių;3643271023;Taip;21;0;0;21
5979;Pagrandukas;Boružėlių;7897742424;Taip;8;0;0;8
5980;Pagrandukas;Boružėlių;3313757952;Taip;6;0;0;6
5981;Pagrandukas;Boružėlių;4013188468;Taip;9;2;0;11
5982;Pagrandukas;Boružėlių;8812047984;Taip;20;0;0;20
5983;Pagrandukas;Boružėlių;2893099852;Taip;10;1;0;11
5984;Pagrandukas;Boružėlių;7219415600;Taip;6;4;1;11
5985;Pagrandukas;Boružėlių;1552515788;Taip;2;6;1;9
5986;Pagrandukas;Boružėlių;6506518248;Taip;0;21;0;21
5987;Pagrandukas;Boružėlių;2244308184;Taip;3;1;1;5
5988;Pagrandukas;Boružėlių;4730178155;Taip;21;1;0;22
5989;Pagrandukas;Boružėlių;8869609106;Taip;9;0;2;11
5990;Pagrandukas;Boružėlių;2752197975;Taip;6;0;1;7
5991;Pagrandukas;Boružėlių;8948739929;Taip;0;2;0;2
5992;Pagrandukas;Boružėlių;9390682686;Taip;8;0;0;8
5993;Pagrandukas;Bitutės;9188382746;Taip;1;0;0;1
5994;Pagrandukas;Bitutės;1583104760;Taip;4;5;0;9
5995;Pagrandukas;Bitutės;5649084353;Taip;0;5;0;5
5996;Pagrandukas;Bitutės;5821945401;Taip;5;0;2;7
5997;Pagrandukas;Bitutės;7675694987;Taip;6;1;0;7
5998;Pagrandukas;Bitutės;3709131197;Taip;2;5;0;7
5999;Pagrandukas;Bitutės;2764732768;Taip;8;0;0;8
6000;Pagrandukas;Bitutės;9987717045;Taip;12;0;0;12
6001;Pagrandukas;Bitutės;4771506131;Taip;11;6;1;18
6002;Pagrandukas;Bitutės;9798727946;Taip;9;0;0;9
6003;Pagrandukas;Bitutės;5464426019;Taip;8;0;0;8
6004;Pagrandukas;Bitutės;6845210200;Taip;6;17;0;23
6005;Pagrandukas;Bitutės;6090721838;Taip;0;0;2;2
6006;Pagrandukas;Bitutės;6129335910;Taip;10;0;3;13
6007;Pagrandukas;Bitutės;1780452241;Taip;4;7;1;12
6008;Pagrandukas;Bitutės;3795172018;Taip;3;0;0;3
6009;Pagrandukas;Bitutės;5604315555;Taip;0;3;0;3
6010;Pagrandukas;Bitutės;7784155503;Taip;0;3;0;3
6011;Pagrandukas;Bitutės;7605508460;Taip;0;16;0;16
6012;Pagrandukas;Bitutės;6304701617;Taip;0;4;0;4
6013;Pagrandukas;Bitutės;5511396314;Taip;0;10;0;10
6014;Pagrandukas;Pelėdžiukai;1714449109;Taip;0;4;0;4
6015;Pagrandukas;Pelėdžiukai;3160109801;Taip;0;5;0;5
6016;Pagrandukas;Pelėdžiukai;7764147734;Taip;0;1;0;1
6017;Pagrandukas;Pelėdžiukai;8633116370;Taip;0;1;0;1
6018;Pagrandukas;Pelėdžiukai;2877401332;Taip;5;5;0;10
6019;Pagrandukas;Pelėdžiukai;8167118045;Taip;8;0;0;8
6020;Pagrandukas;Pelėdžiukai;3390664086;Taip;0;15;0;15
6021;Pagrandukas;Pelėdžiukai;1733723373;Taip;4;0;0;4
6022;Pagrandukas;Pelėdžiukai;6011346969;Taip;9;0;0;9
6023;Pagrandukas;Pelėdžiukai;1077792535;Taip;5;1;0;6
6024;Pagrandukas;Pelėdžiukai;9583471280;Taip;4;1;0;5
6025;Pagrandukas;Pelėdžiukai;4398016119;Taip;2;1;0;3
6026;Pagrandukas;Pelėdžiukai;2640777376;Taip;2;0;0;2
6027;Pagrandukas;Pelėdžiukai;4910151924;Taip;11;1;0;12
6028;Pagrandukas;Pelėdžiukai;9431513632;Taip;0;9;0;9
6029;Pagrandukas;Pelėdžiukai;1977974235;Taip;4;0;0;4
6030;Pagrandukas;Pelėdžiukai;7238694532;Taip;0;4;0;4
6031;Pagrandukas;Pelėdžiukai;4014238120;Taip;8;0;0;8
6032;Pagrandukas;Pelėdžiukai;8789320226;Taip;0;5;1;6
6033;Pagrandukas;Pelėdžiukai;1308066299;Taip;1;0;0;1
6034;Pagrandukas;Pelėdžiukai;3569618725;Taip;8;0;0;8
6035;Pagrandukas;ŠYPSENĖLIŲ;7173561328;Taip;4;0;0;4
6036;Pagrandukas;ŠYPSENĖLIŲ;1101989969;Taip;1;0;0;1
6037;Pagrandukas;ŠYPSENĖLIŲ;5701479990;Taip;18;0;0;18
6038;Pagrandukas;ŠYPSENĖLIŲ;8027783692;Taip;2;0;0;2
6039;Pagrandukas;ŠYPSENĖLIŲ;2904880156;Taip;7;0;0;7
6040;Pagrandukas;ŠYPSENĖLIŲ;5173633710;Taip;6;0;0;6
6041;Pagrandukas;ŠYPSENĖLIŲ;6057078416;Taip;2;17;0;19
6042;Pagrandukas;ŠYPSENĖLIŲ;1855833141;Taip;1;0;0;1
6043;Pagrandukas;ŠYPSENĖLIŲ;1475375452;Taip;15;0;0;15
6044;Pagrandukas;ŠYPSENĖLIŲ;6517393406;Taip;5;4;0;9
6045;Pagrandukas;ŠYPSENĖLIŲ;4094086585;Taip;1;0;0;1
6046;Pagrandukas;ŠYPSENĖLIŲ;6306635507;Taip;0;9;0;9
6047;Pagrandukas;ŠYPSENĖLIŲ;1728795744;Taip;7;0;0;7
6048;Pagrandukas;ŠYPSENĖLIŲ;8728782427;Taip;9;0;0;9
6049;Pagrandukas;ŠYPSENĖLIŲ;8638429638;Taip;5;0;0;5
6050;Pakalnutė;Pagrandukai;7475119623;Taip;0;7;0;7
6051;Pakalnutė;Pagrandukai;9677810607;Taip;1;14;0;15
6052;Pakalnutė;Pagrandukai;5275833872;Taip;2;3;0;5
6053;Pakalnutė;Pagrandukai;2296079246;Taip;2;4;0;6
6054;Pakalnutė;Pagrandukai;9313588621;Taip;9;0;0;9
6055;Pakalnutė;Pagrandukai;7962849592;Taip;1;0;0;1
6056;Pakalnutė;Pagrandukai;5180015882;Taip;5;0;0;5
6057;Pakalnutė;Pagrandukai;3794283102;Taip;0;1;0;1
6058;Pakalnutė;Pagrandukai;3070652992;Taip;0;4;0;4
6059;Pakalnutė;Pagrandukai;8522585063;Taip;0;1;0;1
6060;Pakalnutė;Pagrandukai;4390444128;Taip;2;0;0;2
6061;Pakalnutė;Pagrandukai;2642359967;Taip;6;0;0;6
6062;Pakalnutė;Pagrandukai;7417131378;Taip;5;1;0;6
6063;Pakalnutė;Pagrandukai;6396963609;Taip;5;0;0;5
6064;Pakalnutė;Pagrandukai;1883500676;Taip;0;4;0;4
6065;Pakalnutė;Pagrandukai;9537826109;Taip;2;0;0;2
6066;Pakalnutė;Pagrandukai;7669135310;Taip;1;0;0;1
6067;Pakalnutė;"Pelėdžiukų ";8730363504;Taip;11;0;0;11
6068;Pakalnutė;"Pelėdžiukų ";6002425101;Taip;14;0;0;14
6069;Pakalnutė;"Pelėdžiukų ";6592271501;Taip;7;1;0;8
6070;Pakalnutė;"Pelėdžiukų ";7028010813;Taip;5;0;0;5
6071;Pakalnutė;"Pelėdžiukų ";9167525974;Taip;1;0;0;1
6072;Pakalnutė;"Pelėdžiukų ";6981958616;Taip;19;0;0;19
6073;Pakalnutė;"Pelėdžiukų ";3139358443;Taip;17;0;0;17
6074;Pakalnutė;"Pelėdžiukų ";1999933222;Taip;7;0;0;7
6075;Pakalnutė;"Pelėdžiukų ";1783674258;Taip;2;0;0;2
6076;Pakalnutė;"Pelėdžiukų ";9624523658;Taip;18;0;0;18
6077;Pakalnutė;"Pelėdžiukų ";9517878047;Taip;5;0;0;5
6078;Pakalnutė;"Pelėdžiukų ";1307260377;Taip;5;0;0;5
6079;Pakalnutė;"Pelėdžiukų ";6555749105;Taip;9;0;0;9
6080;Pakalnutė;"Pelėdžiukų ";9253328160;Taip;12;0;0;12
6081;Pakalnutė;"Pelėdžiukų ";6866535420;Taip;9;0;0;9
6082;Pakalnutė;"Pelėdžiukų ";8996675127;Taip;9;4;0;13
6083;Pakalnutė;Ežiukai;5058727058;Taip;0;4;0;4
6084;Pakalnutė;Ežiukai;4052166895;Taip;3;0;0;3
6085;Pakalnutė;Ežiukai;9323200833;Taip;3;4;0;7
6086;Pakalnutė;Ežiukai;9256219647;Taip;0;4;0;4
6087;Pakalnutė;Ežiukai;4317305712;Taip;6;0;0;6
6088;Pakalnutė;Ežiukai;6029905101;Taip;5;0;0;5
6089;Pakalnutė;Ežiukai;7734657452;Taip;9;0;0;9
6090;Pakalnutė;Ežiukai;8081932074;Taip;1;6;0;7
6091;Pakalnutė;Ežiukai;9706455707;Taip;4;0;0;4
6092;Pakalnutė;Ežiukai;7881545979;Ne;0;5;0;5
6093;Pakalnutė;Ežiukai;8080989574;Taip;16;0;0;16
6094;Pakalnutė;Ežiukai;5911381706;Taip;2;1;0;3
6095;Pakalnutė;Ežiukai;2755412687;Taip;3;0;0;3
6096;Pakalnutė;Ežiukai;8236718590;Taip;0;1;0;1
6097;Pakalnutė;Ežiukai;3064391379;Taip;16;0;1;17
6098;Pakalnutė;Ežiukai;2015778005;Taip;3;0;0;3
6099;Pakalnutė;Ežiukai;8329725085;Taip;2;0;0;2
6100;Pakalnutė;Ežiukai;1662773049;Taip;4;0;0;4
6101;Pakalnutė;Ežiukai;4961361687;Taip;10;0;0;10
6102;Pakalnutė;Ežiukai;5685361033;Taip;9;0;1;10
6103;Pakalnutė;Skruzdėliukų;4033813807;Taip;12;4;0;16
6104;Pakalnutė;Skruzdėliukų;5409476517;Taip;0;18;0;18
6105;Pakalnutė;Skruzdėliukų;7105369111;Taip;11;0;0;11
6106;Pakalnutė;Skruzdėliukų;6944726166;Taip;7;0;4;11
6107;Pakalnutė;Skruzdėliukų;1195872320;Taip;0;4;0;4
6108;Pakalnutė;Skruzdėliukų;3211633472;Taip;4;0;0;4
6109;Pakalnutė;Skruzdėliukų;4423348418;Taip;4;4;0;8
6110;Pakalnutė;Skruzdėliukų;6055727963;Taip;7;1;0;8
6111;Pakalnutė;Skruzdėliukų;3215438452;Taip;0;3;0;3
6112;Pakalnutė;Skruzdėliukų;9681515221;Taip;7;0;0;7
6113;Pakalnutė;Skruzdėliukų;8496839980;Ne;3;4;0;7
6114;Pakalnutė;Skruzdėliukų;9336711927;Taip;9;6;0;15
6115;Pakalnutė;Skruzdėliukų;5356902834;Taip;19;0;0;19
6116;Pakalnutė;Skruzdėliukų;1540045675;Taip;0;4;0;4
6117;Pakalnutė;Skruzdėliukų;8768704484;Taip;4;0;0;4
6118;Pakalnutė;Skruzdėliukų;6675588261;Taip;10;0;0;10
6119;Pakalnutė;Bitučių;8461220770;Taip;0;1;0;1
6120;Pakalnutė;Bitučių;2367683002;Taip;0;1;0;1
6121;Pakalnutė;Bitučių;2765220889;Taip;7;4;0;11
6122;Pakalnutė;Bitučių;9445909071;Taip;0;1;0;1
6123;Pakalnutė;Bitučių;5532458706;Taip;0;3;0;3
6124;Pakalnutė;Bitučių;7526989580;Taip;4;0;0;4
6125;Pakalnutė;Bitučių;3306334576;Taip;4;1;0;5
6126;Pakalnutė;Bitučių;2095540372;Taip;5;0;0;5
6127;Pakalnutė;Bitučių;5464143742;Taip;23;0;0;23
6128;Pakalnutė;Bitučių;6351193702;Taip;3;0;0;3
6129;Pakalnutė;Bitučių;3965390135;Taip;9;5;0;14
6130;Pakalnutė;Bitučių;5355198213;Taip;7;0;0;7
6131;Pakalnutė;Bitučių;4533467194;Ne;8;0;0;8
6132;Pakalnutė;Bitučių;4523766424;Taip;0;6;0;6
6133;Pakalnutė;Bitučių;4452372238;Taip;12;1;0;13
6134;Pakalnutė;Bitučių;2992768162;Taip;11;0;0;11
6135;Pakalnutė;Bitučių;9505524183;Taip;18;0;0;18
6136;Pakalnutė;Bitučių;8900756351;Taip;3;0;0;3
6137;Pakalnutė;Bitučių;1330092247;Taip;23;0;0;23
6138;Pakalnutė;Bitučių;3267680599;Ne;6;0;0;6
6139;Pakalnutė;Boružiukų;6798939288;Taip;0;2;0;2
6140;Pakalnutė;Boružiukų;7357431226;Taip;0;4;0;4
6141;Pakalnutė;Boružiukų;5039000154;Taip;0;1;0;1
6142;Pakalnutė;Boružiukų;2835611316;Taip;0;4;0;4
6143;Pakalnutė;Boružiukų;4950195858;Taip;5;0;0;5
6144;Pakalnutė;Boružiukų;4927086034;Taip;8;0;0;8
6145;Pakalnutė;Boružiukų;6557165567;Taip;5;0;0;5
6146;Pakalnutė;Boružiukų;2597900983;Taip;1;1;0;2
6147;Pakalnutė;Boružiukų;2062721289;Taip;0;1;0;1
6148;Pakalnutė;Boružiukų;1340022702;Taip;0;5;0;5
6149;Pakalnutė;Boružiukų;6228196996;Taip;16;0;0;16
6150;Pakalnutė;Boružiukų;7563201788;Taip;2;0;0;2
6151;Pakalnutė;Boružiukų;5619262190;Taip;3;1;0;4
6152;Pakalnutė;Boružiukų;8553182620;Taip;4;0;0;4
6153;Pakalnutė;Boružiukų;3840499737;Taip;4;13;0;17
6154;Pakalnutė;Boružiukų;4220368864;Taip;1;4;0;5
6155;Pakalnutė;Boružiukų;7151877991;Taip;1;0;0;1
6156;Pakalnutė;Boružiukų;4353883274;Ne;1;0;0;1
6157;Pakalnutė;Meškiukų;2101821362;Taip;0;15;0;15
6158;Pakalnutė;Meškiukų;4069910346;Taip;0;4;0;4
6159;Pakalnutė;Meškiukų;4313652059;Taip;4;4;0;8
6160;Pakalnutė;Meškiukų;7084798190;Taip;8;0;0;8
6161;Pakalnutė;Meškiukų;6133481935;Taip;0;1;0;1
6162;Pakalnutė;Meškiukų;3693337607;Taip;18;0;0;18
6163;Pakalnutė;Meškiukų;8576580816;Taip;8;0;0;8
6164;Pakalnutė;Meškiukų;1303121160;Ne;13;0;0;13
6165;Pakalnutė;Meškiukų;6082998947;Taip;8;0;0;8
6166;Pakalnutė;Meškiukų;7696196458;Taip;6;0;0;6
6167;Pakalnutė;Meškiukų;9327477300;Taip;0;14;0;14
6168;Pakalnutė;Nykštukai;9918277117;Taip;6;0;0;6
6169;Pakalnutė;Nykštukai;8324219868;Ne;3;0;0;3
6170;Pakalnutė;Nykštukai;1864990681;Taip;2;0;0;2
6171;Pakalnutė;Nykštukai;1236187157;Taip;5;0;0;5
6172;Pakalnutė;Nykštukai;2063766287;Taip;7;0;0;7
6173;Pakalnutė;Nykštukai;6528913736;Taip;3;0;0;3
6174;Pakalnutė;Nykštukai;8217779439;Taip;9;0;0;9
6175;Pakalnutė;Nykštukai;6206296685;Taip;2;0;0;2
6176;Pakalnutė;Nykštukai;8855237588;Taip;2;0;0;2
6177;Pakalnutė;Nykštukai;1561411767;Taip;1;0;0;1
6178;Pakalnutė;Nykštukai;9443826616;Taip;7;1;0;8
6179;Pakalnutė;Nykštukai;7024440142;Taip;0;2;0;2
6180;Pakalnutė;Nykštukai;2578170222;Taip;6;0;0;6
6181;Pakalnutė;Nykštukai;5377715404;Taip;21;0;0;21
6182;Pakalnutė;Nykštukai;3938091521;Taip;17;0;0;17
6183;Pakalnutė;Nykštukai;4971065032;Taip;1;0;0;1
6184;Pakalnutė;"Zuikučių ";3992958274;Taip;5;3;0;8
6185;Pakalnutė;"Zuikučių ";7665013940;Taip;0;5;0;5
6186;Pakalnutė;"Zuikučių ";5366218312;Taip;8;0;0;8
6187;Pakalnutė;"Zuikučių ";9093281442;Taip;9;0;0;9
6188;Pakalnutė;"Zuikučių ";6346936964;Taip;0;0;1;1
6189;Pakalnutė;"Zuikučių ";8678783379;Taip;12;0;0;12
6190;Pakalnutė;"Zuikučių ";7200174700;Taip;8;6;0;14
6191;Pakalnutė;"Zuikučių ";2364777781;Taip;8;0;1;9
6192;Pakalnutė;"Zuikučių ";6817504559;Taip;4;3;0;7
6193;Pakalnutė;"Zuikučių ";4926207043;Taip;14;0;0;14
6194;Pakalnutė;"Zuikučių ";9324190244;Taip;6;0;0;6
6195;Pakalnutė;"Zuikučių ";1044084070;Taip;9;0;1;10
6196;Pakalnutė;"Zuikučių ";4587376166;Taip;14;0;0;14
6197;Pakalnutė;"Zuikučių ";7696333378;Taip;14;2;0;16
6198;Pakalnutė;"Zuikučių ";5285591409;Taip;3;0;0;3
6199;Pakalnutė;"Drugelių ";5441477374;Ne;0;5;0;5
6200;Pakalnutė;"Drugelių ";7369661890;Taip;11;0;0;11
6201;Pakalnutė;"Drugelių ";5135811550;Taip;16;0;0;16
6202;Pakalnutė;"Drugelių ";7766653114;Taip;2;0;0;2
6203;Pakalnutė;"Drugelių ";9620000116;Taip;5;0;0;5
6204;Pakalnutė;"Drugelių ";5502444590;Taip;1;0;0;1
6205;Pakalnutė;"Drugelių ";3730712580;Taip;9;0;0;9
6206;Pakalnutė;"Drugelių ";1824418095;Taip;0;4;0;4
6207;Pakalnutė;"Drugelių ";4220406978;Ne;1;0;0;1
6208;Pakalnutė;"Drugelių ";5069038636;Taip;3;0;0;3
6209;Pakalnutė;"Drugelių ";7047587606;Taip;7;11;0;18
6210;Pakalnutė;"Drugelių ";2653667596;Taip;2;4;0;6
6211;Pakalnutė;"Drugelių ";2197533802;Taip;3;1;0;4
6212;Pakalnutė;"Drugelių ";1791607977;Taip;5;4;0;9
6213;Pakalnutė;"Drugelių ";4127500142;Taip;1;4;0;5
6214;Pakalnutė;"Drugelių ";9295709508;Taip;21;0;0;21
6215;Pakalnutė;"Drugelių ";6924023022;Taip;8;0;0;8
6216;Pakalnutė;"Drugelių ";8105507156;Taip;2;4;0;6
6217;Pakalnutė;Žvirbliukų;7421275778;Taip;0;2;0;2
6218;Pakalnutė;Žvirbliukų;3190067149;Taip;0;9;0;9
6219;Pakalnutė;Žvirbliukų;8010667913;Taip;10;0;0;10
6220;Pakalnutė;Žvirbliukų;5531209454;Taip;8;0;0;8
6221;Pakalnutė;Žvirbliukų;3342793992;Taip;2;0;0;2
6222;Pakalnutė;Žvirbliukų;7258417347;Taip;4;0;0;4
6223;Pakalnutė;Žvirbliukų;5878352514;Taip;3;0;0;3
6224;Pakalnutė;Žvirbliukų;7782295402;Taip;14;0;1;15
6225;Pakalnutė;Žvirbliukų;7547661599;Taip;5;2;1;8
6226;Pakalnutė;Žvirbliukų;4469974699;Taip;4;1;0;5
6227;Pakalnutė;Žvirbliukų;3903972025;Taip;0;1;0;1
6228;Pakalnutė;Žvirbliukų;8567965305;Taip;4;0;0;4
6229;Pakalnutė;Žvirbliukų;3458404368;Taip;2;1;0;3
6230;Pakalnutė;Žvirbliukų;8394290574;Taip;3;0;0;3
6231;Pakalnutė;Žvirbliukų;8104124782;Taip;13;0;0;13
6232;Pakalnutė;Žvirbliukų;1368254053;Taip;8;0;0;8
6233;Pakalnutė;Žvirbliukų;6361966325;Taip;2;6;0;8
6234;Panerių;Rūtelė;9268618414;Taip;0;0;2;2
6235;Panerių;Rūtelė;2333355325;Taip;7;0;0;7
6236;Panerių;Rūtelė;4867297993;Taip;2;0;0;2
6237;Panerių;Rūtelė;3190117304;Taip;0;9;0;9
6238;Panerių;Rūtelė;8693113275;Taip;14;0;1;15
6239;Panerių;Rūtelė;6468190149;Taip;0;0;3;3
6240;Panerių;Rūtelė;9630302749;Taip;0;2;0;2
6241;Panerių;Rūtelė;3057714143;Taip;2;3;0;5
6242;Panerių;Rūtelė;9432171719;Taip;5;3;0;8
6243;Panerių;Rūtelė;1717129076;Ne;11;0;4;15
6244;Panerių;Rūtelė;2035822976;Taip;0;0;2;2
6245;Panerių;Rūtelė;3550194241;Taip;5;0;1;6
6246;Panerių;Rūtelė;9729731866;Taip;4;0;0;4
6247;Panerių;Rūtelė;8447920373;Taip;7;0;0;7
6248;Panerių;Rūtelė;6583134855;Taip;2;0;6;8
6249;Panerių;Rūtelė;4161189870;Taip;6;0;4;10
6250;Panerių;Rūtelė;8514805919;Taip;8;0;0;8
6251;Panerių;Rūtelė;2751334281;Taip;0;2;2;4
6252;Panerių;Rūtelė;1339256258;Ne;6;0;3;9
6253;Panerių;Gėlytės;3112608087;Taip;5;0;0;5
6254;Panerių;Gėlytės;5100874548;Taip;1;0;0;1
6255;Panerių;Gėlytės;9955613696;Taip;0;2;0;2
6256;Panerių;Gėlytės;6304387432;Taip;0;0;2;2
6257;Panerių;Gėlytės;7166964095;Taip;6;0;1;7
6258;Panerių;Gėlytės;7657860513;Taip;6;6;0;12
6259;Panerių;Gėlytės;4716214117;Taip;0;5;0;5
6260;Panerių;Gėlytės;4369979548;Taip;6;0;0;6
6261;Panerių;Gėlytės;9014387764;Taip;0;8;0;8
6262;Panerių;Gėlytės;3273655606;Ne;18;0;0;18
6263;Panerių;Gėlytės;8067240250;Ne;1;0;1;2
6264;Panerių;Gėlytės;3526636673;Taip;5;0;0;5
6265;Panerių;Gėlytės;8407995549;Taip;6;0;1;7
6266;Panerių;Gėlytės;3502494751;Taip;11;0;0;11
6267;Panerių;Gėlytės;6574858142;Taip;8;0;2;10
6268;Panerių;Gėlytės;6653710644;Taip;7;0;1;8
6269;Panerių;Gėlytės;4957564440;Taip;7;0;1;8
6270;Panerių;Gėlytės;7976634590;Taip;2;0;0;2
6271;Panerių;Gėlytės;1985780685;Ne;12;0;0;12
6272;Panerių;Boružė;6067429637;Taip;5;0;1;6
6273;Panerių;Boružė;8204542330;Taip;11;0;0;11
6274;Panerių;Boružė;9834947195;Taip;7;0;0;7
6275;Panerių;Boružė;7665286465;Ne;6;0;0;6
6276;Panerių;Boružė;7674680327;Taip;17;0;1;18
6277;Panerių;Boružė;9658945394;Ne;10;0;1;11
6278;Panerių;Boružė;5243109212;Taip;16;0;0;16
6279;Panerių;Boružė;7516118069;Taip;0;1;0;1
6280;Panerių;Boružė;9157312277;Taip;7;0;0;7
6281;Panerių;Boružė;5836583423;Ne;5;0;0;5
6282;Panerių;Boružė;6903412424;Taip;3;4;1;8
6283;Panerių;Boružė;7200320230;Taip;3;2;0;5
6284;Papartis;ZUIKUČIAI;2446379598;Taip;11;0;0;11
6285;Papartis;ZUIKUČIAI;3054883426;Taip;7;0;0;7
6286;Papartis;ZUIKUČIAI;1191546794;Taip;6;0;0;6
6287;Papartis;ZUIKUČIAI;7619963429;Taip;10;1;0;11
6288;Papartis;ZUIKUČIAI;8958880558;Taip;8;4;0;12
6289;Papartis;ZUIKUČIAI;4380030213;Taip;6;2;0;8
6290;Papartis;ZUIKUČIAI;4906248064;Taip;10;1;0;11
6291;Papartis;ZUIKUČIAI;8447326505;Taip;5;2;0;7
6292;Papartis;ZUIKUČIAI;1919362027;Taip;0;2;0;2
6293;Papartis;ZUIKUČIAI;4640068595;Taip;2;0;0;2
6294;Papartis;ZUIKUČIAI;5361925390;Taip;9;0;0;9
6295;Papartis;ZUIKUČIAI;9375751990;Taip;10;3;0;13
6296;Papartis;ZUIKUČIAI;5786648402;Taip;10;0;0;10
6297;Papartis;ZUIKUČIAI;5776038830;Taip;0;5;0;5
6298;Papartis;ZUIKUČIAI;5579899922;Taip;12;0;0;12
6299;Papartis;ZUIKUČIAI;8808902528;Taip;0;1;0;1
6300;Papartis;ZUIKUČIAI;9358310527;Taip;0;5;0;5
6301;Papartis;ZUIKUČIAI;5363926529;Taip;6;0;0;6
6302;Papartis;ZUIKUČIAI;1722192450;Taip;4;4;0;8
6303;Papartis;ZUIKUČIAI;8897061283;Taip;8;0;0;8
6304;Papartis;DRUGELIAI;7384518191;Taip;0;4;0;4
6305;Papartis;DRUGELIAI;6664178454;Taip;0;1;0;1
6306;Papartis;DRUGELIAI;2432516496;Taip;7;0;0;7
6307;Papartis;DRUGELIAI;7742769931;Taip;3;1;0;4
6308;Papartis;DRUGELIAI;8305560946;Ne;3;0;0;3
6309;Papartis;DRUGELIAI;4778327620;Taip;6;7;0;13
6310;Papartis;DRUGELIAI;7331682622;Taip;14;1;0;15
6311;Papartis;DRUGELIAI;2824078830;Taip;11;0;0;11
6312;Papartis;DRUGELIAI;8782882575;Taip;7;0;0;7
6313;Papartis;DRUGELIAI;1405767603;Taip;1;5;0;6
6314;Papartis;DRUGELIAI;6435625940;Taip;6;1;0;7
6315;Papartis;DRUGELIAI;7187797639;Taip;6;0;0;6
6316;Papartis;DRUGELIAI;3411472740;Taip;13;1;0;14
6317;Papartis;DRUGELIAI;3209105694;Taip;1;0;0;1
6318;Papartis;DRUGELIAI;8277830926;Taip;7;1;0;8
6319;Papartis;DRUGELIAI;1759982543;Taip;0;15;0;15
6320;Papartis;DRUGELIAI;4689046394;Taip;6;3;0;9
6321;Papartis;DRUGELIAI;5430993785;Taip;11;5;0;16
6322;Papartis;ŽVIRBLIUKAI;5538433120;Taip;0;1;0;1
6323;Papartis;ŽVIRBLIUKAI;9380951144;Taip;15;0;5;20
6324;Papartis;ŽVIRBLIUKAI;2812347963;Taip;0;4;2;6
6325;Papartis;ŽVIRBLIUKAI;3685642787;Taip;15;0;1;16
6326;Papartis;ŽVIRBLIUKAI;8420752169;Taip;5;4;1;10
6327;Papartis;ŽVIRBLIUKAI;4016297254;Taip;25;0;0;25
6328;Papartis;ŽVIRBLIUKAI;6585372451;Taip;2;4;1;7
6329;Papartis;ŽVIRBLIUKAI;6734567714;Taip;0;2;0;2
6330;Papartis;ŽVIRBLIUKAI;4597039190;Taip;7;0;1;8
6331;Papartis;ŽVIRBLIUKAI;1352401881;Taip;18;2;0;20
6332;Papartis;ŽVIRBLIUKAI;3539507686;Taip;10;0;0;10
6333;Papartis;ŽVIRBLIUKAI;5465955537;Taip;7;2;1;10
6334;Papartis;ŽVIRBLIUKAI;6346776139;Taip;20;0;2;22
6335;Papartis;ŽVIRBLIUKAI;3595627659;Taip;5;0;0;5
6336;Papartis;ŽVIRBLIUKAI;6977513472;Taip;2;3;0;5
6337;Papartis;ŽVIRBLIUKAI;5323875279;Taip;15;4;0;19
6338;Papartis;ŽVIRBLIUKAI;6136213985;Taip;2;3;0;5
6339;Papartis;ŽVIRBLIUKAI;7107692314;Taip;1;3;0;4
6340;Papartis;PELĖDŽIUKAI;9502229005;Taip;5;4;0;9
6341;Papartis;PELĖDŽIUKAI;1559196767;Taip;15;0;0;15
6342;Papartis;PELĖDŽIUKAI;5652560002;Taip;0;5;0;5
6343;Papartis;PELĖDŽIUKAI;6360881137;Taip;3;1;0;4
6344;Papartis;PELĖDŽIUKAI;6794076631;Taip;5;1;0;6
6345;Papartis;PELĖDŽIUKAI;6941978169;Taip;1;1;0;2
6346;Papartis;PELĖDŽIUKAI;4203241118;Taip;6;4;0;10
6347;Papartis;PELĖDŽIUKAI;9285319899;Taip;7;0;0;7
6348;Papartis;PELĖDŽIUKAI;5942160584;Taip;2;1;0;3
6349;Papartis;PELĖDŽIUKAI;9922091482;Taip;10;1;0;11
6350;Papartis;PELĖDŽIUKAI;8932290803;Taip;12;0;0;12
6351;Papartis;PELĖDŽIUKAI;1680412204;Taip;3;0;0;3
6352;Papartis;PELĖDŽIUKAI;4509843536;Taip;13;0;0;13
6353;Papartis;PELĖDŽIUKAI;6883101103;Taip;5;1;0;6
6354;Papartis;PELĖDŽIUKAI;4878190663;Taip;5;4;0;9
6355;Papartis;PELĖDŽIUKAI;9900023788;Taip;5;4;0;9
6356;Papartis;PELĖDŽIUKAI;9704930584;Taip;5;9;0;14
6357;Papartis;PELĖDŽIUKAI;9072635586;Ne;16;4;0;20
6358;Papartis;PELĖDŽIUKAI;1442806517;Taip;1;0;0;1
6359;Papartis;SAULUTĖS;8836419340;Taip;8;0;0;8
6360;Papartis;SAULUTĖS;8187136860;Taip;1;0;0;1
6361;Papartis;SAULUTĖS;6408828474;Taip;5;0;0;5
6362;Papartis;SAULUTĖS;1428163291;Taip;11;0;0;11
6363;Papartis;SAULUTĖS;6436061438;Taip;8;0;0;8
6364;Papartis;SAULUTĖS;8423259604;Taip;5;2;0;7
6365;Papartis;SAULUTĖS;4887468138;Ne;14;0;0;14
6366;Papartis;SAULUTĖS;8866437550;Taip;13;0;0;13
6367;Papartis;SAULUTĖS;9731930047;Ne;7;0;0;7
6368;Papartis;SAULUTĖS;3948323728;Taip;7;0;0;7
6369;Papartis;SAULUTĖS;2004327439;Taip;9;0;0;9
6370;Papartis;SAULUTĖS;6199807321;Taip;23;0;0;23
6371;Papartis;SAULUTĖS;4767287348;Taip;10;0;0;10
6372;Papartis;GANDRIUKAI;4969807705;Taip;12;0;0;12
6373;Papartis;GANDRIUKAI;5383936595;Taip;0;3;0;3
6374;Papartis;GANDRIUKAI;6274608449;Taip;9;0;0;9
6375;Papartis;GANDRIUKAI;6664773988;Taip;4;0;0;4
6376;Papartis;GANDRIUKAI;8875490564;Taip;10;3;0;13
6377;Papartis;GANDRIUKAI;7149853209;Taip;6;0;0;6
6378;Papartis;GANDRIUKAI;2921187615;Taip;7;0;0;7
6379;Papartis;GANDRIUKAI;5128663521;Taip;3;0;0;3
6380;Papartis;GANDRIUKAI;4500675679;Taip;0;4;0;4
6381;Papartis;GANDRIUKAI;7203919287;Taip;0;1;0;1
6382;Papartis;GANDRIUKAI;1486770896;Ne;2;0;0;2
6383;Papartis;GANDRIUKAI;5132031416;Taip;15;0;0;15
6384;Papartis;GANDRIUKAI;3395306653;Taip;20;0;0;20
6385;Papartis;GANDRIUKAI;1616537800;Taip;0;10;0;10
6386;Papartis;GANDRIUKAI;8303599213;Taip;2;0;0;2
6387;Papartis;GANDRIUKAI;9326439257;Taip;9;0;0;9
6388;Papartis;GANDRIUKAI;1656161309;Ne;7;0;0;7
6389;Papartis;GANDRIUKAI;8410744610;Taip;10;0;1;11
6390;Papartis;AITVARELIAI;8891856856;Taip;5;4;0;9
6391;Papartis;AITVARELIAI;6889782462;Taip;12;1;0;13
6392;Papartis;AITVARELIAI;8532558577;Taip;7;2;0;9
6393;Papartis;AITVARELIAI;5252947502;Taip;9;2;0;11
6394;Papartis;AITVARELIAI;1916222143;Taip;2;4;0;6
6395;Papartis;AITVARELIAI;7803854703;Taip;8;1;0;9
6396;Papartis;AITVARELIAI;4261270064;Taip;11;0;0;11
6397;Papartis;AITVARELIAI;6416605464;Taip;5;0;0;5
6398;Papartis;AITVARELIAI;7504793827;Taip;12;0;0;12
6399;Papartis;AITVARELIAI;7156767639;Taip;13;1;0;14
6400;Papartis;AITVARELIAI;5268226380;Taip;3;1;0;4
6401;Papartis;AITVARELIAI;2116140075;Taip;0;3;0;3
6402;Papartis;AITVARELIAI;4138926711;Taip;0;6;1;7
6403;Papartis;AITVARELIAI;8989172483;Taip;18;0;1;19
6404;Papartis;AITVARELIAI;9384475270;Taip;14;1;0;15
6405;Papartis;SMALSUČIAI;5660932637;Ne;7;1;0;8
6406;Papartis;SMALSUČIAI;3576856223;Taip;6;0;0;6
6407;Papartis;SMALSUČIAI;5259754395;Taip;7;3;0;10
6408;Papartis;SMALSUČIAI;1157298413;Taip;7;5;0;12
6409;Papartis;SMALSUČIAI;1381195839;Taip;6;0;0;6
6410;Papartis;SMALSUČIAI;5959006739;Taip;5;10;0;15
6411;Papartis;SMALSUČIAI;6776383676;Taip;2;8;0;10
6412;Papartis;SMALSUČIAI;9838432144;Taip;7;1;0;8
6413;Papartis;SMALSUČIAI;9884399306;Taip;6;1;0;7
6414;Papartis;SMALSUČIAI;1511111597;Taip;9;0;0;9
6415;Papartis;SMALSUČIAI;8055310718;Taip;4;1;0;5
6416;Papartis;SMALSUČIAI;7492923318;Taip;8;0;0;8
6417;Papartis;SMALSUČIAI;3490370261;Taip;20;0;0;20
6418;Papartis;SMALSUČIAI;1566259150;Taip;2;2;0;4
6419;Papartis;SMALSUČIAI;4087823915;Taip;5;0;0;5
6420;Papartis;"ŽIRNIUKAI ";3310893254;Taip;8;0;0;8
6421;Papartis;"ŽIRNIUKAI ";1073755384;Taip;10;0;4;14
6422;Papartis;"ŽIRNIUKAI ";7647225316;Taip;12;1;0;13
6423;Papartis;"ŽIRNIUKAI ";1519815331;Taip;3;1;0;4
6424;Papartis;"ŽIRNIUKAI ";4158525314;Taip;13;0;0;13
6425;Papartis;"ŽIRNIUKAI ";4978398085;Taip;9;1;0;10
6426;Papartis;"ŽIRNIUKAI ";9746397380;Taip;10;0;2;12
6427;Papartis;"ŽIRNIUKAI ";4952279543;Taip;5;5;0;10
6428;Papartis;"ŽIRNIUKAI ";5276806556;Taip;6;0;0;6
6429;Papartis;"ŽIRNIUKAI ";2521609574;Taip;9;0;1;10
6430;Papartis;"ŽIRNIUKAI ";7617558492;Taip;9;0;0;9
6431;Papartis;"ŽIRNIUKAI ";8412962815;Ne;0;0;1;1
6432;Papartis;"ŽIRNIUKAI ";2772758899;Taip;11;4;1;16
6433;Papartis;"ŽIRNIUKAI ";1183123161;Taip;0;0;2;2
6434;Papartis;"ŽIRNIUKAI ";1150772988;Ne;7;5;0;12
6435;Papartis;"ŽIRNIUKAI ";9518392031;Taip;8;0;0;8
6436;Papartis;"ŽIRNIUKAI ";6615368741;Taip;23;0;0;23
6437;Papartis;"ŽIRNIUKAI ";1614261572;Taip;0;1;0;1
6438;Papartis;"ŽIRNIUKAI ";8834463589;Taip;0;1;0;1
6439;Papartis;BORUŽĖLĖS;4156776066;Taip;9;0;0;9
6440;Papartis;BORUŽĖLĖS;1713966292;Taip;6;0;0;6
6441;Papartis;BORUŽĖLĖS;6971029839;Taip;2;0;0;2
6442;Papartis;BORUŽĖLĖS;3671248088;Taip;11;0;0;11
6443;Papartis;BORUŽĖLĖS;3033128518;Taip;5;1;0;6
6444;Papartis;BORUŽĖLĖS;3138701373;Taip;7;0;4;11
6445;Papartis;BORUŽĖLĖS;4800482635;Taip;5;0;0;5
6446;Papartis;BORUŽĖLĖS;2833918272;Taip;8;0;0;8
6447;Papartis;BORUŽĖLĖS;5459468987;Taip;12;0;0;12
6448;Papartis;VARPELIAI;8501388069;Taip;12;0;0;12
6449;Papartis;VARPELIAI;3639299679;Taip;4;1;1;6
6450;Papartis;VARPELIAI;5796633935;Taip;8;4;0;12
6451;Papartis;VARPELIAI;9141478403;Taip;12;0;0;12
6452;Papartis;VARPELIAI;5073439000;Taip;5;1;0;6
6453;Papartis;VARPELIAI;1390187546;Taip;6;2;0;8
6454;Papartis;VARPELIAI;6559847250;Taip;16;0;0;16
6455;Papartis;VARPELIAI;6053981340;Taip;16;0;0;16
6456;Papartis;VARPELIAI;3327404107;Taip;9;0;0;9
6457;Papartis;VARPELIAI;3535455931;Taip;9;0;0;9
6458;Papartis;VARPELIAI;4839033346;Taip;15;0;0;15
6459;Papartis;VARPELIAI;5063367652;Taip;9;0;0;9
6460;Papartis;VARPELIAI;4620041887;Taip;4;4;0;8
6461;Papartis;VARPELIAI;1032653411;Taip;7;0;0;7
6462;Papartis;NYKŠTUKAI;7260304487;Taip;5;3;0;8
6463;Papartis;NYKŠTUKAI;9581159294;Taip;9;4;0;13
6464;Papartis;NYKŠTUKAI;2956950308;Taip;1;0;0;1
6465;Papartis;NYKŠTUKAI;6710049689;Taip;6;0;0;6
6466;Papartis;NYKŠTUKAI;2777359899;Taip;0;2;0;2
6467;Papartis;NYKŠTUKAI;1993893368;Taip;4;2;0;6
6468;Papartis;NYKŠTUKAI;3345085436;Taip;1;0;0;1
6469;Papartis;NYKŠTUKAI;7189999679;Taip;3;0;0;3
6470;Papartis;NYKŠTUKAI;8443731277;Ne;4;9;0;13
6471;Papartis;NYKŠTUKAI;3419374226;Taip;3;0;0;3
6472;Papartis;NYKŠTUKAI;8642079824;Taip;9;0;0;9
6473;Papartis;NYKŠTUKAI;2421158534;Taip;5;0;0;5
6474;Papartis;NYKŠTUKAI;2600724041;Taip;10;0;0;10
6475;Papartis;NYKŠTUKAI;8872914372;Taip;9;5;0;14
6476;Papartis;NYKŠTUKAI;2053568874;Taip;0;8;0;8
6477;Papartis;NYKŠTUKAI;4952700737;Taip;14;0;0;14
6478;Papartis;NYKŠTUKAI;9881509036;Taip;1;0;0;1
6479;Pasaka;Drugelių;2308992563;Taip;0;6;0;6
6480;Pasaka;Drugelių;9249389876;Taip;0;1;0;1
6481;Pasaka;Drugelių;2961210575;Taip;6;2;0;8
6482;Pasaka;Drugelių;2383607612;Taip;0;6;0;6
6483;Pasaka;Drugelių;5351364328;Taip;3;0;0;3
6484;Pasaka;Drugelių;4635912654;Taip;3;0;0;3
6485;Pasaka;Drugelių;9737445077;Taip;0;1;0;1
6486;Pasaka;Drugelių;9136521759;Taip;0;2;0;2
6487;Pasaka;Drugelių;8400549247;Taip;4;0;0;4
6488;Pasaka;Drugelių;6326056771;Taip;0;4;0;4
6489;Pasaka;Drugelių;4175157894;Taip;5;0;0;5
6490;Pasaka;Drugelių;7252498738;Taip;14;0;0;14
6491;Pasaka;Nykštukų;5768958388;Taip;0;3;9;12
6492;Pasaka;Nykštukų;2797217440;Taip;0;2;0;2
6493;Pasaka;Nykštukų;2211744442;Taip;6;12;0;18
6494;Pasaka;Nykštukų;5912306325;Taip;0;4;0;4
6495;Pasaka;Nykštukų;2217868951;Taip;0;1;0;1
6496;Pasaka;Nykštukų;2217868951;Taip;0;1;0;1
6497;Pasaka;Nykštukų;2217868951;Taip;0;1;0;1
6498;Pasaka;Nykštukų;3424189866;Taip;0;0;6;6
6499;Pasaka;Nykštukų;6821289069;Taip;0;4;3;7
6500;Pasaka;Nykštukų;3557547656;Taip;0;2;0;2
6501;Pasaka;Nykštukų;2422079450;Taip;3;1;0;4
6502;Pasaka;Nykštukų;2086919906;Taip;17;0;1;18
6503;Pasaka;Nykštukų;8391715624;Taip;0;0;4;4
6504;Pasaka;Montesori;5031538468;Taip;0;1;0;1
6505;Pasaka;Montesori;6625690696;Taip;0;0;1;1
6506;Pasaka;Montesori;4548601585;Taip;0;2;0;2
6507;Pasaka;Montesori;7887326763;Taip;0;1;0;1
6508;Pasaka;Montesori;9850592463;Taip;8;0;0;8
6509;Pasaka;Montesori;2995831258;Taip;0;12;0;12
6510;Pasaka;Montesori;6248810027;Taip;0;4;1;5
6511;Pasaka;Montesori;3620395122;Taip;4;0;0;4
6512;Pasaka;Montesori;5689164477;Taip;0;0;3;3
6513;Pasaka;Montesori;7751618911;Taip;2;1;0;3
6514;Pasaka;Montesori;9471447977;Taip;0;2;0;2
6515;Pasaka;Montesori;4222952044;Taip;2;1;0;3
6516;Pasaka;Montesori;5194285627;Taip;0;5;0;5
6517;Pasaka;Montesori;9488089168;Taip;0;4;0;4
6518;Pasaka;Montesori;2558448927;Taip;0;0;1;1
6519;Pasaka;Žirniukų;2815348652;Taip;0;5;1;6
6520;Pasaka;Žirniukų;2422958320;Taip;5;5;1;11
6521;Pasaka;Žirniukų;9136524816;Taip;0;4;0;4
6522;Pasaka;Žirniukų;9766432049;Taip;2;0;1;3
6523;Pasaka;Žirniukų;6668421711;Taip;2;0;1;3
6524;Pasaka;Žirniukų;6387972576;Taip;0;4;0;4
6525;Pasaka;Žirniukų;4948174745;Taip;6;0;1;7
6526;Pasaka;Žirniukų;8519108324;Taip;0;4;1;5
6527;Pasaka;Žirniukų;9950979894;Taip;8;0;0;8
6528;Pasaka;Žirniukų;9654507441;Taip;8;0;0;8
6529;Pasaka;Žirniukų;9654507441;Taip;8;0;0;8
6530;Pasaka;Žirniukų;9654507441;Taip;8;0;0;8
6531;Pasaka;Žirniukų;5921553817;Taip;0;0;11;11
6532;Pasaka;Žirniukų;2569560383;Taip;0;0;2;2
6533;Pasaka;Žirniukų;9780490338;Taip;3;0;1;4
6534;Pasaka;"Voveriukų ";3606141216;Taip;0;5;0;5
6535;Pasaka;"Voveriukų ";5217688848;Taip;0;4;0;4
6536;Pasaka;"Voveriukų ";4171004263;Taip;0;4;2;6
6537;Pasaka;"Voveriukų ";8504575043;Taip;0;0;5;5
6538;Pasaka;"Voveriukų ";1950145441;Taip;7;0;2;9
6539;Pasaka;"Voveriukų ";9588247759;Taip;0;3;0;3
6540;Pasaka;"Voveriukų ";4915357646;Taip;0;0;2;2
6541;Pasaka;"Voveriukų ";7176272684;Taip;0;4;0;4
6542;Pasaka;"Voveriukų ";4799036184;Taip;0;0;1;1
6543;Pasaka;"Voveriukų ";6684234474;Taip;10;4;0;14
6544;Pasaka;"Voveriukų ";9003508760;Taip;0;4;0;4
6545;Pasaka;"Voveriukų ";1745181416;Taip;0;4;5;9
6546;Pasaka;"Voveriukų ";6315362421;Taip;1;0;0;1
6547;Pasaka;"Voveriukų ";6315362421;Taip;1;0;0;1
6548;Pasaka;"VALDOFRO 12";1305541319;Taip;0;5;1;6
6549;Pasaka;"VALDOFRO 12";7682903999;Taip;2;0;0;2
6550;Pasaka;"VALDOFRO 12";6448940090;Taip;5;0;0;5
6551;Pasaka;"VALDOFRO 12";8411025450;Taip;0;8;1;9
6552;Pasaka;"VALDOFRO 12";1756831961;Taip;0;4;1;5
6553;Pasaka;"VALDOFRO 12";3840053722;Ne;0;13;0;13
6554;Pasaka;"VALDOFRO 12";8995205555;Taip;5;0;0;5
6555;Pasaka;"VALDOFRO 12";4548945364;Taip;0;5;0;5
6556;Pasaka;"VALDOFRO 12";8912822936;Taip;3;0;0;3
6557;Pasaka;"VALDOFRO 12";5244582148;Taip;2;0;0;2
6558;Pasaka;"VALDOFRO 12";2650797982;Taip;2;0;0;2
6559;Pasaka;"VALDOFRO 12";9065016148;Taip;0;3;0;3
6560;Pasaka;"VALDOFRO 12";9809498406;Taip;7;0;0;7
6561;Pasaka;"VALDOFRO 12";6920718870;Taip;4;4;1;9
6562;Pasaka;"VALDOFRO 12";1791565631;Taip;2;0;0;2
6563;Pasaka;"VALDOFRO 12";5601416284;Taip;0;4;1;5
6564;Pasaka;"VALDOFRO 12";9324220807;Taip;2;0;0;2
6565;Pasaka;"VALDORFO 2";4620573687;Taip;0;3;5;8
6566;Pasaka;"VALDORFO 2";4825373152;Taip;0;4;0;4
6567;Pasaka;"VALDORFO 2";9462745431;Taip;0;4;5;9
6568;Pasaka;"VALDORFO 2";5399148997;Taip;0;4;1;5
6569;Pasaka;"VALDORFO 2";1799326151;Taip;2;0;0;2
6570;Pasaka;"VALDORFO 2";2273629510;Taip;2;0;0;2
6571;Pasaka;"VALDORFO 2";3778182691;Taip;0;3;6;9
6572;Pasaka;"VALDORFO 2";5742479853;Taip;0;2;0;2
6573;Pasaka;"VALDORFO 2";3049361712;Taip;4;4;0;8
6574;Pasaka;"VALDORFO 2";6497042042;Taip;0;0;2;2
6575;Pasaka;"VALDORFO 2";9150761761;Taip;3;0;1;4
6576;Pasaka;"VALDORFO 2";9821858308;Taip;0;0;2;2
6577;Pasaka;"VALDORFO 2";1648043715;Taip;0;0;8;8
6578;Pasaka;"VALDORFO 2";3796844193;Taip;2;0;1;3
6579;Pasaka;"VALDORFO 2";1940341287;Taip;6;2;0;8
6580;Pasaka;Gudručiai;5687494160;Taip;0;4;0;4
6581;Pasaka;Gudručiai;3151916774;Taip;0;4;0;4
6582;Pasaka;Gudručiai;4773893970;Taip;10;4;0;14
6583;Pasaka;Gudručiai;1813068555;Taip;0;2;0;2
6584;Pasaka;Gudručiai;7546205285;Taip;0;4;0;4
6585;Pasaka;Gudručiai;4082752808;Taip;9;0;0;9
6586;Pasaka;Gudručiai;6139825302;Taip;0;3;0;3
6587;Pasaka;Gudručiai;7248640367;Taip;0;2;0;2
6588;Pasaka;Gudručiai;8277245475;Taip;7;4;0;11
6589;Pasaka;Gudručiai;1720511696;Taip;3;0;0;3
6590;Pasaka;Gudručiai;4970812899;Taip;8;0;0;8
6591;Pasaka;Gudručiai;8873115041;Taip;1;0;0;1
6592;Pasaka;Gudručiai;5723970763;Taip;0;1;0;1
6593;Pasaka;Gudručiai;2638182985;Taip;0;1;0;1
6594;Pasaka;Gudručiai;3351338617;Taip;0;6;0;6
6595;Pasaka;Gudručiai;3367346582;Taip;0;5;0;5
6596;Pasaka;Gudručiai;6788771605;Taip;0;4;0;4
6597;Pasaka;Bitelių;7696383564;Taip;0;0;1;1
6598;Pasaka;Bitelių;7127138831;Taip;2;0;0;2
6599;Pasaka;Bitelių;9813397639;Taip;2;0;0;2
6600;Pasaka;Bitelių;9770811826;Taip;0;3;0;3
6601;Pasaka;Bitelių;4846146925;Taip;0;3;0;3
6602;Pasaka;Bitelių;4994426702;Taip;0;0;3;3
6603;Pasaka;Bitelių;8289010515;Taip;0;0;3;3
6604;Pasaka;Bitelių;8558563996;Taip;0;1;0;1
6605;Pasaka;Bitelių;6119419213;Taip;0;9;0;9
6606;Pasaka;Bitelių;7101898684;Taip;0;3;0;3
6607;Pasaka;Bitelių;4828789266;Taip;1;0;0;1
6608;Pasaka;Bitelių;9120786116;Taip;2;0;0;2
6609;Pasaka;Bitelių;7960739321;Taip;4;4;0;8
6610;Pasaka;"Pabiručių ";5111195289;Taip;7;0;0;7
6611;Pasaka;"Pabiručių ";6182223896;Taip;7;0;0;7
6612;Pasaka;"Pabiručių ";4982900413;Taip;0;0;1;1
6613;Pasaka;"Pabiručių ";8276520594;Taip;7;0;6;13
6614;Pasaka;"Pabiručių ";3192466285;Taip;0;0;4;4
6615;Pasaka;"Pabiručių ";3730173516;Taip;0;0;3;3
6616;Pasaka;"Pabiručių ";4572517095;Taip;4;0;2;6
6617;Pasaka;"Pabiručių ";5297950763;Taip;0;4;0;4
6618;Pasaka;"Pabiručių ";8662703330;Taip;11;0;0;11
6619;Pasaka;"Pabiručių ";6189170713;Taip;0;0;2;2
6620;Pasaka;Šnekučių;1793176485;Taip;0;5;9;14
6621;Pasaka;Šnekučių;4296539838;Taip;0;8;2;10
6622;Pasaka;Šnekučių;1590306118;Taip;7;0;0;7
6623;Pasaka;Šnekučių;3240292756;Taip;0;1;0;1
6624;Pasaka;Šnekučių;4215568107;Taip;0;1;0;1
6625;Pasaka;Šnekučių;8365256755;Taip;0;4;0;4
6626;Pasaka;Šnekučių;4816441219;Taip;3;0;2;5
6627;Pasaka;Šnekučių;1795497567;Taip;0;4;0;4
6628;Pasaka;Šnekučių;8347051587;Taip;8;0;0;8
6629;Pasaka;Šnekučių;4975045894;Taip;4;0;0;4
6630;Pasaka;Šnekučių;3588073618;Taip;9;0;0;9
6631;Pasaka;Šnekučių;1194745876;Taip;6;0;0;6
6632;Pasaka;Šnekučių;1749821746;Taip;5;4;0;9
6633;Pasaka;Šnekučių;1723076060;Taip;9;2;0;11
6634;Pasaka;Šnekučių;8475365713;Taip;0;2;4;6
6635;Pasaka;Šnekučių;5656511105;Taip;9;0;0;9
6636;Pasaka;"KIŠKUČIŲ (Žirmūnų g. 92)";7311929329;Taip;0;1;0;1
6637;Pasaka;"KIŠKUČIŲ (Žirmūnų g. 92)";2135527938;Taip;0;2;0;2
6638;Pasaka;"KIŠKUČIŲ (Žirmūnų g. 92)";5073970913;Taip;0;0;3;3
6639;Pasaka;"KIŠKUČIŲ (Žirmūnų g. 92)";5255764606;Taip;0;4;9;13
6640;Pasaka;"KIŠKUČIŲ (Žirmūnų g. 92)";6950137606;Taip;0;0;5;5
6641;Pasaka;"KIŠKUČIŲ (Žirmūnų g. 92)";2575986215;Taip;6;0;0;6
6642;Pasaka;"KIŠKUČIŲ (Žirmūnų g. 92)";5632714212;Taip;16;4;0;20
6643;Pasaka;"KIŠKUČIŲ (Žirmūnų g. 92)";9928518840;Taip;4;0;1;5
6644;Pasaka;"KIŠKUČIŲ (Žirmūnų g. 92)";7699290051;Taip;6;0;0;6
6645;Pasaka;"KIŠKUČIŲ (Žirmūnų g. 92)";1780063295;Taip;6;0;0;6
6646;Pasaka;"EŽIUKŲ (Žirmūnų g. 92)";4389337333;Taip;5;0;0;5
6647;Pasaka;"EŽIUKŲ (Žirmūnų g. 92)";7811540398;Taip;7;4;4;15
6648;Pasaka;"EŽIUKŲ (Žirmūnų g. 92)";7964569326;Taip;7;4;4;15
6649;Pasaka;"EŽIUKŲ (Žirmūnų g. 92)";4061808534;Taip;0;4;5;9
6650;Pasaka;"EŽIUKŲ (Žirmūnų g. 92)";3567879839;Taip;0;4;1;5
6651;Pasaka;"EŽIUKŲ (Žirmūnų g. 92)";4458246330;Taip;2;4;3;9
6652;Pasaka;"EŽIUKŲ (Žirmūnų g. 92)";5450477466;Taip;0;1;3;4
6653;Pasaka;"EŽIUKŲ (Žirmūnų g. 92)";9409030208;Taip;0;4;1;5
6654;Pasaka;"EŽIUKŲ (Žirmūnų g. 92)";9717417413;Taip;0;0;1;1
6655;Pasaka;"EŽIUKŲ (Žirmūnų g. 92)";6780585061;Taip;6;2;3;11
6656;Pasaka;"EŽIUKŲ (Žirmūnų g. 92)";2313200719;Taip;6;1;0;7
6657;Pasaka;"SAULUČIŲ (Žirmūnų g. 92)";1963481567;Taip;2;0;2;4
6658;Pasaka;"SAULUČIŲ (Žirmūnų g. 92)";8164697203;Taip;4;1;0;5
6659;Pasaka;"SAULUČIŲ (Žirmūnų g. 92)";6991062262;Taip;1;0;1;2
6660;Pasaka;"SAULUČIŲ (Žirmūnų g. 92)";1214817944;Taip;5;0;0;5
6661;Pasaka;"SAULUČIŲ (Žirmūnų g. 92)";6087447128;Taip;4;0;1;5
6662;Pasaka;"SAULUČIŲ (Žirmūnų g. 92)";6157459742;Taip;0;0;2;2
6663;Pasaka;"SAULUČIŲ (Žirmūnų g. 92)";9369336996;Taip;0;0;2;2
6664;Pasaka;"SAULUČIŲ (Žirmūnų g. 92)";3587648653;Taip;6;0;2;8
6665;Pasaka;"SAULUČIŲ (Žirmūnų g. 92)";6388657745;Taip;6;0;2;8
6666;Pasaka;"SAULUČIŲ (Žirmūnų g. 92)";6280303158;Taip;0;0;2;2
6667;Pasaka;"SAULUČIŲ (Žirmūnų g. 92)";9403892434;Taip;5;0;3;8
6668;Pasaka;"SAULUČIŲ (Žirmūnų g. 92)";8837340945;Taip;3;0;6;9
6669;Pasaka;"SAULUČIŲ (Žirmūnų g. 92)";1083785206;Taip;5;0;0;5
6670;Paslaptis;MONTIKI;4683384309;Taip;5;6;0;11
6671;Paslaptis;MONTIKI;4350594725;Taip;5;1;0;6
6672;Paslaptis;MONTIKI;1780728941;Taip;4;0;0;4
6673;Paslaptis;MONTIKI;4962917136;Taip;13;0;0;13
6674;Paslaptis;MONTIKI;5908641161;Taip;18;0;0;18
6675;Paslaptis;MONTIKI;3822422339;Taip;5;0;0;5
6676;Paslaptis;MONTIKI;1869254264;Taip;7;0;0;7
6677;Paslaptis;MONTIKI;3463582845;Taip;13;0;0;13
6678;Paslaptis;MONTIKI;7867852953;Taip;8;0;0;8
6679;Paslaptis;MONTIKI;4038980805;Taip;6;0;0;6
6680;Paslaptis;FRUTIKI;2105441745;Taip;5;5;0;10
6681;Paslaptis;FRUTIKI;6686352764;Taip;4;0;2;6
6682;Paslaptis;FRUTIKI;6513238386;Taip;4;0;0;4
6683;Paslaptis;FRUTIKI;8457752288;Taip;6;0;0;6
6684;Paslaptis;FRUTIKI;4159590988;Taip;8;0;0;8
6685;Paslaptis;FRUTIKI;9929877115;Taip;5;1;0;6
6686;Paslaptis;FRUTIKI;6860366087;Taip;9;0;0;9
6687;Paslaptis;FRUTIKI;3572102816;Taip;20;0;0;20
6688;Paslaptis;FRUTIKI;2927014406;Taip;11;2;0;13
6689;Paslaptis;FRUTIKI;7053452493;Taip;6;1;0;7
6690;Paslaptis;FRUTIKI;3963816472;Taip;6;0;0;6
6691;Paslaptis;FRUTIKI;5809630456;Taip;1;0;0;1
6692;Paslaptis;FRUTIKI;6764142182;Taip;0;5;1;6
6693;Paslaptis;FRUTIKI;9299390190;Taip;0;0;1;1
6694;Paslaptis;FRUTIKI;9497654214;Taip;5;0;0;5
6695;Paslaptis;FRUTIKI;5480407965;Taip;10;4;0;14
6696;Paslaptis;KALAMBURIKI;1029321312;Taip;0;7;0;7
6697;Paslaptis;KALAMBURIKI;5852939221;Taip;0;4;3;7
6698;Paslaptis;KALAMBURIKI;3104525540;Taip;4;0;0;4
6699;Paslaptis;KALAMBURIKI;3398729758;Taip;11;0;0;11
6700;Paslaptis;KALAMBURIKI;7672102974;Taip;7;0;0;7
6701;Paslaptis;KALAMBURIKI;9100003209;Ne;0;1;0;1
6702;Paslaptis;KALAMBURIKI;3984799090;Taip;0;1;0;1
6703;Paslaptis;KALAMBURIKI;2675089401;Taip;8;1;0;9
6704;Paslaptis;KALAMBURIKI;1557783684;Taip;8;5;0;13
6705;Paslaptis;KALAMBURIKI;5206529350;Taip;0;2;0;2
6706;Paslaptis;KALAMBURIKI;5456011928;Taip;0;7;0;7
6707;Paslaptis;KALAMBURIKI;8717111488;Taip;0;0;1;1
6708;Paslaptis;KALAMBURIKI;5646806136;Taip;0;0;4;4
6709;Paslaptis;KALAMBURIKI;6098345982;Taip;0;1;1;2
6710;Paslaptis;KALAMBURIKI;8296575784;Ne;5;0;0;5
6711;Paslaptis;KALAMBURIKI;7638521198;Taip;0;2;0;2
6712;Pasakaitė;Vieversėlių;5162170061;Taip;0;0;1;1
6713;Pasakaitė;Vieversėlių;4316883215;Taip;0;1;0;1
6714;Pasakaitė;Vieversėlių;6682010485;Taip;6;4;0;10
6715;Pasakaitė;Vieversėlių;8478538959;Taip;0;23;0;23
6716;Pasakaitė;Vieversėlių;5279719152;Taip;0;1;0;1
6717;Pasakaitė;Vieversėlių;6160327808;Taip;4;0;1;5
6718;Pasakaitė;Vieversėlių;1705913604;Taip;8;0;0;8
6719;Pasakaitė;Vieversėlių;4898974534;Taip;0;0;1;1
6720;Pasakaitė;Vieversėlių;7399335037;Taip;4;1;0;5
6721;Pasakaitė;Vieversėlių;7885958426;Taip;4;0;0;4
6722;Pasakaitė;Vieversėlių;2041179927;Taip;0;0;1;1
6723;Pasakaitė;Vieversėlių;7965916747;Taip;7;0;1;8
6724;Pasakaitė;Vieversėlių;1279728451;Taip;0;0;2;2
6725;Pasakaitė;Vieversėlių;2584717150;Taip;3;0;3;6
6726;Pasakaitė;Vieversėlių;4397797616;Taip;16;5;0;21
6727;Pasakaitė;Vieversėlių;4659277297;Taip;0;0;2;2
6728;Pasakaitė;Vieversėlių;2899659479;Taip;0;0;2;2
6729;Pasakaitė;Vieversėlių;8160163060;Taip;10;0;0;10
6730;Pasakaitė;Vieversėlių;8350808883;Taip;8;0;0;8
6731;Pasakaitė;Vieversėlių;1122248122;Taip;0;23;0;23
6732;Pasakaitė;Vieversėlių;2801785334;Taip;7;0;0;7
6733;Pasakaitė;Spindulėlių;1697755753;Taip;4;1;0;5
6734;Pasakaitė;Spindulėlių;8105641645;Taip;0;0;1;1
6735;Pasakaitė;Spindulėlių;5791927811;Taip;5;11;0;16
6736;Pasakaitė;Spindulėlių;5094404397;Taip;5;11;0;16
6737;Pasakaitė;Spindulėlių;9870015737;Ne;12;4;0;16
6738;Pasakaitė;Spindulėlių;7474100735;Taip;0;10;0;10
6739;Pasakaitė;Spindulėlių;6256000265;Taip;5;5;0;10
6740;Pasakaitė;Spindulėlių;2891089579;Taip;5;5;0;10
6741;Pasakaitė;Spindulėlių;3381303531;Taip;0;4;0;4
6742;Pasakaitė;Spindulėlių;7265623955;Taip;8;7;0;15
6743;Pasakaitė;Spindulėlių;1564611671;Taip;4;4;0;8
6744;Pasakaitė;Spindulėlių;4268438476;Taip;11;0;1;12
6745;Pasakaitė;Spindulėlių;2340908210;Taip;5;6;0;11
6746;Pasakaitė;Spindulėlių;6229020982;Taip;0;6;1;7
6747;Pasakaitė;Spindulėlių;2278658674;Taip;5;4;0;9
6748;Pasakaitė;Spindulėlių;9982451343;Taip;2;8;0;10
6749;Pasakaitė;Spindulėlių;5745073940;Taip;0;2;1;3
6750;Pasakaitė;Spindulėlių;5180059311;Taip;7;0;0;7
6751;Pasakaitė;Spindulėlių;6745120294;Taip;0;8;0;8
6752;Pasakaitė;Spindulėlių;9508156795;Taip;0;3;0;3
6753;Pasakaitė;Pasagėlių;2810892060;Taip;0;0;1;1
6754;Pasakaitė;Pasagėlių;9895144528;Taip;4;6;0;10
6755;Pasakaitė;Pasagėlių;9409907631;Taip;6;9;0;15
6756;Pasakaitė;Pasagėlių;5589440439;Ne;0;7;0;7
6757;Pasakaitė;Pasagėlių;5959875562;Taip;4;0;3;7
6758;Pasakaitė;Pasagėlių;3355268509;Taip;8;0;0;8
6759;Pasakaitė;Pasagėlių;1959599606;Taip;2;0;2;4
6760;Pasakaitė;Pasagėlių;7440327561;Taip;0;14;0;14
6761;Pasakaitė;Pasagėlių;6325408070;Taip;4;0;0;4
6762;Pasakaitė;Pasagėlių;9238905834;Taip;0;9;0;9
6763;Pasakaitė;Pasagėlių;4826492004;Taip;0;5;0;5
6764;Pasakaitė;Pasagėlių;7666033916;Taip;4;2;0;6
6765;Pasakaitė;Pasagėlių;5540251866;Taip;0;4;0;4
6766;Pasakaitė;Pasagėlių;7219080600;Ne;10;4;0;14
6767;Pasakaitė;Pasagėlių;8264189678;Taip;6;0;0;6
6768;Pasakaitė;Pasagėlių;2341175137;Taip;11;2;0;13
6769;Pasakaitė;Pasagėlių;8905681529;Taip;12;1;0;13
6770;Pasakaitė;Pasagėlių;8165055476;Taip;0;0;3;3
6771;Pasakaitė;Pasagėlių;7360801624;Taip;0;2;0;2
6772;Pasakaitė;Pasagėlių;5034077389;Taip;0;4;2;6
6773;Pasakaitė;Pasagėlių;9645230615;Taip;6;0;1;7
6774;Pasakaitė;Švyturėlių;7702359586;Taip;0;4;0;4
6775;Pasakaitė;Švyturėlių;6847782430;Taip;0;7;0;7
6776;Pasakaitė;Švyturėlių;4728731352;Taip;4;0;0;4
6777;Pasakaitė;Švyturėlių;9821617981;Taip;0;0;4;4
6778;Pasakaitė;Švyturėlių;2933474317;Taip;0;0;3;3
6779;Pasakaitė;Švyturėlių;5498393070;Taip;9;0;4;13
6780;Pasakaitė;Švyturėlių;9012098645;Taip;13;0;4;17
6781;Pasakaitė;Švyturėlių;3417077517;Taip;0;0;1;1
6782;Pasakaitė;Švyturėlių;1793453325;Taip;0;4;0;4
6783;Pasakaitė;Švyturėlių;4694818333;Taip;0;0;1;1
6784;Pasakaitė;Švyturėlių;6522727154;Taip;5;4;0;9
6785;Pasakaitė;Švyturėlių;4977052991;Taip;0;3;0;3
6786;Pasakaitė;Švyturėlių;7604996145;Taip;23;0;0;23
6787;Pasakaitė;Švyturėlių;4144569088;Taip;2;0;0;2
6788;Pasakaitė;Švyturėlių;8381083251;Taip;23;0;0;23
6789;Pasakaitė;Švyturėlių;9606533767;Taip;0;2;2;4
6790;Pasakaitė;Švyturėlių;2902368705;Taip;5;2;0;7
6791;Pasakaitė;Švyturėlių;3659371923;Taip;1;0;3;4
6792;Pasakaitė;Kodėlčiukų;8662488739;Taip;9;0;0;9
6793;Pasakaitė;Kodėlčiukų;9972985920;Taip;8;5;0;13
6794;Pasakaitė;Kodėlčiukų;5699688792;Taip;9;4;0;13
6795;Pasakaitė;Kodėlčiukų;9441990175;Taip;9;1;3;13
6796;Pasakaitė;Kodėlčiukų;1588525307;Taip;0;6;0;6
6797;Pasakaitė;Kodėlčiukų;4485053261;Taip;0;0;3;3
6798;Pasakaitė;Kodėlčiukų;9351971114;Taip;12;1;0;13
6799;Pasakaitė;Kodėlčiukų;2303884875;Taip;7;0;0;7
6800;Pasakaitė;Kodėlčiukų;9543262464;Taip;4;0;0;4
6801;Pasakaitė;Kodėlčiukų;4878562841;Taip;14;0;0;14
6802;Pasakaitė;Kodėlčiukų;2994653871;Taip;0;0;3;3
6803;Pasakaitė;Kodėlčiukų;4328440534;Taip;9;0;2;11
6804;Pasakaitė;Kodėlčiukų;4881361200;Taip;5;0;4;9
6805;Pasakaitė;Kodėlčiukų;2389832646;Taip;6;5;0;11
6806;Pasakaitė;Kodėlčiukų;7138417196;Taip;8;1;2;11
6807;Pasakaitė;Kodėlčiukų;5581264184;Taip;8;4;0;12
6808;Pasakaitė;Kodėlčiukų;8037316673;Taip;9;3;0;12
6809;Pasakaitė;Kodėlčiukų;5732009054;Taip;0;1;0;1
6810;Pasakaitė;Kodėlčiukų;2407824666;Taip;2;2;0;4
6811;Pasakaitė;Kodėlčiukų;6755983130;Taip;9;0;0;9
6812;Pasakaitė;Kodėlčiukų;2476010561;Taip;14;1;0;15
6813;Pasakaitė;Kodėlčiukų;3925034196;Taip;14;1;0;15
6814;Pasakaitė;Kodėlčiukų;9512782063;Taip;4;0;1;5
6815;Pasakaitė;Gudručių;1513903341;Taip;0;2;0;2
6816;Pasakaitė;Gudručių;3231283338;Taip;8;4;1;13
6817;Pasakaitė;Gudručių;6736879757;Taip;6;4;0;10
6818;Pasakaitė;Gudručių;2194313054;Taip;4;1;1;6
6819;Pasakaitė;Gudručių;7963057831;Taip;0;4;1;5
6820;Pasakaitė;Gudručių;9543991684;Taip;0;4;0;4
6821;Pasakaitė;Gudručių;3444442287;Taip;5;4;0;9
6822;Pasakaitė;Gudručių;3680596008;Taip;0;4;0;4
6823;Pasakaitė;Gudručių;4191875802;Taip;4;1;0;5
6824;Pasakaitė;Gudručių;4882856664;Taip;0;0;3;3
6825;Pasakaitė;Gudručių;5485965486;Taip;0;13;0;13
6826;Pasakaitė;Gudručių;7685647972;Taip;0;0;1;1
6827;Pasakaitė;Gudručių;5953162958;Ne;0;2;0;2
6828;Pasakaitė;Gudručių;2849753418;Taip;5;4;0;9
6829;Pasakaitė;Gudručių;9018830962;Taip;8;7;0;15
6830;Pasakaitė;Gudručių;6459145539;Taip;2;2;0;4
6831;Pasakaitė;Gudručių;5948958906;Taip;0;3;0;3
6832;Pasakaitė;Gudručių;1060914693;Taip;4;0;0;4
6833;Pasakaitė;Gudručių;4864779439;Taip;0;0;1;1
6834;Pasakaitė;Gudručių;1533259056;Taip;0;1;0;1
6835;Pasakaitė;Gudručių;8223662339;Taip;0;4;1;5
6836;Pasakaitė;Čiulbonėlių;7526264241;Taip;0;4;7;11
6837;Pasakaitė;Čiulbonėlių;3541877287;Taip;0;4;2;6
6838;Pasakaitė;Čiulbonėlių;4974486850;Ne;0;4;0;4
6839;Pasakaitė;Čiulbonėlių;7607522887;Taip;4;4;4;12
6840;Pasakaitė;Čiulbonėlių;3606601644;Taip;0;7;0;7
6841;Pasakaitė;Čiulbonėlių;3579498202;Taip;0;1;2;3
6842;Pasakaitė;Čiulbonėlių;1220619991;Taip;0;0;3;3
6843;Pasakaitė;Čiulbonėlių;7790937149;Taip;0;4;5;9
6844;Pasakaitė;Čiulbonėlių;3400305768;Taip;0;4;5;9
6845;Pasakaitė;Čiulbonėlių;1619513932;Taip;0;4;1;5
6846;Pasakaitė;Čiulbonėlių;4604843442;Taip;0;4;0;4
6847;Pasakaitė;Čiulbonėlių;2751828639;Taip;0;4;0;4
6848;Pasakaitė;Čiulbonėlių;1962693480;Taip;0;4;4;8
6849;Pasakaitė;Čiulbonėlių;4758073190;Taip;0;0;3;3
6850;Pasakaitė;Čiulbonėlių;6015360076;Taip;0;8;0;8
6851;Pasakaitė;Čiulbonėlių;1056358241;Taip;4;1;1;6
6852;Pasakaitė;Čiulbonėlių;2652882309;Ne;0;1;1;2
6853;Pasakaitė;Čiulbonėlių;1449037968;Taip;0;4;0;4
6854;Pasakaitė;Čiulbonėlių;8463220257;Taip;0;1;0;1
6855;Pasakaitė;Čiulbonėlių;6714500298;Taip;0;1;0;1
6856;Pasakaitė;Čiulbonėlių;1184513606;Taip;0;1;3;4
6857;Pasakaitė;"Verpstelių ";7621306769;Taip;0;2;0;2
6858;Pasakaitė;"Verpstelių ";4946855684;Taip;0;4;0;4
6859;Pasakaitė;"Verpstelių ";7451624229;Ne;4;0;1;5
6860;Pasakaitė;"Verpstelių ";7759051761;Taip;14;2;0;16
6861;Pasakaitė;"Verpstelių ";1744216870;Taip;0;0;2;2
6862;Pasakaitė;"Verpstelių ";1425166722;Taip;5;0;5;10
6863;Pasakaitė;"Verpstelių ";7813221735;Taip;5;10;0;15
6864;Pasakaitė;"Verpstelių ";9166649594;Taip;0;2;0;2
6865;Pasakaitė;"Verpstelių ";4246461594;Taip;10;0;3;13
6866;Pasakaitė;"Verpstelių ";1963102227;Taip;8;0;2;10
6867;Pasakaitė;"Verpstelių ";8267725352;Taip;0;0;1;1
6868;Pasakaitė;"Verpstelių ";8562284745;Taip;0;6;0;6
6869;Pasakaitė;"Verpstelių ";1041405418;Taip;0;3;0;3
6870;Pasakaitė;"Verpstelių ";7976921380;Taip;0;0;2;2
6871;Pasakaitė;"Verpstelių ";2505815026;Taip;13;0;2;15
6872;Pasakaitė;"Verpstelių ";5413457806;Taip;0;7;0;7
6873;Pasakaitė;"Verpstelių ";1115383380;Taip;0;0;4;4
6874;Pasakaitė;"Verpstelių ";2714905466;Taip;0;0;3;3
6875;Pasakaitė;"Verpstelių ";9226989209;Taip;7;6;0;13
6876;Pasakaitė;Smalsučiai;7557414266;Taip;6;0;0;6
6877;Pasakaitė;Smalsučiai;7994712153;Taip;15;0;3;18
6878;Pasakaitė;Smalsučiai;1271645870;Taip;9;0;7;16
6879;Pasakaitė;Smalsučiai;6266150515;Taip;0;23;0;23
6880;Pasakaitė;Smalsučiai;3359676586;Taip;0;0;4;4
6881;Pasakaitė;Smalsučiai;3041099329;Taip;0;0;2;2
6882;Pasakaitė;Smalsučiai;6446178994;Taip;2;4;0;6
6883;Pasakaitė;Smalsučiai;6803651332;Taip;0;0;2;2
6884;Pasakaitė;Smalsučiai;3191302999;Taip;0;0;4;4
6885;Pasakaitė;Smalsučiai;2301346026;Taip;0;0;8;8
6886;Pasakaitė;Smalsučiai;7515747335;Taip;0;19;0;19
6887;Pasakaitė;Smalsučiai;8398100438;Taip;16;0;0;16
6888;Pasakaitė;Smalsučiai;4413770207;Taip;9;2;1;12
6889;Pasakaitė;Smalsučiai;8181710494;Taip;11;0;0;11
6890;Pasakaitė;"Čiauškučiai ";7585900157;Taip;0;0;2;2
6891;Pasakaitė;"Čiauškučiai ";2182900696;Taip;0;12;4;16
6892;Pasakaitė;"Čiauškučiai ";7378144738;Taip;13;6;0;19
6893;Pasakaitė;"Čiauškučiai ";9335770325;Taip;10;0;0;10
6894;Pasakaitė;"Čiauškučiai ";2780813752;Taip;14;9;0;23
6895;Pasakaitė;"Čiauškučiai ";5202153993;Taip;0;23;0;23
6896;Pasakaitė;"Čiauškučiai ";3329580710;Taip;10;0;0;10
6897;Pasakaitė;"Čiauškučiai ";4189572117;Taip;14;5;0;19
6898;Pasakaitė;"Čiauškučiai ";3931651662;Taip;7;0;0;7
6899;Pasakaitė;"Čiauškučiai ";6756484192;Taip;0;3;0;3
6900;Pasakaitė;"Čiauškučiai ";6033454938;Taip;12;0;0;12
6901;Pasakaitė;"Čiauškučiai ";7118164408;Taip;4;18;0;22
6902;Pasakaitė;"Čiauškučiai ";9823031346;Taip;4;18;0;22
6903;Pasakaitė;"Čiauškučiai ";1400956305;Taip;9;0;0;9
6904;Pasakaitė;Pabiručiai;1453976284;Taip;0;4;3;7
6905;Pasakaitė;Pabiručiai;5439936572;Taip;0;6;0;6
6906;Pasakaitė;Pabiručiai;3466308130;Taip;12;7;0;19
6907;Pasakaitė;Pabiručiai;9402238675;Taip;0;2;0;2
6908;Pasakaitė;Pabiručiai;4852610052;Taip;0;10;0;10
6909;Pasakaitė;Pabiručiai;9285254916;Taip;5;0;0;5
6910;Pasakaitė;Pabiručiai;6025275102;Taip;7;0;0;7
6911;Pasakaitė;Pabiručiai;7902661691;Taip;11;0;0;11
6912;Pasakaitė;Pabiručiai;2398839782;Taip;4;0;1;5
6913;Pasakaitė;Pabiručiai;3552340609;Taip;15;0;0;15
6914;Pasakaitė;Pabiručiai;2332609415;Taip;13;0;0;13
6915;Pasakaitė;Pabiručiai;4081701824;Taip;6;0;0;6
6916;Pasakaitė;Pabiručiai;3070478547;Taip;0;21;0;21
6917;Pasakaitė;Linksmučiai;8252123824;Taip;12;0;0;12
6918;Pasakaitė;Linksmučiai;4444725869;Taip;8;0;0;8
6919;Pasakaitė;Linksmučiai;3049219840;Ne;7;0;3;10
6920;Pasakaitė;Linksmučiai;9190078546;Taip;0;0;1;1
6921;Pasakaitė;Linksmučiai;5274145775;Taip;16;0;0;16
6922;Pasakaitė;Linksmučiai;8399160991;Taip;0;3;0;3
6923;Pasakaitė;Linksmučiai;9690867215;Taip;17;0;0;17
6924;Pasakaitė;Linksmučiai;1117035233;Taip;14;0;1;15
6925;Pasakaitė;Linksmučiai;8055084637;Taip;5;0;1;6
6926;Pasakaitė;Linksmučiai;5058070480;Taip;16;4;0;20
6927;Pasakaitė;Linksmučiai;9311649698;Taip;4;0;0;4
6928;Pasakaitė;Linksmučiai;5499373802;Taip;10;0;0;10
6929;Pasakaitė;Linksmučiai;4307883488;Taip;20;1;0;21
6930;Pasakaitė;Linksmučiai;4120765793;Taip;5;0;0;5
6931;Pelenė;Varpelis;2647876561;Taip;5;1;0;6
6932;Pelenė;Varpelis;8807342148;Taip;10;4;6;20
6933;Pelenė;Varpelis;8239650471;Taip;2;0;0;2
6934;Pelenė;Varpelis;4004975235;Taip;7;7;0;14
6935;Pelenė;Varpelis;8790613872;Taip;8;7;0;15
6936;Pelenė;Varpelis;2487632125;Taip;0;6;7;13
6937;Pelenė;Varpelis;5228983908;Taip;1;0;0;1
6938;Pelenė;Varpelis;6524101295;Taip;8;4;0;12
6939;Pelenė;Varpelis;4373886054;Taip;6;0;0;6
6940;Pelenė;Varpelis;8038559319;Taip;1;2;0;3
6941;Pelenė;Varpelis;7578318198;Taip;7;3;0;10
6942;Pelenė;Varpelis;7164790060;Taip;1;1;0;2
6943;Pelenė;Varpelis;1080017906;Taip;2;0;1;3
6944;Pelenė;Varpelis;4777496709;Taip;4;0;1;5
6945;Pelenė;Varpelis;9447223913;Taip;0;0;8;8
6946;Pelenė;Varpelis;6894978459;Taip;7;15;0;22
6947;Pelenė;Varpelis;6864263698;Taip;14;0;3;17
6948;Pelenė;Saulutės;8718308575;Taip;0;33;0;33
6949;Pelenė;Saulutės;6867256280;Taip;4;0;0;4
6950;Pelenė;Saulutės;4396011355;Taip;4;0;0;4
6951;Pelenė;Saulutės;9639135363;Taip;2;0;0;2
6952;Pelenė;Saulutės;5743530682;Taip;3;0;0;3
6953;Pelenė;Saulutės;6304818782;Taip;0;1;0;1
6954;Pelenė;Saulutės;1975574464;Taip;9;0;0;9
6955;Pelenė;Saulutės;3549088727;Taip;0;0;3;3
6956;Pelenė;Saulutės;2952739501;Taip;0;7;6;13
6957;Pelenė;Saulutės;6567413229;Taip;5;0;0;5
6958;Pelenė;Saulutės;6231387335;Taip;0;29;0;29
6959;Pelenė;Saulutės;4068236246;Taip;11;0;0;11
6960;Pelenė;Saulutės;3700618977;Taip;4;0;0;4
6961;Pelenė;Saulutės;5872711862;Taip;0;0;1;1
6962;Pelenė;Saulutės;6081335781;Taip;0;7;0;7
6963;Pelenė;Saulutės;7341814322;Taip;0;0;3;3
6964;Pelenė;Saulutės;3060502977;Taip;0;0;2;2
6965;Pelenė;Saulutės;2083848693;Taip;7;5;0;12
6966;Pelenė;Raktelis;4023923887;Taip;11;0;0;11
6967;Pelenė;Raktelis;4859437855;Taip;11;15;0;26
6968;Pelenė;Raktelis;5028095861;Taip;1;11;0;12
6969;Pelenė;Raktelis;8202196292;Taip;1;0;0;1
6970;Pelenė;Raktelis;5926700157;Taip;9;0;0;9
6971;Pelenė;Raktelis;5762403752;Taip;0;1;0;1
6972;Pelenė;Raktelis;7926586349;Taip;8;0;0;8
6973;Pelenė;Raktelis;2986690431;Taip;8;0;0;8
6974;Pelenė;Raktelis;4660385383;Taip;12;0;0;12
6975;Pelenė;Raktelis;4305733824;Taip;5;3;0;8
6976;Pelenė;Raktelis;5066227318;Taip;2;0;0;2
6977;Pelenė;Raktelis;8862429244;Taip;19;0;0;19
6978;Pelenė;Raktelis;9505945890;Taip;0;4;0;4
6979;Pelenė;Raktelis;8961082265;Ne;0;4;0;4
6980;Pelenė;Raktelis;2882716674;Taip;2;1;0;3
6981;Pelenė;Raktelis;4051874126;Taip;0;1;0;1
6982;Pelenė;Raktelis;5970146724;Taip;16;0;0;16
6983;Pelenė;Raktelis;1424479862;Taip;16;0;0;16
6984;Pelenė;Raktelis;1197137607;Taip;16;0;0;16
6985;Pelenė;Raktelis;9769835612;Taip;2;0;0;2
6986;Pelenė;Žvaigždutės;9473901831;Taip;10;0;0;10
6987;Pelenė;Žvaigždutės;2476080951;Taip;5;0;0;5
6988;Pelenė;Žvaigždutės;5587759166;Taip;0;1;0;1
6989;Pelenė;Žvaigždutės;5548367924;Taip;10;4;1;15
6990;Pelenė;Žvaigždutės;5031778158;Taip;0;7;0;7
6991;Pelenė;Žvaigždutės;4056676361;Taip;0;4;4;8
6992;Pelenė;Žvaigždutės;4602503400;Taip;0;4;0;4
6993;Pelenė;Žvaigždutės;2555464779;Taip;0;2;0;2
6994;Pelenė;Žvaigždutės;9530531472;Ne;0;10;0;10
6995;Pelenė;Žvaigždutės;2040256240;Taip;2;0;1;3
6996;Pelenė;Žvaigždutės;4870187198;Taip;5;0;0;5
6997;Pelenė;Žvaigždutės;7640768043;Taip;4;0;0;4
6998;Pelenė;Žvaigždutės;4856039707;Taip;0;3;0;3
6999;Pelenė;Žvaigždutės;4737217659;Taip;0;4;2;6
7000;Pelenė;Žvaigždutės;4109516555;Taip;3;3;0;6
7001;Pelenė;Žvaigždutės;5357701072;Taip;0;0;21;21
7002;Pelenė;Žvaigždutės;7426299485;Taip;4;0;0;4
7003;Pelenė;Žvaigždutės;1136986980;Taip;7;0;0;7
7004;Pelenė;Nykštukas;1060619471;Taip;0;1;0;1
7005;Pelenė;Nykštukas;9195113444;Taip;4;0;2;6
7006;Pelenė;Nykštukas;5749399210;Taip;0;1;1;2
7007;Pelenė;Nykštukas;4448592497;Taip;3;1;1;5
7008;Pelenė;Nykštukas;9075193730;Taip;0;0;2;2
7009;Pelenė;Nykštukas;5333802902;Taip;0;8;0;8
7010;Pelenė;Nykštukas;4591637887;Taip;4;0;2;6
7011;Pelenė;Nykštukas;7088493729;Taip;4;0;0;4
7012;Pelenė;Nykštukas;4090532624;Ne;0;10;0;10
7013;Pelenė;Nykštukas;8123162647;Taip;0;1;3;4
7014;Pelenė;Nykštukas;3573543545;Taip;0;1;0;1
7015;Pelenė;Nykštukas;7659625628;Taip;0;2;0;2
7016;Pelenė;Nykštukas;6375060159;Taip;0;7;0;7
7017;Pelenė;Nykštukas;2210314952;Taip;4;0;0;4
7018;Pelenė;Nykštukas;6419661741;Taip;5;0;3;8
7019;Pelenė;Nykštukas;1049199372;Ne;0;3;0;3
7020;Pelenė;Nykštukas;5063098703;Taip;0;1;0;1
7021;Pelenė;Nykštukas;4089199552;Taip;0;0;4;4
7022;Pelenė;Nykštukas;6038229659;Taip;5;2;1;8
7023;Pelenė;Nykštukas;2241816838;Taip;0;0;4;4
7024;Pelenė;Nykštukas;5389865440;Taip;2;4;0;6
7025;Pelenė;Žirniukai;8529178313;Taip;8;0;0;8
7026;Pelenė;Žirniukai;2270989478;Taip;0;23;0;23
7027;Pelenė;Žirniukai;6661371876;Taip;6;0;0;6
7028;Pelenė;Žirniukai;2590035984;Taip;0;4;0;4
7029;Pelenė;Žirniukai;6046921077;Taip;0;5;0;5
7030;Pelenė;Žirniukai;9601582419;Taip;9;0;0;9
7031;Pelenė;Žirniukai;4703442187;Ne;2;0;0;2
7032;Pelenė;Žirniukai;7959433937;Taip;10;0;0;10
7033;Pelenė;Žirniukai;7057752202;Taip;7;0;0;7
7034;Pelenė;Žirniukai;7399112026;Taip;8;0;0;8
7035;Pelenė;Žirniukai;5686182866;Ne;1;0;0;1
7036;Pelenė;Žirniukai;2443906444;Taip;1;0;0;1
7037;Pelenė;Žirniukai;3863839750;Taip;17;0;0;17
7038;Pelenė;Žirniukai;5922348478;Taip;5;0;0;5
7039;Pelenė;Žirniukai;1313425695;Taip;7;4;0;11
7040;Pelenė;Žirniukai;2068793184;Taip;0;16;0;16
7041;Pelenė;Žirniukai;7383544475;Taip;0;20;0;20
7042;Pelenė;Žirniukai;1595627222;Taip;0;11;0;11
7043;Pelenė;Žirniukai;2438266396;Taip;0;4;0;4
7044;Pelenė;Lašeliai;7017031073;Taip;0;1;0;1
7045;Pelenė;Lašeliai;9018211726;Taip;7;0;0;7
7046;Pelenė;Lašeliai;9313153383;Taip;0;20;0;20
7047;Pelenė;Lašeliai;5836118223;Taip;0;5;0;5
7048;Pelenė;Lašeliai;6316640679;Taip;5;4;1;10
7049;Pelenė;Lašeliai;1711603372;Taip;0;11;0;11
7050;Pelenė;Lašeliai;1944933777;Taip;0;19;0;19
7051;Pelenė;Lašeliai;2303618074;Taip;2;0;3;5
7052;Pelenė;Lašeliai;6167965418;Taip;5;4;0;9
7053;Pelenė;Lašeliai;4431474395;Taip;1;9;0;10
7054;Pelenė;Lašeliai;9097123374;Taip;0;9;0;9
7055;Pelenė;Lašeliai;9162252512;Ne;19;1;0;20
7056;Pelenė;Lašeliai;4695104609;Taip;0;3;0;3
7057;Pelenė;Lašeliai;7148956863;Taip;9;11;0;20
7058;Pelenė;Lašeliai;3663288138;Taip;5;0;0;5
7059;Pelenė;Lašeliai;4148108151;Taip;0;7;0;7
7060;Pelenė;Lašeliai;1303066945;Taip;19;1;0;20
7061;Pelenė;Lašeliai;3563882751;Taip;0;8;0;8
7062;Pelenė;Grūdelis;6790396551;Ne;7;0;0;7
7063;Pelenė;Grūdelis;6221703608;Taip;0;8;0;8
7064;Pelenė;Grūdelis;7880284433;Taip;2;4;0;6
7065;Pelenė;Grūdelis;4989239822;Taip;0;1;0;1
7066;Pelenė;Grūdelis;6481466282;Taip;6;1;0;7
7067;Pelenė;Grūdelis;6707167720;Taip;0;0;1;1
7068;Pelenė;Grūdelis;6267178572;Taip;0;8;0;8
7069;Pelenė;Grūdelis;1468658102;Taip;0;0;4;4
7070;Pelenė;Grūdelis;1573848786;Taip;0;9;0;9
7071;Pelenė;Grūdelis;7985634731;Taip;0;4;0;4
7072;Pelenė;Grūdelis;1555782878;Taip;0;0;1;1
7073;Pelenė;Grūdelis;7858530013;Taip;0;8;0;8
7074;Pelenė;Grūdelis;7702502252;Ne;0;5;0;5
7075;Pelenė;Grūdelis;6678273450;Taip;0;2;0;2
7076;Pelenė;Grūdelis;6648966721;Taip;5;0;0;5
7077;Pelenė;Braškytė;8504675439;Taip;4;5;0;9
7078;Pelenė;Braškytė;6306403720;Taip;14;3;0;17
7079;Pelenė;Braškytė;5243889672;Taip;12;0;0;12
7080;Pelenė;Braškytė;6213281783;Taip;4;0;0;4
7081;Pelenė;Braškytė;9123459933;Taip;6;0;0;6
7082;Pelenė;Braškytė;2425992275;Taip;10;0;0;10
7083;Pelenė;Braškytė;5215324103;Taip;8;0;0;8
7084;Pelenė;Braškytė;1783529770;Taip;9;1;0;10
7085;Pelenė;Braškytė;6181640181;Taip;9;0;0;9
7086;Pelenė;Braškytė;7143533875;Taip;6;0;0;6
7087;Pelenė;Braškytė;8977625247;Taip;10;0;1;11
7088;Pelenė;Braškytė;6154342149;Taip;0;1;1;2
7089;Pelenė;Braškytė;7171545733;Taip;11;4;0;15
7090;Pelenė;Braškytė;6025404134;Taip;0;7;0;7
7091;Pelenė;Boružėlės;4955162765;Taip;14;0;0;14
7092;Pelenė;Boružėlės;3200796745;Taip;9;0;0;9
7093;Pelenė;Boružėlės;6427008429;Taip;3;1;0;4
7094;Pelenė;Boružėlės;4290709227;Taip;20;0;0;20
7095;Pelenė;Boružėlės;8325318483;Taip;5;0;0;5
7096;Pelenė;Boružėlės;3677861360;Taip;5;0;0;5
7097;Pelenė;Boružėlės;8732297405;Taip;1;0;0;1
7098;Pelenė;Boružėlės;5845118981;Taip;11;0;0;11
7099;Pelenė;Boružėlės;8942422475;Taip;6;0;1;7
7100;Pelenė;Boružėlės;9554893953;Taip;23;0;0;23
7101;Pelenė;Boružėlės;7320738947;Taip;8;0;0;8
7102;Pelenė;Boružėlės;3004297722;Taip;23;0;0;23
7103;Pelenė;Boružėlės;7794147237;Taip;5;0;0;5
7104;Pelenė;Boružėlės;9772543894;Taip;9;0;0;9
7105;Pelenė;Saldainiukai;2689903631;Taip;0;19;0;19
7106;Pelenė;Saldainiukai;4982869687;Taip;7;0;0;7
7107;Pelenė;Saldainiukai;3499827987;Taip;1;0;0;1
7108;Pelenė;Saldainiukai;8165766331;Taip;4;0;0;4
7109;Pelenė;Saldainiukai;2096373376;Taip;12;0;0;12
7110;Pelenė;Saldainiukai;1384382692;Taip;6;0;0;6
7111;Pelenė;Saldainiukai;9490816122;Taip;12;0;0;12
7112;Pelenė;Saldainiukai;4734502322;Taip;6;1;0;7
7113;Pelenė;Saldainiukai;7602432318;Taip;6;0;0;6
7114;Pelenė;Saldainiukai;2407328091;Taip;0;2;0;2
7115;Pelenė;Saldainiukai;8861981715;Taip;2;0;1;3
7116;Pelenė;Saldainiukai;7599381657;Taip;6;0;0;6
7117;Pelenė;Saldainiukai;2123466599;Ne;11;0;1;12
7118;Pelenė;Saldainiukai;9290443563;Taip;1;0;0;1
7119;Pelenė;Saldainiukai;2661260892;Taip;0;22;0;22
7120;Pelenė;Drugeliai;2540405047;Taip;0;0;7;7
7121;Pelenė;Drugeliai;3603352172;Taip;0;0;1;1
7122;Pelenė;Drugeliai;5084452088;Taip;0;3;0;3
7123;Pelenė;Drugeliai;2628676128;Taip;0;10;0;10
7124;Pelenė;Drugeliai;9810123679;Taip;0;5;0;5
7125;Pelenė;Drugeliai;1048899958;Taip;8;0;2;10
7126;Pelenė;Drugeliai;3327213856;Taip;4;4;0;8
7127;Pelenė;Drugeliai;6252972353;Taip;4;0;0;4
7128;Pelenė;Drugeliai;1584256570;Taip;0;0;2;2
7129;Pelenė;Drugeliai;3205331614;Taip;2;0;2;4
7130;Pelenė;Drugeliai;2163737781;Taip;0;8;0;8
7131;Pelenė;Drugeliai;9004080625;Ne;0;12;0;12
7132;Pelenė;Drugeliai;7565331966;Taip;9;1;0;10
7133;Pelenė;Drugeliai;5074054534;Taip;0;1;0;1
7134;Pelenė;Drugeliai;8194354176;Ne;14;0;0;14
7135;Pelenė;Drugeliai;5579900958;Taip;10;0;0;10
7136;Pelenė;Drugeliai;9969975097;Ne;0;0;1;1
7137;Pipiras;EŽIUKAI;8520454289;Taip;0;5;0;5
7138;Pipiras;EŽIUKAI;5856735452;Taip;2;4;0;6
7139;Pipiras;EŽIUKAI;1711168196;Taip;0;1;0;1
7140;Pipiras;EŽIUKAI;5908707752;Ne;0;4;1;5
7141;Pipiras;EŽIUKAI;4017042461;Taip;0;8;0;8
7142;Pipiras;EŽIUKAI;4725221169;Taip;0;6;0;6
7143;Pipiras;EŽIUKAI;5059203266;Taip;5;0;0;5
7144;Pipiras;EŽIUKAI;8422419380;Taip;0;9;0;9
7145;Pipiras;EŽIUKAI;6791495556;Taip;0;3;0;3
7146;Pipiras;EŽIUKAI;4811029230;Taip;0;4;3;7
7147;Pipiras;EŽIUKAI;6363349541;Taip;0;6;0;6
7148;Pipiras;EŽIUKAI;1353114929;Taip;0;6;3;9
7149;Pipiras;EŽIUKAI;4426479971;Taip;5;4;0;9
7150;Pipiras;BITUTĖS;3851239592;Taip;10;6;0;16
7151;Pipiras;BITUTĖS;1645482584;Taip;7;0;0;7
7152;Pipiras;BITUTĖS;7891664385;Taip;1;0;0;1
7153;Pipiras;BITUTĖS;9050423801;Taip;0;1;0;1
7154;Pipiras;BITUTĖS;5047070127;Taip;8;0;0;8
7155;Pipiras;BITUTĖS;9394456452;Taip;21;0;0;21
7156;Pipiras;BITUTĖS;9610070604;Taip;4;2;0;6
7157;Pipiras;BITUTĖS;7009194986;Taip;5;2;0;7
7158;Pipiras;BITUTĖS;6362968454;Taip;0;2;0;2
7159;Pipiras;BITUTĖS;9950318827;Taip;0;4;0;4
7160;Pipiras;BITUTĖS;9733577233;Taip;9;0;0;9
7161;Pipiras;BITUTĖS;2337751973;Taip;13;1;0;14
7162;Pipiras;BITUTĖS;5735018704;Taip;9;0;0;9
7163;Pipiras;BITUTĖS;6306414173;Taip;1;0;0;1
7164;Pipiras;NYKŠTUKAI;6696824728;Taip;3;4;0;7
7165;Pipiras;NYKŠTUKAI;2016718354;Taip;0;4;0;4
7166;Pipiras;NYKŠTUKAI;1169481984;Taip;13;0;0;13
7167;Pipiras;NYKŠTUKAI;4198534687;Taip;0;5;0;5
7168;Pipiras;NYKŠTUKAI;4458730479;Ne;0;5;3;8
7169;Pipiras;NYKŠTUKAI;3980950261;Taip;0;3;0;3
7170;Pipiras;NYKŠTUKAI;7828638329;Taip;5;9;0;14
7171;Pipiras;NYKŠTUKAI;6775489564;Taip;0;0;19;19
7172;Pipiras;NYKŠTUKAI;7747049622;Taip;0;3;1;4
7173;Pipiras;NYKŠTUKAI;9892201598;Taip;9;3;0;12
7174;Pipiras;NYKŠTUKAI;7371386368;Taip;0;1;0;1
7175;Pipiras;NYKŠTUKAI;1019753152;Taip;0;14;0;14
7176;Pipiras;NYKŠTUKAI;9499869533;Taip;0;4;0;4
7177;Pipiras;NYKŠTUKAI;5141447649;Taip;0;4;7;11
7178;Pipiras;NYKŠTUKAI;9877682150;Taip;0;7;0;7
7179;Pipiras;NYKŠTUKAI;9248925267;Taip;0;14;0;14
7180;Pipiras;NYKŠTUKAI;9711147855;Taip;0;0;1;1
7181;Pipiras;NYKŠTUKAI;2120810457;Taip;0;23;0;23
7182;Pipiras;PELĖDŽIUKAI;8985065850;Taip;5;1;0;6
7183;Pipiras;PELĖDŽIUKAI;3647356600;Taip;3;0;1;4
7184;Pipiras;PELĖDŽIUKAI;6465109403;Taip;5;0;0;5
7185;Pipiras;PELĖDŽIUKAI;6905506774;Taip;6;0;2;8
7186;Pipiras;PELĖDŽIUKAI;7446225835;Taip;0;2;0;2
7187;Pipiras;PELĖDŽIUKAI;8800890503;Taip;0;1;0;1
7188;Pipiras;PELĖDŽIUKAI;6184943213;Taip;0;1;0;1
7189;Pipiras;PELĖDŽIUKAI;8028360748;Taip;0;10;0;10
7190;Pipiras;PELĖDŽIUKAI;3299099535;Taip;0;5;0;5
7191;Pipiras;PELĖDŽIUKAI;8707560610;Taip;7;0;0;7
7192;Pipiras;PELĖDŽIUKAI;4940053409;Taip;3;0;1;4
7193;Pipiras;PELĖDŽIUKAI;2588075386;Taip;0;1;0;1
7194;Pipiras;PELĖDŽIUKAI;6666112357;Taip;0;1;0;1
7195;Pipiras;PELĖDŽIUKAI;9473056714;Taip;0;23;0;23
7196;Pipiras;DRUGELIAI;6482075896;Taip;0;1;0;1
7197;Pipiras;DRUGELIAI;6018174577;Taip;6;0;0;6
7198;Pipiras;DRUGELIAI;1393570307;Taip;7;0;0;7
7199;Pipiras;DRUGELIAI;3216664984;Taip;0;23;0;23
7200;Pipiras;DRUGELIAI;6925577945;Ne;0;2;0;2
7201;Pipiras;DRUGELIAI;9639609431;Taip;0;2;0;2
7202;Pipiras;DRUGELIAI;9422467047;Ne;0;0;1;1
7203;Pipiras;DRUGELIAI;4743474665;Taip;0;4;0;4
7204;Pipiras;DRUGELIAI;9552763906;Taip;10;0;5;15
7205;Pipiras;DRUGELIAI;2159315426;Taip;0;3;0;3
7206;Pipiras;DRUGELIAI;8404246568;Taip;11;1;0;12
7207;Pipiras;DRUGELIAI;3641496225;Taip;0;8;0;8
7208;Pipiras;DRUGELIAI;4991725638;Taip;0;0;2;2
7209;Pipiras;DRUGELIAI;7200147039;Taip;2;6;0;8
7210;Pipiras;DRUGELIAI;5035593032;Taip;9;0;0;9
7211;Pipiras;DRUGELIAI;6361544649;Taip;0;0;3;3
7212;Pipiras;DRUGELIAI;1079088070;Taip;0;0;1;1
7213;Pipiras;GĖLYTĖS;8965139441;Taip;4;1;0;5
7214;Pipiras;GĖLYTĖS;2095794125;Taip;0;0;3;3
7215;Pipiras;GĖLYTĖS;8675473349;Taip;4;0;0;4
7216;Pipiras;GĖLYTĖS;4945164161;Taip;9;5;0;14
7217;Pipiras;GĖLYTĖS;7362002646;Taip;3;0;0;3
7218;Pipiras;GĖLYTĖS;5150723052;Taip;4;0;0;4
7219;Pipiras;GĖLYTĖS;3755824911;Taip;10;0;0;10
7220;Pipiras;GĖLYTĖS;6453274205;Taip;6;4;0;10
7221;Pipiras;GĖLYTĖS;4559954910;Taip;0;18;0;18
7222;Pipiras;GĖLYTĖS;7157187063;Taip;8;11;0;19
7223;Pipiras;GĖLYTĖS;4021613243;Taip;6;4;0;10
7224;Pipiras;GĖLYTĖS;1611488078;Taip;0;2;5;7
7225;Pipiras;GĖLYTĖS;4236597883;Taip;0;0;6;6
7226;Pipiras;GĖLYTĖS;4289497197;Taip;0;3;0;3
7227;Pipiras;GĖLYTĖS;2474548836;Taip;0;5;0;5
7228;Pipiras;GĖLYTĖS;8553422709;Taip;4;0;1;5
7229;Pipiras;GĖLYTĖS;5738334591;Taip;0;9;0;9
7230;Pipiras;GĖLYTĖS;6428525902;Taip;0;5;3;8
7231;Pipiras;GĖLYTĖS;8354158722;Ne;8;0;0;8
7232;Pipiras;BORUŽĖLĖS;9127154444;Taip;0;1;0;1
7233;Pipiras;BORUŽĖLĖS;4707794599;Taip;7;0;0;7
7234;Pipiras;BORUŽĖLĖS;8673271201;Taip;11;0;0;11
7235;Pipiras;BORUŽĖLĖS;5968015502;Taip;0;4;0;4
7236;Pipiras;BORUŽĖLĖS;4086728233;Taip;8;5;0;13
7237;Pipiras;BORUŽĖLĖS;8508292428;Taip;0;4;0;4
7238;Pipiras;BORUŽĖLĖS;1210940213;Taip;3;6;0;9
7239;Pipiras;BORUŽĖLĖS;8260680662;Taip;0;1;0;1
7240;Pipiras;BORUŽĖLĖS;1548928533;Taip;1;6;0;7
7241;Pipiras;BORUŽĖLĖS;9097987789;Taip;0;2;0;2
7242;Pipiras;BORUŽĖLĖS;6310054093;Taip;0;4;0;4
7243;Pipiras;BORUŽĖLĖS;8959946514;Taip;9;0;0;9
7244;Pipiras;BORUŽĖLĖS;9396979045;Taip;5;0;0;5
7245;Pipiras;BORUŽĖLĖS;8443786510;Taip;4;6;0;10
7246;Pipiras;BORUŽĖLĖS;1146369304;Taip;0;5;0;5
7247;Pipiras;BORUŽĖLĖS;9970587185;Taip;5;0;0;5
7248;Pipiras;BORUŽĖLĖS;6034298583;Taip;5;4;0;9
7249;Pipiras;BORUŽĖLĖS;6344932171;Taip;4;4;0;8
7250;Pipiras;BORUŽĖLĖS;1550959705;Taip;5;0;0;5
7251;Pipiras;SKRUZDĖLIUKAI;7969837759;Taip;0;9;0;9
7252;Pipiras;SKRUZDĖLIUKAI;1315372873;Taip;0;1;0;1
7253;Pipiras;SKRUZDĖLIUKAI;9372109848;Taip;12;0;0;12
7254;Pipiras;SKRUZDĖLIUKAI;2296702730;Taip;3;0;0;3
7255;Pipiras;SKRUZDĖLIUKAI;3768825314;Taip;5;0;3;8
7256;Pipiras;SKRUZDĖLIUKAI;4309096743;Taip;7;6;0;13
7257;Pipiras;SKRUZDĖLIUKAI;2399588759;Taip;0;5;0;5
7258;Pipiras;SKRUZDĖLIUKAI;8081343184;Taip;0;0;4;4
7259;Pipiras;SKRUZDĖLIUKAI;9852475056;Taip;0;2;0;2
7260;Pipiras;SKRUZDĖLIUKAI;6176818802;Taip;5;0;1;6
7261;Pipiras;SKRUZDĖLIUKAI;6570068615;Taip;5;0;0;5
7262;Pipiras;SKRUZDĖLIUKAI;1215623527;Taip;0;5;0;5
7263;Pipiras;SKRUZDĖLIUKAI;9625933545;Taip;0;2;0;2
7264;Pipiras;SKRUZDĖLIUKAI;7211189491;Taip;8;0;0;8
7265;Pipiras;SKRUZDĖLIUKAI;6092576917;Taip;6;0;0;6
7266;Pipiras;SKRUZDĖLIUKAI;4321420201;Taip;5;6;0;11
7267;Pipiras;ŽVIRBLIUKŲ;6342044341;Ne;3;2;0;5
7268;Pipiras;ŽVIRBLIUKŲ;5725956659;Taip;7;0;0;7
7269;Pipiras;ŽVIRBLIUKŲ;3882437376;Taip;5;0;0;5
7270;Pipiras;ŽVIRBLIUKŲ;9157870634;Taip;0;3;0;3
7271;Pipiras;ŽVIRBLIUKŲ;5235868332;Taip;0;3;0;3
7272;Pipiras;ŽVIRBLIUKŲ;3554786173;Taip;0;8;0;8
7273;Pipiras;ŽVIRBLIUKŲ;1034182352;Taip;0;6;0;6
7274;Pipiras;ŽVIRBLIUKŲ;6792777396;Taip;0;4;0;4
7275;Pipiras;ŽVIRBLIUKŲ;6780333972;Taip;0;2;0;2
7276;Pipiras;ŽVIRBLIUKŲ;5622119207;Taip;0;2;0;2
7277;Pipiras;ŽVIRBLIUKŲ;7934365114;Taip;1;7;0;8
7278;Pipiras;ŽVIRBLIUKŲ;9770780973;Taip;17;0;0;17
7279;Pipiras;ŽVIRBLIUKŲ;5845498558;Taip;0;7;0;7
7280;Pipiras;ŽVIRBLIUKŲ;9840040112;Ne;0;4;0;4
7281;Pipiras;ŽVIRBLIUKŲ;1784839485;Taip;0;9;0;9
7282;Pipiras;ŽVIRBLIUKŲ;3775916247;Ne;0;4;0;4
7283;Pipiras;ŽVIRBLIUKŲ;7350131214;Taip;5;13;0;18
7284;Pipiras;ZUIKUČIŲ;7202983046;Taip;4;1;0;5
7285;Pipiras;ZUIKUČIŲ;6392620549;Taip;4;2;0;6
7286;Pipiras;ZUIKUČIŲ;4017133866;Taip;5;1;0;6
7287;Pipiras;ZUIKUČIŲ;1443705808;Taip;6;0;3;9
7288;Pipiras;ZUIKUČIŲ;5273904507;Taip;23;0;0;23
7289;Pipiras;ZUIKUČIŲ;3779938901;Taip;13;0;0;13
7290;Pipiras;ZUIKUČIŲ;8364071068;Taip;13;0;0;13
7291;Pipiras;ZUIKUČIŲ;9206586291;Taip;5;1;0;6
7292;Pipiras;ZUIKUČIŲ;1326532597;Taip;18;0;0;18
7293;Pipiras;ZUIKUČIŲ;3759775049;Taip;5;1;0;6
7294;Pipiras;ZUIKUČIŲ;8716061709;Taip;0;2;0;2
7295;Pipiras;ZUIKUČIŲ;6700688846;Taip;0;23;0;23
7296;Pipiras;ZUIKUČIŲ;5065567026;Taip;3;0;0;3
7297;Pipiras;VARLIUKŲ;8952109131;Taip;9;9;0;18
7298;Pipiras;VARLIUKŲ;1419011066;Taip;3;0;0;3
7299;Pipiras;VARLIUKŲ;3553431200;Taip;14;0;0;14
7300;Pipiras;VARLIUKŲ;7262747212;Taip;0;1;0;1
7301;Pipiras;VARLIUKŲ;3219349754;Taip;18;0;0;18
7302;Pipiras;VARLIUKŲ;1254069142;Taip;6;3;0;9
7303;Pipiras;VARLIUKŲ;3548414064;Taip;3;0;0;3
7304;Pipiras;VARLIUKŲ;5735835403;Taip;8;0;1;9
7305;Pipiras;VARLIUKŲ;8128573827;Taip;3;0;12;15
7306;Pipiras;VARLIUKŲ;6349032299;Taip;14;4;0;18
7307;Pipiras;VARLIUKŲ;7209844964;Taip;4;0;0;4
7308;Pipiras;ŽIOGELIŲ;7510719254;Taip;11;4;1;16
7309;Pipiras;ŽIOGELIŲ;7802812858;Taip;4;3;0;7
7310;Pipiras;ŽIOGELIŲ;8697732892;Taip;15;0;1;16
7311;Pipiras;ŽIOGELIŲ;1466527534;Taip;7;0;1;8
7312;Pipiras;ŽIOGELIŲ;1172225661;Taip;0;2;0;2
7313;Pipiras;ŽIOGELIŲ;3825960148;Taip;0;2;0;2
7314;Pipiras;ŽIOGELIŲ;9747219629;Taip;0;14;0;14
7315;Pipiras;ŽIOGELIŲ;8445608419;Taip;0;1;0;1
7316;Pipiras;ŽIOGELIŲ;6602780166;Taip;4;0;0;4
7317;Pipiras;ŽIOGELIŲ;4229548366;Taip;18;4;0;22
7318;Pipiras;ŽIOGELIŲ;8666908143;Taip;13;5;0;18
7319;Pipiras;ŽIOGELIŲ;4083110785;Taip;0;4;0;4
7320;Pipiras;ŽIOGELIŲ;7011969610;Taip;10;4;0;14
7321;Pipiras;ŽIOGELIŲ;2784222529;Taip;11;0;0;11
7322;Pipiras;ŽIOGELIŲ;3701585967;Taip;0;6;2;8
7323;Pipiras;ŽIOGELIŲ;5274511724;Taip;0;2;3;5
7324;Pipiras;ŽIOGELIŲ;8852386906;Taip;0;3;0;3
7325;Pipiras;ŽIOGELIŲ;1417118390;Taip;6;3;5;14
7326;Pipiras;ŽIOGELIŲ;8364783015;Taip;16;4;0;20
7327;Pipiras;ŽIOGELIŲ;8351469544;Taip;0;23;0;23
7328;"Prie pasakų parko";ZUIKUČIAI;8493622886;Taip;4;0;0;4
7329;"Prie pasakų parko";ZUIKUČIAI;3998970024;Taip;4;0;0;4
7330;"Prie pasakų parko";ZUIKUČIAI;3907016976;Taip;1;0;0;1
7331;"Prie pasakų parko";ZUIKUČIAI;4904562817;Taip;5;0;0;5
7332;"Prie pasakų parko";ZUIKUČIAI;9659710840;Taip;0;4;0;4
7333;"Prie pasakų parko";ZUIKUČIAI;5394554484;Taip;13;0;0;13
7334;"Prie pasakų parko";ZUIKUČIAI;9707694441;Taip;5;4;0;9
7335;"Prie pasakų parko";ZUIKUČIAI;7220229641;Ne;16;0;0;16
7336;"Prie pasakų parko";ZUIKUČIAI;8616467675;Taip;6;0;0;6
7337;"Prie pasakų parko";ZUIKUČIAI;8215496569;Ne;2;0;0;2
7338;"Prie pasakų parko";ZUIKUČIAI;9742058853;Taip;4;0;0;4
7339;"Prie pasakų parko";ZUIKUČIAI;3038164555;Taip;1;0;0;1
7340;"Prie pasakų parko";ZUIKUČIAI;4183640714;Taip;21;0;0;21
7341;"Prie pasakų parko";ZUIKUČIAI;5326765354;Taip;11;0;0;11
7342;"Prie pasakų parko";PAUKŠČIUKŲ;7330033315;Taip;4;0;0;4
7343;"Prie pasakų parko";PAUKŠČIUKŲ;9061639276;Taip;1;0;0;1
7344;"Prie pasakų parko";PAUKŠČIUKŲ;1476515947;Ne;0;0;1;1
7345;"Prie pasakų parko";PAUKŠČIUKŲ;6601363351;Ne;6;0;0;6
7346;"Prie pasakų parko";PAUKŠČIUKŲ;7693728136;Taip;0;3;0;3
7347;"Prie pasakų parko";PAUKŠČIUKŲ;8882083855;Taip;3;0;0;3
7348;"Prie pasakų parko";PAUKŠČIUKŲ;8627379659;Taip;3;0;0;3
7349;"Prie pasakų parko";PAUKŠČIUKŲ;1644560882;Taip;0;4;0;4
7350;"Prie pasakų parko";PAUKŠČIUKŲ;4643624588;Taip;11;0;0;11
7351;"Prie pasakų parko";PAUKŠČIUKŲ;7349726598;Taip;1;0;0;1
7352;"Prie pasakų parko";PAUKŠČIUKŲ;9571177184;Taip;11;0;0;11
7353;"Prie pasakų parko";PAUKŠČIUKŲ;1435069282;Taip;11;0;0;11
7354;"Prie pasakų parko";"LINKSMOJI ŠEIMYNĖLĖ (SPEC)";2077861244;Ne;0;0;1;1
7355;"Prie pasakų parko";"LINKSMOJI ŠEIMYNĖLĖ (SPEC)";4895744524;Taip;3;0;0;3
7356;"Prie pasakų parko";NYKŠTUKŲ;2287711014;Taip;0;0;2;2
7357;"Prie pasakų parko";NYKŠTUKŲ;6491435655;Taip;14;0;2;16
7358;"Prie pasakų parko";NYKŠTUKŲ;1743429440;Taip;0;0;2;2
7359;"Prie pasakų parko";NYKŠTUKŲ;7739970115;Taip;5;0;0;5
7360;"Prie pasakų parko";NYKŠTUKŲ;6700916147;Taip;3;0;0;3
7361;"Prie pasakų parko";NYKŠTUKŲ;6733793491;Taip;9;9;1;19
7362;"Prie pasakų parko";NYKŠTUKŲ;2515928623;Taip;3;0;1;4
7363;"Prie pasakų parko";NYKŠTUKŲ;4726737519;Taip;4;0;1;5
7364;"Prie pasakų parko";NYKŠTUKŲ;2654978735;Taip;14;0;9;23
7365;"Prie pasakų parko";NYKŠTUKŲ;4457827262;Taip;5;0;2;7
7366;"Prie pasakų parko";NYKŠTUKŲ;6171021539;Taip;7;0;1;8
7367;"Prie pasakų parko";NYKŠTUKŲ;4860316199;Ne;0;4;0;4
7368;"Prie pasakų parko";NYKŠTUKŲ;3907578461;Taip;10;0;0;10
7369;"Prie pasakų parko";NYKŠTUKŲ;4891232161;Taip;0;0;1;1
7370;"Prie pasakų parko";LAŠELIŲ;8574432191;Taip;2;1;0;3
7371;"Prie pasakų parko";LAŠELIŲ;4181676762;Taip;0;1;0;1
7372;"Prie pasakų parko";LAŠELIŲ;4548803933;Taip;5;0;0;5
7373;"Prie pasakų parko";LAŠELIŲ;6250610187;Taip;0;4;0;4
7374;"Prie pasakų parko";LAŠELIŲ;2216634402;Taip;6;0;0;6
7375;"Prie pasakų parko";LAŠELIŲ;8339335908;Taip;2;0;0;2
7376;"Prie pasakų parko";LAŠELIŲ;2350325153;Ne;9;0;0;9
7377;"Prie pasakų parko";LAŠELIŲ;7390391804;Taip;1;0;0;1
7378;"Prie pasakų parko";LAŠELIŲ;6762267582;Taip;7;4;0;11
7379;"Prie pasakų parko";LAŠELIŲ;9072312203;Taip;1;0;0;1
7380;"Prie pasakų parko";LAŠELIŲ;2952868428;Taip;1;0;0;1
7381;"Prie pasakų parko";LAŠELIŲ;5159105661;Taip;7;0;0;7
7382;"Prie pasakų parko";LAŠELIŲ;6074218082;Taip;3;0;0;3
7383;"Prie pasakų parko";"KAČIUKAI (SPEC)";3949671257;Taip;13;0;0;13
7384;"Prie pasakų parko";"KAČIUKAI (SPEC)";2583331243;Taip;13;0;0;13
7385;"Prie pasakų parko";"KAČIUKAI (SPEC)";1370201372;Taip;4;0;0;4
7386;"Prie pasakų parko";"KAČIUKAI (SPEC)";8056265378;Taip;7;0;0;7
7387;"Prie pasakų parko";"KAČIUKAI (SPEC)";5594531224;Taip;4;0;0;4
7388;"Prie pasakų parko";"KAČIUKAI (SPEC)";1618225282;Taip;2;9;0;11
7389;"Prie pasakų parko";"ŽVAIGŽDUTĖS  (SPEC)";7216751216;Taip;8;0;0;8
7390;"Prie pasakų parko";"ŽVAIGŽDUTĖS  (SPEC)";5006152810;Taip;5;0;0;5
7391;"Prie pasakų parko";"ŽVAIGŽDUTĖS  (SPEC)";6989235061;Taip;6;0;4;10
7392;"Prie pasakų parko";"ŽVAIGŽDUTĖS  (SPEC)";6585504578;Taip;13;0;2;15
7393;"Prie pasakų parko";"ŽVAIGŽDUTĖS  (SPEC)";1621710265;Ne;4;0;0;4
7394;"Prie pasakų parko";"ŽVAIGŽDUTĖS  (SPEC)";8203595449;Taip;14;0;0;14
7395;"Prie pasakų parko";"ŽVAIGŽDUTĖS  (SPEC)";7476984763;Taip;4;0;2;6
7396;"Prie pasakų parko";"ŽVAIGŽDUTĖS  (SPEC)";7449993309;Taip;9;0;0;9
7397;"Prie pasakų parko";"ANČIUKAI (SPEC)";6802898184;Taip;0;0;1;1
7398;"Prie pasakų parko";"ANČIUKAI (SPEC)";4309482351;Taip;11;0;0;11
7399;"Prie pasakų parko";"ANČIUKAI (SPEC)";7200571639;Taip;0;0;4;4
7400;"Prie pasakų parko";"ANČIUKAI (SPEC)";2047018335;Ne;0;0;1;1
7401;"Prie pasakų parko";"ANČIUKAI (SPEC)";2731902356;Taip;11;0;0;11
7402;"Prie pasakų parko";"ANČIUKAI (SPEC)";5627477370;Ne;0;9;1;10
7403;"Prie pasakų parko";"ANČIUKAI (SPEC)";9999109437;Ne;11;3;1;15
7404;"Prie pasakų parko";TIGRIUKAI;3918269702;Taip;15;0;0;15
7405;"Prie pasakų parko";TIGRIUKAI;6446562388;Taip;3;0;2;5
7406;"Prie pasakų parko";TIGRIUKAI;2168919559;Taip;3;5;0;8
7407;"Prie pasakų parko";TIGRIUKAI;2898016639;Taip;7;0;0;7
7408;"Prie pasakų parko";TIGRIUKAI;9476448601;Taip;3;0;2;5
7409;"Prie pasakų parko";TIGRIUKAI;8715851643;Taip;5;0;2;7
7410;"Prie pasakų parko";TIGRIUKAI;3617673265;Taip;0;0;1;1
7411;"Prie pasakų parko";TIGRIUKAI;1704679306;Taip;5;5;0;10
7412;"Prie pasakų parko";TIGRIUKAI;7776961789;Taip;0;0;2;2
7413;"Prie pasakų parko";TIGRIUKAI;3373275644;Taip;7;2;0;9
7414;"Prie pasakų parko";TIGRIUKAI;5518041213;Taip;0;2;1;3
7415;"Prie pasakų parko";TIGRIUKAI;8738488104;Taip;0;2;1;3
7416;"Prie pasakų parko";TIGRIUKAI;6606867989;Taip;0;0;1;1
7417;"Prie pasakų parko";TIGRIUKAI;2263419475;Taip;4;0;0;4
7418;"Prie pasakų parko";TIGRIUKAI;6784471792;Taip;6;5;0;11
7419;"Prie pasakų parko";TIGRIUKAI;8338549157;Ne;7;0;0;7
7420;"Prie pasakų parko";"EŽIUKŲ (SPEC)";5944113879;Ne;13;0;0;13
7421;"Prie pasakų parko";"EŽIUKŲ (SPEC)";4950143153;Ne;0;0;1;1
7422;"Prie pasakų parko";"EŽIUKŲ (SPEC)";5834070970;Taip;0;0;3;3
7423;"Prie pasakų parko";"EŽIUKŲ (SPEC)";3579773269;Taip;5;0;1;6
7424;"Prie pasakų parko";"BORUŽIUKŲ (SPEC)";9715586563;Ne;20;0;0;20
7425;"Prie pasakų parko";"BORUŽIUKŲ (SPEC)";2104412442;Ne;6;0;0;6
7426;"Prie pasakų parko";"BORUŽIUKŲ (SPEC)";6051760219;Taip;7;0;0;7
7427;"Prie pasakų parko";"BORUŽIUKŲ (SPEC)";5821107898;Taip;4;0;0;4
7428;"Prie pasakų parko";SAULYTĖS;4827245401;Taip;5;0;0;5
7429;"Prie pasakų parko";SAULYTĖS;7404885669;Ne;8;0;0;8
7430;"Prie pasakų parko";SAULYTĖS;3430128279;Taip;15;0;1;16
7431;"Prie pasakų parko";SAULYTĖS;5039094555;Ne;5;0;0;5
7432;"Prie pasakų parko";SAULYTĖS;4580377882;Ne;8;0;0;8
7433;"Prie pasakų parko";SAULYTĖS;5676549541;Ne;14;0;0;14
7434;"Prie pasakų parko";SAULYTĖS;9464727980;Taip;3;0;0;3
7435;"Prie pasakų parko";SAULYTĖS;8621403184;Taip;8;0;0;8
7436;"Prie pasakų parko";SAULYTĖS;4844984321;Taip;4;0;0;4
7437;"Prie pasakų parko";SAULYTĖS;6955061957;Taip;6;4;0;10
7438;"Pumpurėlis (Kalvarijų g. 186)";RAMUNĖLIŲ;7652642088;Taip;0;0;1;1
7439;"Pumpurėlis (Kalvarijų g. 186)";RAMUNĖLIŲ;9052267552;Taip;0;3;1;4
7440;"Pumpurėlis (Kalvarijų g. 186)";RAMUNĖLIŲ;9372725707;Taip;0;0;1;1
7441;"Pumpurėlis (Kalvarijų g. 186)";RAMUNĖLIŲ;2715059752;Taip;0;0;3;3
7442;"Pumpurėlis (Kalvarijų g. 186)";RAMUNĖLIŲ;4249039048;Taip;5;4;2;11
7443;"Pumpurėlis (Kalvarijų g. 186)";RAMUNĖLIŲ;1082775039;Taip;0;4;1;5
7444;"Pumpurėlis (Kalvarijų g. 186)";RAMUNĖLIŲ;6982600785;Taip;14;0;0;14
7445;"Pumpurėlis (Kalvarijų g. 186)";RAMUNĖLIŲ;1667602636;Taip;7;0;0;7
7446;"Pumpurėlis (Kalvarijų g. 186)";RAMUNĖLIŲ;8212403350;Taip;0;0;3;3
7447;"Pumpurėlis (Kalvarijų g. 186)";RAMUNĖLIŲ;6795405194;Taip;0;0;1;1
7448;"Pumpurėlis (Kalvarijų g. 186)";RAMUNĖLIŲ;7443152469;Taip;0;0;23;23
7449;"Pumpurėlis (Kalvarijų g. 186)";RAMUNĖLIŲ;9306426978;Taip;1;0;0;1
7450;"Pumpurėlis (Kalvarijų g. 186)";RAMUNĖLIŲ;8458676611;Taip;8;0;0;8
7451;"Pumpurėlis (Kalvarijų g. 186)";RAMUNĖLIŲ;1856558407;Taip;13;0;1;14
7452;"Pumpurėlis (Kalvarijų g. 186)";RAMUNĖLIŲ;7002569226;Ne;7;0;0;7
7453;"Pumpurėlis (Kalvarijų g. 186)";RAMUNĖLIŲ;1189960583;Ne;0;0;4;4
7454;"Pumpurėlis (Kalvarijų g. 186)";RAMUNĖLIŲ;8534897580;Taip;6;0;0;6
7455;"Pumpurėlis (Kalvarijų g. 186)";VARPELIŲ;5326000400;Taip;18;0;0;18
7456;"Pumpurėlis (Kalvarijų g. 186)";VARPELIŲ;7998027741;Taip;8;0;1;9
7457;"Pumpurėlis (Kalvarijų g. 186)";VARPELIŲ;9395698760;Taip;6;8;1;15
7458;"Pumpurėlis (Kalvarijų g. 186)";VARPELIŲ;9478685443;Taip;1;0;0;1
7459;"Pumpurėlis (Kalvarijų g. 186)";VARPELIŲ;9903981454;Taip;4;0;1;5
7460;"Pumpurėlis (Kalvarijų g. 186)";VARPELIŲ;6647331393;Taip;2;0;5;7
7461;"Pumpurėlis (Kalvarijų g. 186)";VARPELIŲ;3537534154;Taip;0;4;0;4
7462;"Pumpurėlis (Kalvarijų g. 186)";VARPELIŲ;3001331278;Taip;2;0;0;2
7463;"Pumpurėlis (Kalvarijų g. 186)";VARPELIŲ;9735493140;Taip;2;0;0;2
7464;"Pumpurėlis (Kalvarijų g. 186)";VARPELIŲ;3964441086;Taip;8;0;0;8
7465;"Pumpurėlis (Kalvarijų g. 186)";VARPELIŲ;8550119831;Taip;9;0;1;10
7466;"Pumpurėlis (Kalvarijų g. 186)";VARPELIŲ;6860128064;Taip;0;0;1;1
7467;"Pumpurėlis (Kalvarijų g. 186)";VARPELIŲ;2282966743;Taip;7;0;0;7
7468;"Pumpurėlis (Kalvarijų g. 186)";VARPELIŲ;5968577443;Taip;2;0;2;4
7469;"Pumpurėlis (Kalvarijų g. 186)";VARPELIŲ;8083674991;Taip;3;0;1;4
7470;"Pumpurėlis (Kalvarijų g. 186)";VARPELIŲ;6422203618;Taip;0;3;1;4
7471;"Pumpurėlis (Kalvarijų g. 186)";VARPELIŲ;1782842327;Taip;6;0;0;6
7472;"Pumpurėlis (Kalvarijų g. 186)";VARPELIŲ;9750242149;Taip;5;0;0;5
7473;"Pumpurėlis (Kalvarijų g. 186)";VARPELIŲ;5420222684;Taip;2;1;0;3
7474;"Pumpurėlis (Kalvarijų g. 186)";DRUGELIŲ;5928552565;Taip;0;0;2;2
7475;"Pumpurėlis (Kalvarijų g. 186)";DRUGELIŲ;5897036076;Taip;14;0;0;14
7476;"Pumpurėlis (Kalvarijų g. 186)";DRUGELIŲ;7055989095;Taip;0;18;0;18
7477;"Pumpurėlis (Kalvarijų g. 186)";DRUGELIŲ;7078621340;Taip;0;4;0;4
7478;"Pumpurėlis (Kalvarijų g. 186)";DRUGELIŲ;2368226822;Taip;6;0;0;6
7479;"Pumpurėlis (Kalvarijų g. 186)";DRUGELIŲ;3088476130;Taip;6;0;0;6
7480;"Pumpurėlis (Kalvarijų g. 186)";DRUGELIŲ;9640790401;Taip;8;0;0;8
7481;"Pumpurėlis (Kalvarijų g. 186)";DRUGELIŲ;8320987208;Taip;0;4;0;4
7482;"Pumpurėlis (Kalvarijų g. 186)";DRUGELIŲ;7832408524;Taip;4;0;0;4
7483;"Pumpurėlis (Kalvarijų g. 186)";DRUGELIŲ;8644853849;Taip;10;4;0;14
7484;"Pumpurėlis (Kalvarijų g. 186)";DRUGELIŲ;9417688597;Taip;7;4;0;11
7485;"Pumpurėlis (Kalvarijų g. 186)";DRUGELIŲ;9032255874;Taip;15;0;0;15
7486;"Pumpurėlis (Kalvarijų g. 186)";DRUGELIŲ;9996789041;Taip;0;0;3;3
7487;"Pumpurėlis (Kalvarijų g. 186)";DRUGELIŲ;2684592319;Taip;2;0;0;2
7488;"Pumpurėlis (Kalvarijų g. 186)";DRUGELIŲ;5835115428;Taip;0;4;1;5
7489;"Pumpurėlis (Kalvarijų g. 186)";DRUGELIŲ;2132563531;Taip;14;0;0;14
7490;"Pumpurėlis (Kalvarijų g. 186)";DRUGELIŲ;4506063812;Taip;10;2;0;12
7491;"Pumpurėlis (Kalvarijų g. 186)";DRUGELIŲ;2165141865;Taip;7;0;0;7
7492;"Pumpurėlis (Kalvarijų g. 186)";DRUGELIŲ;8671697745;Taip;5;0;0;5
7493;"Pumpurėlis (Kalvarijų g. 186)";DRUGELIŲ;3187815703;Taip;20;0;1;21
7494;"Pumpurėlis (Kalvarijų g. 186)";KODĖLČIUKŲ;8214602054;Taip;0;0;1;1
7495;"Pumpurėlis (Kalvarijų g. 186)";KODĖLČIUKŲ;5564844211;Taip;0;0;1;1
7496;"Pumpurėlis (Kalvarijų g. 186)";KODĖLČIUKŲ;1215117598;Taip;3;5;0;8
7497;"Pumpurėlis (Kalvarijų g. 186)";KODĖLČIUKŲ;6978091765;Taip;0;0;4;4
7498;"Pumpurėlis (Kalvarijų g. 186)";KODĖLČIUKŲ;6433757421;Taip;0;0;1;1
7499;"Pumpurėlis (Kalvarijų g. 186)";KODĖLČIUKŲ;3748601124;Taip;0;4;0;4
7500;"Pumpurėlis (Kalvarijų g. 186)";KODĖLČIUKŲ;6004234378;Taip;0;2;0;2
7501;"Pumpurėlis (Kalvarijų g. 186)";KODĖLČIUKŲ;4196409137;Ne;4;2;0;6
7502;"Pumpurėlis (Kalvarijų g. 186)";KODĖLČIUKŲ;6117720533;Taip;0;2;0;2
7503;"Pumpurėlis (Kalvarijų g. 186)";KODĖLČIUKŲ;8070486897;Taip;0;0;2;2
7504;"Pumpurėlis (Kalvarijų g. 186)";KODĖLČIUKŲ;3534133061;Taip;0;5;0;5
7505;"Pumpurėlis (Kalvarijų g. 186)";KODĖLČIUKŲ;2307819108;Ne;0;4;0;4
7506;"Pumpurėlis (Kalvarijų g. 186)";KODĖLČIUKŲ;6702744879;Taip;0;0;3;3
7507;"Pumpurėlis (Kalvarijų g. 186)";KODĖLČIUKŲ;9839285886;Taip;5;4;0;9
7508;"Pumpurėlis (Kalvarijų g. 186)";LINELIS;6780042929;Taip;0;9;0;9
7509;"Pumpurėlis (Kalvarijų g. 186)";LINELIS;7610949816;Taip;2;2;0;4
7510;"Pumpurėlis (Kalvarijų g. 186)";LINELIS;8667762689;Taip;0;4;0;4
7511;"Pumpurėlis (Kalvarijų g. 186)";LINELIS;3953103488;Taip;0;3;0;3
7512;"Pumpurėlis (Kalvarijų g. 186)";LINELIS;9431295796;Taip;0;6;0;6
7513;"Pumpurėlis (Kalvarijų g. 186)";LINELIS;3838705973;Taip;4;2;0;6
7514;"Pumpurėlis (Kalvarijų g. 186)";LINELIS;1395380236;Taip;0;1;0;1
7515;"Pumpurėlis (Kalvarijų g. 186)";LINELIS;9424449290;Taip;0;6;0;6
7516;"Pumpurėlis (Kalvarijų g. 186)";LINELIS;6955168163;Taip;0;1;0;1
7517;"Pumpurėlis (Kalvarijų g. 186)";LINELIS;5171198109;Taip;0;1;0;1
7518;"Pumpurėlis (Kalvarijų g. 186)";LINELIS;7229289985;Taip;6;0;0;6
7519;"Pumpurėlis (Kalvarijų g. 186)";LINELIS;7619709360;Taip;11;0;0;11
7520;"Pumpurėlis (Kalvarijų g. 186)";LINELIS;6726875853;Taip;0;6;0;6
7521;"Pumpurėlis (Kalvarijų g. 186)";LINELIS;7559071945;Taip;0;4;0;4
7522;"Pumpurėlis (Kalvarijų g. 186)";LINELIS;9117809080;Taip;0;4;0;4
7523;"Pumpurėlis (Kalvarijų g. 186)";SAULUTĖS;7182107790;Taip;0;0;2;2
7524;"Pumpurėlis (Kalvarijų g. 186)";SAULUTĖS;8525537588;Ne;0;0;1;1
7525;"Pumpurėlis (Kalvarijų g. 186)";SAULUTĖS;3101133244;Taip;0;5;0;5
7526;"Pumpurėlis (Kalvarijų g. 186)";SAULUTĖS;2668855786;Taip;0;9;0;9
7527;"Pumpurėlis (Kalvarijų g. 186)";SAULUTĖS;2103139845;Taip;0;1;1;2
7528;"Pumpurėlis (Kalvarijų g. 186)";SAULUTĖS;9612924972;Taip;0;4;0;4
7529;"Pumpurėlis (Kalvarijų g. 186)";SAULUTĖS;9884099545;Taip;6;4;0;10
7530;"Pumpurėlis (Kalvarijų g. 186)";SAULUTĖS;3733509497;Taip;0;3;1;4
7531;"Pumpurėlis (Kalvarijų g. 186)";SAULUTĖS;2247300456;Taip;0;2;0;2
7532;"Pumpurėlis (Kalvarijų g. 186)";SAULUTĖS;9224879966;Taip;6;0;1;7
7533;"Pumpurėlis (Kalvarijų g. 186)";SAULUTĖS;5564680653;Taip;0;4;2;6
7534;"Pumpurėlis (Kalvarijų g. 186)";SAULUTĖS;1411232443;Taip;1;1;0;2
7535;"Pumpurėlis (Kalvarijų g. 186)";SAULUTĖS;4629544683;Taip;0;1;0;1
7536;"Pumpurėlis (Kalvarijų g. 186)";SAULUTĖS;5583929465;Taip;0;3;0;3
7537;"Pumpurėlis (Kalvarijų g. 186)";BITUTĖS;4419940231;Taip;10;5;0;15
7538;"Pumpurėlis (Kalvarijų g. 186)";BITUTĖS;4985045047;Taip;0;0;1;1
7539;"Pumpurėlis (Kalvarijų g. 186)";BITUTĖS;2651037375;Ne;8;0;0;8
7540;"Pumpurėlis (Kalvarijų g. 186)";BITUTĖS;1768239820;Taip;0;0;3;3
7541;"Pumpurėlis (Kalvarijų g. 186)";BITUTĖS;2566557351;Taip;0;4;1;5
7542;"Pumpurėlis (Kalvarijų g. 186)";BITUTĖS;4426697956;Taip;0;0;1;1
7543;"Pumpurėlis (Kalvarijų g. 186)";BITUTĖS;7363814444;Taip;4;0;6;10
7544;"Pumpurėlis (Kalvarijų g. 186)";BITUTĖS;3405169131;Taip;0;4;0;4
7545;"Pumpurėlis (Kalvarijų g. 186)";BITUTĖS;3951445693;Taip;5;0;1;6
7546;"Pumpurėlis (Kalvarijų g. 186)";BITUTĖS;9612924316;Taip;0;15;0;15
7547;"Pumpurėlis (Kalvarijų g. 186)";BITUTĖS;1714440337;Taip;0;0;7;7
7548;"Pumpurėlis (Kalvarijų g. 186)";BITUTĖS;8655389224;Taip;3;0;0;3
7549;"Pumpurėlis (Kalvarijų g. 186)";BITUTĖS;3842632260;Taip;0;4;1;5
7550;"Pumpurėlis (Kalvarijų g. 186)";BITUTĖS;1933502038;Taip;0;4;0;4
7551;"Pumpurėlis (Kalvarijų g. 186)";BITUTĖS;7062090879;Taip;7;4;2;13
7552;"Pumpurėlis (Kalvarijų g. 186)";BITUTĖS;9245739052;Ne;0;0;5;5
7553;"Pumpurėlis (Kalvarijų g. 186)";BITUTĖS;8470433743;Taip;10;0;8;18
7554;"Pumpurėlis (Kalvarijų g. 186)";BITUTĖS;6474918016;Taip;0;0;2;2
7555;"Pumpurėlis (Kalvarijų g. 186)";DOBILIUKAI;9179780392;Taip;2;0;0;2
7556;"Pumpurėlis (Kalvarijų g. 186)";DOBILIUKAI;1839505206;Taip;0;6;0;6
7557;"Pumpurėlis (Kalvarijų g. 186)";DOBILIUKAI;3970253545;Taip;3;0;1;4
7558;"Pumpurėlis (Kalvarijų g. 186)";DOBILIUKAI;1808734330;Taip;2;0;0;2
7559;"Pumpurėlis (Kalvarijų g. 186)";DOBILIUKAI;6968264923;Taip;0;3;0;3
7560;"Pumpurėlis (Kalvarijų g. 186)";DOBILIUKAI;2700017433;Taip;0;0;3;3
7561;"Pumpurėlis (Kalvarijų g. 186)";DOBILIUKAI;7038597556;Taip;0;12;0;12
7562;"Pumpurėlis (Kalvarijų g. 186)";DOBILIUKAI;4130539703;Ne;0;5;0;5
7563;"Pumpurėlis (Kalvarijų g. 186)";DOBILIUKAI;3374174445;Taip;0;6;0;6
7564;"Pumpurėlis (Kalvarijų g. 186)";DOBILIUKAI;1961282282;Taip;0;0;2;2
7565;"Pumpurėlis (Kalvarijų g. 186)";DOBILIUKAI;7276322999;Taip;5;0;0;5
7566;"Pumpurėlis (Kalvarijų g. 186)";DOBILIUKAI;5587118874;Taip;1;0;0;1
7567;"Pumpurėlis (Kalvarijų g. 186)";DOBILIUKAI;9058493247;Taip;0;1;0;1
7568;"Pumpurėlis (Kalvarijų g. 186)";DOBILIUKAI;3214652626;Taip;4;0;0;4
7569;"Pumpurėlis (Kalvarijų g. 186)";DOBILIUKAI;5444879430;Taip;2;1;0;3
7570;"Pumpurėlis (Kalvarijų g. 186)";DOBILIUKAI;7825190756;Taip;0;0;3;3
7571;"Pumpurėlis (Kalvarijų g. 186)";DOBILIUKAI;1438740562;Taip;5;0;0;5
7572;"Pumpurėlis (Kalvarijų g. 186)";DOBILIUKAI;9740660699;Taip;0;4;0;4
7573;"Pumpurėlis (Kalvarijų g. 186)";PUPYČIŲ;9317274035;Taip;9;0;0;9
7574;"Pumpurėlis (Kalvarijų g. 186)";PUPYČIŲ;1555441484;Taip;9;0;0;9
7575;"Pumpurėlis (Kalvarijų g. 186)";PUPYČIŲ;5238756058;Taip;7;0;14;21
7576;"Pumpurėlis (Kalvarijų g. 186)";PUPYČIŲ;3131907007;Taip;4;0;1;5
7577;"Pumpurėlis (Kalvarijų g. 186)";PUPYČIŲ;5384176825;Taip;0;0;2;2
7578;"Pumpurėlis (Kalvarijų g. 186)";PUPYČIŲ;5228548329;Taip;0;0;11;11
7579;"Pumpurėlis (Kalvarijų g. 186)";PUPYČIŲ;7114896633;Taip;9;0;0;9
7580;"Pumpurėlis (Kalvarijų g. 186)";PUPYČIŲ;4133819653;Taip;4;1;0;5
7581;"Pumpurėlis (Kalvarijų g. 186)";PUPYČIŲ;8215233820;Taip;7;0;1;8
7582;"Pumpurėlis (Kalvarijų g. 186)";PUPYČIŲ;1413673339;Taip;18;0;0;18
7583;"Pumpurėlis (Kalvarijų g. 186)";PUPYČIŲ;1084209625;Taip;1;0;1;2
7584;"Pumpurėlis (Kalvarijų g. 186)";PUPYČIŲ;9164586359;Taip;4;0;0;4
7585;"Pumpurėlis (Kalvarijų g. 186)";PUPYČIŲ;9316908064;Taip;4;0;0;4
7586;"Pumpurėlis (Kalvarijų g. 186)";PUPYČIŲ;1082943651;Taip;11;0;0;11
7587;"Pumpurėlis (Kalvarijų g. 186)";ŽIRNIUKŲ;4198532140;Taip;8;0;0;8
7588;"Pumpurėlis (Kalvarijų g. 186)";ŽIRNIUKŲ;6162279957;Taip;11;0;0;11
7589;"Pumpurėlis (Kalvarijų g. 186)";ŽIRNIUKŲ;6602860291;Taip;13;0;0;13
7590;"Pumpurėlis (Kalvarijų g. 186)";ŽIRNIUKŲ;6535225429;Taip;11;0;0;11
7591;"Pumpurėlis (Kalvarijų g. 186)";ŽIRNIUKŲ;6606861732;Taip;8;0;2;10
7592;"Pumpurėlis (Kalvarijų g. 186)";ŽIRNIUKŲ;8057222613;Taip;16;0;0;16
7593;"Pumpurėlis (Kalvarijų g. 186)";ŽIRNIUKŲ;9704396561;Taip;14;0;0;14
7594;"Pumpurėlis (Kalvarijų g. 186)";ŽIRNIUKŲ;9033360796;Taip;14;0;0;14
7595;"Pumpurėlis (Kalvarijų g. 186)";ŽIRNIUKŲ;1550949005;Taip;0;0;1;1
7596;"Pumpurėlis (Kalvarijų g. 186)";ŽIRNIUKŲ;3438212768;Taip;10;0;0;10
7597;"Pumpurėlis (Kalvarijų g. 186)";ŽIRNIUKŲ;4686840292;Taip;5;0;2;7
7598;"Pumpurėlis (Kalvarijų g. 186)";ŽIRNIUKŲ;4195060928;Taip;8;0;0;8
7599;"Pumpurėlis (Kalvarijų g. 186)";ŽIRNIUKŲ;3966128737;Taip;7;0;1;8
7600;"Pumpurėlis (Kalvarijų g. 186)";ŽIRNIUKŲ;4446088965;Taip;10;0;2;12
7601;"Pumpurėlis (Kalvarijų g. 186)";ŽIRNIUKŲ;7994376089;Taip;7;1;0;8
7602;"Pumpurėlis (Kalvarijų g. 186)";ŽIRNIUKŲ;5765942106;Taip;14;0;0;14
7603;"Pumpurėlis (Kalvarijų g. 186)";ŽIRNIUKŲ;8978637291;Taip;1;0;0;1
7604;"Pumpurėlis (Kalvarijų g. 186)";BORUŽĖLIŲ;2269864490;Taip;16;0;0;16
7605;"Pumpurėlis (Kalvarijų g. 186)";BORUŽĖLIŲ;6223338814;Taip;12;0;0;12
7606;"Pumpurėlis (Kalvarijų g. 186)";BORUŽĖLIŲ;5659508302;Taip;2;0;0;2
7607;"Pumpurėlis (Kalvarijų g. 186)";BORUŽĖLIŲ;5998858670;Ne;5;0;3;8
7608;"Pumpurėlis (Kalvarijų g. 186)";BORUŽĖLIŲ;7398363498;Taip;5;0;0;5
7609;"Pumpurėlis (Kalvarijų g. 186)";BORUŽĖLIŲ;5835545051;Taip;0;10;0;10
7610;"Pumpurėlis (Kalvarijų g. 186)";BORUŽĖLIŲ;4188020534;Taip;5;0;1;6
7611;"Pumpurėlis (Kalvarijų g. 186)";BORUŽĖLIŲ;6256781298;Taip;0;5;0;5
7612;"Pumpurėlis (Kalvarijų g. 186)";BORUŽĖLIŲ;7045349032;Taip;6;9;1;16
7613;"Pumpurėlis (Kalvarijų g. 186)";BORUŽĖLIŲ;1017838338;Taip;14;0;0;14
7614;"Pumpurėlis (Kalvarijų g. 186)";BORUŽĖLIŲ;1648249689;Taip;0;1;1;2
7615;"Pumpurėlis (Kalvarijų g. 186)";BORUŽĖLIŲ;7535098093;Taip;1;0;2;3
7616;"Pumpurėlis (Kalvarijų g. 186)";BORUŽĖLIŲ;7843280418;Taip;8;0;0;8
7617;"Pumpurėlis (Kalvarijų g. 186)";BORUŽĖLIŲ;3531862496;Taip;7;1;0;8
7618;"Pumpurėlis (Kalvarijų g. 186)";BORUŽĖLIŲ;1441993078;Ne;16;0;0;16
7619;"Pumpurėlis (Kalvarijų g. 186)";BORUŽĖLIŲ;2768082342;Taip;7;5;0;12
7620;"Pumpurėlis (Kalvarijų g. 186)";BORUŽĖLIŲ;3407251558;Taip;14;0;0;14
7621;"Pumpurėlis (Kalvarijų g. 186)";BORUŽĖLIŲ;4355867863;Ne;4;0;0;4
7622;"Pumpurėlis (Kalvarijų g. 186)";SMALSUČIŲ;6212212516;Taip;11;1;0;12
7623;"Pumpurėlis (Kalvarijų g. 186)";SMALSUČIŲ;6604801631;Taip;13;0;2;15
7624;"Pumpurėlis (Kalvarijų g. 186)";SMALSUČIŲ;9363610488;Taip;2;4;0;6
7625;"Pumpurėlis (Kalvarijų g. 186)";SMALSUČIŲ;8380689261;Taip;5;0;0;5
7626;"Pumpurėlis (Kalvarijų g. 186)";SMALSUČIŲ;6483338028;Taip;5;0;0;5
7627;"Pumpurėlis (Kalvarijų g. 186)";SMALSUČIŲ;3492977569;Taip;10;0;0;10
7628;"Pumpurėlis (Kalvarijų g. 186)";SMALSUČIŲ;6959214331;Taip;2;4;0;6
7629;"Pumpurėlis (Kalvarijų g. 186)";SMALSUČIŲ;3085309902;Taip;9;0;0;9
7630;"Pumpurėlis (Kalvarijų g. 186)";SMALSUČIŲ;4964949574;Taip;5;0;0;5
7631;"Pumpurėlis (Kalvarijų g. 186)";SMALSUČIŲ;2905797053;Taip;3;0;0;3
7632;"Pumpurėlis (Kalvarijų g. 186)";SMALSUČIŲ;2026021360;Taip;5;0;0;5
7633;"Pumpurėlis (Kalvarijų g. 186)";SMALSUČIŲ;3871151401;Taip;4;0;0;4
7634;"Pumpurėlis (Kalvarijų g. 186)";SMALSUČIŲ;6557857672;Taip;11;0;0;11
7635;"Pumpurėlis (Kalvarijų g. 186)";SMALSUČIŲ;5212827184;Taip;17;0;0;17
7636;"Pumpurėlis (Kalvarijų g. 186)";SMALSUČIŲ;7813696919;Taip;5;0;0;5
7637;"Pumpurėlis (Kalvarijų g. 186)";SMALSUČIŲ;5278250113;Taip;6;0;0;6
7638;"Pumpurėlis (Kalvarijų g. 186)";SMALSUČIŲ;5236515914;Taip;2;0;0;2
7639;"Pumpurėlis (Kalvarijų g. 186)";SMALSUČIŲ;5456922203;Taip;4;4;0;8
7640;"Pumpurėlis (Kalvarijų g. 186)";SMALSUČIŲ;8886730333;Taip;5;4;0;9
7641;Puriena;Ančiukų;6158842119;Taip;0;4;0;4
7642;Puriena;Ančiukų;3557013127;Taip;0;3;0;3
7643;Puriena;Ančiukų;4100466337;Taip;0;23;0;23
7644;Puriena;Ančiukų;9251058353;Taip;3;1;0;4
7645;Puriena;Ančiukų;4060087185;Taip;0;2;0;2
7646;Puriena;Ančiukų;6280465748;Taip;0;2;0;2
7647;Puriena;Ančiukų;3033562627;Taip;7;3;0;10
7648;Puriena;Ančiukų;5777076971;Taip;7;2;0;9
7649;Puriena;Ančiukų;8310231540;Taip;11;4;0;15
7650;Puriena;Ančiukų;4460575818;Taip;0;4;0;4
7651;Puriena;Ančiukų;7967288875;Taip;4;0;3;7
7652;Puriena;Ančiukų;1907429094;Taip;4;4;0;8
7653;Puriena;Ančiukų;4605662701;Taip;0;1;0;1
7654;Puriena;Ančiukų;1819876614;Taip;4;0;3;7
7655;Puriena;Ančiukų;4776745276;Taip;0;1;2;3
7656;Puriena;Ančiukų;7769252165;Taip;0;6;0;6
7657;Puriena;Ančiukų;2170025682;Taip;4;0;0;4
7658;Puriena;Ančiukų;3772941726;Taip;0;1;0;1
7659;Puriena;Ančiukų;1428098802;Taip;0;1;0;1
7660;Puriena;Ančiukų;6416145396;Taip;7;0;0;7
7661;Puriena;Drugeliai;4016228982;Taip;4;5;0;9
7662;Puriena;Drugeliai;9671916745;Taip;4;0;0;4
7663;Puriena;Drugeliai;5797970231;Taip;1;1;0;2
7664;Puriena;Drugeliai;3382737176;Taip;4;0;0;4
7665;Puriena;Drugeliai;4587892949;Taip;9;0;0;9
7666;Puriena;Drugeliai;8284860687;Taip;0;1;0;1
7667;Puriena;Drugeliai;6941251095;Taip;0;23;0;23
7668;Puriena;Drugeliai;3252190329;Taip;0;4;0;4
7669;Puriena;Drugeliai;5927216569;Taip;0;4;0;4
7670;Puriena;Drugeliai;8474426340;Taip;0;9;0;9
7671;Puriena;Drugeliai;6308393533;Taip;9;1;3;13
7672;Puriena;Drugeliai;9907972536;Taip;1;0;0;1
7673;Puriena;Drugeliai;8239919265;Taip;4;0;1;5
7674;Puriena;Drugeliai;9176303276;Ne;0;13;0;13
7675;Puriena;Drugeliai;3604094165;Ne;0;0;10;10
7676;Puriena;Drugeliai;8110665629;Taip;0;5;0;5
7677;Puriena;Pelėdžiukai;2013783668;Taip;0;1;0;1
7678;Puriena;Pelėdžiukai;8874823029;Taip;0;5;0;5
7679;Puriena;Pelėdžiukai;3149718901;Taip;12;1;0;13
7680;Puriena;Pelėdžiukai;3175917649;Ne;0;4;1;5
7681;Puriena;Pelėdžiukai;2579402981;Taip;0;1;3;4
7682;Puriena;Pelėdžiukai;3671297035;Taip;5;0;2;7
7683;Puriena;Pelėdžiukai;2701942325;Taip;0;6;0;6
7684;Puriena;Pelėdžiukai;4858971990;Taip;2;4;0;6
7685;Puriena;Pelėdžiukai;1417566073;Taip;4;0;0;4
7686;Puriena;Pelėdžiukai;6463129806;Taip;1;0;2;3
7687;Puriena;Pelėdžiukai;4501239330;Taip;6;4;0;10
7688;Puriena;Pelėdžiukai;5341228269;Taip;6;3;0;9
7689;Puriena;Pelėdžiukai;5080805225;Taip;7;1;0;8
7690;Puriena;Pelėdžiukai;1158768017;Taip;0;4;5;9
7691;Puriena;Pelėdžiukai;1658720269;Taip;0;2;4;6
7692;Puriena;Voveriukai;8772936125;Taip;14;0;1;15
7693;Puriena;Voveriukai;6428413592;Ne;14;0;1;15
7694;Puriena;Voveriukai;8242140541;Taip;20;0;0;20
7695;Puriena;Voveriukai;7066959314;Taip;4;5;0;9
7696;Puriena;Voveriukai;1455237224;Taip;3;1;0;4
7697;Puriena;Voveriukai;3094722037;Taip;0;0;2;2
7698;Puriena;Voveriukai;6227990580;Taip;9;0;0;9
7699;Puriena;Voveriukai;8412041946;Taip;7;0;2;9
7700;Puriena;Voveriukai;3287725982;Ne;21;0;0;21
7701;Puriena;Voveriukai;6496077328;Taip;6;0;1;7
7702;Puriena;Voveriukai;8845361962;Ne;0;23;0;23
7703;Puriena;Voveriukai;9965834233;Taip;2;4;0;6
7704;Puriena;Voveriukai;5841409384;Taip;7;0;2;9
7705;Puriena;Voveriukai;9934831745;Taip;4;0;0;4
7706;Puriena;Voveriukai;8310464710;Taip;0;18;5;23
7707;Puriena;Voveriukai;1614993691;Taip;0;4;0;4
7708;Puriena;Voveriukai;2172109284;Taip;3;1;0;4
7709;Puriena;Bitučių;1621772702;Taip;0;3;0;3
7710;Puriena;Bitučių;9413672989;Taip;3;0;0;3
7711;Puriena;Bitučių;1175665781;Taip;5;6;1;12
7712;Puriena;Bitučių;6853706997;Taip;5;1;0;6
7713;Puriena;Bitučių;1339162214;Taip;0;6;0;6
7714;Puriena;Bitučių;9543884311;Taip;0;8;0;8
7715;Puriena;Bitučių;6656013805;Taip;0;4;0;4
7716;Puriena;Bitučių;8022809059;Taip;0;0;2;2
7717;Puriena;Bitučių;5395382717;Taip;1;0;0;1
7718;Puriena;Bitučių;8237149969;Taip;4;8;0;12
7719;Puriena;Bitučių;7481642656;Taip;0;23;0;23
7720;Puriena;Bitučių;8512814466;Taip;0;8;0;8
7721;Puriena;Bitučių;7622407056;Taip;0;0;4;4
7722;Puriena;Bitučių;4017644414;Taip;0;0;4;4
7723;Puriena;Bitučių;8416003733;Taip;0;2;4;6
7724;Puriena;Bitučių;8199607793;Taip;0;0;7;7
7725;Puriena;Bitučių;9854244405;Taip;0;4;0;4
7726;Puriena;Bitučių;6780164845;Taip;4;0;0;4
7727;Puriena;Bitučių;6413337915;Taip;0;5;2;7
7728;Puriena;Zylutės;1521955898;Taip;3;1;0;4
7729;Puriena;Zylutės;8881337164;Taip;4;0;0;4
7730;Puriena;Zylutės;6914613438;Taip;0;3;0;3
7731;Puriena;Zylutės;1121312813;Taip;0;2;0;2
7732;Puriena;Zylutės;2321753665;Taip;10;3;0;13
7733;Puriena;Zylutės;7021756459;Taip;8;0;0;8
7734;Puriena;Zylutės;1564155036;Taip;7;2;0;9
7735;Puriena;Zylutės;9098291788;Taip;4;3;0;7
7736;Puriena;Zylutės;6613654824;Taip;10;0;0;10
7737;Puriena;Zylutės;3738277048;Ne;7;0;0;7
7738;Puriena;Zylutės;7562458336;Taip;0;1;1;2
7739;Puriena;Zylutės;3579008577;Taip;9;7;0;16
7740;Puriena;Zylutės;7477278612;Taip;0;2;0;2
7741;Puriena;Zylutės;9150157724;Ne;5;0;0;5
7742;Puriena;Meškučių;6234132927;Taip;14;5;0;19
7743;Puriena;Meškučių;4563681164;Taip;3;1;0;4
7744;Puriena;Meškučių;3153330970;Taip;7;0;0;7
7745;Puriena;Meškučių;9500729561;Taip;0;5;0;5
7746;Puriena;Meškučių;1238475246;Taip;3;1;0;4
7747;Puriena;Meškučių;9748726934;Taip;10;0;0;10
7748;Puriena;Meškučių;7466163131;Taip;3;0;0;3
7749;Puriena;Meškučių;2466609635;Taip;4;1;0;5
7750;Puriena;Meškučių;3309219271;Taip;0;5;0;5
7751;Puriena;Meškučių;9509041179;Taip;0;2;0;2
7752;Puriena;Meškučių;5176663365;Taip;4;2;2;8
7753;Puriena;Meškučių;9961074983;Taip;0;2;1;3
7754;Puriena;Meškučių;3011629747;Taip;16;1;0;17
7755;Puriena;Meškučių;2029981617;Taip;19;0;0;19
7756;Puriena;Meškučių;6185080390;Taip;0;2;0;2
7757;Puriena;Meškučių;3526684967;Taip;3;5;0;8
7758;Puriena;Meškučių;1513909923;Taip;7;0;5;12
7759;Puriena;Meškučių;7556975480;Taip;0;0;9;9
7760;Puriena;Meškučių;2711642252;Taip;4;1;0;5
7761;Puriena;Meškučių;8093664167;Taip;4;1;0;5
7762;Puriena;Nykštukų;1053386081;Taip;3;14;0;17
7763;Puriena;Nykštukų;5469827031;Taip;0;3;0;3
7764;Puriena;Nykštukų;7649596096;Taip;19;0;0;19
7765;Puriena;Nykštukų;2762325241;Taip;0;1;4;5
7766;Puriena;Nykštukų;9907142348;Taip;14;0;0;14
7767;Puriena;Nykštukų;9369786639;Taip;8;0;3;11
7768;Puriena;Nykštukų;4728991133;Taip;0;2;0;2
7769;Puriena;Nykštukų;2344061847;Taip;0;1;0;1
7770;Puriena;Nykštukų;3630564604;Ne;19;0;0;19
7771;Puriena;Nykštukų;9438604106;Taip;0;0;2;2
7772;Puriena;Nykštukų;9379314578;Taip;11;0;0;11
7773;Puriena;Nykštukų;4211784186;Taip;13;0;0;13
7774;Puriena;Nykštukų;2146727759;Taip;0;1;0;1
7775;Puriena;Nykštukų;6605817147;Taip;5;0;0;5
7776;Puriena;Nykštukų;6271951373;Taip;9;1;0;10
7777;Puriena;Nykštukų;7869104640;Taip;4;4;0;8
7778;Puriena;Nykštukų;9931397038;Taip;15;0;0;15
7779;Puriena;Nykštukų;9497287421;Taip;5;7;0;12
7780;Puriena;Nykštukų;4006267650;Taip;0;10;0;10
7781;Puriena;Nykštukų;5277351784;Taip;9;0;0;9
7782;Puriena;Nykštukų;3215364967;Taip;0;2;3;5
7783;Puriena;Ežiukai;6451492815;Taip;0;2;0;2
7784;Puriena;Ežiukai;6612468095;Taip;0;2;3;5
7785;Puriena;Ežiukai;7913847170;Taip;3;3;0;6
7786;Puriena;Ežiukai;8089081251;Taip;4;9;0;13
7787;Puriena;Ežiukai;2830409862;Taip;4;6;0;10
7788;Puriena;Ežiukai;5550321808;Taip;0;3;0;3
7789;Puriena;Ežiukai;8038573068;Taip;0;1;3;4
7790;Puriena;Ežiukai;2624283930;Taip;3;3;0;6
7791;Puriena;Ežiukai;6001659356;Taip;6;4;1;11
7792;Puriena;Ežiukai;5539708916;Taip;0;7;0;7
7793;Puriena;Ežiukai;7335537384;Taip;0;0;1;1
7794;Puriena;Ežiukai;3204824116;Taip;5;1;0;6
7795;Puriena;Ežiukai;7720549981;Taip;10;0;0;10
7796;Puriena;Ežiukai;5555076926;Taip;0;4;0;4
7797;Puriena;Ežiukai;2312297583;Taip;0;0;3;3
7798;Puriena;Ežiukai;3232981406;Taip;4;5;1;10
7799;Puriena;Ežiukai;9228372078;Taip;23;0;0;23
7800;Puriena;Ežiukai;5374864513;Taip;12;0;1;13
7801;Puriena;Ežiukai;1737249860;Taip;1;0;0;1
7802;Puriena;Ežiukai;4608801156;Taip;0;3;0;3
7803;Puriena;"Boružiukų ";9600515308;Taip;0;1;3;4
7804;Puriena;"Boružiukų ";7985332838;Taip;23;0;0;23
7805;Puriena;"Boružiukų ";2818282875;Taip;0;4;0;4
7806;Puriena;"Boružiukų ";1796123753;Taip;0;0;1;1
7807;Puriena;"Boružiukų ";9489913940;Taip;6;0;0;6
7808;Puriena;"Boružiukų ";7350776605;Taip;4;0;1;5
7809;Puriena;"Boružiukų ";3521550682;Taip;9;0;0;9
7810;Puriena;"Boružiukų ";7554505121;Taip;4;1;1;6
7811;Puriena;"Boružiukų ";9728603155;Taip;0;4;0;4
7812;Puriena;"Boružiukų ";9715082990;Taip;11;1;2;14
7813;Puriena;"Boružiukų ";1453976004;Taip;4;3;1;8
7814;Puriena;"Boružiukų ";9402161115;Taip;2;0;0;2
7815;Puriena;"Boružiukų ";6966564224;Taip;4;0;0;4
7816;Puriena;"Boružiukų ";3888242345;Taip;4;0;0;4
7817;Puriena;"Boružiukų ";9085439508;Taip;18;0;0;18
7818;Puriena;"Zuikučių ";6549867740;Taip;6;0;0;6
7819;Puriena;"Zuikučių ";9102891844;Ne;11;0;0;11
7820;Puriena;"Zuikučių ";4946887007;Taip;0;23;0;23
7821;Puriena;"Zuikučių ";4139839679;Taip;3;0;0;3
7822;Puriena;"Zuikučių ";9553026735;Taip;23;0;0;23
7823;Puriena;"Zuikučių ";5257520238;Taip;6;3;0;9
7824;Puriena;"Zuikučių ";4549244705;Taip;0;7;0;7
7825;Puriena;"Zuikučių ";4102059769;Taip;16;0;0;16
7826;Puriena;"Zuikučių ";4257334383;Taip;7;1;0;8
7827;Puriena;"Zuikučių ";2736255661;Taip;1;1;0;2
7828;Puriena;"Zuikučių ";4363865643;Taip;5;1;0;6
7829;Puriena;"Zuikučių ";6084041374;Taip;17;0;0;17
7830;Puriena;"Zuikučių ";3510157302;Taip;0;23;0;23
7831;Puriena;Skruzdėliukai;9729644429;Ne;4;1;2;7
7832;Puriena;Skruzdėliukai;3826282438;Taip;0;5;0;5
7833;Puriena;Skruzdėliukai;4283608124;Taip;2;4;0;6
7834;Puriena;Skruzdėliukai;8144488922;Taip;4;11;0;15
7835;Puriena;Skruzdėliukai;8476986855;Taip;0;10;1;11
7836;Puriena;Skruzdėliukai;8130975863;Taip;0;4;0;4
7837;Puriena;Skruzdėliukai;6140294839;Taip;14;0;0;14
7838;Puriena;Skruzdėliukai;2813562677;Taip;0;1;0;1
7839;Puriena;Skruzdėliukai;9453994213;Taip;5;0;0;5
7840;Puriena;Skruzdėliukai;7120683581;Taip;0;4;0;4
7841;Puriena;Skruzdėliukai;4653085762;Taip;5;7;0;12
7842;Puriena;Skruzdėliukai;3542374463;Taip;0;4;0;4
7843;Puriena;Skruzdėliukai;8497070167;Taip;8;1;0;9
7844;Puriena;Skruzdėliukai;4498919764;Taip;3;0;0;3
7845;Puriena;Skruzdėliukai;1933733714;Taip;0;1;0;1
7846;Puriena;Skruzdėliukai;4517020977;Taip;1;4;0;5
7847;Puriena;Skruzdėliukai;6150437624;Ne;0;4;0;4
7848;Puriena;Skruzdėliukai;3455291312;Taip;11;0;1;12
7849;Puriena;Skruzdėliukai;9911792407;Taip;3;5;0;8
7850;Puriena;Skruzdėliukai;6352605894;Ne;2;0;0;2
7851;Pušaitė;Kodėlčiukai;8702361596;Taip;0;2;0;2
7852;Pušaitė;Kodėlčiukai;3832434608;Taip;0;0;3;3
7853;Pušaitė;Kodėlčiukai;7068451014;Taip;0;4;0;4
7854;Pušaitė;Kodėlčiukai;8750774616;Taip;0;6;0;6
7855;Pušaitė;Kodėlčiukai;9391350218;Taip;0;3;0;3
7856;Pušaitė;Kodėlčiukai;2793941689;Taip;0;10;0;10
7857;Pušaitė;Kodėlčiukai;9364887123;Taip;0;4;0;4
7858;Pušaitė;Kodėlčiukai;4326967247;Taip;4;1;0;5
7859;Pušaitė;Kodėlčiukai;4473930703;Taip;0;4;0;4
7860;Pušaitė;Kodėlčiukai;6775428321;Taip;0;2;2;4
7861;Pušaitė;Kodėlčiukai;4615270419;Taip;0;2;0;2
7862;Pušaitė;Kodėlčiukai;7117784038;Taip;0;1;0;1
7863;Pušaitė;Kodėlčiukai;6186545163;Taip;0;8;0;8
7864;Pušaitė;Kodėlčiukai;6189116357;Taip;1;0;17;18
7865;Pušaitė;Saulutės;2254269292;Taip;0;0;10;10
7866;Pušaitė;Saulutės;5306237557;Taip;16;0;1;17
7867;Pušaitė;Saulutės;7480846917;Taip;0;0;2;2
7868;Pušaitė;Saulutės;8355083823;Taip;2;0;0;2
7869;Pušaitė;Saulutės;8914668904;Taip;2;5;2;9
7870;Pušaitė;Saulutės;2396217546;Taip;4;2;1;7
7871;Pušaitė;Saulutės;3126709123;Taip;3;0;1;4
7872;Pušaitė;Saulutės;5469990058;Taip;8;0;4;12
7873;Pušaitė;Saulutės;1044902638;Taip;7;0;0;7
7874;Pušaitė;Saulutės;6784729764;Taip;0;23;0;23
7875;Pušaitė;Saulutės;6215522656;Taip;10;0;0;10
7876;Pušaitė;Saulutės;2675136958;Taip;13;0;1;14
7877;Pušaitė;Saulutės;6261355186;Taip;2;4;8;14
7878;Pušaitė;Saulutės;7888103890;Taip;11;0;4;15
7879;Pušaitė;Saulutės;6848340140;Taip;2;2;0;4
7880;Pušaitė;Zuikučiai;7291412329;Taip;11;0;0;11
7881;Pušaitė;Zuikučiai;8931688329;Taip;0;0;2;2
7882;Pušaitė;Zuikučiai;5981944481;Taip;13;0;0;13
7883;Pušaitė;Zuikučiai;5422616450;Taip;0;1;0;1
7884;Pušaitė;Zuikučiai;5819186055;Taip;0;0;1;1
7885;Pušaitė;Zuikučiai;4234318548;Taip;0;4;0;4
7886;Pušaitė;Zuikučiai;1384820994;Taip;0;1;0;1
7887;Pušaitė;Zuikučiai;9180309936;Taip;7;0;0;7
7888;Pušaitė;Zuikučiai;4754791489;Taip;4;0;0;4
7889;Pušaitė;Zuikučiai;4082173648;Taip;0;3;0;3
7890;Pušaitė;Zuikučiai;2264047794;Taip;0;1;0;1
7891;Pušaitė;Zuikučiai;3052743933;Taip;0;23;0;23
7892;Pušaitė;Zuikučiai;4278699624;Taip;6;4;0;10
7893;Pušaitė;Zuikučiai;8244793037;Taip;6;1;4;11
7894;Pušaitė;Zuikučiai;5002710062;Taip;5;12;1;18
7895;Pušaitė;Zuikučiai;3508664946;Taip;0;2;0;2
7896;Pušaitė;Zuikučiai;7583243031;Taip;3;0;0;3
7897;Pušaitė;Zuikučiai;1180343204;Taip;10;6;0;16
7898;Pušaitė;Vėžliukai;8412276797;Taip;0;3;0;3
7899;Pušaitė;Vėžliukai;1326581025;Taip;0;10;0;10
7900;Pušaitė;Vėžliukai;3485234259;Taip;5;1;0;6
7901;Pušaitė;Vėžliukai;3014867515;Taip;0;1;0;1
7902;Pušaitė;Vėžliukai;9470667227;Taip;3;0;0;3
7903;Pušaitė;Vėžliukai;7890577174;Taip;4;1;0;5
7904;Pušaitė;Vėžliukai;7652706756;Taip;0;4;0;4
7905;Pušaitė;Vėžliukai;5318602924;Taip;0;23;0;23
7906;Pušaitė;Vėžliukai;6794867560;Taip;2;0;0;2
7907;Pušaitė;Vėžliukai;5512786073;Taip;9;5;0;14
7908;Pušaitė;Vėžliukai;8399589954;Taip;0;4;0;4
7909;Pušaitė;Vėžliukai;4281125486;Taip;0;0;2;2
7910;Pušaitė;Vėžliukai;2777222076;Taip;0;1;0;1
7911;Pušaitė;"Linksmieji nykštukai";9265357004;Taip;1;8;0;9
7912;Pušaitė;"Linksmieji nykštukai";4517181474;Taip;0;2;0;2
7913;Pušaitė;"Linksmieji nykštukai";9033615485;Taip;2;1;0;3
7914;Pušaitė;"Linksmieji nykštukai";3130824742;Taip;0;4;0;4
7915;Pušaitė;"Linksmieji nykštukai";1024996364;Taip;0;3;0;3
7916;Pušaitė;"Linksmieji nykštukai";4662871524;Taip;3;9;0;12
7917;Pušaitė;"Linksmieji nykštukai";8438652029;Taip;6;0;0;6
7918;Pušaitė;"Linksmieji nykštukai";6578483902;Taip;6;0;0;6
7919;Pušaitė;"Linksmieji nykštukai";9327636862;Taip;2;1;0;3
7920;Pušaitė;"Linksmieji nykštukai";4175909754;Taip;0;3;0;3
7921;Pušaitė;"Linksmieji nykštukai";3788392895;Taip;1;0;0;1
7922;Pušaitė;"Linksmieji nykštukai";3195191374;Taip;0;1;0;1
7923;Pušaitė;"Linksmieji nykštukai";9127444013;Taip;0;4;0;4
7924;Pušaitė;"Linksmieji nykštukai";5422784898;Taip;0;4;0;4
7925;Pušaitė;"Linksmieji nykštukai";5104111840;Taip;4;0;0;4
7926;Pušaitė;"Linksmieji nykštukai";9866431097;Taip;2;5;0;7
7927;Pušaitė;"Linksmieji nykštukai";4564478833;Taip;0;1;0;1
7928;Pušaitė;"Linksmieji nykštukai";4374232593;Taip;3;4;0;7
7929;Pušaitė;"Linksmieji nykštukai";8378313810;Taip;10;4;0;14
7930;Pušaitė;"Kačiukų trobelė";3695016765;Taip;0;5;1;6
7931;Pušaitė;"Kačiukų trobelė";5415680731;Taip;0;2;0;2
7932;Pušaitė;"Kačiukų trobelė";7983115812;Taip;3;3;0;6
7933;Pušaitė;"Kačiukų trobelė";1122112207;Taip;0;5;0;5
7934;Pušaitė;"Kačiukų trobelė";1635528919;Taip;0;0;2;2
7935;Pušaitė;"Kačiukų trobelė";7014914682;Taip;9;2;0;11
7936;Pušaitė;"Kačiukų trobelė";1624587173;Taip;0;2;0;2
7937;Pušaitė;"Kačiukų trobelė";8793102437;Taip;7;5;0;12
7938;Pušaitė;"Kačiukų trobelė";9056933586;Taip;2;3;0;5
7939;Pušaitė;"Kačiukų trobelė";7898355721;Taip;5;0;0;5
7940;Pušaitė;"Kačiukų trobelė";6323180798;Taip;5;0;0;5
7941;Pušaitė;"Kačiukų trobelė";1161519408;Taip;0;4;0;4
7942;Pušaitė;"Kačiukų trobelė";8822285103;Taip;4;4;0;8
7943;Pušaitė;"Kačiukų trobelė";9313564235;Taip;15;0;0;15
7944;Pušaitė;"Kačiukų trobelė";2430891944;Taip;3;0;0;3
7945;Pušaitė;"Kačiukų trobelė";1978339054;Taip;4;0;0;4
7946;Pušaitė;"Kačiukų trobelė";5461822909;Taip;5;0;0;5
7947;Pušaitė;Ežiukai;5013833636;Taip;0;2;0;2
7948;Pušaitė;Ežiukai;7891007708;Taip;0;1;0;1
7949;Pušaitė;Ežiukai;3732377309;Taip;1;0;0;1
7950;Pušaitė;Ežiukai;6511940816;Taip;0;0;1;1
7951;Pušaitė;Ežiukai;9546541248;Taip;0;0;5;5
7952;Pušaitė;Ežiukai;4769806128;Taip;10;0;0;10
7953;Pušaitė;Ežiukai;4529006786;Taip;4;0;0;4
7954;Pušaitė;Ežiukai;5270528758;Taip;13;0;0;13
7955;Pušaitė;Ežiukai;6767281906;Taip;4;0;0;4
7956;Pušaitė;Ežiukai;7210529114;Taip;0;4;0;4
7957;Pušaitė;Ežiukai;9164927041;Taip;0;23;0;23
7958;Pušaitė;Ežiukai;9867041220;Taip;6;0;0;6
7959;Pušaitė;Ežiukai;6059415475;Taip;0;4;12;16
7960;Pušaitė;Ežiukai;6851908671;Taip;0;0;1;1
7961;Pušaitė;Ežiukai;7737524017;Taip;2;1;0;3
7962;Pušaitė;Ežiukai;1069369636;Taip;0;1;0;1
7963;Pušaitė;Ežiukai;2454348536;Taip;7;0;0;7
7964;Pušaitė;Ežiukai;4883211957;Taip;0;0;1;1
7965;Pušaitė;"Gudručių šalis";8763667682;Taip;0;4;0;4
7966;Pušaitė;"Gudručių šalis";5488507646;Taip;0;23;0;23
7967;Pušaitė;"Gudručių šalis";1305526154;Taip;3;0;1;4
7968;Pušaitė;"Gudručių šalis";6205900423;Ne;0;23;0;23
7969;Pušaitė;"Gudručių šalis";2078734161;Taip;1;0;3;4
7970;Pušaitė;"Gudručių šalis";8790959900;Taip;0;2;0;2
7971;Pušaitė;"Gudručių šalis";2397106198;Taip;2;2;0;4
7972;Pušaitė;"Gudručių šalis";8343949011;Taip;7;0;2;9
7973;Pušaitė;"Gudručių šalis";4101285889;Taip;0;0;5;5
7974;Pušaitė;"Gudručių šalis";3959838346;Taip;0;1;0;1
7975;Pušaitė;"Gudručių šalis";5563772495;Taip;2;5;2;9
7976;Pušaitė;"Gudručių šalis";6356263503;Taip;4;5;5;14
7977;Pušaitė;"Gudručių šalis";2333176054;Taip;0;1;0;1
7978;Pušaitė;"Gudručių šalis";4918124423;Taip;2;0;8;10
7979;Pušaitė;"Gudručių šalis";6734504906;Taip;5;0;0;5
7980;Pušaitė;"Gudručių šalis";7992567219;Taip;0;1;1;2
7981;Pušaitė;"Gudručių šalis";1807432967;Taip;5;0;0;5
7982;Pušaitė;"Gudručių šalis";3380836598;Taip;8;0;0;8
7983;Pušaitė;"Lapučių mokyklėlė";9337726482;Taip;0;10;0;10
7984;Pušaitė;"Lapučių mokyklėlė";2666541612;Taip;0;1;0;1
7985;Pušaitė;"Lapučių mokyklėlė";8343225451;Taip;0;2;0;2
7986;Pušaitė;"Lapučių mokyklėlė";8218991320;Taip;0;3;0;3
7987;Pušaitė;"Lapučių mokyklėlė";1994898058;Taip;5;1;9;15
7988;Pušaitė;"Lapučių mokyklėlė";8551426938;Taip;4;3;0;7
7989;Pušaitė;"Lapučių mokyklėlė";4444972517;Taip;0;1;0;1
7990;Pušaitė;"Lapučių mokyklėlė";4857214952;Taip;0;1;0;1
7991;Pušaitė;"Lapučių mokyklėlė";4138386134;Taip;5;2;0;7
7992;Pušaitė;"Lapučių mokyklėlė";4103149433;Taip;0;2;0;2
7993;Pušaitė;"Lapučių mokyklėlė";4747611989;Taip;0;2;0;2
7994;Pušaitė;"Lapučių mokyklėlė";3387165403;Taip;0;1;0;1
7995;Pušaitė;"Lapučių mokyklėlė";5339878948;Ne;8;3;0;11
7996;Pušaitė;"Lapučių mokyklėlė";3610256789;Taip;0;4;6;10
7997;Pušaitė;"Lapučių mokyklėlė";6576647982;Taip;5;1;0;6
7998;Pušaitė;"Lapučių mokyklėlė";5328083339;Taip;2;0;0;2
7999;Pušaitė;"Lapučių mokyklėlė";3200968850;Taip;0;9;0;9
8000;Pušaitė;"Lapučių mokyklėlė";5270684456;Taip;4;4;0;8
8001;Pušaitė;"VOVERIUKAI ";1665030028;Taip;0;23;0;23
8002;Pušaitė;"VOVERIUKAI ";8876092901;Taip;0;2;1;3
8003;Pušaitė;"VOVERIUKAI ";4767321724;Taip;0;0;2;2
8004;Pušaitė;"VOVERIUKAI ";7971556404;Taip;5;0;1;6
8005;Pušaitė;"VOVERIUKAI ";6643741885;Taip;4;0;3;7
8006;Pušaitė;"VOVERIUKAI ";1439721280;Taip;16;0;1;17
8007;Pušaitė;"VOVERIUKAI ";8157849971;Taip;4;0;0;4
8008;Pušaitė;"VOVERIUKAI ";6891217457;Taip;8;1;0;9
8009;Pušaitė;"VOVERIUKAI ";6786313527;Taip;12;0;0;12
8010;Pušaitė;"VOVERIUKAI ";8739461926;Taip;19;0;0;19
8011;Pušaitė;"VOVERIUKAI ";8967363762;Taip;22;0;0;22
8012;Pušaitė;"VOVERIUKAI ";2699657569;Taip;3;0;0;3
8013;Pušaitė;"VOVERIUKAI ";5191447724;Taip;5;0;1;6
8014;Pušaitė;MEŠKUČIAI;6754402783;Taip;3;0;0;3
8015;Pušaitė;MEŠKUČIAI;3239486674;Taip;8;0;1;9
8016;Pušaitė;MEŠKUČIAI;9339706754;Taip;5;0;0;5
8017;Pušaitė;MEŠKUČIAI;9418440677;Taip;1;2;0;3
8018;Pušaitė;MEŠKUČIAI;7426036114;Taip;7;0;0;7
8019;Pušaitė;MEŠKUČIAI;9887693476;Taip;4;8;0;12
8020;Pušaitė;MEŠKUČIAI;1034005054;Taip;11;0;2;13
8021;Pušaitė;MEŠKUČIAI;8720258818;Taip;0;4;0;4
8022;Pušaitė;MEŠKUČIAI;8916214448;Taip;2;0;0;2
8023;Pušaitė;MEŠKUČIAI;3238080908;Taip;14;4;0;18
8024;Pušaitė;MEŠKUČIAI;4331500545;Taip;2;0;0;2
8025;Pušaitė;MEŠKUČIAI;7278950473;Taip;0;0;1;1
8026;Pušaitė;MEŠKUČIAI;3994799424;Taip;4;5;0;9
8027;Pušaitė;MEŠKUČIAI;5686927118;Taip;0;23;0;23
8028;Pušaitė;PELIUKAI;9177861202;Taip;14;2;0;16
8029;Pušaitė;PELIUKAI;6645711171;Taip;2;3;0;5
8030;Pušaitė;PELIUKAI;2618038364;Taip;0;2;0;2
8031;Pušaitė;PELIUKAI;5112517007;Taip;0;2;0;2
8032;Pušaitė;PELIUKAI;9261546370;Taip;0;5;0;5
8033;Pušaitė;PELIUKAI;7285450755;Taip;14;0;0;14
8034;Pušaitė;PELIUKAI;7204853123;Taip;3;6;0;9
8035;Pušaitė;PELIUKAI;4802860079;Taip;10;0;0;10
8036;Pušaitė;PELIUKAI;2772351972;Taip;5;0;0;5
8037;Pušaitė;PELIUKAI;5305731047;Taip;0;2;0;2
8038;Pušaitė;PELIUKAI;1450204608;Taip;0;23;0;23
8039;Pušaitė;PELIUKAI;7553389781;Taip;9;0;0;9
8040;Pušaitė;PELIUKAI;4420904389;Taip;0;23;0;23
8041;Pušaitė;PELIUKAI;8273198870;Taip;9;0;0;9
8042;Pušaitė;PELIUKAI;3245931596;Taip;0;19;0;19
8043;"Pušynėlis (Miglos g. 53)";PUMPURĖLIAI;9465619945;Taip;0;0;2;2
8044;"Pušynėlis (Miglos g. 53)";PUMPURĖLIAI;7689524787;Taip;7;0;0;7
8045;"Pušynėlis (Miglos g. 53)";PUMPURĖLIAI;1517104634;Taip;0;12;0;12
8046;"Pušynėlis (Miglos g. 53)";PUMPURĖLIAI;7732546085;Taip;16;0;0;16
8047;"Pušynėlis (Miglos g. 53)";PUMPURĖLIAI;6414064067;Taip;0;1;0;1
8048;"Pušynėlis (Miglos g. 53)";PUMPURĖLIAI;8933840402;Taip;3;0;1;4
8049;"Pušynėlis (Miglos g. 53)";PUMPURĖLIAI;1439408620;Taip;10;4;0;14
8050;"Pušynėlis (Miglos g. 53)";PUMPURĖLIAI;3682719098;Taip;2;0;0;2
8051;"Pušynėlis (Miglos g. 53)";PUMPURĖLIAI;4449613959;Taip;0;0;23;23
8052;"Pušynėlis (Miglos g. 53)";PUMPURĖLIAI;3125802067;Taip;0;0;15;15
8053;"Pušynėlis (Miglos g. 53)";PUMPURĖLIAI;1508282873;Taip;8;0;0;8
8054;"Pušynėlis (Miglos g. 53)";PUMPURĖLIAI;4603625624;Taip;0;0;1;1
8055;"Pušynėlis (Miglos g. 53)";PUMPURĖLIAI;5488832089;Taip;1;0;3;4
8056;"Pušynėlis (Miglos g. 53)";PUMPURĖLIAI;5670094788;Taip;1;4;0;5
8057;"Pušynėlis (Miglos g. 53)";PUMPURĖLIAI;5264481173;Taip;3;2;0;5
8058;"Pušynėlis (Miglos g. 53)";SAULUTĖS;5501281051;Taip;5;0;0;5
8059;"Pušynėlis (Miglos g. 53)";SAULUTĖS;2135996648;Taip;11;0;0;11
8060;"Pušynėlis (Miglos g. 53)";SAULUTĖS;9454407638;Taip;22;0;0;22
8061;"Pušynėlis (Miglos g. 53)";SAULUTĖS;5508064424;Taip;0;1;0;1
8062;"Pušynėlis (Miglos g. 53)";SAULUTĖS;5568838550;Taip;0;4;0;4
8063;"Pušynėlis (Miglos g. 53)";SAULUTĖS;2553444832;Taip;2;0;0;2
8064;"Pušynėlis (Miglos g. 53)";SAULUTĖS;2718421498;Taip;0;4;0;4
8065;"Pušynėlis (Miglos g. 53)";SAULUTĖS;2509111066;Taip;2;3;0;5
8066;"Pušynėlis (Miglos g. 53)";SAULUTĖS;8902047615;Taip;1;0;0;1
8067;"Pušynėlis (Miglos g. 53)";SAULUTĖS;3483639540;Taip;2;1;0;3
8068;"Pušynėlis (Miglos g. 53)";SAULUTĖS;2861000826;Taip;0;5;0;5
8069;"Pušynėlis (Miglos g. 53)";SAULUTĖS;3882064516;Taip;5;0;0;5
8070;"Pušynėlis (Miglos g. 53)";SAULUTĖS;9081582524;Taip;5;0;0;5
8071;"Pušynėlis (Miglos g. 53)";SAULUTĖS;9883505094;Taip;1;0;0;1
8072;"Pušynėlis (Miglos g. 53)";SAULUTĖS;4526807309;Taip;0;4;0;4
8073;"Pušynėlis (Miglos g. 53)";SAULUTĖS;7787646910;Taip;4;0;0;4
8074;"Pušynėlis (Miglos g. 53)";SAULUTĖS;7438923710;Taip;5;4;0;9
8075;"Pušynėlis (Miglos g. 53)";SAULUTĖS;6110878898;Taip;3;2;0;5
8076;"Pušynėlis (Miglos g. 53)";SAULUTĖS;8803766149;Taip;1;4;0;5
8077;"Pušynėlis (Miglos g. 53)";SAULUTĖS;8462742834;Taip;0;5;0;5
8078;"Pušynėlis (Miglos g. 53)";SAULUTĖS;6962705842;Taip;5;0;0;5
8079;"Pušynėlis (Miglos g. 53)";SAULUTĖS;2744665477;Taip;0;6;0;6
8080;"Pušynėlis (Miglos g. 53)";PRIEŠMOKYKLINĖ;4668634909;Taip;0;2;0;2
8081;"Pušynėlis (Miglos g. 53)";PRIEŠMOKYKLINĖ;4030500100;Taip;7;1;0;8
8082;"Pušynėlis (Miglos g. 53)";PRIEŠMOKYKLINĖ;8172450090;Taip;2;3;0;5
8083;"Pušynėlis (Miglos g. 53)";PRIEŠMOKYKLINĖ;3158789663;Taip;0;4;0;4
8084;"Pušynėlis (Miglos g. 53)";PRIEŠMOKYKLINĖ;9483417104;Taip;10;0;0;10
8085;"Pušynėlis (Miglos g. 53)";PRIEŠMOKYKLINĖ;1891728904;Taip;0;3;0;3
8086;"Pušynėlis (Miglos g. 53)";PRIEŠMOKYKLINĖ;7401066252;Taip;2;0;0;2
8087;"Pušynėlis (Miglos g. 53)";PRIEŠMOKYKLINĖ;1164201286;Taip;0;4;0;4
8088;"Pušynėlis (Miglos g. 53)";PRIEŠMOKYKLINĖ;2508640229;Taip;1;0;0;1
8089;"Pušynėlis (Miglos g. 53)";PRIEŠMOKYKLINĖ;1251787066;Taip;10;2;0;12
8090;"Pušynėlis (Miglos g. 53)";PRIEŠMOKYKLINĖ;5236219294;Taip;0;4;0;4
8091;"Pušynėlis (Miglos g. 53)";PRIEŠMOKYKLINĖ;6709692748;Taip;4;4;0;8
8092;"Pušynėlis (Miglos g. 53)";PRIEŠMOKYKLINĖ;8799095053;Taip;2;2;0;4
8093;"Pušynėlis (Miglos g. 53)";PRIEŠMOKYKLINĖ;5318223378;Taip;1;2;0;3
8094;"Pušynėlis (Miglos g. 53)";PRIEŠMOKYKLINĖ;3100230874;Taip;0;10;0;10
8095;"Pušynėlis (Miglos g. 53)";PRIEŠMOKYKLINĖ;7896617995;Taip;2;4;0;6
8096;"Pušynėlis (Miglos g. 53)";PRIEŠMOKYKLINĖ;5897839636;Taip;0;1;0;1
8097;"Pušynėlis (Miglos g. 53)";PRIEŠMOKYKLINĖ;1034336110;Taip;19;0;0;19
8098;"Pušynėlis (Miglos g. 53)";PRIEŠMOKYKLINĖ;3483007385;Taip;0;5;0;5
8099;"Pušynėlis (Miglos g. 53)";"TREPSIUKAI (2018.09)";4468698630;Taip;0;0;5;5
8100;"Pušynėlis (Miglos g. 53)";"TREPSIUKAI (2018.09)";8911046719;Taip;2;0;0;2
8101;"Pušynėlis (Miglos g. 53)";"TREPSIUKAI (2018.09)";8668256321;Taip;2;0;0;2
8102;"Pušynėlis (Miglos g. 53)";"TREPSIUKAI (2018.09)";5748126562;Taip;23;0;0;23
8103;"Pušynėlis (Miglos g. 53)";"TREPSIUKAI (2018.09)";7752614074;Taip;4;0;0;4
8104;"Pušynėlis (Miglos g. 53)";"TREPSIUKAI (2018.09)";9665045009;Taip;4;0;2;6
8105;"Pušynėlis (Miglos g. 53)";"TREPSIUKAI (2018.09)";1318218735;Taip;3;0;2;5
8106;"Pušynėlis (Miglos g. 53)";"TREPSIUKAI (2018.09)";5723212271;Ne;19;0;0;19
8107;Raktelis;LAŠIUKAI;9230053040;Taip;3;13;0;16
8108;Raktelis;LAŠIUKAI;9139322116;Taip;0;14;1;15
8109;Raktelis;LAŠIUKAI;6929358401;Taip;0;5;0;5
8110;Raktelis;LAŠIUKAI;2652125338;Taip;0;1;0;1
8111;Raktelis;LAŠIUKAI;5627179884;Taip;0;2;0;2
8112;Raktelis;LAŠIUKAI;4187804340;Ne;1;2;2;5
8113;Raktelis;LAŠIUKAI;9965855682;Taip;0;4;0;4
8114;Raktelis;LAŠIUKAI;7265543701;Taip;0;3;0;3
8115;Raktelis;LAŠIUKAI;4319176525;Taip;2;3;0;5
8116;Raktelis;LAŠIUKAI;5820028619;Taip;0;1;0;1
8117;Raktelis;LAŠIUKAI;5405322552;Taip;0;1;3;4
8118;Raktelis;LAŠIUKAI;3821849812;Taip;10;2;0;12
8119;Raktelis;LAŠIUKAI;4905982507;Taip;0;3;1;4
8120;Raktelis;LAŠIUKAI;7170546710;Taip;7;2;1;10
8121;Raktelis;LAŠIUKAI;9593639791;Taip;0;4;1;5
8122;Raktelis;LAŠIUKAI;1975411457;Taip;6;0;0;6
8123;Raktelis;LAŠIUKAI;6608224825;Taip;0;8;0;8
8124;Raktelis;LAŠIUKAI;6199212999;Taip;0;7;0;7
8125;Raktelis;LAŠIUKAI;1622504968;Taip;3;1;0;4
8126;Raktelis;LAŠIUKAI;9591285702;Taip;0;4;0;4
8127;Raktelis;BITUTĖS;3308623522;Ne;5;2;2;9
8128;Raktelis;BITUTĖS;4059286631;Taip;5;5;0;10
8129;Raktelis;BITUTĖS;5913060415;Taip;2;1;0;3
8130;Raktelis;BITUTĖS;6974263764;Taip;0;10;0;10
8131;Raktelis;BITUTĖS;6932820066;Taip;2;0;0;2
8132;Raktelis;BITUTĖS;2410682193;Taip;0;0;1;1
8133;Raktelis;BITUTĖS;5705825231;Taip;0;0;2;2
8134;Raktelis;BITUTĖS;4615337759;Taip;0;5;0;5
8135;Raktelis;BITUTĖS;4962251215;Taip;0;5;0;5
8136;Raktelis;BITUTĖS;8282429202;Taip;1;2;0;3
8137;Raktelis;BITUTĖS;7479542200;Taip;9;0;3;12
8138;Raktelis;BITUTĖS;6703168910;Taip;3;2;0;5
8139;Raktelis;BITUTĖS;1026592738;Taip;0;5;0;5
8140;Raktelis;BITUTĖS;7900644404;Taip;18;0;5;23
8141;Raktelis;BITUTĖS;6685891017;Taip;0;0;4;4
8142;Raktelis;BITUTĖS;3484991718;Taip;0;2;0;2
8143;Raktelis;BITUTĖS;6358227532;Taip;0;7;0;7
8144;Raktelis;BITUTĖS;9718355271;Taip;3;9;0;12
8145;Raktelis;BITUTĖS;8608093349;Taip;3;1;1;5
8146;Raktelis;BITUTĖS;6855863189;Taip;9;0;0;9
8147;Raktelis;BITUTĖS;7605822626;Taip;10;0;0;10
8148;Raktelis;BITUTĖS;9169797346;Taip;7;1;0;8
8149;Raktelis;BITUTĖS;2383174152;Taip;0;17;0;17
8150;Raktelis;BORUŽĖLĖS;7068061170;Taip;0;9;0;9
8151;Raktelis;BORUŽĖLĖS;2361477092;Taip;7;2;0;9
8152;Raktelis;BORUŽĖLĖS;4226277600;Ne;2;3;0;5
8153;Raktelis;BORUŽĖLĖS;2599670832;Taip;7;0;0;7
8154;Raktelis;BORUŽĖLĖS;1757601091;Taip;4;0;0;4
8155;Raktelis;BORUŽĖLĖS;5865484633;Ne;1;2;0;3
8156;Raktelis;BORUŽĖLĖS;4529213150;Taip;0;6;0;6
8157;Raktelis;BORUŽĖLĖS;4333191842;Taip;0;8;0;8
8158;Raktelis;BORUŽĖLĖS;9529797517;Taip;0;5;0;5
8159;Raktelis;BORUŽĖLĖS;4442395100;Taip;11;4;0;15
8160;Raktelis;BORUŽĖLĖS;5150954686;Taip;16;0;1;17
8161;Raktelis;BORUŽĖLĖS;3490428062;Taip;0;4;0;4
8162;Raktelis;BORUŽĖLĖS;5404673733;Taip;4;0;0;4
8163;Raktelis;BORUŽĖLĖS;1314972335;Taip;0;18;0;18
8164;Raktelis;BORUŽĖLĖS;3343352568;Taip;5;6;0;11
8165;Raktelis;BORUŽĖLĖS;7459272209;Taip;5;0;0;5
8166;Raktelis;BORUŽĖLĖS;5046450478;Taip;0;2;0;2
8167;Raktelis;BORUŽĖLĖS;1141447274;Taip;0;5;0;5
8168;Raktelis;BORUŽĖLĖS;5576511314;Taip;0;2;1;3
8169;Raktelis;BORUŽĖLĖS;9567582066;Taip;7;0;0;7
8170;Raktelis;BORUŽĖLĖS;3456093273;Taip;2;9;0;11
8171;Raktelis;BORUŽĖLĖS;8647112887;Taip;1;2;0;3
8172;Raktelis;KAČIUKAI;5270430511;Taip;2;1;0;3
8173;Raktelis;KAČIUKAI;4622683599;Taip;0;0;2;2
8174;Raktelis;KAČIUKAI;8600632097;Taip;0;4;0;4
8175;Raktelis;KAČIUKAI;7630501672;Taip;1;10;0;11
8176;Raktelis;KAČIUKAI;6007823584;Taip;3;9;0;12
8177;Raktelis;KAČIUKAI;3733786043;Taip;9;1;0;10
8178;Raktelis;KAČIUKAI;8456082594;Taip;0;4;0;4
8179;Raktelis;KAČIUKAI;4676213966;Taip;0;10;0;10
8180;Raktelis;KAČIUKAI;4631375439;Taip;0;0;1;1
8181;Raktelis;KAČIUKAI;6265489540;Taip;5;0;0;5
8182;Raktelis;KAČIUKAI;4160091258;Taip;0;2;0;2
8183;Raktelis;KAČIUKAI;3775306030;Taip;0;2;0;2
8184;Raktelis;KAČIUKAI;6550851582;Taip;0;1;0;1
8185;Raktelis;KAČIUKAI;4009105487;Taip;4;0;1;5
8186;Raktelis;KAČIUKAI;1843086151;Ne;13;1;0;14
8187;Raktelis;KAČIUKAI;2295251060;Taip;3;0;0;3
8188;Raktelis;KAČIUKAI;1983808547;Taip;9;0;0;9
8189;Raktelis;KAČIUKAI;5042538956;Taip;0;1;0;1
8190;Raktelis;KAČIUKAI;7260767942;Taip;9;1;0;10
8191;Raktelis;KAČIUKAI;1123693990;Taip;0;5;0;5
8192;Raktelis;KAČIUKAI;4979657165;Taip;7;1;0;8
8193;Raktelis;KAČIUKAI;9264550987;Taip;1;0;0;1
8194;Raktelis;KAČIUKAI;8767785444;Taip;4;1;0;5
8195;Raktelis;KIŠKUČIAI;1810732707;Taip;4;2;0;6
8196;Raktelis;KIŠKUČIAI;5293558630;Taip;14;0;0;14
8197;Raktelis;KIŠKUČIAI;6473692639;Taip;4;0;0;4
8198;Raktelis;KIŠKUČIAI;1668164327;Taip;4;0;0;4
8199;Raktelis;KIŠKUČIAI;1058482540;Taip;0;6;1;7
8200;Raktelis;KIŠKUČIAI;6222364306;Taip;12;0;0;12
8201;Raktelis;KIŠKUČIAI;6451056434;Taip;6;0;0;6
8202;Raktelis;KIŠKUČIAI;1129962966;Taip;0;8;0;8
8203;Raktelis;KIŠKUČIAI;7931502610;Taip;12;4;0;16
8204;Raktelis;KIŠKUČIAI;2976675359;Taip;8;7;0;15
8205;Raktelis;KIŠKUČIAI;9203811388;Taip;3;0;0;3
8206;Raktelis;KIŠKUČIAI;1511932941;Taip;7;0;0;7
8207;Raktelis;KIŠKUČIAI;5053933317;Taip;10;0;0;10
8208;Raktelis;KIŠKUČIAI;1664533959;Taip;6;0;0;6
8209;Raktelis;NYKŠTUKAI;7865593006;Ne;0;0;2;2
8210;Raktelis;NYKŠTUKAI;4252867688;Taip;5;0;0;5
8211;Raktelis;NYKŠTUKAI;4578445282;Taip;0;4;0;4
8212;Raktelis;NYKŠTUKAI;3890474241;Taip;9;1;0;10
8213;Raktelis;NYKŠTUKAI;9164539135;Taip;0;4;0;4
8214;Raktelis;NYKŠTUKAI;4147382341;Taip;0;2;3;5
8215;Raktelis;NYKŠTUKAI;3968555691;Ne;0;7;0;7
8216;Raktelis;NYKŠTUKAI;8507551381;Taip;4;0;1;5
8217;Raktelis;NYKŠTUKAI;4764915486;Taip;4;0;0;4
8218;Raktelis;NYKŠTUKAI;2803146830;Taip;10;1;0;11
8219;Raktelis;NYKŠTUKAI;1002851704;Taip;9;1;0;10
8220;Raktelis;NYKŠTUKAI;7202523804;Taip;0;3;0;3
8221;Raktelis;NYKŠTUKAI;6718159439;Taip;7;4;0;11
8222;Raktelis;NYKŠTUKAI;9390692206;Taip;17;0;0;17
8223;Raktelis;NYKŠTUKAI;8992797384;Taip;5;5;0;10
8224;Raktelis;NYKŠTUKAI;9803505110;Taip;1;6;0;7
8225;Raktelis;NYKŠTUKAI;6587878165;Taip;0;6;4;10
8226;Raktelis;NYKŠTUKAI;2262854947;Taip;18;0;0;18
8227;Raktelis;NYKŠTUKAI;2278227649;Taip;1;3;0;4
8228;Raktelis;NYKŠTUKAI;3493159224;Taip;14;0;5;19
8229;Raktelis;PELIUKAI;2044812301;Taip;0;6;0;6
8230;Raktelis;PELIUKAI;7389910330;Taip;0;2;0;2
8231;Raktelis;PELIUKAI;8698736569;Taip;0;4;0;4
8232;Raktelis;PELIUKAI;4834301832;Taip;0;1;0;1
8233;Raktelis;PELIUKAI;9983004779;Taip;1;0;0;1
8234;Raktelis;PELIUKAI;6346741475;Taip;14;2;0;16
8235;Raktelis;PELIUKAI;7117319827;Taip;0;9;0;9
8236;Raktelis;PELIUKAI;4100807708;Taip;12;0;0;12
8237;Raktelis;PELIUKAI;9778807678;Taip;1;2;2;5
8238;Raktelis;PELIUKAI;2928040174;Taip;18;0;0;18
8239;Raktelis;PELIUKAI;5497606646;Taip;0;2;0;2
8240;Raktelis;PELIUKAI;4139932945;Taip;8;0;0;8
8241;Raktelis;PELIUKAI;8581379659;Taip;8;0;0;8
8242;Raktelis;PELIUKAI;7892633426;Taip;9;0;0;9
8243;Raktelis;AGUONOS;9039234219;Ne;15;0;0;15
8244;Raktelis;AGUONOS;3811586185;Taip;5;4;0;9
8245;Raktelis;AGUONOS;1714731965;Taip;11;0;0;11
8246;Raktelis;AGUONOS;9666909207;Ne;11;0;0;11
8247;Raktelis;AGUONOS;9992920721;Taip;19;0;0;19
8248;Raktelis;AGUONOS;3373893685;Ne;3;7;0;10
8249;Raktelis;AGUONOS;6499798110;Taip;4;0;0;4
8250;Raktelis;AGUONOS;4828942464;Taip;6;0;0;6
8251;Raktelis;AGUONOS;5686613002;Taip;15;0;0;15
8252;Raktelis;AGUONOS;5362472918;Taip;6;3;0;9
8253;Raktelis;AGUONOS;9205511475;Taip;17;0;0;17
8254;Raktelis;AGUONOS;1197236154;Taip;14;0;0;14
8255;Raktelis;AGUONOS;2666984428;Taip;6;0;0;6
8256;Raktelis;AGUONOS;6019423312;Taip;2;0;0;2
8257;Raktelis;AGUONOS;2550528342;Taip;8;0;0;8
8258;Raktelis;AGUONOS;1356784453;Taip;12;0;0;12
8259;Raktelis;LAPIUKŲ;3517484891;Taip;0;8;0;8
8260;Raktelis;LAPIUKŲ;2731096860;Taip;0;4;0;4
8261;Raktelis;LAPIUKŲ;1263150004;Taip;0;3;0;3
8262;Raktelis;LAPIUKŲ;9497620710;Taip;6;0;0;6
8263;Raktelis;LAPIUKŲ;1120263625;Taip;12;1;0;13
8264;Raktelis;LAPIUKŲ;5688795147;Taip;2;4;0;6
8265;Raktelis;LAPIUKŲ;8035618134;Ne;0;2;0;2
8266;Raktelis;LAPIUKŲ;8146076115;Taip;0;5;0;5
8267;Raktelis;LAPIUKŲ;8700012974;Taip;0;7;0;7
8268;Raktelis;LAPIUKŲ;1445359221;Taip;1;0;0;1
8269;Raktelis;LAPIUKŲ;1604357851;Taip;19;0;0;19
8270;Raktelis;LAPIUKŲ;5758873229;Taip;4;2;0;6
8271;Raktelis;LAPIUKŲ;9599034285;Taip;8;1;0;9
8272;Raktelis;LAPIUKŲ;3311870918;Taip;11;2;0;13
8273;Raktelis;LAPIUKŲ;6826993779;Taip;11;2;0;13
8274;Raktelis;LAPIUKŲ;6393143566;Taip;0;9;0;9
8275;Raktelis;LAPIUKŲ;2141128125;Taip;9;0;0;9
8276;Raktelis;LAPIUKŲ;4502236264;Taip;0;2;0;2
8277;Raktelis;LAPIUKŲ;6853881405;Taip;7;5;0;12
8278;Raktelis;LAPIUKŲ;4513031164;Taip;12;0;1;13
8279;Raktelis;LAPIUKŲ;4014822452;Taip;0;2;0;2
8280;Raktelis;PELĖDŽIUKAI;4583377785;Taip;2;0;1;3
8281;Raktelis;PELĖDŽIUKAI;7962509432;Taip;0;10;0;10
8282;Raktelis;PELĖDŽIUKAI;9716191639;Taip;0;5;0;5
8283;Raktelis;PELĖDŽIUKAI;8869030487;Taip;0;0;1;1
8284;Raktelis;PELĖDŽIUKAI;1322912585;Taip;0;2;4;6
8285;Raktelis;PELĖDŽIUKAI;6877934219;Taip;4;0;0;4
8286;Raktelis;PELĖDŽIUKAI;9130613710;Taip;0;3;0;3
8287;Raktelis;PELĖDŽIUKAI;9151796053;Taip;0;1;0;1
8288;Raktelis;PELĖDŽIUKAI;2282754345;Taip;0;4;0;4
8289;Raktelis;PELĖDŽIUKAI;8207675881;Taip;0;6;0;6
8290;Raktelis;PELĖDŽIUKAI;7869495911;Taip;0;1;0;1
8291;Raktelis;PELĖDŽIUKAI;5925441742;Taip;5;5;0;10
8292;Raktelis;PELĖDŽIUKAI;5082785025;Taip;0;7;0;7
8293;Raktelis;PELĖDŽIUKAI;7142823740;Taip;0;7;0;7
8294;Raktelis;PELĖDŽIUKAI;3395720463;Taip;0;8;0;8
8295;Raktelis;PELĖDŽIUKAI;4167194960;Taip;0;4;0;4
8296;Raktelis;PELĖDŽIUKAI;2809458453;Taip;0;4;0;4
8297;Raktelis;PELĖDŽIUKAI;6894769625;Taip;0;5;0;5
8298;Raktelis;PELĖDŽIUKAI;2967941870;Taip;0;2;0;2
8299;Raktelis;PELĖDŽIUKAI;7440866459;Taip;9;5;0;14
8300;Raktelis;PELĖDŽIUKAI;3884068578;Taip;0;1;0;1
8301;Raktelis;PELĖDŽIUKAI;4755892641;Taip;0;6;0;6
8302;Raktelis;MEŠKIUKAI;8851021346;Taip;16;0;0;16
8303;Raktelis;MEŠKIUKAI;4185763817;Taip;5;8;0;13
8304;Raktelis;MEŠKIUKAI;6409457833;Ne;5;4;0;9
8305;Raktelis;MEŠKIUKAI;1740426946;Taip;11;0;0;11
8306;Raktelis;MEŠKIUKAI;1304479190;Taip;15;0;0;15
8307;Raktelis;MEŠKIUKAI;6391559356;Taip;6;0;0;6
8308;Raktelis;MEŠKIUKAI;5358970156;Taip;14;0;0;14
8309;Rasa;Nykštukai;5176175108;Taip;0;7;0;7
8310;Rasa;Nykštukai;3979273111;Taip;0;4;0;4
8311;Rasa;Nykštukai;4847544355;Taip;0;4;0;4
8312;Rasa;Nykštukai;9723040721;Taip;0;4;0;4
8313;Rasa;Nykštukai;1223962374;Taip;1;0;0;1
8314;Rasa;Nykštukai;3200377629;Taip;0;6;0;6
8315;Rasa;Nykštukai;1336291828;Taip;0;8;0;8
8316;Rasa;Nykštukai;5861229664;Taip;0;4;0;4
8317;Rasa;Nykštukai;1386880644;Taip;0;5;0;5
8318;Rasa;Nykštukai;7228037580;Taip;0;5;0;5
8319;Rasa;Nykštukai;2093263887;Taip;0;4;0;4
8320;Rasa;Nykštukai;2540124793;Taip;0;5;0;5
8321;Rasa;Nykštukai;5363748728;Taip;0;5;0;5
8322;Rasa;Nykštukai;2977737634;Taip;0;2;0;2
8323;Rasa;Nykštukai;7520665472;Taip;0;5;0;5
8324;Rasa;Nykštukai;7534306402;Taip;0;4;0;4
8325;Rasa;Nykštukai;3755794133;Taip;3;1;0;4
8326;Rasa;Nykštukai;2190948879;Taip;5;4;0;9
8327;Rasa;Nykštukai;4010262461;Taip;8;4;0;12
8328;Rasa;Nykštukai;8236464670;Taip;0;4;0;4
8329;Rasa;Nykštukai;6976298054;Taip;3;0;0;3
8330;Rasa;Nykštukai;2333938367;Taip;4;4;0;8
8331;Rasa;Meškiukai;8378755600;Taip;0;15;0;15
8332;Rasa;Meškiukai;3073804713;Taip;5;1;0;6
8333;Rasa;Meškiukai;6691161322;Taip;0;1;0;1
8334;Rasa;Meškiukai;8740659600;Taip;0;23;0;23
8335;Rasa;Meškiukai;4127921417;Taip;4;4;0;8
8336;Rasa;Meškiukai;7357915584;Taip;1;0;0;1
8337;Rasa;Meškiukai;8314522373;Taip;0;5;0;5
8338;Rasa;Meškiukai;3548008659;Taip;0;13;0;13
8339;Rasa;Meškiukai;3773600344;Taip;8;1;2;11
8340;Rasa;Meškiukai;2371282781;Taip;8;1;2;11
8341;Rasa;Meškiukai;2555108465;Taip;0;0;3;3
8342;Rasa;Meškiukai;1992726664;Taip;0;7;0;7
8343;Rasa;Meškiukai;5165588335;Taip;10;0;0;10
8344;Rasa;Meškiukai;7637404588;Taip;0;4;0;4
8345;Rasa;Meškiukai;7502435359;Taip;0;8;0;8
8346;Rasa;Meškiukai;6853285570;Taip;4;5;0;9
8347;Rasa;Meškiukai;8674133653;Taip;16;0;2;18
8348;Rasa;Sauliukai;3657956842;Ne;10;1;0;11
8349;Rasa;Sauliukai;6891623055;Taip;4;5;0;9
8350;Rasa;Sauliukai;9010812748;Taip;0;4;0;4
8351;Rasa;Sauliukai;7220007488;Taip;0;4;0;4
8352;Rasa;Sauliukai;5134342817;Taip;0;1;0;1
8353;Rasa;Sauliukai;4734775151;Ne;7;3;0;10
8354;Rasa;Sauliukai;8235869241;Taip;9;4;0;13
8355;Rasa;Sauliukai;3428261829;Taip;0;11;0;11
8356;Rasa;Sauliukai;5426981046;Taip;1;4;0;5
8357;Rasa;Sauliukai;5885520521;Taip;0;2;0;2
8358;Rasa;Sauliukai;3631124501;Taip;9;3;0;12
8359;Rasa;Sauliukai;2477057223;Taip;0;12;0;12
8360;Rasa;Sauliukai;4913483444;Taip;6;4;0;10
8361;Rasa;Sauliukai;9343039995;Taip;0;6;0;6
8362;Rasa;Sauliukai;4758138905;Taip;0;4;0;4
8363;Rasa;Sauliukai;6411372006;Taip;14;4;0;18
8364;Rasa;Sauliukai;9157136735;Taip;0;7;0;7
8365;Rasa;Sauliukai;4942819477;Taip;0;1;0;1
8366;Rasa;Smalsučiai;9288967646;Taip;10;0;0;10
8367;Rasa;Smalsučiai;6307149426;Taip;0;0;1;1
8368;Rasa;Smalsučiai;8350239611;Taip;0;0;1;1
8369;Rasa;Smalsučiai;3867443155;Taip;5;0;0;5
8370;Rasa;Smalsučiai;4828855802;Taip;14;0;1;15
8371;Rasa;Smalsučiai;7250512345;Taip;0;0;5;5
8372;Rasa;Smalsučiai;8888344226;Taip;0;4;2;6
8373;Rasa;Smalsučiai;1683652129;Taip;10;0;0;10
8374;Rasa;Smalsučiai;2368671762;Taip;9;0;0;9
8375;Rasa;Smalsučiai;7335907373;Taip;7;3;5;15
8376;Rasa;Smalsučiai;2647048529;Taip;7;0;0;7
8377;Rasa;Smalsučiai;7901163117;Taip;9;0;0;9
8378;Rasa;Smalsučiai;7389262967;Taip;0;4;1;5
8379;Rasa;"Pelėdžiukai ";3387615841;Taip;0;2;0;2
8380;Rasa;"Pelėdžiukai ";8455168346;Taip;5;0;7;12
8381;Rasa;"Pelėdžiukai ";9056416308;Taip;0;2;0;2
8382;Rasa;"Pelėdžiukai ";5141906920;Taip;0;2;0;2
8383;Rasa;"Pelėdžiukai ";1261868339;Taip;0;5;3;8
8384;Rasa;"Pelėdžiukai ";6553479199;Taip;11;1;0;12
8385;Rasa;"Pelėdžiukai ";4947382314;Taip;4;2;0;6
8386;Rasa;"Pelėdžiukai ";2968464121;Taip;0;5;1;6
8387;Rasa;"Pelėdžiukai ";5816940902;Taip;5;0;1;6
8388;Rasa;"Pelėdžiukai ";8403268732;Taip;0;4;0;4
8389;Rasa;"Pelėdžiukai ";4855210006;Taip;3;2;0;5
8390;Rasa;"Pelėdžiukai ";4234198467;Taip;3;2;0;5
8391;Rasa;"Pelėdžiukai ";6874601830;Taip;14;2;0;16
8392;Rasa;Katinėliai;8574946856;Taip;4;7;0;11
8393;Rasa;Katinėliai;1477018184;Taip;0;0;3;3
8394;Rasa;Katinėliai;1521328997;Taip;4;4;2;10
8395;Rasa;Katinėliai;4018241056;Taip;5;4;1;10
8396;Rasa;Katinėliai;7568880413;Taip;0;0;2;2
8397;Rasa;Katinėliai;4762348187;Taip;3;0;2;5
8398;Rasa;Katinėliai;4979105526;Taip;0;0;2;2
8399;Rasa;Katinėliai;6755131948;Taip;3;0;0;3
8400;Rasa;Katinėliai;6442933249;Taip;0;6;2;8
8401;Rasa;Katinėliai;1736903037;Taip;3;9;0;12
8402;Rasa;Katinėliai;6656230158;Taip;7;3;0;10
8403;Rasa;Katinėliai;7029860782;Taip;0;0;9;9
8404;Rasa;Katinėliai;6640475278;Taip;7;0;0;7
8405;Rasa;Katinėliai;6856440701;Taip;0;0;23;23
8406;Rasa;Katinėliai;1263070686;Taip;5;4;0;9
8407;Rasa;Ančiukai;5260636074;Taip;11;0;0;11
8408;Rasa;Ančiukai;3898763654;Taip;5;0;0;5
8409;Rasa;Ančiukai;4427497247;Taip;11;0;0;11
8410;Rasa;Ančiukai;5128743872;Taip;4;0;0;4
8411;Rasa;Ančiukai;6044145252;Taip;0;7;0;7
8412;Rasa;Ančiukai;5407988663;Taip;5;0;0;5
8413;Rasa;Ančiukai;2683337738;Taip;0;0;1;1
8414;Rasa;Ančiukai;3559964630;Taip;14;9;0;23
8415;Rasa;Ančiukai;6403716333;Taip;2;0;0;2
8416;Rasa;Ančiukai;3569945230;Taip;1;4;0;5
8417;Rasa;Ančiukai;4872698495;Taip;6;0;0;6
8418;Rasa;Ančiukai;8159424999;Taip;4;0;0;4
8419;Rasa;"Vyturiukai ";7028605422;Taip;7;0;0;7
8420;Rasa;"Vyturiukai ";9599510902;Taip;4;0;0;4
8421;Rasa;"Vyturiukai ";5869253167;Taip;5;2;0;7
8422;Rasa;"Vyturiukai ";7037958994;Taip;0;4;0;4
8423;Rasa;"Vyturiukai ";8236785255;Taip;3;4;0;7
8424;Rasa;"Vyturiukai ";6887471189;Taip;8;0;0;8
8425;Rasa;"Vyturiukai ";2347639286;Taip;2;0;0;2
8426;Rasa;"Vyturiukai ";1206005039;Taip;0;4;0;4
8427;Rasa;"Vyturiukai ";9788282861;Taip;4;4;0;8
8428;Rasa;"Vyturiukai ";2711923397;Taip;4;0;0;4
8429;Rasa;"Vyturiukai ";2769096357;Taip;10;0;1;11
8430;Rasa;"Vyturiukai ";6883073764;Taip;5;2;2;9
8431;Rasa;"Vyturiukai ";9706428782;Ne;3;8;0;11
8432;Rasa;"Vyturiukai ";6575864256;Taip;6;0;0;6
8433;Rasa;"Vyturiukai ";2434270419;Taip;1;0;0;1
8434;Rasa;"Vyturiukai ";8296425777;Taip;1;4;0;5
8435;Rasa;"Vyturiukai ";7265752821;Taip;0;0;4;4
8436;Rasa;Voveriukai;4111850024;Taip;0;6;1;7
8437;Rasa;Voveriukai;1978999728;Ne;6;0;1;7
8438;Rasa;Voveriukai;3546684695;Taip;9;4;2;15
8439;Rasa;Voveriukai;5740754301;Ne;0;0;2;2
8440;Rasa;Voveriukai;5977524939;Taip;6;0;1;7
8441;Rasa;Voveriukai;1592174114;Taip;10;4;0;14
8442;Rasa;Voveriukai;1564194649;Taip;0;0;3;3
8443;Rasa;Voveriukai;1764959761;Taip;0;0;6;6
8444;Rasa;Voveriukai;2895124729;Taip;0;2;1;3
8445;Rasa;Voveriukai;5622110823;Taip;0;6;0;6
8446;Rasa;Voveriukai;6221754830;Taip;0;0;1;1
8447;Rasa;Voveriukai;7218250981;Taip;0;10;0;10
8448;Rasa;Voveriukai;7152769140;Taip;2;0;1;3
8449;Rasa;"DRUGELIAI ";6621628020;Taip;13;0;0;13
8450;Rasa;"DRUGELIAI ";9959160342;Taip;13;0;0;13
8451;Rasa;"DRUGELIAI ";5761013588;Taip;0;7;0;7
8452;Rasa;"DRUGELIAI ";7220103314;Taip;0;0;1;1
8453;Rasa;"DRUGELIAI ";9506388242;Taip;5;1;0;6
8454;Rasa;"DRUGELIAI ";4188303400;Taip;1;0;0;1
8455;Rasa;"DRUGELIAI ";5483943978;Taip;7;0;0;7
8456;Rasa;"DRUGELIAI ";7251815682;Taip;14;0;0;14
8457;Rasa;"DRUGELIAI ";8702962863;Taip;2;3;0;5
8458;Rasa;"DRUGELIAI ";6291089659;Taip;10;0;0;10
8459;Rasa;"DRUGELIAI ";1575522555;Taip;9;1;2;12
8460;Rasa;"DRUGELIAI ";1610581364;Taip;0;5;1;6
8461;Rasa;"DRUGELIAI ";2881055956;Taip;17;4;0;21
8462;Rasa;"DRUGELIAI ";3113010641;Taip;18;0;0;18
8463;Rasa;"DRUGELIAI ";9938323938;Taip;6;0;3;9
8464;Rasa;Zuikučiai;8027532547;Taip;1;2;1;4
8465;Rasa;Zuikučiai;3470054190;Taip;5;0;0;5
8466;Rasa;Zuikučiai;7253736220;Taip;11;5;0;16
8467;Rasa;Zuikučiai;4940758709;Taip;0;4;0;4
8468;Rasa;Zuikučiai;7091899236;Taip;4;2;3;9
8469;Rasa;Zuikučiai;6574998939;Taip;0;1;0;1
8470;Rasa;Zuikučiai;4212798846;Taip;0;3;0;3
8471;Rasa;Zuikučiai;6505001743;Taip;7;11;1;19
8472;Rasa;Zuikučiai;6780996150;Taip;0;4;2;6
8473;Rasa;Zuikučiai;8159411349;Taip;2;2;3;7
8474;Rasa;Zuikučiai;8992548689;Taip;3;6;3;12
8475;Rasa;Zuikučiai;1983112873;Taip;10;4;0;14
8476;Rasa;Zuikučiai;6650473677;Taip;1;0;1;2
8477;Rasa;Zuikučiai;4508356130;Taip;0;4;0;4
8478;Rasa;Zuikučiai;8503010505;Taip;2;0;2;4
8479;Rasa;Zuikučiai;1843058886;Taip;0;5;0;5
8480;Rasa;Širdelė;3668598028;Taip;1;1;0;2
8481;Rasa;Širdelė;9560289781;Taip;0;2;0;2
8482;Rasa;Širdelė;9140875020;Ne;9;2;0;11
8483;Rasa;Širdelė;4694382836;Taip;2;0;0;2
8484;Rasa;Širdelė;1796573723;Taip;1;4;0;5
8485;Rasa;Širdelė;3535655117;Taip;0;3;0;3
8486;Rasa;Širdelė;2830296197;Taip;2;0;0;2
8487;Rasa;Širdelė;4361959446;Taip;0;4;0;4
8488;Rasa;Širdelė;3215464914;Taip;10;0;0;10
8489;Rasa;Širdelė;6760723624;Taip;2;0;0;2
8490;Rasa;Širdelė;1447258806;Taip;8;0;0;8
8491;Rasa;Širdelė;1627996663;Taip;2;5;0;7
8492;Rasa;Širdelė;9884995175;Taip;1;0;0;1
8493;Rasa;Širdelė;3965976031;Taip;3;0;0;3
8494;Rasa;Širdelė;4248042049;Taip;5;0;0;5
8495;Rasa;Širdelė;7604145882;Taip;2;0;0;2
8496;Rasa;Širdelė;9713743149;Taip;1;4;0;5
8497;Riešutėlis;Viščiukų;8413887888;Taip;6;1;1;8
8498;Riešutėlis;Viščiukų;7142412042;Taip;6;0;0;6
8499;Riešutėlis;Viščiukų;5659054276;Taip;3;1;0;4
8500;Riešutėlis;Viščiukų;7985174814;Taip;9;1;0;10
8501;Riešutėlis;Viščiukų;3508479107;Taip;5;3;0;8
8502;Riešutėlis;Viščiukų;6398881485;Taip;5;0;0;5
8503;Riešutėlis;Viščiukų;3109659339;Taip;9;0;0;9
8504;Riešutėlis;Viščiukų;4554875389;Taip;8;0;0;8
8505;Riešutėlis;Viščiukų;4533005769;Taip;9;0;0;9
8506;Riešutėlis;Viščiukų;3883149010;Taip;8;0;0;8
8507;Riešutėlis;Viščiukų;8049449033;Taip;4;2;0;6
8508;Riešutėlis;Viščiukų;1389302927;Taip;4;5;0;9
8509;Riešutėlis;Viščiukų;6105142818;Taip;6;1;0;7
8510;Riešutėlis;"Riešutėliai ";3800733442;Taip;9;0;0;9
8511;Riešutėlis;"Riešutėliai ";2117939721;Ne;9;0;0;9
8512;Riešutėlis;"Riešutėliai ";1343776985;Taip;6;0;0;6
8513;Riešutėlis;"Riešutėliai ";5915019363;Taip;5;6;0;11
8514;Riešutėlis;"Riešutėliai ";2207907790;Taip;15;0;0;15
8515;Riešutėlis;"Riešutėliai ";9699503472;Taip;10;0;0;10
8516;Riešutėlis;"Riešutėliai ";2098369052;Taip;16;0;0;16
8517;Riešutėlis;"Riešutėliai ";1426700414;Taip;6;1;0;7
8518;Riešutėlis;"Riešutėliai ";8539906445;Taip;2;1;0;3
8519;Riešutėlis;"Riešutėliai ";5873443383;Taip;5;0;0;5
8520;Riešutėlis;"Riešutėliai ";2301247729;Taip;9;10;0;19
8521;Riešutėlis;"Riešutėliai ";3602707130;Taip;4;1;0;5
8522;Riešutėlis;"Riešutėliai ";8991963843;Taip;4;0;0;4
8523;Riešutėlis;"Riešutėliai ";9318640304;Taip;2;0;0;2
8524;Riešutėlis;"Riešutėliai ";4293402095;Taip;6;1;0;7
8525;Riešutėlis;"Riešutėliai ";8917451081;Taip;16;1;0;17
8526;Riešutėlis;"Riešutėliai ";4698338374;Taip;10;4;0;14
8527;Riešutėlis;"Riešutėliai ";3345064565;Taip;12;2;0;14
8528;Riešutėlis;"Riešutėliai ";2560507294;Taip;0;13;0;13
8529;Riešutėlis;"Riešutėliai ";9078282526;Taip;5;2;0;7
8530;Riešutėlis;Ežiukai;5758442826;Taip;6;1;0;7
8531;Riešutėlis;Ežiukai;9888470246;Taip;6;1;0;7
8532;Riešutėlis;Ežiukai;1858791074;Taip;0;5;0;5
8533;Riešutėlis;Ežiukai;3759837057;Taip;4;10;0;14
8534;Riešutėlis;Ežiukai;3249196007;Taip;3;0;0;3
8535;Riešutėlis;Ežiukai;4740516426;Taip;16;0;0;16
8536;Riešutėlis;Ežiukai;5078051087;Taip;1;1;0;2
8537;Riešutėlis;Ežiukai;3150141050;Taip;6;0;0;6
8538;Riešutėlis;Ežiukai;6580050526;Taip;16;0;0;16
8539;Riešutėlis;Ežiukai;4810919435;Taip;7;0;0;7
8540;Riešutėlis;Ežiukai;2736824231;Taip;16;0;0;16
8541;Riešutėlis;Ežiukai;2378301886;Taip;6;9;0;15
8542;Riešutėlis;Ežiukai;2483793992;Taip;5;4;0;9
8543;Riešutėlis;Ežiukai;5262881964;Taip;6;0;0;6
8544;Riešutėlis;Ežiukai;4328166135;Taip;2;2;0;4
8545;Riešutėlis;Ežiukai;9052991215;Taip;4;3;0;7
8546;Riešutėlis;Pelėdžiukai;3975540383;Taip;4;0;0;4
8547;Riešutėlis;Pelėdžiukai;1705599429;Taip;2;4;0;6
8548;Riešutėlis;Pelėdžiukai;4116506453;Taip;6;1;0;7
8549;Riešutėlis;Pelėdžiukai;2467739101;Taip;10;0;0;10
8550;Riešutėlis;Pelėdžiukai;2587460110;Taip;18;0;0;18
8551;Riešutėlis;Pelėdžiukai;6147780439;Taip;5;0;0;5
8552;Riešutėlis;Pelėdžiukai;3287685792;Taip;8;0;0;8
8553;Riešutėlis;Pelėdžiukai;1811701628;Taip;4;0;0;4
8554;Riešutėlis;Pelėdžiukai;5183264581;Taip;0;4;0;4
8555;Riešutėlis;Pelėdžiukai;6121386391;Taip;10;0;0;10
8556;Riešutėlis;Pelėdžiukai;3251066115;Taip;6;3;0;9
8557;Riešutėlis;Pelėdžiukai;4808684145;Taip;0;6;0;6
8558;Riešutėlis;Pelėdžiukai;4897581681;Taip;10;0;0;10
8559;Riešutėlis;Pelėdžiukai;7256075146;Taip;7;2;0;9
8560;Riešutėlis;Pelėdžiukai;5443448616;Taip;0;10;0;10
8561;Riešutėlis;Pelėdžiukai;9598824163;Taip;7;1;0;8
8562;Riešutėlis;Pelėdžiukai;8839482370;Taip;11;0;0;11
8563;Riešutėlis;Pelėdžiukai;4692384639;Ne;5;0;0;5
8564;Riešutėlis;Meškiukai;7030346495;Taip;0;1;0;1
8565;Riešutėlis;Meškiukai;9750713954;Taip;0;6;0;6
8566;Riešutėlis;Meškiukai;3577669231;Taip;4;5;0;9
8567;Riešutėlis;Meškiukai;2837471235;Taip;15;0;0;15
8568;Riešutėlis;Meškiukai;2699984170;Taip;1;5;0;6
8569;Riešutėlis;Meškiukai;7601776182;Taip;0;1;0;1
8570;Riešutėlis;Meškiukai;7050440691;Taip;0;6;0;6
8571;Riešutėlis;Meškiukai;7381623086;Taip;0;5;0;5
8572;Riešutėlis;Meškiukai;6284614328;Taip;12;5;0;17
8573;Riešutėlis;Meškiukai;9964688413;Taip;0;8;0;8
8574;Riešutėlis;Meškiukai;1548585448;Taip;3;0;0;3
8575;Riešutėlis;Meškiukai;5728858361;Taip;0;3;0;3
8576;Riešutėlis;Meškiukai;1818130297;Taip;0;3;0;3
8577;Riešutėlis;Meškiukai;8954127616;Taip;4;5;0;9
8578;Riešutėlis;Meškiukai;2092933906;Taip;2;9;0;11
8579;Riešutėlis;Meškiukai;6813024366;Taip;14;0;0;14
8580;Riešutėlis;Meškiukai;8480059272;Taip;8;1;0;9
8581;Riešutėlis;Meškiukai;8751571852;Taip;0;1;0;1
8582;Riešutėlis;Kiškučiai;9086474785;Taip;15;0;0;15
8583;Riešutėlis;Kiškučiai;3363757821;Ne;4;5;0;9
8584;Riešutėlis;Kiškučiai;2581250615;Taip;4;0;0;4
8585;Riešutėlis;Kiškučiai;8445984114;Taip;23;0;0;23
8586;Riešutėlis;Kiškučiai;5266946070;Taip;2;0;0;2
8587;Riešutėlis;Kiškučiai;9357375649;Taip;4;0;0;4
8588;Riešutėlis;Kiškučiai;9548551553;Taip;5;0;0;5
8589;Riešutėlis;Kiškučiai;9500744921;Ne;6;0;0;6
8590;Riešutėlis;Kiškučiai;4851336076;Taip;4;0;0;4
8591;Riešutėlis;Kiškučiai;6705754238;Taip;7;0;0;7
8592;Riešutėlis;Kiškučiai;1111543507;Ne;0;10;0;10
8593;Riešutėlis;Kiškučiai;9964105252;Taip;5;0;0;5
8594;Riešutėlis;Kiškučiai;6693197006;Taip;9;0;0;9
8595;Riešutėlis;Kiškučiai;5846061115;Taip;4;0;0;4
8596;Riešutėlis;Kiškučiai;3165015754;Taip;6;0;0;6
8597;Riešutėlis;Kiškučiai;1494363200;Taip;18;0;0;18
8598;Riešutėlis;Voveriukų;9864636983;Taip;11;2;0;13
8599;Riešutėlis;Voveriukų;5662911204;Taip;1;0;0;1
8600;Riešutėlis;Voveriukų;7663823906;Taip;0;8;0;8
8601;Riešutėlis;Voveriukų;1282121190;Taip;7;0;0;7
8602;Riešutėlis;Voveriukų;5336618381;Taip;0;4;0;4
8603;Riešutėlis;Voveriukų;7327578507;Taip;5;1;0;6
8604;Riešutėlis;Voveriukų;2875416610;Taip;9;0;0;9
8605;Riešutėlis;Voveriukų;9815988800;Taip;0;2;0;2
8606;Riešutėlis;Voveriukų;9296178632;Taip;10;0;0;10
8607;Riešutėlis;Voveriukų;6681930005;Taip;8;0;0;8
8608;Riešutėlis;Voveriukų;2352984379;Taip;12;0;0;12
8609;Riešutėlis;Voveriukų;2238641969;Taip;8;1;0;9
8610;Riešutėlis;Voveriukų;1058206787;Taip;8;0;0;8
8611;Riešutėlis;Voveriukų;9198289423;Taip;0;1;0;1
8612;Riešutėlis;Voveriukų;3340831522;Taip;20;0;0;20
8613;Riešutėlis;Saulutės;4004669930;Taip;4;3;0;7
8614;Riešutėlis;Saulutės;6721758785;Taip;5;2;0;7
8615;Riešutėlis;Saulutės;3694146893;Taip;0;4;0;4
8616;Riešutėlis;Saulutės;1748151109;Taip;4;0;0;4
8617;Riešutėlis;Saulutės;8504832383;Taip;0;1;0;1
8618;Riešutėlis;Saulutės;8738716660;Taip;0;2;0;2
8619;Riešutėlis;Saulutės;4828635362;Taip;0;1;0;1
8620;Riešutėlis;Saulutės;6635909614;Taip;0;4;0;4
8621;Riešutėlis;Saulutės;1196740726;Taip;14;4;0;18
8622;Riešutėlis;Saulutės;8415858895;Taip;10;2;0;12
8623;Riešutėlis;Saulutės;4498718519;Taip;2;1;0;3
8624;Riešutėlis;Saulutės;5753609922;Taip;0;4;0;4
8625;Riešutėlis;Saulutės;5013754772;Taip;4;0;0;4
8626;Riešutėlis;Saulutės;6468871352;Taip;12;0;1;13
8627;Riešutėlis;Saulutės;7154361660;Taip;14;7;0;21
8628;Riešutėlis;Saulutės;2395391926;Taip;4;0;0;4
8629;Riešutėlis;Saulutės;2572642260;Taip;5;0;1;6
8630;Riešutėlis;Saulutės;3544780386;Taip;11;0;1;12
8631;Riešutėlis;"Boruželės ";7666200219;Taip;0;2;0;2
8632;Riešutėlis;"Boruželės ";6626441225;Taip;1;0;0;1
8633;Riešutėlis;"Boruželės ";4426750525;Taip;2;0;0;2
8634;Riešutėlis;"Boruželės ";6906373822;Taip;2;2;0;4
8635;Riešutėlis;"Boruželės ";4636191548;Taip;1;0;0;1
8636;Riešutėlis;"Boruželės ";2493171003;Taip;9;0;1;10
8637;Riešutėlis;"Boruželės ";5133625078;Taip;11;0;0;11
8638;Riešutėlis;"Boruželės ";9341748384;Taip;12;1;0;13
8639;Riešutėlis;"Boruželės ";4429903561;Taip;7;0;0;7
8640;Riešutėlis;"Boruželės ";8235524536;Taip;1;1;0;2
8641;Riešutėlis;"Boruželės ";7795124495;Taip;0;0;2;2
8642;Riešutėlis;"Boruželės ";2832538856;Taip;6;3;0;9
8643;Riešutėlis;"Boruželės ";3730909181;Taip;7;0;0;7
8644;Riešutėlis;"Bitutės ";2498093110;Taip;11;0;0;11
8645;Riešutėlis;"Bitutės ";2459494071;Taip;2;5;0;7
8646;Riešutėlis;"Bitutės ";3931422170;Taip;7;2;0;9
8647;Riešutėlis;"Bitutės ";8265627960;Taip;6;0;0;6
8648;Riešutėlis;"Bitutės ";4591910912;Taip;5;0;0;5
8649;Riešutėlis;"Bitutės ";9285782325;Taip;13;0;0;13
8650;Riešutėlis;"Bitutės ";7473054556;Taip;6;1;0;7
8651;Riešutėlis;"Bitutės ";3475897400;Taip;6;0;0;6
8652;Riešutėlis;"Bitutės ";3592271009;Taip;5;1;0;6
8653;Riešutėlis;"Bitutės ";6815804556;Taip;7;0;0;7
8654;Riešutėlis;"Bitutės ";4358354602;Taip;3;1;0;4
8655;Riešutėlis;"Bitutės ";1842107341;Ne;14;0;0;14
8656;Riešutėlis;"Bitutės ";4211273525;Taip;6;0;0;6
8657;Riešutėlis;Drugelių;8266735624;Taip;4;6;0;10
8658;Riešutėlis;Drugelių;4776231497;Taip;4;6;0;10
8659;Riešutėlis;Drugelių;5811657782;Taip;0;1;0;1
8660;Riešutėlis;Drugelių;4221375847;Taip;0;5;0;5
8661;Riešutėlis;Drugelių;1075842434;Taip;4;0;0;4
8662;Riešutėlis;Drugelių;8845709386;Taip;2;2;0;4
8663;Riešutėlis;Drugelių;8128352818;Taip;0;5;0;5
8664;Riešutėlis;Drugelių;8352146446;Taip;0;1;0;1
8665;Riešutėlis;Drugelių;8180618419;Taip;9;4;0;13
8666;Riešutėlis;Drugelių;5412882446;Taip;14;0;0;14
8667;Riešutėlis;Drugelių;8020533200;Taip;5;4;0;9
8668;Riešutėlis;Drugelių;1164273595;Taip;2;2;0;4
8669;Riešutėlis;Drugelių;8918753084;Taip;0;1;0;1
8670;Riešutėlis;Drugelių;3836374000;Taip;0;3;0;3
8671;Riešutėlis;Drugelių;3071643137;Taip;2;0;0;2
8672;Riešutėlis;Drugelių;2599147931;Taip;2;1;0;3
8673;Riešutėlis;Drugelių;3151689985;Taip;2;4;0;6
8674;Riešutėlis;Drugelių;4845447863;Taip;2;3;0;5
8675;Riešutėlis;Drugelių;7225365172;Taip;2;0;0;2
8676;Riešutėlis;Nykštukų;3208422211;Taip;19;0;0;19
8677;Riešutėlis;Nykštukų;9445000826;Taip;11;12;0;23
8678;Riešutėlis;Nykštukų;2133207806;Taip;9;0;0;9
8679;Riešutėlis;Nykštukų;2965742701;Taip;5;1;0;6
8680;Riešutėlis;Nykštukų;8965323622;Taip;5;1;0;6
8681;Riešutėlis;Nykštukų;3304849985;Taip;10;0;0;10
8682;Riešutėlis;Nykštukų;4996921259;Taip;8;0;0;8
8683;Riešutėlis;Nykštukų;2380936705;Taip;5;1;0;6
8684;Riešutėlis;Nykštukų;1227857842;Taip;3;5;0;8
8685;Riešutėlis;Nykštukų;8857997445;Taip;15;2;0;17
8686;Riešutėlis;Nykštukų;5296617022;Taip;10;0;0;10
8687;Riešutėlis;Nykštukų;9445150366;Taip;3;3;0;6
8688;Riešutėlis;Nykštukų;9977733313;Taip;18;4;0;22
8689;Riešutėlis;Nykštukų;4746769566;Taip;6;0;0;6
8690;Riešutėlis;Nykštukų;9415334673;Taip;15;5;0;20
8691;Ramunėlė;SAULUTĖS;3852734401;Taip;1;1;0;2
8692;Ramunėlė;SAULUTĖS;1192743154;Taip;5;7;0;12
8693;Ramunėlė;SAULUTĖS;5714771643;Taip;0;6;0;6
8694;Ramunėlė;SAULUTĖS;1483391590;Taip;0;4;0;4
8695;Ramunėlė;SAULUTĖS;4209191105;Taip;0;1;0;1
8696;Ramunėlė;SAULUTĖS;9927068798;Taip;12;5;0;17
8697;Ramunėlė;SAULUTĖS;7219400182;Taip;11;9;0;20
8698;Ramunėlė;SAULUTĖS;3779769727;Taip;0;6;0;6
8699;Ramunėlė;SAULUTĖS;8912978935;Taip;0;5;0;5
8700;Ramunėlė;SAULUTĖS;1618282165;Taip;0;4;1;5
8701;Ramunėlė;SAULUTĖS;9533155706;Taip;1;0;0;1
8702;Ramunėlė;SAULUTĖS;3109623760;Taip;6;0;0;6
8703;Ramunėlė;SAULUTĖS;6329943991;Taip;11;5;0;16
8704;Ramunėlė;SAULUTĖS;4677819736;Taip;1;6;0;7
8705;Ramunėlė;SAULUTĖS;6310921755;Taip;0;5;0;5
8706;Ramunėlė;SAULUTĖS;1568531299;Taip;0;4;1;5
8707;Ramunėlė;SAULUTĖS;4605161267;Taip;0;7;0;7
8708;Ramunėlė;ŽIBUTĖ;4715809064;Taip;0;4;0;4
8709;Ramunėlė;ŽIBUTĖ;5315953299;Taip;0;2;0;2
8710;Ramunėlė;ŽIBUTĖ;2173425836;Taip;0;1;0;1
8711;Ramunėlė;ŽIBUTĖ;2686455030;Taip;0;1;0;1
8712;Ramunėlė;ŽIBUTĖ;5650659504;Taip;0;5;0;5
8713;Ramunėlė;ŽIBUTĖ;6627399830;Taip;0;1;0;1
8714;Ramunėlė;ŽIBUTĖ;8726443989;Taip;0;2;0;2
8715;Ramunėlė;ŽIBUTĖ;5801760033;Taip;5;0;0;5
8716;Ramunėlė;ŽIBUTĖ;6389008823;Taip;5;2;0;7
8717;Ramunėlė;ŽIBUTĖ;9136437288;Taip;6;4;0;10
8718;Ramunėlė;ŽIBUTĖ;6040461460;Taip;3;2;0;5
8719;Ramunėlė;ŽIBUTĖ;2605941371;Taip;0;2;0;2
8720;Ramunėlė;ŽIBUTĖ;7010828978;Taip;0;5;0;5
8721;Ramunėlė;ŽIBUTĖ;3879563193;Taip;0;5;0;5
8722;Ramunėlė;ŽIBUTĖ;2591052434;Taip;0;1;0;1
8723;Ramunėlė;ŽIBUTĖ;2446375037;Taip;5;6;0;11
8724;Ramunėlė;ŽIBUTĖ;1671759939;Taip;0;4;0;4
8725;Ramunėlė;ŽIBUTĖ;5304803880;Taip;0;6;0;6
8726;Ramunėlė;ŽIBUTĖ;8055844166;Taip;7;2;0;9
8727;Ramunėlė;ŽIRNIUKAI;7721421570;Ne;2;8;0;10
8728;Ramunėlė;ŽIRNIUKAI;8942483792;Taip;26;0;0;26
8729;Ramunėlė;ŽIRNIUKAI;6674467484;Taip;0;23;0;23
8730;Ramunėlė;ŽIRNIUKAI;7593855877;Taip;4;2;0;6
8731;Ramunėlė;ŽIRNIUKAI;2177200537;Taip;0;1;0;1
8732;Ramunėlė;ŽIRNIUKAI;7026935746;Taip;0;6;0;6
8733;Ramunėlė;ŽIRNIUKAI;5581693652;Ne;19;4;0;23
8734;Ramunėlė;ŽIRNIUKAI;4269170508;Taip;4;0;1;5
8735;Ramunėlė;ŽIRNIUKAI;7263195574;Taip;1;4;0;5
8736;Ramunėlė;ŽIRNIUKAI;4076525701;Taip;13;0;0;13
8737;Ramunėlė;ŽIRNIUKAI;4139935502;Taip;9;0;1;10
8738;Ramunėlė;ŽIRNIUKAI;1833069020;Taip;4;1;0;5
8739;Ramunėlė;ŽIRNIUKAI;4875011312;Taip;10;9;0;19
8740;Ramunėlė;ŽIRNIUKAI;4084046207;Taip;5;1;0;6
8741;Ramunėlė;ŽIRNIUKAI;5017020616;Taip;0;5;0;5
8742;Ramunėlė;ŽIRNIUKAI;6458458913;Taip;1;2;0;3
8743;Ramunėlė;ŽIRNIUKAI;6225605784;Taip;7;1;0;8
8744;Ramunėlė;ŽIRNIUKAI;4805808663;Ne;0;2;0;2
8745;Ramunėlė;ŽIRNIUKAI;7250951221;Taip;13;8;0;21
8746;Ramunėlė;BITUTĖS;5865482869;Taip;0;17;0;17
8747;Ramunėlė;BITUTĖS;7692958269;Taip;9;0;0;9
8748;Ramunėlė;BITUTĖS;1182350830;Taip;6;0;0;6
8749;Ramunėlė;BITUTĖS;6342801407;Taip;11;4;0;15
8750;Ramunėlė;BITUTĖS;4022818032;Taip;5;5;0;10
8751;Ramunėlė;BITUTĖS;1916520056;Taip;0;11;0;11
8752;Ramunėlė;BITUTĖS;2245564567;Taip;2;2;0;4
8753;Ramunėlė;BITUTĖS;6870110390;Taip;2;2;0;4
8754;Ramunėlė;BITUTĖS;6892481929;Taip;4;1;0;5
8755;Ramunėlė;BITUTĖS;6881228078;Taip;0;16;0;16
8756;Ramunėlė;BITUTĖS;9326288662;Taip;0;1;0;1
8757;Ramunėlė;BITUTĖS;3045477012;Taip;7;6;0;13
8758;Ramunėlė;BITUTĖS;8643188779;Taip;27;0;0;27
8759;Ramunėlė;BITUTĖS;3106987206;Taip;4;0;0;4
8760;Ramunėlė;BITUTĖS;1797997937;Taip;9;0;0;9
8761;Ramunėlė;BITUTĖS;4329292281;Taip;19;0;0;19
8762;Ramunėlė;BITUTĖS;9928703066;Taip;0;1;0;1
8763;Ramunėlė;BITUTĖS;4756689520;Taip;4;7;0;11
8764;Ramunėlė;DRUGELIAI;9984243153;Taip;4;4;0;8
8765;Ramunėlė;DRUGELIAI;4392309015;Taip;8;7;2;17
8766;Ramunėlė;DRUGELIAI;5049415445;Taip;6;7;0;13
8767;Ramunėlė;DRUGELIAI;8460527225;Taip;0;4;0;4
8768;Ramunėlė;DRUGELIAI;6809164145;Taip;7;6;0;13
8769;Ramunėlė;DRUGELIAI;6981729247;Taip;11;5;0;16
8770;Ramunėlė;DRUGELIAI;3683181174;Taip;0;1;0;1
8771;Ramunėlė;DRUGELIAI;7364976547;Taip;0;1;0;1
8772;Ramunėlė;DRUGELIAI;6156792400;Taip;0;7;0;7
8773;Ramunėlė;DRUGELIAI;2983986428;Taip;4;10;0;14
8774;Ramunėlė;DRUGELIAI;5548358138;Taip;1;1;0;2
8775;Ramunėlė;DRUGELIAI;2427399083;Ne;0;3;1;4
8776;Ramunėlė;DRUGELIAI;8623311748;Taip;0;1;0;1
8777;Ramunėlė;DRUGELIAI;6849205606;Taip;2;0;0;2
8778;Ramunėlė;DRUGELIAI;2422656007;Taip;0;14;0;14
8779;Ramunėlė;DRUGELIAI;7829765488;Taip;0;0;1;1
8780;Ramunėlė;DRUGELIAI;5153948802;Taip;4;12;0;16
8781;Ramunėlė;DRUGELIAI;4233978236;Taip;0;10;0;10
8782;Ramunėlė;DRUGELIAI;2558296296;Taip;6;0;0;6
8783;Ramunėlė;NEUŽMIRŠTUOLĖS;2070729684;Taip;0;4;0;4
8784;Ramunėlė;NEUŽMIRŠTUOLĖS;6613469006;Taip;0;15;0;15
8785;Ramunėlė;NEUŽMIRŠTUOLĖS;9012749913;Taip;3;12;0;15
8786;Ramunėlė;NEUŽMIRŠTUOLĖS;1728034615;Taip;0;1;0;1
8787;Ramunėlė;NEUŽMIRŠTUOLĖS;1579527330;Taip;0;3;0;3
8788;Ramunėlė;NEUŽMIRŠTUOLĖS;7519551613;Taip;0;7;0;7
8789;Ramunėlė;NEUŽMIRŠTUOLĖS;2880352109;Taip;5;0;0;5
8790;Ramunėlė;NEUŽMIRŠTUOLĖS;3949246652;Taip;16;0;0;16
8791;Ramunėlė;NEUŽMIRŠTUOLĖS;5267145991;Ne;0;7;0;7
8792;Ramunėlė;NEUŽMIRŠTUOLĖS;1181787182;Taip;2;0;0;2
8793;Ramunėlė;NEUŽMIRŠTUOLĖS;9374972014;Taip;0;3;0;3
8794;Ramunėlė;NEUŽMIRŠTUOLĖS;6849227110;Taip;3;4;0;7
8795;Ramunėlė;NEUŽMIRŠTUOLĖS;3792795591;Taip;0;2;0;2
8796;Ramunėlė;NEUŽMIRŠTUOLĖS;4862989594;Taip;0;1;0;1
8797;Ramunėlė;NEUŽMIRŠTUOLĖS;9758688249;Ne;9;0;0;9
8798;Ramunėlė;NEUŽMIRŠTUOLĖS;9945561827;Taip;7;0;0;7
8799;Ramunėlė;OBUOLIUKAI;6604244856;Taip;5;0;0;5
8800;Ramunėlė;OBUOLIUKAI;8617271247;Taip;0;11;0;11
8801;Ramunėlė;OBUOLIUKAI;6413888803;Taip;0;3;0;3
8802;Ramunėlė;OBUOLIUKAI;5610672420;Taip;3;2;0;5
8803;Ramunėlė;OBUOLIUKAI;9861069932;Taip;0;5;0;5
8804;Ramunėlė;OBUOLIUKAI;4806844761;Taip;23;0;0;23
8805;Ramunėlė;OBUOLIUKAI;7639613472;Taip;14;1;0;15
8806;Ramunėlė;OBUOLIUKAI;4040520907;Taip;1;4;0;5
8807;Ramunėlė;OBUOLIUKAI;5573083546;Taip;10;0;0;10
8808;Ramunėlė;OBUOLIUKAI;1215510902;Taip;6;4;0;10
8809;Ramunėlė;OBUOLIUKAI;8218201930;Taip;28;0;0;28
8810;Ramunėlė;OBUOLIUKAI;2760710235;Taip;5;0;0;5
8811;Ramunėlė;OBUOLIUKAI;4788062781;Taip;0;2;0;2
8812;Ramunėlė;OBUOLIUKAI;3166386231;Taip;4;6;0;10
8813;Ramunėlė;OBUOLIUKAI;4642590173;Taip;0;1;0;1
8814;Ramunėlė;OBUOLIUKAI;4491147309;Taip;20;0;0;20
8815;Ramunėlė;OBUOLIUKAI;9549605315;Taip;4;1;0;5
8816;Ramunėlė;OBUOLIUKAI;1277413234;Taip;0;2;0;2
8817;Ramunėlė;SAULĖGRĄŽA;2458101652;Taip;0;9;0;9
8818;Ramunėlė;SAULĖGRĄŽA;9663304288;Taip;2;0;0;2
8819;Ramunėlė;SAULĖGRĄŽA;5398069413;Taip;1;0;0;1
8820;Ramunėlė;SAULĖGRĄŽA;7873462803;Taip;11;0;0;11
8821;Ramunėlė;SAULĖGRĄŽA;3793779715;Taip;0;1;0;1
8822;Ramunėlė;SAULĖGRĄŽA;6775947111;Taip;2;0;24;26
8823;Ramunėlė;SAULĖGRĄŽA;1102946363;Taip;14;0;0;14
8824;Ramunėlė;SAULĖGRĄŽA;3801952385;Taip;0;1;0;1
8825;Ramunėlė;SAULĖGRĄŽA;9120142666;Taip;6;0;0;6
8826;Ramunėlė;SAULĖGRĄŽA;6942789511;Taip;0;0;1;1
8827;Ramunėlė;SAULĖGRĄŽA;2415377154;Taip;0;10;0;10
8828;Ramunėlė;SAULĖGRĄŽA;9076692864;Taip;2;4;0;6
8829;Ramunėlė;SAULĖGRĄŽA;3744140961;Taip;0;4;0;4
8830;Ramunėlė;SAULĖGRĄŽA;4177116924;Taip;4;0;0;4
8831;Ramunėlė;SAULĖGRĄŽA;1071166494;Taip;2;6;0;8
8832;Ramunėlė;SAULĖGRĄŽA;9656732273;Taip;2;0;1;3
8833;Ramunėlė;SAULĖGRĄŽA;6983139076;Taip;10;0;0;10
8834;Ramunėlė;SAULĖGRĄŽA;8045080504;Taip;7;5;0;12
8835;Ramunėlė;BORUŽĖLĖS;1818513881;Taip;13;4;0;17
8836;Ramunėlė;BORUŽĖLĖS;4581826404;Taip;8;0;0;8
8837;Ramunėlė;BORUŽĖLĖS;8310875815;Taip;3;3;0;6
8838;Ramunėlė;BORUŽĖLĖS;1491688322;Taip;0;6;0;6
8839;Ramunėlė;BORUŽĖLĖS;6606966969;Taip;2;4;0;6
8840;Ramunėlė;BORUŽĖLĖS;5703289545;Taip;6;0;0;6
8841;Ramunėlė;BORUŽĖLĖS;4968998913;Taip;9;0;0;9
8842;Ramunėlė;BORUŽĖLĖS;9292235402;Taip;6;0;0;6
8843;Ramunėlė;BORUŽĖLĖS;3996453947;Taip;0;2;0;2
8844;Ramunėlė;BORUŽĖLĖS;3461269451;Taip;0;1;0;1
8845;Ramunėlė;BORUŽĖLĖS;3474578046;Taip;7;3;0;10
8846;Ramunėlė;BORUŽĖLĖS;7544671346;Taip;3;4;0;7
8847;Ramunėlė;BORUŽĖLĖS;6433856416;Taip;0;17;0;17
8848;Ramunėlė;BORUŽĖLĖS;3542912372;Taip;16;1;0;17
8849;Ramunėlė;BORUŽĖLĖS;1159457001;Taip;3;3;0;6
8850;Ramunėlė;BORUŽĖLĖS;3735308599;Taip;6;4;0;10
8851;Ramunėlė;BORUŽĖLĖS;3272747656;Taip;1;0;0;1
8852;Ramunėlė;BORUŽĖLĖS;1811931985;Taip;0;2;0;2
8853;Ramunėlė;NYKŠTUKAS;7542328641;Taip;7;0;0;7
8854;Ramunėlė;NYKŠTUKAS;1802650607;Taip;10;0;0;10
8855;Ramunėlė;NYKŠTUKAS;7715458376;Taip;13;0;1;14
8856;Ramunėlė;NYKŠTUKAS;2874729290;Taip;8;0;0;8
8857;Ramunėlė;NYKŠTUKAS;1212737814;Taip;0;1;0;1
8858;Ramunėlė;NYKŠTUKAS;5011852981;Taip;8;0;0;8
8859;Ramunėlė;NYKŠTUKAS;7049941095;Taip;10;0;0;10
8860;Ramunėlė;NYKŠTUKAS;7958270513;Taip;10;0;0;10
8861;Ramunėlė;NYKŠTUKAS;9005050527;Taip;14;0;0;14
8862;Ramunėlė;NYKŠTUKAS;2521516332;Taip;21;0;0;21
8863;Ramunėlė;NYKŠTUKAS;7248072779;Taip;6;3;0;9
8864;Ramunėlė;UOGELĖ;9765904825;Taip;7;0;0;7
8865;Ramunėlė;UOGELĖ;5934414699;Taip;7;1;0;8
8866;Ramunėlė;UOGELĖ;3097478921;Taip;8;5;0;13
8867;Ramunėlė;UOGELĖ;1962502699;Taip;21;0;0;21
8868;Ramunėlė;UOGELĖ;2652236809;Taip;2;0;0;2
8869;Ramunėlė;UOGELĖ;9603368652;Taip;14;0;0;14
8870;Ramunėlė;UOGELĖ;5468189903;Taip;10;0;0;10
8871;Ramunėlė;UOGELĖ;9834640538;Taip;5;0;0;5
8872;Ramunėlė;UOGELĖ;3838004754;Taip;7;2;0;9
8873;Ramunėlė;UOGELĖ;3037286125;Taip;9;0;0;9
8874;Ramunėlė;UOGELĖ;5196627958;Taip;0;11;0;11
8875;Ramunėlė;UOGELĖ;1346734609;Taip;5;0;0;5
8876;Ramunėlė;UOGELĖ;8538153845;Taip;10;21;0;31
8877;Ramunėlė;VARPELIAI;8023404173;Taip;19;0;0;19
8878;Ramunėlė;VARPELIAI;7005354909;Taip;0;3;0;3
8879;Ramunėlė;VARPELIAI;5665429647;Taip;2;2;0;4
8880;Ramunėlė;VARPELIAI;4946797276;Taip;0;2;0;2
8881;Ramunėlė;VARPELIAI;9180197156;Taip;4;0;0;4
8882;Ramunėlė;VARPELIAI;5108864184;Taip;0;1;0;1
8883;Ramunėlė;VARPELIAI;4321527067;Taip;4;4;0;8
8884;Ramunėlė;VARPELIAI;2202879286;Taip;3;2;0;5
8885;Ramunėlė;VARPELIAI;1666033483;Taip;16;2;0;18
8886;Ramunėlė;VARPELIAI;7896711579;Taip;0;4;3;7
8887;Ramunėlė;VARPELIAI;9994601365;Taip;19;2;0;21
8888;Ramunėlė;VARPELIAI;2620747378;Taip;5;0;2;7
8889;Ramunėlė;VARPELIAI;5726947811;Taip;0;1;0;1
8890;Ramunėlė;VARPELIAI;4171905362;Taip;0;3;0;3
8891;Ramunėlė;VARPELIAI;8764042799;Taip;0;3;0;3
8892;Ramunėlė;VARPELIAI;7926168752;Taip;20;0;0;20
8893;Ramunėlė;VARPELIAI;5498856861;Taip;8;0;0;8
8894;Ramunėlė;VARPELIAI;3024065664;Taip;5;5;0;10
8895;Ramunėlė;VARPELIAI;4397072823;Taip;8;0;3;11
8896;Ramunėlė;VARPELIAI;3793699824;Taip;0;1;0;1
8897;Rūta;SMALSUČIAI;2601011765;Taip;11;0;5;16
8898;Rūta;SMALSUČIAI;5902965224;Taip;0;4;2;6
8899;Rūta;SMALSUČIAI;5579794648;Taip;0;11;0;11
8900;Rūta;SMALSUČIAI;7837861265;Taip;0;2;0;2
8901;Rūta;SMALSUČIAI;9471291067;Taip;11;0;0;11
8902;Rūta;SMALSUČIAI;4165080541;Taip;0;0;1;1
8903;Rūta;SMALSUČIAI;8012225409;Taip;9;0;1;10
8904;Rūta;SMALSUČIAI;3877807687;Taip;9;0;0;9
8905;Rūta;SMALSUČIAI;8483916287;Taip;0;0;1;1
8906;Rūta;SMALSUČIAI;1290867375;Taip;0;14;0;14
8907;Rūta;SMALSUČIAI;4780828296;Taip;6;0;1;7
8908;Rūta;SMALSUČIAI;7724451685;Taip;8;1;0;9
8909;Rūta;SMALSUČIAI;8320791295;Taip;1;2;0;3
8910;Rūta;SMALSUČIAI;3109709043;Taip;10;0;1;11
8911;Rūta;SMALSUČIAI;2733932207;Taip;0;5;0;5
8912;Rūta;SMALSUČIAI;3498596516;Taip;4;0;0;4
8913;Rūta;KŪLVERSTUKAI;5002760763;Taip;5;0;0;5
8914;Rūta;KŪLVERSTUKAI;4440148328;Taip;6;5;0;11
8915;Rūta;KŪLVERSTUKAI;1059126758;Taip;0;6;0;6
8916;Rūta;KŪLVERSTUKAI;6417693659;Taip;5;4;0;9
8917;Rūta;KŪLVERSTUKAI;3352007694;Taip;0;2;0;2
8918;Rūta;KŪLVERSTUKAI;4090915728;Taip;0;1;0;1
8919;Rūta;KŪLVERSTUKAI;4466522924;Taip;6;4;0;10
8920;Rūta;KŪLVERSTUKAI;7905893575;Taip;13;1;0;14
8921;Rūta;KŪLVERSTUKAI;4776631890;Taip;7;0;0;7
8922;Rūta;KŪLVERSTUKAI;4436482805;Taip;0;2;0;2
8923;Rūta;KŪLVERSTUKAI;1260386759;Taip;8;1;0;9
8924;Rūta;KŪLVERSTUKAI;4208678278;Taip;4;1;0;5
8925;Rūta;KŪLVERSTUKAI;6044060646;Taip;2;1;0;3
8926;Rūta;KŪLVERSTUKAI;1671179652;Taip;5;4;0;9
8927;Rūta;KŪLVERSTUKAI;1152453609;Taip;2;0;0;2
8928;Rūta;KŪLVERSTUKAI;3081348981;Taip;0;1;0;1
8929;Rūta;KODĖLČIUKAI;4347678781;Taip;0;0;4;4
8930;Rūta;KODĖLČIUKAI;8416455711;Taip;0;5;0;5
8931;Rūta;KODĖLČIUKAI;2547849837;Taip;0;4;0;4
8932;Rūta;KODĖLČIUKAI;9501101073;Taip;13;0;3;16
8933;Rūta;KODĖLČIUKAI;8883578144;Taip;5;0;4;9
8934;Rūta;KODĖLČIUKAI;4546082355;Taip;0;8;0;8
8935;Rūta;KODĖLČIUKAI;1000645885;Taip;10;0;0;10
8936;Rūta;KODĖLČIUKAI;5766392854;Taip;5;9;0;14
8937;Rūta;KODĖLČIUKAI;9916296056;Taip;0;0;1;1
8938;Rūta;KODĖLČIUKAI;1605412505;Taip;8;0;0;8
8939;Rūta;KODĖLČIUKAI;4533816630;Taip;0;3;0;3
8940;Rūta;KODĖLČIUKAI;8455941633;Taip;5;0;0;5
8941;Rūta;KODĖLČIUKAI;8120157087;Ne;6;0;0;6
8942;Rūta;BORUŽĖLĖS;7712500278;Ne;0;2;3;5
8943;Rūta;BORUŽĖLĖS;8945868791;Taip;14;0;2;16
8944;Rūta;BORUŽĖLĖS;3348066709;Taip;1;0;1;2
8945;Rūta;BORUŽĖLĖS;4279367893;Taip;5;0;1;6
8946;Rūta;BORUŽĖLĖS;5141290453;Taip;7;0;0;7
8947;Rūta;BORUŽĖLĖS;8303314520;Taip;6;0;0;6
8948;Rūta;BORUŽĖLĖS;3470052541;Taip;11;4;0;15
8949;Rūta;BORUŽĖLĖS;2625691851;Taip;4;0;0;4
8950;Rūta;BORUŽĖLĖS;1804222979;Taip;4;10;0;14
8951;Rūta;BORUŽĖLĖS;5624054621;Ne;4;0;1;5
8952;Rūta;BORUŽĖLĖS;6853057649;Taip;1;0;0;1
8953;Rūta;BORUŽĖLĖS;2373746441;Taip;0;1;0;1
8954;Rūta;BORUŽĖLĖS;2724625200;Taip;1;0;0;1
8955;Rūta;BORUŽĖLĖS;2118244290;Taip;4;0;0;4
8956;Rūta;BORUŽĖLĖS;2492891254;Taip;8;0;3;11
8957;Rūta;BORUŽĖLĖS;4204930257;Taip;0;0;2;2
8958;Rūta;VYTURĖLIAI;7680605199;Taip;0;0;5;5
8959;Rūta;VYTURĖLIAI;6075632046;Taip;6;0;2;8
8960;Rūta;VYTURĖLIAI;9386595365;Taip;0;0;4;4
8961;Rūta;VYTURĖLIAI;7649756034;Taip;0;0;1;1
8962;Rūta;VYTURĖLIAI;5899860543;Taip;0;2;0;2
8963;Rūta;VYTURĖLIAI;1346124133;Taip;7;5;0;12
8964;Rūta;VYTURĖLIAI;4728904136;Taip;0;9;0;9
8965;Rūta;VYTURĖLIAI;9791861646;Taip;0;1;0;1
8966;Rūta;VYTURĖLIAI;2928803089;Taip;0;6;0;6
8967;Rūta;VYTURĖLIAI;8378318357;Taip;0;1;0;1
8968;Rūta;VYTURĖLIAI;1951202550;Taip;0;13;0;13
8969;Rūta;VYTURĖLIAI;3875136625;Taip;3;4;1;8
8970;Rūta;VYTURĖLIAI;9911151238;Taip;0;1;0;1
8971;Rūta;VYTURĖLIAI;1035527190;Taip;5;4;1;10
8972;Rūta;VYTURĖLIAI;3843325181;Ne;0;1;3;4
8973;Rūta;VYTURĖLIAI;8182243701;Taip;0;1;0;1
8974;Rūta;VYTURĖLIAI;8763382361;Taip;9;4;2;15
8975;Rūta;"PABIRUČIAI (LOGOPEDINĖ)";5211104903;Taip;9;4;0;13
8976;Rūta;"PABIRUČIAI (LOGOPEDINĖ)";1734479058;Taip;3;0;2;5
8977;Rūta;"PABIRUČIAI (LOGOPEDINĖ)";2164103114;Taip;13;0;0;13
8978;Rūta;"PABIRUČIAI (LOGOPEDINĖ)";4271185150;Taip;6;0;0;6
8979;Rūta;"PABIRUČIAI (LOGOPEDINĖ)";6088978998;Taip;5;0;0;5
8980;Rūta;"PABIRUČIAI (LOGOPEDINĖ)";6849928601;Taip;9;0;0;9
8981;Rūta;GUDRUČIAI;4044349935;Taip;8;0;0;8
8982;Rūta;GUDRUČIAI;3998791775;Taip;3;7;0;10
8983;Rūta;GUDRUČIAI;3462986405;Taip;3;0;0;3
8984;Rūta;GUDRUČIAI;8548089843;Taip;3;0;2;5
8985;Rūta;GUDRUČIAI;4293920701;Taip;0;4;0;4
8986;Rūta;GUDRUČIAI;4473591998;Taip;0;4;0;4
8987;Rūta;GUDRUČIAI;3044976169;Taip;0;0;1;1
8988;Rūta;GUDRUČIAI;8273644943;Taip;0;4;0;4
8989;Rūta;GUDRUČIAI;8963959004;Taip;0;3;0;3
8990;Rūta;GUDRUČIAI;1811055786;Taip;0;14;0;14
8991;Rūta;GUDRUČIAI;1510268514;Taip;6;4;0;10
8992;Rūta;GUDRUČIAI;2702537976;Taip;0;4;0;4
8993;Rūta;GUDRUČIAI;2772130413;Taip;0;2;0;2
8994;Rūta;GUDRUČIAI;1623968580;Taip;0;4;1;5
8995;Rūta;GUDRUČIAI;8592528906;Taip;0;0;1;1
8996;Rūta;SEKLYTĖLĖ;4423305209;Taip;0;5;0;5
8997;Rūta;SEKLYTĖLĖ;9245618776;Taip;4;5;0;9
8998;Rūta;SEKLYTĖLĖ;1216786487;Taip;0;7;0;7
8999;Rūta;SEKLYTĖLĖ;9736567509;Taip;0;4;0;4
9000;Rūta;SEKLYTĖLĖ;7222494215;Taip;0;3;0;3
9001;Rūta;SEKLYTĖLĖ;7519931138;Taip;4;5;0;9
9002;Rūta;SEKLYTĖLĖ;4880804625;Taip;0;3;0;3
9003;Rūta;SEKLYTĖLĖ;3055345528;Taip;0;2;0;2
9004;Rūta;SEKLYTĖLĖ;3499727608;Taip;0;7;0;7
9005;Rūta;SEKLYTĖLĖ;9765301038;Taip;0;7;0;7
9006;Rūta;SEKLYTĖLĖ;9638495757;Taip;7;1;0;8
9007;Rūta;SEKLYTĖLĖ;1962172243;Taip;3;1;0;4
9008;Rūta;SEKLYTĖLĖ;8605070655;Taip;0;4;0;4
9009;Rūta;SEKLYTĖLĖ;7553844890;Taip;0;13;0;13
9010;Rūta;SEKLYTĖLĖ;3964922552;Taip;0;6;0;6
9011;Rūta;SEKLYTĖLĖ;8395765508;Taip;4;0;0;4
9012;Rūta;SEKLYTĖLĖ;9400586178;Taip;5;4;0;9
9013;Rūta;SEKLYTĖLĖ;3956912957;Taip;6;1;0;7
9014;Rūta;SEKLYTĖLĖ;2890569107;Taip;7;0;0;7
9015;Rūta;SEKLYTĖLĖ;2474991135;Taip;7;4;0;11
9016;Rūta;"VARPELIAI (LOGOPEDINĖ)";4911219947;Taip;9;0;0;9
9017;Rūta;"VARPELIAI (LOGOPEDINĖ)";9171781646;Taip;7;0;2;9
9018;Rūta;"VARPELIAI (LOGOPEDINĖ)";6221528830;Taip;16;0;0;16
9019;Rūta;"VARPELIAI (LOGOPEDINĖ)";5871960113;Taip;12;4;0;16
9020;Rūta;"VARPELIAI (LOGOPEDINĖ)";3814794448;Taip;0;0;3;3
9021;Rūta;"VARPELIAI (LOGOPEDINĖ)";1029871210;Taip;4;0;0;4
9022;Rūta;"VARPELIAI (LOGOPEDINĖ)";6572172779;Taip;4;0;0;4
9023;Rūta;"VARPELIAI (LOGOPEDINĖ)";1590778538;Taip;0;2;0;2
9024;Rūta;"VARPELIAI (LOGOPEDINĖ)";7946139474;Taip;6;2;0;8
9025;Rūta;"VARPELIAI (LOGOPEDINĖ)";4931253729;Taip;7;3;0;10
9026;Rūta;KIŠKUČIŲ;6587625933;Taip;1;1;0;2
9027;Rūta;KIŠKUČIŲ;9526121339;Taip;12;0;0;12
9028;Rūta;KIŠKUČIŲ;3805738277;Taip;8;0;0;8
9029;Rūta;KIŠKUČIŲ;6019344201;Taip;8;0;0;8
9030;Rūta;KIŠKUČIŲ;4712457100;Taip;10;0;0;10
9031;Rūta;KIŠKUČIŲ;8370305271;Taip;13;1;0;14
9032;Rūta;KIŠKUČIŲ;4244665683;Taip;2;0;2;4
9033;Rūta;KIŠKUČIŲ;1504057906;Taip;0;1;2;3
9034;Rūta;KIŠKUČIŲ;9842173401;Taip;5;4;0;9
9035;Rūta;KIŠKUČIŲ;2895194578;Taip;2;0;0;2
9036;Rūta;KIŠKUČIŲ;1893871283;Taip;0;23;0;23
9037;Rūta;KIŠKUČIŲ;8711505500;Taip;0;2;0;2
9038;Rūta;ŽVIRBLIUKAI;6778088225;Taip;4;2;0;6
9039;Rūta;ŽVIRBLIUKAI;1397028236;Taip;0;0;3;3
9040;Rūta;ŽVIRBLIUKAI;6567603848;Taip;0;0;3;3
9041;Rūta;ŽVIRBLIUKAI;7913626224;Taip;8;0;0;8
9042;Rūta;ŽVIRBLIUKAI;9803391980;Taip;14;4;0;18
9043;Rūta;ŽVIRBLIUKAI;4512761439;Taip;0;2;0;2
9044;Rūta;ŽVIRBLIUKAI;9695283747;Taip;21;0;0;21
9045;Rūta;ŽVIRBLIUKAI;1184265720;Taip;0;0;22;22
9046;Rūta;ŽVIRBLIUKAI;5868983105;Taip;0;1;0;1
9047;Rūta;ŽVIRBLIUKAI;8423092171;Taip;0;0;22;22
9048;Rūta;ŽVIRBLIUKAI;5375565821;Taip;6;0;3;9
9049;Rūta;SAULUTĖS;6585842434;Taip;4;0;3;7
9050;Rūta;SAULUTĖS;8806743371;Taip;3;0;0;3
9051;Rūta;SAULUTĖS;2391120026;Taip;0;5;0;5
9052;Rūta;SAULUTĖS;3765741047;Taip;0;0;1;1
9053;Rūta;SAULUTĖS;7762509383;Taip;0;2;0;2
9054;Rūta;SAULUTĖS;2685515977;Taip;11;6;0;17
9055;Rūta;SAULUTĖS;5512946296;Taip;0;2;0;2
9056;Rūta;SAULUTĖS;9308127402;Taip;5;0;1;6
9057;Rūta;SAULUTĖS;7422059414;Taip;18;4;0;22
9058;Rūta;SAULUTĖS;8479424939;Taip;7;0;1;8
9059;Rūta;SAULUTĖS;9014433476;Taip;0;3;0;3
9060;Rūta;SAULUTĖS;1207463357;Taip;0;0;1;1
9061;Rūta;SAULUTĖS;8715921452;Taip;0;5;0;5
9062;Rūta;SAULUTĖS;9243332756;Taip;9;1;0;10
9063;Sadutė;Kiškučiai;6645848193;Taip;2;0;0;2
9064;Sadutė;Kiškučiai;1589424708;Taip;5;4;0;9
9065;Sadutė;Kiškučiai;5992865266;Taip;1;1;1;3
9066;Sadutė;Kiškučiai;3568132830;Taip;2;0;1;3
9067;Sadutė;Kiškučiai;4360361866;Taip;0;4;0;4
9068;Sadutė;Kiškučiai;2139177648;Taip;10;0;0;10
9069;Sadutė;Kiškučiai;6493110772;Taip;0;0;2;2
9070;Sadutė;Kiškučiai;8397295024;Taip;0;4;0;4
9071;Sadutė;Kiškučiai;4075714061;Taip;0;0;1;1
9072;Sadutė;Kiškučiai;3285448692;Taip;0;1;0;1
9073;Sadutė;Kiškučiai;2845125335;Taip;0;1;0;1
9074;Sadutė;Kiškučiai;4135398332;Taip;6;0;2;8
9075;Sadutė;Kiškučiai;1860645542;Taip;5;0;0;5
9076;Sadutė;Kiškučiai;8841564884;Taip;0;0;3;3
9077;Sadutė;Kiškučiai;8350900604;Taip;12;4;0;16
9078;Sadutė;Kiškučiai;6784030565;Taip;0;0;2;2
9079;Sadutė;Kiškučiai;3510450761;Taip;11;0;2;13
9080;Sadutė;Kiškučiai;2807949826;Taip;0;6;6;12
9081;Sadutė;Boružėlės;9115304973;Taip;0;0;2;2
9082;Sadutė;Boružėlės;8442967732;Taip;4;0;0;4
9083;Sadutė;Boružėlės;1273355194;Taip;0;10;0;10
9084;Sadutė;Boružėlės;3119547420;Taip;0;10;0;10
9085;Sadutė;Boružėlės;8987528237;Taip;0;4;0;4
9086;Sadutė;Boružėlės;6994383907;Taip;7;1;0;8
9087;Sadutė;Boružėlės;8914509685;Taip;9;4;0;13
9088;Sadutė;Boružėlės;3875265137;Taip;12;4;0;16
9089;Sadutė;Boružėlės;5992119777;Taip;0;6;0;6
9090;Sadutė;Boružėlės;5682745869;Taip;8;0;1;9
9091;Sadutė;Boružėlės;7072437339;Taip;1;0;0;1
9092;Sadutė;Boružėlės;3362830536;Taip;7;4;2;13
9093;Sadutė;Boružėlės;5395676303;Taip;3;4;1;8
9094;Sadutė;Boružėlės;1923014145;Taip;0;0;1;1
9095;Sadutė;Boružėlės;5698462283;Taip;5;2;1;8
9096;Sadutė;Boružėlės;3845369333;Taip;7;0;3;10
9097;Sadutė;Boružėlės;8200891038;Taip;3;0;0;3
9098;Sadutė;Boružėlės;4696990344;Ne;0;6;0;6
9099;Sadutė;Boružėlės;1753849762;Taip;4;0;4;8
9100;Sadutė;Boružėlės;7580736252;Taip;4;0;2;6
9101;Sadutė;Bitutės;1759479328;Taip;0;5;4;9
9102;Sadutė;Bitutės;1975767401;Taip;0;1;0;1
9103;Sadutė;Bitutės;4245873513;Taip;2;0;0;2
9104;Sadutė;Bitutės;1873928395;Taip;0;0;3;3
9105;Sadutė;Bitutės;4883934480;Taip;6;3;0;9
9106;Sadutė;Bitutės;7097653016;Taip;4;3;0;7
9107;Sadutė;Bitutės;4479315578;Taip;3;2;0;5
9108;Sadutė;Bitutės;2020766695;Taip;0;23;0;23
9109;Sadutė;Bitutės;5011320850;Taip;0;0;2;2
9110;Sadutė;Bitutės;4161502667;Taip;7;0;0;7
9111;Sadutė;Bitutės;5973513916;Taip;0;1;7;8
9112;Sadutė;Bitutės;3361904803;Taip;0;0;2;2
9113;Sadutė;Bitutės;1231048342;Taip;0;3;0;3
9114;Sadutė;Bitutės;6066145909;Taip;0;8;2;10
9115;Sadutė;Bitutės;5142566738;Taip;6;4;3;13
9116;Sadutė;Bitutės;8662375739;Taip;3;0;0;3
9117;Sadutė;Bitutės;9107727583;Taip;3;0;0;3
9118;Sadutė;Bitutės;6138604955;Taip;8;1;0;9
9119;Sadutė;Bitutės;3339522259;Taip;0;0;1;1
9120;Sadutė;Bitutės;9005989501;Taip;6;0;0;6
9121;Sadutė;Drugeliai;2965270548;Taip;18;0;0;18
9122;Sadutė;Drugeliai;7533550197;Taip;6;4;0;10
9123;Sadutė;Drugeliai;8308487263;Taip;1;4;0;5
9124;Sadutė;Drugeliai;6039555589;Taip;13;0;0;13
9125;Sadutė;Drugeliai;4862514558;Taip;7;0;0;7
9126;Sadutė;Drugeliai;4866469773;Taip;0;23;0;23
9127;Sadutė;Drugeliai;4062325464;Taip;1;1;0;2
9128;Sadutė;Drugeliai;3450873020;Taip;9;0;0;9
9129;Sadutė;Drugeliai;5133144667;Taip;4;0;0;4
9130;Sadutė;Drugeliai;9224321056;Taip;5;0;0;5
9131;Sadutė;Drugeliai;3895799244;Taip;0;12;0;12
9132;Sadutė;Drugeliai;1907291315;Taip;6;0;0;6
9133;Sadutė;Drugeliai;3337178609;Taip;5;0;0;5
9134;Sadutė;Drugeliai;3540727678;Taip;18;0;0;18
9135;Sadutė;Pėledžiukai;5616756293;Taip;12;0;0;12
9136;Sadutė;Pėledžiukai;2705458480;Taip;14;0;0;14
9137;Sadutė;Pėledžiukai;6314488650;Taip;0;1;4;5
9138;Sadutė;Pėledžiukai;6126235707;Taip;2;4;2;8
9139;Sadutė;Pėledžiukai;1537482438;Taip;0;0;1;1
9140;Sadutė;Pėledžiukai;6716550703;Taip;6;0;0;6
9141;Sadutė;Pėledžiukai;7551299839;Taip;5;0;0;5
9142;Sadutė;Pėledžiukai;8914706717;Taip;8;0;0;8
9143;Sadutė;Pėledžiukai;6379705269;Taip;5;0;3;8
9144;Sadutė;Pėledžiukai;5385678913;Taip;0;1;2;3
9145;Sadutė;Pėledžiukai;2747256989;Taip;1;0;1;2
9146;Sadutė;Pėledžiukai;3277826759;Taip;2;0;0;2
9147;Sadutė;Pėledžiukai;4791750087;Taip;2;0;0;2
9148;Sadutė;Pėledžiukai;2003300961;Taip;0;5;0;5
9149;Sadutė;Pėledžiukai;5580870821;Taip;8;0;0;8
9150;Sadutė;Pėledžiukai;6430493524;Taip;14;0;0;14
9151;Sadutė;Pėledžiukai;1510498753;Taip;14;0;0;14
9152;Sadutė;Kačiukų;1903961488;Taip;0;4;4;8
9153;Sadutė;Kačiukų;2890916313;Taip;5;4;0;9
9154;Sadutė;Kačiukų;2733633163;Taip;0;1;0;1
9155;Sadutė;Kačiukų;8835627470;Taip;0;4;0;4
9156;Sadutė;Kačiukų;2532626934;Taip;0;5;0;5
9157;Sadutė;Kačiukų;2466024649;Taip;0;4;0;4
9158;Sadutė;Kačiukų;2426974464;Taip;0;4;0;4
9159;Sadutė;Kačiukų;8974374101;Taip;3;4;0;7
9160;Sadutė;Kačiukų;4401870028;Taip;0;4;0;4
9161;Sadutė;Kačiukų;8714168144;Taip;0;9;0;9
9162;Sadutė;Kačiukų;3927044011;Taip;0;1;0;1
9163;Sadutė;Kačiukų;8974225608;Taip;0;4;0;4
9164;Sadutė;Kačiukų;8770727233;Taip;0;4;0;4
9165;Sadutė;Kačiukų;8556218971;Taip;0;1;0;1
9166;Sadutė;Kačiukų;5267093203;Taip;5;4;13;22
9167;Sadutė;Kačiukų;5614758320;Taip;0;16;0;16
9168;Sadutė;Kačiukų;2194387139;Taip;0;1;0;1
9169;Sakalėlis;GIRINUKŲ;6597274376;Taip;0;1;0;1
9170;Sakalėlis;GIRINUKŲ;5500248048;Taip;0;0;1;1
9171;Sakalėlis;GIRINUKŲ;8562164673;Ne;0;1;0;1
9172;Sakalėlis;GIRINUKŲ;3719351129;Taip;0;1;0;1
9173;Sakalėlis;GIRINUKŲ;3570413330;Taip;4;0;4;8
9174;Sakalėlis;GIRINUKŲ;6889888573;Taip;0;0;4;4
9175;Sakalėlis;GIRINUKŲ;5465596207;Taip;1;0;0;1
9176;Sakalėlis;GIRINUKŲ;7852255204;Taip;6;0;0;6
9177;Sakalėlis;GIRINUKŲ;1253452975;Taip;0;0;2;2
9178;Sakalėlis;GIRINUKŲ;7480286509;Taip;0;0;1;1
9179;Sakalėlis;GIRINUKŲ;2250828607;Taip;6;1;1;8
9180;Sakalėlis;GIRINUKŲ;2672429406;Taip;6;1;1;8
9181;Sakalėlis;GIRINUKŲ;2233966176;Taip;13;0;3;16
9182;Sakalėlis;GIRINUKŲ;7079300418;Taip;15;0;0;15
9183;Sakalėlis;GIRINUKŲ;6851247779;Taip;4;0;0;4
9184;Sakalėlis;GIRINUKŲ;8501785305;Taip;2;0;0;2
9185;Sakalėlis;GIRINUKŲ;2649804066;Taip;1;0;1;2
9186;Sakalėlis;GIRINUKŲ;6996901033;Taip;3;0;0;3
9187;Sakalėlis;VYTURIUKŲ;3927487265;Taip;0;5;0;5
9188;Sakalėlis;VYTURIUKŲ;2352118061;Taip;5;0;0;5
9189;Sakalėlis;VYTURIUKŲ;3680732318;Taip;1;4;0;5
9190;Sakalėlis;VYTURIUKŲ;4862004373;Taip;3;0;0;3
9191;Sakalėlis;VYTURIUKŲ;8422299669;Ne;0;3;0;3
9192;Sakalėlis;VYTURIUKŲ;6579827280;Taip;0;2;2;4
9193;Sakalėlis;VYTURIUKŲ;8381310908;Taip;0;12;0;12
9194;Sakalėlis;VYTURIUKŲ;6840368824;Taip;0;1;0;1
9195;Sakalėlis;VYTURIUKŲ;1742362136;Taip;1;4;0;5
9196;Sakalėlis;VYTURIUKŲ;5795250727;Taip;0;9;2;11
9197;Sakalėlis;VYTURIUKŲ;2985239904;Taip;5;4;0;9
9198;Sakalėlis;VYTURIUKŲ;3351218789;Taip;3;0;0;3
9199;Sakalėlis;VYTURIUKŲ;9120873899;Ne;0;3;7;10
9200;Sakalėlis;VYTURIUKŲ;4136266629;Taip;0;2;7;9
9201;Sakalėlis;VYTURIUKŲ;5991029760;Taip;10;1;1;12
9202;Sakalėlis;VYTURIUKŲ;1736303381;Taip;0;3;6;9
9203;Sakalėlis;VYTURIUKŲ;1200252225;Taip;5;1;0;6
9204;Sakalėlis;VYTURIUKŲ;7280513854;Taip;4;0;0;4
9205;Sakalėlis;VYTURIUKŲ;1806698668;Taip;2;4;2;8
9206;Sakalėlis;DRUGELIŲ;8095359035;Taip;3;0;3;6
9207;Sakalėlis;DRUGELIŲ;6515519140;Taip;0;4;1;5
9208;Sakalėlis;DRUGELIŲ;5911341542;Taip;3;0;0;3
9209;Sakalėlis;DRUGELIŲ;9272347788;Taip;11;0;0;11
9210;Sakalėlis;DRUGELIŲ;8331612396;Taip;0;0;1;1
9211;Sakalėlis;DRUGELIŲ;2898006208;Taip;2;0;0;2
9212;Sakalėlis;DRUGELIŲ;7542322748;Taip;13;0;0;13
9213;Sakalėlis;DRUGELIŲ;4918228191;Taip;7;0;1;8
9214;Sakalėlis;DRUGELIŲ;1201086815;Taip;8;0;0;8
9215;Sakalėlis;DRUGELIŲ;3934295338;Taip;12;0;1;13
9216;Sakalėlis;DRUGELIŲ;1117800518;Taip;11;0;0;11
9217;Sakalėlis;DRUGELIŲ;2515169899;Taip;2;4;0;6
9218;Sakalėlis;DRUGELIŲ;8160589611;Taip;6;0;0;6
9219;Sakalėlis;DRUGELIŲ;9836193857;Taip;8;0;0;8
9220;Sakalėlis;DRUGELIŲ;4004006771;Taip;0;4;0;4
9221;Sakalėlis;DRUGELIŲ;1833573491;Taip;10;0;1;11
9222;Sakalėlis;DRUGELIŲ;8713298648;Taip;0;0;1;1
9223;Sakalėlis;DRUGELIŲ;2889638745;Taip;0;4;1;5
9224;Sakalėlis;DRUGELIŲ;7540098033;Taip;4;0;1;5
9225;Sakalėlis;DRUGELIŲ;7285833058;Taip;0;4;0;4
9226;Sakalėlis;GENIUKŲ;1004062550;Taip;2;0;0;2
9227;Sakalėlis;GENIUKŲ;5865993835;Taip;6;1;1;8
9228;Sakalėlis;GENIUKŲ;2003090775;Taip;2;0;2;4
9229;Sakalėlis;GENIUKŲ;8228039819;Taip;7;0;0;7
9230;Sakalėlis;GENIUKŲ;4633296169;Taip;2;0;0;2
9231;Sakalėlis;GENIUKŲ;4611384179;Taip;10;2;1;13
9232;Sakalėlis;GENIUKŲ;4490632523;Taip;10;0;0;10
9233;Sakalėlis;GENIUKŲ;8868588637;Taip;14;0;1;15
9234;Sakalėlis;GENIUKŲ;8015985605;Taip;8;0;0;8
9235;Sakalėlis;GENIUKŲ;5052638078;Taip;9;0;0;9
9236;Sakalėlis;GENIUKŲ;5327382009;Taip;9;0;0;9
9237;Sakalėlis;GENIUKŲ;6897550418;Taip;3;0;0;3
9238;Sakalėlis;GENIUKŲ;9642519454;Taip;0;4;2;6
9239;Sakalėlis;GENIUKŲ;6300266321;Taip;0;4;0;4
9240;Sakalėlis;GENIUKŲ;8796728627;Taip;0;13;0;13
9241;Sakalėlis;GENIUKŲ;8659925528;Taip;13;0;0;13
9242;Sakalėlis;VOVERIUKŲ;5172421763;Taip;0;0;6;6
9243;Sakalėlis;VOVERIUKŲ;5233697077;Taip;4;0;1;5
9244;Sakalėlis;VOVERIUKŲ;6414564366;Taip;20;0;0;20
9245;Sakalėlis;VOVERIUKŲ;4358313171;Taip;9;0;0;9
9246;Sakalėlis;VOVERIUKŲ;1873392718;Taip;5;0;0;5
9247;Sakalėlis;VOVERIUKŲ;6806170544;Taip;0;0;2;2
9248;Sakalėlis;VOVERIUKŲ;2557089391;Taip;11;0;1;12
9249;Sakalėlis;VOVERIUKŲ;8133985842;Taip;0;0;1;1
9250;Sakalėlis;VOVERIUKŲ;3574956316;Taip;0;2;0;2
9251;Sakalėlis;VOVERIUKŲ;1403384561;Taip;12;0;1;13
9252;Sakalėlis;VOVERIUKŲ;3927363997;Taip;0;3;0;3
9253;Sakalėlis;VOVERIUKŲ;6293226507;Taip;8;0;0;8
9254;Sakalėlis;VOVERIUKŲ;2699844937;Taip;2;4;0;6
9255;Sakalėlis;VOVERIUKŲ;1669610397;Taip;7;0;7;14
9256;Sakalėlis;VOVERIUKŲ;6016854405;Taip;0;1;0;1
9257;Sakalėlis;VOVERIUKŲ;2575873447;Taip;0;0;1;1
9258;Sakalėlis;VOVERIUKŲ;3217646353;Taip;0;2;0;2
9259;Sakalėlis;PĖLEDŽIUKŲ;2474164013;Ne;0;1;0;1
9260;Sakalėlis;PĖLEDŽIUKŲ;3165387995;Taip;0;4;3;7
9261;Sakalėlis;PĖLEDŽIUKŲ;6603105354;Taip;0;0;1;1
9262;Sakalėlis;PĖLEDŽIUKŲ;3418702674;Taip;0;0;1;1
9263;Sakalėlis;PĖLEDŽIUKŲ;3748865437;Taip;7;3;0;10
9264;Sakalėlis;PĖLEDŽIUKŲ;3333037807;Taip;2;0;0;2
9265;Sakalėlis;PĖLEDŽIUKŲ;8606714134;Taip;0;3;1;4
9266;Sakalėlis;PĖLEDŽIUKŲ;4596727938;Taip;2;0;0;2
9267;Sakalėlis;PĖLEDŽIUKŲ;1347171934;Taip;0;4;0;4
9268;Sakalėlis;PĖLEDŽIUKŲ;8790189865;Taip;0;0;1;1
9269;Sakalėlis;PĖLEDŽIUKŲ;6217643065;Ne;2;2;2;6
9270;Sakalėlis;PĖLEDŽIUKŲ;4344537391;Taip;0;0;2;2
9271;Sakalėlis;PĖLEDŽIUKŲ;9368758708;Ne;10;4;0;14
9272;Sakalėlis;PĖLEDŽIUKŲ;4576495786;Taip;0;2;8;10
9273;Sakalėlis;"BITUČIŲ (LOGOPEDINĖ)";3938470708;Taip;1;0;0;1
9274;Sakalėlis;"BITUČIŲ (LOGOPEDINĖ)";3079900548;Taip;1;0;0;1
9275;Sakalėlis;"BITUČIŲ (LOGOPEDINĖ)";8638720071;Taip;13;0;0;13
9276;Sakalėlis;"BITUČIŲ (LOGOPEDINĖ)";4442027941;Ne;7;0;0;7
9277;Sakalėlis;"BITUČIŲ (LOGOPEDINĖ)";1208798798;Taip;1;0;0;1
9278;Sakalėlis;"BITUČIŲ (LOGOPEDINĖ)";2748400429;Taip;3;1;0;4
9279;Sakalėlis;"BORUŽIUKŲ (LOGOPEDINĖ)";2124857941;Taip;0;2;0;2
9280;Sakalėlis;"BORUŽIUKŲ (LOGOPEDINĖ)";6250400609;Taip;0;0;3;3
9281;Sakalėlis;"BORUŽIUKŲ (LOGOPEDINĖ)";6222204020;Taip;0;0;3;3
9282;Sakalėlis;"BORUŽIUKŲ (LOGOPEDINĖ)";7602249339;Taip;0;0;1;1
9283;Sakalėlis;"BORUŽIUKŲ (LOGOPEDINĖ)";8263169658;Taip;0;2;3;5
9284;Sakalėlis;"BORUŽIUKŲ (LOGOPEDINĖ)";9776767584;Taip;0;0;1;1
9285;Sakalėlis;"BORUŽIUKŲ (LOGOPEDINĖ)";7620944079;Taip;4;4;0;8
9286;Sakalėlis;"BORUŽIUKŲ (LOGOPEDINĖ)";2732572235;Taip;16;0;0;16
9287;Sakalėlis;"BORUŽIUKŲ (LOGOPEDINĖ)";5677280944;Taip;4;0;6;10
9288;Sakalėlis;MEŠKUČIŲ;9546779717;Taip;22;0;0;22
9289;Sakalėlis;MEŠKUČIŲ;8535457018;Taip;6;3;0;9
9290;Sakalėlis;MEŠKUČIŲ;4813561523;Taip;9;0;2;11
9291;Sakalėlis;MEŠKUČIŲ;7154383856;Taip;4;0;0;4
9292;Sakalėlis;MEŠKUČIŲ;5082756444;Taip;4;0;0;4
9293;Sakalėlis;MEŠKUČIŲ;7839893402;Taip;5;0;0;5
9294;Sakalėlis;MEŠKUČIŲ;3092760315;Taip;5;4;0;9
9295;Sakalėlis;MEŠKUČIŲ;3524545708;Taip;0;7;0;7
9296;Sakalėlis;MEŠKUČIŲ;5961207419;Taip;1;0;0;1
9297;Sakalėlis;MEŠKUČIŲ;2389541483;Taip;9;3;0;12
9298;Sakalėlis;MEŠKUČIŲ;4063074948;Taip;10;0;0;10
9299;Sakalėlis;MEŠKUČIŲ;8108456923;Taip;0;0;2;2
9300;Sakalėlis;MEŠKUČIŲ;7285230768;Taip;7;4;0;11
9301;Sakalėlis;MEŠKUČIŲ;8888784168;Taip;0;2;0;2
9302;Sakalėlis;MEŠKUČIŲ;2090313887;Ne;0;5;0;5
9303;Sakalėlis;MEŠKUČIŲ;9794245922;Taip;4;0;4;8
9304;Sakalėlis;MEŠKUČIŲ;8106231242;Taip;6;0;0;6
9305;Sakalėlis;MEŠKUČIŲ;4520212128;Taip;0;8;0;8
9306;Sakalėlis;MEŠKUČIŲ;7228559861;Taip;0;12;1;13
9307;Sakalėlis;MEŠKUČIŲ;8000744698;Taip;4;0;0;4
9308;Sakalėlis;KIŠKUČIŲ;6029443196;Taip;4;12;1;17
9309;Sakalėlis;KIŠKUČIŲ;8036737782;Taip;0;12;8;20
9310;Sakalėlis;KIŠKUČIŲ;9621137382;Taip;7;0;1;8
9311;Sakalėlis;KIŠKUČIŲ;3941949117;Taip;4;0;0;4
9312;Sakalėlis;KIŠKUČIŲ;2117073621;Taip;0;0;2;2
9313;Sakalėlis;KIŠKUČIŲ;7796882816;Taip;2;0;2;4
9314;Sakalėlis;KIŠKUČIŲ;8788790889;Taip;0;0;4;4
9315;Sakalėlis;KIŠKUČIŲ;1270977572;Taip;13;0;1;14
9316;Sakalėlis;KIŠKUČIŲ;1213702668;Taip;4;0;0;4
9317;Sakalėlis;KIŠKUČIŲ;6682017840;Taip;11;0;1;12
9318;Sakalėlis;KIŠKUČIŲ;1913818905;Taip;6;0;2;8
9319;Sakalėlis;KIŠKUČIŲ;1969584481;Taip;19;0;2;21
9320;Sakalėlis;KIŠKUČIŲ;7764732694;Taip;0;3;0;3
9321;Sakalėlis;KIŠKUČIŲ;8461873822;Taip;0;2;0;2
9322;Sakalėlis;KIŠKUČIŲ;9172210601;Taip;0;2;0;2
9323;Sakalėlis;SVIRPLIUKŲ;1981444595;Taip;9;0;0;9
9324;Sakalėlis;SVIRPLIUKŲ;8562206323;Taip;5;0;0;5
9325;Sakalėlis;SVIRPLIUKŲ;5494452779;Taip;11;0;0;11
9326;Sakalėlis;SVIRPLIUKŲ;3294479203;Taip;19;0;0;19
9327;Sakalėlis;SVIRPLIUKŲ;9423279756;Taip;8;0;0;8
9328;Sakalėlis;SVIRPLIUKŲ;3205403024;Taip;14;0;0;14
9329;Sakalėlis;SVIRPLIUKŲ;1172937572;Taip;0;0;1;1
9330;Sakalėlis;SVIRPLIUKŲ;3963251786;Taip;2;0;3;5
9331;Sakalėlis;SVIRPLIUKŲ;8386308690;Taip;3;1;0;4
9332;Sakalėlis;SVIRPLIUKŲ;9410185441;Taip;10;0;0;10
9333;Sakalėlis;SVIRPLIUKŲ;8959937912;Taip;4;0;1;5
9334;Sakalėlis;SVIRPLIUKŲ;5649630720;Taip;1;0;0;1
9335;Sakalėlis;SVIRPLIUKŲ;5740175023;Taip;0;0;10;10
9336;Sakalėlis;SVIRPLIUKŲ;6476563646;Taip;13;0;0;13
9337;Sakalėlis;SVIRPLIUKŲ;8162876482;Taip;1;0;0;1
9338;Sakalėlis;GANDRIUKŲ;8502289806;Taip;0;4;0;4
9339;Sakalėlis;GANDRIUKŲ;7384400795;Taip;0;7;1;8
9340;Sakalėlis;GANDRIUKŲ;3644413861;Taip;3;5;0;8
9341;Sakalėlis;GANDRIUKŲ;4230762388;Taip;14;0;0;14
9342;Sakalėlis;GANDRIUKŲ;3228617971;Taip;0;0;2;2
9343;Sakalėlis;GANDRIUKŲ;5748438461;Taip;0;0;1;1
9344;Sakalėlis;GANDRIUKŲ;2734462553;Taip;2;0;2;4
9345;Sakalėlis;GANDRIUKŲ;2481285439;Taip;0;0;2;2
9346;Sakalėlis;GANDRIUKŲ;7345113972;Taip;0;1;0;1
9347;Sakalėlis;GANDRIUKŲ;6069544792;Taip;0;0;5;5
9348;Sakalėlis;GANDRIUKŲ;5460619168;Ne;0;0;2;2
9349;Sakalėlis;GANDRIUKŲ;1560077883;Taip;0;0;1;1
9350;Sakalėlis;GANDRIUKŲ;5387119771;Taip;18;0;0;18
9351;Sakalėlis;GANDRIUKŲ;9599801230;Taip;13;0;0;13
9352;Sakalėlis;GANDRIUKŲ;3611884072;Taip;0;0;7;7
9353;Sakalėlis;GANDRIUKŲ;7321913487;Taip;0;0;2;2
9354;Sakalėlis;GANDRIUKŲ;1820886350;Taip;16;0;1;17
9355;Sakalėlis;GANDRIUKŲ;4307106905;Taip;0;0;2;2
9356;Sakalėlis;GANDRIUKŲ;2889517278;Taip;10;0;0;10
9357;Salininkų;BORUŽIUKAI;1315946153;Taip;4;0;1;5
9358;Salininkų;BORUŽIUKAI;4251420816;Taip;0;7;0;7
9359;Salininkų;BORUŽIUKAI;4753007411;Taip;0;6;0;6
9360;Salininkų;BORUŽIUKAI;5023856698;Taip;10;0;0;10
9361;Salininkų;BORUŽIUKAI;9802972916;Taip;0;10;1;11
9362;Salininkų;BORUŽIUKAI;1198469626;Taip;7;0;1;8
9363;Salininkų;BORUŽIUKAI;3168392325;Taip;4;1;0;5
9364;Salininkų;BORUŽIUKAI;6477136976;Taip;19;0;0;19
9365;Salininkų;BORUŽIUKAI;6903692351;Taip;4;0;0;4
9366;Salininkų;BORUŽIUKAI;8049341629;Taip;5;0;1;6
9367;Salininkų;BORUŽIUKAI;7022231494;Taip;9;0;0;9
9368;Salininkų;BORUŽIUKAI;4866786238;Taip;12;0;0;12
9369;Salininkų;BORUŽIUKAI;3710734769;Taip;0;1;0;1
9370;Salininkų;GĖLYTĖS;8718514114;Taip;0;11;0;11
9371;Salininkų;GĖLYTĖS;8329495685;Taip;6;0;0;6
9372;Salininkų;GĖLYTĖS;8930622266;Taip;0;1;0;1
9373;Salininkų;GĖLYTĖS;5447236646;Taip;10;2;0;12
9374;Salininkų;GĖLYTĖS;8911016037;Taip;9;0;0;9
9375;Salininkų;GĖLYTĖS;5045064069;Taip;4;0;0;4
9376;Salininkų;GĖLYTĖS;1647401700;Taip;10;1;0;11
9377;Salininkų;GĖLYTĖS;9817285587;Taip;3;0;0;3
9378;Salininkų;GĖLYTĖS;2146404021;Taip;0;3;0;3
9379;Salininkų;GĖLYTĖS;8823595510;Taip;0;1;0;1
9380;Salininkų;GĖLYTĖS;9416926474;Taip;0;4;0;4
9381;Salininkų;GĖLYTĖS;1005025619;Taip;0;10;0;10
9382;Salininkų;GĖLYTĖS;9855014750;Taip;4;0;0;4
9383;Salininkų;GĖLYTĖS;1254843449;Taip;6;4;0;10
9384;Salininkų;GĖLYTĖS;6315595048;Taip;8;0;0;8
9385;Salininkų;GĖLYTĖS;3231379271;Taip;5;2;0;7
9386;Salininkų;GĖLYTĖS;1346133493;Taip;6;0;0;6
9387;Salininkų;GĖLYTĖS;2273407270;Taip;5;0;0;5
9388;Salininkų;GĖLYTĖS;2056560837;Taip;13;0;0;13
9389;Salininkų;DRUGELIAI;2684868661;Taip;8;0;0;8
9390;Salininkų;DRUGELIAI;4333027447;Taip;4;0;0;4
9391;Salininkų;DRUGELIAI;3115232507;Taip;1;3;0;4
9392;Salininkų;DRUGELIAI;2009246885;Taip;0;0;2;2
9393;Salininkų;DRUGELIAI;3420217477;Taip;10;0;0;10
9394;Salininkų;DRUGELIAI;3890914603;Taip;0;6;0;6
9395;Salininkų;DRUGELIAI;3181932118;Taip;1;1;0;2
9396;Salininkų;DRUGELIAI;5017068344;Taip;0;1;1;2
9397;Salininkų;DRUGELIAI;3761217912;Taip;3;15;0;18
9398;Salininkų;DRUGELIAI;2208607684;Taip;0;10;0;10
9399;Salininkų;DRUGELIAI;3963410827;Taip;0;8;0;8
9400;Salininkų;DRUGELIAI;5539560359;Taip;2;3;3;8
9401;Salininkų;DRUGELIAI;5587577036;Ne;5;0;0;5
9402;Salininkų;DRUGELIAI;5375668400;Taip;0;4;0;4
9403;Salininkų;DRUGELIAI;4529253958;Taip;0;2;1;3
9404;Salininkų;DRUGELIAI;5583804491;Taip;11;0;1;12
9405;Salininkų;DRUGELIAI;7063718023;Taip;6;0;5;11
9406;Salininkų;DRUGELIAI;9018366347;Taip;11;0;0;11
9407;Salininkų;ŽIRNIUKAI;7643665643;Taip;0;2;0;2
9408;Salininkų;ŽIRNIUKAI;9198411540;Taip;0;4;0;4
9409;Salininkų;ŽIRNIUKAI;6885580632;Taip;0;9;0;9
9410;Salininkų;ŽIRNIUKAI;7409604480;Taip;0;1;0;1
9411;Salininkų;ŽIRNIUKAI;3677558828;Taip;0;3;0;3
9412;Salininkų;ŽIRNIUKAI;8095820690;Taip;0;1;0;1
9413;Salininkų;ŽIRNIUKAI;6482437251;Taip;0;7;0;7
9414;Salininkų;ŽIRNIUKAI;1380797788;Taip;0;4;0;4
9415;Salininkų;ŽIRNIUKAI;2495782496;Taip;0;6;7;13
9416;Salininkų;ŽIRNIUKAI;9896357816;Taip;10;2;0;12
9417;Salininkų;ŽIRNIUKAI;4568462071;Taip;5;0;3;8
9418;Salininkų;ŽIRNIUKAI;9137783249;Ne;0;1;0;1
9419;Salininkų;ŽIRNIUKAI;8524400656;Ne;0;1;0;1
9420;Salininkų;ŽIRNIUKAI;7463713798;Taip;0;2;0;2
9421;Salininkų;ŽIRNIUKAI;9617873735;Taip;8;0;0;8
9422;Salininkų;ŽIRNIUKAI;1111197633;Taip;0;1;0;1
9423;Salininkų;ŽIRNIUKAI;6143967744;Taip;0;4;0;4
9424;Salininkų;ŽIRNIUKAI;8552427446;Taip;11;0;0;11
9425;Salininkų;ŽIRNIUKAI;6586988786;Taip;8;0;0;8
9426;Salininkų;ŽIRNIUKAI;1587485662;Taip;0;2;0;2
9427;Salininkų;ŽIRNIUKAI;9611858211;Taip;7;0;0;7
9428;Salininkų;PAUKŠČIUKAI;2895782373;Taip;2;2;0;4
9429;Salininkų;PAUKŠČIUKAI;4971070998;Taip;0;0;1;1
9430;Salininkų;PAUKŠČIUKAI;9893985732;Taip;7;0;0;7
9431;Salininkų;PAUKŠČIUKAI;1284909139;Taip;4;0;0;4
9432;Salininkų;PAUKŠČIUKAI;9892443649;Taip;0;4;0;4
9433;Salininkų;PAUKŠČIUKAI;5164367382;Taip;4;0;0;4
9434;Salininkų;PAUKŠČIUKAI;3338213592;Taip;0;4;0;4
9435;Salininkų;PAUKŠČIUKAI;6506819265;Taip;0;6;0;6
9436;Salininkų;PAUKŠČIUKAI;6510096414;Taip;0;3;0;3
9437;Salininkų;PAUKŠČIUKAI;2491796874;Taip;1;0;0;1
9438;Salininkų;PAUKŠČIUKAI;2440831687;Taip;0;12;0;12
9439;Salininkų;PAUKŠČIUKAI;2726813574;Taip;3;0;0;3
9440;Salininkų;PAUKŠČIUKAI;8141168894;Taip;12;1;0;13
9441;Salininkų;PAUKŠČIUKAI;2798153926;Taip;0;1;0;1
9442;Salininkų;PAUKŠČIUKAI;8602489420;Taip;0;9;0;9
9443;Salininkų;PAUKŠČIUKAI;1453214735;Taip;0;4;0;4
9444;Salininkų;PAUKŠČIUKAI;8336855920;Taip;6;0;0;6
9445;Salininkų;BITUTĖS;3252151974;Taip;11;1;0;12
9446;Salininkų;BITUTĖS;6845471044;Taip;4;0;2;6
9447;Salininkų;BITUTĖS;9902751686;Taip;0;2;0;2
9448;Salininkų;BITUTĖS;6125152143;Taip;0;4;0;4
9449;Salininkų;BITUTĖS;2095952937;Taip;0;4;0;4
9450;Salininkų;BITUTĖS;6551489987;Taip;0;3;0;3
9451;Salininkų;BITUTĖS;5582091833;Taip;0;4;0;4
9452;Salininkų;BITUTĖS;9996809930;Taip;4;0;3;7
9453;Salininkų;BITUTĖS;3915336062;Taip;11;2;0;13
9454;Salininkų;BITUTĖS;7115888747;Taip;0;0;1;1
9455;Salininkų;BITUTĖS;2370778977;Taip;3;0;1;4
9456;Salininkų;BITUTĖS;1020073382;Taip;0;0;2;2
9457;Salininkų;BITUTĖS;4480303856;Ne;0;5;0;5
9458;Salininkų;BITUTĖS;7383557807;Taip;0;4;0;4
9459;Salvija;Daigelis(šatil);8337554678;Taip;4;0;2;6
9460;Salvija;Daigelis(šatil);5805537864;Taip;0;2;0;2
9461;Salvija;Daigelis(šatil);6323383244;Taip;4;7;0;11
9462;Salvija;Daigelis(šatil);1043297837;Taip;9;0;0;9
9463;Salvija;Daigelis(šatil);3857916185;Taip;4;0;4;8
9464;Salvija;Daigelis(šatil);4719344565;Taip;4;0;0;4
9465;Salvija;Daigelis(šatil);1168900211;Taip;2;0;2;4
9466;Salvija;Daigelis(šatil);7410091250;Taip;2;0;0;2
9467;Salvija;Daigelis(šatil);5761622263;Taip;8;0;0;8
9468;Salvija;Daigelis(šatil);6797777730;Taip;4;0;0;4
9469;Salvija;Daigelis(šatil);1850688392;Taip;0;0;1;1
9470;Salvija;Daigelis(šatil);2959140033;Taip;11;2;0;13
9471;Salvija;Daigelis(šatil);9129939185;Taip;4;0;0;4
9472;Salvija;Daigelis(šatil);2161008233;Taip;1;0;0;1
9473;Salvija;Daigelis(šatil);6690635579;Taip;0;0;2;2
9474;Salvija;Daigelis(šatil);1959861292;Taip;10;0;0;10
9475;Salvija;Daigelis(šatil);6260496597;Taip;17;0;1;18
9476;Salvija;"Pienė (savjon)";8981331532;Taip;5;4;3;12
9477;Salvija;"Pienė (savjon)";8013023311;Taip;0;1;2;3
9478;Salvija;"Pienė (savjon)";7477171133;Taip;10;0;0;10
9479;Salvija;"Pienė (savjon)";8853389268;Taip;0;8;0;8
9480;Salvija;"Pienė (savjon)";7862619996;Ne;0;12;2;14
9481;Salvija;"Pienė (savjon)";3487446998;Taip;2;0;0;2
9482;Salvija;"Pienė (savjon)";9456556523;Taip;0;4;0;4
9483;Salvija;"Pienė (savjon)";5816893736;Taip;3;0;4;7
9484;Salvija;"Pienė (savjon)";5327735648;Taip;14;0;0;14
9485;Salvija;"Pienė (savjon)";4665919836;Taip;0;0;1;1
9486;Salvija;"Pienė (savjon)";4577248630;Taip;5;4;0;9
9487;Salvija;"Pienė (savjon)";1509182157;Taip;0;0;2;2
9488;Salvija;"Pienė (savjon)";6509829735;Taip;0;0;2;2
9489;Salvija;"Pienė (savjon)";1062662192;Taip;0;0;1;1
9490;Salvija;"Pienė (savjon)";9978634888;Taip;5;4;0;9
9491;Salvija;"Pienė (savjon)";1511271658;Taip;2;0;0;2
9492;Saulėtekis;BERŽELIS;3493175211;Taip;0;9;0;9
9493;Saulėtekis;BERŽELIS;8086451893;Taip;15;0;0;15
9494;Saulėtekis;BERŽELIS;9351122147;Taip;5;0;0;5
9495;Saulėtekis;BERŽELIS;6667804855;Taip;0;2;2;4
9496;Saulėtekis;BERŽELIS;5468364505;Taip;2;0;0;2
9497;Saulėtekis;BERŽELIS;4704426104;Taip;4;0;1;5
9498;Saulėtekis;BERŽELIS;7407540257;Taip;1;0;2;3
9499;Saulėtekis;BERŽELIS;6920619390;Taip;2;0;0;2
9500;Saulėtekis;BERŽELIS;5194925689;Taip;10;4;0;14
9501;Saulėtekis;BERŽELIS;2672108464;Ne;16;0;0;16
9502;Saulėtekis;BERŽELIS;9579088485;Taip;6;1;0;7
9503;Saulėtekis;BERŽELIS;7436158953;Taip;8;0;1;9
9504;Saulėtekis;BERŽELIS;7165739418;Taip;4;0;1;5
9505;Saulėtekis;BERŽELIS;1917500190;Taip;5;5;0;10
9506;Saulėtekis;BERŽELIS;2935641362;Taip;10;0;0;10
9507;Saulėtekis;BERŽELIS;4676218435;Taip;4;0;2;6
9508;Saulėtekis;BERŽELIS;7598254324;Taip;4;0;1;5
9509;Saulėtekis;BERŽELIS;8468491266;Taip;9;1;0;10
9510;Saulėtekis;BERŽELIS;6181992249;Taip;1;0;0;1
9511;Saulėtekis;BERŽELIS;5824537129;Taip;15;4;0;19
9512;Saulėtekis;BERŽELIS;8427457478;Taip;10;0;0;10
9513;Saulėtekis;ŠYPSENA;8331205443;Taip;19;0;0;19
9514;Saulėtekis;ŠYPSENA;4975294724;Taip;20;0;1;21
9515;Saulėtekis;ŠYPSENA;2946991447;Taip;4;0;0;4
9516;Saulėtekis;ŠYPSENA;7780877703;Taip;4;2;0;6
9517;Saulėtekis;ŠYPSENA;2282128335;Taip;7;0;1;8
9518;Saulėtekis;ŠYPSENA;7759917109;Taip;3;0;0;3
9519;Saulėtekis;ŠYPSENA;3306250980;Taip;5;0;2;7
9520;Saulėtekis;ŠYPSENA;4391887095;Taip;3;0;0;3
9521;Saulėtekis;ŠYPSENA;1278985938;Taip;6;0;0;6
9522;Saulėtekis;ŠYPSENA;4765756650;Taip;20;0;0;20
9523;Saulėtekis;ŠYPSENA;8173628625;Taip;2;0;0;2
9524;Saulėtekis;ŠYPSENA;1237869114;Taip;8;10;0;18
9525;Saulėtekis;ŠYPSENA;1515580716;Taip;9;1;0;10
9526;Saulėtekis;ŠYPSENA;6831161042;Taip;9;1;0;10
9527;Saulėtekis;ŠYPSENA;4433821698;Taip;6;0;0;6
9528;Saulėtekis;NYKŠTUKAI;7849181976;Taip;9;0;0;9
9529;Saulėtekis;NYKŠTUKAI;5748816813;Taip;12;0;0;12
9530;Saulėtekis;NYKŠTUKAI;7555273745;Taip;10;0;0;10
9531;Saulėtekis;NYKŠTUKAI;1416983683;Taip;3;3;0;6
9532;Saulėtekis;NYKŠTUKAI;4758423356;Taip;1;4;0;5
9533;Saulėtekis;NYKŠTUKAI;9270109327;Taip;0;4;0;4
9534;Saulėtekis;NYKŠTUKAI;5183297420;Taip;10;3;0;13
9535;Saulėtekis;NYKŠTUKAI;8007704080;Taip;11;0;0;11
9536;Saulėtekis;NYKŠTUKAI;8683571534;Taip;8;0;0;8
9537;Saulėtekis;NYKŠTUKAI;9481578412;Taip;12;0;0;12
9538;Saulėtekis;NYKŠTUKAI;8167740525;Taip;15;0;0;15
9539;Saulėtekis;NYKŠTUKAI;7273354670;Taip;11;0;0;11
9540;Saulėtekis;NYKŠTUKAI;3371045145;Taip;10;0;0;10
9541;Saulėtekis;NYKŠTUKAI;9818660340;Taip;6;5;0;11
9542;Saulėtekis;NYKŠTUKAI;3729811521;Taip;0;3;0;3
9543;Saulėtekis;NYKŠTUKAI;5888979911;Taip;0;8;0;8
9544;Saulėtekis;NYKŠTUKAI;8090571664;Taip;0;4;0;4
9545;Saulėtekis;NYKŠTUKAI;9104549419;Ne;7;0;0;7
9546;Saulėtekis;NYKŠTUKAI;3957655772;Taip;5;4;0;9
9547;Saulėtekis;NYKŠTUKAI;1331793286;Taip;15;2;0;17
9548;Saulėtekis;NYKŠTUKAI;8927598999;Taip;18;0;0;18
9549;Saulėtekis;PAGRANDUKAS;8098047919;Taip;8;3;0;11
9550;Saulėtekis;PAGRANDUKAS;8240764949;Taip;9;0;1;10
9551;Saulėtekis;PAGRANDUKAS;6763015593;Taip;10;4;0;14
9552;Saulėtekis;PAGRANDUKAS;5970957754;Taip;11;0;0;11
9553;Saulėtekis;PAGRANDUKAS;5252265065;Taip;13;0;0;13
9554;Saulėtekis;PAGRANDUKAS;3903728416;Taip;11;4;1;16
9555;Saulėtekis;PAGRANDUKAS;3096623181;Taip;13;0;0;13
9556;Saulėtekis;PAGRANDUKAS;6029401583;Taip;19;4;0;23
9557;Saulėtekis;PAGRANDUKAS;5321135231;Taip;10;0;0;10
9558;Saulėtekis;PAGRANDUKAS;6008705995;Taip;0;4;3;7
9559;Saulėtekis;PAGRANDUKAS;5173602064;Taip;0;2;0;2
9560;Saulėtekis;PAGRANDUKAS;3142594542;Taip;0;2;0;2
9561;Saulėtekis;PAGRANDUKAS;1734813803;Taip;5;2;0;7
9562;Saulėtekis;PAGRANDUKAS;6966791665;Taip;4;4;0;8
9563;Saulėtekis;PAGRANDUKAS;7293735126;Taip;3;4;0;7
9564;Saulėtekis;PAGRANDUKAS;4066394876;Taip;0;3;0;3
9565;Saulėtekis;PAGRANDUKAS;9575338070;Taip;7;0;0;7
9566;Saulėtekis;RAMUNĖLIŲ;8739919774;Taip;0;7;0;7
9567;Saulėtekis;RAMUNĖLIŲ;4681031693;Taip;6;0;2;8
9568;Saulėtekis;RAMUNĖLIŲ;2316817605;Taip;0;4;2;6
9569;Saulėtekis;RAMUNĖLIŲ;3987535802;Taip;0;1;0;1
9570;Saulėtekis;RAMUNĖLIŲ;6979741482;Taip;0;0;2;2
9571;Saulėtekis;RAMUNĖLIŲ;8348456528;Taip;3;4;0;7
9572;Saulėtekis;RAMUNĖLIŲ;3430209353;Taip;8;0;0;8
9573;Saulėtekis;RAMUNĖLIŲ;5980690239;Taip;0;4;0;4
9574;Saulėtekis;RAMUNĖLIŲ;2786112846;Ne;0;4;0;4
9575;Saulėtekis;RAMUNĖLIŲ;8876580678;Ne;0;4;0;4
9576;Saulėtekis;RAMUNĖLIŲ;1427323748;Taip;9;0;0;9
9577;Saulėtekis;RAMUNĖLIŲ;3224110585;Taip;18;0;0;18
9578;Saulėtekis;RAMUNĖLIŲ;2002180753;Taip;13;4;1;18
9579;Saulėtekis;RAMUNĖLIŲ;9668125862;Taip;4;0;3;7
9580;Saulėtekis;RAMUNĖLIŲ;4736430248;Taip;8;2;2;12
9581;Saulėtekis;RAMUNĖLIŲ;1108736588;Taip;14;0;0;14
9582;Saulėtekis;RAMUNĖLIŲ;3680199463;Taip;8;4;1;13
9583;Saulėtekis;RAMUNĖLIŲ;2383861394;Taip;4;4;0;8
9584;Saulėtekis;RAMUNĖLIŲ;2872732978;Taip;6;0;1;7
9585;Saulėtekis;RAMUNĖLIŲ;9732352141;Taip;4;0;0;4
9586;Saulėtekis;RAMUNĖLIŲ;7494641077;Taip;0;7;0;7
9587;Saulėtekis;RAMUNĖLIŲ;1577609727;Taip;0;7;0;7
9588;Saulėtekis;PASAKAITĖ;8033763960;Taip;0;1;0;1
9589;Saulėtekis;PASAKAITĖ;9428709415;Taip;0;0;1;1
9590;Saulėtekis;PASAKAITĖ;5086871001;Taip;8;4;0;12
9591;Saulėtekis;PASAKAITĖ;2446282019;Taip;0;1;0;1
9592;Saulėtekis;PASAKAITĖ;8572701238;Taip;3;0;0;3
9593;Saulėtekis;PASAKAITĖ;6063956790;Taip;13;3;0;16
9594;Saulėtekis;PASAKAITĖ;4437540996;Taip;0;2;0;2
9595;Saulėtekis;PASAKAITĖ;9226317303;Taip;5;3;0;8
9596;Saulėtekis;PASAKAITĖ;9267790598;Taip;4;2;0;6
9597;Saulėtekis;PASAKAITĖ;6670590135;Taip;3;0;0;3
9598;Saulėtekis;PASAKAITĖ;6720758829;Taip;3;0;0;3
9599;Saulėtekis;PASAKAITĖ;7966714585;Taip;7;4;0;11
9600;Saulėtekis;PASAKAITĖ;3224883243;Taip;7;0;0;7
9601;Saulėtekis;PASAKAITĖ;9382031144;Taip;5;7;0;12
9602;Saulėtekis;PASAKAITĖ;3371914339;Taip;5;6;0;11
9603;Saulėtekis;PASAKAITĖ;6214539956;Taip;5;7;0;12
9604;Saulėtekis;PASAKAITĖ;9584556476;Taip;5;4;0;9
9605;Saulėtekis;PASAKAITĖ;9799880235;Taip;0;6;0;6
9606;Saulėtekis;PASAKAITĖ;3499575148;Taip;5;0;0;5
9607;Saulėtekis;PASAKAITĖ;2206038658;Taip;9;0;0;9
9608;Saulėtekis;PASAKAITĖ;7826554599;Taip;10;1;0;11
9609;Saulėtekis;VARPELIAI;3303064486;Taip;10;5;2;17
9610;Saulėtekis;VARPELIAI;8195320453;Taip;2;0;0;2
9611;Saulėtekis;VARPELIAI;5997903066;Taip;4;0;0;4
9612;Saulėtekis;VARPELIAI;9383203972;Taip;3;0;0;3
9613;Saulėtekis;VARPELIAI;5870177112;Taip;1;0;0;1
9614;Saulėtekis;VARPELIAI;7171550857;Taip;10;0;0;10
9615;Saulėtekis;VARPELIAI;3157110037;Taip;0;4;0;4
9616;Saulėtekis;VARPELIAI;8331659142;Taip;17;0;0;17
9617;Saulėtekis;VARPELIAI;1479530265;Taip;2;4;1;7
9618;Saulėtekis;VARPELIAI;1164913351;Taip;2;3;0;5
9619;Saulėtekis;VARPELIAI;3499215193;Taip;7;0;1;8
9620;Saulėtekis;VARPELIAI;5165684803;Taip;0;0;1;1
9621;Saulėtekis;VARPELIAI;3780019474;Taip;9;0;2;11
9622;Saulėtekis;VARPELIAI;9615110873;Taip;5;0;0;5
9623;Saulėtekis;VARPELIAI;7423380888;Taip;11;0;0;11
9624;Saulėtekis;VARPELIAI;3832717108;Taip;0;1;0;1
9625;Saulėtekis;VARPELIAI;1240595768;Taip;2;0;0;2
9626;Saulėtekis;GRŪDELIS;1864236745;Taip;0;4;0;4
9627;Saulėtekis;GRŪDELIS;7171048750;Taip;7;0;0;7
9628;Saulėtekis;GRŪDELIS;6535620172;Taip;8;0;3;11
9629;Saulėtekis;GRŪDELIS;8252953405;Taip;4;0;3;7
9630;Saulėtekis;GRŪDELIS;8219644557;Taip;0;0;1;1
9631;Saulėtekis;GRŪDELIS;5218345414;Taip;10;0;0;10
9632;Saulėtekis;GRŪDELIS;9646060606;Taip;0;8;0;8
9633;Saulėtekis;GRŪDELIS;1934900185;Ne;5;0;0;5
9634;Saulėtekis;GRŪDELIS;9995919137;Taip;17;1;0;18
9635;Saulėtekis;GRŪDELIS;6928825133;Taip;4;1;0;5
9636;Saulėtekis;GRŪDELIS;8138047893;Taip;10;1;0;11
9637;Saulėtekis;GRŪDELIS;3953501167;Taip;10;3;0;13
9638;Saulėtekis;GRŪDELIS;6779891385;Taip;7;4;0;11
9639;Saulėtekis;GRŪDELIS;9743690247;Taip;12;0;2;14
9640;Saulėtekis;GRŪDELIS;7666624373;Taip;8;0;2;10
9641;Saulėtekis;GRŪDELIS;8061477303;Taip;9;1;2;12
9642;Saulėtekis;GRŪDELIS;2568544418;Taip;9;0;0;9
9643;Saulėtekis;GRŪDELIS;9734188792;Taip;19;4;0;23
9644;Saulėtekis;GRŪDELIS;6983324115;Taip;0;0;1;1
9645;Saulėtekis;GRŪDELIS;9787534807;Taip;5;0;0;5
9646;Saulėtekis;JONVABALIS;8239855620;Taip;1;1;0;2
9647;Saulėtekis;JONVABALIS;8603952810;Taip;0;4;1;5
9648;Saulėtekis;JONVABALIS;8881524909;Taip;12;4;0;16
9649;Saulėtekis;JONVABALIS;7673965242;Taip;10;4;0;14
9650;Saulėtekis;JONVABALIS;7730889108;Taip;0;4;4;8
9651;Saulėtekis;JONVABALIS;2686041419;Taip;0;9;1;10
9652;Saulėtekis;JONVABALIS;3166959569;Taip;0;11;0;11
9653;Saulėtekis;JONVABALIS;9972687066;Taip;3;5;0;8
9654;Saulėtekis;JONVABALIS;9661075465;Taip;0;1;0;1
9655;Saulėtekis;JONVABALIS;7346852524;Taip;4;0;0;4
9656;Saulėtekis;JONVABALIS;5518726567;Taip;4;0;0;4
9657;Saulėtekis;JONVABALIS;6072030240;Taip;5;4;0;9
9658;Saulėtekis;JONVABALIS;7435424899;Taip;6;4;2;12
9659;Saulėtekis;JONVABALIS;2177470008;Taip;0;5;0;5
9660;Saulėtekis;JONVABALIS;7893982893;Taip;4;1;0;5
9661;Saulėtekis;JONVABALIS;7803735686;Taip;9;4;0;13
9662;Saulėtekis;JONVABALIS;7505040675;Taip;0;4;0;4
9663;Saulėtekis;JONVABALIS;8143793642;Taip;0;5;0;5
9664;Saulėtekis;JONVABALIS;1720125332;Ne;4;4;0;8
9665;Saulėtekis;JONVABALIS;9694119292;Taip;13;4;0;17
9666;Saulėtekis;JONVABALIS;9791926936;Taip;2;4;1;7
9667;Saulėtekis;JONVABALIS;6608831217;Taip;10;4;0;14
9668;Saulėtekis;JONVABALIS;8023603198;Taip;5;0;0;5
9669;Saulėtekis;SMALSUČIAI;9941731250;Taip;2;0;0;2
9670;Saulėtekis;SMALSUČIAI;8102360466;Taip;5;4;0;9
9671;Saulėtekis;SMALSUČIAI;2371396923;Taip;0;4;0;4
9672;Saulėtekis;SMALSUČIAI;1020209414;Taip;2;0;0;2
9673;Saulėtekis;SMALSUČIAI;8745921541;Taip;0;4;0;4
9674;Saulėtekis;SMALSUČIAI;2728836108;Taip;5;4;2;11
9675;Saulėtekis;SMALSUČIAI;7164579375;Ne;0;4;1;5
9676;Saulėtekis;SMALSUČIAI;4038684284;Taip;5;0;0;5
9677;Saulėtekis;SMALSUČIAI;8390615573;Taip;0;2;0;2
9678;Saulėtekis;SMALSUČIAI;4152255439;Taip;0;4;0;4
9679;Saulėtekis;SMALSUČIAI;8574702901;Taip;0;4;1;5
9680;Saulėtekis;SMALSUČIAI;7186085219;Taip;0;4;0;4
9681;Saulėtekis;SMALSUČIAI;2209156661;Taip;0;4;0;4
9682;Saulėtekis;SMALSUČIAI;5552614092;Ne;9;1;0;10
9683;Saulėtekis;SMALSUČIAI;9497129509;Taip;6;0;0;6
9684;Saulėtekis;SMALSUČIAI;3366064429;Taip;2;4;1;7
9685;Saulėtekis;SMALSUČIAI;9870595577;Taip;5;2;0;7
9686;Saulėtekis;SMALSUČIAI;7766084857;Taip;0;4;0;4
9687;Saulėtekis;SMALSUČIAI;2154590089;Taip;0;3;0;3
9688;Saulėtekis;SMALSUČIAI;3220993253;Taip;4;2;0;6
9689;Saulėtekis;SMALSUČIAI;2698535938;Taip;0;4;0;4
9690;Saulėtekis;SMALSUČIAI;8517049464;Taip;0;2;0;2
9691;Saulėtekis;SMALSUČIAI;8620689981;Taip;0;4;1;5
9692;Saulėtekis;BITUTĖS;4252302344;Taip;7;2;0;9
9693;Saulėtekis;BITUTĖS;9382796391;Taip;13;0;1;14
9694;Saulėtekis;BITUTĖS;2095103400;Taip;13;0;1;14
9695;Saulėtekis;BITUTĖS;7614555277;Taip;11;0;0;11
9696;Saulėtekis;BITUTĖS;7308749675;Taip;6;7;0;13
9697;Saulėtekis;BITUTĖS;4135680619;Taip;10;0;0;10
9698;Saulėtekis;BITUTĖS;3768954974;Taip;5;0;1;6
9699;Saulėtekis;BITUTĖS;2939151459;Taip;6;0;0;6
9700;Saulėtekis;BITUTĖS;8522059028;Taip;5;0;0;5
9701;Saulėtekis;BITUTĖS;2790163936;Taip;15;2;0;17
9702;Saulėtekis;BITUTĖS;9649078106;Taip;10;0;2;12
9703;Saulėtekis;BITUTĖS;9892315045;Taip;2;3;0;5
9704;Saulėtekis;BITUTĖS;8890060293;Taip;7;0;0;7
9705;Saulėtekis;BITUTĖS;3954368962;Taip;9;0;0;9
9706;Saulėtekis;BITUTĖS;3349025533;Taip;14;0;0;14
9707;Saulėtekis;BITUTĖS;6945891800;Taip;6;0;0;6
9708;Saulėtekis;BITUTĖS;6468360941;Taip;0;0;1;1
9709;Saulėtekis;RIEŠUTĖLIAI;8767786444;Taip;5;0;2;7
9710;Saulėtekis;RIEŠUTĖLIAI;2224626144;Taip;6;0;1;7
9711;Saulėtekis;RIEŠUTĖLIAI;9270231819;Taip;0;0;2;2
9712;Saulėtekis;RIEŠUTĖLIAI;7898928446;Taip;0;2;0;2
9713;Saulėtekis;RIEŠUTĖLIAI;3356705340;Taip;14;0;0;14
9714;Saulėtekis;RIEŠUTĖLIAI;7824492464;Taip;3;0;0;3
9715;Saulėtekis;RIEŠUTĖLIAI;2548612572;Taip;0;4;0;4
9716;Saulėtekis;RIEŠUTĖLIAI;2908714227;Taip;10;0;0;10
9717;Saulėtekis;RIEŠUTĖLIAI;7305619721;Taip;0;10;3;13
9718;Saulėtekis;RIEŠUTĖLIAI;9516841263;Taip;2;0;5;7
9719;Saulėtekis;RIEŠUTĖLIAI;6557482092;Taip;10;0;0;10
9720;Saulėtekis;RIEŠUTĖLIAI;6183384994;Taip;0;4;0;4
9721;Saulėtekis;RIEŠUTĖLIAI;1540848694;Taip;0;1;0;1
9722;Saulėtekis;RIEŠUTĖLIAI;3559882322;Taip;2;0;0;2
9723;Saulėtekis;RIEŠUTĖLIAI;4767842376;Taip;5;0;1;6
9724;Saulėtekis;RIEŠUTĖLIAI;9351147084;Taip;3;0;1;4
9725;Saulėtekis;RIEŠUTĖLIAI;4413014466;Taip;1;0;0;1
9726;Saulėtekis;RIEŠUTĖLIAI;9246555859;Taip;5;0;0;5
9727;Saulėtekis;RIEŠUTĖLIAI;7338301696;Taip;11;0;0;11
9728;Saulėtekis;RIEŠUTĖLIAI;3206247299;Taip;2;0;0;2
9729;Skroblinukas;SVIRPLIUKŲ;2195112297;Taip;13;0;3;16
9730;Skroblinukas;SVIRPLIUKŲ;4198512202;Taip;9;0;4;13
9731;Skroblinukas;SVIRPLIUKŲ;7750501815;Taip;20;0;0;20
9732;Skroblinukas;SVIRPLIUKŲ;4960825597;Taip;0;6;1;7
9733;Skroblinukas;SVIRPLIUKŲ;1544598440;Taip;13;0;0;13
9734;Skroblinukas;SVIRPLIUKŲ;6574558658;Taip;0;6;2;8
9735;Skroblinukas;SVIRPLIUKŲ;4861971439;Taip;8;0;0;8
9736;Skroblinukas;SVIRPLIUKŲ;7817632987;Taip;4;5;0;9
9737;Skroblinukas;SVIRPLIUKŲ;7675772872;Taip;4;0;2;6
9738;Skroblinukas;SVIRPLIUKŲ;4266945644;Taip;14;4;0;18
9739;Skroblinukas;SVIRPLIUKŲ;5154111867;Taip;7;3;0;10
9740;Skroblinukas;SVIRPLIUKŲ;8622930871;Taip;21;0;0;21
9741;Skroblinukas;SVIRPLIUKŲ;9661609284;Taip;3;0;0;3
9742;Skroblinukas;SVIRPLIUKŲ;3260267388;Taip;0;10;0;10
9743;Skroblinukas;SVIRPLIUKŲ;7761972818;Taip;3;1;0;4
9744;Skroblinukas;SVIRPLIUKŲ;9629502585;Taip;2;3;0;5
9745;Skroblinukas;SVIRPLIUKŲ;6461678336;Taip;7;0;1;8
9746;Skroblinukas;SVIRPLIUKŲ;8283516422;Taip;7;0;0;7
9747;Skroblinukas;GANDRIUKŲ;2197158518;Taip;0;4;0;4
9748;Skroblinukas;GANDRIUKŲ;2406619611;Taip;10;4;0;14
9749;Skroblinukas;GANDRIUKŲ;5646847921;Taip;0;8;0;8
9750;Skroblinukas;GANDRIUKŲ;1851920334;Taip;0;0;1;1
9751;Skroblinukas;GANDRIUKŲ;9377215921;Taip;0;11;0;11
9752;Skroblinukas;GANDRIUKŲ;6489976163;Taip;5;1;0;6
9753;Skroblinukas;GANDRIUKŲ;1159546580;Taip;0;6;1;7
9754;Skroblinukas;GANDRIUKŲ;2310750833;Taip;6;3;0;9
9755;Skroblinukas;GANDRIUKŲ;9888115079;Taip;0;2;0;2
9756;Skroblinukas;GANDRIUKŲ;9475514959;Ne;5;5;0;10
9757;Skroblinukas;GANDRIUKŲ;9031598603;Taip;1;1;1;3
9758;Skroblinukas;GANDRIUKŲ;5251903769;Ne;0;7;0;7
9759;Skroblinukas;GANDRIUKŲ;7385271438;Taip;0;1;3;4
9760;Skroblinukas;GANDRIUKŲ;7274368180;Taip;0;1;0;1
9761;Skroblinukas;GANDRIUKŲ;9541682085;Taip;5;0;0;5
9762;Skroblinukas;GANDRIUKŲ;7753392781;Taip;2;0;1;3
9763;Skroblinukas;GANDRIUKŲ;1369962422;Taip;1;0;1;2
9764;Skroblinukas;VYTURIUKŲ;3954228349;Taip;4;0;4;8
9765;Skroblinukas;VYTURIUKŲ;4560580022;Taip;0;1;0;1
9766;Skroblinukas;VYTURIUKŲ;3065235192;Taip;3;7;0;10
9767;Skroblinukas;VYTURIUKŲ;5902713448;Taip;0;3;0;3
9768;Skroblinukas;VYTURIUKŲ;3594000419;Taip;0;4;0;4
9769;Skroblinukas;VYTURIUKŲ;3512297435;Taip;0;4;0;4
9770;Skroblinukas;VYTURIUKŲ;2481980627;Taip;6;0;1;7
9771;Skroblinukas;VYTURIUKŲ;9725125130;Taip;0;4;0;4
9772;Skroblinukas;VYTURIUKŲ;7068452970;Taip;10;2;0;12
9773;Skroblinukas;VYTURIUKŲ;3292517112;Taip;0;1;0;1
9774;Skroblinukas;VYTURIUKŲ;5101136022;Ne;0;1;3;4
9775;Skroblinukas;VYTURIUKŲ;9828486832;Taip;3;1;0;4
9776;Skroblinukas;VYTURIUKŲ;2263955772;Taip;0;7;0;7
9777;Skroblinukas;VYTURIUKŲ;9731326488;Taip;0;3;0;3
9778;Skroblinukas;GENIUKŲ;6011466024;Ne;7;3;0;10
9779;Skroblinukas;GENIUKŲ;8629189405;Taip;7;0;2;9
9780;Skroblinukas;GENIUKŲ;9809817630;Taip;9;0;0;9
9781;Skroblinukas;GENIUKŲ;8544069746;Taip;0;2;0;2
9782;Skroblinukas;GENIUKŲ;6475609065;Taip;0;0;27;27
9783;Skroblinukas;GENIUKŲ;4091852305;Taip;0;6;1;7
9784;Skroblinukas;GENIUKŲ;1820748152;Taip;0;4;0;4
9785;Skroblinukas;GENIUKŲ;3705638869;Taip;12;0;0;12
9786;Skroblinukas;GENIUKŲ;2511496284;Taip;10;0;0;10
9787;Skroblinukas;GENIUKŲ;7153774246;Ne;0;6;0;6
9788;Skroblinukas;GENIUKŲ;7045587415;Taip;1;0;5;6
9789;Skroblinukas;GENIUKŲ;5946356374;Taip;10;0;0;10
9790;Skroblinukas;GENIUKŲ;5274898590;Taip;0;3;0;3
9791;Skroblinukas;GENIUKŲ;1167332689;Taip;0;4;0;4
9792;Skroblinukas;GENIUKŲ;4491947846;Taip;4;2;0;6
9793;Skroblinukas;GENIUKŲ;7955574061;Taip;7;3;0;10
9794;Skroblinukas;GENIUKŲ;9162582460;Taip;5;0;1;6
9795;Skroblinukas;GENIUKŲ;1014993354;Taip;17;0;0;17
9796;Skroblinukas;GENIUKŲ;1232121301;Ne;3;4;0;7
9797;Skroblinukas;GENIUKŲ;8680329175;Taip;14;0;0;14
9798;Skroblinukas;BITUČIŲ;4639384934;Taip;7;0;0;7
9799;Skroblinukas;BITUČIŲ;5206925237;Taip;5;0;1;6
9800;Skroblinukas;BITUČIŲ;7581372511;Taip;0;3;2;5
9801;Skroblinukas;BITUČIŲ;6717008836;Taip;5;4;0;9
9802;Skroblinukas;BITUČIŲ;6791969485;Taip;0;1;0;1
9803;Skroblinukas;BITUČIŲ;2363368201;Ne;11;5;2;18
9804;Skroblinukas;BITUČIŲ;2885814517;Taip;0;3;0;3
9805;Skroblinukas;BITUČIŲ;3689247672;Taip;3;1;0;4
9806;Skroblinukas;BITUČIŲ;5354832150;Taip;0;0;1;1
9807;Skroblinukas;BITUČIŲ;5841866621;Taip;4;1;0;5
9808;Skroblinukas;BITUČIŲ;4688496560;Taip;0;1;0;1
9809;Skroblinukas;BITUČIŲ;9341501143;Taip;0;13;0;13
9810;Skroblinukas;BITUČIŲ;3490684777;Taip;4;2;0;6
9811;Skroblinukas;BITUČIŲ;2717586232;Taip;6;0;0;6
9812;Skroblinukas;BITUČIŲ;4840767748;Taip;2;0;0;2
9813;Skroblinukas;BITUČIŲ;9513546028;Taip;8;0;3;11
9814;Skroblinukas;BITUČIŲ;8715188878;Taip;10;9;3;22
9815;Skroblinukas;BITUČIŲ;7407601996;Taip;0;1;0;1
9816;Skroblinukas;BITUČIŲ;4631657273;Taip;8;0;0;8
9817;Skroblinukas;BITUČIŲ;7255510731;Taip;6;0;1;7
9818;Skroblinukas;BITUČIŲ;5694105568;Taip;12;0;0;12
9819;Skroblinukas;BORUŽĖLIŲ;2523742608;Taip;9;0;0;9
9820;Skroblinukas;BORUŽĖLIŲ;2311459579;Taip;9;0;0;9
9821;Skroblinukas;BORUŽĖLIŲ;7771969055;Taip;0;1;0;1
9822;Skroblinukas;BORUŽĖLIŲ;8711201474;Ne;2;1;1;4
9823;Skroblinukas;BORUŽĖLIŲ;2166244766;Taip;5;0;0;5
9824;Skroblinukas;BORUŽĖLIŲ;7729612420;Taip;23;0;0;23
9825;Skroblinukas;BORUŽĖLIŲ;5082212661;Taip;8;5;1;14
9826;Skroblinukas;BORUŽĖLIŲ;4904084567;Taip;0;0;3;3
9827;Skroblinukas;BORUŽĖLIŲ;1357700154;Taip;16;0;0;16
9828;Skroblinukas;BORUŽĖLIŲ;7446262781;Taip;11;0;0;11
9829;Skroblinukas;BORUŽĖLIŲ;6005897181;Taip;16;0;0;16
9830;Skroblinukas;SKRUZDĖLIUKŲ;5688453546;Taip;0;4;2;6
9831;Skroblinukas;SKRUZDĖLIUKŲ;6890306112;Taip;0;5;0;5
9832;Skroblinukas;SKRUZDĖLIUKŲ;6445065388;Taip;0;1;0;1
9833;Skroblinukas;SKRUZDĖLIUKŲ;3006521657;Taip;0;1;0;1
9834;Skroblinukas;SKRUZDĖLIUKŲ;3771045336;Taip;0;4;0;4
9835;Skroblinukas;SKRUZDĖLIUKŲ;4424763028;Taip;4;0;0;4
9836;Skroblinukas;SKRUZDĖLIUKŲ;7493915017;Taip;0;5;0;5
9837;Skroblinukas;SKRUZDĖLIUKŲ;5157913924;Taip;0;9;0;9
9838;Skroblinukas;SKRUZDĖLIUKŲ;9368764758;Taip;4;2;0;6
9839;Skroblinukas;SKRUZDĖLIUKŲ;8576448571;Taip;0;4;0;4
9840;Skroblinukas;SKRUZDĖLIUKŲ;3290115134;Taip;7;4;0;11
9841;Skroblinukas;SKRUZDĖLIUKŲ;2706526326;Ne;0;0;1;1
9842;Skroblinukas;SKRUZDĖLIUKŲ;6640062847;Ne;0;3;0;3
9843;Skroblinukas;SKRUZDĖLIUKŲ;5433647187;Taip;4;0;0;4
9844;Skroblinukas;ŽVIRBLIUKŲ;3041669079;Taip;9;10;0;19
9845;Skroblinukas;ŽVIRBLIUKŲ;6068248705;Taip;7;0;0;7
9846;Skroblinukas;ŽVIRBLIUKŲ;3117532423;Taip;2;0;0;2
9847;Skroblinukas;ŽVIRBLIUKŲ;8124086303;Taip;12;0;0;12
9848;Skroblinukas;ŽVIRBLIUKŲ;7640540309;Ne;0;4;0;4
9849;Skroblinukas;ŽVIRBLIUKŲ;3858667425;Taip;7;0;0;7
9850;Skroblinukas;ŽVIRBLIUKŲ;1996484086;Taip;2;1;0;3
9851;Skroblinukas;ŽVIRBLIUKŲ;7527177120;Taip;0;2;0;2
9852;Skroblinukas;ŽVIRBLIUKŲ;6135412007;Taip;10;0;0;10
9853;Skroblinukas;ŽVIRBLIUKŲ;2312400921;Taip;10;0;0;10
9854;Skroblinukas;ŽVIRBLIUKŲ;7804920443;Ne;4;0;0;4
9855;Skroblinukas;ŽVIRBLIUKŲ;4197050176;Taip;0;6;0;6
9856;Skroblinukas;ŽVIRBLIUKŲ;4390614970;Taip;12;0;0;12
9857;Skroblinukas;ŽIOGELIŲ;6279909049;Taip;4;0;2;6
9858;Skroblinukas;ŽIOGELIŲ;9737310101;Taip;5;0;1;6
9859;Skroblinukas;ŽIOGELIŲ;8118284793;Taip;10;0;2;12
9860;Skroblinukas;ŽIOGELIŲ;1844211217;Taip;5;0;0;5
9861;Skroblinukas;ŽIOGELIŲ;4266029484;Taip;0;3;0;3
9862;Skroblinukas;ŽIOGELIŲ;9191337531;Taip;14;0;2;16
9863;Skroblinukas;ŽIOGELIŲ;2941319404;Taip;0;0;1;1
9864;Skroblinukas;ŽIOGELIŲ;3909811358;Taip;0;4;0;4
9865;Skroblinukas;ŽIOGELIŲ;7650915045;Taip;2;0;6;8
9866;Skroblinukas;ŽIOGELIŲ;6444788760;Taip;4;3;0;7
9867;Skroblinukas;STRAZDELIŲ;4799600999;Taip;0;2;0;2
9868;Skroblinukas;STRAZDELIŲ;8898971191;Taip;0;5;0;5
9869;Skroblinukas;STRAZDELIŲ;5804217824;Taip;7;0;0;7
9870;Skroblinukas;STRAZDELIŲ;1762416639;Taip;0;0;1;1
9871;Skroblinukas;STRAZDELIŲ;7483556761;Taip;0;0;1;1
9872;Skroblinukas;STRAZDELIŲ;1846830752;Taip;2;0;1;3
9873;Skroblinukas;STRAZDELIŲ;4500841908;Taip;2;0;0;2
9874;Skroblinukas;STRAZDELIŲ;8734405028;Taip;0;5;0;5
9875;Skroblinukas;STRAZDELIŲ;2132271995;Taip;3;4;0;7
9876;Skroblinukas;STRAZDELIŲ;9753194124;Taip;9;0;0;9
9877;Skroblinukas;DRUGELIŲ;8305867345;Taip;3;2;0;5
9878;Skroblinukas;DRUGELIŲ;7400908711;Ne;0;8;0;8
9879;Skroblinukas;DRUGELIŲ;3889890374;Taip;0;6;0;6
9880;Skroblinukas;DRUGELIŲ;9481718833;Taip;3;0;0;3
9881;Skroblinukas;DRUGELIŲ;2772360168;Taip;0;3;0;3
9882;Skroblinukas;DRUGELIŲ;4831370981;Taip;0;4;0;4
9883;Skroblinukas;DRUGELIŲ;5957417413;Ne;6;0;0;6
9884;Skroblinukas;DRUGELIŲ;2887161771;Taip;0;2;0;2
9885;Skroblinukas;DRUGELIŲ;4737605061;Ne;0;3;0;3
9886;Skroblinukas;DRUGELIŲ;3046542264;Taip;5;1;0;6
9887;Skroblinukas;DRUGELIŲ;2948231687;Taip;0;0;1;1
9888;Skroblinukas;DRUGELIŲ;5912771080;Taip;13;2;0;15
9889;Skroblinukas;DRUGELIŲ;7528824951;Taip;9;0;1;10
9890;Skroblinukas;DRUGELIŲ;2987938909;Taip;0;7;0;7
9891;Skroblinukas;DRUGELIŲ;8064713969;Taip;0;6;1;7
9892;Skroblinukas;DRUGELIŲ;8286842648;Taip;0;0;1;1
9893;Skroblinukas;DRUGELIŲ;1453029732;Taip;0;6;2;8
9894;Skroblinukas;PELĖDŽIUKŲ;8953844650;Taip;0;1;0;1
9895;Skroblinukas;PELĖDŽIUKŲ;5813075721;Taip;10;4;1;15
9896;Skroblinukas;PELĖDŽIUKŲ;3646325903;Taip;0;3;0;3
9897;Skroblinukas;PELĖDŽIUKŲ;9292990596;Taip;11;0;0;11
9898;Skroblinukas;PELĖDŽIUKŲ;8202855376;Taip;10;0;4;14
9899;Skroblinukas;PELĖDŽIUKŲ;3658815079;Taip;5;0;0;5
9900;Skroblinukas;PELĖDŽIUKŲ;5418212729;Taip;0;0;1;1
9901;Skroblinukas;PELĖDŽIUKŲ;4168542339;Taip;0;7;0;7
9902;Skroblinukas;PELĖDŽIUKŲ;8958893525;Taip;0;0;1;1
9903;Skroblinukas;PELĖDŽIUKŲ;6675716937;Taip;0;0;1;1
9904;Skroblinukas;PELĖDŽIUKŲ;1009065470;Taip;13;2;0;15
9905;Skroblinukas;PELĖDŽIUKŲ;9553242594;Taip;0;6;0;6
9906;Skroblinukas;PELĖDŽIUKŲ;4802801867;Taip;2;0;1;3
9907;Skroblinukas;PELĖDŽIUKŲ;8465074037;Taip;0;4;1;5
9908;Skroblinukas;PELĖDŽIUKŲ;2071093890;Taip;2;4;1;7
9909;Skroblinukas;PELĖDŽIUKŲ;9523720873;Taip;14;2;2;18
9910;Skroblinukas;PELĖDŽIUKŲ;7920117036;Taip;2;1;0;3
9911;Skroblinukas;PELĖDŽIUKŲ;2215428081;Taip;0;0;1;1
9912;Smalsučiai;Žibuoklės;6535494814;Taip;3;0;1;4
9913;Smalsučiai;Žibuoklės;3309134310;Taip;8;3;0;11
9914;Smalsučiai;Žibuoklės;2326167599;Taip;5;2;0;7
9915;Smalsučiai;Žibuoklės;4094037708;Taip;0;0;2;2
9916;Smalsučiai;Žibuoklės;5893045664;Taip;0;4;0;4
9917;Smalsučiai;Žibuoklės;2742992400;Taip;0;0;3;3
9918;Smalsučiai;Žibuoklės;3877274360;Ne;6;5;0;11
9919;Smalsučiai;Žibuoklės;7726086066;Taip;4;0;0;4
9920;Smalsučiai;Žibuoklės;5489140006;Taip;3;0;0;3
9921;Smalsučiai;Žibuoklės;6931092874;Taip;12;1;4;17
9922;Smalsučiai;Žibuoklės;3071594259;Taip;0;7;0;7
9923;Smalsučiai;Žibuoklės;7107126092;Taip;0;7;0;7
9924;Smalsučiai;Žibuoklės;7070240693;Taip;4;2;1;7
9925;Smalsučiai;Žibuoklės;4288788194;Taip;9;0;0;9
9926;Smalsučiai;Žibuoklės;8259056296;Taip;12;0;0;12
9927;Smalsučiai;Žibuoklės;9637877396;Taip;0;4;3;7
9928;Smalsučiai;Aitvarų;3349726106;Taip;10;1;0;11
9929;Smalsučiai;Aitvarų;2219168902;Taip;0;0;1;1
9930;Smalsučiai;Aitvarų;9305837033;Taip;7;0;0;7
9931;Smalsučiai;Aitvarų;9305837033;Taip;7;0;0;7
9932;Smalsučiai;Aitvarų;9305837033;Taip;7;0;0;7
9933;Smalsučiai;Aitvarų;3888093640;Taip;0;1;0;1
9934;Smalsučiai;Aitvarų;8284740122;Taip;15;0;0;15
9935;Smalsučiai;Aitvarų;1309254661;Taip;3;0;0;3
9936;Smalsučiai;Aitvarų;8985656809;Taip;6;0;0;6
9937;Smalsučiai;Aitvarų;6032887449;Taip;6;0;0;6
9938;Smalsučiai;Aitvarų;9821259659;Taip;0;6;0;6
9939;Smalsučiai;Aitvarų;4054278651;Ne;1;0;0;1
9940;Smalsučiai;Aitvarų;6232068532;Taip;4;4;1;9
9941;Smalsučiai;Aitvarų;3157534923;Taip;0;9;0;9
9942;Smalsučiai;Aitvarų;6825499095;Taip;1;0;0;1
9943;Smalsučiai;Aitvarų;4832292565;Taip;2;0;0;2
9944;Smalsučiai;Aitvarų;2835117069;Taip;2;1;0;3
9945;Smalsučiai;Aitvarų;2350539797;Taip;4;0;0;4
9946;Smalsučiai;Aitvarų;1126565862;Taip;6;1;0;7
9947;Smalsučiai;Sraigiukų;7933302912;Taip;0;8;0;8
9948;Smalsučiai;Sraigiukų;1471941426;Taip;0;5;0;5
9949;Smalsučiai;Sraigiukų;1458544456;Taip;0;2;0;2
9950;Smalsučiai;Sraigiukų;5406430393;Taip;0;5;0;5
9951;Smalsučiai;Sraigiukų;9582225178;Taip;0;4;0;4
9952;Smalsučiai;Sraigiukų;9604182559;Taip;0;8;0;8
9953;Smalsučiai;Sraigiukų;6469604093;Taip;0;1;0;1
9954;Smalsučiai;Sraigiukų;4364810458;Taip;0;4;0;4
9955;Smalsučiai;Sraigiukų;4566816316;Taip;4;5;0;9
9956;Smalsučiai;Sraigiukų;5184903287;Taip;0;1;0;1
9957;Smalsučiai;Sraigiukų;4629526320;Taip;2;0;0;2
9958;Smalsučiai;Sraigiukų;4134975456;Taip;5;4;0;9
9959;Smalsučiai;Sraigiukų;7396172351;Ne;0;5;0;5
9960;Smalsučiai;Sraigiukų;6358800570;Taip;11;5;0;16
9961;Smalsučiai;Sraigiukų;2327930850;Taip;0;1;0;1
9962;Smalsučiai;Sraigiukų;3787937467;Taip;0;5;0;5
9963;Smalsučiai;Sraigiukų;4824786207;Taip;0;1;0;1
9964;Smalsučiai;Sraigiukų;3399798448;Taip;1;1;1;3
9965;Smalsučiai;Sraigiukų;1997966082;Taip;0;4;0;4
9966;Smalsučiai;Sraigiukų;4585930202;Taip;0;4;0;4
9967;Smalsučiai;Sraigiukų;8193410963;Taip;0;2;0;2
9968;Smalsučiai;Sraigiukų;9155011285;Taip;3;4;0;7
9969;Smalsučiai;Saulučių;1776385691;Ne;9;0;0;9
9970;Smalsučiai;Saulučių;2259361924;Taip;10;0;0;10
9971;Smalsučiai;Saulučių;1162964613;Taip;0;0;2;2
9972;Smalsučiai;Saulučių;9934952886;Taip;5;2;1;8
9973;Smalsučiai;Saulučių;9556433086;Taip;0;3;0;3
9974;Smalsučiai;Saulučių;1904973393;Taip;4;0;1;5
9975;Smalsučiai;Saulučių;3252901131;Taip;7;0;2;9
9976;Smalsučiai;Saulučių;9743116843;Taip;4;5;2;11
9977;Smalsučiai;Saulučių;2392217952;Taip;10;0;1;11
9978;Smalsučiai;Saulučių;1447512509;Taip;0;0;15;15
9979;Smalsučiai;Saulučių;7774766882;Taip;3;0;0;3
9980;Smalsučiai;Saulučių;2034284973;Taip;0;4;1;5
9981;Smalsučiai;Saulučių;7423419934;Taip;0;0;1;1
9982;Smalsučiai;Saulučių;7049101015;Taip;3;3;0;6
9983;Smalsučiai;Saulučių;9183519167;Taip;6;0;3;9
9984;Smalsučiai;Saulučių;5708986552;Taip;4;0;0;4
9985;Smalsučiai;Saulučių;4889923629;Taip;0;1;0;1
9986;Smalsučiai;Saulučių;8630411244;Taip;0;3;0;3
9987;Smalsučiai;Saulučių;5541908981;Taip;0;4;1;5
9988;Smalsučiai;Saulučių;6927421427;Taip;4;0;0;4
9989;Smalsučiai;Saulučių;7874635165;Taip;0;4;9;13
9990;Smalsučiai;Saulučių;5536697307;Taip;0;0;23;23
9991;Smalsučiai;Viščiukų;6827441564;Taip;5;0;0;5
9992;Smalsučiai;Viščiukų;4760366724;Taip;5;4;0;9
9993;Smalsučiai;Viščiukų;2045283348;Taip;8;4;0;12
9994;Smalsučiai;Viščiukų;9710944054;Taip;11;0;0;11
9995;Smalsučiai;Viščiukų;5213319192;Taip;9;1;0;10
9996;Smalsučiai;Viščiukų;8210141253;Taip;11;1;0;12
9997;Smalsučiai;Viščiukų;3782502443;Taip;6;0;0;6
9998;Smalsučiai;Viščiukų;6358968221;Taip;2;4;0;6
9999;Smalsučiai;Viščiukų;2926560092;Taip;7;0;0;7
10000;Smalsučiai;Viščiukų;4075656060;Taip;1;2;0;3
10001;Smalsučiai;Viščiukų;4030955447;Ne;1;2;0;3
10002;Smalsučiai;Viščiukų;6131743288;Taip;9;0;4;13
10003;Smalsučiai;Viščiukų;1331674807;Taip;0;4;0;4
10004;Smalsučiai;Viščiukų;9984878984;Taip;4;2;0;6
10005;Smalsučiai;Viščiukų;5535858303;Taip;2;0;0;2
10006;Smalsučiai;Viščiukų;8724759192;Taip;0;4;0;4
10007;Smalsučiai;Viščiukų;2662588310;Taip;6;0;2;8
10008;Smalsučiai;Viščiukų;2668720481;Taip;3;3;0;6
10009;Smalsučiai;Viščiukų;2369569130;Taip;7;0;0;7
10010;Smalsučiai;Boružėlių;8606216911;Taip;0;1;0;1
10011;Smalsučiai;Boružėlių;1023255628;Taip;4;0;0;4
10012;Smalsučiai;Boružėlių;9181601713;Taip;9;1;0;10
10013;Smalsučiai;Boružėlių;6642882883;Taip;5;9;0;14
10014;Smalsučiai;Boružėlių;7637630200;Taip;0;1;1;2
10015;Smalsučiai;Boružėlių;1247774684;Taip;0;2;0;2
10016;Smalsučiai;Boružėlių;2375360937;Taip;9;4;0;13
10017;Smalsučiai;Boružėlių;1224857159;Taip;0;6;1;7
10018;Smalsučiai;Boružėlių;2015172985;Taip;0;1;0;1
10019;Smalsučiai;Boružėlių;4457317471;Taip;8;0;0;8
10020;Smalsučiai;Boružėlių;8893480054;Taip;6;0;0;6
10021;Smalsučiai;Boružėlių;3646740184;Taip;5;2;1;8
10022;Smalsučiai;Boružėlių;6996192450;Taip;0;1;2;3
10023;Smalsučiai;Boružėlių;9378696084;Taip;5;0;4;9
10024;Smalsučiai;Boružėlių;7267389695;Taip;4;4;0;8
10025;Smalsučiai;Boružėlių;4847212069;Taip;4;0;4;8
10026;Smalsučiai;Boružėlių;8690626891;Taip;10;0;0;10
10027;Smalsučiai;Zuikių;6006832443;Taip;1;4;0;5
10028;Smalsučiai;Zuikių;9864518144;Taip;0;4;0;4
10029;Smalsučiai;Zuikių;8128348060;Taip;3;0;2;5
10030;Smalsučiai;Zuikių;3757955200;Taip;5;4;0;9
10031;Smalsučiai;Zuikių;4847584492;Taip;0;4;0;4
10032;Smalsučiai;Zuikių;6415906523;Taip;2;3;0;5
10033;Smalsučiai;Zuikių;4425714802;Taip;0;2;0;2
10034;Smalsučiai;Zuikių;4379645417;Taip;0;5;0;5
10035;Smalsučiai;Zuikių;6090391818;Taip;6;4;0;10
10036;Smalsučiai;Zuikių;5098291946;Ne;0;0;23;23
10037;Smalsučiai;Zuikių;3582805599;Taip;0;4;0;4
10038;Smalsučiai;Zuikių;7137550663;Taip;1;1;0;2
10039;Smalsučiai;Zuikių;2958335372;Taip;0;1;0;1
10040;Smalsučiai;Zuikių;8578693978;Taip;0;4;0;4
10041;Smalsučiai;Zuikių;7713078413;Taip;0;3;0;3
10042;Smalsučiai;Zuikių;3627324317;Ne;0;4;0;4
10043;Smalsučiai;Zuikių;2034790691;Taip;6;0;1;7
10044;Smalsučiai;Zuikių;4506058735;Taip;2;4;0;6
10045;Smalsučiai;Nykštukų;3254574278;Taip;7;0;0;7
10046;Smalsučiai;Nykštukų;6279850475;Taip;4;0;1;5
10047;Smalsučiai;Nykštukų;6589139999;Taip;7;0;0;7
10048;Smalsučiai;Nykštukų;8461139523;Taip;4;0;0;4
10049;Smalsučiai;Nykštukų;3162567266;Taip;4;0;0;4
10050;Smalsučiai;Nykštukų;7231947961;Taip;7;0;0;7
10051;Smalsučiai;Nykštukų;5205336476;Taip;13;0;0;13
10052;Smalsučiai;Nykštukų;5537437823;Taip;1;1;0;2
10053;Smalsučiai;Nykštukų;4110887316;Taip;0;0;1;1
10054;Smalsučiai;Nykštukų;7257857454;Taip;16;1;0;17
10055;Smalsučiai;Nykštukų;9299524862;Taip;9;0;1;10
10056;Smalsučiai;Nykštukų;6372742288;Taip;18;0;0;18
10057;Smalsučiai;Katinėlių;3636314894;Taip;12;0;0;12
10058;Smalsučiai;Katinėlių;8527953002;Taip;0;7;0;7
10059;Smalsučiai;Katinėlių;4306056807;Taip;0;4;3;7
10060;Smalsučiai;Katinėlių;7094624971;Taip;10;0;0;10
10061;Smalsučiai;Katinėlių;2505732707;Taip;0;0;1;1
10062;Smalsučiai;Katinėlių;4517950062;Taip;7;0;0;7
10063;Smalsučiai;Katinėlių;3325151724;Taip;11;0;1;12
10064;Smalsučiai;Katinėlių;5390381543;Taip;12;0;1;13
10065;Smalsučiai;Katinėlių;9373529880;Taip;16;0;2;18
10066;Smalsučiai;Katinėlių;3104627678;Taip;5;0;0;5
10067;Smalsučiai;Katinėlių;4989144093;Taip;0;0;1;1
10068;Smalsučiai;Katinėlių;4275309820;Taip;0;3;1;4
10069;Smalsučiai;Katinėlių;9482651454;Taip;2;0;0;2
10070;Smalsučiai;Katinėlių;7123127278;Taip;0;0;1;1
10071;Smalsučiai;PELĖDŽIUKAI;9222858199;Taip;6;2;0;8
10072;Smalsučiai;PELĖDŽIUKAI;1909797307;Taip;14;0;0;14
10073;Smalsučiai;PELĖDŽIUKAI;7400990599;Taip;6;0;0;6
10074;Smalsučiai;PELĖDŽIUKAI;8615110249;Taip;0;0;1;1
10075;Smalsučiai;PELĖDŽIUKAI;2673224420;Taip;2;0;0;2
10076;Smalsučiai;PELĖDŽIUKAI;9771532192;Taip;10;4;0;14
10077;Smalsučiai;PELĖDŽIUKAI;8402519872;Taip;6;1;0;7
10078;Smalsučiai;PELĖDŽIUKAI;1305808180;Taip;0;5;0;5
10079;Smalsučiai;PELĖDŽIUKAI;6393203986;Taip;4;3;0;7
10080;Smalsučiai;PELĖDŽIUKAI;3746193901;Taip;4;2;0;6
10081;Smalsučiai;PELĖDŽIUKAI;8499612926;Taip;5;0;2;7
10082;Smalsučiai;PELĖDŽIUKAI;3625628040;Taip;4;0;0;4
10083;Smalsučiai;PELĖDŽIUKAI;2305950301;Taip;0;7;0;7
10084;Smalsučiai;PELĖDŽIUKAI;6128134712;Taip;0;1;1;2
10085;Smalsučiai;PELĖDŽIUKAI;8615789381;Taip;9;6;0;15
10086;Smalsučiai;PELĖDŽIUKAI;5789420793;Taip;13;0;1;14
10087;Smalsučiai;PELĖDŽIUKAI;7973827402;Taip;5;0;1;6
10088;Smalsučiai;PELĖDŽIUKAI;5104153092;Taip;16;0;0;16
10089;Smalsučiai;Pingvinukai;2054305125;Taip;0;1;0;1
10090;Smalsučiai;Pingvinukai;7731862348;Taip;10;6;0;16
10091;Smalsučiai;Pingvinukai;3064333387;Taip;0;2;0;2
10092;Smalsučiai;Pingvinukai;4557510634;Taip;0;0;1;1
10093;Smalsučiai;Pingvinukai;3340929454;Taip;15;0;0;15
10094;Smalsučiai;Pingvinukai;1381962216;Taip;19;0;3;22
10095;Smalsučiai;Pingvinukai;7065180174;Taip;0;1;0;1
10096;Smalsučiai;Pingvinukai;5081708388;Taip;4;0;0;4
10097;Smalsučiai;Pingvinukai;6430983316;Taip;2;4;0;6
10098;Smalsučiai;Pingvinukai;6380199558;Taip;19;0;3;22
10099;Smalsučiai;Voverikų;4811022648;Taip;0;2;0;2
10100;Smalsučiai;Voverikų;4973651632;Taip;2;0;2;4
10101;Smalsučiai;Voverikų;3509573985;Taip;9;1;0;10
10102;Smalsučiai;Voverikų;1485450504;Taip;2;1;0;3
10103;Smalsučiai;Voverikų;3042578767;Taip;4;7;0;11
10104;Smalsučiai;Voverikų;2070248478;Taip;11;4;0;15
10105;Smalsučiai;Voverikų;7205498813;Taip;10;1;0;11
10106;Smalsučiai;Voverikų;2612579099;Taip;0;22;0;22
10107;Smalsučiai;Voverikų;1559069582;Taip;3;0;0;3
10108;Smalsučiai;Voverikų;2885279828;Taip;8;1;0;9
10109;Smalsučiai;Voverikų;5964344820;Taip;4;0;0;4
10110;Smalsučiai;Voverikų;4105866680;Taip;1;0;0;1
10111;Smalsučiai;Voverikų;8493718326;Taip;4;0;0;4
10112;Smalsučiai;Voverikų;4611852575;Taip;0;10;0;10
10113;Smalsučiai;Voverikų;7988779202;Taip;0;11;0;11
10114;Smalsučiai;Voverikų;2583712404;Taip;0;12;1;13
10115;Smalsučiai;Voverikų;6984861531;Taip;4;5;1;10
10116;Smalsučiai;Voverikų;4233687544;Taip;4;0;0;4
10117;Smalsučiai;Voverikų;5710530457;Taip;3;0;0;3
10118;Spragtukas;NYKŠTUKAI;4527798635;Taip;0;1;0;1
10119;Spragtukas;NYKŠTUKAI;8551195766;Taip;9;0;0;9
10120;Spragtukas;NYKŠTUKAI;8297700739;Taip;5;0;1;6
10121;Spragtukas;NYKŠTUKAI;9595221494;Taip;4;0;0;4
10122;Spragtukas;NYKŠTUKAI;1710184531;Taip;3;0;0;3
10123;Spragtukas;NYKŠTUKAI;2076126173;Ne;0;3;0;3
10124;Spragtukas;NYKŠTUKAI;3012345413;Ne;0;3;0;3
10125;Spragtukas;NYKŠTUKAI;8698492694;Taip;12;0;2;14
10126;Spragtukas;NYKŠTUKAI;1150002524;Taip;0;2;0;2
10127;Spragtukas;NYKŠTUKAI;8288793522;Taip;5;7;0;12
10128;Spragtukas;NYKŠTUKAI;6986034864;Taip;5;0;0;5
10129;Spragtukas;NYKŠTUKAI;9665371858;Ne;0;4;0;4
10130;Spragtukas;NYKŠTUKAI;9308064461;Taip;0;2;0;2
10131;Spragtukas;SAULUTĖ;3337355440;Taip;0;5;0;5
10132;Spragtukas;SAULUTĖ;4669257062;Taip;3;2;0;5
10133;Spragtukas;SAULUTĖ;3692960591;Taip;0;4;0;4
10134;Spragtukas;SAULUTĖ;6192381779;Taip;5;0;0;5
10135;Spragtukas;SAULUTĖ;2305568596;Taip;4;1;0;5
10136;Spragtukas;SAULUTĖ;9191831532;Taip;0;5;0;5
10137;Spragtukas;SAULUTĖ;3948232692;Taip;7;6;0;13
10138;Spragtukas;SAULUTĖ;9149954373;Taip;0;8;0;8
10139;Spragtukas;SAULUTĖ;7511680722;Taip;1;2;0;3
10140;Spragtukas;SAULUTĖ;8235791891;Taip;9;0;0;9
10141;Spragtukas;SAULUTĖ;2987638580;Taip;0;5;0;5
10142;Spragtukas;SAULUTĖ;5687853390;Taip;0;1;0;1
10143;Spragtukas;SAULUTĖ;6679886985;Taip;0;20;0;20
10144;Spragtukas;SAULUTĖ;2879077913;Ne;2;10;0;12
10145;Spragtukas;SAULUTĖ;1998148708;Taip;3;5;0;8
10146;Spragtukas;SAULUTĖ;8227086854;Taip;0;8;0;8
10147;Spragtukas;SAULUTĖ;5697451914;Taip;0;1;0;1
10148;Spragtukas;SAULUTĖ;3086399458;Taip;0;4;2;6
10149;Spragtukas;SAULUTĖ;2879614195;Taip;0;13;0;13
10150;Spragtukas;SAULUTĖ;8912031554;Taip;15;0;0;15
10151;Spragtukas;SPINDULĖLIAI;4527531194;Taip;13;0;0;13
10152;Spragtukas;SPINDULĖLIAI;8083960192;Taip;2;2;0;4
10153;Spragtukas;SPINDULĖLIAI;6228634157;Taip;0;0;1;1
10154;Spragtukas;SPINDULĖLIAI;5902286196;Taip;12;0;1;13
10155;Spragtukas;SPINDULĖLIAI;4194552077;Taip;0;0;1;1
10156;Spragtukas;SPINDULĖLIAI;5998318402;Taip;10;0;0;10
10157;Spragtukas;SPINDULĖLIAI;9074266444;Taip;6;0;0;6
10158;Spragtukas;SPINDULĖLIAI;3323280861;Taip;10;0;2;12
10159;Spragtukas;SPINDULĖLIAI;1928122722;Taip;3;2;0;5
10160;Spragtukas;SPINDULĖLIAI;3367731738;Taip;0;7;0;7
10161;Spragtukas;GINTARĖLIAI;1525489137;Taip;3;0;0;3
10162;Spragtukas;GINTARĖLIAI;5724874569;Taip;9;7;0;16
10163;Spragtukas;GINTARĖLIAI;1430632638;Ne;0;2;0;2
10164;Spragtukas;GINTARĖLIAI;8625143071;Taip;0;12;0;12
10165;Spragtukas;GINTARĖLIAI;2255007161;Taip;6;2;0;8
10166;Spragtukas;GINTARĖLIAI;6493380877;Taip;0;2;0;2
10167;Spragtukas;GINTARĖLIAI;2316071393;Taip;0;1;0;1
10168;Spragtukas;GINTARĖLIAI;8698469979;Taip;0;5;0;5
10169;Spragtukas;GINTARĖLIAI;1747417905;Taip;5;3;0;8
10170;Spragtukas;GINTARĖLIAI;6388163866;Taip;0;13;0;13
10171;Spragtukas;GINTARĖLIAI;8191270443;Taip;3;0;0;3
10172;Spragtukas;GINTARĖLIAI;3684183344;Taip;0;1;0;1
10173;Spragtukas;GINTARĖLIAI;7806145224;Taip;15;0;0;15
10174;Spragtukas;GINTARĖLIAI;2992201984;Taip;0;3;0;3
10175;Spragtukas;GINTARĖLIAI;2217627240;Taip;0;6;0;6
10176;Spragtukas;GINTARĖLIAI;1150727381;Taip;18;0;0;18
10177;Spragtukas;GINTARĖLIAI;2706473182;Taip;0;2;0;2
10178;Spragtukas;ČIPOLINO;9951226210;Taip;0;8;0;8
10179;Spragtukas;ČIPOLINO;7933945356;Taip;0;1;0;1
10180;Spragtukas;ČIPOLINO;8473814776;Taip;9;0;0;9
10181;Spragtukas;ČIPOLINO;4461217748;Taip;4;0;0;4
10182;Spragtukas;ČIPOLINO;2087416420;Taip;0;4;0;4
10183;Spragtukas;ČIPOLINO;9579825533;Taip;9;3;0;12
10184;Spragtukas;ČIPOLINO;9443091032;Taip;0;18;0;18
10185;Spragtukas;ČIPOLINO;7412489884;Taip;9;1;0;10
10186;Spragtukas;ČIPOLINO;9294770557;Taip;9;0;0;9
10187;Spragtukas;ČIPOLINO;8110631015;Taip;3;2;0;5
10188;Spragtukas;ČIPOLINO;2963449719;Taip;2;10;0;12
10189;Spragtukas;ČIPOLINO;8136108310;Taip;0;4;0;4
10190;Spragtukas;ČIPOLINO;8710910167;Taip;0;2;0;2
10191;Spragtukas;ČIPOLINO;7692148513;Taip;0;6;0;6
10192;Spragtukas;ČIPOLINO;2599579491;Taip;12;0;0;12
10193;Spragtukas;ČIPOLINO;7402797271;Taip;9;0;0;9
10194;Spragtukas;BORUŽĖLĖS;8614890958;Taip;0;7;0;7
10195;Spragtukas;BORUŽĖLĖS;2356476212;Taip;0;2;0;2
10196;Spragtukas;BORUŽĖLĖS;8287102733;Taip;5;6;0;11
10197;Spragtukas;BORUŽĖLĖS;6584145176;Taip;5;8;0;13
10198;Spragtukas;BORUŽĖLĖS;6824861247;Taip;0;2;0;2
10199;Spragtukas;BORUŽĖLĖS;7264683147;Taip;5;0;0;5
10200;Spragtukas;BORUŽĖLĖS;5556920140;Taip;0;4;0;4
10201;Spragtukas;BORUŽĖLĖS;7073092344;Taip;0;17;0;17
10202;Spragtukas;BORUŽĖLĖS;7042345781;Taip;0;2;0;2
10203;Spragtukas;BORUŽĖLĖS;1046613540;Taip;0;1;0;1
10204;Spragtukas;BORUŽĖLĖS;1180285187;Taip;9;0;0;9
10205;Spragtukas;BORUŽĖLĖS;2268649859;Taip;3;2;0;5
10206;Spragtukas;BORUŽĖLĖS;3110077272;Taip;5;0;0;5
10207;Spragtukas;BORUŽĖLĖS;3225684296;Taip;6;0;0;6
10208;Spragtukas;BORUŽĖLĖS;5940679759;Taip;10;4;0;14
10209;Spragtukas;DRUGELIAI;7058848570;Taip;4;0;0;4
10210;Spragtukas;DRUGELIAI;7271482702;Taip;0;5;0;5
10211;Spragtukas;DRUGELIAI;9099921999;Taip;1;0;0;1
10212;Spragtukas;DRUGELIAI;4441290823;Taip;11;0;0;11
10213;Spragtukas;DRUGELIAI;5440632023;Taip;0;2;0;2
10214;Spragtukas;DRUGELIAI;9310818975;Taip;0;2;3;5
10215;Spragtukas;DRUGELIAI;1493711333;Ne;4;0;0;4
10216;Spragtukas;DRUGELIAI;4742132709;Taip;0;4;0;4
10217;Spragtukas;DRUGELIAI;3423699840;Taip;0;0;1;1
10218;Spragtukas;DRUGELIAI;2026249018;Taip;1;1;0;2
10219;Spragtukas;DRUGELIAI;1487259291;Taip;7;2;0;9
10220;Spragtukas;DRUGELIAI;5225669850;Taip;0;8;0;8
10221;Spragtukas;DRUGELIAI;8109894184;Taip;0;4;0;4
10222;Spragtukas;DRUGELIAI;8396134652;Taip;3;0;3;6
10223;Spragtukas;DRUGELIAI;1784758799;Ne;5;3;0;8
10224;Spragtukas;GAIDELIAI;2541126095;Taip;11;0;0;11
10225;Spragtukas;GAIDELIAI;4097458544;Taip;4;0;0;4
10226;Spragtukas;GAIDELIAI;8957903306;Taip;4;4;1;9
10227;Spragtukas;GAIDELIAI;1326714513;Taip;0;6;0;6
10228;Spragtukas;GAIDELIAI;7108640957;Taip;4;0;0;4
10229;Spragtukas;GAIDELIAI;6370760287;Taip;6;2;0;8
10230;Spragtukas;GAIDELIAI;7911124524;Taip;3;0;0;3
10231;Spragtukas;GAIDELIAI;3216796441;Taip;0;3;0;3
10232;Spragtukas;GAIDELIAI;8440836721;Taip;13;1;0;14
10233;Spragtukas;GAIDELIAI;4535021524;Taip;5;2;0;7
10234;Spragtukas;GAIDELIAI;2679834328;Taip;8;0;0;8
10235;Spragtukas;GAIDELIAI;7912840514;Taip;0;2;0;2
10236;Spragtukas;ŽUVELĖS;9078163633;Taip;1;2;0;3
10237;Spragtukas;ŽUVELĖS;8762832644;Taip;5;0;0;5
10238;Spragtukas;ŽUVELĖS;8652973900;Taip;7;0;0;7
10239;Spragtukas;ŽUVELĖS;3261213140;Taip;0;8;0;8
10240;Spragtukas;ŽUVELĖS;5689392663;Taip;1;6;3;10
10241;Spragtukas;ŽUVELĖS;9592271053;Taip;0;2;0;2
10242;Spragtukas;ŽUVELĖS;1272075883;Taip;0;4;0;4
10243;Spragtukas;ŽUVELĖS;6465991136;Taip;0;4;0;4
10244;Spragtukas;ŽUVELĖS;9282940430;Taip;0;3;0;3
10245;Spragtukas;ŽUVELĖS;6503842956;Taip;0;3;2;5
10246;Spragtukas;ŽUVELĖS;2578400770;Taip;0;4;0;4
10247;Spragtukas;ŽUVELĖS;3139748724;Taip;0;8;0;8
10248;Spragtukas;ŽUVELĖS;8640877497;Taip;18;1;0;19
10249;Spragtukas;ŽUVELĖS;4848647219;Taip;0;6;0;6
10250;Spragtukas;ŽUVELĖS;3491418162;Taip;0;2;0;2
10251;Spragtukas;ŽUVELĖS;5836788916;Taip;0;1;0;1
10252;Spragtukas;ŽUVELĖS;5704941595;Taip;17;1;0;18
10253;Spragtukas;ŽUVELĖS;3286456855;Taip;0;1;0;1
10254;Spragtukas;ŽUVELĖS;9662188102;Taip;5;6;0;11
10255;Spragtukas;ŽUVELĖS;2539660577;Taip;0;1;0;1
10256;Spragtukas;ŽUVELĖS;6800727630;Taip;0;4;0;4
10257;Spragtukas;ŽUVELĖS;1627243902;Taip;4;1;0;5
10258;Spragtukas;RIEŠUTĖLIAI;8773952377;Taip;0;2;0;2
10259;Spragtukas;RIEŠUTĖLIAI;6797841737;Taip;3;2;0;5
10260;Spragtukas;RIEŠUTĖLIAI;8342098575;Taip;0;2;0;2
10261;Spragtukas;RIEŠUTĖLIAI;6158327941;Taip;0;2;0;2
10262;Spragtukas;RIEŠUTĖLIAI;3009567338;Taip;1;1;0;2
10263;Spragtukas;RIEŠUTĖLIAI;2648358901;Taip;0;6;0;6
10264;Spragtukas;RIEŠUTĖLIAI;3822599790;Taip;0;12;0;12
10265;Spragtukas;RIEŠUTĖLIAI;7767940027;Taip;1;1;0;2
10266;Spragtukas;RIEŠUTĖLIAI;6963190259;Taip;15;2;0;17
10267;Spragtukas;RIEŠUTĖLIAI;8732886749;Taip;0;5;0;5
10268;Spragtukas;RIEŠUTĖLIAI;9975308171;Taip;0;9;0;9
10269;Spragtukas;VIŠČIUKAI;8291401010;Taip;19;0;0;19
10270;Spragtukas;VIŠČIUKAI;6219915771;Taip;7;0;0;7
10271;Spragtukas;VIŠČIUKAI;5497023448;Taip;0;2;1;3
10272;Spragtukas;VIŠČIUKAI;2359209112;Taip;5;0;0;5
10273;Spragtukas;VIŠČIUKAI;8371817233;Taip;7;0;0;7
10274;Spragtukas;VIŠČIUKAI;4489637427;Taip;14;0;0;14
10275;Spragtukas;VIŠČIUKAI;6804843816;Taip;0;10;0;10
10276;Spragtukas;VIŠČIUKAI;9617355214;Taip;3;0;0;3
10277;Spragtukas;VIŠČIUKAI;1878079499;Taip;5;0;1;6
10278;Spragtukas;VIŠČIUKAI;9198638303;Taip;0;2;0;2
10279;Spragtukas;VIŠČIUKAI;1572602399;Taip;0;2;0;2
10280;Spragtukas;MEŠKIUKAI;7730786172;Taip;5;0;0;5
10281;Spragtukas;MEŠKIUKAI;2422384041;Taip;2;0;0;2
10282;Spragtukas;MEŠKIUKAI;1411972930;Taip;16;0;0;16
10283;Spragtukas;MEŠKIUKAI;4654665538;Taip;0;2;0;2
10284;Spragtukas;MEŠKIUKAI;9313536781;Taip;6;0;0;6
10285;Spragtukas;MEŠKIUKAI;9616402367;Taip;14;0;0;14
10286;Spragtukas;MEŠKIUKAI;1869458751;Taip;9;2;0;11
10287;Spragtukas;MEŠKIUKAI;4332445650;Taip;4;0;0;4
10288;Spragtukas;MEŠKIUKAI;4900860607;Taip;8;0;0;8
10289;Spragtukas;MEŠKIUKAI;2172787507;Taip;0;1;0;1
10290;Spragtukas;MEŠKIUKAI;6073139322;Taip;8;0;0;8
10291;Strazdelis;Žiogelių;5346485534;Taip;0;3;0;3
10292;Strazdelis;Žiogelių;9933042249;Taip;0;5;0;5
10293;Strazdelis;Žiogelių;8581533423;Taip;8;1;0;9
10294;Strazdelis;Žiogelių;8209625399;Taip;3;6;0;9
10295;Strazdelis;Žiogelių;1141752802;Taip;7;1;0;8
10296;Strazdelis;Žiogelių;3596394112;Taip;4;2;1;7
10297;Strazdelis;Žiogelių;4563247013;Taip;23;0;0;23
10298;Strazdelis;Žiogelių;6437928004;Taip;1;0;0;1
10299;Strazdelis;Žiogelių;8971395173;Taip;1;1;0;2
10300;Strazdelis;Žiogelių;4955907851;Taip;11;0;0;11
10301;Strazdelis;Žiogelių;7425818775;Taip;1;0;0;1
10302;Strazdelis;Žiogelių;9567476872;Taip;4;1;0;5
10303;Strazdelis;Žiogelių;4516288199;Taip;2;4;0;6
10304;Strazdelis;Žiogelių;3028208428;Taip;5;0;0;5
10305;Strazdelis;Žiogelių;2753635198;Taip;2;2;1;5
10306;Strazdelis;Žiogelių;1194918926;Taip;5;0;0;5
10307;Strazdelis;Žiogelių;6651360492;Taip;0;5;0;5
10308;Strazdelis;Žiogelių;7913526787;Taip;1;4;0;5
10309;Strazdelis;Žiogelių;5742215922;Taip;5;0;0;5
10310;Strazdelis;Žiogelių;8035603341;Taip;0;4;0;4
10311;Strazdelis;Šeimynėlės;6570504154;Taip;0;4;0;4
10312;Strazdelis;Šeimynėlės;3848288765;Taip;0;1;0;1
10313;Strazdelis;Šeimynėlės;5033799225;Taip;0;1;0;1
10314;Strazdelis;Šeimynėlės;1683900907;Taip;1;0;0;1
10315;Strazdelis;Šeimynėlės;2990771887;Taip;8;4;0;12
10316;Strazdelis;Šeimynėlės;2185364583;Taip;2;1;0;3
10317;Strazdelis;Šeimynėlės;7905687363;Taip;5;1;0;6
10318;Strazdelis;Šeimynėlės;4501391298;Taip;0;8;0;8
10319;Strazdelis;Šeimynėlės;1277844969;Taip;0;2;0;2
10320;Strazdelis;Šeimynėlės;1012692326;Taip;9;0;0;9
10321;Strazdelis;Šeimynėlės;8899530711;Taip;10;0;0;10
10322;Strazdelis;Šeimynėlės;5784406335;Taip;0;6;0;6
10323;Strazdelis;Šeimynėlės;5296218650;Taip;5;3;0;8
10324;Strazdelis;Šeimynėlės;1754106518;Taip;5;0;0;5
10325;Strazdelis;Šeimynėlės;9806107189;Taip;6;1;0;7
10326;Strazdelis;Šeimynėlės;8295035233;Taip;0;4;0;4
10327;Strazdelis;Genelio;9586256979;Taip;0;4;0;4
10328;Strazdelis;Genelio;3084249678;Taip;0;6;0;6
10329;Strazdelis;Genelio;8333151969;Taip;0;4;0;4
10330;Strazdelis;Genelio;7083940713;Taip;0;1;0;1
10331;Strazdelis;Genelio;6271193831;Taip;11;0;0;11
10332;Strazdelis;Genelio;6480803618;Taip;7;1;0;8
10333;Strazdelis;Genelio;9490861272;Taip;5;5;0;10
10334;Strazdelis;Genelio;6071502600;Taip;0;3;0;3
10335;Strazdelis;Genelio;3713797440;Taip;0;3;0;3
10336;Strazdelis;Genelio;1034497200;Taip;14;0;0;14
10337;Strazdelis;Genelio;2459718449;Taip;0;2;0;2
10338;Strazdelis;Genelio;5714581201;Taip;0;1;0;1
10339;Strazdelis;Genelio;8956634754;Taip;6;1;0;7
10340;Strazdelis;Genelio;8762859576;Taip;7;1;0;8
10341;Strazdelis;Genelio;2306665561;Taip;0;3;0;3
10342;Strazdelis;Vikruolių;8287554571;Taip;0;1;0;1
10343;Strazdelis;Vikruolių;1901641517;Taip;0;2;0;2
10344;Strazdelis;Vikruolių;1704292727;Taip;5;6;0;11
10345;Strazdelis;Vikruolių;5892430004;Taip;0;9;0;9
10346;Strazdelis;Vikruolių;4617237063;Taip;0;2;1;3
10347;Strazdelis;Vikruolių;3036380561;Taip;0;2;1;3
10348;Strazdelis;Vikruolių;8371999002;Taip;0;7;0;7
10349;Strazdelis;Vikruolių;4562530311;Taip;0;0;4;4
10350;Strazdelis;Vikruolių;4004930488;Taip;3;0;0;3
10351;Strazdelis;Vikruolių;5768674837;Taip;0;1;4;5
10352;Strazdelis;Vikruolių;6046139859;Taip;7;0;0;7
10353;Strazdelis;Vikruolių;7349106795;Taip;0;4;2;6
10354;Strazdelis;Vikruolių;9761595867;Taip;1;1;0;2
10355;Strazdelis;Vikruolių;4448556404;Taip;3;2;0;5
10356;Strazdelis;Vikruolių;7876385010;Taip;0;0;4;4
10357;Strazdelis;Vikruolių;8854150040;Taip;0;4;0;4
10358;Strazdelis;Vyturėlių;7471890377;Taip;0;0;2;2
10359;Strazdelis;Vyturėlių;2848984531;Taip;6;0;0;6
10360;Strazdelis;Vyturėlių;4159072583;Taip;5;2;1;8
10361;Strazdelis;Vyturėlių;2662549392;Taip;0;4;0;4
10362;Strazdelis;Vyturėlių;7469848482;Taip;0;1;0;1
10363;Strazdelis;Vyturėlių;2251157025;Taip;0;0;1;1
10364;Strazdelis;Vyturėlių;1841285441;Taip;0;1;0;1
10365;Strazdelis;Vyturėlių;5904388732;Taip;0;5;0;5
10366;Strazdelis;Vyturėlių;3460993302;Taip;0;0;2;2
10367;Strazdelis;Vyturėlių;7393083827;Taip;3;0;1;4
10368;Strazdelis;Vyturėlių;6555803164;Taip;3;2;0;5
10369;Strazdelis;Vyturėlių;1955166372;Taip;2;0;2;4
10370;Strazdelis;Vyturėlių;1706026100;Taip;0;4;0;4
10371;Strazdelis;Vyturėlių;4873707286;Taip;0;6;0;6
10372;Strazdelis;Vyturėlių;6527855940;Taip;0;4;0;4
10373;Strazdelis;Vyturėlių;2824416350;Taip;0;4;0;4
10374;Strazdelis;Vyturėlių;3610250359;Taip;0;4;0;4
10375;Strazdelis;Vyturėlių;2789987994;Taip;5;0;0;5
10376;Strazdelis;Vyturėlių;1173067724;Taip;8;0;0;8
10377;Strazdelis;Vyturėlių;2766970956;Taip;0;4;0;4
10378;Strazdelis;Varpelio;9502341478;Taip;0;10;0;10
10379;Strazdelis;Varpelio;5924324241;Taip;12;0;1;13
10380;Strazdelis;Varpelio;6954336739;Taip;2;0;0;2
10381;Strazdelis;Varpelio;3456287323;Taip;8;2;0;10
10382;Strazdelis;Varpelio;2438598773;Taip;11;0;0;11
10383;Strazdelis;Varpelio;5425585036;Taip;4;1;0;5
10384;Strazdelis;Varpelio;1018598897;Taip;0;1;0;1
10385;Strazdelis;Varpelio;5314676261;Taip;6;2;0;8
10386;Strazdelis;Varpelio;1787432390;Taip;0;4;0;4
10387;Strazdelis;Varpelio;1455467186;Taip;5;4;0;9
10388;Strazdelis;Varpelio;9955443967;Taip;9;0;0;9
10389;Strazdelis;Pelėdžiukų;7087235151;Taip;14;4;0;18
10390;Strazdelis;Pelėdžiukų;1770338988;Taip;4;2;1;7
10391;Strazdelis;Pelėdžiukų;3030445367;Taip;6;0;0;6
10392;Strazdelis;Pelėdžiukų;8953577585;Taip;5;0;0;5
10393;Strazdelis;Pelėdžiukų;3426039979;Taip;16;0;0;16
10394;Strazdelis;Pelėdžiukų;4715198107;Taip;0;4;0;4
10395;Strazdelis;Pelėdžiukų;4334385271;Taip;11;1;0;12
10396;Strazdelis;Pelėdžiukų;8677659019;Taip;0;1;0;1
10397;Strazdelis;Pelėdžiukų;4848650799;Taip;0;1;0;1
10398;Strazdelis;Pelėdžiukų;7716476995;Taip;0;1;0;1
10399;Strazdelis;Pelėdžiukų;8356680705;Taip;0;2;1;3
10400;Strazdelis;Pelėdžiukų;8554043784;Taip;0;19;0;19
10401;Strazdelis;Pelėdžiukų;1952086370;Taip;2;1;0;3
10402;Strazdelis;Pelėdžiukų;7802337169;Taip;0;4;0;4
10403;Strazdelis;Saulutės;5604313206;Taip;0;3;0;3
10404;Strazdelis;Saulutės;8877104963;Taip;0;3;0;3
10405;Strazdelis;Saulutės;4726043862;Taip;0;4;0;4
10406;Strazdelis;Saulutės;8686828982;Taip;0;4;0;4
10407;Strazdelis;Saulutės;2852253325;Taip;0;1;0;1
10408;Strazdelis;Saulutės;3943914976;Taip;1;0;0;1
10409;Strazdelis;Saulutės;8938997208;Taip;0;1;0;1
10410;Strazdelis;Saulutės;2589303722;Taip;0;1;0;1
10411;Strazdelis;Saulutės;5232064496;Taip;0;2;0;2
10412;Strazdelis;Saulutės;2081538505;Taip;14;3;0;17
10413;Strazdelis;Saulutės;9776075027;Taip;7;0;0;7
10414;Strazdelis;Saulutės;6311710825;Taip;0;9;0;9
10415;Strazdelis;Saulutės;1021364759;Taip;0;5;0;5
10416;Strazdelis;Bitutės;8485509145;Taip;0;5;0;5
10417;Strazdelis;Bitutės;6508933324;Taip;2;0;0;2
10418;Strazdelis;Bitutės;4020547762;Taip;0;7;0;7
10419;Strazdelis;Bitutės;8753316532;Taip;3;3;0;6
10420;Strazdelis;Bitutės;9555240419;Taip;4;2;0;6
10421;Strazdelis;Bitutės;3043580835;Taip;0;1;0;1
10422;Strazdelis;Bitutės;1539984888;Taip;0;4;0;4
10423;Strazdelis;Bitutės;4400849922;Taip;0;5;0;5
10424;Strazdelis;Bitutės;7890064837;Taip;19;1;0;20
10425;Strazdelis;Bitutės;1881071425;Taip;0;2;0;2
10426;Strazdelis;Bitutės;2908567982;Taip;14;0;0;14
10427;Strazdelis;Bitutės;9548465554;Taip;4;1;0;5
10428;Strazdelis;Bitutės;7466648222;Taip;0;1;0;1
10429;Strazdelis;Bitutės;2963535523;Taip;0;2;0;2
10430;Strazdelis;Bitutės;4369569609;Taip;0;6;0;6
10431;Strazdelis;Bitutės;3149930355;Taip;0;1;0;1
10432;Strazdelis;Bitutės;8277333786;Taip;10;0;0;10
10433;Strazdelis;Mažylių;9357195019;Taip;7;0;0;7
10434;Strazdelis;Mažylių;5256750516;Taip;0;6;0;6
10435;Strazdelis;Mažylių;4965049621;Taip;0;1;0;1
10436;Strazdelis;Mažylių;2378910473;Taip;0;11;0;11
10437;Strazdelis;Mažylių;4699373769;Taip;0;4;0;4
10438;Strazdelis;Mažylių;3648883435;Taip;13;2;0;15
10439;Strazdelis;Mažylių;6788732053;Taip;9;0;0;9
10440;Strazdelis;Mažylių;2764495554;Taip;9;0;0;9
10441;Strazdelis;Mažylių;7039347901;Taip;9;0;0;9
10442;Strazdelis;Mažylių;4904388387;Taip;14;0;0;14
10443;Strazdelis;Mažylių;3082900425;Taip;10;0;0;10
10444;Strazdelis;Mažylių;3900225484;Taip;8;0;0;8
10445;Strazdelis;Mažylių;8734458997;Taip;5;4;1;10
10446;Strazdelis;Mažylių;3561551193;Taip;0;9;0;9
10447;Strazdelis;Mažylių;1932428439;Taip;4;3;0;7
10448;Strazdelis;Mažylių;2871841427;Taip;7;6;0;13
10449;Strazdelis;Mažylių;3572665646;Taip;6;0;0;6
10450;Strazdelis;Mažylių;8699020650;Taip;3;0;0;3
10451;Strazdelis;Pabiručių;6853311266;Taip;2;6;0;8
10452;Strazdelis;Pabiručių;1823053560;Taip;9;0;1;10
10453;Strazdelis;Pabiručių;7065489134;Taip;2;4;0;6
10454;Strazdelis;Pabiručių;6113204629;Taip;0;1;0;1
10455;Strazdelis;Pabiručių;9931075329;Taip;4;0;0;4
10456;Strazdelis;Pabiručių;2474988890;Taip;0;7;0;7
10457;Strazdelis;Pabiručių;9036931027;Taip;0;1;0;1
10458;Strazdelis;Pabiručių;4335313098;Taip;0;6;0;6
10459;Strazdelis;Pabiručių;6199087019;Taip;7;14;0;21
10460;Strazdelis;Pabiručių;2230287744;Taip;4;2;0;6
10461;Strazdelis;Pabiručių;5109807137;Taip;0;4;0;4
10462;Strazdelis;Pabiručių;5326864534;Taip;7;0;0;7
10463;Šermukšnėlė;MOLINUKAI;9746313951;Taip;0;13;0;13
10464;Šermukšnėlė;MOLINUKAI;4638109666;Taip;0;4;0;4
10465;Šermukšnėlė;MOLINUKAI;9329824053;Taip;0;4;0;4
10466;Šermukšnėlė;MOLINUKAI;2714018690;Taip;4;4;0;8
10467;Šermukšnėlė;MOLINUKAI;5262882873;Taip;5;2;0;7
10468;Šermukšnėlė;MOLINUKAI;2985284699;Taip;0;1;0;1
10469;Šermukšnėlė;MOLINUKAI;4983510683;Taip;0;1;0;1
10470;Šermukšnėlė;MOLINUKAI;7385114026;Taip;0;1;0;1
10471;Šermukšnėlė;MOLINUKAI;2784732759;Taip;5;0;3;8
10472;Šermukšnėlė;MOLINUKAI;3342919832;Taip;5;4;0;9
10473;Šermukšnėlė;MOLINUKAI;9337047371;Taip;0;4;0;4
10474;Šermukšnėlė;MOLINUKAI;2098090763;Taip;0;2;0;2
10475;Šermukšnėlė;MOLINUKAI;5835100042;Taip;0;0;1;1
10476;Šermukšnėlė;MOLINUKAI;8000479161;Taip;0;2;1;3
10477;Šermukšnėlė;MOLINUKAI;4952285322;Taip;0;5;0;5
10478;Šermukšnėlė;MOLINUKAI;5733048755;Taip;0;0;2;2
10479;Šermukšnėlė;MOLINUKAI;6608458145;Taip;5;4;0;9
10480;Šermukšnėlė;MOLINUKAI;8104182167;Taip;8;0;2;10
10481;Šermukšnėlė;MOLINUKAI;6988120570;Taip;0;15;0;15
10482;Šermukšnėlė;MOLINUKAI;8728441474;Taip;5;4;0;9
10483;Šermukšnėlė;MOLINUKAI;4075151928;Taip;0;0;1;1
10484;Šermukšnėlė;MOLINUKAI;4968522498;Taip;12;5;0;17
10485;Šermukšnėlė;ŠIAUDINUKAI;7249568196;Taip;0;1;0;1
10486;Šermukšnėlė;ŠIAUDINUKAI;3451361097;Taip;4;0;0;4
10487;Šermukšnėlė;ŠIAUDINUKAI;7002917737;Taip;11;0;0;11
10488;Šermukšnėlė;ŠIAUDINUKAI;7785671936;Taip;3;0;0;3
10489;Šermukšnėlė;ŠIAUDINUKAI;3637882900;Taip;0;10;0;10
10490;Šermukšnėlė;ŠIAUDINUKAI;1159472154;Taip;0;4;2;6
10491;Šermukšnėlė;ŠIAUDINUKAI;4956414941;Taip;7;0;1;8
10492;Šermukšnėlė;ŠIAUDINUKAI;3499394539;Taip;2;9;2;13
10493;Šermukšnėlė;ŠIAUDINUKAI;1157979179;Taip;0;7;0;7
10494;Šermukšnėlė;ŠIAUDINUKAI;3082272196;Taip;0;0;1;1
10495;Šermukšnėlė;ŠIAUDINUKAI;9903310024;Taip;5;0;0;5
10496;Šermukšnėlė;ŠIAUDINUKAI;9012757607;Taip;1;4;0;5
10497;Šermukšnėlė;ŠIAUDINUKAI;3550736579;Taip;10;10;0;20
10498;Šermukšnėlė;ŠIAUDINUKAI;5993599994;Taip;5;0;3;8
10499;Šermukšnėlė;ŠIAUDINUKAI;6077798297;Taip;0;4;2;6
10500;Šermukšnėlė;ŠIAUDINUKAI;2351386211;Taip;1;0;5;6
10501;Šermukšnėlė;ŠIAUDINUKAI;1437314920;Taip;0;2;0;2
10502;Šermukšnėlė;TOŠINUKAI;3994316729;Taip;0;4;0;4
10503;Šermukšnėlė;TOŠINUKAI;7229632099;Taip;5;4;0;9
10504;Šermukšnėlė;TOŠINUKAI;7038705221;Taip;0;1;3;4
10505;Šermukšnėlė;TOŠINUKAI;9035625467;Taip;6;0;0;6
10506;Šermukšnėlė;TOŠINUKAI;3081548524;Taip;0;4;0;4
10507;Šermukšnėlė;TOŠINUKAI;1753169856;Taip;0;2;0;2
10508;Šermukšnėlė;TOŠINUKAI;9442514813;Taip;0;4;1;5
10509;Šermukšnėlė;TOŠINUKAI;9585435700;Taip;3;0;3;6
10510;Šermukšnėlė;TOŠINUKAI;1131780941;Taip;0;0;1;1
10511;Šermukšnėlė;TOŠINUKAI;6286039101;Taip;5;0;0;5
10512;Šermukšnėlė;TOŠINUKAI;8691777167;Taip;2;0;0;2
10513;Šermukšnėlė;TOŠINUKAI;2534758615;Taip;5;1;0;6
10514;Šermukšnėlė;TOŠINUKAI;1622834854;Taip;4;4;0;8
10515;Šermukšnėlė;TOŠINUKAI;4945395564;Taip;6;0;3;9
10516;Šermukšnėlė;TOŠINUKAI;2163955454;Taip;0;2;1;3
10517;Šermukšnėlė;TOŠINUKAI;7106405983;Taip;1;1;1;3
10518;Šermukšnėlė;ODINUKAI;4422415026;Taip;0;13;0;13
10519;Šermukšnėlė;ODINUKAI;5545018656;Taip;0;4;0;4
10520;Šermukšnėlė;ODINUKAI;2176788727;Taip;0;0;2;2
10521;Šermukšnėlė;ODINUKAI;5733540837;Taip;0;3;1;4
10522;Šermukšnėlė;ODINUKAI;7262199284;Taip;2;2;0;4
10523;Šermukšnėlė;ODINUKAI;5159461963;Taip;0;4;0;4
10524;Šermukšnėlė;ODINUKAI;5354978646;Taip;23;0;0;23
10525;Šermukšnėlė;ODINUKAI;1882432812;Taip;10;3;1;14
10526;Šermukšnėlė;ODINUKAI;3949629658;Taip;0;3;0;3
10527;Šermukšnėlė;ODINUKAI;6105915822;Taip;0;4;1;5
10528;Šermukšnėlė;ODINUKAI;7667114310;Taip;5;2;0;7
10529;Šermukšnėlė;ODINUKAI;7245206247;Taip;0;3;0;3
10530;Šermukšnėlė;ODINUKAI;5397385093;Taip;0;4;2;6
10531;Šermukšnėlė;ODINUKAI;4331948700;Taip;0;1;1;2
10532;Šermukšnėlė;ODINUKAI;6718242890;Taip;4;4;0;8
10533;Šermukšnėlė;ODINUKAI;9664249364;Taip;5;2;0;7
10534;Šermukšnėlė;ODINUKAI;1064222922;Taip;0;4;0;4
10535;Šermukšnėlė;ODINUKAI;7770630580;Taip;0;1;2;3
10536;Šermukšnėlė;ODINUKAI;6194188831;Taip;0;4;1;5
10537;Šermukšnėlė;KRIAUKLELĖS;7458930634;Taip;4;0;0;4
10538;Šermukšnėlė;KRIAUKLELĖS;6342714998;Taip;0;0;1;1
10539;Šermukšnėlė;KRIAUKLELĖS;6946711443;Taip;0;0;4;4
10540;Šermukšnėlė;KRIAUKLELĖS;9074111563;Taip;0;3;0;3
10541;Šermukšnėlė;KRIAUKLELĖS;9908568127;Taip;2;1;2;5
10542;Šermukšnėlė;KRIAUKLELĖS;9783673534;Taip;9;0;0;9
10543;Šermukšnėlė;KRIAUKLELĖS;5408843906;Taip;5;1;1;7
10544;Šermukšnėlė;KRIAUKLELĖS;4810571143;Taip;0;2;0;2
10545;Šermukšnėlė;KRIAUKLELĖS;6797936390;Taip;0;5;0;5
10546;Šermukšnėlė;KRIAUKLELĖS;8092422909;Taip;3;0;0;3
10547;Šermukšnėlė;KRIAUKLELĖS;6286235756;Taip;0;1;0;1
10548;Šermukšnėlė;KRIAUKLELĖS;9246072554;Taip;0;1;0;1
10549;Šermukšnėlė;KRIAUKLELĖS;9080074486;Taip;10;0;0;10
10550;Šermukšnėlė;KRIAUKLELĖS;7098953763;Taip;3;0;1;4
10551;Šermukšnėlė;VYTINUKAI;2235123503;Taip;6;0;1;7
10552;Šermukšnėlė;VYTINUKAI;5605191023;Taip;4;0;0;4
10553;Šermukšnėlė;VYTINUKAI;6928863055;Taip;0;1;0;1
10554;Šermukšnėlė;VYTINUKAI;8558117857;Taip;0;0;10;10
10555;Šermukšnėlė;VYTINUKAI;6531113007;Taip;0;2;0;2
10556;Šermukšnėlė;VYTINUKAI;1318170904;Taip;0;0;1;1
10557;Šermukšnėlė;VYTINUKAI;8200175951;Taip;5;6;0;11
10558;Šermukšnėlė;VYTINUKAI;6149973884;Taip;0;0;2;2
10559;Šermukšnėlė;VYTINUKAI;7532979465;Taip;5;1;1;7
10560;Šermukšnėlė;VYTINUKAI;7211488009;Taip;0;0;1;1
10561;Šermukšnėlė;VYTINUKAI;7546040491;Taip;23;0;0;23
10562;Šermukšnėlė;VYTINUKAI;2698741674;Taip;0;4;0;4
10563;Šermukšnėlė;VYTINUKAI;9872479998;Taip;10;0;0;10
10564;Šermukšnėlė;VYTINUKAI;8802335133;Taip;0;3;0;3
10565;Šermukšnėlė;GINTARĖLIAI;5069572637;Taip;0;1;0;1
10566;Šermukšnėlė;GINTARĖLIAI;8249749948;Taip;0;3;1;4
10567;Šermukšnėlė;GINTARĖLIAI;3747531232;Taip;0;4;0;4
10568;Šermukšnėlė;GINTARĖLIAI;1996859146;Taip;0;1;1;2
10569;Šermukšnėlė;GINTARĖLIAI;4176986876;Taip;0;11;0;11
10570;Šermukšnėlė;GINTARĖLIAI;7036078780;Taip;11;0;0;11
10571;Šermukšnėlė;GINTARĖLIAI;1994737857;Taip;5;6;0;11
10572;Šermukšnėlė;GINTARĖLIAI;4619811264;Taip;2;6;0;8
10573;Šermukšnėlė;GINTARĖLIAI;5886893562;Taip;14;0;0;14
10574;Šermukšnėlė;GINTARĖLIAI;4783726095;Taip;0;1;0;1
10575;Šermukšnėlė;GINTARĖLIAI;9714566919;Taip;6;0;0;6
10576;Šermukšnėlė;GINTARĖLIAI;5172187141;Taip;0;5;0;5
10577;Šermukšnėlė;GINTARĖLIAI;3688946505;Taip;13;0;1;14
10578;Šermukšnėlė;GINTARĖLIAI;5905330617;Taip;0;0;1;1
10579;Šermukšnėlė;GINTARĖLIAI;1636944853;Taip;0;8;0;8
10580;Šermukšnėlė;GINTARĖLIAI;7053319091;Taip;8;0;0;8
10581;Šermukšnėlė;GINTARĖLIAI;6351841889;Taip;9;0;2;11
10582;Šermukšnėlė;GINTARĖLIAI;6698650179;Taip;1;1;0;2
10583;Šermukšnėlė;GINTARĖLIAI;8639470631;Taip;3;6;0;9
10584;Šermukšnėlė;GINTARĖLIAI;8541743148;Taip;0;1;0;1
10585;Šermukšnėlė;AKMENUKAI;8669676262;Taip;0;10;0;10
10586;Šermukšnėlė;AKMENUKAI;3148857617;Taip;0;8;0;8
10587;Šermukšnėlė;AKMENUKAI;4965640386;Taip;0;4;1;5
10588;Šermukšnėlė;AKMENUKAI;3639954786;Taip;9;3;1;13
10589;Šermukšnėlė;AKMENUKAI;7843128263;Taip;7;4;0;11
10590;Šermukšnėlė;AKMENUKAI;9805841777;Taip;7;3;0;10
10591;Šermukšnėlė;AKMENUKAI;3945291560;Taip;2;0;0;2
10592;Šermukšnėlė;AKMENUKAI;5660238634;Taip;11;5;0;16
10593;Šermukšnėlė;AKMENUKAI;6067298318;Taip;5;0;0;5
10594;Šermukšnėlė;AKMENUKAI;5678559268;Taip;9;2;0;11
10595;Šermukšnėlė;AKMENUKAI;8479230675;Taip;0;2;0;2
10596;Šermukšnėlė;AKMENUKAI;6162830167;Taip;1;1;0;2
10597;Šermukšnėlė;AKMENUKAI;2913363351;Taip;2;0;6;8
10598;Šermukšnėlė;AKMENUKAI;3613456202;Taip;7;0;4;11
10599;Šermukšnėlė;AKMENUKAI;2506945279;Taip;0;0;1;1
10600;Šermukšnėlė;AKMENUKAI;8709426669;Taip;9;10;0;19
10601;Šermukšnėlė;AKMENUKAI;6585484701;Taip;5;1;0;6
10602;Šermukšnėlė;AKMENUKAI;6599779539;Taip;0;12;0;12
10603;Šermukšnėlė;AKMENUKAI;9876533442;Taip;10;0;4;14
10604;Šermukšnėlė;AKMENUKAI;3653792683;Taip;0;4;2;6
10605;Šermukšnėlė;SIŪLINUKAI;2967000352;Taip;0;3;0;3
10606;Šermukšnėlė;SIŪLINUKAI;4528448735;Taip;0;4;3;7
10607;Šermukšnėlė;SIŪLINUKAI;2740644605;Taip;15;4;0;19
10608;Šermukšnėlė;SIŪLINUKAI;8454298610;Taip;5;0;0;5
10609;Šermukšnėlė;SIŪLINUKAI;1819553019;Ne;11;0;0;11
10610;Šermukšnėlė;SIŪLINUKAI;7568969509;Taip;3;0;1;4
10611;Šermukšnėlė;SIŪLINUKAI;7758886713;Taip;0;2;0;2
10612;Šermukšnėlė;SIŪLINUKAI;4390650081;Taip;0;3;1;4
10613;Šermukšnėlė;SIŪLINUKAI;7934772640;Taip;0;4;0;4
10614;Šermukšnėlė;SIŪLINUKAI;3994075596;Ne;0;9;3;12
10615;Šermukšnėlė;SIŪLINUKAI;3098629992;Taip;0;2;0;2
10616;Šermukšnėlė;SIŪLINUKAI;6231057889;Ne;6;0;1;7
10617;Šermukšnėlė;SIŪLINUKAI;3106890807;Taip;0;0;2;2
10618;Šermukšnėlė;SIŪLINUKAI;3979766151;Taip;7;0;0;7
10619;Šermukšnėlė;SIŪLINUKAI;9534316724;Taip;2;4;0;6
10620;Šermukšnėlė;SIŪLINUKAI;9703804879;Taip;0;0;2;2
10621;Šermukšnėlė;SIŪLINUKAI;6030012939;Taip;6;0;0;6
10622;Šermukšnėlė;MEDINUKAi;2568480087;Taip;23;0;0;23
10623;Šermukšnėlė;MEDINUKAi;2868258867;Taip;6;9;0;15
10624;Šermukšnėlė;MEDINUKAi;5483843510;Taip;0;0;4;4
10625;Šermukšnėlė;MEDINUKAi;7832178585;Taip;0;1;0;1
10626;Šermukšnėlė;MEDINUKAi;7523588943;Taip;0;2;0;2
10627;Šermukšnėlė;MEDINUKAi;1931894084;Taip;5;0;1;6
10628;Šermukšnėlė;MEDINUKAi;9535836301;Taip;3;0;2;5
10629;Šermukšnėlė;MEDINUKAi;3138507073;Taip;6;0;5;11
10630;Šermukšnėlė;MEDINUKAi;1502704170;Taip;0;3;5;8
10631;Šermukšnėlė;MEDINUKAi;9247356229;Taip;4;10;0;14
10632;Šermukšnėlė;MEDINUKAi;3206222470;Taip;5;0;0;5
10633;Šermukšnėlė;MEDINUKAi;5751303170;Taip;10;5;0;15
10634;Šermukšnėlė;MEDINUKAi;2810624440;Taip;0;2;0;2
10635;Šermukšnėlė;MEDINUKAi;3955219247;Taip;0;5;0;5
10636;Šermukšnėlė;MEDINUKAi;5564759354;Taip;9;0;1;10
10637;Šermukšnėlė;MEDINUKAi;5081685546;Taip;10;0;1;11
10638;Šermukšnėlė;SKUDURINUKAI;5162694179;Taip;4;2;0;6
10639;Šermukšnėlė;SKUDURINUKAI;9005316719;Taip;0;7;0;7
10640;Šermukšnėlė;SKUDURINUKAI;7353340444;Taip;6;0;0;6
10641;Šermukšnėlė;SKUDURINUKAI;6618875999;Taip;4;0;1;5
10642;Šermukšnėlė;SKUDURINUKAI;4839548718;Taip;7;0;0;7
10643;Šermukšnėlė;SKUDURINUKAI;2154197839;Taip;0;0;1;1
10644;Šermukšnėlė;SKUDURINUKAI;2156273039;Taip;0;0;1;1
10645;Šermukšnėlė;SKUDURINUKAI;9777470572;Taip;0;2;0;2
10646;Šermukšnėlė;SKUDURINUKAI;3024192802;Taip;6;0;0;6
10647;Šermukšnėlė;SKUDURINUKAI;1208356789;Taip;6;0;0;6
10648;Šermukšnėlė;SKUDURINUKAI;6437380493;Taip;3;0;1;4
10649;Šermukšnėlė;SKUDURINUKAI;8726532739;Taip;0;1;0;1
10650;Šermukšnėlė;PAGRANDUKAI;6185588116;Taip;0;0;3;3
10651;Šermukšnėlė;PAGRANDUKAI;1209135668;Taip;15;0;0;15
10652;Šermukšnėlė;PAGRANDUKAI;8641098720;Taip;3;1;0;4
10653;Šermukšnėlė;PAGRANDUKAI;8130815072;Taip;0;6;0;6
10654;Šermukšnėlė;PAGRANDUKAI;9246403711;Taip;5;0;2;7
10655;Šermukšnėlė;PAGRANDUKAI;3105388312;Taip;8;4;1;13
10656;Šermukšnėlė;PAGRANDUKAI;2300950399;Taip;0;1;0;1
10657;Šermukšnėlė;PAGRANDUKAI;7570038521;Taip;5;0;1;6
10658;Šermukšnėlė;PAGRANDUKAI;4627034424;Taip;10;4;1;15
10659;Šermukšnėlė;PAGRANDUKAI;7777832161;Taip;0;0;1;1
10660;Šermukšnėlė;PAGRANDUKAI;1761737605;Taip;0;0;1;1
10661;Šermukšnėlė;PAGRANDUKAI;5397987456;Taip;15;0;0;15
10662;Šermukšnėlė;PAGRANDUKAI;3705620362;Taip;5;0;1;6
10663;Šypsena;NYKŠTUKAI;3806651280;Taip;0;14;0;14
10664;Šypsena;NYKŠTUKAI;4330797734;Taip;14;0;0;14
10665;Šypsena;NYKŠTUKAI;7876871684;Taip;6;0;1;7
10666;Šypsena;NYKŠTUKAI;6055482561;Ne;18;3;0;21
10667;Šypsena;NYKŠTUKAI;6028006499;Taip;6;1;0;7
10668;Šypsena;NYKŠTUKAI;3724483762;Ne;10;0;0;10
10669;Šypsena;NYKŠTUKAI;7817486488;Taip;9;4;8;21
10670;Šypsena;NYKŠTUKAI;9862387726;Taip;15;0;8;23
10671;Šypsena;NYKŠTUKAI;8094166916;Taip;2;8;0;10
10672;Šypsena;NYKŠTUKAI;5446516798;Taip;5;0;0;5
10673;Šypsena;NYKŠTUKAI;5094556499;Taip;7;0;0;7
10674;Šypsena;NYKŠTUKAI;4496704989;Taip;10;0;7;17
10675;Šypsena;NYKŠTUKAI;7471913547;Taip;14;0;1;15
10676;Šypsena;NYKŠTUKAI;7174068697;Taip;6;0;2;8
10677;Šypsena;NYKŠTUKAI;7905089772;Taip;10;7;1;18
10678;Šypsena;NYKŠTUKAI;7960872132;Ne;7;5;6;18
10679;Šypsena;NYKŠTUKAI;4260693029;Ne;6;8;0;14
10680;Šypsena;SPINDULIUKAI;8627994583;Taip;15;0;2;17
10681;Šypsena;SPINDULIUKAI;8913058656;Taip;8;0;0;8
10682;Šypsena;SPINDULIUKAI;9702364620;Ne;0;2;0;2
10683;Šypsena;SPINDULIUKAI;8508569167;Taip;1;0;0;1
10684;Šypsena;SPINDULIUKAI;2179657619;Ne;0;5;0;5
10685;Šypsena;SPINDULIUKAI;2900195046;Taip;7;0;0;7
10686;Šypsena;SPINDULIUKAI;5818211923;Ne;4;0;0;4
10687;Šypsena;SPINDULIUKAI;3724645162;Taip;0;1;0;1
10688;Šypsena;SPINDULIUKAI;8665786789;Taip;9;0;1;10
10689;Šypsena;SPINDULIUKAI;3003901966;Taip;13;3;0;16
10690;Šypsena;SPINDULIUKAI;2182189246;Taip;15;0;0;15
10691;Šypsena;SPINDULIUKAI;1431850136;Taip;7;4;0;11
10692;Šypsena;SPINDULIUKAI;1716274053;Ne;15;0;4;19
10693;Šypsena;SPINDULIUKAI;8439694239;Taip;0;6;0;6
10694;Šypsena;SPINDULIUKAI;6377979434;Taip;10;1;0;11
10695;Šypsena;SPINDULIUKAI;6724776618;Taip;5;4;1;10
10696;Šypsena;SPINDULIUKAI;2790906806;Ne;2;0;0;2
10697;Šypsena;SKRUZDELIUKAI;7898387398;Taip;8;0;0;8
10698;Šypsena;SKRUZDELIUKAI;1324902555;Taip;10;1;0;11
10699;Šypsena;SKRUZDELIUKAI;5222603743;Taip;2;4;0;6
10700;Šypsena;SKRUZDELIUKAI;7120597034;Taip;1;4;1;6
10701;Šypsena;SKRUZDELIUKAI;5879506651;Taip;8;0;0;8
10702;Šypsena;SKRUZDELIUKAI;3823623458;Ne;3;0;0;3
10703;Šypsena;SKRUZDELIUKAI;3429836513;Taip;13;4;10;27
10704;Šypsena;SKRUZDELIUKAI;4695547847;Taip;0;0;1;1
10705;Šypsena;SKRUZDELIUKAI;3901424559;Taip;0;9;5;14
10706;Šypsena;SKRUZDELIUKAI;6713182218;Taip;0;8;0;8
10707;Šypsena;SKRUZDELIUKAI;8215278033;Taip;12;0;0;12
10708;Šypsena;SKRUZDELIUKAI;7537442618;Taip;0;7;0;7
10709;Šypsena;SKRUZDELIUKAI;8566236342;Taip;10;0;2;12
10710;Šypsena;SKRUZDELIUKAI;9704350208;Ne;0;8;0;8
10711;Šypsena;SKRUZDELIUKAI;5906001927;Taip;4;0;0;4
10712;Šypsena;SKRUZDELIUKAI;6951845385;Taip;6;0;0;6
10713;Šypsena;SKRUZDELIUKAI;7877396588;Taip;0;1;5;6
10714;Šypsena;SKRUZDELIUKAI;8765509994;Taip;6;0;0;6
10715;Šypsena;SKRUZDELIUKAI;4520148322;Taip;0;7;5;12
10716;Šypsena;Bitutės;1422418997;Taip;0;3;0;3
10717;Šypsena;Bitutės;2312828770;Taip;0;0;1;1
10718;Šypsena;Bitutės;3130841241;Taip;0;0;1;1
10719;Šypsena;Bitutės;3810433774;Ne;4;8;5;17
10720;Šypsena;Bitutės;9623451754;Ne;6;5;0;11
10721;Šypsena;Bitutės;5611440056;Ne;1;4;0;5
10722;Šypsena;Bitutės;1558614852;Taip;10;1;0;11
10723;Šypsena;Bitutės;1897176871;Taip;6;0;0;6
10724;Šypsena;Bitutės;1181590127;Taip;0;9;0;9
10725;Šypsena;Bitutės;4808041625;Taip;0;4;0;4
10726;Šypsena;Bitutės;5834057370;Taip;0;4;0;4
10727;Šypsena;Bitutės;3809171499;Taip;0;10;0;10
10728;Šypsena;Bitutės;5928432220;Taip;0;0;1;1
10729;Šypsena;Bitutės;5504570516;Taip;5;0;2;7
10730;Šypsena;Bitutės;1063834589;Taip;3;0;0;3
10731;Šypsena;Bitutės;5369445077;Taip;0;4;0;4
10732;Šypsena;Bitutės;2798819321;Taip;0;5;0;5
10733;Šypsena;Bitutės;4450146424;Taip;8;0;0;8
10734;Šypsena;MEŠKIUKAI;9696633725;Taip;4;0;3;7
10735;Šypsena;MEŠKIUKAI;4011596895;Taip;6;2;0;8
10736;Šypsena;MEŠKIUKAI;7234904026;Ne;8;1;0;9
10737;Šypsena;MEŠKIUKAI;3951000812;Taip;0;23;0;23
10738;Šypsena;MEŠKIUKAI;2177181171;Taip;15;0;0;15
10739;Šypsena;MEŠKIUKAI;1657019248;Taip;4;0;0;4
10740;Šypsena;MEŠKIUKAI;8756079118;Taip;0;7;0;7
10741;Šypsena;MEŠKIUKAI;4960714853;Taip;15;0;0;15
10742;Šypsena;MEŠKIUKAI;6224937025;Taip;5;2;0;7
10743;Šypsena;MEŠKIUKAI;1934857313;Taip;10;3;0;13
10744;Šypsena;MEŠKIUKAI;8109877136;Taip;6;0;2;8
10745;Šypsena;MEŠKIUKAI;3643736553;Taip;9;0;0;9
10746;Šypsena;MEŠKIUKAI;9841955736;Taip;10;0;1;11
10747;Šypsena;MEŠKIUKAI;2692869989;Taip;15;0;0;15
10748;Šypsena;BORUŽĖLĖS;3563748951;Taip;9;0;5;14
10749;Šypsena;BORUŽĖLĖS;8456684826;Ne;1;4;0;5
10750;Šypsena;BORUŽĖLĖS;1153036896;Ne;16;0;0;16
10751;Šypsena;BORUŽĖLĖS;3624678823;Taip;11;0;1;12
10752;Šypsena;BORUŽĖLĖS;9232229854;Taip;15;0;0;15
10753;Šypsena;BORUŽĖLĖS;1597728767;Taip;0;2;0;2
10754;Šypsena;BORUŽĖLĖS;3285293143;Taip;13;0;0;13
10755;Šypsena;BORUŽĖLĖS;6905376170;Taip;4;0;0;4
10756;Šypsena;BORUŽĖLĖS;3205854107;Taip;3;0;0;3
10757;Šnekutis;DRUGELIŲ;9543014297;Taip;0;12;0;12
10758;Šnekutis;DRUGELIŲ;3096125224;Taip;0;4;0;4
10759;Šnekutis;DRUGELIŲ;3386995244;Taip;0;9;0;9
10760;Šnekutis;DRUGELIŲ;8984597121;Taip;2;0;0;2
10761;Šnekutis;DRUGELIŲ;8810371475;Taip;0;13;0;13
10762;Šnekutis;DRUGELIŲ;7680962037;Taip;19;1;0;20
10763;Šnekutis;DRUGELIŲ;3611064172;Taip;2;2;0;4
10764;Šnekutis;DRUGELIŲ;1556960616;Taip;0;2;0;2
10765;Šnekutis;DRUGELIŲ;4380966487;Taip;0;1;0;1
10766;Šnekutis;DRUGELIŲ;7954240439;Taip;3;18;0;21
10767;Šnekutis;DRUGELIŲ;6330033887;Taip;0;2;0;2
10768;Šnekutis;DRUGELIŲ;6071004512;Taip;5;0;0;5
10769;Šnekutis;DRUGELIŲ;1504945841;Taip;20;0;0;20
10770;Šnekutis;DRUGELIŲ;6305168453;Taip;3;0;0;3
10771;Šnekutis;DRUGELIŲ;1902486846;Taip;5;0;0;5
10772;Šnekutis;Kačiukų;2914145045;Taip;14;0;0;14
10773;Šnekutis;Kačiukų;2656152037;Taip;0;4;0;4
10774;Šnekutis;Kačiukų;5521822696;Ne;0;1;1;2
10775;Šnekutis;Kačiukų;2144568225;Taip;4;1;0;5
10776;Šnekutis;Kačiukų;4624075875;Taip;0;0;3;3
10777;Šnekutis;Kačiukų;3635781445;Taip;3;0;5;8
10778;Šnekutis;Kačiukų;7109850241;Taip;3;1;0;4
10779;Šnekutis;Kačiukų;2386547087;Taip;4;0;0;4
10780;Šnekutis;Kačiukų;6072420827;Taip;12;0;1;13
10781;Šnekutis;Kačiukų;2626247219;Taip;5;0;0;5
10782;Šnekutis;Kačiukų;7707897830;Taip;4;0;0;4
10783;Šnekutis;Kačiukų;2852111627;Taip;0;4;0;4
10784;Šnekutis;Kačiukų;3214549246;Taip;5;2;0;7
10785;Šnekutis;Kačiukų;9574210410;Taip;5;2;0;7
10786;Šnekutis;Kačiukų;8417485561;Taip;3;0;1;4
10787;Šnekutis;Kačiukų;5727476284;Taip;4;0;1;5
10788;Šnekutis;Pėlėdžiukų;4835202527;Taip;0;1;2;3
10789;Šnekutis;Pėlėdžiukų;7089000987;Taip;1;1;3;5
10790;Šnekutis;Pėlėdžiukų;9326455786;Taip;0;0;2;2
10791;Šnekutis;Pėlėdžiukų;2843483435;Taip;10;0;0;10
10792;Šnekutis;Pėlėdžiukų;6405894763;Ne;0;10;0;10
10793;Šnekutis;Pėlėdžiukų;3889176018;Taip;5;0;0;5
10794;Šnekutis;Pėlėdžiukų;9862362744;Taip;4;0;0;4
10795;Šnekutis;Pėlėdžiukų;6015384795;Ne;0;0;2;2
10796;Šnekutis;Pėlėdžiukų;7307895397;Taip;0;0;1;1
10797;Šnekutis;Pėlėdžiukų;3344425033;Ne;0;0;1;1
10798;Šnekutis;Pėlėdžiukų;6544973632;Taip;4;0;0;4
10799;Šnekutis;Pėlėdžiukų;8219465079;Taip;2;8;0;10
10800;Šnekutis;Pėlėdžiukų;2779793970;Taip;0;6;0;6
10801;Šnekutis;Pėlėdžiukų;6146988521;Taip;1;3;0;4
10802;Šnekutis;Pėlėdžiukų;5519015388;Taip;0;3;1;4
10803;Šnekutis;Pėlėdžiukų;3628210526;Taip;5;0;0;5
10804;Šnekutis;Pėlėdžiukų;7344776758;Taip;0;0;1;1
10805;Šnekutis;Pėlėdžiukų;5970951526;Taip;0;9;0;9
10806;Šnekutis;Pėlėdžiukų;3937465849;Taip;4;0;0;4
10807;Šnekutis;Boružėlių;9887692849;Taip;0;0;3;3
10808;Šnekutis;Boružėlių;3115675798;Taip;7;0;0;7
10809;Šnekutis;Boružėlių;1805259980;Taip;9;0;0;9
10810;Šnekutis;Boružėlių;7006343288;Taip;10;0;0;10
10811;Šnekutis;Boružėlių;9322106995;Taip;2;0;0;2
10812;Šnekutis;Boružėlių;1248466603;Taip;2;0;0;2
10813;Šnekutis;Boružėlių;3842436406;Taip;0;1;1;2
10814;Šnekutis;Boružėlių;9772257715;Taip;2;2;0;4
10815;Šnekutis;Boružėlių;3593766968;Taip;0;1;0;1
10816;Šnekutis;Boružėlių;5919317274;Taip;0;0;1;1
10817;Šnekutis;Boružėlių;7200356364;Taip;5;0;0;5
10818;Šnekutis;Boružėlių;9709701441;Taip;0;5;0;5
10819;Šnekutis;Meškučių;1219175855;Taip;5;0;0;5
10820;Šnekutis;Meškučių;7980166125;Taip;8;9;0;17
10821;Šnekutis;Meškučių;6041045276;Taip;14;0;0;14
10822;Šnekutis;Meškučių;2134556666;Taip;18;0;0;18
10823;Šnekutis;Meškučių;7775818807;Taip;3;3;0;6
10824;Šnekutis;Meškučių;9752334636;Taip;7;0;0;7
10825;Šnekutis;Meškučių;7704236799;Taip;8;0;0;8
10826;Šnekutis;Meškučių;8612528998;Taip;5;2;0;7
10827;Šnekutis;Meškučių;6915324469;Taip;12;0;0;12
10828;Šnekutis;Meškučių;5785972840;Taip;6;0;0;6
10829;Šnekutis;Meškučių;4963132460;Taip;7;0;0;7
10830;Šnekutis;Meškučių;5506037153;Taip;6;0;0;6
10831;Šnekutis;Meškučių;1772197145;Taip;4;2;0;6
10832;Šnekutis;Meškučių;4452941417;Taip;13;0;0;13
10833;Šnekutis;Meškučių;8332860563;Taip;7;0;0;7
10834;Šnekutis;Meškučių;2615956847;Taip;11;0;0;11
10835;Šnekutis;Viščiukų;3588737003;Taip;10;4;0;14
10836;Šnekutis;Viščiukų;4848437026;Taip;7;1;0;8
10837;Šnekutis;Viščiukų;5059417996;Taip;0;0;1;1
10838;Šnekutis;Viščiukų;7914683654;Taip;4;4;0;8
10839;Šnekutis;Viščiukų;6849168221;Taip;5;0;0;5
10840;Šnekutis;Viščiukų;2817345948;Taip;10;0;0;10
10841;Šnekutis;Viščiukų;8061450452;Taip;14;0;0;14
10842;Šnekutis;Viščiukų;9238064074;Taip;15;0;0;15
10843;Šnekutis;Viščiukų;2258811969;Taip;12;0;1;13
10844;Šnekutis;Viščiukų;3852214850;Taip;18;0;0;18
10845;Šnekutis;Viščiukų;3869428583;Taip;4;0;0;4
10846;Šnekutis;Viščiukų;9433668798;Taip;7;0;0;7
10847;Šnekutis;Viščiukų;5185096482;Taip;2;4;0;6
10848;Šnekutis;Viščiukų;1811580823;Taip;0;5;0;5
10849;Šnekutis;Viščiukų;9385583890;Taip;6;17;0;23
10850;Užupiukas;VYTURĖLIŲ;9807212956;Taip;0;0;7;7
10851;Užupiukas;VYTURĖLIŲ;5182110542;Taip;0;0;7;7
10852;Užupiukas;VYTURĖLIŲ;3690562985;Taip;0;0;5;5
10853;Užupiukas;VYTURĖLIŲ;7034777770;Taip;0;0;1;1
10854;Užupiukas;VYTURĖLIŲ;4449466321;Taip;0;0;1;1
10855;Užupiukas;VYTURĖLIŲ;9872846882;Taip;6;0;0;6
10856;Užupiukas;VYTURĖLIŲ;5694960072;Taip;0;0;5;5
10857;Užupiukas;VYTURĖLIŲ;3879735445;Taip;5;0;1;6
10858;Užupiukas;VYTURĖLIŲ;2377079878;Taip;0;3;0;3
10859;Užupiukas;VYTURĖLIŲ;3474990673;Taip;6;0;0;6
10860;Užupiukas;VYTURĖLIŲ;1434083187;Taip;0;0;1;1
10861;Užupiukas;VYTURĖLIŲ;5851602817;Taip;0;0;2;2
10862;Užupiukas;VYTURĖLIŲ;9556937880;Taip;17;4;0;21
10863;Užupiukas;VYTURĖLIŲ;4055044580;Taip;0;0;5;5
10864;Užupiukas;VYTURĖLIŲ;3275112189;Taip;2;0;5;7
10865;Užupiukas;VYTURĖLIŲ;5280778870;Taip;0;0;4;4
10866;Užupiukas;VYTURĖLIŲ;7735497084;Taip;0;0;3;3
10867;Užupiukas;VYTURĖLIŲ;9278445367;Taip;19;4;0;23
10868;Užupiukas;VYTURĖLIŲ;8931872728;Taip;15;0;0;15
10869;Užupiukas;KAČIUKŲ;3567963511;Taip;10;4;1;15
10870;Užupiukas;KAČIUKŲ;9991552624;Taip;0;4;0;4
10871;Užupiukas;KAČIUKŲ;3048959458;Taip;5;4;1;10
10872;Užupiukas;KAČIUKŲ;1809036046;Taip;6;4;0;10
10873;Užupiukas;KAČIUKŲ;1102468034;Taip;5;4;0;9
10874;Užupiukas;KAČIUKŲ;1464016943;Taip;7;4;0;11
10875;Užupiukas;KAČIUKŲ;4485435274;Taip;0;0;2;2
10876;Užupiukas;KAČIUKŲ;1102293237;Taip;4;0;0;4
10877;Užupiukas;KAČIUKŲ;9386211193;Taip;0;4;2;6
10878;Užupiukas;KAČIUKŲ;1388346927;Taip;0;2;0;2
10879;Užupiukas;KAČIUKŲ;7092857844;Taip;0;0;1;1
10880;Užupiukas;KAČIUKŲ;2606742144;Taip;0;1;0;1
10881;Užupiukas;KAČIUKŲ;3543913063;Taip;0;3;2;5
10882;Užupiukas;KAČIUKŲ;4920190785;Taip;0;6;0;6
10883;Užupiukas;KAČIUKŲ;1414888906;Taip;5;0;0;5
10884;Užupiukas;KAČIUKŲ;5436401811;Taip;0;0;1;1
10885;Užupiukas;KAČIUKŲ;3001874900;Taip;8;4;0;12
10886;Užupiukas;KAČIUKŲ;3794021404;Ne;0;4;1;5
10887;Užupiukas;KAČIUKŲ;6685567970;Taip;1;0;0;1
10888;Užupiukas;DRUGELIŲ;8876174256;Ne;8;0;12;20
10889;Užupiukas;DRUGELIŲ;5239006321;Taip;0;1;5;6
10890;Užupiukas;DRUGELIŲ;7581152903;Taip;0;0;4;4
10891;Užupiukas;DRUGELIŲ;6698907535;Taip;0;0;4;4
10892;Užupiukas;DRUGELIŲ;3419182422;Taip;0;0;9;9
10893;Užupiukas;DRUGELIŲ;4854016957;Taip;0;0;4;4
10894;Užupiukas;DRUGELIŲ;4595291532;Taip;0;0;12;12
10895;Užupiukas;DRUGELIŲ;3383643388;Taip;0;1;0;1
10896;Užupiukas;DRUGELIŲ;3961733676;Taip;11;0;1;12
10897;Užupiukas;DRUGELIŲ;5006880916;Taip;3;0;4;7
10898;Užupiukas;DRUGELIŲ;9715624372;Taip;0;10;6;16
10899;Užupiukas;DRUGELIŲ;1108429907;Taip;0;0;9;9
10900;Užupiukas;DRUGELIŲ;9295230331;Taip;0;0;11;11
10901;Užupiukas;DRUGELIŲ;3575209839;Taip;0;2;2;4
10902;Užupiukas;DRUGELIŲ;5361599156;Taip;0;4;0;4
10903;Užupiukas;DRUGELIŲ;9577167600;Taip;8;0;0;8
10904;Užupiukas;DRUGELIŲ;8692826414;Taip;0;0;3;3
10905;Užupiukas;DRUGELIŲ;1156471313;Taip;0;3;0;3
10906;Užupiukas;DRUGELIŲ;4680027403;Taip;0;0;7;7
10907;Užupiukas;EŽIUKŲ;8936209423;Taip;5;0;2;7
10908;Užupiukas;EŽIUKŲ;2522356285;Taip;0;3;0;3
10909;Užupiukas;EŽIUKŲ;5055376157;Taip;8;0;0;8
10910;Užupiukas;EŽIUKŲ;3235855849;Taip;0;0;1;1
10911;Užupiukas;EŽIUKŲ;9116065216;Taip;0;0;1;1
10912;Užupiukas;EŽIUKŲ;4788900708;Taip;5;1;0;6
10913;Užupiukas;EŽIUKŲ;4670096314;Taip;5;0;3;8
10914;Užupiukas;EŽIUKŲ;7914295007;Taip;14;0;0;14
10915;Užupiukas;EŽIUKŲ;7671705684;Taip;0;0;2;2
10916;Užupiukas;EŽIUKŲ;6016947840;Taip;3;0;0;3
10917;Užupiukas;EŽIUKŲ;8443732431;Taip;2;0;0;2
10918;Užupiukas;EŽIUKŲ;4583779329;Taip;7;0;0;7
10919;Užupiukas;EŽIUKŲ;1757695746;Taip;7;0;0;7
10920;Užupiukas;EŽIUKŲ;7299810108;Taip;2;0;1;3
10921;Užupiukas;EŽIUKŲ;1989125835;Taip;0;0;23;23
10922;Užupiukas;EŽIUKŲ;5866437622;Taip;4;0;4;8
10923;Užupiukas;EŽIUKŲ;5784908270;Taip;13;0;3;16
10924;Užupiukas;EŽIUKŲ;9163947073;Taip;0;0;3;3
10925;Užupiukas;EŽIUKŲ;4034821342;Taip;7;0;1;8
10926;Užupiukas;EŽIUKŲ;7589905741;Taip;9;0;1;10
10927;Užupiukas;BORUŽĖLIŲ;8467502933;Taip;6;0;1;7
10928;Užupiukas;BORUŽĖLIŲ;2804115700;Taip;0;0;1;1
10929;Užupiukas;BORUŽĖLIŲ;4151757682;Taip;15;0;1;16
10930;Užupiukas;BORUŽĖLIŲ;1473606331;Taip;0;0;3;3
10931;Užupiukas;BORUŽĖLIŲ;9312234251;Taip;3;0;2;5
10932;Užupiukas;BORUŽĖLIŲ;4570457987;Taip;8;0;1;9
10933;Užupiukas;BORUŽĖLIŲ;4841475687;Taip;0;0;1;1
10934;Užupiukas;BORUŽĖLIŲ;9714322911;Taip;5;0;0;5
10935;Užupiukas;BORUŽĖLIŲ;7107441792;Taip;0;0;2;2
10936;Užupiukas;BORUŽĖLIŲ;7105857162;Taip;0;1;1;2
10937;Užupiukas;BORUŽĖLIŲ;8881187663;Taip;1;0;0;1
10938;Užupiukas;BORUŽĖLIŲ;7895825571;Taip;0;0;1;1
10939;Užupiukas;BORUŽĖLIŲ;8518137669;Taip;3;0;0;3
10940;Užupiukas;BORUŽĖLIŲ;7169272175;Taip;6;0;0;6
10941;Užupiukas;BORUŽĖLIŲ;7716893423;Taip;0;0;5;5
10942;Užupiukas;BORUŽĖLIŲ;6857321547;Taip;0;0;3;3
10943;Užupiukas;SPINDULIUKŲ;7443013255;Taip;0;1;0;1
10944;Užupiukas;SPINDULIUKŲ;3656400244;Taip;0;8;0;8
10945;Užupiukas;SPINDULIUKŲ;5718382826;Taip;5;4;2;11
10946;Užupiukas;SPINDULIUKŲ;2580733127;Taip;0;4;1;5
10947;Užupiukas;SPINDULIUKŲ;1791922219;Taip;0;5;0;5
10948;Užupiukas;SPINDULIUKŲ;1146968021;Taip;0;1;1;2
10949;Užupiukas;SPINDULIUKŲ;3829013911;Taip;4;1;1;6
10950;Užupiukas;SPINDULIUKŲ;9212428150;Taip;5;0;0;5
10951;Užupiukas;SPINDULIUKŲ;8001099421;Taip;9;1;0;10
10952;Užupiukas;SPINDULIUKŲ;4401569800;Taip;0;4;1;5
10953;Užupiukas;SPINDULIUKŲ;1391826582;Taip;0;2;1;3
10954;Užupiukas;SPINDULIUKŲ;8960813016;Taip;0;1;0;1
10955;Užupiukas;SPINDULIUKŲ;9132605734;Taip;8;4;0;12
10956;Užupiukas;SPINDULIUKŲ;8347350503;Taip;9;4;1;14
10957;Užupiukas;SPINDULIUKŲ;7532497390;Taip;2;1;0;3
10958;Užupiukas;SPINDULIUKŲ;9209209113;Taip;13;4;0;17
10959;Užupiukas;SPINDULIUKŲ;5168946019;Taip;0;1;2;3
10960;Užupiukas;SPINDULIUKŲ;5116564840;Taip;0;0;4;4
10961;Užupiukas;SPINDULIUKŲ;8519118225;Taip;0;3;0;3
10962;Užupiukas;ŽVIRBLIUKŲ;5085660507;Taip;3;6;0;9
10963;Užupiukas;ŽVIRBLIUKŲ;9925592494;Taip;10;0;0;10
10964;Užupiukas;ŽVIRBLIUKŲ;4710910251;Taip;0;14;0;14
10965;Užupiukas;ŽVIRBLIUKŲ;9428884149;Taip;0;0;4;4
10966;Užupiukas;ŽVIRBLIUKŲ;2210437775;Taip;4;4;0;8
10967;Užupiukas;ŽVIRBLIUKŲ;1995228207;Taip;4;0;0;4
10968;Užupiukas;ŽVIRBLIUKŲ;1496541880;Taip;0;10;9;19
10969;Užupiukas;ŽVIRBLIUKŲ;1684901495;Taip;4;1;0;5
10970;Užupiukas;ŽVIRBLIUKŲ;2390955083;Taip;0;8;0;8
10971;Užupiukas;ŽVIRBLIUKŲ;3768945773;Taip;0;6;0;6
10972;Užupiukas;ŽVIRBLIUKŲ;3224193396;Taip;0;3;0;3
10973;Užupiukas;ŽVIRBLIUKŲ;4785494419;Taip;0;2;0;2
10974;Užupiukas;ŽVIRBLIUKŲ;8119142600;Taip;5;5;1;11
10975;Užupiukas;ŽVIRBLIUKŲ;2362568676;Taip;4;0;0;4
10976;Užupiukas;ŽVIRBLIUKŲ;7530856195;Taip;0;4;0;4
10977;Užupiukas;ŽVIRBLIUKŲ;6308141378;Taip;0;4;0;4
10978;Užupiukas;ŽVIRBLIUKŲ;1843171673;Taip;9;4;0;13
10979;Užupiukas;ŽVIRBLIUKŲ;9719845726;Taip;8;2;0;10
10980;Užupiukas;ŽVIRBLIUKŲ;1647271985;Taip;5;0;0;5
10981;Užupiukas;PELĖDŽIUKŲ;3398225200;Taip;2;4;1;7
10982;Užupiukas;PELĖDŽIUKŲ;6699322898;Taip;17;4;0;21
10983;Užupiukas;PELĖDŽIUKŲ;5204808398;Taip;0;4;1;5
10984;Užupiukas;PELĖDŽIUKŲ;6512355340;Taip;0;5;1;6
10985;Užupiukas;PELĖDŽIUKŲ;9906475253;Taip;0;4;7;11
10986;Užupiukas;PELĖDŽIUKŲ;3171528288;Taip;0;0;1;1
10987;Užupiukas;PELĖDŽIUKŲ;7860601571;Taip;9;4;6;19
10988;Užupiukas;PELĖDŽIUKŲ;3611922301;Taip;0;4;1;5
10989;Užupiukas;PELĖDŽIUKŲ;8020138690;Taip;0;0;2;2
10990;Užupiukas;PELĖDŽIUKŲ;9774124589;Ne;1;4;1;6
10991;Užupiukas;PELĖDŽIUKŲ;2724216446;Taip;4;7;0;11
10992;Užupiukas;PELĖDŽIUKŲ;6823724962;Taip;0;1;0;1
10993;Užupiukas;PELĖDŽIUKŲ;9446562736;Taip;0;4;1;5
10994;Užupiukas;PELĖDŽIUKŲ;5072363435;Taip;0;4;1;5
10995;Užupiukas;PELĖDŽIUKŲ;1651249962;Taip;0;4;1;5
10996;Užupiukas;PELĖDŽIUKŲ;5538327364;Taip;1;0;0;1
10997;Užupiukas;PELĖDŽIUKŲ;1526296386;Taip;0;2;2;4
10998;Užupiukas;PELĖDŽIUKŲ;8720638097;Taip;0;1;0;1
10999;Užupiukas;PELĖDŽIUKŲ;3057147440;Taip;0;1;0;1
11000;Užupiukas;PELĖDŽIUKŲ;6370918943;Taip;0;4;0;4
11001;Užupiukas;PELĖDŽIUKŲ;1100574872;Taip;5;4;1;10
11002;Užupiukas;VARPELIŲ;7919242126;Taip;0;0;1;1
11003;Užupiukas;VARPELIŲ;9310238442;Taip;0;0;3;3
11004;Užupiukas;VARPELIŲ;5941280824;Taip;0;0;13;13
11005;Užupiukas;VARPELIŲ;2485426055;Taip;13;0;0;13
11006;Užupiukas;VARPELIŲ;2752139377;Taip;2;0;0;2
11007;Užupiukas;VARPELIŲ;4106614478;Taip;0;0;1;1
11008;Užupiukas;VARPELIŲ;1407429980;Taip;0;0;1;1
11009;Užupiukas;VARPELIŲ;4811619739;Taip;0;2;0;2
11010;Užupiukas;VARPELIŲ;9523512906;Taip;11;0;1;12
11011;Užupiukas;VARPELIŲ;3745080560;Taip;0;0;1;1
11012;Užupiukas;VARPELIŲ;5148672602;Taip;10;0;2;12
11013;Užupiukas;VARPELIŲ;2769924857;Taip;0;0;3;3
11014;Užupiukas;VARPELIŲ;4112143599;Taip;0;7;0;7
11015;Užupiukas;VARPELIŲ;7628420639;Taip;8;0;0;8
11016;Užupiukas;VARPELIŲ;6879206867;Taip;4;0;8;12
11017;Užupiukas;VARPELIŲ;6736111909;Taip;0;0;23;23
11018;Užupiukas;VARPELIŲ;4206519159;Taip;0;0;2;2
11019;Užupiukas;VARPELIŲ;9514298829;Taip;0;4;2;6
11020;Užupiukas;VARPELIŲ;3394103404;Taip;11;0;0;11
11021;Užupiukas;VARPELIŲ;4446988239;Taip;0;0;2;2
11022;Užupiukas;SAULUČIŲ;5704945892;Taip;0;4;1;5
11023;Užupiukas;SAULUČIŲ;2681679016;Taip;0;0;1;1
11024;Užupiukas;SAULUČIŲ;8163092636;Taip;5;0;1;6
11025;Užupiukas;SAULUČIŲ;1976775494;Taip;8;0;1;9
11026;Užupiukas;SAULUČIŲ;3341292382;Taip;9;0;0;9
11027;Užupiukas;SAULUČIŲ;2211595125;Taip;13;0;0;13
11028;Užupiukas;SAULUČIŲ;7643286183;Taip;3;0;0;3
11029;Užupiukas;SAULUČIŲ;2814556305;Taip;0;0;3;3
11030;Užupiukas;SAULUČIŲ;7209853233;Taip;0;0;1;1
11031;Užupiukas;SAULUČIŲ;9953994943;Taip;0;9;0;9
11032;Užupiukas;SAULUČIŲ;7956550754;Taip;4;0;1;5
11033;Užupiukas;SAULUČIŲ;5469735455;Taip;0;1;5;6
11034;Užupiukas;SAULUČIŲ;8489545569;Taip;0;0;1;1
11035;Užupiukas;SAULUČIŲ;7990479988;Taip;0;10;1;11
11036;Užupiukas;SAULUČIŲ;4691413468;Taip;0;6;0;6
11037;Užupiukas;SAULUČIŲ;7423292334;Taip;0;3;2;5
11038;Užupiukas;SAULUČIŲ;9216626936;Taip;0;4;7;11
11039;Užupiukas;SAULUČIŲ;9709440406;Taip;4;0;5;9
11040;Užupiukas;SAULUČIŲ;9434907771;Taip;0;3;3;6
11041;Užupiukas;LAPIUKŲ;9833934299;Taip;0;1;0;1
11042;Užupiukas;LAPIUKŲ;2679915982;Taip;0;1;0;1
11043;Užupiukas;LAPIUKŲ;6004467875;Taip;0;1;1;2
11044;Užupiukas;LAPIUKŲ;1718048938;Taip;0;4;0;4
11045;Užupiukas;LAPIUKŲ;7986962850;Taip;0;1;0;1
11046;Užupiukas;LAPIUKŲ;2517606394;Taip;4;0;6;10
11047;Užupiukas;LAPIUKŲ;7161001771;Taip;7;0;0;7
11048;Užupiukas;LAPIUKŲ;1886792898;Taip;0;3;0;3
11049;Užupiukas;LAPIUKŲ;6967184410;Taip;0;2;0;2
11050;Užupiukas;LAPIUKŲ;1178152392;Taip;5;4;0;9
11051;Užupiukas;LAPIUKŲ;7029091978;Taip;0;1;6;7
11052;Užupiukas;LAPIUKŲ;3311694266;Taip;0;2;0;2
11053;Užupiukas;LAPIUKŲ;1041972540;Taip;0;1;0;1
11054;Užupiukas;LAPIUKŲ;4467470795;Taip;0;1;0;1
11055;Užupiukas;LAPIUKŲ;3333547785;Taip;4;5;1;10
11056;Užupiukas;LAPIUKŲ;8529259340;Taip;5;4;0;9
11057;Užupiukas;LAPIUKŲ;8252575784;Taip;4;0;0;4
11058;Užupiukas;LAPIUKŲ;7247347675;Taip;0;4;0;4
11059;Užupiukas;NYKŠTUKŲ;1399112659;Taip;7;7;0;14
11060;Užupiukas;NYKŠTUKŲ;4379182756;Taip;1;0;0;1
11061;Užupiukas;NYKŠTUKŲ;3094320206;Taip;3;0;0;3
11062;Užupiukas;NYKŠTUKŲ;9118614894;Taip;4;4;0;8
11063;Užupiukas;NYKŠTUKŲ;1358906847;Taip;4;4;0;8
11064;Užupiukas;NYKŠTUKŲ;6628511386;Taip;9;0;1;10
11065;Užupiukas;NYKŠTUKŲ;5343951688;Taip;3;0;0;3
11066;Užupiukas;NYKŠTUKŲ;5556719499;Taip;5;0;4;9
11067;Užupiukas;NYKŠTUKŲ;6716173079;Taip;9;1;0;10
11068;Užupiukas;NYKŠTUKŲ;4441941216;Taip;15;0;2;17
11069;Užupiukas;NYKŠTUKŲ;4489962171;Ne;13;4;0;17
11070;Užupiukas;NYKŠTUKŲ;1139748215;Taip;9;0;1;10
11071;Vaidilutė;Žiogelis;9568450630;Taip;0;1;2;3
11072;Vaidilutė;Žiogelis;8789527552;Taip;0;4;0;4
11073;Vaidilutė;Žiogelis;7319037375;Taip;0;0;3;3
11074;Vaidilutė;Žiogelis;4838951446;Taip;0;1;1;2
11075;Vaidilutė;Žiogelis;7494818866;Taip;0;4;0;4
11076;Vaidilutė;Žiogelis;5500950179;Taip;7;0;0;7
11077;Vaidilutė;Žiogelis;7306768961;Taip;0;4;1;5
11078;Vaidilutė;Žiogelis;7532115462;Taip;0;2;0;2
11079;Vaidilutė;Žiogelis;9437865610;Taip;2;1;0;3
11080;Vaidilutė;Žiogelis;1140011879;Taip;1;4;5;10
11081;Vaidilutė;Žiogelis;9563257771;Taip;0;2;2;4
11082;Vaidilutė;Žiogelis;3059654988;Taip;0;5;1;6
11083;Vaidilutė;Žiogelis;1341696594;Taip;0;4;1;5
11084;Vaidilutė;Žiogelis;1141947715;Taip;0;4;9;13
11085;Vaidilutė;Žiogelis;5482030284;Taip;0;4;0;4
11086;Vaidilutė;Žiogelis;8505156287;Taip;0;2;0;2
11087;Vaidilutė;Žiogelis;2189753894;Taip;0;0;3;3
11088;Vaidilutė;Žiogelis;2081959307;Taip;0;4;0;4
11089;Vaidilutė;Rūtelė;6449710777;Taip;0;0;1;1
11090;Vaidilutė;Rūtelė;2444426554;Taip;0;0;1;1
11091;Vaidilutė;Rūtelė;4887753072;Taip;0;3;2;5
11092;Vaidilutė;Rūtelė;7726116370;Taip;5;0;0;5
11093;Vaidilutė;Rūtelė;2876157676;Taip;0;0;1;1
11094;Vaidilutė;Rūtelė;3557654689;Taip;1;0;0;1
11095;Vaidilutė;Rūtelė;8257746012;Taip;2;0;0;2
11096;Vaidilutė;Rūtelė;8444010416;Taip;0;0;2;2
11097;Vaidilutė;Rūtelė;4568108299;Taip;0;4;0;4
11098;Vaidilutė;Rūtelė;1998966302;Taip;0;0;3;3
11099;Vaidilutė;Rūtelė;5026620305;Taip;4;0;1;5
11100;Vaidilutė;Rūtelė;3826303389;Taip;7;0;0;7
11101;Vaidilutė;Rūtelė;4469754560;Taip;0;9;0;9
11102;Vaidilutė;Rūtelė;5918039529;Taip;6;0;2;8
11103;Vaidilutė;Rūtelė;7660273021;Taip;4;5;1;10
11104;Vaidilutė;Rūtelė;6795083491;Taip;0;0;3;3
11105;Vaidilutė;Rūtelė;6604575848;Taip;0;0;3;3
11106;Vaidilutė;Rūtelė;7649954695;Ne;9;4;0;13
11107;Vaidilutė;Rūtelė;5797505797;Taip;5;0;0;5
11108;Vaidilutė;Voveraitė;3248203941;Taip;4;0;0;4
11109;Vaidilutė;Voveraitė;1608646909;Taip;10;0;0;10
11110;Vaidilutė;Voveraitė;9429544108;Taip;0;0;9;9
11111;Vaidilutė;Voveraitė;5652381296;Taip;0;0;1;1
11112;Vaidilutė;Voveraitė;8377824920;Taip;0;5;0;5
11113;Vaidilutė;Voveraitė;3299081380;Taip;0;8;2;10
11114;Vaidilutė;Voveraitė;3634285869;Taip;10;0;10;20
11115;Vaidilutė;Voveraitė;7703578508;Taip;5;0;5;10
11116;Vaidilutė;Voveraitė;3150642420;Taip;4;0;1;5
11117;Vaidilutė;Voveraitė;5855762068;Taip;0;2;0;2
11118;Vaidilutė;Voveraitė;8177787790;Taip;0;3;0;3
11119;Vaidilutė;Voveraitė;7327131165;Taip;5;4;4;13
11120;Vaidilutė;Voveraitė;2318578603;Taip;0;4;7;11
11121;Vaidilutė;Voveraitė;9372280434;Taip;0;1;0;1
11122;Vaidilutė;Voveraitė;1372767364;Ne;0;0;3;3
11123;Vaidilutė;Voveraitė;4738318120;Taip;0;5;0;5
11124;Vaidilutė;Voveraitė;3319615121;Taip;0;2;1;3
11125;Vaidilutė;Voveraitė;6299324271;Ne;5;0;0;5
11126;Vaidilutė;Voveraitė;4186708502;Taip;0;0;4;4
11127;Vaidilutė;Voveraitė;2855672500;Taip;0;10;0;10
11128;Vaidilutė;Voveraitė;8053548602;Taip;10;0;9;19
11129;Vaidilutė;Saulutė;2164241264;Taip;9;1;0;10
11130;Vaidilutė;Saulutė;4648985217;Taip;0;4;0;4
11131;Vaidilutė;Saulutė;4805621473;Taip;6;0;0;6
11132;Vaidilutė;Saulutė;4348206726;Taip;3;14;0;17
11133;Vaidilutė;Saulutė;5008411199;Taip;3;1;0;4
11134;Vaidilutė;Saulutė;5405461987;Taip;0;0;3;3
11135;Vaidilutė;Saulutė;6928815317;Taip;10;0;0;10
11136;Vaidilutė;Saulutė;1283676263;Taip;0;1;17;18
11137;Vaidilutė;Saulutė;8629789128;Taip;15;0;0;15
11138;Vaidilutė;Saulutė;8413764934;Taip;5;0;0;5
11139;Vaidilutė;Saulutė;2315322608;Taip;0;10;1;11
11140;Vaidilutė;Saulutė;7075509397;Taip;13;3;0;16
11141;Vaidilutė;Saulutė;4760330697;Taip;0;1;0;1
11142;Vaidilutė;Saulutė;5205356977;Taip;0;4;0;4
11143;Vaidilutė;Saulutė;5095161432;Taip;4;0;0;4
11144;Vaidilutė;Saulutė;7572407329;Taip;4;2;0;6
11145;Vaidilutė;Saulutė;4963577351;Taip;2;0;4;6
11146;Vaidilutė;Saulutė;6527155865;Taip;10;1;2;13
11147;Vaidilutė;Žibutė;4085959509;Taip;10;3;0;13
11148;Vaidilutė;Žibutė;1001320466;Taip;3;0;0;3
11149;Vaidilutė;Žibutė;3051006765;Taip;3;0;0;3
11150;Vaidilutė;Žibutė;7903242996;Taip;13;0;3;16
11151;Vaidilutė;Žibutė;7400197367;Taip;6;1;0;7
11152;Vaidilutė;Žibutė;5236154349;Taip;3;0;0;3
11153;Vaidilutė;Žibutė;3980894528;Taip;5;0;0;5
11154;Vaidilutė;Žibutė;1362256314;Taip;0;5;0;5
11155;Vaidilutė;Žibutė;7940581813;Taip;6;0;0;6
11156;Vaidilutė;Žibutė;2767482145;Taip;0;0;2;2
11157;Vaidilutė;Žibutė;7765298370;Taip;4;10;1;15
11158;Vaidilutė;Žibutė;8769601956;Taip;0;0;1;1
11159;Vaidilutė;Žibutė;1726638921;Taip;0;5;1;6
11160;Vaidilutė;Žibutė;5415279154;Ne;8;4;0;12
11161;Vaidilutė;Žibutė;1377015807;Taip;4;0;0;4
11162;Vaidilutė;Žibutė;4124217264;Taip;5;2;0;7
11163;Vaidilutė;Žibutė;7429825620;Taip;5;0;0;5
11164;Vaidilutė;Žibutė;3087959868;Taip;0;4;0;4
11165;Vaidilutė;Žibutė;7690470762;Taip;3;2;0;5
11166;Vaidilutė;Žibutė;1606864068;Taip;7;0;0;7
11167;Vaidilutė;"Ąžuoliukas ";3730573432;Taip;6;1;0;7
11168;Vaidilutė;"Ąžuoliukas ";5988376676;Taip;2;0;0;2
11169;Vaidilutė;"Ąžuoliukas ";1305478052;Taip;7;0;1;8
11170;Vaidilutė;"Ąžuoliukas ";4954285515;Ne;0;3;0;3
11171;Vaidilutė;"Ąžuoliukas ";5556351358;Taip;0;4;0;4
11172;Vaidilutė;"Ąžuoliukas ";5439973183;Taip;9;4;2;15
11173;Vaidilutė;"Ąžuoliukas ";4761992071;Taip;5;0;1;6
11174;Vaidilutė;"Ąžuoliukas ";3381544575;Taip;0;0;1;1
11175;Vaidilutė;"Ąžuoliukas ";5307486959;Taip;4;4;0;8
11176;Vaidilutė;"Ąžuoliukas ";1653497170;Taip;5;4;0;9
11177;Vaidilutė;"Ąžuoliukas ";1440819171;Taip;4;4;0;8
11178;Vaidilutė;"Ąžuoliukas ";2668758195;Taip;0;4;1;5
11179;Vaidilutė;"Ąžuoliukas ";4901387311;Taip;0;1;0;1
11180;Vaidilutė;"Ąžuoliukas ";9811981645;Taip;6;2;0;8
11181;Vaidilutė;"Ąžuoliukas ";2997948252;Ne;14;0;0;14
11182;Vaidilutė;"Ąžuoliukas ";9723156071;Taip;0;2;1;3
11183;Vaidilutė;"Ąžuoliukas ";4193108560;Taip;4;0;0;4
11184;Vaidilutė;"Ąžuoliukas ";3782651091;Taip;13;0;2;15
11185;Vaidilutė;"Ąžuoliukas ";6637224510;Taip;0;0;6;6
11186;Vaidilutė;"Ąžuoliukas ";6067801976;Taip;8;0;0;8
11187;Vaidilutė;"Žemuogėlė ";2131127298;Taip;0;4;1;5
11188;Vaidilutė;"Žemuogėlė ";2014160468;Ne;0;0;2;2
11189;Vaidilutė;"Žemuogėlė ";4680645841;Taip;0;5;2;7
11190;Vaidilutė;"Žemuogėlė ";2662468804;Taip;7;0;1;8
11191;Vaidilutė;"Žemuogėlė ";5217609332;Taip;0;5;1;6
11192;Vaidilutė;"Žemuogėlė ";8492055287;Taip;6;0;1;7
11193;Vaidilutė;"Žemuogėlė ";5945744595;Taip;8;2;0;10
11194;Vaidilutė;"Žemuogėlė ";2864731541;Taip;6;0;0;6
11195;Vaidilutė;"Žemuogėlė ";1998872078;Taip;4;0;0;4
11196;Vaidilutė;"Žemuogėlė ";2468220275;Taip;0;1;0;1
11197;Vaidilutė;"Žemuogėlė ";6844372910;Taip;9;0;1;10
11198;Vaidilutė;"Žemuogėlė ";4972645715;Taip;0;4;7;11
11199;Vaidilutė;"Žemuogėlė ";1610262589;Taip;5;0;0;5
11200;Vaidilutė;"Žemuogėlė ";2356037175;Taip;5;0;0;5
11201;Vaidilutė;"Žemuogėlė ";5054640268;Taip;6;1;5;12
11202;Vaidilutė;"Žemuogėlė ";6885473308;Taip;2;5;0;7
11203;Vaidilutė;"Žemuogėlė ";7826111890;Taip;0;1;1;2
11204;Vaidilutė;"Žemuogėlė ";1355005114;Taip;8;0;0;8
11205;Vaidilutė;"Žemuogėlė ";2294802783;Taip;2;9;0;11
11206;Vaidilutė;"Žemuogėlė ";2419903023;Taip;14;0;0;14
11207;Vaidilutė;"Vyturėlis ";3121914268;Taip;2;0;0;2
11208;Vaidilutė;"Vyturėlis ";5050251048;Taip;5;0;0;5
11209;Vaidilutė;"Vyturėlis ";7106410219;Taip;0;0;5;5
11210;Vaidilutė;"Vyturėlis ";9558983004;Taip;0;8;0;8
11211;Vaidilutė;"Vyturėlis ";5326935037;Taip;2;3;0;5
11212;Vaidilutė;"Vyturėlis ";9689388330;Taip;0;4;0;4
11213;Vaidilutė;"Vyturėlis ";1539700521;Taip;6;0;0;6
11214;Vaidilutė;"Vyturėlis ";4230076320;Taip;0;4;2;6
11215;Vaidilutė;"Vyturėlis ";1401180999;Taip;2;2;0;4
11216;Vaidilutė;"Vyturėlis ";1417828163;Taip;0;2;1;3
11217;Vaidilutė;"Vyturėlis ";5651628204;Ne;0;2;0;2
11218;Vaidilutė;"Vyturėlis ";2251608691;Taip;5;0;0;5
11219;Vaidilutė;"Vyturėlis ";7914006128;Taip;7;0;0;7
11220;Vaidilutė;"Vyturėlis ";7131561558;Taip;0;4;1;5
11221;Vaidilutė;"Vyturėlis ";2194984060;Taip;4;4;6;14
11222;Vaidilutė;"Vyturėlis ";3351968717;Taip;0;2;0;2
11223;Vaidilutė;"Vyturėlis ";1732848786;Taip;14;0;0;14
11224;Vaidilutė;"Varpelis ";6250831269;Taip;1;3;0;4
11225;Vaidilutė;"Varpelis ";2763266518;Taip;2;2;0;4
11226;Vaidilutė;"Varpelis ";6037349527;Taip;0;4;5;9
11227;Vaidilutė;"Varpelis ";5867501558;Taip;0;6;3;9
11228;Vaidilutė;"Varpelis ";3832349858;Taip;0;1;3;4
11229;Vaidilutė;"Varpelis ";9317774960;Taip;3;0;0;3
11230;Vaidilutė;"Varpelis ";5448014291;Taip;2;4;0;6
11231;Vaidilutė;"Varpelis ";3497795848;Taip;0;4;1;5
11232;Vaidilutė;"Varpelis ";4280822951;Taip;0;1;0;1
11233;Vaidilutė;"Varpelis ";6107554047;Taip;0;4;2;6
11234;Vaidilutė;"Varpelis ";6022130248;Taip;0;1;0;1
11235;Vaidilutė;"Varpelis ";5101104226;Taip;4;0;0;4
11236;Vaidilutė;"Varpelis ";5594121340;Taip;0;1;0;1
11237;Vaidilutė;"Varpelis ";1882829340;Taip;6;4;2;12
11238;Vaidilutė;"Varpelis ";3353827105;Taip;0;4;1;5
11239;Vaidilutė;"Varpelis ";4362797606;Taip;0;4;0;4
11240;Vaidilutė;"Varpelis ";6322986820;Taip;0;0;2;2
11241;Vaidilutė;"Varpelis ";2941550026;Taip;0;4;0;4
11242;Vaidilutė;"Varpelis ";2058071219;Taip;1;4;4;9
11243;Vaidilutė;"Boružėlių ";2401619665;Taip;10;0;0;10
11244;Vaidilutė;"Boružėlių ";1036327491;Taip;0;0;5;5
11245;Vaidilutė;"Boružėlių ";7992756674;Taip;17;0;0;17
11246;Vaidilutė;"Boružėlių ";4202779406;Taip;10;0;0;10
11247;Vaidilutė;"Boružėlių ";1736009458;Taip;2;0;0;2
11248;Vaidilutė;"Boružėlių ";7163100596;Taip;5;0;4;9
11249;Vaidilutė;"Boružėlių ";1924346626;Taip;15;0;7;22
11250;Vaidilutė;"Boružėlių ";7535557733;Taip;15;0;7;22
11251;Vaidilutė;"Boružėlių ";1224632280;Taip;0;0;6;6
11252;Vaidilutė;"Boružėlių ";7916111396;Taip;0;1;0;1
11253;Vaidilutė;"Boružėlių ";7605835683;Taip;4;0;0;4
11254;Vaidilutė;"Boružėlių ";2194687285;Taip;5;0;5;10
11255;Vaidilutė;"Malūnelis ";7406210603;Taip;13;4;0;17
11256;Vaidilutė;"Malūnelis ";5166331829;Taip;4;0;3;7
11257;Vaidilutė;"Malūnelis ";6688767475;Taip;2;0;0;2
11258;Vaidilutė;"Malūnelis ";3509892176;Taip;8;0;0;8
11259;Vaidilutė;"Malūnelis ";9183056003;Taip;7;0;2;9
11260;Vaidilutė;"Malūnelis ";1562042820;Taip;0;10;4;14
11261;Vaidilutė;"Malūnelis ";6001198563;Taip;3;1;0;4
11262;Vaidilutė;"Malūnelis ";7109743847;Taip;19;0;4;23
11263;Vaidilutė;"Malūnelis ";7036611507;Taip;0;9;0;9
11264;Vaidilutė;"Malūnelis ";9007565120;Taip;3;1;0;4
11265;Vaidilutė;"Malūnelis ";2393977201;Taip;0;0;1;1
11266;Vaidilutė;"Malūnelis ";8042617129;Taip;1;0;0;1
11267;Vaidilutė;"Malūnelis ";5415659432;Taip;4;0;0;4
11268;Vaidilutė;"Malūnelis ";6541442524;Taip;12;0;0;12
11269;Vaidilutė;"Riešutėlis ";1161455376;Taip;9;0;0;9
11270;Vaidilutė;"Riešutėlis ";4657952465;Taip;5;0;2;7
11271;Vaidilutė;"Riešutėlis ";8756807918;Taip;8;0;5;13
11272;Vaidilutė;"Riešutėlis ";9782176726;Taip;9;0;0;9
11273;Vaidilutė;"Riešutėlis ";1206696843;Taip;0;2;5;7
11274;Vaidilutė;"Riešutėlis ";9872915544;Taip;4;2;1;7
11275;Vaidilutė;"Riešutėlis ";2976615414;Taip;0;0;13;13
11276;Vaidilutė;"Riešutėlis ";4709977896;Taip;14;1;0;15
11277;Vaidilutė;"Riešutėlis ";2409760986;Taip;0;0;2;2
11278;Vaidilutė;"Riešutėlis ";4051575845;Taip;0;0;2;2
11279;Vaidilutė;"Riešutėlis ";9025469107;Taip;8;0;4;12
11280;Vaidilutė;"Riešutėlis ";3862444839;Taip;0;0;1;1
11281;Vaidilutė;"Riešutėlis ";9567786222;Taip;2;0;0;2
11282;Vaidilutė;"Riešutėlis ";3064988592;Taip;5;0;0;5
11283;Vaidilutė;"Riešutėlis ";7043895152;Taip;0;4;0;4
11284;Vaidilutė;"Riešutėlis ";8296567629;Taip;11;0;0;11
11285;Vaidilutė;"Riešutėlis ";9398922369;Taip;0;10;10;20
11286;Vandenis;ŽUVĖDRŲ;5362078687;Taip;0;5;0;5
11287;Vandenis;ŽUVĖDRŲ;6784010746;Taip;8;2;0;10
11288;Vandenis;ŽUVĖDRŲ;9334958945;Taip;0;4;0;4
11289;Vandenis;ŽUVĖDRŲ;7447487403;Taip;0;3;0;3
11290;Vandenis;ŽUVĖDRŲ;7646133208;Taip;0;2;0;2
11291;Vandenis;ŽUVĖDRŲ;4303303483;Taip;16;0;0;16
11292;Vandenis;ŽUVĖDRŲ;2325465812;Taip;0;4;0;4
11293;Vandenis;ŽUVĖDRŲ;2649542586;Taip;0;9;0;9
11294;Vandenis;ŽUVĖDRŲ;1144490168;Taip;0;4;0;4
11295;Vandenis;ŽUVĖDRŲ;7948161881;Taip;0;3;0;3
11296;Vandenis;ŽUVĖDRŲ;9335319713;Taip;7;5;0;12
11297;Vandenis;ŽUVĖDRŲ;6068154206;Taip;0;2;0;2
11298;Vandenis;ŽUVĖDRŲ;7296608892;Taip;0;4;0;4
11299;Vandenis;ŽUVĖDRŲ;4117091634;Taip;19;4;0;23
11300;Vandenis;ŽUVĖDRŲ;6063181697;Taip;0;1;0;1
11301;Vandenis;ŽUVĖDRŲ;6661117114;Taip;1;7;0;8
11302;Vandenis;ŽUVĖDRŲ;5112768778;Taip;0;12;0;12
11303;Vandenis;ŽUVĖDRŲ;6456557095;Taip;6;0;0;6
11304;Vandenis;RUONIUKŲ;9756270419;Taip;0;4;0;4
11305;Vandenis;RUONIUKŲ;5438770600;Taip;4;0;0;4
11306;Vandenis;RUONIUKŲ;6851036864;Taip;4;0;0;4
11307;Vandenis;RUONIUKŲ;2144282854;Taip;0;9;0;9
11308;Vandenis;RUONIUKŲ;1969144957;Taip;9;0;0;9
11309;Vandenis;RUONIUKŲ;4319584977;Taip;11;0;0;11
11310;Vandenis;RUONIUKŲ;7950837626;Taip;3;0;0;3
11311;Vandenis;RUONIUKŲ;8001157954;Taip;11;1;0;12
11312;Vandenis;RUONIUKŲ;9178978753;Taip;8;0;0;8
11313;Vandenis;RUONIUKŲ;9095152994;Taip;7;0;0;7
11314;Vandenis;RUONIUKŲ;9756750533;Taip;0;1;0;1
11315;Vandenis;RUONIUKŲ;4525906178;Taip;4;4;0;8
11316;Vandenis;RUONIUKŲ;9316297713;Taip;8;0;0;8
11317;Vandenis;RUONIUKŲ;3101289470;Taip;0;8;0;8
11318;Vandenis;RUONIUKŲ;6134775528;Taip;7;0;0;7
11319;Vandenis;RUONIUKŲ;9542360827;Taip;15;0;0;15
11320;Vandenis;RUONIUKŲ;5516720117;Taip;2;0;0;2
11321;Vandenis;ŽUVYČIŲ;7565308536;Taip;0;7;0;7
11322;Vandenis;ŽUVYČIŲ;1120907086;Taip;2;8;0;10
11323;Vandenis;ŽUVYČIŲ;1563710105;Taip;1;4;0;5
11324;Vandenis;ŽUVYČIŲ;6330187732;Taip;2;7;0;9
11325;Vandenis;ŽUVYČIŲ;9527253920;Taip;2;3;0;5
11326;Vandenis;ŽUVYČIŲ;6158299885;Taip;5;0;0;5
11327;Vandenis;ŽUVYČIŲ;5535901447;Taip;0;4;0;4
11328;Vandenis;ŽUVYČIŲ;8971291182;Taip;2;1;0;3
11329;Vandenis;ŽUVYČIŲ;9688954631;Taip;0;1;0;1
11330;Vandenis;ŽUVYČIŲ;3664560833;Taip;0;2;0;2
11331;Vandenis;ŽUVYČIŲ;6476051751;Taip;0;6;0;6
11332;Vandenis;ŽUVYČIŲ;9162936403;Taip;0;4;0;4
11333;Vandenis;ŽUVYČIŲ;1051281257;Taip;6;4;0;10
11334;Vandenis;ŽUVYČIŲ;2422642232;Taip;1;7;0;8
11335;Vandenis;ŽUVYČIŲ;6986724058;Taip;0;1;0;1
11336;Vandenis;ŽUVYČIŲ;4971165639;Taip;1;1;0;2
11337;Vandenis;ŽUVYČIŲ;9731729915;Taip;0;4;0;4
11338;Vandenis;PERLIUKŲ;8239664149;Taip;10;1;0;11
11339;Vandenis;PERLIUKŲ;2451901210;Taip;10;0;0;10
11340;Vandenis;PERLIUKŲ;1953052452;Taip;3;0;0;3
11341;Vandenis;PERLIUKŲ;6724626527;Taip;9;0;1;10
11342;Vandenis;PERLIUKŲ;1786146371;Taip;4;4;0;8
11343;Vandenis;PERLIUKŲ;6570331247;Taip;4;2;0;6
11344;Vandenis;PERLIUKŲ;3038533882;Taip;10;5;0;15
11345;Vandenis;PERLIUKŲ;3393306645;Taip;2;2;0;4
11346;Vandenis;PERLIUKŲ;8841954633;Taip;10;3;0;13
11347;Vandenis;PERLIUKŲ;7001613448;Taip;10;3;0;13
11348;Vandenis;PERLIUKŲ;2661339448;Taip;11;0;0;11
11349;Vandenis;PERLIUKŲ;5675840354;Taip;3;4;0;7
11350;Vandenis;PERLIUKŲ;9380306986;Taip;0;1;0;1
11351;Vandenis;PERLIUKŲ;1983972864;Taip;2;3;0;5
11352;Vandenis;PERLIUKŲ;3173213991;Taip;0;9;0;9
11353;Vandenis;PERLIUKŲ;6067408982;Taip;1;2;0;3
11354;Vandenis;PERLIUKŲ;7233484054;Taip;4;0;0;4
11355;Vandenis;ANČIUKŲ;4607196473;Taip;2;0;0;2
11356;Vandenis;ANČIUKŲ;9763300020;Taip;0;7;0;7
11357;Vandenis;ANČIUKŲ;9968877035;Taip;0;2;0;2
11358;Vandenis;ANČIUKŲ;3639160500;Taip;0;1;0;1
11359;Vandenis;ANČIUKŲ;9458613523;Taip;2;0;0;2
11360;Vandenis;ANČIUKŲ;1213743099;Taip;0;5;0;5
11361;Vandenis;ANČIUKŲ;4954121871;Taip;0;2;0;2
11362;Vandenis;ANČIUKŲ;8751355814;Taip;0;5;0;5
11363;Vandenis;ANČIUKŲ;4978712442;Taip;0;1;0;1
11364;Vandenis;ANČIUKŲ;7581114286;Ne;0;1;0;1
11365;Vandenis;ANČIUKŲ;9679010239;Taip;7;4;0;11
11366;Vandenis;ANČIUKŲ;1132534461;Taip;0;2;0;2
11367;Vandenis;ANČIUKŲ;5610800263;Taip;0;1;0;1
11368;Vandenis;ANČIUKŲ;3544764716;Taip;7;2;0;9
11369;Vandenis;ANČIUKŲ;4530824157;Taip;10;8;0;18
11370;Vandenis;ANČIUKŲ;4954787474;Taip;18;0;0;18
11371;Vandenis;ANČIUKŲ;8967191975;Taip;1;0;0;1
11372;Vandenis;VĖŽLIUKŲ;2309166304;Taip;6;8;1;15
11373;Vandenis;VĖŽLIUKŲ;2872343656;Taip;4;4;0;8
11374;Vandenis;VĖŽLIUKŲ;8921666108;Taip;0;4;0;4
11375;Vandenis;VĖŽLIUKŲ;7924399684;Taip;5;12;0;17
11376;Vandenis;VĖŽLIUKŲ;7091356848;Taip;0;2;0;2
11377;Vandenis;VĖŽLIUKŲ;5126732658;Taip;3;1;0;4
11378;Vandenis;VĖŽLIUKŲ;7059385610;Taip;0;4;0;4
11379;Vandenis;VĖŽLIUKŲ;1707354287;Taip;4;4;0;8
11380;Vandenis;VĖŽLIUKŲ;4413648496;Taip;5;4;0;9
11381;Vandenis;VĖŽLIUKŲ;9704394568;Taip;3;0;0;3
11382;Vandenis;VĖŽLIUKŲ;4177166475;Taip;4;2;0;6
11383;Vandenis;VĖŽLIUKŲ;5218101579;Taip;0;0;1;1
11384;Vandenis;VĖŽLIUKŲ;8416839037;Taip;2;3;0;5
11385;Vandenis;VĖŽLIUKŲ;2936885357;Taip;13;0;0;13
11386;Vandenis;VĖŽLIUKŲ;8879608849;Taip;2;8;0;10
11387;Vandenis;AŠTUNKOJŲ;3429495073;Taip;0;1;0;1
11388;Vandenis;AŠTUNKOJŲ;6896047075;Taip;0;4;0;4
11389;Vandenis;AŠTUNKOJŲ;9304912028;Taip;0;1;0;1
11390;Vandenis;AŠTUNKOJŲ;5844576485;Taip;0;1;0;1
11391;Vandenis;AŠTUNKOJŲ;6295009202;Taip;0;6;0;6
11392;Vandenis;AŠTUNKOJŲ;3239754791;Taip;0;6;0;6
11393;Vandenis;AŠTUNKOJŲ;7598257845;Taip;0;6;0;6
11394;Vandenis;AŠTUNKOJŲ;5323428164;Taip;0;1;0;1
11395;Vandenis;AŠTUNKOJŲ;6073002418;Taip;5;0;0;5
11396;Vandenis;AŠTUNKOJŲ;5565147603;Taip;0;5;0;5
11397;Vandenis;AŠTUNKOJŲ;2576575249;Taip;0;1;0;1
11398;Vandenis;AŠTUNKOJŲ;7832674282;Taip;2;1;0;3
11399;Vandenis;AŠTUNKOJŲ;9798192239;Taip;0;1;0;1
11400;Vandenis;AŠTUNKOJŲ;5129492284;Taip;0;1;0;1
11401;Vandenis;AŠTUNKOJŲ;1975385430;Taip;0;4;0;4
11402;Vandenis;AŠTUNKOJŲ;3061606138;Taip;2;0;0;2
11403;Vandenis;AŠTUNKOJŲ;5613067534;Taip;7;4;0;11
11404;Vandenis;AŠTUNKOJŲ;8987444198;Taip;0;2;0;2
11405;Vandenis;AŠTUNKOJŲ;2321919298;Taip;2;5;0;7
11406;Vandenis;GANDRIUKŲ;4753416316;Taip;13;0;0;13
11407;Vandenis;GANDRIUKŲ;8264797886;Taip;7;0;0;7
11408;Vandenis;GANDRIUKŲ;9936940067;Ne;2;1;0;3
11409;Vandenis;GANDRIUKŲ;6153669587;Taip;9;2;0;11
11410;Vandenis;GANDRIUKŲ;6260893699;Taip;10;0;0;10
11411;Vandenis;GANDRIUKŲ;1919577714;Taip;17;0;0;17
11412;Vandenis;GANDRIUKŲ;7019646962;Taip;6;5;0;11
11413;Vandenis;GANDRIUKŲ;2078767085;Taip;8;4;0;12
11414;Vandenis;GANDRIUKŲ;2976505868;Taip;12;0;0;12
11415;Vandenis;GANDRIUKŲ;6558155968;Taip;0;4;0;4
11416;Vandenis;GANDRIUKŲ;6691874473;Taip;4;0;0;4
11417;Vandenis;GANDRIUKŲ;6483030616;Taip;8;4;0;12
11418;Vandenis;GANDRIUKŲ;8144830789;Taip;9;0;0;9
11419;Vandenis;GANDRIUKŲ;5899846599;Taip;7;0;0;7
11420;Vandenis;GANDRIUKŲ;8127873607;Taip;9;0;0;9
11421;Vandenis;GANDRIUKŲ;1606103904;Taip;7;10;0;17
11422;Vandenis;GANDRIUKŲ;1753180703;Taip;4;0;0;4
11423;Vandenis;GANDRIUKŲ;7303512055;Taip;9;0;0;9
11424;Vandenis;GANDRIUKŲ;7311677107;Taip;13;0;0;13
11425;Vandenis;GANDRIUKŲ;6586215199;Taip;0;9;0;9
11426;Vandenis;ŽĄSIUKAI;8034690071;Taip;5;0;0;5
11427;Vandenis;ŽĄSIUKAI;9937317687;Taip;6;0;0;6
11428;Vandenis;ŽĄSIUKAI;2004158593;Taip;9;0;0;9
11429;Vandenis;ŽĄSIUKAI;4984723792;Taip;8;2;0;10
11430;Vandenis;ŽĄSIUKAI;8014569725;Taip;5;0;0;5
11431;Vandenis;ŽĄSIUKAI;1333381525;Taip;2;0;0;2
11432;Vandenis;ŽĄSIUKAI;7071349847;Taip;0;4;0;4
11433;Vandenis;ŽĄSIUKAI;7070234429;Taip;3;11;0;14
11434;Vandenis;ŽĄSIUKAI;4072405890;Taip;0;1;0;1
11435;Vandenis;ŽĄSIUKAI;5684262347;Taip;5;0;0;5
11436;Vandenis;ŽĄSIUKAI;4349464804;Taip;7;1;0;8
11437;Vandenis;ŽĄSIUKAI;7596199296;Taip;12;2;0;14
11438;Vandenis;ŽĄSIUKAI;6876019354;Taip;0;1;0;1
11439;Vandenis;ŽĄSIUKAI;5607412408;Taip;1;0;0;1
11440;Vandenis;ŽĄSIUKAI;1925178245;Taip;0;2;0;2
11441;Vandenis;ŽĄSIUKAI;5641929490;Taip;9;0;0;9
11442;Vandenis;ŽĄSIUKAI;7058441500;Taip;1;4;0;5
11443;Vandenis;ŽĄSIUKAI;1850352131;Taip;9;0;0;9
11444;Vandenis;ŽĄSIUKAI;2454959791;Taip;4;0;0;4
11445;Vandenis;ŽĄSIUKAI;9801593009;Taip;10;5;0;15
11446;Vandenis;ŽĄSIUKAI;9093048795;Taip;6;0;0;6
11447;Vandenis;PURIENŲ;6851178154;Taip;0;5;0;5
11448;Vandenis;PURIENŲ;5440027798;Taip;6;4;0;10
11449;Vandenis;PURIENŲ;4455886780;Taip;5;1;0;6
11450;Vandenis;PURIENŲ;4815210197;Taip;0;4;0;4
11451;Vandenis;PURIENŲ;3337286021;Taip;7;1;0;8
11452;Vandenis;PURIENŲ;7020534318;Taip;1;0;0;1
11453;Vandenis;PURIENŲ;2960005490;Taip;11;0;0;11
11454;Vandenis;PURIENŲ;1180322026;Taip;12;0;0;12
11455;Vandenis;PURIENŲ;3633805607;Taip;1;5;0;6
11456;Vandenis;PURIENŲ;6332179750;Taip;0;6;0;6
11457;Vandenis;PURIENŲ;2315167746;Taip;0;1;0;1
11458;Vandenis;PURIENŲ;2719678617;Taip;0;6;0;6
11459;Vandenis;PURIENŲ;7171302906;Taip;5;2;0;7
11460;Vandenis;PURIENŲ;8085633453;Taip;5;2;0;7
11461;Vandenis;PURIENŲ;2614561762;Taip;0;3;0;3
11462;Vandenis;PURIENŲ;1244502945;Taip;0;5;0;5
11463;Vandenis;PURIENŲ;9158541919;Taip;7;3;0;10
11464;Vandenis;PURIENŲ;5959181898;Taip;7;3;0;10
11465;Vandenis;VARLIUKAI;3851301038;Ne;2;0;0;2
11466;Vandenis;VARLIUKAI;1557924470;Taip;19;0;0;19
11467;Vandenis;VARLIUKAI;4467604017;Taip;12;0;0;12
11468;Vandenis;VARLIUKAI;1586318209;Taip;9;10;0;19
11469;Vandenis;VARLIUKAI;1713088739;Taip;8;0;0;8
11470;Vandenis;VARLIUKAI;6348714341;Taip;0;1;0;1
11471;Vandenis;VARLIUKAI;1926484881;Taip;16;0;0;16
11472;Vandenis;VARLIUKAI;8866969905;Taip;4;0;0;4
11473;Vandenis;VARLIUKAI;1587789226;Taip;8;3;0;11
11474;Vandenis;VARLIUKAI;6061476765;Taip;10;0;0;10
11475;Vandenis;VARLIUKAI;4220080362;Taip;14;0;0;14
11476;Vandenis;VARLIUKAI;8642524068;Taip;9;0;0;9
11477;Vandenis;VARLIUKAI;8184314532;Taip;9;2;0;11
11478;Vandenis;VARLIUKAI;6499309064;Taip;13;0;0;13
11479;Vandenis;VARLIUKAI;1321803758;Taip;9;0;0;9
11480;Vandenis;VARLIUKAI;5310917664;Taip;13;3;0;16
11481;Vandenis;VARLIUKAI;3048168468;Taip;14;0;0;14
11482;Vandenis;PINGVINAI;9856199548;Taip;11;2;0;13
11483;Vandenis;PINGVINAI;2209513000;Taip;0;3;0;3
11484;Vandenis;PINGVINAI;2665865704;Taip;10;0;0;10
11485;Vandenis;PINGVINAI;8755050997;Taip;4;0;0;4
11486;Vandenis;PINGVINAI;1780124964;Taip;0;7;0;7
11487;Vandenis;PINGVINAI;9609168578;Taip;0;7;0;7
11488;Vandenis;PINGVINAI;2156775779;Taip;5;5;0;10
11489;Vandenis;PINGVINAI;3360623444;Taip;4;1;0;5
11490;Vandenis;PINGVINAI;5191604973;Taip;6;2;0;8
11491;Vandenis;PINGVINAI;2757376962;Taip;4;4;0;8
11492;Vandenis;PINGVINAI;6992750701;Taip;6;0;0;6
11493;Vandenis;PINGVINAI;6731336385;Taip;0;3;0;3
11494;Vandenis;PINGVINAI;3933306911;Taip;11;1;0;12
11495;Vandenis;PINGVINAI;2534991705;Taip;5;4;0;9
11496;Vandenis;PINGVINAI;7267965471;Taip;0;1;0;1
11497;Vandenis;PINGVINAI;5632082019;Taip;0;1;0;1
11498;Vandenis;PINGVINAI;9717294497;Taip;0;4;0;4
11499;Vandenis;PINGVINAI;7770227772;Taip;16;5;0;21
11500;Vandenis;PINGVINAI;8560123112;Taip;16;1;0;17
11501;Vandenis;PINGVINAI;4091633411;Taip;4;1;0;5
11502;Vandenis;Debesėlių;3163423293;Taip;0;0;10;10
11503;Vandenis;Debesėlių;6555465114;Taip;2;0;0;2
11504;Vandenis;Debesėlių;4226028904;Taip;4;1;1;6
11505;Vandenis;Debesėlių;2844636823;Taip;3;0;0;3
11506;Vandenis;Debesėlių;8299531021;Taip;2;0;1;3
11507;Vandenis;Debesėlių;6494266251;Taip;7;0;0;7
11508;Vandenis;Debesėlių;3835819023;Taip;4;0;0;4
11509;Vandenis;Debesėlių;2953842982;Taip;17;0;0;17
11510;Vandenis;Debesėlių;2645775090;Taip;0;5;0;5
11511;Vandenis;Debesėlių;8678508812;Taip;0;5;0;5
11512;Vandenis;Debesėlių;5609737826;Taip;7;5;2;14
11513;Vandenis;Debesėlių;5963181638;Taip;2;1;0;3
11514;Vandenis;Debesėlių;6327478049;Taip;0;0;21;21
11515;Vandenis;Debesėlių;3231434944;Taip;0;0;23;23
11516;Vandenis;Debesėlių;6003491409;Taip;3;1;0;4
11517;Vandenis;Debesėlių;5690075288;Taip;4;1;1;6
11518;Vandenis;Debesėlių;3701053997;Taip;10;1;0;11
11519;Vandenis;Debesėlių;1081283323;Taip;0;4;0;4
11520;Vandenis;Debesėlių;1081283323;Taip;0;4;0;4
11521;Vandenis;Debesėlių;1081283323;Taip;0;4;0;4
11522;Vandenis;Gintarėlių;1542662577;Taip;8;0;5;13
11523;Vandenis;Gintarėlių;5683829836;Taip;3;0;4;7
11524;Vandenis;Gintarėlių;5560529824;Taip;0;8;0;8
11525;Vandenis;Gintarėlių;5874429309;Taip;7;0;0;7
11526;Vandenis;Gintarėlių;7318344804;Taip;0;0;3;3
11527;Vandenis;Gintarėlių;8420609325;Taip;9;0;6;15
11528;Vandenis;Gintarėlių;5081501601;Taip;0;4;9;13
11529;Vandenis;Gintarėlių;9498231306;Taip;0;1;0;1
11530;Vandenis;Gintarėlių;3968719760;Taip;5;0;4;9
11531;Vandenis;Gintarėlių;4565893472;Taip;6;0;0;6
11532;Vandenis;Gintarėlių;3342147138;Taip;4;0;12;16
11533;Vandenis;Gintarėlių;7959438279;Taip;0;0;2;2
11534;Vandenis;Gintarėlių;5540306590;Taip;0;2;0;2
11535;Vandenis;Gintarėlių;3672852524;Taip;13;0;0;13
11536;Vandenis;Gintarėlių;4069657268;Taip;0;0;1;1
11537;Vandenis;Lašelių;1233236350;Taip;8;0;0;8
11538;Vandenis;Lašelių;5459023317;Taip;13;0;0;13
11539;Vandenis;Lašelių;2475761158;Taip;15;0;0;15
11540;Vandenis;Lašelių;6869501724;Taip;0;6;0;6
11541;Vandenis;Lašelių;4575455479;Taip;0;3;0;3
11542;Vandenis;Lašelių;8860667587;Taip;0;3;0;3
11543;Vandenis;Lašelių;5434744285;Taip;5;4;0;9
11544;Vandenis;Lašelių;5207600083;Taip;5;2;0;7
11545;Vandenis;Lašelių;2440317162;Taip;5;0;0;5
11546;Vandenis;Lašelių;7544597355;Taip;11;0;0;11
11547;Vandenis;Lašelių;7095534371;Taip;4;0;0;4
11548;Vandenis;Lašelių;1636387018;Taip;17;0;0;17
11549;Vandenis;Lašelių;5440102024;Taip;10;0;0;10
11550;Vandenis;Lašelių;6025496917;Taip;0;1;0;1
11551;Vandenis;Burbuliukų;5144953316;Taip;11;1;0;12
11552;Vandenis;Burbuliukų;3750162497;Taip;27;0;1;28
11553;Vandenis;Burbuliukų;6068144373;Taip;1;0;2;3
11554;Vandenis;Burbuliukų;2783738727;Taip;3;1;0;4
11555;Vandenis;Burbuliukų;2998970043;Taip;6;1;0;7
11556;Vandenis;Burbuliukų;7080129095;Taip;0;2;0;2
11557;Vandenis;Burbuliukų;7856148436;Taip;11;0;1;12
11558;Vandenis;Burbuliukų;1035549424;Taip;5;1;0;6
11559;Vandenis;Burbuliukų;7492804255;Taip;5;4;0;9
11560;Vandenis;Burbuliukų;4483401826;Taip;1;0;1;2
11561;Vandenis;Burbuliukų;9314410776;Taip;20;0;0;20
11562;Vandenis;Burbuliukų;2647966131;Taip;0;2;0;2
11563;Vandenis;Burbuliukų;5545019790;Taip;8;2;2;12
11564;Vandenis;Burbuliukų;9128547685;Taip;8;2;2;12
11565;Vandenis;Kriauklyčių;9130870495;Taip;12;2;0;14
11566;Vandenis;Kriauklyčių;2578294768;Taip;9;4;0;13
11567;Vandenis;Kriauklyčių;7736505435;Taip;5;0;0;5
11568;Vandenis;Kriauklyčių;5362018982;Taip;8;0;0;8
11569;Vandenis;Kriauklyčių;4219981694;Taip;1;0;5;6
11570;Vandenis;Kriauklyčių;8703465445;Taip;9;3;0;12
11571;Vandenis;Kriauklyčių;5983635986;Taip;2;0;3;5
11572;Vandenis;Kriauklyčių;4373688502;Taip;0;1;0;1
11573;Vandenis;Kriauklyčių;8921398489;Taip;15;9;0;24
11574;Vandenis;Kriauklyčių;6112591131;Ne;0;0;1;1
11575;Vandenis;Kriauklyčių;2528214535;Taip;13;0;0;13
11576;Vandenis;Kriauklyčių;6848032146;Taip;0;3;0;3
11577;Vandenis;Kriauklyčių;1836082819;Taip;4;0;0;4
11578;Vandenis;Kriauklyčių;2945086818;Taip;11;0;1;12
11579;Vandenis;Kriauklyčių;3262634002;Taip;8;0;0;8
11580;Vandenis;Kriauklyčių;3820448467;Taip;1;0;0;1
11581;Vandenis;Kriauklyčių;4168391832;Taip;3;1;0;4
11582;Vandenis;Kriauklyčių;2883058280;Taip;9;0;0;9
11583;Vandenis;Kriauklyčių;2997649372;Taip;18;0;0;18
11584;Vandenis;Kriauklyčių;9400150352;Taip;7;1;0;8
11585;Vėjelis;Pumpurėliai;2541077369;Taip;7;3;0;10
11586;Vėjelis;Pumpurėliai;3125815427;Taip;0;1;2;3
11587;Vėjelis;Pumpurėliai;5516672613;Taip;9;3;0;12
11588;Vėjelis;Pumpurėliai;2866394056;Taip;0;4;0;4
11589;Vėjelis;Pumpurėliai;3206025676;Taip;9;0;0;9
11590;Vėjelis;Pumpurėliai;5611813359;Taip;1;2;0;3
11591;Vėjelis;Pumpurėliai;1057586168;Taip;9;0;0;9
11592;Vėjelis;Pumpurėliai;7539681314;Taip;0;4;0;4
11593;Vėjelis;Pumpurėliai;3081923183;Taip;0;10;0;10
11594;Vėjelis;Pumpurėliai;9003601108;Taip;0;11;0;11
11595;Vėjelis;Pumpurėliai;6168648640;Taip;0;1;0;1
11596;Vėjelis;Pumpurėliai;6840643273;Taip;0;9;0;9
11597;Vėjelis;Pumpurėliai;9824130744;Taip;3;0;0;3
11598;Vėjelis;Pumpurėliai;1842552329;Taip;13;0;1;14
11599;Vėjelis;Pumpurėliai;8994680698;Taip;3;1;0;4
11600;Vėjelis;Pumpurėliai;2656895893;Taip;0;6;0;6
11601;Vėjelis;Pumpurėliai;2734891342;Taip;5;1;0;6
11602;Vėjelis;Pumpurėliai;7748975870;Taip;0;0;2;2
11603;Vėjelis;Drugeliai;1331334220;Taip;0;6;3;9
11604;Vėjelis;Drugeliai;2151737048;Taip;0;5;0;5
11605;Vėjelis;Drugeliai;4988352741;Taip;0;0;3;3
11606;Vėjelis;Drugeliai;4473677352;Taip;0;17;0;17
11607;Vėjelis;Drugeliai;4506243333;Taip;4;5;0;9
11608;Vėjelis;Drugeliai;3524350131;Taip;0;4;1;5
11609;Vėjelis;Drugeliai;6061966626;Taip;0;4;0;4
11610;Vėjelis;Drugeliai;6891260701;Taip;0;5;0;5
11611;Vėjelis;Drugeliai;9986867356;Taip;0;4;0;4
11612;Vėjelis;Drugeliai;1876663813;Taip;9;4;0;13
11613;Vėjelis;Drugeliai;8467887788;Taip;7;9;0;16
11614;Vėjelis;Drugeliai;1073818739;Taip;14;0;4;18
11615;Vėjelis;Drugeliai;6775556050;Taip;0;0;21;21
11616;Vėjelis;Drugeliai;1823215441;Taip;1;0;0;1
11617;Vėjelis;Drugeliai;5888429623;Taip;4;0;0;4
11618;Vėjelis;Drugeliai;9592852011;Taip;0;1;0;1
11619;Vėjelis;Drugeliai;7247057946;Taip;0;2;9;11
11620;Vėjelis;Drugeliai;8986581196;Taip;0;0;11;11
11621;Vėjelis;Malūnėlis;1994035417;Ne;0;4;0;4
11622;Vėjelis;Malūnėlis;1448699738;Taip;3;2;6;11
11623;Vėjelis;Malūnėlis;3275186042;Taip;2;0;0;2
11624;Vėjelis;Malūnėlis;1882750621;Taip;14;1;0;15
11625;Vėjelis;Malūnėlis;5109441799;Taip;11;0;1;12
11626;Vėjelis;Malūnėlis;4171024976;Taip;6;4;2;12
11627;Vėjelis;Malūnėlis;1871467392;Taip;8;0;1;9
11628;Vėjelis;Malūnėlis;8221349174;Taip;0;1;0;1
11629;Vėjelis;Malūnėlis;6600504736;Taip;0;0;4;4
11630;Vėjelis;Malūnėlis;8063276082;Taip;9;5;2;16
11631;Vėjelis;Malūnėlis;6244227830;Taip;6;8;1;15
11632;Vėjelis;Malūnėlis;1417987860;Taip;2;11;2;15
11633;Vėjelis;Malūnėlis;9636946669;Taip;4;0;5;9
11634;Vėjelis;Malūnėlis;5066748621;Taip;9;4;0;13
11635;Vėjelis;Malūnėlis;8822873586;Taip;9;0;0;9
11636;Vėjelis;Malūnėlis;6823103188;Taip;4;7;0;11
11637;Vėjelis;Malūnėlis;2887703782;Taip;3;1;0;4
11638;Vėjelis;Malūnėlis;4063795811;Taip;4;4;0;8
11639;Vėjelis;Žvaigždutės;4868574574;Taip;8;1;0;9
11640;Vėjelis;Žvaigždutės;3495322620;Taip;3;5;0;8
11641;Vėjelis;Žvaigždutės;1956418258;Taip;0;7;4;11
11642;Vėjelis;Žvaigždutės;7203026860;Taip;8;0;0;8
11643;Vėjelis;Žvaigždutės;7860576967;Taip;7;0;0;7
11644;Vėjelis;Žvaigždutės;1075188861;Taip;0;1;0;1
11645;Vėjelis;Žvaigždutės;9451358807;Taip;16;0;0;16
11646;Vėjelis;Žvaigždutės;8281508498;Taip;0;6;3;9
11647;Vėjelis;Žvaigždutės;6909799367;Taip;0;6;1;7
11648;Vėjelis;Žvaigždutės;4884057836;Taip;8;0;1;9
11649;Vėjelis;Žvaigždutės;9546928491;Taip;9;0;0;9
11650;Vėjelis;Žvaigždutės;9675488924;Taip;9;0;0;9
11651;Vėjelis;Žvaigždutės;7101585528;Taip;8;3;0;11
11652;Vėjelis;Žvaigždutės;9202471939;Taip;0;9;0;9
11653;Vėjelis;Žvaigždutės;1615837863;Taip;0;9;0;9
11654;Vėjelis;Žvaigždutės;8273890475;Taip;9;4;0;13
11655;Vėjelis;Žvaigždutės;9403445317;Taip;0;5;0;5
11656;Vėjelis;Varpeliai;7507448059;Taip;0;4;0;4
11657;Vėjelis;Varpeliai;9492690970;Taip;0;5;0;5
11658;Vėjelis;Varpeliai;9557135813;Taip;0;4;0;4
11659;Vėjelis;Varpeliai;9135807341;Taip;18;3;0;21
11660;Vėjelis;Varpeliai;2117924725;Taip;2;0;0;2
11661;Vėjelis;Varpeliai;8866974952;Taip;0;5;0;5
11662;Vėjelis;Varpeliai;2132551615;Taip;10;6;1;17
11663;Vėjelis;Varpeliai;4101161670;Taip;7;4;0;11
11664;Vėjelis;Varpeliai;1549518622;Taip;3;2;0;5
11665;Vėjelis;Varpeliai;6386092350;Taip;0;8;0;8
11666;Vėjelis;Varpeliai;7046938604;Taip;0;4;0;4
11667;Vėjelis;Varpeliai;6777528441;Taip;0;4;0;4
11668;Vėjelis;Varpeliai;6844704326;Taip;0;4;0;4
11669;Vėjelis;Varpeliai;3315240387;Taip;0;12;0;12
11670;Vėjelis;Varpeliai;8300497094;Taip;3;5;0;8
11671;Vėjelis;Pelėdžiukų;7211756910;Ne;0;4;0;4
11672;Vėjelis;Pelėdžiukų;2302652824;Taip;8;0;0;8
11673;Vėjelis;Pelėdžiukų;4852532740;Taip;19;0;0;19
11674;Vėjelis;Pelėdžiukų;9852892338;Taip;0;4;0;4
11675;Vėjelis;Pelėdžiukų;8433853523;Taip;1;0;1;2
11676;Vėjelis;Pelėdžiukų;4746355716;Taip;3;0;0;3
11677;Vėjelis;Pelėdžiukų;5507017221;Taip;0;4;0;4
11678;Vėjelis;Pelėdžiukų;1259743374;Taip;12;2;0;14
11679;Vėjelis;Pelėdžiukų;6226234271;Taip;20;0;0;20
11680;Vėjelis;Pelėdžiukų;7559733997;Taip;3;0;0;3
11681;Vėjelis;Pelėdžiukų;8153021028;Taip;5;0;0;5
11682;Vėjelis;Pelėdžiukų;8067153728;Taip;6;0;0;6
11683;Vėjelis;Pelėdžiukų;2283628712;Taip;0;8;3;11
11684;Vėjelis;Pelėdžiukų;9769871497;Taip;7;0;2;9
11685;Vėjelis;Pelėdžiukų;4318295503;Taip;4;0;0;4
11686;Vėjelis;Pelėdžiukų;9867392835;Taip;9;6;0;15
11687;Vėjelis;Pelėdžiukų;5662728912;Taip;5;2;4;11
11688;Vėjelis;Skruzdeliukų;3096861110;Taip;9;0;0;9
11689;Vėjelis;Skruzdeliukų;1938557472;Taip;12;1;0;13
11690;Vėjelis;Skruzdeliukų;9964641007;Taip;5;0;0;5
11691;Vėjelis;Skruzdeliukų;7577991381;Taip;4;0;0;4
11692;Vėjelis;Skruzdeliukų;5333058186;Taip;18;0;0;18
11693;Vėjelis;Skruzdeliukų;2928489724;Taip;14;0;0;14
11694;Vėjelis;Skruzdeliukų;2238139120;Taip;7;0;0;7
11695;Vėjelis;Skruzdeliukų;4531125902;Taip;4;0;0;4
11696;Vėjelis;Skruzdeliukų;9528142262;Taip;4;0;0;4
11697;Vėjelis;Skruzdeliukų;4758209854;Taip;14;0;0;14
11698;Vėjelis;Skruzdeliukų;2486741803;Taip;11;0;0;11
11699;Vėjelis;Skruzdeliukų;1793991609;Taip;0;1;0;1
11700;Vėjelis;Skruzdeliukų;2987292658;Taip;0;1;0;1
11701;Vėjelis;Pieštukų;7854614677;Taip;9;4;0;13
11702;Vėjelis;Pieštukų;6453605110;Taip;11;0;2;13
11703;Vėjelis;Pieštukų;2720886612;Taip;1;3;0;4
11704;Vėjelis;Pieštukų;6520167840;Taip;13;0;1;14
11705;Vėjelis;Pieštukų;3691974508;Taip;0;4;5;9
11706;Vėjelis;Pieštukų;7613786936;Taip;1;0;3;4
11707;Vėjelis;Pieštukų;6839116451;Taip;12;0;0;12
11708;Vėjelis;Pieštukų;6938777118;Taip;9;1;0;10
11709;Vėjelis;Pieštukų;2553724469;Taip;23;0;0;23
11710;Vėjelis;Pieštukų;3012722334;Taip;20;0;0;20
11711;Vėjelis;Pieštukų;7889625599;Taip;9;1;0;10
11712;Vėjelis;Pieštukų;7763996061;Taip;4;0;0;4
11713;Vėjelis;Pieštukų;7553070848;Taip;6;0;0;6
11714;Vėjelis;Pieštukų;8310513436;Taip;0;0;4;4
11715;Vėjelis;Pieštukų;1291592424;Taip;0;0;1;1
11716;Vėjelis;Ramunėlių;5331895599;Taip;7;4;0;11
11717;Vėjelis;Ramunėlių;1506416880;Taip;14;0;0;14
11718;Vėjelis;Ramunėlių;3756116835;Taip;10;0;0;10
11719;Vėjelis;Ramunėlių;6576149860;Taip;11;0;0;11
11720;Vėjelis;Ramunėlių;4843434827;Taip;13;0;0;13
11721;Vėjelis;Ramunėlių;1452685229;Taip;3;1;0;4
11722;Vėjelis;Ramunėlių;6573481399;Taip;16;1;0;17
11723;Vėjelis;Ramunėlių;2534737343;Taip;6;0;0;6
11724;Vėjelis;Ramunėlių;2195618699;Taip;7;3;0;10
11725;Vėjelis;Ramunėlių;8505186157;Taip;9;0;0;9
11726;Vėjelis;Ramunėlių;5452294829;Taip;5;0;0;5
11727;Vėjelis;Ramunėlių;4717248684;Taip;12;3;0;15
11728;Vėjelis;Ramunėlių;5291321394;Taip;0;1;0;1
11729;Vėjelis;Nykštukai;6741600874;Taip;9;0;0;9
11730;Vėjelis;Nykštukai;9957614551;Taip;0;6;0;6
11731;Vėjelis;Nykštukai;7233448544;Taip;10;3;0;13
11732;Vėjelis;Nykštukai;5339200991;Taip;0;4;0;4
11733;Vėjelis;Nykštukai;6602964509;Taip;9;1;0;10
11734;Vėjelis;Nykštukai;2573683778;Taip;0;7;0;7
11735;Vėjelis;Nykštukai;3843601190;Taip;7;0;0;7
11736;Vėjelis;Nykštukai;3574432129;Taip;4;7;0;11
11737;Vėjelis;Nykštukai;4713754452;Taip;4;0;0;4
11738;Vėjelis;Nykštukai;3813509637;Taip;3;0;0;3
11739;Vėjelis;Nykštukai;8755889077;Ne;3;4;0;7
11740;Vėjelis;Nykštukai;9979979480;Taip;9;1;0;10
11741;Vėjelis;Nykštukai;6581265682;Taip;0;11;0;11
11742;Vėjelis;Nykštukai;8452132066;Taip;0;23;0;23
11743;Vėjelis;Nykštukai;7552365055;Taip;19;0;0;19
11744;Vėjelis;Nykštukai;6389449089;Taip;3;0;1;4
11745;Vėjelis;Nykštukai;9351658311;Taip;7;6;0;13
11746;Vėjelis;Nykštukai;1074246375;Taip;8;0;0;8
11747;Vėjelis;BITUTĖS;6824919005;Taip;1;0;0;1
11748;Vėjelis;BITUTĖS;4276237884;Taip;0;6;0;6
11749;Vėjelis;BITUTĖS;3772706363;Taip;1;4;0;5
11750;Vėjelis;BITUTĖS;1834203833;Taip;0;4;1;5
11751;Vėjelis;BITUTĖS;6283428333;Taip;6;0;1;7
11752;Vėjelis;BITUTĖS;6569848405;Taip;4;5;0;9
11753;Vėjelis;BITUTĖS;1457373815;Taip;18;0;0;18
11754;Vėjelis;BITUTĖS;8571757635;Taip;0;5;0;5
11755;Vėjelis;BITUTĖS;1022888418;Taip;4;6;1;11
11756;Vėjelis;BITUTĖS;1116238331;Taip;0;5;0;5
11757;Vėjelis;BITUTĖS;8286070405;Taip;4;4;0;8
11758;Vėjelis;BITUTĖS;1674810054;Taip;18;0;1;19
11759;Vėjelis;BITUTĖS;1070853175;Taip;7;0;0;7
11760;Vėjelis;BITUTĖS;4348246825;Taip;0;0;1;1
11761;Vėjelis;BITUTĖS;6660799519;Taip;0;3;0;3
11762;Vėjelis;BITUTĖS;6889825160;Taip;7;0;2;9
11763;Vėjelis;BITUTĖS;1235788079;Taip;0;1;2;3
11764;Vėjelis;BITUTĖS;4745262277;Taip;1;0;0;1
11765;Vėjelis;BITUTĖS;7790713917;Taip;4;0;0;4
11766;Vėjelis;Boruželės;1429496839;Taip;0;0;1;1
11767;Vėjelis;Boruželės;6108049183;Taip;0;3;4;7
11768;Vėjelis;Boruželės;1115802837;Taip;0;2;0;2
11769;Vėjelis;Boruželės;1494531065;Taip;10;0;0;10
11770;Vėjelis;Boruželės;3276062426;Taip;4;4;0;8
11771;Vėjelis;Boruželės;4132824111;Taip;4;0;0;4
11772;Vėjelis;Boruželės;7752923796;Taip;0;2;5;7
11773;Vėjelis;Boruželės;8957653216;Taip;6;2;0;8
11774;Vėjelis;Boruželės;6431589805;Taip;0;4;0;4
11775;Vėjelis;Boruželės;4412135676;Taip;0;3;0;3
11776;Vėjelis;Boruželės;4746932126;Taip;10;5;0;15
11777;Vėjelis;Boruželės;1978952781;Taip;0;4;0;4
11778;Vėjelis;Boruželės;8353084814;Taip;9;4;1;14
11779;Vėjelis;Boruželės;2416832899;Taip;0;5;0;5
11780;Vėjelis;Boruželės;7594586198;Taip;1;4;0;5
11781;Vėjelis;Boruželės;7981032872;Taip;9;4;4;17
11782;Vėjelis;Boruželės;7697394469;Taip;0;4;0;4
11783;Vėjelis;Boruželės;4066956765;Taip;0;1;0;1
11784;Vėjelis;Boruželės;2788205363;Taip;5;6;0;11
11785;Vėtrungė;Debesėlių;3655025938;Taip;0;0;3;3
11786;Vėtrungė;Debesėlių;2825732654;Taip;0;1;4;5
11787;Vėtrungė;Debesėlių;7863176604;Taip;0;4;0;4
11788;Vėtrungė;Debesėlių;3179715496;Taip;0;4;0;4
11789;Vėtrungė;Debesėlių;6439014588;Taip;0;5;0;5
11790;Vėtrungė;Debesėlių;9423361592;Taip;8;3;0;11
11791;Vėtrungė;Debesėlių;1191007983;Taip;5;4;0;9
11792;Vėtrungė;Debesėlių;3745680607;Taip;15;4;0;19
11793;Vėtrungė;Debesėlių;9359012317;Taip;4;0;4;8
11794;Vėtrungė;Debesėlių;1807742144;Taip;11;1;5;17
11795;Vėtrungė;Debesėlių;3433811829;Taip;0;0;3;3
11796;Vėtrungė;Debesėlių;2447851565;Taip;0;0;4;4
11797;Vėtrungė;Debesėlių;5246813735;Taip;0;5;0;5
11798;Vėtrungė;Debesėlių;8957071345;Taip;4;0;0;4
11799;Vėtrungė;Debesėlių;5545581078;Taip;3;4;0;7
11800;Vėtrungė;Debesėlių;7185104341;Taip;5;0;2;7
11801;Vėtrungė;Debesėlių;5939537473;Taip;0;6;0;6
11802;Vėtrungė;Debesėlių;1871358961;Taip;13;0;1;14
11803;Vėtrungė;Debesėlių;7632969321;Ne;14;0;1;15
11804;Vėtrungė;Debesėlių;9642541034;Taip;0;4;5;9
11805;Vėtrungė;Zuikių;9332362038;Taip;0;1;4;5
11806;Vėtrungė;Zuikių;9407558097;Taip;2;12;0;14
11807;Vėtrungė;Zuikių;2985829593;Taip;0;1;0;1
11808;Vėtrungė;Zuikių;7573021445;Taip;0;0;10;10
11809;Vėtrungė;Zuikių;3335047815;Ne;0;2;2;4
11810;Vėtrungė;Zuikių;8157356569;Ne;0;2;2;4
11811;Vėtrungė;Zuikių;9742099165;Taip;0;4;0;4
11812;Vėtrungė;Zuikių;1215953192;Taip;4;2;0;6
11813;Vėtrungė;Zuikių;3908259010;Ne;5;0;0;5
11814;Vėtrungė;Zuikių;1729819557;Taip;5;0;1;6
11815;Vėtrungė;Zuikių;4916692634;Taip;1;5;1;7
11816;Vėtrungė;Zuikių;4197321604;Taip;0;0;1;1
11817;Vėtrungė;Zuikių;1007578933;Taip;10;1;1;12
11818;Vėtrungė;Zuikių;7558548846;Taip;14;1;0;15
11819;Vėtrungė;Zuikių;8742161467;Taip;2;5;0;7
11820;Vėtrungė;Zuikių;2537221101;Taip;0;1;0;1
11821;Vėtrungė;Zuikių;7342250921;Taip;0;11;0;11
11822;Vėtrungė;Zuikių;9248113268;Ne;2;0;0;2
11823;Vėtrungė;Zuikių;7435005821;Ne;0;3;0;3
11824;Vėtrungė;Zuikių;1280823326;Ne;3;6;0;9
11825;Vėtrungė;Zuikių;4508176017;Taip;2;0;0;2
11826;Vėtrungė;Zuikių;8958748086;Taip;5;4;2;11
11827;Vėtrungė;Zuikių;5887929703;Taip;7;0;0;7
11828;Vėtrungė;Drugelių;5622109033;Taip;14;1;0;15
11829;Vėtrungė;Drugelių;9090873546;Taip;4;0;0;4
11830;Vėtrungė;Drugelių;2124476787;Taip;0;3;0;3
11831;Vėtrungė;Drugelių;2970067995;Taip;11;0;0;11
11832;Vėtrungė;Drugelių;5251308945;Taip;9;3;0;12
11833;Vėtrungė;Drugelių;9812496068;Taip;0;5;0;5
11834;Vėtrungė;Drugelių;8753387108;Taip;0;1;0;1
11835;Vėtrungė;Drugelių;3744377479;Taip;0;0;2;2
11836;Vėtrungė;Drugelių;7186353024;Taip;3;2;0;5
11837;Vėtrungė;Drugelių;2933312366;Taip;0;16;0;16
11838;Vėtrungė;Drugelių;2508501223;Taip;0;9;0;9
11839;Vėtrungė;Drugelių;6538402680;Taip;0;1;1;2
11840;Vėtrungė;Drugelių;5887245282;Taip;4;0;0;4
11841;Vėtrungė;Drugelių;3306549764;Taip;9;1;0;10
11842;Vėtrungė;Drugelių;7974212517;Taip;2;2;1;5
11843;Vėtrungė;Drugelių;9423979719;Taip;2;2;1;5
11844;Vėtrungė;Drugelių;1611114179;Taip;19;0;0;19
11845;Vėtrungė;Do-re-mi;7752842285;Taip;17;0;0;17
11846;Vėtrungė;Do-re-mi;1408629891;Taip;16;0;0;16
11847;Vėtrungė;Do-re-mi;7411180918;Taip;2;1;0;3
11848;Vėtrungė;Do-re-mi;2832753464;Taip;9;5;0;14
11849;Vėtrungė;Do-re-mi;2643851525;Taip;4;0;0;4
11850;Vėtrungė;Do-re-mi;6782673546;Taip;2;1;0;3
11851;Vėtrungė;Do-re-mi;3885409650;Taip;11;0;0;11
11852;Vėtrungė;Do-re-mi;4944115709;Taip;15;1;0;16
11853;Vėtrungė;Do-re-mi;7175547800;Taip;13;4;0;17
11854;Vėtrungė;Do-re-mi;1024958500;Taip;0;4;1;5
11855;Vėtrungė;Do-re-mi;5272077870;Taip;5;0;0;5
11856;Vėtrungė;Do-re-mi;1185643576;Taip;4;2;0;6
11857;Vėtrungė;Do-re-mi;9158760410;Taip;21;0;0;21
11858;Vėtrungė;Do-re-mi;3000030998;Taip;12;0;0;12
11859;Vėtrungė;Smalsučių;1020095914;Taip;0;2;0;2
11860;Vėtrungė;Smalsučių;2510763357;Taip;0;4;0;4
11861;Vėtrungė;Smalsučių;4713420194;Taip;0;4;0;4
11862;Vėtrungė;Smalsučių;2520926439;Taip;7;0;0;7
11863;Vėtrungė;Smalsučių;9313438768;Taip;0;2;0;2
11864;Vėtrungė;Smalsučių;9685389270;Ne;0;3;0;3
11865;Vėtrungė;Smalsučių;9207846866;Taip;0;13;0;13
11866;Vėtrungė;Smalsučių;2226654309;Taip;0;3;0;3
11867;Vėtrungė;Smalsučių;1766599777;Ne;0;4;0;4
11868;Vėtrungė;Smalsučių;3328447991;Taip;0;1;0;1
11869;Vėtrungė;Smalsučių;7143997258;Taip;0;0;1;1
11870;Vėtrungė;Smalsučių;5832298824;Ne;0;4;0;4
11871;Vėtrungė;Smalsučių;2136966687;Taip;11;8;0;19
11872;Vėtrungė;Smalsučių;9070732925;Taip;0;3;1;4
11873;Vėtrungė;Smalsučių;2207041148;Taip;4;5;0;9
11874;Vėtrungė;Smalsučių;5836190044;Taip;0;4;0;4
11875;Vėtrungė;Smalsučių;6374739740;Taip;0;5;0;5
11876;Vėtrungė;Gudručių;6449124019;Taip;0;0;2;2
11877;Vėtrungė;Gudručių;9079483362;Taip;1;4;1;6
11878;Vėtrungė;Gudručių;8956375453;Taip;0;3;1;4
11879;Vėtrungė;Gudručių;7807708310;Taip;5;3;3;11
11880;Vėtrungė;Gudručių;9271869305;Taip;2;1;0;3
11881;Vėtrungė;Gudručių;2883254822;Taip;4;5;0;9
11882;Vėtrungė;Gudručių;7895027909;Taip;0;4;0;4
11883;Vėtrungė;Gudručių;5452337780;Taip;2;3;0;5
11884;Vėtrungė;Gudručių;3200251047;Taip;0;18;1;19
11885;Vėtrungė;Gudručių;5430818470;Taip;1;3;3;7
11886;Vėtrungė;Gudručių;9324733839;Taip;4;0;0;4
11887;Vėtrungė;Gudručių;4709068324;Taip;0;4;0;4
11888;Vėtrungė;Gudručių;9865628172;Taip;4;4;2;10
11889;Vėtrungė;Kodėlčių;9172488122;Taip;3;4;3;10
11890;Vėtrungė;Kodėlčių;2739382736;Taip;6;6;3;15
11891;Vėtrungė;Kodėlčių;3903604247;Taip;6;0;0;6
11892;Vėtrungė;Kodėlčių;3500551575;Taip;0;6;0;6
11893;Vėtrungė;Kodėlčių;7872043253;Taip;0;7;0;7
11894;Vėtrungė;Kodėlčių;9852609222;Taip;0;5;0;5
11895;Vėtrungė;Kodėlčių;8465132902;Taip;4;1;0;5
11896;Vėtrungė;Kodėlčių;8859592174;Taip;10;0;0;10
11897;Vėtrungė;Kodėlčių;7862615352;Taip;0;3;0;3
11898;Vėtrungė;Kodėlčių;5385880910;Taip;4;0;0;4
11899;Vėtrungė;Kodėlčių;9211406129;Taip;0;16;0;16
11900;Vėtrungė;Kodėlčių;1032730549;Taip;6;8;0;14
11901;Vėtrungė;Kodėlčių;7511121411;Taip;0;1;0;1
11902;Vėtrungė;Kodėlčių;9127735773;Taip;8;5;0;13
11903;Vėtrungė;Kodėlčių;5830221727;Taip;7;0;0;7
11904;Vėtrungė;Kodėlčių;4756863295;Taip;4;4;0;8
11905;Vėtrungė;Kodėlčių;8985054558;Taip;14;1;0;15
11906;Vėtrungė;Kodėlčių;3922749661;Taip;9;5;0;14
11907;Vėtrungė;Kodėlčių;8013249618;Taip;0;4;2;6
11908;Vėtrungė;Kodėlčių;3887230224;Taip;1;2;0;3
11909;Vėtrungė;Kodėlčių;7740260264;Taip;7;0;0;7
11910;Vėtrungė;Kodėlčių;6807838878;Taip;4;1;0;5
11911;Vėtrungė;Kodėlčių;3638303693;Taip;4;2;5;11
11912;Vėtrungė;Paukštelių;6983172988;Taip;7;2;1;10
11913;Vėtrungė;Paukštelių;3957148270;Taip;5;4;0;9
11914;Vėtrungė;Paukštelių;3466149991;Taip;12;1;0;13
11915;Vėtrungė;Paukštelių;7258995031;Taip;5;1;0;6
11916;Vėtrungė;Paukštelių;5338424871;Taip;0;2;0;2
11917;Vėtrungė;Paukštelių;6812588777;Taip;0;10;0;10
11918;Vėtrungė;Paukštelių;2798915063;Taip;4;5;0;9
11919;Vėtrungė;Paukštelių;2981610749;Ne;12;0;2;14
11920;Vėtrungė;Paukštelių;6146327857;Taip;7;0;0;7
11921;Vėtrungė;Paukštelių;8149563485;Ne;2;2;1;5
11922;Vėtrungė;Paukštelių;9461365083;Taip;13;4;0;17
11923;Vėtrungė;Paukštelių;9822462988;Taip;10;0;0;10
11924;Vėtrungė;Paukštelių;2741119142;Taip;0;1;0;1
11925;Vėtrungė;Viščiukų;2725607774;Taip;0;6;0;6
11926;Vėtrungė;Viščiukų;5808423634;Taip;7;0;0;7
11927;Vėtrungė;Viščiukų;6190900822;Taip;2;0;0;2
11928;Vėtrungė;Viščiukų;4597361099;Taip;19;0;0;19
11929;Vėtrungė;Viščiukų;2490075899;Taip;12;0;0;12
11930;Vėtrungė;Viščiukų;8761701511;Taip;11;4;0;15
11931;Vėtrungė;Viščiukų;3527585648;Taip;10;0;0;10
11932;Vėtrungė;Viščiukų;4145172377;Taip;4;0;4;8
11933;Vėtrungė;Viščiukų;3859501564;Taip;8;0;1;9
11934;Vėtrungė;Viščiukų;3917214308;Taip;15;0;1;16
11935;Vėtrungė;Viščiukų;9862408289;Taip;0;0;5;5
11936;Vėtrungė;Viščiukų;7065114742;Taip;10;0;1;11
11937;Vėtrungė;Viščiukų;2558088727;Taip;7;11;0;18
11938;Vėtrungė;Viščiukų;6495674830;Taip;4;0;0;4
11939;Vėtrungė;Viščiukų;4782989673;Taip;0;0;1;1
11940;Vėtrungė;Viščiukų;8276160906;Ne;0;0;20;20
11941;Vėtrungė;Viščiukų;4516633703;Taip;11;0;1;12
11942;Vėtrungė;Viščiukų;6279761125;Taip;10;0;0;10
11943;Vėtrungė;Nykštukų;9696984346;Taip;0;4;5;9
11944;Vėtrungė;Nykštukų;7819147751;Taip;7;1;0;8
11945;Vėtrungė;Nykštukų;6990506209;Taip;23;0;0;23
11946;Vėtrungė;Nykštukų;2348557463;Taip;0;3;6;9
11947;Vėtrungė;Nykštukų;7733472482;Taip;10;0;0;10
11948;Vėtrungė;Nykštukų;2309821873;Taip;0;6;0;6
11949;Vėtrungė;Nykštukų;8059553343;Taip;0;1;0;1
11950;Vėtrungė;Nykštukų;4020987532;Taip;0;1;0;1
11951;Vėtrungė;Nykštukų;9569555731;Taip;4;0;0;4
11952;Vėtrungė;Nykštukų;7699392279;Taip;2;0;0;2
11953;Vėtrungė;Nykštukų;9773838651;Taip;0;1;0;1
11954;Vėtrungė;Nykštukų;6866720274;Taip;0;1;0;1
11955;Vėtrungė;Nykštukų;3869546285;Taip;6;0;0;6
11956;Vėtrungė;Nykštukų;4289435509;Taip;7;3;0;10
11957;Vėtrungė;Nykštukų;5132419026;Taip;5;1;2;8
11958;Vėtrungė;Nykštukų;7647363322;Taip;5;1;2;8
11959;Vėtrungė;Nykštukų;3046782145;Taip;6;0;5;11
11960;Vėtrungė;Nykštukų;7037942782;Taip;0;9;0;9
11961;Vėtrungė;Nykštukų;2205455847;Taip;12;1;1;14
11962;Vėtrungė;Ąžuoliukų;8775969909;Taip;6;0;3;9
11963;Vėtrungė;Ąžuoliukų;6363761237;Taip;0;4;0;4
11964;Vėtrungė;Ąžuoliukų;8913748584;Taip;0;1;0;1
11965;Vėtrungė;Ąžuoliukų;3073965379;Taip;3;4;0;7
11966;Vėtrungė;Ąžuoliukų;3938684888;Taip;10;2;0;12
11967;Vėtrungė;Ąžuoliukų;6073563461;Taip;0;3;0;3
11968;Vėtrungė;Ąžuoliukų;2977116563;Taip;7;1;0;8
11969;Vėtrungė;Ąžuoliukų;4925843510;Taip;12;0;0;12
11970;Vėtrungė;Ąžuoliukų;7096106273;Taip;17;0;0;17
11971;Vėtrungė;Ąžuoliukų;8026065367;Taip;2;1;0;3
11972;Vėtrungė;Ąžuoliukų;6476717645;Taip;4;2;0;6
11973;Vėtrungė;Ąžuoliukų;1169648551;Taip;3;0;0;3
11974;Vėtrungė;Ąžuoliukų;4489937085;Taip;10;4;0;14
11975;Vėtrungė;Ąžuoliukų;4740985408;Taip;0;0;4;4
11976;Vėtrungė;Ąžuoliukų;9684184905;Ne;0;10;1;11
11977;Vėtrungė;Ąžuoliukų;5021830780;Taip;11;0;0;11
11978;Vėtrungė;Ąžuoliukų;1568598938;Taip;8;1;0;9
11979;Vėtrungė;Ąžuoliukų;9459062715;Taip;4;0;0;4
11980;Vėtrungė;"&quot;MEŠKIUKŲ&quot;";9667227707;Taip;4;0;0;4
11981;Vėtrungė;"&quot;MEŠKIUKŲ&quot;";4529215724;Taip;4;0;0;4
11982;Vėtrungė;"&quot;MEŠKIUKŲ&quot;";7900887923;Taip;17;0;0;17
11983;Vėtrungė;"&quot;MEŠKIUKŲ&quot;";2462720995;Taip;2;1;0;3
11984;Vėtrungė;"&quot;MEŠKIUKŲ&quot;";7323779310;Taip;3;0;0;3
11985;Vėtrungė;"&quot;MEŠKIUKŲ&quot;";4550285483;Taip;5;2;0;7
11986;Vėtrungė;"&quot;MEŠKIUKŲ&quot;";3019474140;Taip;13;0;3;16
11987;Vėtrungė;"&quot;MEŠKIUKŲ&quot;";6529918013;Taip;10;0;0;10
11988;Vėtrungė;"&quot;MEŠKIUKŲ&quot;";2711203550;Ne;12;0;0;12
11989;Vėtrungė;"&quot;MEŠKIUKŲ&quot;";8632209474;Taip;11;0;0;11
11990;Vilnelė;Lakštutė;8843094480;Taip;1;1;2;4
11991;Vilnelė;Lakštutė;5786086401;Taip;9;3;0;12
11992;Vilnelė;Lakštutė;6249731759;Taip;5;9;0;14
11993;Vilnelė;Lakštutė;6837850601;Taip;0;2;0;2
11994;Vilnelė;Lakštutė;5554451335;Taip;10;0;0;10
11995;Vilnelė;Lakštutė;1762024490;Taip;7;1;0;8
11996;Vilnelė;Lakštutė;8201829887;Taip;4;0;0;4
11997;Vilnelė;Lakštutė;7702217893;Taip;2;0;0;2
11998;Vilnelė;Lakštutė;4427383755;Taip;0;7;0;7
11999;Vilnelė;Lakštutė;1547117566;Taip;0;7;0;7
12000;Vilnelė;Lakštutė;3231387543;Taip;4;0;0;4
12001;Vilnelė;Lakštutė;1734277231;Taip;14;0;0;14
12002;Vilnelė;Lakštutė;3900484348;Taip;0;5;0;5
12003;Vilnelė;Lakštutė;5498574366;Taip;0;3;0;3
12004;Vilnelė;Lakštutė;6686896190;Taip;0;6;4;10
12005;Vilnelė;Lakštutė;3032273912;Taip;9;1;0;10
12006;Vilnelė;Lakštutė;4017436910;Taip;1;2;0;3
12007;Vilnelė;Lakštutė;6156838553;Taip;4;5;0;9
12008;Vilnelė;Lakštutė;9843449060;Taip;15;1;1;17
12009;Vilnelė;Lakštutė;2803880424;Taip;2;2;0;4
12010;Vilnelė;Lakštutė;2418216191;Taip;0;0;3;3
12011;Vilnelė;Lakštutė;5913967803;Taip;18;0;0;18
12012;Vilnelė;Vyturėlis;7536603663;Ne;0;5;3;8
12013;Vilnelė;Vyturėlis;3503461211;Taip;0;1;0;1
12014;Vilnelė;Vyturėlis;2788449626;Taip;2;0;0;2
12015;Vilnelė;Vyturėlis;1574809879;Taip;9;0;0;9
12016;Vilnelė;Vyturėlis;3558073399;Taip;2;0;0;2
12017;Vilnelė;Vyturėlis;6083082959;Taip;0;4;0;4
12018;Vilnelė;Vyturėlis;7388336851;Taip;0;2;0;2
12019;Vilnelė;Vyturėlis;2923012145;Taip;2;1;0;3
12020;Vilnelė;Vyturėlis;8667403338;Taip;6;1;0;7
12021;Vilnelė;Vyturėlis;1351798589;Taip;4;0;6;10
12022;Vilnelė;Vyturėlis;2841315531;Taip;0;0;4;4
12023;Vilnelė;Vyturėlis;9162681538;Taip;0;3;0;3
12024;Vilnelė;Vyturėlis;3075681823;Taip;0;3;0;3
12025;Vilnelė;Vyturėlis;9804772168;Taip;3;2;0;5
12026;Vilnelė;Vyturėlis;1596625263;Taip;4;0;0;4
12027;Vilnelė;Vyturėlis;7338573817;Taip;0;2;1;3
12028;Vilnelė;Vyturėlis;8121075430;Taip;0;4;0;4
12029;Vilnelė;Vyturėlis;3843064564;Taip;0;0;1;1
12030;Vilnelė;Vyturėlis;9674145631;Taip;2;0;0;2
12031;Vilnelė;Pagrandukas;5508759323;Taip;8;2;1;11
12032;Vilnelė;Pagrandukas;2144925171;Taip;15;0;0;15
12033;Vilnelė;Pagrandukas;4295816753;Taip;9;6;0;15
12034;Vilnelė;Pagrandukas;3844066232;Ne;0;9;0;9
12035;Vilnelė;Pagrandukas;6659537454;Taip;0;8;0;8
12036;Vilnelė;Pagrandukas;4448413194;Taip;4;0;0;4
12037;Vilnelė;Pagrandukas;6830433856;Taip;6;1;1;8
12038;Vilnelė;Pagrandukas;4664946923;Taip;6;0;0;6
12039;Vilnelė;Pagrandukas;6982847450;Taip;0;5;0;5
12040;Vilnelė;Pagrandukas;7560124407;Taip;4;0;1;5
12041;Vilnelė;Pagrandukas;3685294539;Taip;3;0;0;3
12042;Vilnelė;Pagrandukas;4931943297;Taip;6;0;0;6
12043;Vilnelė;Pagrandukas;7882756938;Taip;9;0;0;9
12044;Vilnelė;Pagrandukas;7348404699;Taip;0;4;0;4
12045;Vilnelė;Pagrandukas;3323738649;Taip;5;4;0;9
12046;Vilnelė;Pagrandukas;8116613831;Taip;0;4;0;4
12047;Vilnelė;Pagrandukas;9489760844;Taip;0;2;0;2
12048;Vilnelė;Pagrandukas;6466321228;Taip;6;5;0;11
12049;Vilnelė;Pagrandukas;4478847902;Taip;0;16;0;16
12050;Vilnelė;Pagrandukas;9635159885;Taip;6;1;1;8
12051;Vilnelė;Pagrandukas;6448119003;Taip;0;2;0;2
12052;Vilnelė;Pagrandukas;2165389724;Taip;5;0;0;5
12053;Vilnelė;Bitutė;4718994967;Taip;5;11;0;16
12054;Vilnelė;Bitutė;1880318663;Taip;0;4;0;4
12055;Vilnelė;Bitutė;9589410276;Taip;0;5;0;5
12056;Vilnelė;Bitutė;9879688569;Taip;0;2;0;2
12057;Vilnelė;Bitutė;5473379559;Taip;0;3;0;3
12058;Vilnelė;Bitutė;3781595939;Taip;0;9;0;9
12059;Vilnelė;Bitutė;3791258264;Taip;6;2;0;8
12060;Vilnelė;Bitutė;6132739519;Ne;4;6;0;10
12061;Vilnelė;Bitutė;1730149127;Taip;0;6;0;6
12062;Vilnelė;Bitutė;9884955712;Taip;9;3;0;12
12063;Vilnelė;Bitutė;5778176840;Taip;9;3;0;12
12064;Vilnelė;Bitutė;8162191913;Ne;0;4;0;4
12065;Vilnelė;Bitutė;6355912551;Taip;0;2;0;2
12066;Vilnelė;Bitutė;3945921490;Taip;0;17;0;17
12067;Vilnelė;Bitutė;7976798775;Taip;0;0;6;6
12068;Vilnelė;Bitutė;1975954784;Ne;0;1;0;1
12069;Vilnelė;Bitutė;8092642447;Ne;0;1;0;1
12070;Vilnelė;Bitutė;7199490431;Taip;5;6;3;14
12071;Vilnelė;Bitutė;3811289758;Taip;0;10;0;10
12072;Vilnelė;Bitutė;3856917286;Taip;0;8;0;8
12073;Vilnelė;Bitutė;7883724600;Taip;7;1;0;8
12074;Vilnelė;Šaltinėlis;5487729159;Taip;5;6;0;11
12075;Vilnelė;Šaltinėlis;1108529953;Taip;7;0;0;7
12076;Vilnelė;Šaltinėlis;8118746185;Taip;6;0;0;6
12077;Vilnelė;Šaltinėlis;7949990857;Taip;5;0;0;5
12078;Vilnelė;Šaltinėlis;8267286482;Taip;13;0;0;13
12079;Vilnelė;Šaltinėlis;3579253910;Taip;2;0;0;2
12080;Vilnelė;Šaltinėlis;4973214588;Taip;3;1;0;4
12081;Vilnelė;Šaltinėlis;4939435139;Taip;4;8;0;12
12082;Vilnelė;Šaltinėlis;6858955752;Taip;10;1;0;11
12083;Vilnelė;Šaltinėlis;9578062060;Taip;16;0;0;16
12084;Vilnelė;Šaltinėlis;5341996342;Taip;16;0;0;16
12085;Vilnelė;Šaltinėlis;2639194662;Taip;7;0;0;7
12086;Vilnelė;Šaltinėlis;5625236416;Taip;11;0;0;11
12087;Vilnelė;Šaltinėlis;9774791340;Taip;14;0;0;14
12088;Vilnelė;Šaltinėlis;1893356606;Taip;11;0;0;11
12089;Vilnelė;Šaltinėlis;2835124257;Taip;11;0;0;11
12090;Vilnelė;Šaltinėlis;7924367229;Taip;12;0;0;12
12091;Vilnelė;Riešutėllis;1027463000;Taip;0;2;2;4
12092;Vilnelė;Riešutėllis;7020707723;Taip;0;6;0;6
12093;Vilnelė;Riešutėllis;1960860528;Taip;2;0;0;2
12094;Vilnelė;Riešutėllis;8588430578;Taip;13;4;0;17
12095;Vilnelė;Riešutėllis;7957695470;Taip;0;4;1;5
12096;Vilnelė;Riešutėllis;4780827432;Taip;0;5;0;5
12097;Vilnelė;Riešutėllis;4455099179;Taip;11;1;0;12
12098;Vilnelė;Riešutėllis;2367127222;Taip;5;0;0;5
12099;Vilnelė;Riešutėllis;5306723959;Taip;0;0;2;2
12100;Vilnelė;Riešutėllis;3670613082;Taip;4;6;0;10
12101;Vilnelė;Riešutėllis;3211657057;Taip;1;3;0;4
12102;Vilnelė;Riešutėllis;9016866597;Taip;4;6;0;10
12103;Vilnelė;Riešutėllis;7087798406;Taip;0;4;0;4
12104;Vilnelė;Riešutėllis;4254744025;Ne;8;7;0;15
12105;Vilnelė;Riešutėllis;3730997665;Taip;10;0;0;10
12106;Vilnelė;Riešutėllis;2706699572;Taip;0;4;0;4
12107;Vilnelė;Riešutėllis;8774842903;Taip;11;1;1;13
12108;Vilnelė;Nykštukas;4210511566;Taip;13;0;0;13
12109;Vilnelė;Nykštukas;2891787022;Taip;3;1;0;4
12110;Vilnelė;Nykštukas;4734511521;Taip;11;4;0;15
12111;Vilnelė;Nykštukas;6344134620;Taip;6;0;0;6
12112;Vilnelė;Nykštukas;4295630317;Taip;23;0;0;23
12113;Vilnelė;Nykštukas;1554473199;Taip;14;3;0;17
12114;Vilnelė;Nykštukas;4060927733;Taip;15;4;0;19
12115;Vilnelė;Nykštukas;2299381653;Taip;0;11;0;11
12116;Vilnelė;Nykštukas;5041031750;Taip;10;0;0;10
12117;Vilnelė;Nykštukas;2157793186;Taip;14;0;0;14
12118;Vilnelė;Nykštukas;4516818999;Taip;0;13;0;13
12119;Vilnelė;Nykštukas;8579294202;Taip;0;10;0;10
12120;Vilnelė;Nykštukas;7161529969;Taip;15;0;0;15
12121;Vilnelė;Nykštukas;6048991617;Taip;8;0;0;8
12122;Vilnelė;Nykštukas;6054488692;Taip;11;0;0;11
12123;Vilnelė;Nykštukas;8630048961;Ne;0;14;0;14
12124;Vilnelė;Nykštukas;7592040226;Taip;18;0;0;18
12125;Vilnelė;Nykštukas;1515873552;Taip;13;2;0;15
12126;Vilnelė;Nykštukas;5629086127;Taip;7;0;0;7
12127;Vilnelė;Pieštukas;9882766915;Taip;15;0;0;15
12128;Vilnelė;Pieštukas;5444967820;Taip;3;2;0;5
12129;Vilnelė;Pieštukas;3828623778;Taip;18;0;0;18
12130;Vilnelė;Pieštukas;7698638698;Taip;11;0;0;11
12131;Vilnelė;Pieštukas;3064118212;Taip;4;4;0;8
12132;Vilnelė;Pieštukas;7231998656;Taip;14;0;0;14
12133;Vilnelė;Pieštukas;2343750614;Taip;3;0;0;3
12134;Vilnelė;Pieštukas;9317041585;Taip;1;0;0;1
12135;Vilnelė;Pieštukas;2683662906;Taip;1;0;0;1
12136;Vilnelė;Pieštukas;4982137749;Taip;3;0;0;3
12137;Vilnelė;Pieštukas;2700153185;Taip;3;0;0;3
12138;Vilnelė;Pieštukas;4817502971;Taip;19;0;0;19
12139;Vilnelė;Pieštukas;3712463891;Taip;0;2;0;2
12140;Vilnelė;Pieštukas;9476510950;Taip;4;0;0;4
12141;Vilnelė;Pieštukas;9316933315;Taip;9;5;0;14
12142;Vilnelė;Pieštukas;8848138564;Taip;9;4;0;13
12143;Vilnelė;Voverytė;3432602015;Taip;0;4;0;4
12144;Vilnelė;Voverytė;9660305163;Taip;5;0;2;7
12145;Vilnelė;Voverytė;9950598582;Taip;17;6;0;23
12146;Vilnelė;Voverytė;2964672357;Taip;0;2;2;4
12147;Vilnelė;Voverytė;5273665901;Taip;1;0;0;1
12148;Vilnelė;Voverytė;1566734465;Taip;0;2;0;2
12149;Vilnelė;Voverytė;1371066506;Taip;0;1;0;1
12150;Vilnelė;Voverytė;3654833067;Taip;0;2;0;2
12151;Vilnelė;Voverytė;4322462166;Taip;0;2;0;2
12152;Vilnelė;Voverytė;5649725693;Taip;4;4;0;8
12153;Vilnelė;Voverytė;3234028667;Taip;9;2;0;11
12154;Vilnelė;Voverytė;7870509810;Taip;4;0;1;5
12155;Vilnelė;Voverytė;6569980514;Taip;9;9;0;18
12156;Vilnelė;Voverytė;4758117005;Taip;0;1;0;1
12157;Vilnelė;Voverytė;6634526716;Taip;5;5;0;10
12158;Vilnelė;Voverytė;1598555488;Taip;2;1;0;3
12159;Vilnelė;Voverytė;5960725916;Taip;6;5;0;11
12160;Vilnelė;Voverytė;7568755715;Taip;8;1;0;9
12161;Vilnelė;Kodėlčiukas;4642378600;Taip;5;4;0;9
12162;Vilnelė;Kodėlčiukas;6618109352;Taip;0;20;0;20
12163;Vilnelė;Kodėlčiukas;6715997340;Taip;0;1;0;1
12164;Vilnelė;Kodėlčiukas;9482133396;Taip;9;0;0;9
12165;Vilnelė;Kodėlčiukas;8620789304;Taip;8;0;0;8
12166;Vilnelė;Kodėlčiukas;8439505238;Taip;3;13;0;16
12167;Vilnelė;Kodėlčiukas;1580287517;Taip;4;3;0;7
12168;Vilnelė;Kodėlčiukas;5558378376;Taip;4;1;0;5
12169;Vilnelė;Kodėlčiukas;4328263940;Taip;6;4;0;10
12170;Vilnelė;Kodėlčiukas;3056845279;Taip;0;10;0;10
12171;Vilnelė;Kodėlčiukas;9537740492;Taip;2;0;0;2
12172;Vilnelė;Kodėlčiukas;9640330864;Taip;13;0;0;13
12173;Vilnelė;Kodėlčiukas;3848720970;Taip;5;0;0;5
12174;Vilnelė;Kodėlčiukas;7833531435;Taip;0;2;0;2
12175;Vilnelė;Kodėlčiukas;5961910077;Taip;3;4;0;7
12176;Vilnelė;Kodėlčiukas;3115242919;Taip;2;1;0;3
12177;Vilnelė;Kodėlčiukas;8543995029;Taip;13;5;0;18
12178;Vilnelė;Kodėlčiukas;1933660272;Taip;6;0;0;6
12179;Vilnelė;Kodėlčiukas;4986079102;Taip;0;3;0;3
12180;Vilnelė;Kodėlčiukas;5398303580;Taip;8;0;0;8
12181;Vilnelė;Kodėlčiukas;9418661965;Taip;0;2;0;2
12182;Vilnelė;Kodėlčiukas;5180951251;Taip;5;2;0;7
12183;Vilnelė;Žirniukas;9817054571;Taip;0;3;0;3
12184;Vilnelė;Žirniukas;9476348226;Taip;11;1;0;12
12185;Vilnelė;Žirniukas;9253975757;Taip;3;1;0;4
12186;Vilnelė;Žirniukas;9432188739;Taip;1;0;0;1
12187;Vilnelė;Žirniukas;8216383228;Taip;6;2;0;8
12188;Vilnelė;Žirniukas;2358167792;Taip;1;0;0;1
12189;Vilnelė;Žirniukas;2146981715;Taip;6;0;0;6
12190;Vilnelė;Žirniukas;1465849135;Taip;2;1;0;3
12191;Vilnelė;Žirniukas;9578715472;Taip;9;1;0;10
12192;Vilnelė;Žirniukas;2188575653;Taip;0;23;0;23
12193;Vilnelė;Žirniukas;2234709212;Taip;10;4;0;14
12194;Vilnelė;Žirniukas;1912897383;Taip;14;0;0;14
12195;Vilnelė;Žirniukas;4789175532;Taip;13;0;0;13
12196;Vilnelė;Pipiras;1977362135;Taip;10;0;0;10
12197;Vilnelė;Pipiras;6883775268;Taip;7;0;0;7
12198;Vilnelė;Pipiras;1336126156;Taip;10;0;0;10
12199;Vilnelė;Pipiras;8061099641;Taip;7;1;0;8
12200;Vilnelė;Pipiras;1631249610;Taip;0;1;0;1
12201;Vilnelė;Pipiras;9300237246;Taip;15;0;0;15
12202;Vilnelė;Pipiras;7090044022;Taip;11;0;0;11
12203;Vilnelė;Pipiras;8602843000;Taip;8;6;0;14
12204;Vilnelė;Pipiras;9909858294;Taip;11;1;0;12
12205;Vilnelė;Pipiras;6707024855;Taip;5;1;0;6
12206;Vilnelė;Pipiras;9016135318;Taip;5;4;0;9
12207;Vilnelė;Pipiras;8015908754;Taip;9;6;0;15
12208;Vilnelė;Pipiras;4445721874;Taip;10;13;0;23
12209;Vilnelė;Pipiras;1003518211;Taip;10;13;0;23
12210;Vilnelė;Pipiras;3980908303;Taip;9;0;0;9
12211;Vėrinėlis;GAIDELIAI;6162461750;Taip;4;0;0;4
12212;Vėrinėlis;GAIDELIAI;1944358526;Taip;16;2;0;18
12213;Vėrinėlis;GAIDELIAI;3500287869;Taip;5;2;1;8
12214;Vėrinėlis;GAIDELIAI;6500266853;Taip;14;0;1;15
12215;Vėrinėlis;GAIDELIAI;5891690000;Taip;5;0;0;5
12216;Vėrinėlis;GAIDELIAI;4401001009;Taip;19;1;0;20
12217;Vėrinėlis;GAIDELIAI;1685329004;Taip;3;0;0;3
12218;Vėrinėlis;GAIDELIAI;4498096701;Taip;8;0;0;8
12219;Vėrinėlis;GAIDELIAI;9144004655;Taip;14;0;0;14
12220;Vėrinėlis;GAIDELIAI;8272531606;Taip;7;0;0;7
12221;Vėrinėlis;GAIDELIAI;2114637828;Taip;8;0;1;9
12222;Vėrinėlis;GAIDELIAI;1844862699;Taip;10;0;0;10
12223;Vėrinėlis;GAIDELIAI;7455948332;Taip;16;3;0;19
12224;Vėrinėlis;GAIDELIAI;4965735537;Taip;9;0;0;9
12225;Vėrinėlis;GAIDELIAI;1014076118;Taip;13;0;0;13
12226;Vėrinėlis;GAIDELIAI;2273903945;Taip;0;15;0;15
12227;Vėrinėlis;GAIDELIAI;8817186115;Taip;7;7;0;14
12228;Vėrinėlis;GAIDELIAI;8050158529;Taip;4;0;0;4
12229;Vėrinėlis;GAIDELIAI;6211953526;Taip;9;0;0;9
12230;Vėrinėlis;GAIDELIAI;9522506115;Taip;12;0;0;12
12231;Vėrinėlis;GAIDELIAI;6159725406;Taip;8;0;0;8
12232;Vėrinėlis;SAULUTĖ;7224418233;Taip;8;0;0;8
12233;Vėrinėlis;SAULUTĖ;7471147288;Taip;0;4;0;4
12234;Vėrinėlis;SAULUTĖ;8238013636;Taip;9;0;0;9
12235;Vėrinėlis;SAULUTĖ;7273090217;Taip;0;1;0;1
12236;Vėrinėlis;SAULUTĖ;2337883071;Taip;0;0;7;7
12237;Vėrinėlis;SAULUTĖ;6913001318;Taip;0;1;0;1
12238;Vėrinėlis;SAULUTĖ;7440020169;Taip;6;6;0;12
12239;Vėrinėlis;SAULUTĖ;7913975075;Taip;0;11;0;11
12240;Vėrinėlis;SAULUTĖ;9967737864;Taip;0;1;0;1
12241;Vėrinėlis;SAULUTĖ;9009344779;Taip;0;5;0;5
12242;Vėrinėlis;SAULUTĖ;4059906525;Taip;5;1;0;6
12243;Vėrinėlis;SAULUTĖ;3832662507;Taip;15;0;0;15
12244;Vėrinėlis;SAULUTĖ;3291922401;Taip;0;1;0;1
12245;Vėrinėlis;SAULUTĖ;1007705906;Taip;9;4;0;13
12246;Vėrinėlis;SAULUTĖ;9289003583;Taip;3;2;0;5
12247;Vėrinėlis;SAULUTĖ;1684203955;Taip;3;2;0;5
12248;Vėrinėlis;SAULUTĖ;5942475043;Taip;0;12;0;12
12249;Vėrinėlis;SAULUTĖ;9310629340;Taip;0;1;0;1
12250;Vėrinėlis;SAULUTĖ;2369434537;Taip;4;4;0;8
12251;Vėrinėlis;SAULUTĖ;1515803985;Taip;0;0;1;1
12252;Vėrinėlis;NYKŠTUKAI;5488087105;Taip;0;4;0;4
12253;Vėrinėlis;NYKŠTUKAI;5859566909;Taip;0;4;0;4
12254;Vėrinėlis;NYKŠTUKAI;4423562494;Taip;14;4;0;18
12255;Vėrinėlis;NYKŠTUKAI;5167825818;Taip;20;0;0;20
12256;Vėrinėlis;NYKŠTUKAI;2646575761;Taip;0;1;1;2
12257;Vėrinėlis;NYKŠTUKAI;9300891973;Taip;7;0;0;7
12258;Vėrinėlis;NYKŠTUKAI;8397635057;Taip;5;8;0;13
12259;Vėrinėlis;NYKŠTUKAI;8423611087;Taip;0;0;1;1
12260;Vėrinėlis;NYKŠTUKAI;8294753714;Taip;14;1;0;15
12261;Vėrinėlis;NYKŠTUKAI;4841000338;Taip;2;0;0;2
12262;Vėrinėlis;NYKŠTUKAI;2403376619;Taip;0;2;6;8
12263;Vėrinėlis;NYKŠTUKAI;2384172198;Taip;0;0;1;1
12264;Vėrinėlis;NYKŠTUKAI;4133310852;Taip;11;0;0;11
12265;Vėrinėlis;NYKŠTUKAI;7958241295;Taip;14;0;0;14
12266;Vėrinėlis;BURATINAS;7093959212;Taip;4;2;0;6
12267;Vėrinėlis;BURATINAS;8100283579;Taip;4;0;0;4
12268;Vėrinėlis;BURATINAS;2774618380;Taip;4;2;0;6
12269;Vėrinėlis;BURATINAS;2467700639;Taip;5;4;0;9
12270;Vėrinėlis;BURATINAS;6136232912;Taip;14;1;0;15
12271;Vėrinėlis;BURATINAS;6058712578;Taip;0;5;0;5
12272;Vėrinėlis;BURATINAS;6413701823;Taip;6;0;0;6
12273;Vėrinėlis;BURATINAS;2364117224;Taip;7;1;0;8
12274;Vėrinėlis;BURATINAS;7287634205;Taip;4;0;0;4
12275;Vėrinėlis;BURATINAS;3898060925;Ne;8;2;0;10
12276;Vėrinėlis;BURATINAS;4676052255;Taip;5;1;0;6
12277;Vėrinėlis;BURATINAS;3882915774;Taip;0;1;3;4
12278;Vėrinėlis;BURATINAS;7167034587;Taip;7;2;0;9
12279;Vėrinėlis;BURATINAS;1919350623;Taip;19;0;1;20
12280;Vėrinėlis;BURATINAS;6310807762;Taip;5;0;1;6
12281;Vėrinėlis;BURATINAS;5514167627;Taip;10;0;1;11
12282;Vėrinėlis;GINTARĖLIAI;8372084728;Taip;15;9;0;24
12283;Vėrinėlis;GINTARĖLIAI;6054398276;Taip;5;10;0;15
12284;Vėrinėlis;GINTARĖLIAI;7432965615;Taip;15;2;0;17
12285;Vėrinėlis;GINTARĖLIAI;3457199716;Taip;12;2;0;14
12286;Vėrinėlis;GINTARĖLIAI;7743951577;Taip;11;0;0;11
12287;Vėrinėlis;GINTARĖLIAI;2006432327;Taip;8;2;0;10
12288;Vėrinėlis;GINTARĖLIAI;6785519869;Taip;16;1;0;17
12289;Vėrinėlis;GINTARĖLIAI;3363388500;Taip;9;19;0;28
12290;Vėrinėlis;GINTARĖLIAI;8545392429;Taip;5;0;0;5
12291;Vėrinėlis;GINTARĖLIAI;9171173116;Taip;8;0;0;8
12292;Vėrinėlis;GINTARĖLIAI;3192625484;Taip;4;10;0;14
12293;Vėrinėlis;GINTARĖLIAI;8343196405;Taip;8;1;0;9
12294;Vėrinėlis;GINTARĖLIAI;2284527544;Taip;1;0;0;1
12295;Vėrinėlis;GINTARĖLIAI;4034106321;Taip;3;0;0;3
12296;Vėrinėlis;GINTARĖLIAI;5654269153;Taip;3;0;0;3
12297;Vėrinėlis;GINTARĖLIAI;6226329879;Taip;16;0;0;16
12298;Vėrinėlis;GINTARĖLIAI;7069247393;Taip;4;0;0;4
12299;Vėrinėlis;GINTARĖLIAI;9370715798;Taip;10;0;0;10
12300;Vėrinėlis;GINTARĖLIAI;6055921178;Taip;4;0;0;4
12301;Vėrinėlis;RAMUNĖLĖS;5447760434;Taip;0;1;0;1
12302;Vėrinėlis;RAMUNĖLĖS;2911674984;Taip;4;0;0;4
12303;Vėrinėlis;RAMUNĖLĖS;4123553749;Taip;11;0;0;11
12304;Vėrinėlis;RAMUNĖLĖS;9234123596;Taip;10;0;1;11
12305;Vėrinėlis;RAMUNĖLĖS;5051742311;Ne;10;0;0;10
12306;Vėrinėlis;RAMUNĖLĖS;9257045102;Taip;2;1;0;3
12307;Vėrinėlis;RAMUNĖLĖS;5501075800;Taip;0;1;0;1
12308;Vėrinėlis;RAMUNĖLĖS;1699912818;Taip;2;0;1;3
12309;Vėrinėlis;RAMUNĖLĖS;4492269367;Taip;4;0;0;4
12310;Vėrinėlis;RAMUNĖLĖS;7294499755;Taip;0;22;0;22
12311;Vėrinėlis;RAMUNĖLĖS;7544881486;Taip;0;2;0;2
12312;Vėrinėlis;RAMUNĖLĖS;1403519604;Taip;15;0;0;15
12313;Vėrinėlis;RAMUNĖLĖS;6240649255;Taip;15;0;0;15
12314;Vėrinėlis;RAMUNĖLĖS;2763569936;Taip;5;7;0;12
12315;Vėrinėlis;RAMUNĖLĖS;7349463495;Taip;7;0;0;7
12316;Vėrinėlis;RAMUNĖLĖS;9935098198;Ne;13;0;1;14
12317;Vėrinėlis;KODELČIUKŲ;8722816580;Taip;0;0;5;5
12318;Vėrinėlis;KODELČIUKŲ;5342916562;Taip;1;0;0;1
12319;Vėrinėlis;KODELČIUKŲ;6316271212;Taip;8;0;0;8
12320;Vėrinėlis;KODELČIUKŲ;9650883071;Taip;14;0;0;14
12321;Vėrinėlis;KODELČIUKŲ;9349874701;Taip;8;0;0;8
12322;Vėrinėlis;KODELČIUKŲ;9179544549;Taip;16;0;1;17
12323;Vėrinėlis;KODELČIUKŲ;3830101723;Taip;0;0;2;2
12324;Vėrinėlis;KODELČIUKŲ;4818860992;Taip;0;0;2;2
12325;Vėrinėlis;KODELČIUKŲ;2908247336;Taip;15;0;0;15
12326;Vėrinėlis;KODELČIUKŲ;8389805682;Taip;9;0;0;9
12327;Vėrinėlis;KODELČIUKŲ;3563156582;Taip;10;0;1;11
12328;Vėrinėlis;KODELČIUKŲ;1119458722;Taip;11;0;0;11
12329;Vėrinėlis;KODELČIUKŲ;8029977991;Taip;3;0;0;3
12330;Vėrinėlis;KODELČIUKŲ;4065241921;Taip;11;0;0;11
12331;Vėrinėlis;KODELČIUKŲ;8977670959;Taip;10;0;0;10
12332;Vėrinėlis;KODELČIUKŲ;7382201231;Taip;4;0;0;4
12333;Vėrinėlis;ŽIRNIUKAI;1769852084;Taip;5;0;0;5
12334;Vėrinėlis;ŽIRNIUKAI;4718732261;Taip;1;4;0;5
12335;Vėrinėlis;ŽIRNIUKAI;4981127515;Taip;1;3;0;4
12336;Vėrinėlis;ŽIRNIUKAI;8329989952;Taip;5;0;0;5
12337;Vėrinėlis;ŽIRNIUKAI;3202518504;Taip;8;4;0;12
12338;Vėrinėlis;ŽIRNIUKAI;4752902173;Taip;0;4;0;4
12339;Vėrinėlis;ŽIRNIUKAI;7237945125;Taip;13;0;0;13
12340;Vėrinėlis;ŽIRNIUKAI;5600815908;Taip;0;4;1;5
12341;Vėrinėlis;ŽIRNIUKAI;1736733257;Taip;0;1;3;4
12342;Vėrinėlis;ŽIRNIUKAI;2687583764;Taip;11;0;0;11
12343;Vėrinėlis;ŽIRNIUKAI;2633143128;Taip;0;4;0;4
12344;Vėrinėlis;ŽIRNIUKAI;9419245081;Taip;0;5;1;6
12345;Vėrinėlis;ŽIRNIUKAI;7817387800;Taip;0;0;1;1
12346;Vėrinėlis;ŽIRNIUKAI;6377447141;Ne;15;0;0;15
12347;Vėrinėlis;ŽIRNIUKAI;7371908331;Taip;11;0;0;11
12348;Vėrinėlis;ŽIRNIUKAI;2087129236;Taip;0;4;0;4
12349;Vėrinėlis;ŽIRNIUKAI;6392625405;Ne;4;6;0;10
12350;Vėrinėlis;ŽIRNIUKAI;1896980533;Taip;3;1;0;4
12351;Vėrinėlis;ŽIRNIUKAI;8483525051;Taip;2;2;0;4
12352;Vėrinėlis;ŽIRNIUKAI;8397025332;Taip;0;6;1;7
12353;Vėrinėlis;ŽIRNIUKAI;6576726481;Taip;0;6;1;7
12354;Vėrinėlis;ŽIRNIUKAI;6220653152;Taip;0;1;0;1
12355;Vėrinėlis;VARPELIAI;7416041207;Taip;0;3;0;3
12356;Vėrinėlis;VARPELIAI;8655158155;Taip;11;4;0;15
12357;Vėrinėlis;VARPELIAI;6362125404;Ne;8;1;0;9
12358;Vėrinėlis;VARPELIAI;7216867683;Taip;0;5;0;5
12359;Vėrinėlis;VARPELIAI;8336694468;Taip;8;1;0;9
12360;Vėrinėlis;VARPELIAI;2731207996;Taip;0;0;4;4
12361;Vėrinėlis;VARPELIAI;2625930005;Taip;0;0;2;2
12362;Vėrinėlis;VARPELIAI;1026312967;Taip;0;1;0;1
12363;Vėrinėlis;VARPELIAI;2561255096;Taip;9;3;0;12
12364;Vėrinėlis;VARPELIAI;3392458614;Taip;12;0;0;12
12365;Vėrinėlis;VARPELIAI;5837383907;Taip;2;3;0;5
12366;Vėrinėlis;VARPELIAI;3953496894;Taip;6;3;0;9
12367;Vėrinėlis;VARPELIAI;3663446767;Taip;2;0;0;2
12368;Vėrinėlis;VARPELIAI;4086695239;Taip;9;0;0;9
12369;Vėrinėlis;BORUŽĖLĖS;8759487574;Taip;0;7;0;7
12370;Vėrinėlis;BORUŽĖLĖS;4819016753;Taip;6;0;0;6
12371;Vėrinėlis;BORUŽĖLĖS;1910385020;Taip;7;0;0;7
12372;Vėrinėlis;BORUŽĖLĖS;2078857084;Taip;0;1;0;1
12373;Vėrinėlis;BORUŽĖLĖS;3934652683;Taip;4;0;0;4
12374;Vėrinėlis;BORUŽĖLĖS;6904733283;Taip;4;0;6;10
12375;Vėrinėlis;BORUŽĖLĖS;4446546335;Taip;10;0;0;10
12376;Vėrinėlis;BORUŽĖLĖS;2501287529;Taip;5;2;0;7
12377;Vėrinėlis;BORUŽĖLĖS;8904833339;Taip;0;7;0;7
12378;Vėrinėlis;BORUŽĖLĖS;3312501759;Taip;0;7;0;7
12379;Vėrinėlis;BORUŽĖLĖS;9217188911;Taip;10;8;0;18
12380;Vėrinėlis;BORUŽĖLĖS;7414937335;Taip;0;7;0;7
12381;Vėrinėlis;BORUŽĖLĖS;2574507205;Taip;5;0;0;5
12382;Vėrinėlis;BORUŽĖLĖS;3200007674;Taip;15;0;0;15
12383;Vėrinėlis;BORUŽĖLĖS;4852563692;Taip;0;2;2;4
12384;Vėrinėlis;BORUŽĖLĖS;5865529907;Taip;14;0;0;14
12385;Vėrinėlis;BORUŽĖLĖS;9613642664;Taip;0;7;0;7
12386;Vėrinėlis;BORUŽĖLĖS;2467242845;Taip;0;6;0;6
12387;Vėrinėlis;BORUŽĖLĖS;4037594669;Taip;0;0;1;1
12388;Vėrinėlis;SVEIKUOLIAI;1909742394;Taip;3;2;0;5
12389;Vėrinėlis;SVEIKUOLIAI;6176308531;Taip;0;4;0;4
12390;Vėrinėlis;SVEIKUOLIAI;3070965434;Taip;0;1;0;1
12391;Vėrinėlis;SVEIKUOLIAI;6154618103;Taip;0;4;0;4
12392;Vėrinėlis;SVEIKUOLIAI;3563114419;Taip;0;1;0;1
12393;Vėrinėlis;SVEIKUOLIAI;3973272659;Taip;4;0;0;4
12394;Vėrinėlis;SVEIKUOLIAI;8716965452;Taip;10;5;0;15
12395;Vėrinėlis;SVEIKUOLIAI;7584124339;Taip;15;0;0;15
12396;Vėrinėlis;SVEIKUOLIAI;9352630743;Taip;5;2;0;7
12397;Vėrinėlis;SVEIKUOLIAI;4859330774;Taip;2;0;0;2
12398;Vėrinėlis;SVEIKUOLIAI;8543081245;Taip;2;3;0;5
12399;Vėrinėlis;SVEIKUOLIAI;1800434426;Taip;2;4;0;6
12400;Vėrinėlis;SVEIKUOLIAI;5614185158;Taip;7;1;0;8
12401;Vėrinėlis;SVEIKUOLIAI;5539714292;Taip;3;1;0;4
12402;Vėrinėlis;SVEIKUOLIAI;2516474825;Taip;10;2;0;12
12403;Vėrinėlis;SVEIKUOLIAI;9058127692;Taip;2;0;0;2
12404;Vėrinėlis;SVEIKUOLIAI;1278914183;Taip;8;0;0;8
12405;Vėrinėlis;SVEIKUOLIAI;7573209012;Taip;0;5;0;5
12406;Vėrinėlis;SVEIKUOLIAI;3084117432;Taip;9;0;0;9
12407;Vėrinėlis;SVEIKUOLIAI;2015928440;Taip;6;0;0;6
12408;Vėrinėlis;ŠIRDELĖS;7734163541;Taip;0;4;0;4
12409;Vėrinėlis;ŠIRDELĖS;4378592116;Taip;0;2;0;2
12410;Vėrinėlis;ŠIRDELĖS;7517113022;Taip;8;0;0;8
12411;Vėrinėlis;ŠIRDELĖS;1841277321;Taip;0;4;0;4
12412;Vėrinėlis;ŠIRDELĖS;5588658517;Taip;0;5;0;5
12413;Vėrinėlis;ŠIRDELĖS;5653635907;Taip;0;7;0;7
12414;Vėrinėlis;ŠIRDELĖS;1152010178;Taip;1;5;0;6
12415;Vėrinėlis;ŠIRDELĖS;2038169885;Taip;6;6;0;12
12416;Vėrinėlis;ŠIRDELĖS;9375922889;Taip;7;2;0;9
12417;Vėrinėlis;ŠIRDELĖS;5813009126;Taip;0;8;0;8
12418;Vėrinėlis;ŠIRDELĖS;9217815657;Taip;0;10;0;10
12419;Vėrinėlis;ŠIRDELĖS;1339847370;Taip;1;0;0;1
12420;Vėrinėlis;ŠIRDELĖS;3687250255;Taip;0;1;0;1
12421;Vėrinėlis;ŠIRDELĖS;2847839917;Taip;10;3;0;13
12422;Vėrinėlis;ŠIRDELĖS;7311740859;Taip;0;4;0;4
12423;Vėrinėlis;ŠIRDELĖS;6905591549;Taip;0;10;0;10
12424;Viltenė;Drugeliai;3625763429;Taip;4;0;0;4
12425;Viltenė;Drugeliai;2392304909;Taip;0;2;0;2
12426;Viltenė;Drugeliai;5781655552;Taip;0;5;0;5
12427;Viltenė;Drugeliai;8679787688;Taip;0;2;0;2
12428;Viltenė;Drugeliai;4616047113;Ne;0;4;0;4
12429;Viltenė;Drugeliai;6810811656;Taip;4;1;0;5
12430;Viltenė;Drugeliai;3905014810;Taip;6;5;0;11
12431;Viltenė;Drugeliai;4121448859;Taip;4;3;0;7
12432;Viltenė;Drugeliai;9157616307;Taip;2;0;0;2
12433;Viltenė;Drugeliai;9476132305;Taip;5;0;0;5
12434;Viltenė;Drugeliai;5522245968;Taip;0;5;0;5
12435;Viltenė;Drugeliai;7401460248;Taip;7;0;0;7
12436;Viltenė;Drugeliai;5552217000;Taip;0;1;0;1
12437;Viltenė;Drugeliai;9756519374;Taip;0;3;0;3
12438;Viltenė;Drugeliai;7928894276;Taip;0;2;0;2
12439;Viltenė;Drugeliai;4195708756;Taip;9;0;0;9
12440;Viltenė;Drugeliai;1081603034;Taip;14;1;0;15
12441;Viltenė;Drugeliai;7500965165;Taip;0;4;0;4
12442;Viltenė;Bitučių;4001205912;Taip;11;0;0;11
12443;Viltenė;Bitučių;5077874991;Taip;13;1;0;14
12444;Viltenė;Bitučių;7266522399;Taip;3;5;0;8
12445;Viltenė;Bitučių;5241075224;Taip;4;0;0;4
12446;Viltenė;Bitučių;1374979411;Taip;0;5;0;5
12447;Viltenė;Bitučių;1765335359;Taip;11;2;0;13
12448;Viltenė;Bitučių;8681961430;Taip;21;0;0;21
12449;Viltenė;Bitučių;8608269197;Taip;0;2;0;2
12450;Viltenė;Bitučių;9805422851;Taip;0;1;1;2
12451;Viltenė;Bitučių;3234013091;Taip;14;0;0;14
12452;Viltenė;Bitučių;2460019568;Taip;0;4;0;4
12453;Viltenė;Boružėlių;6642790962;Taip;0;1;0;1
12454;Viltenė;Boružėlių;9572407405;Taip;0;4;0;4
12455;Viltenė;Boružėlių;3738838707;Taip;4;4;0;8
12456;Viltenė;Boružėlių;8473588098;Taip;4;3;0;7
12457;Viltenė;Boružėlių;3995418079;Taip;1;0;0;1
12458;Viltenė;Boružėlių;1399653129;Taip;5;0;0;5
12459;Viltenė;Boružėlių;7526555727;Ne;0;6;0;6
12460;Viltenė;Boružėlių;1936628249;Taip;0;1;0;1
12461;Viltenė;Boružėlių;4036109404;Taip;0;3;0;3
12462;Viltenė;Boružėlių;4604298036;Taip;0;10;0;10
12463;Viltenė;Boružėlių;9197007374;Taip;0;1;0;1
12464;Viltenė;Boružėlių;9242034622;Taip;0;1;0;1
12465;Viltenė;Boružėlių;6621273812;Taip;0;2;0;2
12466;Viltenė;Boružėlių;8527270437;Ne;0;10;0;10
12467;Viltenė;Gandriukų;6481491422;Taip;0;0;3;3
12468;Viltenė;Gandriukų;2884698447;Taip;0;2;0;2
12469;Viltenė;Gandriukų;6060648988;Taip;0;4;0;4
12470;Viltenė;Gandriukų;1840626621;Taip;0;3;0;3
12471;Viltenė;Gandriukų;7796422726;Taip;0;3;0;3
12472;Viltenė;Gandriukų;2815105107;Taip;0;2;0;2
12473;Viltenė;Gandriukų;6511850468;Taip;2;3;0;5
12474;Viltenė;Gandriukų;4945108189;Taip;0;10;0;10
12475;Viltenė;Gandriukų;8110413064;Taip;0;1;0;1
12476;Viltenė;Gandriukų;1243595112;Taip;0;4;0;4
12477;Viltenė;Gandriukų;3073228245;Ne;4;0;5;9
12478;Viltenė;Gandriukų;4468743044;Taip;2;0;0;2
12479;Viltenė;Gandriukų;6355857716;Taip;0;0;2;2
12480;Viltenė;Gandriukų;5929135840;Taip;0;0;1;1
12481;Viltenė;Gandriukų;6473925760;Taip;9;0;1;10
12482;Viltenė;Gandriukų;8458769051;Taip;0;4;0;4
12483;Viltenė;Aitvariukai;5083515613;Ne;0;1;0;1
12484;Viltenė;Aitvariukai;2137929911;Taip;0;2;0;2
12485;Viltenė;Aitvariukai;9185054066;Taip;0;5;0;5
12486;Viltenė;Aitvariukai;2036902795;Taip;0;1;0;1
12487;Viltenė;Aitvariukai;5599943846;Taip;0;4;0;4
12488;Viltenė;Aitvariukai;6296509460;Taip;0;4;0;4
12489;Viltenė;Aitvariukai;9101795131;Taip;0;4;0;4
12490;Viltenė;Aitvariukai;8439859449;Taip;4;4;0;8
12491;Viltenė;Aitvariukai;2976705872;Taip;6;3;0;9
12492;Viltenė;Aitvariukai;2192086488;Taip;0;5;0;5
12493;Viltenė;Aitvariukai;2026654467;Taip;1;2;0;3
12494;Viltenė;Aitvariukai;4641365031;Taip;0;2;0;2
12495;Viltenė;Aitvariukai;7277455268;Taip;0;10;0;10
12496;Viltenė;Aitvariukai;3245284852;Taip;0;1;0;1
12497;Viltenė;Aitvariukai;2786572522;Taip;0;9;0;9
12498;Viltenė;Aitvariukai;6171399579;Taip;5;0;0;5
12499;Viltenė;Aitvariukai;3839680327;Taip;1;0;0;1
12500;Viltenė;Geniukų;3157417614;Taip;1;0;0;1
12501;Viltenė;Geniukų;2903596382;Taip;5;1;0;6
12502;Viltenė;Geniukų;1318750938;Taip;3;0;0;3
12503;Viltenė;Geniukų;6379567497;Taip;9;0;0;9
12504;Viltenė;Geniukų;7145240197;Taip;1;0;0;1
12505;Viltenė;Geniukų;7058586628;Taip;7;0;0;7
12506;Viltenė;Geniukų;7005219570;Taip;1;0;0;1
12507;Viltenė;Geniukų;8278572246;Taip;5;0;0;5
12508;Viltenė;Geniukų;1587868835;Taip;5;0;0;5
12509;Viltenė;Geniukų;2850146424;Taip;5;0;0;5
12510;Viltenė;Geniukų;7993258845;Ne;0;4;0;4
12511;Viltenė;Geniukų;4537287677;Taip;6;0;0;6
12512;Viltenė;Geniukų;3306285115;Taip;10;1;0;11
12513;Viltenė;Geniukų;9288406881;Taip;0;1;0;1
12514;Viltenė;Geniukų;6992120038;Taip;10;0;0;10
12515;Viltenė;Geniukų;4981225829;Taip;4;4;0;8
12516;Viltenė;Geniukų;3853518656;Taip;5;0;0;5
12517;Viltenė;Geniukų;9582577013;Taip;19;4;0;23
12518;Viltenė;Geniukų;2036857372;Taip;6;0;0;6
12519;Viltenė;Geniukų;3343045604;Taip;2;0;0;2
12520;Viltenė;Geniukų;9424773418;Taip;1;0;0;1
12521;Viltenė;Saulutės;8091905944;Taip;0;1;0;1
12522;Viltenė;Saulutės;5974408492;Taip;2;1;0;3
12523;Viltenė;Saulutės;1641406030;Taip;0;1;0;1
12524;Viltenė;Saulutės;4615393852;Taip;0;4;0;4
12525;Viltenė;Saulutės;9760364123;Taip;10;0;0;10
12526;Viltenė;Saulutės;3347380524;Taip;4;2;0;6
12527;Viltenė;Saulutės;2846574130;Taip;0;22;0;22
12528;Viltenė;Saulutės;4724382069;Taip;14;0;0;14
12529;Viltenė;Saulutės;2841144656;Taip;10;0;0;10
12530;Viltenė;Saulutės;8141954391;Taip;0;1;0;1
12531;Viltenė;Saulutės;4379784712;Taip;0;3;0;3
12532;Viltenė;Saulutės;7810374329;Taip;0;2;0;2
12533;Viltenė;Saulutės;9095458948;Taip;23;0;0;23
12534;Viltenė;Saulutės;4661430937;Taip;5;0;0;5
12535;Viltenė;Saulutės;8258247750;Taip;9;0;0;9
12536;Viltenė;Saulutės;6595715908;Taip;0;1;0;1
12537;Viltenė;Lapiukų;2034259692;Taip;0;3;0;3
12538;Viltenė;Lapiukų;3473533533;Taip;5;5;0;10
12539;Viltenė;Lapiukų;8696698257;Taip;0;6;0;6
12540;Viltenė;Lapiukų;8248514570;Taip;18;0;0;18
12541;Viltenė;Lapiukų;2878124826;Taip;8;3;0;11
12542;Viltenė;Lapiukų;2660622296;Taip;3;1;0;4
12543;Viltenė;Lapiukų;8122878153;Taip;0;4;0;4
12544;Viltenė;Lapiukų;9573891616;Taip;0;11;0;11
12545;Viltenė;Lapiukų;4243501722;Taip;1;4;0;5
12546;Viltenė;Lapiukų;6429905246;Taip;7;4;0;11
12547;Viltenė;Lapiukų;6070264006;Taip;5;1;0;6
12548;Viltenė;Lapiukų;8187712849;Taip;2;1;0;3
12549;Viltenė;Lapiukų;3679704404;Taip;0;8;0;8
12550;Viltenė;Lapiukų;1507287948;Taip;4;0;0;4
12551;Viltenė;Lapiukų;9846205631;Taip;2;1;0;3
12552;Viltenė;Lapiukų;9063994291;Taip;4;0;0;4
12553;Viltenė;Lapiukų;1964849653;Taip;21;0;0;21
12554;Viltenė;Voveriukai;6888346135;Taip;7;6;0;13
12555;Viltenė;Voveriukai;2936670828;Ne;10;0;0;10
12556;Viltenė;Voveriukai;5816623708;Taip;0;23;0;23
12557;Viltenė;Voveriukai;5611839058;Taip;1;5;0;6
12558;Viltenė;Voveriukai;4414192600;Taip;4;2;2;8
12559;Viltenė;Voveriukai;2483760198;Ne;4;1;0;5
12560;Viltenė;Voveriukai;8341211836;Taip;13;0;0;13
12561;Viltenė;Voveriukai;6954065006;Taip;13;0;0;13
12562;Viltenė;Voveriukai;6741521720;Taip;0;14;0;14
12563;Viltenė;Voveriukai;2642080849;Taip;4;2;0;6
12564;Viltenė;Voveriukai;6040634853;Taip;0;1;0;1
12565;Viltenė;Voveriukai;7322841332;Taip;0;6;2;8
12566;Viltenė;Voveriukai;1888167096;Taip;0;2;0;2
12567;Viltenė;Voveriukai;3291926243;Taip;7;7;0;14
12568;Viltenė;Voveriukai;2894570917;Taip;0;1;0;1
12569;Viltenė;Voveriukai;7158824421;Taip;0;1;0;1
12570;Viltenė;Voveriukai;1890096287;Taip;9;0;0;9
12571;Viltenė;Kiškučiai;7314937470;Taip;0;2;0;2
12572;Viltenė;Kiškučiai;8150583354;Ne;0;4;4;8
12573;Viltenė;Kiškučiai;9862698928;Ne;10;0;0;10
12574;Viltenė;Kiškučiai;3996210451;Taip;0;2;0;2
12575;Viltenė;Kiškučiai;1512772072;Taip;3;0;0;3
12576;Viltenė;Kiškučiai;4970273010;Taip;5;0;0;5
12577;Viltenė;Kiškučiai;6971198297;Taip;12;0;0;12
12578;Viltenė;Kiškučiai;3719039209;Taip;0;1;0;1
12579;Viltenė;Kiškučiai;2413392645;Taip;7;1;0;8
12580;Viltenė;Kiškučiai;3501209955;Ne;0;11;0;11
12581;Viltenė;Kiškučiai;1828982237;Taip;3;2;1;6
12582;Viltenė;Nykštukų;9263941853;Taip;16;0;0;16
12583;Viltenė;Nykštukų;9308502487;Taip;11;0;0;11
12584;Viltenė;Nykštukų;3331402933;Taip;4;0;1;5
12585;Viltenė;Nykštukų;6715408809;Taip;4;0;0;4
12586;Viltenė;Nykštukų;7957033437;Taip;0;4;0;4
12587;Viltenė;Nykštukų;8423445808;Taip;3;0;0;3
12588;Viltenė;Nykštukų;4692894136;Taip;8;0;0;8
12589;Viltenė;Nykštukų;2675172000;Taip;2;0;0;2
12590;Viltenė;Nykštukų;7950534618;Taip;4;0;0;4
12591;Viltenė;Nykštukų;7281994705;Taip;1;0;0;1
12592;Viltenė;Nykštukų;6805422614;Taip;4;0;0;4
12593;Viltenė;Nykštukų;2549050819;Taip;19;0;0;19
12594;Viltenė;Triušiukai;7754951374;Taip;4;3;0;7
12595;Viltenė;Triušiukai;1788524515;Taip;0;2;0;2
12596;Viltenė;Triušiukai;7331321780;Taip;0;3;0;3
12597;Viltenė;Triušiukai;9211978362;Taip;0;2;0;2
12598;Viltenė;Triušiukai;3007260551;Taip;9;1;0;10
12599;Viltenė;Triušiukai;7809538482;Taip;22;0;0;22
12600;Viltenė;Triušiukai;1324341385;Taip;9;0;0;9
12601;Viltenė;Triušiukai;5083086443;Taip;8;0;0;8
12602;Viltenė;Triušiukai;9643964097;Taip;0;2;0;2
12603;Viltenė;Triušiukai;9163535422;Ne;3;0;0;3
12604;Viltenė;Triušiukai;1280744308;Taip;6;0;0;6
12605;Viltenė;Triušiukai;2077492267;Taip;12;0;0;12
12606;Voveraitė;ŽVIRBLIUKŲ;6684234832;Taip;0;4;7;11
12607;Voveraitė;ŽVIRBLIUKŲ;8119493388;Taip;0;2;0;2
12608;Voveraitė;ŽVIRBLIUKŲ;9715405072;Taip;3;0;0;3
12609;Voveraitė;ŽVIRBLIUKŲ;5804351872;Taip;4;1;2;7
12610;Voveraitė;ŽVIRBLIUKŲ;8925151080;Taip;0;4;0;4
12611;Voveraitė;ŽVIRBLIUKŲ;5510544648;Taip;1;2;3;6
12612;Voveraitė;ŽVIRBLIUKŲ;6959751328;Taip;0;0;2;2
12613;Voveraitė;ŽVIRBLIUKŲ;8803052781;Taip;0;0;5;5
12614;Voveraitė;ŽVIRBLIUKŲ;8257748589;Taip;0;2;0;2
12615;Voveraitė;ŽVIRBLIUKŲ;1522307865;Taip;0;0;1;1
12616;Voveraitė;ŽVIRBLIUKŲ;3811230983;Taip;0;4;7;11
12617;Voveraitė;ŽVIRBLIUKŲ;2142507659;Taip;14;0;3;17
12618;Voveraitė;ŽVIRBLIUKŲ;3247101840;Taip;0;2;2;4
12619;Voveraitė;ŽVIRBLIUKŲ;6643600680;Taip;3;1;2;6
12620;Voveraitė;ŽVIRBLIUKŲ;4460047281;Taip;0;4;8;12
12621;Voveraitė;ŽVIRBLIUKŲ;3877673172;Taip;0;0;4;4
12622;Voveraitė;ŽVIRBLIUKŲ;7008576999;Taip;0;3;0;3
12623;Voveraitė;ŽVIRBLIUKŲ;2716400502;Taip;0;2;0;2
12624;Voveraitė;ŽVIRBLIUKŲ;6994680282;Taip;0;3;0;3
12625;Voveraitė;ŽVIRBLIUKŲ;5605614222;Taip;0;0;2;2
12626;Voveraitė;VOVERIUKŲ;5104290434;Taip;0;7;0;7
12627;Voveraitė;VOVERIUKŲ;3883413387;Taip;7;0;0;7
12628;Voveraitė;VOVERIUKŲ;6762558038;Taip;4;0;0;4
12629;Voveraitė;VOVERIUKŲ;2317744694;Taip;6;2;0;8
12630;Voveraitė;VOVERIUKŲ;5484809515;Taip;6;0;0;6
12631;Voveraitė;VOVERIUKŲ;7047943041;Taip;7;0;0;7
12632;Voveraitė;VOVERIUKŲ;9350363241;Taip;5;0;0;5
12633;Voveraitė;VOVERIUKŲ;1003244190;Taip;0;1;0;1
12634;Voveraitė;VOVERIUKŲ;1805322222;Taip;1;0;0;1
12635;Voveraitė;VOVERIUKŲ;6179702518;Taip;16;0;0;16
12636;Voveraitė;VOVERIUKŲ;2035456422;Taip;5;1;0;6
12637;Voveraitė;VOVERIUKŲ;8936261148;Taip;6;0;0;6
12638;Voveraitė;KIŠKUČIŲ;9537862791;Taip;16;0;0;16
12639;Voveraitė;KIŠKUČIŲ;4478984171;Taip;0;4;0;4
12640;Voveraitė;KIŠKUČIŲ;3736638759;Taip;5;2;0;7
12641;Voveraitė;KIŠKUČIŲ;9011096222;Taip;10;2;0;12
12642;Voveraitė;KIŠKUČIŲ;3058377539;Taip;0;1;0;1
12643;Voveraitė;KIŠKUČIŲ;8507818993;Taip;0;1;0;1
12644;Voveraitė;KIŠKUČIŲ;8084986328;Taip;0;2;0;2
12645;Voveraitė;KIŠKUČIŲ;6261152304;Taip;0;5;0;5
12646;Voveraitė;KIŠKUČIŲ;4060906360;Taip;0;4;0;4
12647;Voveraitė;KIŠKUČIŲ;5069929376;Taip;2;0;0;2
12648;Voveraitė;KIŠKUČIŲ;7379045686;Taip;0;3;0;3
12649;Voveraitė;KIŠKUČIŲ;1961699588;Taip;5;0;0;5
12650;Voveraitė;KIŠKUČIŲ;1979839656;Taip;4;0;0;4
12651;Voveraitė;KIŠKUČIŲ;8121423914;Taip;5;1;0;6
12652;Voveraitė;KIŠKUČIŲ;8528435385;Taip;2;1;0;3
12653;Voveraitė;KIŠKUČIŲ;8937070276;Taip;10;1;0;11
12654;Voveraitė;KIŠKUČIŲ;3859125174;Taip;0;5;0;5
12655;Voveraitė;KIŠKUČIŲ;4234600509;Taip;5;4;0;9
12656;Voveraitė;KODĖLČIUKŲ;3274422598;Taip;0;3;1;4
12657;Voveraitė;KODĖLČIUKŲ;8438808999;Taip;6;1;0;7
12658;Voveraitė;KODĖLČIUKŲ;8818603905;Taip;15;0;1;16
12659;Voveraitė;KODĖLČIUKŲ;9397887760;Taip;5;2;0;7
12660;Voveraitė;KODĖLČIUKŲ;4151144278;Taip;3;0;0;3
12661;Voveraitė;KODĖLČIUKŲ;5598685365;Taip;10;6;0;16
12662;Voveraitė;KODĖLČIUKŲ;1482908802;Taip;5;0;0;5
12663;Voveraitė;KODĖLČIUKŲ;9887747925;Taip;6;0;0;6
12664;Voveraitė;KODĖLČIUKŲ;7605427741;Taip;7;4;0;11
12665;Voveraitė;KODĖLČIUKŲ;1046297151;Taip;1;4;0;5
12666;Voveraitė;KODĖLČIUKŲ;4996778855;Taip;1;4;0;5
12667;Voveraitė;KODĖLČIUKŲ;3432886020;Taip;14;2;0;16
12668;Voveraitė;KODĖLČIUKŲ;8154347030;Taip;0;15;0;15
12669;Voveraitė;KODĖLČIUKŲ;2482908027;Taip;0;8;0;8
12670;Voveraitė;KODĖLČIUKŲ;8692155848;Taip;0;13;0;13
12671;Voveraitė;KODĖLČIUKŲ;1040007977;Taip;0;2;0;2
12672;Voveraitė;KODĖLČIUKŲ;3881039538;Taip;0;2;0;2
12673;Voveraitė;KODĖLČIUKŲ;7281753415;Taip;0;2;0;2
12674;Voveraitė;KODĖLČIUKŲ;8021563060;Taip;7;5;2;14
12675;Voveraitė;KODĖLČIUKŲ;9816971493;Taip;0;5;0;5
12676;Voveraitė;MEŠKIUKŲ;8881070477;Taip;0;5;0;5
12677;Voveraitė;MEŠKIUKŲ;7253112849;Taip;10;1;0;11
12678;Voveraitė;MEŠKIUKŲ;7499150201;Taip;4;1;0;5
12679;Voveraitė;MEŠKIUKŲ;3217609712;Taip;4;6;0;10
12680;Voveraitė;MEŠKIUKŲ;3088866739;Taip;5;3;0;8
12681;Voveraitė;MEŠKIUKŲ;4207949414;Taip;5;2;0;7
12682;Voveraitė;MEŠKIUKŲ;7474214701;Taip;0;8;0;8
12683;Voveraitė;MEŠKIUKŲ;9729735431;Taip;0;2;0;2
12684;Voveraitė;MEŠKIUKŲ;6853358062;Taip;5;0;0;5
12685;Voveraitė;MEŠKIUKŲ;6609235703;Taip;5;0;0;5
12686;Voveraitė;MEŠKIUKŲ;1528968162;Taip;10;1;0;11
12687;Voveraitė;MEŠKIUKŲ;3159659638;Taip;11;1;0;12
12688;Voveraitė;MEŠKIUKŲ;3532178114;Taip;11;1;0;12
12689;Voveraitė;MEŠKIUKŲ;8534405352;Taip;12;0;0;12
12690;Voveraitė;MEŠKIUKŲ;5018335921;Taip;18;1;0;19
12691;Voveraitė;MEŠKIUKŲ;6579193196;Taip;9;1;0;10
12692;Voveraitė;MEŠKIUKŲ;8940421826;Taip;0;7;0;7
12693;Voveraitė;MEŠKIUKŲ;9332936763;Taip;2;0;0;2
12694;Voveraitė;MEŠKIUKŲ;6206817227;Taip;5;2;0;7
12695;Voveraitė;BORUŽĖLIŲ;7969862374;Taip;4;0;0;4
12696;Voveraitė;BORUŽĖLIŲ;4233627593;Taip;3;0;0;3
12697;Voveraitė;BORUŽĖLIŲ;2446269570;Taip;14;1;0;15
12698;Voveraitė;BORUŽĖLIŲ;1542869765;Taip;0;0;2;2
12699;Voveraitė;BORUŽĖLIŲ;3408126903;Taip;7;0;0;7
12700;Voveraitė;BORUŽĖLIŲ;8675606844;Taip;11;4;0;15
12701;Voveraitė;BORUŽĖLIŲ;8627692360;Taip;6;0;0;6
12702;Voveraitė;BORUŽĖLIŲ;3168493145;Taip;5;1;2;8
12703;Voveraitė;BORUŽĖLIŲ;7776716092;Taip;5;0;0;5
12704;Voveraitė;BORUŽĖLIŲ;8693704363;Taip;13;0;0;13
12705;Voveraitė;BORUŽĖLIŲ;7718303218;Taip;3;0;0;3
12706;Voveraitė;BORUŽĖLIŲ;9218074631;Taip;14;0;0;14
12707;Voveraitė;BORUŽĖLIŲ;6443288864;Taip;6;0;0;6
12708;Voveraitė;BORUŽĖLIŲ;2552772063;Ne;0;1;0;1
12709;Voveraitė;BORUŽĖLIŲ;1921260351;Taip;21;0;0;21
12710;Voveraitė;BORUŽĖLIŲ;8695525951;Taip;9;0;1;10
12711;Voveraitė;BORUŽĖLIŲ;6650343917;Taip;12;0;0;12
12712;Voveraitė;BORUŽĖLIŲ;3452040361;Taip;6;1;0;7
12713;Voveraitė;BORUŽĖLIŲ;8382950248;Taip;0;2;0;2
12714;Voveraitė;PELĖDŽIUKŲ;7984755636;Taip;8;0;0;8
12715;Voveraitė;PELĖDŽIUKŲ;8705616608;Taip;9;0;0;9
12716;Voveraitė;PELĖDŽIUKŲ;2028714618;Taip;7;0;0;7
12717;Voveraitė;PELĖDŽIUKŲ;5415791380;Taip;5;0;0;5
12718;Voveraitė;PELĖDŽIUKŲ;2915226148;Taip;0;4;0;4
12719;Voveraitė;PELĖDŽIUKŲ;8252478186;Taip;0;23;0;23
12720;Voveraitė;PELĖDŽIUKŲ;1971097565;Taip;6;0;0;6
12721;Voveraitė;PELĖDŽIUKŲ;2724402352;Taip;7;0;0;7
12722;Voveraitė;PELĖDŽIUKŲ;1063298119;Taip;11;0;0;11
12723;Voveraitė;PELĖDŽIUKŲ;1877131292;Taip;8;0;0;8
12724;Voveraitė;PELĖDŽIUKŲ;9074318124;Taip;10;0;0;10
12725;Voveraitė;PELĖDŽIUKŲ;6666893294;Taip;5;0;1;6
12726;Voveraitė;PELĖDŽIUKŲ;5918809105;Taip;6;0;0;6
12727;Voveraitė;PELĖDŽIUKŲ;9130691819;Taip;14;0;0;14
12728;Voveraitė;PELĖDŽIUKŲ;8126894347;Taip;13;0;0;13
12729;Voveraitė;PELĖDŽIUKŲ;2761041681;Taip;3;0;0;3
12730;Voveraitė;DRUGELIŲ;1441921029;Taip;0;1;0;1
12731;Voveraitė;DRUGELIŲ;7531020548;Taip;6;4;0;10
12732;Voveraitė;DRUGELIŲ;4300235743;Taip;9;0;0;9
12733;Voveraitė;DRUGELIŲ;1510853268;Taip;0;6;0;6
12734;Voveraitė;DRUGELIŲ;3388547792;Taip;0;4;0;4
12735;Voveraitė;DRUGELIŲ;8719547570;Taip;12;0;0;12
12736;Voveraitė;DRUGELIŲ;3475601049;Taip;5;0;1;6
12737;Voveraitė;DRUGELIŲ;4017408873;Taip;0;0;6;6
12738;Voveraitė;DRUGELIŲ;7533728486;Taip;5;2;0;7
12739;Voveraitė;DRUGELIŲ;1550830434;Taip;0;5;0;5
12740;Voveraitė;DRUGELIŲ;5114768009;Taip;5;5;0;10
12741;Voveraitė;DRUGELIŲ;1045204378;Taip;4;0;0;4
12742;Voveraitė;DRUGELIŲ;4605007814;Taip;3;0;0;3
12743;Voveraitė;DRUGELIŲ;4911291891;Taip;7;5;0;12
12744;Voveraitė;DRUGELIŲ;4782336282;Taip;4;3;0;7
12745;Voveraitė;DRUGELIŲ;6415024059;Taip;1;10;1;12
12746;Voveraitė;DRUGELIŲ;4350450125;Taip;1;10;0;11
12747;Voveraitė;DRUGELIŲ;8913940646;Taip;4;0;0;4
12748;Voveraitė;DRUGELIŲ;1201270622;Taip;3;2;0;5
12749;Voveraitė;DRUGELIŲ;7238482039;Taip;13;0;0;13
12750;Voveraitė;DRUGELIŲ;4961315260;Taip;7;4;2;13
12751;Voveraitė;DRUGELIŲ;8939638368;Taip;7;4;2;13
12752;Voveraitė;NYKŠTUKŲ;3068683904;Taip;9;0;0;9
12753;Voveraitė;NYKŠTUKŲ;3600230896;Taip;0;0;1;1
12754;Voveraitė;NYKŠTUKŲ;1294012085;Ne;5;9;0;14
12755;Voveraitė;NYKŠTUKŲ;9363490578;Taip;8;6;0;14
12756;Voveraitė;NYKŠTUKŲ;8217771158;Taip;0;2;0;2
12757;Voveraitė;NYKŠTUKŲ;3409709168;Taip;5;3;1;9
12758;Voveraitė;NYKŠTUKŲ;1045121363;Taip;10;0;0;10
12759;Voveraitė;NYKŠTUKŲ;4319786615;Taip;3;0;0;3
12760;Voveraitė;NYKŠTUKŲ;1384430452;Taip;7;0;3;10
12761;Voveraitė;NYKŠTUKŲ;6648733729;Taip;12;3;0;15
12762;Voveraitė;NYKŠTUKŲ;2801245150;Taip;2;0;0;2
12763;Voveraitė;NYKŠTUKŲ;2839442228;Taip;0;0;1;1
12764;Voveraitė;NYKŠTUKŲ;5887384991;Ne;13;0;0;13
12765;Voveraitė;NYKŠTUKŲ;1647496426;Taip;2;0;0;2
12766;Voveraitė;NYKŠTUKŲ;3627796093;Taip;4;9;0;13
12767;Voveraitė;NYKŠTUKŲ;4329107736;Taip;7;0;2;9
12768;Voveraitė;GENIUKŲ;8697761112;Taip;7;0;0;7
12769;Voveraitė;GENIUKŲ;6007396459;Taip;0;1;3;4
12770;Voveraitė;GENIUKŲ;9514425475;Taip;7;3;0;10
12771;Voveraitė;GENIUKŲ;1663784931;Taip;6;0;0;6
12772;Voveraitė;GENIUKŲ;8373093305;Taip;3;1;0;4
12773;Voveraitė;GENIUKŲ;4054841724;Taip;0;1;0;1
12774;Voveraitė;GENIUKŲ;4563198733;Taip;0;5;0;5
12775;Voveraitė;GENIUKŲ;1141304286;Taip;3;4;0;7
12776;Voveraitė;GENIUKŲ;6891841301;Taip;6;0;0;6
12777;Voveraitė;GENIUKŲ;6017698476;Taip;5;2;0;7
12778;Voveraitė;GENIUKŲ;8344323109;Taip;6;4;0;10
12779;Voveraitė;GENIUKŲ;2594535017;Taip;0;1;0;1
12780;Voveraitė;GENIUKŲ;5956830012;Taip;0;11;0;11
12781;Voveraitė;GENIUKŲ;1960385335;Taip;7;0;0;7
12782;Voveraitė;GENIUKŲ;9912862474;Taip;0;1;0;1
12783;Voveraitė;GENIUKŲ;1340379090;Taip;0;4;0;4
12784;Voveraitė;GENIUKŲ;5935777154;Taip;6;0;0;6
12785;Voveraitė;GENIUKŲ;5138855000;Taip;0;0;1;1
12786;Voveraitė;GENIUKŲ;6113913885;Ne;0;4;0;4
12787;Voveraitė;GENIUKŲ;9195700962;Taip;7;4;0;11
12788;Voveraitė;GENIUKŲ;1515087924;Taip;9;0;2;11
12789;Voveraitė;LAPIUKŲ;8405238812;Taip;4;0;0;4
12790;Voveraitė;LAPIUKŲ;8152541593;Taip;16;0;1;17
12791;Voveraitė;LAPIUKŲ;9327593792;Taip;19;0;0;19
12792;Voveraitė;LAPIUKŲ;4139239328;Taip;19;0;0;19
12793;Voveraitė;LAPIUKŲ;4689191326;Taip;7;0;0;7
12794;Voveraitė;LAPIUKŲ;7131189895;Taip;4;0;0;4
12795;Voveraitė;LAPIUKŲ;6766131083;Taip;18;0;1;19
12796;Voveraitė;LAPIUKŲ;4760054428;Taip;14;0;0;14
12797;Voveraitė;LAPIUKŲ;4848321265;Taip;17;0;3;20
12798;Voveraitė;LAPIUKŲ;3419973673;Taip;9;0;0;9
12799;Voveraitė;LAPIUKŲ;4402971359;Taip;4;0;0;4
12800;Voveraitė;LAPIUKŲ;1328831240;Taip;9;0;4;13
12801;Voveraitė;LAPIUKŲ;3955549715;Taip;0;4;2;6
12802;Voveraitė;LAPIUKŲ;8382465808;Taip;7;11;0;18
12803;Voveraitė;EŽIUKŲ;5420123208;Taip;1;2;0;3
12804;Voveraitė;EŽIUKŲ;1692829228;Taip;6;0;0;6
12805;Voveraitė;EŽIUKŲ;8074808131;Taip;4;0;0;4
12806;Voveraitė;EŽIUKŲ;8229145014;Ne;8;0;0;8
12807;Voveraitė;EŽIUKŲ;2755043670;Taip;8;4;0;12
12808;Voveraitė;EŽIUKŲ;6481289149;Taip;11;0;1;12
12809;Voveraitė;EŽIUKŲ;7227349394;Taip;2;0;4;6
12810;Voveraitė;EŽIUKŲ;8663564002;Taip;2;0;0;2
12811;Voveraitė;EŽIUKŲ;3598956934;Taip;12;8;0;20
12812;Voveraitė;EŽIUKŲ;5439761018;Taip;8;0;0;8
12813;Voveraitė;EŽIUKŲ;2064720751;Taip;14;3;0;17
12814;Voveraitė;EŽIUKŲ;4913232575;Taip;3;5;0;8
12815;Voveraitė;EŽIUKŲ;9859868228;Taip;15;0;0;15
12816;"Trakų Vokė";Voveriukų;1252962923;Taip;0;0;1;1
12817;"Trakų Vokė";Voveriukų;2163756512;Taip;2;0;0;2
12818;"Trakų Vokė";Voveriukų;2318712376;Taip;5;0;1;6
12819;"Trakų Vokė";Voveriukų;9140597911;Taip;12;0;1;13
12820;"Trakų Vokė";Voveriukų;5741852704;Taip;6;0;2;8
12821;"Trakų Vokė";Voveriukų;8636196544;Taip;0;1;0;1
12822;"Trakų Vokė";Voveriukų;4516714702;Taip;10;0;0;10
12823;"Trakų Vokė";Voveriukų;3445611475;Taip;4;0;0;4
12824;"Trakų Vokė";Voveriukų;3422308444;Taip;10;0;0;10
12825;"Trakų Vokė";Voveriukų;6076083379;Taip;3;0;0;3
12826;"Trakų Vokė";Voveriukų;5626732539;Taip;0;7;0;7
12827;"Trakų Vokė";Voveriukų;7706665420;Taip;8;0;2;10
12828;"Trakų Vokė";Voveriukų;7656305410;Taip;7;1;0;8
12829;"Trakų Vokė";Voveriukų;7346128036;Taip;0;7;4;11
12830;"Trakų Vokė";Voveriukų;2812442474;Taip;5;0;0;5
12831;"Trakų Vokė";Voveriukų;7671121106;Taip;0;4;4;8
12832;"Trakų Vokė";Voveriukų;7797516793;Taip;2;0;0;2
12833;"Trakų Vokė";Voveriukų;2077669020;Taip;10;0;0;10
12834;"Trakų Vokė";Voveriukų;8938061997;Taip;10;0;0;10
12835;"Trakų Vokė";Voveriukų;1946140073;Taip;17;0;0;17
12836;"Trakų Vokė";Voveriukų;6494156059;Taip;2;3;0;5
12837;"Trakų Vokė";Voveriukų;6247495021;Taip;11;2;0;13
12838;"Trakų Vokė";Voveriukų;3471649998;Taip;23;0;0;23
12839;"Trakų Vokė";Boružėlių;6550998156;Taip;14;0;0;14
12840;"Trakų Vokė";Boružėlių;7705116536;Taip;5;0;0;5
12841;"Trakų Vokė";Boružėlių;4300812649;Taip;6;0;1;7
12842;"Trakų Vokė";Boružėlių;6495211591;Taip;13;0;2;15
12843;"Trakų Vokė";Boružėlių;2141759752;Taip;4;0;1;5
12844;"Trakų Vokė";Boružėlių;4621824988;Taip;10;0;1;11
12845;"Trakų Vokė";Boružėlių;7122970239;Taip;4;0;2;6
12846;"Trakų Vokė";Boružėlių;1798327247;Taip;0;0;2;2
12847;"Trakų Vokė";Boružėlių;6004005405;Taip;3;0;3;6
12848;"Trakų Vokė";Boružėlių;3930137078;Taip;1;0;0;1
12849;"Trakų Vokė";Boružėlių;1515075178;Taip;2;0;0;2
12850;"Trakų Vokė";Boružėlių;4377392002;Taip;17;0;0;17
12851;"Trakų Vokė";Boružėlių;3733223248;Taip;5;0;0;5
12852;"Trakų Vokė";Boružėlių;7778039165;Taip;11;0;0;11
12853;"Trakų Vokė";Boružėlių;9334999599;Taip;0;1;0;1
12854;"Trakų Vokė";Boružėlių;7933901042;Taip;8;0;0;8
12855;"Trakų Vokė";Boružėlių;7042434004;Taip;23;0;0;23
12856;"Trakų Vokė";KIŠKUČIŲ;2348524235;Taip;9;0;0;9
12857;"Trakų Vokė";KIŠKUČIŲ;6916284436;Taip;6;0;0;6
12858;"Trakų Vokė";KIŠKUČIŲ;2027461389;Taip;8;0;0;8
12859;"Trakų Vokė";KIŠKUČIŲ;8148859043;Taip;17;0;0;17
12860;"Trakų Vokė";KIŠKUČIŲ;9375730686;Taip;19;0;0;19
12861;"Trakų Vokė";KIŠKUČIŲ;2327739950;Taip;17;0;0;17
12862;"Trakų Vokė";KIŠKUČIŲ;4138226032;Taip;23;0;0;23
12863;"Trakų Vokė";KIŠKUČIŲ;1436135794;Taip;12;0;0;12
12864;"Trakų Vokė";KIŠKUČIŲ;3233117814;Taip;8;0;0;8
12865;"Trakų Vokė";KIŠKUČIŲ;3146611814;Taip;5;1;0;6
12866;"Trakų Vokė";KIŠKUČIŲ;8601290001;Taip;16;1;0;17
12867;"Trakų Vokė";KIŠKUČIŲ;1941250346;Taip;9;0;0;9
12868;"Trakų Vokė";KIŠKUČIŲ;4832898751;Taip;0;1;0;1
12869;"Trakų Vokė";KIŠKUČIŲ;8861279937;Taip;12;0;0;12
12870;"Trakų Vokė";KIŠKUČIŲ;8747275362;Taip;2;0;0;2
12871;"Trakų Vokė";KIŠKUČIŲ;7799307934;Taip;5;0;0;5
12872;"Trakų Vokė";BITUČIŲ;3686108421;Taip;5;0;0;5
12873;"Trakų Vokė";BITUČIŲ;5031669549;Taip;1;4;0;5
12874;"Trakų Vokė";BITUČIŲ;8703806519;Taip;20;0;0;20
12875;"Trakų Vokė";BITUČIŲ;4531294784;Taip;2;0;0;2
12876;"Trakų Vokė";BITUČIŲ;5720994041;Taip;5;0;0;5
12877;"Trakų Vokė";BITUČIŲ;7459132887;Taip;1;12;0;13
12878;"Trakų Vokė";BITUČIŲ;6402002961;Taip;5;0;0;5
12879;"Trakų Vokė";BITUČIŲ;3536227018;Taip;4;0;0;4
12880;"Trakų Vokė";BITUČIŲ;6787506848;Taip;3;10;0;13
12881;"Trakų Vokė";BITUČIŲ;1359519176;Taip;4;0;0;4
12882;"Trakų Vokė";BITUČIŲ;1039317931;Taip;14;0;0;14
12883;"Trakų Vokė";BITUČIŲ;3333979364;Taip;7;0;0;7
12884;"Trakų Vokė";BITUČIŲ;3023545645;Taip;0;1;0;1
12885;"Trakų Vokė";BITUČIŲ;1000323267;Taip;2;0;0;2
12886;"Trakų Vokė";BITUČIŲ;8496627262;Taip;22;0;0;22
12887;"Trakų Vokė";BITUČIŲ;1389577176;Taip;1;0;0;1
12888;Zylutė;Katerok;8749296671;Taip;8;4;0;12
12889;Zylutė;Katerok;4592825972;Taip;7;1;0;8
12890;Zylutė;Katerok;8747721198;Taip;10;4;0;14
12891;Zylutė;Katerok;8212030518;Taip;0;4;0;4
12892;Zylutė;Katerok;7706833089;Taip;0;6;0;6
12893;Zylutė;Katerok;3115223229;Taip;5;0;0;5
12894;Zylutė;Katerok;2968625045;Taip;3;0;0;3
12895;Zylutė;Katerok;5687201052;Taip;10;0;0;10
12896;Zylutė;Katerok;2792217953;Taip;6;1;0;7
12897;Zylutė;Katerok;5948147748;Taip;0;1;0;1
12898;Zylutė;Katerok;7851423851;Taip;6;1;0;7
12899;Zylutė;Katerok;1423890598;Taip;5;0;0;5
12900;Zylutė;Katerok;8268700439;Taip;4;5;2;11
12901;Zylutė;Katerok;4494567155;Taip;9;5;0;14
12902;Zylutė;Katerok;8618778936;Taip;0;2;0;2
12903;Zylutė;"Vesole misiaki";9162232979;Taip;0;1;0;1
12904;Zylutė;"Vesole misiaki";9737308076;Taip;7;8;0;15
12905;Zylutė;"Vesole misiaki";5589330186;Taip;6;3;0;9
12906;Zylutė;"Vesole misiaki";3848401615;Taip;13;1;0;14
12907;Zylutė;"Vesole misiaki";2913504349;Taip;0;2;0;2
12908;Zylutė;"Vesole misiaki";2501761963;Taip;0;5;0;5
12909;Zylutė;"Vesole misiaki";3976277394;Ne;0;6;0;6
12910;Zylutė;"Vesole misiaki";2489898107;Taip;0;6;0;6
12911;Zylutė;"Vesole misiaki";2313423907;Taip;4;3;0;7
12912;Zylutė;"Vesole misiaki";8121814945;Taip;6;0;0;6
12913;Zylutė;"Vesole misiaki";9159342804;Taip;5;1;0;6
12914;Zylutė;"Vesole misiaki";2201317313;Taip;9;2;0;11
12915;Zylutė;"Vesole misiaki";9018673580;Taip;5;2;0;7
12916;Zylutė;"Vesole misiaki";5369354390;Taip;19;3;0;22
12917;Zylutė;"Vesole misiaki";8023418946;Taip;9;4;0;13
12918;Zylutė;"Vesole misiaki";9507157625;Taip;12;0;0;12
12919;Zylutė;"Vesole misiaki";2484025931;Taip;0;8;0;8
12920;Zylutė;NYKŠTUKAI;1169490002;Taip;15;1;0;16
12921;Zylutė;NYKŠTUKAI;4894611078;Taip;2;0;1;3
12922;Zylutė;NYKŠTUKAI;7648922403;Ne;5;0;0;5
12923;Zylutė;NYKŠTUKAI;2113594059;Taip;8;8;0;16
12924;Zylutė;NYKŠTUKAI;9615779237;Taip;7;1;0;8
12925;Zylutė;NYKŠTUKAI;2604844156;Taip;6;4;0;10
12926;Zylutė;NYKŠTUKAI;2511658462;Ne;10;0;0;10
12927;Zylutė;NYKŠTUKAI;3035745273;Taip;6;1;1;8
12928;Zylutė;NYKŠTUKAI;2620903587;Ne;19;0;0;19
12929;Zylutė;NYKŠTUKAI;4706933533;Taip;4;0;0;4
12930;Zylutė;NYKŠTUKAI;4491529018;Taip;10;0;1;11
12931;Zylutė;NYKŠTUKAI;2745905798;Taip;9;0;1;10
12932;Zylutė;NYKŠTUKAI;5975875502;Ne;22;0;0;22
12933;Zylutė;NYKŠTUKAI;9107676840;Taip;0;0;4;4
12934;Zylutė;NYKŠTUKAI;4840138765;Taip;5;0;1;6
12935;Zylutė;NYKŠTUKAI;9221414691;Taip;18;0;0;18
12936;Zylutė;NYKŠTUKAI;7433615959;Ne;4;4;0;8
12937;Zylutė;Ručijok;5096881585;Ne;8;4;2;14
12938;Zylutė;Ručijok;9904758615;Taip;1;0;1;2
12939;Zylutė;Ručijok;4874246039;Taip;0;5;0;5
12940;Zylutė;Ručijok;3274885318;Taip;0;0;5;5
12941;Zylutė;Ručijok;6607670962;Taip;10;0;2;12
12942;Zylutė;Ručijok;2769424439;Taip;7;5;0;12
12943;Zylutė;Ručijok;1145229045;Taip;6;0;0;6
12944;Zylutė;Ručijok;3058040516;Taip;4;4;0;8
12945;Zylutė;Ručijok;5038936878;Taip;14;0;2;16
12946;Zylutė;Ručijok;2491905840;Taip;2;0;0;2
12947;Zylutė;Ručijok;5956114459;Taip;23;0;0;23
12948;Zylutė;Ručijok;6276017610;Taip;8;9;0;17
12949;Zylutė;Ručijok;3128535871;Taip;7;4;1;12
12950;Zylutė;Ručijok;6281989117;Taip;10;3;0;13
12951;Zylutė;Ručijok;2505224609;Taip;7;0;1;8
12952;Zylutė;Ručijok;7519900933;Ne;0;0;1;1
12953;Zylutė;Ručijok;3573761619;Taip;9;4;0;13
12954;Zylutė;Ručijok;7742044835;Taip;3;6;0;9
12955;Zylutė;Raduga;2916622808;Taip;20;0;0;20
12956;Zylutė;Raduga;2527003662;Taip;23;0;0;23
12957;Zylutė;Raduga;3977730349;Taip;13;0;1;14
12958;Zylutė;Raduga;7911418657;Taip;17;0;0;17
12959;Zylutė;Raduga;5650984730;Taip;9;0;1;10
12960;Zylutė;Raduga;6422018564;Taip;10;0;1;11
12961;Zylutė;Raduga;5019654510;Taip;13;0;0;13
12962;Zylutė;Raduga;2826889413;Taip;15;0;1;16
12963;Zylutė;Raduga;1935817272;Taip;6;0;0;6
12964;Zylutė;Raduga;9584717697;Ne;13;2;0;15
12965;Zylutė;Raduga;8448343323;Taip;10;0;0;10
12966;Zylutė;Raduga;1108316842;Ne;6;0;0;6
12967;Zylutė;Raduga;4801678066;Taip;13;0;0;13
12968;Zylutė;"Miki Maus";7762245887;Taip;9;4;0;13
12969;Zylutė;"Miki Maus";9213491152;Taip;5;1;0;6
12970;Zylutė;"Miki Maus";3928932787;Taip;0;14;0;14
12971;Zylutė;"Miki Maus";4057419108;Taip;5;0;0;5
12972;Zylutė;"Miki Maus";3668160578;Taip;0;9;0;9
12973;Zylutė;"Miki Maus";9093777086;Taip;0;6;0;6
12974;Zylutė;"Miki Maus";7123399601;Ne;0;4;0;4
12975;Zylutė;"Miki Maus";9951774752;Taip;3;4;0;7
12976;Zylutė;"Miki Maus";7625237309;Taip;8;0;0;8
12977;Zylutė;"Miki Maus";8291414891;Taip;9;0;1;10
12978;Zylutė;"Miki Maus";8230673446;Ne;11;2;0;13
12979;Zylutė;"Miki Maus";6876326785;Taip;4;2;0;6
12980;Zylutė;"Miki Maus";6389666593;Taip;7;0;0;7
12981;Zylutė;Solnyško;8379932761;Taip;14;0;0;14
12982;Zylutė;Solnyško;5556769710;Taip;5;0;0;5
12983;Zylutė;Solnyško;2088316489;Taip;0;11;0;11
12984;Zylutė;Solnyško;1076803315;Taip;0;2;0;2
12985;Zylutė;Solnyško;7616444695;Taip;9;1;0;10
12986;Zylutė;Solnyško;5234846079;Taip;8;0;0;8
12987;Zylutė;Solnyško;5939522435;Taip;0;7;0;7
12988;Zylutė;Solnyško;5826813410;Taip;0;8;0;8
12989;Zylutė;Solnyško;8033573972;Ne;0;10;0;10
12990;Zylutė;Solnyško;7447067072;Taip;2;0;0;2
12991;Zylutė;Solnyško;1386683435;Taip;5;0;0;5
12992;Zylutė;Solnyško;1969578486;Taip;5;2;0;7
12993;Zylutė;Solnyško;6573541087;Taip;12;0;0;12
12994;Zylutė;Solnyško;2520744071;Taip;9;1;2;12
12995;Zylutė;Solnyško;3201966434;Taip;6;0;0;6
12996;Zylutė;Solnyško;3656587423;Taip;4;0;0;4
12997;Zylutė;Solnyško;5011947014;Taip;0;1;0;1
12998;Zylutė;Solnyško;4474338590;Taip;0;0;1;1
12999;Zylutė;Solnyško;4474338590;Taip;0;0;1;1
13000;Zylutė;Motyliok;7241045507;Taip;7;0;1;8
13001;Zylutė;Motyliok;9913001904;Ne;0;4;0;4
13002;Zylutė;Motyliok;6112586092;Taip;0;10;0;10
13003;Zylutė;Motyliok;8178488164;Taip;7;0;1;8
13004;Zylutė;Motyliok;5045652581;Taip;12;4;0;16
13005;Zylutė;Motyliok;9586800176;Taip;3;2;0;5
13006;Zylutė;Motyliok;4497904128;Taip;0;6;0;6
13007;Zylutė;Motyliok;3355159275;Taip;10;0;0;10
13008;Zylutė;Motyliok;9995791665;Taip;13;6;0;19
13009;Zylutė;Motyliok;1455822427;Taip;4;0;0;4
13010;Zylutė;Motyliok;3455374127;Taip;0;8;0;8
13011;Zylutė;Motyliok;1632490481;Taip;16;5;0;21
13012;Zylutė;Motyliok;1726060015;Ne;5;0;0;5
13013;Zylutė;Motyliok;3084870481;Taip;13;0;0;13
13014;Zylutė;Motyliok;6051657134;Taip;8;0;0;8
13015;Zylutė;Motyliok;3271366684;Taip;7;0;0;7
13016;Zylutė;Motyliok;3633983359;Taip;16;0;0;16
13017;Zylutė;Motyliok;9155513221;Ne;4;4;0;8
13018;Zylutė;Motyliok;8262929231;Taip;8;0;0;8
13019;Zylutė;Motyliok;6778361006;Ne;11;0;0;11
13020;Zylutė;ŽVIRBLIUKAI;1319040747;Taip;4;4;4;12
13021;Zylutė;ŽVIRBLIUKAI;8326987895;Taip;0;11;0;11
13022;Zylutė;ŽVIRBLIUKAI;9330583784;Taip;0;4;0;4
13023;Zylutė;ŽVIRBLIUKAI;1220439948;Taip;5;9;0;14
13024;Zylutė;ŽVIRBLIUKAI;4646273830;Ne;0;0;1;1
13025;Zylutė;ŽVIRBLIUKAI;9580188426;Ne;2;0;0;2
13026;Zylutė;ŽVIRBLIUKAI;1797701777;Taip;0;4;0;4
13027;Zylutė;ŽVIRBLIUKAI;2966482773;Taip;0;12;0;12
13028;Zylutė;ŽVIRBLIUKAI;1452384017;Ne;10;0;0;10
13029;Zylutė;ŽVIRBLIUKAI;8152140523;Taip;4;4;0;8
13030;Zylutė;ŽVIRBLIUKAI;8346794629;Taip;2;0;0;2
13031;Zylutė;ŽVIRBLIUKAI;2061747513;Taip;0;0;4;4
13032;Zylutė;ŽVIRBLIUKAI;4611555689;Taip;0;6;0;6
13033;Zylutė;ŽVIRBLIUKAI;3894885445;Taip;0;6;0;6
13034;Zylutė;ŽVIRBLIUKAI;3371202491;Taip;0;0;23;23
13035;Zylutė;ŽVIRBLIUKAI;7137348151;Taip;0;3;1;4
13036;Zylutė;ŽVIRBLIUKAI;3556698363;Taip;0;1;0;1
13037;Zylutė;"DRUŽNYJE REBIATA";5332039406;Taip;10;9;0;19
13038;Zylutė;"DRUŽNYJE REBIATA";9039665233;Taip;2;0;0;2
13039;Zylutė;"DRUŽNYJE REBIATA";6075614020;Taip;0;8;0;8
13040;Zylutė;"DRUŽNYJE REBIATA";9518714240;Taip;0;5;0;5
13041;Zylutė;"DRUŽNYJE REBIATA";2693961315;Taip;8;0;0;8
13042;Zylutė;"DRUŽNYJE REBIATA";4916625058;Taip;5;0;0;5
13043;Zylutė;"DRUŽNYJE REBIATA";3447644735;Taip;0;10;0;10
13044;Zylutė;"DRUŽNYJE REBIATA";3174042441;Taip;0;4;0;4
13045;Zylutė;"DRUŽNYJE REBIATA";6848387941;Taip;4;4;0;8
13046;Zylutė;"DRUŽNYJE REBIATA";1404949829;Taip;9;4;0;13
13047;Zylutė;"DRUŽNYJE REBIATA";4548205666;Taip;0;2;0;2
13048;Zylutė;"DRUŽNYJE REBIATA";6962852787;Taip;0;2;0;2
13049;Zylutė;"DRUŽNYJE REBIATA";9220918504;Taip;0;2;0;2
13050;Zylutė;"DRUŽNYJE REBIATA";9193349264;Taip;9;0;0;9
13051;Zylutė;"DRUŽNYJE REBIATA";2444440430;Taip;4;0;0;4
13052;Zylutė;"DRUŽNYJE REBIATA";8204885376;Taip;1;4;0;5
13053;Zylutė;"DRUŽNYJE REBIATA";8130859512;Taip;6;0;0;6
13054;Zylutė;"DRUŽNYJE REBIATA";9769201088;Ne;5;5;0;10
13055;Zylutė;"DRUŽNYJE REBIATA";5233163416;Taip;0;4;0;4
13056;Zylutė;"DRUŽNYJE REBIATA";5126282685;Taip;9;1;0;10
13057;Zylutė;"DRUŽNYJE REBIATA";8820121776;Taip;6;0;0;6
13058;Zylutė;VIEVERSĖLIAI;9748604675;Taip;17;0;0;17
13059;Zylutė;VIEVERSĖLIAI;9372402025;Taip;10;0;0;10
13060;Zylutė;VIEVERSĖLIAI;6540140502;Taip;23;0;0;23
13061;Zylutė;VIEVERSĖLIAI;5058082347;Taip;9;2;0;11
13062;Zylutė;VIEVERSĖLIAI;6311805184;Taip;1;0;0;1
13063;Zylutė;VIEVERSĖLIAI;7072947464;Taip;7;0;0;7
13064;Zylutė;VIEVERSĖLIAI;3449678598;Taip;7;0;0;7
13065;Zylutė;VIEVERSĖLIAI;1271913393;Taip;9;0;0;9
13066;Zylutė;VIEVERSĖLIAI;7070131037;Taip;5;0;0;5
13067;Zylutė;VIEVERSĖLIAI;1501573278;Taip;21;0;0;21
13068;Zylutė;VIEVERSĖLIAI;3787829836;Taip;5;0;0;5
13069;Zylutė;VIEVERSĖLIAI;5125900173;Taip;7;4;0;11
13070;Zylutė;VIEVERSĖLIAI;7173499688;Taip;9;0;0;9
13071;Zylutė;VIEVERSĖLIAI;5444138006;Taip;16;0;0;16
13072;Zylutė;VIEVERSĖLIAI;4437827048;Taip;3;0;0;3
13073;Želmenėliai;Bitučių;3268310531;Taip;8;0;0;8
13074;Želmenėliai;Bitučių;2563117992;Taip;0;2;1;3
13075;Želmenėliai;Bitučių;6799702725;Taip;5;3;0;8
13076;Želmenėliai;Bitučių;8358780570;Taip;0;5;0;5
13077;Želmenėliai;Bitučių;9006406225;Taip;0;2;0;2
13078;Želmenėliai;Bitučių;2102401372;Taip;6;0;0;6
13079;Želmenėliai;Bitučių;4931835807;Taip;0;1;0;1
13080;Želmenėliai;Bitučių;5147895081;Taip;0;4;0;4
13081;Želmenėliai;Bitučių;9611741258;Taip;7;4;0;11
13082;Želmenėliai;Bitučių;9825545754;Taip;6;0;0;6
13083;Želmenėliai;Bitučių;5314438217;Taip;1;8;1;10
13084;Želmenėliai;Bitučių;4927030144;Taip;5;2;0;7
13085;Želmenėliai;Bitučių;8028761330;Taip;0;4;0;4
13086;Želmenėliai;Bitučių;2853659708;Taip;2;1;0;3
13087;Želmenėliai;Bitučių;9207984505;Taip;0;12;0;12
13088;Želmenėliai;Kačiukų;2350936740;Taip;0;4;0;4
13089;Želmenėliai;Kačiukų;3063417708;Taip;0;11;0;11
13090;Želmenėliai;Kačiukų;2570248893;Taip;3;1;0;4
13091;Želmenėliai;Kačiukų;2577850672;Taip;4;5;0;9
13092;Želmenėliai;Kačiukų;7197717698;Taip;18;0;0;18
13093;Želmenėliai;Kačiukų;7849682820;Taip;7;3;0;10
13094;Želmenėliai;Kačiukų;2111008869;Taip;10;0;0;10
13095;Želmenėliai;Kačiukų;4589396143;Taip;0;3;0;3
13096;Želmenėliai;Kačiukų;4198085732;Taip;0;12;0;12
13097;Želmenėliai;Kačiukų;4126499046;Taip;0;12;0;12
13098;Želmenėliai;Kačiukų;4758240577;Taip;0;6;0;6
13099;Želmenėliai;Kačiukų;7094853897;Taip;2;1;0;3
13100;Želmenėliai;Kačiukų;9493581034;Taip;9;4;5;18
13101;Želmenėliai;Kačiukų;4931664953;Taip;7;1;0;8
13102;Želmenėliai;Kačiukų;4376978921;Taip;0;16;0;16
13103;Želmenėliai;Kačiukų;9313666706;Taip;5;1;0;6
13104;Želmenėliai;Kačiukų;3959066963;Taip;2;5;0;7
13105;Želmenėliai;Voveriukų;8418427863;Taip;0;9;0;9
13106;Želmenėliai;Voveriukų;5360157217;Taip;0;14;0;14
13107;Želmenėliai;Voveriukų;4968328834;Taip;0;5;0;5
13108;Želmenėliai;Voveriukų;2025424742;Taip;0;0;1;1
13109;Želmenėliai;Voveriukų;2924134152;Taip;19;0;0;19
13110;Želmenėliai;Voveriukų;5975166975;Taip;10;6;0;16
13111;Želmenėliai;Voveriukų;6857922902;Taip;3;0;1;4
13112;Želmenėliai;Voveriukų;9811131936;Taip;5;4;0;9
13113;Želmenėliai;Voveriukų;8968533318;Taip;3;0;1;4
13114;Želmenėliai;Voveriukų;8952421941;Taip;4;0;0;4
13115;Želmenėliai;Voveriukų;7345540758;Taip;10;3;0;13
13116;Želmenėliai;Voveriukų;9709599805;Taip;0;5;0;5
13117;Želmenėliai;Voveriukų;4248374729;Taip;0;9;0;9
13118;Želmenėliai;Voveriukų;7263162876;Taip;12;1;1;14
13119;Želmenėliai;Voveriukų;1199920167;Taip;0;0;3;3
13120;Želmenėliai;Voveriukų;5247889693;Taip;5;0;1;6
13121;Želmenėliai;Voveriukų;5767158743;Taip;19;0;0;19
13122;Želmenėliai;Ežiukų;1652131150;Taip;10;0;0;10
13123;Želmenėliai;Ežiukų;5795735579;Taip;0;6;0;6
13124;Želmenėliai;Ežiukų;2311169187;Taip;5;0;0;5
13125;Želmenėliai;Ežiukų;3353793939;Taip;0;4;0;4
13126;Želmenėliai;Ežiukų;7495157523;Taip;10;0;0;10
13127;Želmenėliai;Ežiukų;3972980949;Taip;0;9;0;9
13128;Želmenėliai;Ežiukų;6779746783;Taip;10;0;0;10
13129;Želmenėliai;Ežiukų;6876147546;Taip;4;4;0;8
13130;Želmenėliai;Ežiukų;9126715074;Taip;0;1;0;1
13131;Želmenėliai;Ežiukų;1260607572;Taip;0;1;0;1
13132;Želmenėliai;Ežiukų;5638248652;Taip;0;1;0;1
13133;Želmenėliai;Ežiukų;8154713582;Taip;6;0;0;6
13134;Želmenėliai;Ežiukų;2296870749;Taip;4;0;1;5
13135;Želmenėliai;Ežiukų;6180553648;Taip;0;5;0;5
13136;Želmenėliai;Ežiukų;7294722095;Taip;8;6;0;14
13137;Želmenėliai;Ežiukų;4120125150;Taip;6;2;0;8
13138;Želmenėliai;Ežiukų;5281861477;Taip;0;7;0;7
13139;Želmenėliai;Ežiukų;8987377791;Taip;0;5;0;5
13140;Želmenėliai;Ežiukų;6481952132;Taip;0;1;0;1
13141;Želmenėliai;Peledžiukų;8491797555;Taip;12;5;0;17
13142;Želmenėliai;Peledžiukų;4485249321;Taip;0;16;0;16
13143;Želmenėliai;Peledžiukų;4374898642;Taip;2;5;0;7
13144;Želmenėliai;Peledžiukų;7751609462;Taip;0;5;0;5
13145;Želmenėliai;Peledžiukų;5929410363;Taip;5;4;0;9
13146;Želmenėliai;Peledžiukų;5205425589;Taip;0;1;0;1
13147;Želmenėliai;Peledžiukų;5362390260;Taip;0;4;0;4
13148;Želmenėliai;Peledžiukų;1580370689;Taip;3;0;0;3
13149;Želmenėliai;Peledžiukų;1983575576;Taip;5;0;0;5
13150;Želmenėliai;Peledžiukų;7672980212;Taip;3;2;4;9
13151;Želmenėliai;Peledžiukų;6260153299;Taip;5;0;0;5
13152;Želmenėliai;Peledžiukų;6187661667;Taip;6;0;0;6
13153;Želmenėliai;Peledžiukų;6109546917;Taip;7;6;0;13
13154;Želmenėliai;Peledžiukų;8118696261;Taip;9;2;0;11
13155;Želmenėliai;Peledžiukų;4746898209;Taip;0;1;6;7
13156;Želmenėliai;Peledžiukų;9929149682;Taip;4;0;0;4
13157;Želmenėliai;Peledžiukų;3723155757;Taip;0;6;0;6
13158;Želmenėliai;Peledžiukų;5401466574;Taip;0;4;0;4
13159;Želmenėliai;Peledžiukų;6662439747;Taip;0;1;0;1
13160;Želmenėliai;Drugelių;7123290599;Taip;10;0;0;10
13161;Želmenėliai;Drugelių;4526936339;Taip;0;0;1;1
13162;Želmenėliai;Drugelių;5052052744;Taip;9;1;0;10
13163;Želmenėliai;Drugelių;2878494111;Taip;10;0;0;10
13164;Želmenėliai;Drugelių;5169813205;Taip;7;0;1;8
13165;Želmenėliai;Drugelių;7341132501;Taip;5;0;0;5
13166;Želmenėliai;Drugelių;9661692350;Taip;2;5;0;7
13167;Želmenėliai;Drugelių;6230010537;Taip;0;4;0;4
13168;Želmenėliai;Drugelių;1025894534;Ne;0;14;5;19
13169;Želmenėliai;Drugelių;1606079948;Taip;6;0;0;6
13170;Želmenėliai;Drugelių;9250666159;Taip;16;0;0;16
13171;Želmenėliai;Drugelių;5569699398;Taip;16;0;0;16
13172;Želmenėliai;Drugelių;4207070475;Taip;0;1;0;1
13173;Želmenėliai;Drugelių;7925266303;Taip;7;0;0;7
13174;Želmenėliai;Drugelių;8409831053;Taip;1;3;0;4
13175;Želmenėliai;Drugelių;8060048377;Taip;17;0;0;17
13176;Želmenėliai;Drugelių;3608041516;Taip;0;4;0;4
13177;Želmenėliai;Drugelių;5454656514;Taip;5;4;0;9
13178;Želmenėliai;Drugelių;7792850272;Taip;8;1;0;9
13179;Želmenėliai;Voriukų;4264751761;Taip;6;0;0;6
13180;Želmenėliai;Voriukų;6916426436;Taip;0;0;1;1
13181;Želmenėliai;Voriukų;7563461821;Taip;0;2;0;2
13182;Želmenėliai;Voriukų;4534946646;Taip;0;2;0;2
13183;Želmenėliai;Voriukų;4075533071;Taip;0;11;0;11
13184;Želmenėliai;Voriukų;4545012342;Taip;6;0;0;6
13185;Želmenėliai;Voriukų;7505996978;Taip;0;12;0;12
13186;Želmenėliai;Voriukų;2722619508;Taip;0;18;0;18
13187;Želmenėliai;Voriukų;5025345647;Taip;0;19;0;19
13188;Želmenėliai;Voriukų;8892137326;Taip;0;2;0;2
13189;Želmenėliai;Voriukų;7700521261;Taip;0;6;0;6
13190;Želmenėliai;Voriukų;5794346039;Taip;0;2;0;2
13191;Želmenėliai;Voriukų;8273301992;Taip;8;4;0;12
13192;Želmenėliai;Voriukų;9427388681;Taip;0;2;0;2
13193;Želmenėliai;Voriukų;9977585033;Taip;7;0;0;7
13194;Želmenėliai;Voriukų;6343814445;Taip;0;0;1;1
13195;Želmenėliai;Voriukų;5171736943;Taip;0;1;0;1
13196;Želmenėliai;Voriukų;7833143421;Taip;0;2;0;2
13197;Želmenėliai;Voriukų;7423900312;Taip;0;6;0;6
13198;Želmenėliai;Boružėlių;1764468979;Taip;0;10;0;10
13199;Želmenėliai;Boružėlių;5161934903;Taip;0;2;0;2
13200;Želmenėliai;Boružėlių;8722573513;Taip;8;1;0;9
13201;Želmenėliai;Boružėlių;3516695805;Taip;15;8;0;23
13202;Želmenėliai;Boružėlių;5949535657;Taip;12;1;0;13
13203;Želmenėliai;Boružėlių;2262009049;Taip;6;0;0;6
13204;Želmenėliai;Boružėlių;7077832687;Taip;6;3;0;9
13205;Želmenėliai;Boružėlių;3896171121;Taip;8;1;0;9
13206;Želmenėliai;Boružėlių;2951719129;Taip;0;10;0;10
13207;Želmenėliai;Boružėlių;2066439950;Taip;0;1;0;1
13208;Želmenėliai;Boružėlių;5207899503;Taip;5;12;0;17
13209;Želmenėliai;Boružėlių;2111705047;Taip;7;3;0;10
13210;Želmenėliai;Boružėlių;8474210476;Taip;11;0;0;11
13211;Želmenėliai;Boružėlių;2179165096;Taip;21;1;0;22
13212;Želmenėliai;Boružėlių;6831569546;Taip;3;2;0;5
13213;Želmenėliai;Boružėlių;9042786857;Taip;15;0;0;15
13214;Želmenėliai;Boružėlių;5913022147;Taip;2;6;0;8
13215;Želmenėliai;Pūkuotukų;3558547171;Taip;1;0;0;1
13216;Želmenėliai;Pūkuotukų;3979635800;Taip;2;0;0;2
13217;Želmenėliai;Pūkuotukų;4485851428;Taip;0;5;0;5
13218;Želmenėliai;Pūkuotukų;2501163903;Taip;2;4;0;6
13219;Želmenėliai;Pūkuotukų;9076874685;Taip;3;0;0;3
13220;Želmenėliai;Pūkuotukų;3346680108;Taip;23;0;0;23
13221;Želmenėliai;Pūkuotukų;8654298177;Taip;1;0;0;1
13222;Želmenėliai;Pūkuotukų;9182208354;Taip;5;4;0;9
13223;Želmenėliai;Pūkuotukų;4679930998;Taip;2;0;0;2
13224;Želmenėliai;Pūkuotukų;3344426717;Taip;5;0;0;5
13225;Želmenėliai;Pūkuotukų;4930868989;Taip;6;0;0;6
13226;Želmenėliai;Pūkuotukų;4451798870;Taip;2;0;0;2
13227;Želmenėliai;Pūkuotukų;8104790589;Taip;8;0;0;8
13228;Želmenėliai;Pūkuotukų;4722890143;Taip;3;0;0;3
13229;Želmenėliai;Pūkuotukų;3232996198;Taip;12;0;0;12
13230;Želmenėliai;Pūkuotukų;6764567873;Taip;0;10;0;10
13231;Želmenėliai;Pūkuotukų;3926238501;Taip;0;11;0;11
13232;Želmenėliai;Pūkuotukų;2095477479;Taip;1;1;0;2
13233;Želmenėliai;Ančiukų;9377359390;Taip;7;0;0;7
13234;Želmenėliai;Ančiukų;8165683014;Taip;19;2;0;21
13235;Želmenėliai;Ančiukų;3172645969;Taip;4;0;0;4
13236;Želmenėliai;Ančiukų;7128213908;Taip;3;6;0;9
13237;Želmenėliai;Ančiukų;6723870371;Taip;8;0;1;9
13238;Želmenėliai;Ančiukų;5872145297;Taip;6;0;0;6
13239;Želmenėliai;Ančiukų;9558387704;Taip;0;1;0;1
13240;Želmenėliai;Ančiukų;3057181122;Taip;5;0;0;5
13241;Želmenėliai;Ančiukų;1359184372;Taip;17;1;0;18
13242;Želmenėliai;Ančiukų;9945526672;Taip;33;0;0;33
13243;Želmenėliai;Nykštukų;8276857357;Taip;0;1;0;1
13244;Želmenėliai;Nykštukų;3003922213;Taip;4;1;0;5
13245;Želmenėliai;Nykštukų;3539019330;Taip;7;0;0;7
13246;Želmenėliai;Nykštukų;3313780575;Taip;16;0;0;16
13247;Želmenėliai;Nykštukų;5560792581;Taip;4;1;0;5
13248;Želmenėliai;Nykštukų;8191484604;Taip;15;0;0;15
13249;Želmenėliai;Nykštukų;2028226797;Taip;8;4;0;12
13250;Želmenėliai;Nykštukų;2369379191;Taip;9;0;0;9
13251;Želmenėliai;Nykštukų;6172599827;Taip;6;0;0;6
13252;Želmenėliai;Nykštukų;2678902898;Taip;10;0;0;10
13253;Želmenėliai;Nykštukų;7537198352;Taip;12;1;0;13
13254;Želmenėliai;Nykštukų;2896053108;Taip;12;1;0;13
13255;Želmenėliai;Nykštukų;4165912796;Taip;4;4;0;8
13256;Želmenėliai;Nykštukų;1613626023;Taip;3;0;0;3
13257;Želmenėliai;Lašelių;9483665065;Taip;13;1;0;14
13258;Želmenėliai;Lašelių;5494517342;Taip;6;0;0;6
13259;Želmenėliai;Lašelių;9774587149;Taip;4;0;0;4
13260;Želmenėliai;Lašelių;2143421412;Taip;2;1;0;3
13261;Želmenėliai;Lašelių;9608259121;Taip;13;2;0;15
13262;Želmenėliai;Lašelių;7403060823;Taip;6;0;0;6
13263;Želmenėliai;Lašelių;9178657126;Taip;6;0;0;6
13264;Želmenėliai;Lašelių;6605391184;Taip;2;0;0;2
13265;Želmenėliai;Lašelių;4197691574;Ne;16;1;0;17
13266;Želmenėliai;Lašelių;7714476156;Taip;4;0;0;4
13267;Želmenėliai;Lašelių;7067545362;Taip;10;2;0;12
13268;Želmenėliai;Lašelių;4354709866;Taip;15;0;0;15
13269;Žemyna;Čiauškučiai;9985529041;Taip;0;1;4;5
13270;Žemyna;Čiauškučiai;6346173832;Taip;13;0;1;14
13271;Žemyna;Čiauškučiai;3074391266;Taip;9;4;1;14
13272;Žemyna;Čiauškučiai;1365045512;Taip;0;0;1;1
13273;Žemyna;Čiauškučiai;7620179886;Taip;4;0;2;6
13274;Žemyna;Čiauškučiai;2792702536;Taip;0;2;0;2
13275;Žemyna;Čiauškučiai;7376806308;Taip;0;2;0;2
13276;Žemyna;Čiauškučiai;7277970673;Taip;0;0;1;1
13277;Žemyna;Čiauškučiai;5069437469;Taip;0;4;1;5
13278;Žemyna;Čiauškučiai;7427119736;Taip;0;1;0;1
13279;Žemyna;Čiauškučiai;4642600915;Ne;0;1;1;2
13280;Žemyna;Čiauškučiai;2354265632;Taip;0;0;1;1
13281;Žemyna;Čiauškučiai;2887459684;Taip;8;4;0;12
13282;Žemyna;Čiauškučiai;1654157342;Taip;0;1;0;1
13283;Žemyna;Čiauškučiai;4652384557;Taip;10;0;1;11
13284;Žemyna;Čiauškučiai;7352868453;Taip;0;4;0;4
13285;Žemyna;Čiauškučiai;4501408683;Taip;0;4;2;6
13286;Žemyna;Čiauškučiai;4613946229;Taip;0;2;0;2
13287;Žemyna;Čiauškučiai;7675699775;Taip;4;7;0;11
13288;Žemyna;Čiauškučiai;6254811026;Taip;3;2;1;6
13289;Žemyna;Nykštukai;8965957442;Taip;2;0;5;7
13290;Žemyna;Nykštukai;6965700024;Taip;8;4;2;14
13291;Žemyna;Nykštukai;3413550977;Taip;5;0;2;7
13292;Žemyna;Nykštukai;8234617396;Taip;10;5;0;15
13293;Žemyna;Nykštukai;2105658990;Taip;0;0;1;1
13294;Žemyna;Nykštukai;1241953155;Taip;1;0;2;3
13295;Žemyna;Nykštukai;5274759824;Taip;7;0;0;7
13296;Žemyna;Nykštukai;9457156368;Taip;18;0;0;18
13297;Žemyna;Nykštukai;5968816137;Taip;0;0;2;2
13298;Žemyna;Nykštukai;4238528111;Taip;0;1;0;1
13299;Žemyna;Nykštukai;3741459808;Taip;0;1;0;1
13300;Žemyna;Nykštukai;3870917221;Taip;9;0;1;10
13301;Žemyna;Nykštukai;6571952468;Taip;0;0;1;1
13302;Žemyna;Nykštukai;6632827240;Taip;0;4;2;6
13303;Žemyna;Nykštukai;3935318882;Taip;6;0;0;6
13304;Žemyna;Nykštukai;2010676445;Taip;6;0;0;6
13305;Žemyna;Nykštukai;9788890112;Taip;13;0;0;13
13306;Žemyna;Nykštukai;8157281885;Taip;2;0;0;2
13307;Žemyna;Voveriukai;6912605631;Taip;7;0;0;7
13308;Žemyna;Voveriukai;4549562657;Taip;4;5;0;9
13309;Žemyna;Voveriukai;8882641275;Taip;4;7;0;11
13310;Žemyna;Voveriukai;7121061078;Taip;0;0;1;1
13311;Žemyna;Voveriukai;4900914346;Taip;18;0;0;18
13312;Žemyna;Voveriukai;8241038433;Taip;4;4;0;8
13313;Žemyna;Voveriukai;3500358886;Taip;9;2;0;11
13314;Žemyna;Voveriukai;6592356004;Taip;4;0;0;4
13315;Žemyna;Voveriukai;7705964355;Taip;4;2;0;6
13316;Žemyna;Voveriukai;5486645485;Taip;0;12;0;12
13317;Žemyna;Voveriukai;5828590779;Taip;12;0;0;12
13318;Žemyna;Voveriukai;6070560979;Taip;4;7;0;11
13319;Žemyna;Voveriukai;8601806926;Taip;12;1;0;13
13320;Žemyna;Voveriukai;1883775045;Taip;16;0;0;16
13321;Žemyna;Kiškučiai;4937929385;Taip;0;9;0;9
13322;Žemyna;Kiškučiai;9912869400;Taip;5;0;1;6
13323;Žemyna;Kiškučiai;2006173745;Taip;0;4;2;6
13324;Žemyna;Kiškučiai;6116581655;Taip;1;1;0;2
13325;Žemyna;Kiškučiai;6728229865;Taip;0;7;0;7
13326;Žemyna;Kiškučiai;4872348199;Taip;0;4;2;6
13327;Žemyna;Kiškučiai;2710551760;Taip;0;9;0;9
13328;Žemyna;Kiškučiai;6419974691;Ne;10;4;0;14
13329;Žemyna;Kiškučiai;9818711030;Taip;0;0;1;1
13330;Žemyna;Kiškučiai;7764615445;Taip;0;4;3;7
13331;Žemyna;Kiškučiai;4502958166;Taip;0;2;0;2
13332;Žemyna;Kiškučiai;5868208651;Taip;0;1;0;1
13333;Žemyna;Kiškučiai;3982766622;Taip;2;4;0;6
13334;Žemyna;Kiškučiai;3992383447;Taip;4;0;1;5
13335;Žemyna;Kiškučiai;9568886284;Taip;1;3;4;8
13336;Žemyna;Kiškučiai;9668975591;Taip;0;3;0;3
13337;Žemyna;Kiškučiai;4612112289;Taip;0;1;1;2
13338;Žemyna;Kiškučiai;5188496664;Taip;11;4;0;15
13339;Žemyna;Vyturiukai;2526949655;Taip;0;5;0;5
13340;Žemyna;Vyturiukai;1417007895;Taip;0;5;0;5
13341;Žemyna;Vyturiukai;1481273689;Taip;7;0;0;7
13342;Žemyna;Vyturiukai;7781332622;Taip;0;10;0;10
13343;Žemyna;Vyturiukai;9366133892;Taip;0;4;0;4
13344;Žemyna;Vyturiukai;1031171460;Taip;2;0;6;8
13345;Žemyna;Vyturiukai;5204349188;Taip;9;0;0;9
13346;Žemyna;Vyturiukai;1345704379;Taip;4;0;1;5
13347;Žemyna;Vyturiukai;6097681172;Taip;0;6;0;6
13348;Žemyna;Vyturiukai;5133115712;Taip;0;7;0;7
13349;Žemyna;Vyturiukai;5416338054;Taip;0;7;0;7
13350;Žemyna;Vyturiukai;3446774478;Taip;0;6;0;6
13351;Žemyna;Vyturiukai;2304633263;Taip;7;0;0;7
13352;Žemyna;Vyturiukai;3679990879;Taip;0;0;2;2
13353;Žemyna;Vyturiukai;8681308720;Taip;0;2;0;2
13354;Žemyna;Vyturiukai;9646494715;Taip;0;5;0;5
13355;Žemyna;Vyturiukai;4863350801;Taip;2;0;0;2
13356;Žemyna;Vyturiukai;6372465987;Taip;0;0;1;1
13357;Žemyna;Vyturiukai;5655302107;Ne;0;15;0;15
13358;Žemyna;Pelėdžiukai;1846287760;Ne;6;2;0;8
13359;Žemyna;Pelėdžiukai;8775518984;Taip;0;3;5;8
13360;Žemyna;Pelėdžiukai;5337086029;Taip;5;0;0;5
13361;Žemyna;Pelėdžiukai;5450351549;Taip;3;1;0;4
13362;Žemyna;Pelėdžiukai;8926045231;Taip;0;4;1;5
13363;Žemyna;Pelėdžiukai;3860791215;Taip;4;6;0;10
13364;Žemyna;Pelėdžiukai;8185243991;Taip;0;4;0;4
13365;Žemyna;Pelėdžiukai;7942276632;Taip;4;0;0;4
13366;Žemyna;Pelėdžiukai;8408275231;Taip;6;4;1;11
13367;Žemyna;Pelėdžiukai;7417179112;Taip;0;0;2;2
13368;Žemyna;Pelėdžiukai;9831054554;Taip;0;0;1;1
13369;Žemyna;Pelėdžiukai;9194899557;Taip;6;0;0;6
13370;Žemyna;Pelėdžiukai;6175213274;Taip;23;0;0;23
13371;Žemyna;Pelėdžiukai;7311046586;Taip;0;7;0;7
13372;Žemyna;Pelėdžiukai;5124507416;Taip;0;7;0;7
13373;Žemyna;Pelėdžiukai;7672879525;Taip;5;2;0;7
13374;Žemyna;Vijurkai;4524929331;Taip;0;1;1;2
13375;Žemyna;Vijurkai;5114094924;Taip;9;4;1;14
13376;Žemyna;Vijurkai;3643594001;Taip;0;4;1;5
13377;Žemyna;Vijurkai;9182709647;Taip;0;4;0;4
13378;Žemyna;Vijurkai;4257096808;Taip;0;4;0;4
13379;Žemyna;Vijurkai;3874855308;Taip;0;10;0;10
13380;Žemyna;Vijurkai;7121742098;Taip;0;4;3;7
13381;Žemyna;Vijurkai;2461700030;Taip;0;7;0;7
13382;Žemyna;Vijurkai;3519840747;Taip;0;2;0;2
13383;Žemyna;Vijurkai;7508491119;Taip;0;4;0;4
13384;Žemyna;Vijurkai;1725771976;Taip;0;1;1;2
13385;Žemyna;Vijurkai;9653530823;Taip;0;1;0;1
13386;Žemyna;Vijurkai;2860210906;Taip;7;3;3;13
13387;Žemyna;Vijurkai;7832066079;Taip;0;3;0;3
13388;Žemyna;Vijurkai;1468040559;Ne;0;0;1;1
13389;Žemyna;Vijurkai;4322192775;Taip;0;4;0;4
13390;Žemyna;Vijurkai;4444870782;Taip;0;3;0;3
13391;Žemyna;Vijurkai;7781924111;Taip;0;4;0;4
13392;Žemyna;Vijurkai;2928125522;Taip;12;2;0;14
13393;Žemyna;Vijurkai;4759403487;Taip;0;4;2;6
13394;Žemyna;Vijurkai;5222774764;Taip;0;23;0;23
13395;Žemyna;Šnekučiai;4540472310;Taip;0;7;1;8
13396;Žemyna;Šnekučiai;9647706055;Taip;0;0;1;1
13397;Žemyna;Šnekučiai;7537145330;Taip;13;0;0;13
13398;Žemyna;Šnekučiai;7683443675;Taip;13;0;0;13
13399;Žemyna;Šnekučiai;3899901920;Taip;8;0;0;8
13400;Žemyna;Šnekučiai;7831778620;Taip;0;2;0;2
13401;Žemyna;Šnekučiai;9692952139;Taip;0;1;0;1
13402;Žemyna;Šnekučiai;1795919515;Taip;0;0;3;3
13403;Žemyna;Šnekučiai;8319442149;Taip;13;0;0;13
13404;Žemyna;Šnekučiai;1999410395;Taip;4;0;0;4
13405;Žemyna;Šnekučiai;6872208929;Taip;8;6;0;14
13406;Žemyna;Šnekučiai;4373063041;Taip;0;4;0;4
13407;Žemyna;Šnekučiai;9813765590;Taip;3;3;0;6
13408;Žemyna;Šnekučiai;4779461598;Taip;10;0;0;10
13409;Žemyna;Šnekučiai;3976010927;Taip;23;0;0;23
13410;Žemyna;Šnekučiai;4963338410;Taip;15;0;3;18
13411;Žemyna;Šnekučiai;1078809628;Taip;9;0;0;9
13412;Žemyna;Šnekučiai;3729250035;Taip;0;0;1;1
13413;Žemyna;Šnekučiai;9535234845;Taip;0;0;9;9
13414;Žemyna;Šnekučiai;9796331127;Taip;0;1;0;1
13415;Žemyna;Pabiručiai;9827401825;Taip;4;0;0;4
13416;Žemyna;Pabiručiai;5743535463;Taip;19;0;0;19
13417;Žemyna;Pabiručiai;6958537154;Taip;0;1;1;2
13418;Žemyna;Pabiručiai;7005045961;Taip;0;4;0;4
13419;Žemyna;Pabiručiai;1745197274;Taip;0;3;0;3
13420;Žemyna;Pabiručiai;6041223291;Taip;0;0;2;2
13421;Žemyna;Pabiručiai;9094718595;Taip;5;0;2;7
13422;Žemyna;Pabiručiai;6208953341;Taip;0;8;0;8
13423;Žemyna;Pabiručiai;1656335765;Taip;0;1;0;1
13424;Žemyna;Pabiručiai;5127174926;Taip;10;0;0;10
13425;Žemyna;Pabiručiai;1850100203;Taip;5;3;0;8
13426;Žemyna;Pabiručiai;6450681255;Taip;5;3;0;8
13427;Žemyna;Pabiručiai;2860232791;Taip;0;0;1;1
13428;Žemyna;Pabiručiai;4237778022;Taip;0;5;0;5
13429;Žemyna;Pabiručiai;2414400761;Taip;13;5;0;18
13430;Žemyna;Pabiručiai;9511935264;Taip;0;6;0;6
13431;Žemyna;Pabiručiai;4176386795;Taip;0;4;0;4
13432;Žemyna;Pabiručiai;3393414493;Taip;7;0;0;7
13433;Žemyna;Pabiručiai;4960936366;Taip;10;0;0;10
13434;Žemyna;Pabiručiai;2495616844;Taip;0;0;3;3
13435;Žemyna;Pabiručiai;6329592260;Taip;0;6;1;7
13436;Žemyna;Drugeliai;7564693757;Taip;6;1;1;8
13437;Žemyna;Drugeliai;8302345911;Taip;2;0;0;2
13438;Žemyna;Drugeliai;3505551915;Taip;5;1;3;9
13439;Žemyna;Drugeliai;2231967652;Taip;3;0;2;5
13440;Žemyna;Drugeliai;3755964840;Taip;9;4;0;13
13441;Žemyna;Drugeliai;9171823612;Taip;0;0;12;12
13442;Žemyna;Drugeliai;5518125715;Taip;8;0;1;9
13443;Žemyna;Drugeliai;9589582451;Taip;6;0;1;7
13444;Žemyna;Drugeliai;3872427931;Taip;5;0;0;5
13445;Žemyna;Drugeliai;1279981170;Taip;0;0;1;1
13446;Žemyna;Drugeliai;2102920661;Taip;0;0;4;4
13447;Žemyna;Drugeliai;6575272457;Taip;0;0;2;2
13448;Žemyna;Drugeliai;6164541167;Taip;7;0;0;7
13449;Žemyna;Drugeliai;7461187735;Taip;0;13;0;13
13450;Žemyna;Drugeliai;3390442637;Taip;0;4;0;4
13451;Žemyna;Drugeliai;2371069183;Taip;0;0;1;1
13452;Žemyna;Drugeliai;2139103576;Taip;0;0;1;1
13453;Žemyna;Drugeliai;7920398415;Taip;8;1;0;9
13454;Žemyna;Drugeliai;1695063377;Taip;0;1;0;1
13455;Žemyna;Drugeliai;7745383607;Taip;12;0;0;12
13456;Žemyna;Drugeliai;7661182825;Taip;0;1;0;1
13457;Žemyna;Drugeliai;4861799571;Taip;0;1;0;1
13458;Žemyna;Drugeliai;7969518430;Taip;0;0;4;4
13459;Žemyna;"ŽIRNIUKAI ";8638419172;Taip;8;0;0;8
13460;Žemyna;"ŽIRNIUKAI ";5262196604;Taip;0;0;2;2
13461;Žemyna;"ŽIRNIUKAI ";6783675344;Taip;10;0;0;10
13462;Žemyna;"ŽIRNIUKAI ";9082375371;Taip;7;0;0;7
13463;Žemyna;"ŽIRNIUKAI ";3172071074;Taip;9;0;9;18
13464;Žemyna;"ŽIRNIUKAI ";7684869135;Taip;0;0;2;2
13465;Žemyna;"ŽIRNIUKAI ";8574497593;Taip;6;4;3;13
13466;Žemyna;"ŽIRNIUKAI ";3951546627;Taip;17;0;0;17
13467;Žemyna;"ŽIRNIUKAI ";2333634521;Ne;0;0;7;7
13468;Žemyna;"ŽIRNIUKAI ";8915491841;Taip;7;0;5;12
13469;Žemyna;"ŽIRNIUKAI ";7567666690;Taip;0;0;2;2
13470;Žemyna;"ŽIRNIUKAI ";1667692063;Taip;0;0;22;22
13471;Žemyna;"ŽIRNIUKAI ";1898736492;Taip;4;0;0;4
13472;Žemyna;"ŽIRNIUKAI ";8371442452;Taip;0;5;0;5
13473;Žemyna;"ŽIRNIUKAI ";2302222659;Taip;14;0;0;14
13474;Žemyna;"ŽIRNIUKAI ";3695746422;Taip;18;0;0;18
13475;Žemyna;"ŽIRNIUKAI ";1014787654;Taip;18;3;0;21
13476;Žemyna;"ŽIOGELIAI ";2039344248;Taip;8;0;0;8
13477;Žemyna;"ŽIOGELIAI ";5193466394;Taip;1;4;0;5
13478;Žemyna;"ŽIOGELIAI ";3164469202;Taip;0;1;1;2
13479;Žemyna;"ŽIOGELIAI ";8365200813;Taip;0;0;1;1
13480;Žemyna;"ŽIOGELIAI ";3234902380;Ne;6;0;0;6
13481;Žemyna;"ŽIOGELIAI ";8939113856;Taip;12;6;0;18
13482;Žemyna;"ŽIOGELIAI ";8205404725;Taip;7;0;2;9
13483;Žemyna;"ŽIOGELIAI ";3768231563;Taip;9;0;0;9
13484;Žemyna;"ŽIOGELIAI ";7580529381;Taip;4;0;0;4
13485;Žemyna;"ŽIOGELIAI ";5593285877;Taip;4;0;0;4
13486;Žemyna;"ŽIOGELIAI ";3397833166;Taip;4;0;0;4
13487;Žemyna;"ŽIOGELIAI ";2255662379;Taip;16;0;0;16
13488;Žemyna;"ŽIOGELIAI ";8017209353;Taip;16;0;0;16
13489;Žemyna;"ŽIOGELIAI ";8036600474;Taip;0;6;0;6
13490;Žemyna;"ŽIOGELIAI ";6317657622;Taip;5;2;0;7
13491;Žemyna;"ŽIOGELIAI ";9992027222;Taip;6;4;0;10
13492;Žemuogėlė;Boružiukai;1350671777;Taip;4;0;0;4
13493;Žemuogėlė;Boružiukai;9344628661;Taip;0;1;0;1
13494;Žemuogėlė;Boružiukai;2158359435;Ne;5;1;0;6
13495;Žemuogėlė;Boružiukai;1639634300;Taip;16;0;0;16
13496;Žemuogėlė;Boružiukai;5521993938;Ne;4;0;0;4
13497;Žemuogėlė;Boružiukai;1267222057;Taip;0;1;0;1
13498;Žemuogėlė;Boružiukai;9562512849;Taip;10;7;2;19
13499;Žemuogėlė;Boružiukai;8661864424;Taip;2;1;0;3
13500;Žemuogėlė;Boružiukai;1150466286;Taip;7;5;0;12
13501;Žemuogėlė;Boružiukai;8040255583;Taip;4;6;0;10
13502;Žemuogėlė;Boružiukai;2190458676;Taip;4;1;0;5
13503;Žemuogėlė;Boružiukai;6073591450;Taip;9;0;0;9
13504;Žemuogėlė;Boružiukai;7328566035;Taip;0;0;1;1
13505;Žemuogėlė;Boružiukai;8557325116;Taip;0;1;0;1
13506;Žemuogėlė;Boružiukai;1350383125;Taip;6;0;0;6
13507;Žemuogėlė;Boružiukai;7050896262;Taip;0;3;0;3
13508;Žemuogėlė;Boružiukai;3413805578;Taip;3;0;0;3
13509;Žemuogėlė;Boružiukai;1187953952;Taip;0;4;0;4
13510;Žemuogėlė;Boružiukai;3677459716;Taip;8;1;0;9
13511;Žemuogėlė;Boružiukai;8426601160;Taip;7;0;0;7
13512;Žemuogėlė;Boružiukai;5911215640;Taip;4;2;8;14
13513;Žemuogėlė;Šviesuliukai;9599829363;Taip;0;5;0;5
13514;Žemuogėlė;Šviesuliukai;4663181188;Taip;0;5;0;5
13515;Žemuogėlė;Šviesuliukai;7288060676;Taip;27;0;0;27
13516;Žemuogėlė;Šviesuliukai;5447960062;Ne;10;0;0;10
13517;Žemuogėlė;Šviesuliukai;4654060157;Taip;2;0;0;2
13518;Žemuogėlė;Šviesuliukai;2652630375;Taip;7;0;0;7
13519;Žemuogėlė;Šviesuliukai;1250186598;Taip;10;4;0;14
13520;Žemuogėlė;Šviesuliukai;3287415964;Taip;0;7;0;7
13521;Žemuogėlė;Šviesuliukai;5094867109;Taip;7;0;0;7
13522;Žemuogėlė;Šviesuliukai;4974793430;Taip;14;0;0;14
13523;Žemuogėlė;Šviesuliukai;5125826172;Taip;0;7;0;7
13524;Žemuogėlė;Šviesuliukai;8262862183;Taip;5;4;1;10
13525;Žemuogėlė;Šviesuliukai;8798113318;Taip;2;0;0;2
13526;Žemuogėlė;Šviesuliukai;1280794094;Taip;1;2;1;4
13527;Žemuogėlė;Šviesuliukai;2251142510;Taip;3;4;0;7
13528;Žemuogėlė;Šviesuliukai;1417355297;Taip;10;0;0;10
13529;Žemuogėlė;Lašiukai;3190523750;Taip;8;1;1;10
13530;Žemuogėlė;Lašiukai;1251497003;Taip;3;1;0;4
13531;Žemuogėlė;Lašiukai;3706531223;Ne;6;3;0;9
13532;Žemuogėlė;Lašiukai;8029484123;Taip;11;0;0;11
13533;Žemuogėlė;Lašiukai;5992802843;Taip;6;4;0;10
13534;Žemuogėlė;Lašiukai;3753156044;Taip;5;2;0;7
13535;Žemuogėlė;Lašiukai;7592566602;Taip;6;2;5;13
13536;Žemuogėlė;Lašiukai;1555899448;Taip;0;1;0;1
13537;Žemuogėlė;Lašiukai;8644564820;Taip;0;4;0;4
13538;Žemuogėlė;Lašiukai;3546429231;Taip;0;19;0;19
13539;Žemuogėlė;Lašiukai;9693814425;Taip;2;0;0;2
13540;Žemuogėlė;Lašiukai;3059525247;Taip;4;0;0;4
13541;Žemuogėlė;Lašiukai;6747566307;Taip;0;4;0;4
13542;Žemuogėlė;Lašiukai;2115883173;Taip;11;0;1;12
13543;Žemuogėlė;Lašiukai;9848385521;Taip;4;1;0;5
13544;Žemuogėlė;Lašiukai;5602718614;Taip;0;3;4;7
13545;Žemuogėlė;Skambaliukai;7804015060;Taip;0;7;0;7
13546;Žemuogėlė;Skambaliukai;3765022476;Taip;0;4;0;4
13547;Žemuogėlė;Skambaliukai;9476688736;Taip;5;1;0;6
13548;Žemuogėlė;Skambaliukai;9519563708;Taip;3;4;0;7
13549;Žemuogėlė;Skambaliukai;2841634296;Taip;0;1;0;1
13550;Žemuogėlė;Skambaliukai;3237083654;Taip;2;2;0;4
13551;Žemuogėlė;Skambaliukai;2259779058;Taip;4;0;0;4
13552;Žemuogėlė;Skambaliukai;9693894254;Ne;0;5;0;5
13553;Žemuogėlė;Skambaliukai;9378432383;Taip;0;3;0;3
13554;Žemuogėlė;Skambaliukai;6581889641;Taip;0;3;0;3
13555;Žemuogėlė;Skambaliukai;2555902309;Taip;9;3;0;12
13556;Žemuogėlė;Skambaliukai;2132549536;Taip;9;5;0;14
13557;Žemuogėlė;Skambaliukai;8496353410;Taip;5;1;0;6
13558;Žemuogėlė;Skambaliukai;1733808230;Taip;0;8;0;8
13559;Žemuogėlė;Skambaliukai;9579921777;Taip;8;0;0;8
13560;Žemuogėlė;Spinduliukai;5971652934;Taip;1;9;0;10
13561;Žemuogėlė;Spinduliukai;4578291476;Taip;9;9;0;18
13562;Žemuogėlė;Spinduliukai;6707522989;Taip;0;3;0;3
13563;Žemuogėlė;Spinduliukai;7669457695;Taip;0;2;3;5
13564;Žemuogėlė;Spinduliukai;4933948491;Taip;1;9;0;10
13565;Žemuogėlė;Spinduliukai;7342985744;Taip;0;8;1;9
13566;Žemuogėlė;Spinduliukai;7551522580;Taip;0;0;3;3
13567;Žemuogėlė;Spinduliukai;5499401648;Taip;6;0;0;6
13568;Žemuogėlė;Spinduliukai;7603740057;Taip;4;0;2;6
13569;Žemuogėlė;Spinduliukai;6755278376;Ne;9;0;5;14
13570;Žemuogėlė;Spinduliukai;3746045950;Taip;0;14;0;14
13571;Žemuogėlė;Spinduliukai;4506847669;Taip;5;4;0;9
13572;Žemuogėlė;Spinduliukai;7837251012;Taip;10;1;1;12
13573;Žemuogėlė;Spinduliukai;7189855370;Taip;0;13;0;13
13574;Žemuogėlė;Spinduliukai;3801534195;Taip;11;8;0;19
13575;Žemuogėlė;Perliukai;1002937953;Taip;0;2;0;2
13576;Žemuogėlė;Perliukai;6504659145;Ne;2;0;0;2
13577;Žemuogėlė;Perliukai;3505090532;Taip;9;6;1;16
13578;Žemuogėlė;Perliukai;1790341419;Taip;6;1;0;7
13579;Žemuogėlė;Perliukai;4998981337;Taip;20;1;0;21
13580;Žemuogėlė;Perliukai;6045257180;Taip;9;0;0;9
13581;Žemuogėlė;Perliukai;8301927361;Taip;11;0;1;12
13582;Žemuogėlė;Perliukai;2496321184;Taip;2;3;0;5
13583;Žemuogėlė;Perliukai;8490643028;Taip;0;1;0;1
13584;Žemuogėlė;Perliukai;5208043522;Ne;3;0;0;3
13585;Žemuogėlė;Perliukai;2139102266;Taip;10;2;0;12
13586;Žemuogėlė;Perliukai;3740127955;Taip;13;0;1;14
13587;Žemuogėlė;Perliukai;5614510812;Taip;0;1;0;1
13588;Žemuogėlė;Perliukai;9735379466;Taip;16;0;0;16
13589;Žemuogėlė;Perliukai;4089939292;Taip;9;5;0;14
13590;Žemuogėlė;Perliukai;9584172565;Ne;0;2;0;2
13591;Žemuogėlė;Perliukai;8706379207;Taip;5;0;1;6
13592;Žemuogėlė;Perliukai;1457860763;Taip;4;0;0;4
13593;Žemuogėlė;Drugeliai;2745609317;Taip;9;0;0;9
13594;Žemuogėlė;Drugeliai;9694133286;Taip;0;2;0;2
13595;Žemuogėlė;Drugeliai;5557409350;Taip;0;6;0;6
13596;Žemuogėlė;Drugeliai;7668200447;Taip;5;0;0;5
13597;Žemuogėlė;Drugeliai;7148244029;Taip;11;3;0;14
13598;Žemuogėlė;Drugeliai;1901423257;Taip;6;6;0;12
13599;Žemuogėlė;Drugeliai;4862145385;Taip;10;2;0;12
13600;Žemuogėlė;Drugeliai;4368183799;Taip;10;1;0;11
13601;Žemuogėlė;Drugeliai;9902953729;Taip;16;0;0;16
13602;Žemuogėlė;Drugeliai;9537297860;Taip;1;8;0;9
13603;Žemuogėlė;Drugeliai;2428043195;Ne;3;0;0;3
13604;Žemuogėlė;Drugeliai;1716114524;Taip;1;0;1;2
13605;Žemuogėlė;Drugeliai;8137567729;Taip;0;14;0;14
13606;Žemuogėlė;Drugeliai;7974688217;Taip;7;2;0;9
13607;Žemuogėlė;Drugeliai;9273896998;Ne;20;0;0;20
13608;Žemuogėlė;Drugeliai;9801151322;Taip;9;4;0;13
13609;Žemuogėlė;Drugeliai;5142411841;Taip;19;0;0;19
13610;Žemuogėlė;Drugeliai;9872387354;Taip;12;2;0;14
13611;Žemuogėlė;Drugeliai;5300388726;Taip;0;1;0;1
13612;Žemuogėlė;"VIEVERSIUKAI ";6520776378;Taip;2;0;0;2
13613;Žemuogėlė;"VIEVERSIUKAI ";8048818368;Taip;7;0;5;12
13614;Žemuogėlė;"VIEVERSIUKAI ";6577040746;Taip;9;0;1;10
13615;Žemuogėlė;"VIEVERSIUKAI ";2674188340;Taip;4;0;0;4
13616;Žemuogėlė;"VIEVERSIUKAI ";7823828526;Taip;0;9;0;9
13617;Žemuogėlė;"VIEVERSIUKAI ";4172356209;Taip;11;0;0;11
13618;Žemuogėlė;"VIEVERSIUKAI ";6379837644;Taip;2;0;0;2
13619;Žemuogėlė;"VIEVERSIUKAI ";3104276726;Taip;5;0;0;5
13620;Žemuogėlė;"VIEVERSIUKAI ";2800160529;Taip;19;0;0;19
13621;Žemuogėlė;"VIEVERSIUKAI ";8934779062;Taip;7;0;1;8
13622;Žemuogėlė;"VIEVERSIUKAI ";3090630899;Taip;3;0;1;4
13623;Žemuogėlė;"VIEVERSIUKAI ";8091000121;Taip;8;0;0;8
13624;Žemuogėlė;"VIEVERSIUKAI ";2110963483;Taip;20;0;1;21
13625;Žemuogėlė;"VIEVERSIUKAI ";2574719380;Taip;16;0;0;16
13626;Žemuogėlė;"NYKŠTUKAI ";9205221446;Taip;11;0;0;11
13627;Žemuogėlė;"NYKŠTUKAI ";2655733505;Taip;8;0;0;8
13628;Žemuogėlė;"NYKŠTUKAI ";1911605637;Taip;11;0;0;11
13629;Žemuogėlė;"NYKŠTUKAI ";9798128294;Taip;25;0;0;25
13630;Žemuogėlė;"NYKŠTUKAI ";1916826391;Taip;5;0;0;5
13631;Žemuogėlė;"NYKŠTUKAI ";5948873766;Ne;4;0;0;4
13632;Žemuogėlė;"NYKŠTUKAI ";3010585170;Taip;0;18;0;18
13633;Žemuogėlė;"NYKŠTUKAI ";1769751604;Taip;22;0;0;22
13634;Žemuogėlė;"NYKŠTUKAI ";3462564692;Taip;24;0;0;24
13635;Žemuogėlė;"NYKŠTUKAI ";7565473877;Taip;4;0;0;4
13636;Žemuogėlė;"NYKŠTUKAI ";8211122634;Taip;4;0;0;4
13637;Žemuogėlė;"NYKŠTUKAI ";8706639942;Taip;12;0;0;12
13638;Žemuogėlė;"NYKŠTUKAI ";4180815331;Taip;13;0;0;13
13639;Žemuogėlė;"NYKŠTUKAI ";9290074229;Taip;7;0;0;7
13640;Žemuogėlė;"NYKŠTUKAI ";1601617523;Taip;20;0;0;20
13641;Žemuogėlė;KIŠKUČIAI;3467743802;Taip;16;0;0;16
13642;Žemuogėlė;KIŠKUČIAI;8584425313;Taip;7;4;0;11
13643;Žemuogėlė;KIŠKUČIAI;7423719480;Taip;15;1;0;16
13644;Žemuogėlė;KIŠKUČIAI;9889748260;Taip;7;0;0;7
13645;Žemuogėlė;KIŠKUČIAI;3385450072;Taip;6;1;0;7
13646;Žemuogėlė;KIŠKUČIAI;3842157786;Taip;5;2;0;7
13647;Žemuogėlė;KIŠKUČIAI;6557523361;Ne;4;0;0;4
13648;Žemuogėlė;KIŠKUČIAI;9153455673;Taip;10;0;0;10
13649;Žemuogėlė;KIŠKUČIAI;2091617436;Taip;26;0;0;26
13650;Žemuogėlė;KIŠKUČIAI;9501717210;Taip;26;0;0;26
13651;Žemuogėlė;KIŠKUČIAI;6901260056;Taip;0;3;0;3
13652;Žemuogėlė;KIŠKUČIAI;7263992351;Taip;0;8;0;8
13653;Žemuogėlė;KIŠKUČIAI;7508582586;Taip;10;0;0;10
13654;Žemuogėlė;Žiniukai;1306065826;Taip;0;4;0;4
13655;Žemuogėlė;Žiniukai;8106709288;Taip;8;5;0;13
13656;Žemuogėlė;Žiniukai;2664267604;Taip;23;1;0;24
13657;Žemuogėlė;Žiniukai;9150335499;Taip;15;0;0;15
13658;Žemuogėlė;Žiniukai;7794377881;Taip;8;0;4;12
13659;Žemuogėlė;Žiniukai;1658954821;Taip;8;2;1;11
13660;Žemuogėlė;Žiniukai;4698671798;Taip;11;0;0;11
13661;Žemuogėlė;Žiniukai;1079114347;Taip;0;1;0;1
13662;Žemuogėlė;Žiniukai;5902241163;Ne;10;2;0;12
13663;Žemuogėlė;Žiniukai;7879519193;Taip;8;2;2;12
13664;Žemuogėlė;Žiniukai;2922827304;Taip;9;9;0;18
13665;Žemuogėlė;Žiniukai;2109195565;Taip;11;0;0;11
13666;Žemuogėlė;Žiniukai;7415364637;Taip;6;5;0;11
13667;Žemuogėlė;Žiniukai;3710681463;Taip;12;4;0;16
13668;Žemuogėlė;Žiniukai;1796489729;Taip;0;1;0;1
13669;Žemuogėlė;Žiniukai;8215763877;Taip;0;2;0;2
13670;Žemuogėlė;Žiniukai;2934225120;Taip;21;0;0;21
13671;Žemuogėlė;Žiniukai;3426685084;Taip;21;1;0;22
13672;Žibutė;PELĖDŽIUKAI;3777544301;Taip;1;4;0;5
13673;Žibutė;PELĖDŽIUKAI;1362419302;Taip;1;1;0;2
13674;Žibutė;PELĖDŽIUKAI;9634311146;Taip;0;2;0;2
13675;Žibutė;PELĖDŽIUKAI;5677389434;Taip;0;5;0;5
13676;Žibutė;PELĖDŽIUKAI;5416015554;Taip;1;1;0;2
13677;Žibutė;PELĖDŽIUKAI;1366469428;Taip;0;1;0;1
13678;Žibutė;PELĖDŽIUKAI;4825064521;Taip;11;0;0;11
13679;Žibutė;PELĖDŽIUKAI;5826523148;Taip;0;3;0;3
13680;Žibutė;PELĖDŽIUKAI;7531027545;Taip;1;1;0;2
13681;Žibutė;PELĖDŽIUKAI;4382812297;Taip;2;0;0;2
13682;Žibutė;PELĖDŽIUKAI;8880329060;Taip;6;0;0;6
13683;Žibutė;PELĖDŽIUKAI;9868621666;Ne;1;1;0;2
13684;Žibutė;PELĖDŽIUKAI;5009495840;Taip;2;0;0;2
13685;Žibutė;PELĖDŽIUKAI;7136145033;Taip;3;0;0;3
13686;Žibutė;PELĖDŽIUKAI;6978977383;Taip;0;2;0;2
13687;Žibutė;PELĖDŽIUKAI;2880593326;Taip;0;1;0;1
13688;Žibutė;PELĖDŽIUKAI;7479437931;Taip;0;2;0;2
13689;Žibutė;PELĖDŽIUKAI;9498011134;Taip;2;4;0;6
13690;Žibutė;KREGŽDUTĖS;7036454359;Taip;5;0;1;6
13691;Žibutė;KREGŽDUTĖS;3555071718;Taip;6;4;0;10
13692;Žibutė;KREGŽDUTĖS;5187777741;Taip;4;0;0;4
13693;Žibutė;KREGŽDUTĖS;5190377896;Taip;9;4;0;13
13694;Žibutė;KREGŽDUTĖS;6013340521;Taip;0;1;0;1
13695;Žibutė;KREGŽDUTĖS;3574946816;Taip;2;0;0;2
13696;Žibutė;KREGŽDUTĖS;9923687090;Taip;14;6;0;20
13697;Žibutė;KREGŽDUTĖS;4847295068;Taip;9;0;0;9
13698;Žibutė;KREGŽDUTĖS;9700866512;Taip;3;0;0;3
13699;Žibutė;KREGŽDUTĖS;7774532200;Taip;0;9;0;9
13700;Žibutė;KREGŽDUTĖS;2607509585;Taip;0;3;0;3
13701;Žibutė;KREGŽDUTĖS;8944042589;Taip;5;1;0;6
13702;Žibutė;KREGŽDUTĖS;2438980348;Taip;0;2;1;3
13703;Žibutė;KREGŽDUTĖS;9918283923;Taip;1;2;0;3
13704;Žibutė;KREGŽDUTĖS;5126232169;Taip;12;0;0;12
13705;Žibutė;KREGŽDUTĖS;8792292819;Taip;7;0;0;7
13706;Žibutė;KREGŽDUTĖS;7668484415;Taip;0;8;0;8
13707;Žibutė;KREGŽDUTĖS;2516448580;Taip;0;4;0;4
13708;Žibutė;BORUŽĖLĖS;5430856044;Taip;8;0;0;8
13709;Žibutė;BORUŽĖLĖS;8303166103;Taip;11;0;0;11
13710;Žibutė;BORUŽĖLĖS;4708691611;Taip;15;0;6;21
13711;Žibutė;BORUŽĖLĖS;9116859942;Taip;15;2;0;17
13712;Žibutė;BORUŽĖLĖS;1730975120;Taip;15;3;2;20
13713;Žibutė;BORUŽĖLĖS;9547812966;Taip;10;0;0;10
13714;Žibutė;BORUŽĖLĖS;7738606888;Taip;8;0;4;12
13715;Žibutė;BORUŽĖLĖS;6072605005;Taip;3;2;0;5
13716;Žibutė;BORUŽĖLĖS;8423264689;Taip;16;0;1;17
13717;Žibutė;BORUŽĖLĖS;7683703528;Taip;8;0;0;8
13718;Žibutė;BORUŽĖLĖS;5462787553;Taip;7;0;0;7
13719;Žibutė;BORUŽĖLĖS;3258258046;Taip;9;0;0;9
13720;Žibutė;BORUŽĖLĖS;9127784681;Taip;8;0;0;8
13721;Žibutė;BORUŽĖLĖS;6209156111;Taip;4;7;0;11
13722;Žibutė;BITUTĖS;7023683517;Taip;0;1;0;1
13723;Žibutė;BITUTĖS;3687123871;Ne;1;0;0;1
13724;Žibutė;BITUTĖS;2312717334;Taip;11;0;0;11
13725;Žibutė;BITUTĖS;6361543454;Taip;3;0;0;3
13726;Žibutė;BITUTĖS;1297347740;Taip;1;0;0;1
13727;Žibutė;BITUTĖS;6934760468;Taip;2;0;0;2
13728;Žibutė;BITUTĖS;4455757640;Taip;10;0;0;10
13729;Žibutė;BITUTĖS;8797870379;Taip;2;0;0;2
13730;Žibutė;BITUTĖS;7792267540;Taip;16;0;0;16
13731;Žibutė;BITUTĖS;3632745935;Taip;9;0;0;9
13732;Žibutė;BITUTĖS;7611641692;Taip;2;8;0;10
13733;Žibutė;BITUTĖS;5112512917;Ne;8;0;0;8
13734;Žibutė;BITUTĖS;8276724226;Taip;2;0;0;2
13735;Žibutė;BITUTĖS;4685356158;Taip;4;0;0;4
13736;Žibutė;BITUTĖS;1515636796;Taip;19;1;0;20
13737;Žibutė;BITUTĖS;7872636200;Taip;6;1;0;7
13738;Žibutė;BITUTĖS;6833179680;Taip;8;0;0;8
13739;Žibutė;BITUTĖS;1614551884;Taip;13;0;0;13
13740;Žibutė;KAČIUKAI;9611892163;Taip;6;4;0;10
13741;Žibutė;KAČIUKAI;1786332689;Taip;3;3;0;6
13742;Žibutė;KAČIUKAI;3618347199;Taip;0;1;0;1
13743;Žibutė;KAČIUKAI;7764376193;Taip;18;0;0;18
13744;Žibutė;KAČIUKAI;8879347884;Taip;12;0;0;12
13745;Žibutė;KAČIUKAI;7608622330;Taip;0;0;1;1
13746;Žibutė;KAČIUKAI;5186839413;Taip;4;0;0;4
13747;Žibutė;KAČIUKAI;4278832423;Taip;19;0;0;19
13748;Žibutė;KAČIUKAI;1381488132;Taip;2;0;1;3
13749;Žibutė;KAČIUKAI;4622674814;Taip;5;1;0;6
13750;Žibutė;KAČIUKAI;5632520305;Taip;0;0;2;2
13751;Žibutė;KAČIUKAI;7805758264;Taip;0;0;1;1
13752;Žibutė;KAČIUKAI;6672033757;Taip;15;0;0;15
13753;Žibutė;KAČIUKAI;8155327668;Taip;4;0;0;4
13754;Žibutė;KAČIUKAI;2374119662;Taip;0;0;1;1
13755;Žibutė;ZUIKIAI;5326761360;Taip;12;0;0;12
13756;Žibutė;ZUIKIAI;4741505387;Taip;9;0;0;9
13757;Žibutė;ZUIKIAI;2787326978;Taip;13;0;0;13
13758;Žibutė;ZUIKIAI;4787010953;Taip;2;1;0;3
13759;Žibutė;ZUIKIAI;9645026432;Taip;15;9;0;24
13760;Žibutė;ZUIKIAI;3875455223;Taip;1;8;0;9
13761;Žibutė;ZUIKIAI;3449188614;Taip;11;1;0;12
13762;Žibutė;ZUIKIAI;4434623264;Taip;10;4;0;14
13763;Žibutė;ZUIKIAI;9769180056;Taip;18;4;0;22
13764;Žibutė;ZUIKIAI;2013724729;Taip;4;0;0;4
13765;Žibutė;ZUIKIAI;3786933891;Taip;7;0;0;7
13766;Žibutė;ZUIKIAI;9379539151;Taip;5;0;0;5
13767;Žibutė;ZUIKIAI;6234135622;Taip;13;0;0;13
13768;Žibutė;ZUIKIAI;8585964720;Taip;9;0;0;9
13769;Žibutė;ZUIKIAI;9793570682;Taip;13;1;0;14
13770;Žibutė;ZUIKIAI;6618315401;Taip;22;0;0;22
13771;Žibutė;ZUIKIAI;6290821274;Taip;14;0;0;14
13772;Žibutė;ZUIKIAI;5045628452;Ne;0;8;0;8
13773;Žiedas;Bitutės;8208331527;Taip;0;14;0;14
13774;Žiedas;Bitutės;9140396365;Taip;0;3;2;5
13775;Žiedas;Bitutės;8148831014;Taip;0;7;2;9
13776;Žiedas;Bitutės;3230107921;Taip;2;1;0;3
13777;Žiedas;Bitutės;3178778438;Taip;0;8;0;8
13778;Žiedas;Bitutės;9602083568;Taip;14;4;0;18
13779;Žiedas;Bitutės;5061575884;Taip;5;2;0;7
13780;Žiedas;Bitutės;5628720422;Taip;0;3;0;3
13781;Žiedas;Bitutės;1582961378;Taip;0;4;0;4
13782;Žiedas;Bitutės;9020540780;Taip;0;4;0;4
13783;Žiedas;Bitutės;5578227349;Taip;0;2;0;2
13784;Žiedas;Bitutės;6914059680;Ne;2;1;0;3
13785;Žiedas;Bitutės;7771247056;Taip;4;1;0;5
13786;Žiedas;Bitutės;6515510381;Taip;10;0;0;10
13787;Žiedas;Bitutės;3842589827;Taip;12;0;1;13
13788;Žiedas;Bitutės;1043230748;Taip;5;0;1;6
13789;Žiedas;Bitutės;5835309107;Taip;0;2;0;2
13790;Žiedas;Bitutės;3387263016;Taip;6;0;0;6
13791;Žiedas;Bitutės;3178580610;Taip;0;1;0;1
13792;Žiedas;Varpeliai;5830738378;Taip;4;0;1;5
13793;Žiedas;Varpeliai;2320543511;Taip;0;4;0;4
13794;Žiedas;Varpeliai;4699833757;Taip;0;2;0;2
13795;Žiedas;Varpeliai;7780469974;Taip;6;1;0;7
13796;Žiedas;Varpeliai;4360175072;Taip;5;2;0;7
13797;Žiedas;Varpeliai;2149342412;Taip;0;1;0;1
13798;Žiedas;Varpeliai;1086714229;Taip;7;9;0;16
13799;Žiedas;Varpeliai;3051211643;Taip;0;1;0;1
13800;Žiedas;Varpeliai;7445583512;Ne;1;2;0;3
13801;Žiedas;Varpeliai;2714272604;Taip;14;0;0;14
13802;Žiedas;Varpeliai;8539301771;Taip;18;0;0;18
13803;Žiedas;Varpeliai;2321239854;Taip;7;3;0;10
13804;Žiedas;Varpeliai;2680021778;Taip;4;0;0;4
13805;Žiedas;Varpeliai;9012779767;Taip;8;0;0;8
13806;Žiedas;Varpeliai;9400503719;Taip;6;0;0;6
13807;Žiedas;Varpeliai;2884725931;Taip;12;1;0;13
13808;Žiedas;Ramunėlės;3055218791;Taip;0;1;0;1
13809;Žiedas;Ramunėlės;1333555044;Taip;11;0;0;11
13810;Žiedas;Ramunėlės;5789261620;Taip;8;0;0;8
13811;Žiedas;Ramunėlės;5577339739;Taip;0;5;0;5
13812;Žiedas;Ramunėlės;6884933845;Taip;2;5;0;7
13813;Žiedas;Ramunėlės;1659873036;Taip;4;4;0;8
13814;Žiedas;Ramunėlės;1243169901;Taip;0;1;0;1
13815;Žiedas;Ramunėlės;5920211041;Ne;2;0;0;2
13816;Žiedas;Ramunėlės;4933650089;Taip;0;1;0;1
13817;Žiedas;Ramunėlės;4044156905;Taip;0;8;0;8
13818;Žiedas;Ramunėlės;4844442247;Taip;0;8;0;8
13819;Žiedas;Ramunėlės;8415686253;Taip;10;1;0;11
13820;Žiedas;Ramunėlės;1309242930;Taip;0;1;0;1
13821;Žiedas;Ramunėlės;8797245208;Ne;6;0;0;6
13822;Žiedas;Ramunėlės;5635958124;Taip;4;4;0;8
13823;Žiedas;Ramunėlės;9337317396;Taip;13;0;0;13
13824;Žiedas;Ramunėlės;2320411618;Taip;1;11;0;12
13825;Žiedas;Ramunėlės;1184578906;Ne;2;0;1;3
13826;Žiedas;Pakalnutės;7798930533;Taip;0;11;0;11
13827;Žiedas;Pakalnutės;1094506858;Taip;2;8;0;10
13828;Žiedas;Pakalnutės;9375048835;Taip;6;3;0;9
13829;Žiedas;Pakalnutės;5266048033;Taip;16;4;0;20
13830;Žiedas;Pakalnutės;5804334198;Taip;0;0;1;1
13831;Žiedas;Pakalnutės;1721956438;Ne;6;1;0;7
13832;Žiedas;Pakalnutės;4808020243;Taip;2;5;0;7
13833;Žiedas;Pakalnutės;3742949697;Taip;10;0;0;10
13834;Žiedas;Pakalnutės;6343634478;Taip;3;2;0;5
13835;Žiedas;Pakalnutės;8015880569;Taip;0;3;0;3
13836;Žiedas;Pakalnutės;8857150598;Taip;5;4;0;9
13837;Žiedas;Pakalnutės;2416234016;Taip;5;0;0;5
13838;Žiedas;Pakalnutės;9054709268;Taip;0;3;0;3
13839;Žiedas;Pakalnutės;9964883646;Taip;0;2;0;2
13840;Žiedas;Pakalnutės;4917324037;Taip;0;5;0;5
13841;Žiedas;Pakalnutės;4021189767;Taip;0;4;0;4
13842;Žiedas;Pakalnutės;1346658299;Taip;2;1;0;3
13843;Žiedas;Pakalnutės;4663390744;Taip;0;1;0;1
13844;Žiedas;Pakalnutės;4697477761;Taip;4;1;0;5
13845;Žiedas;Pakalnutės;7678333395;Taip;0;3;0;3
13846;Žiedas;Pakalnutės;9207945616;Taip;2;5;0;7
13847;Žiedas;Pakalnutės;7221702677;Taip;6;0;0;6
13848;Žiedas;Pakalnutės;2393112381;Taip;0;2;0;2
13849;Žiedas;Rožytės;8846443535;Taip;4;1;0;5
13850;Žiedas;Rožytės;7799489700;Taip;0;12;0;12
13851;Žiedas;Rožytės;8927034492;Taip;0;23;0;23
13852;Žiedas;Rožytės;1777501190;Taip;0;1;0;1
13853;Žiedas;Rožytės;1844621525;Ne;0;3;0;3
13854;Žiedas;Rožytės;6459679214;Taip;0;4;0;4
13855;Žiedas;Rožytės;5987689515;Taip;2;4;1;7
13856;Žiedas;Rožytės;1035854293;Taip;0;0;3;3
13857;Žiedas;Rožytės;7584712202;Taip;4;2;0;6
13858;Žiedas;Rožytės;2642760082;Taip;3;1;0;4
13859;Žiedas;Rožytės;1917085385;Taip;0;4;0;4
13860;Žiedas;Rožytės;3099608553;Taip;8;6;0;14
13861;Žiedas;Rožytės;7228139235;Taip;6;4;0;10
13862;Žiedas;Rožytės;1975718197;Taip;4;1;2;7
13863;Žiedas;Rožytės;2312361963;Taip;13;4;0;17
13864;Žiedas;Rožytės;6859410675;Taip;4;4;0;8
13865;Žiedas;Rožytės;1390431397;Taip;2;8;0;10
13866;Žiedas;Rožytės;3490370918;Ne;4;1;0;5
13867;Žiedas;Rožytės;9183582003;Ne;4;1;0;5
13868;Žiedas;Pumpurėliai;1631534238;Taip;10;0;0;10
13869;Žiedas;Pumpurėliai;3994387532;Taip;19;0;0;19
13870;Žiedas;Pumpurėliai;5862164657;Taip;3;0;1;4
13871;Žiedas;Pumpurėliai;9143843408;Taip;10;0;0;10
13872;Žiedas;Pumpurėliai;9833875402;Taip;11;1;0;12
13873;Žiedas;Pumpurėliai;8336518449;Taip;16;0;0;16
13874;Žiedas;Pumpurėliai;8112164640;Taip;7;0;0;7
13875;Žiedas;Pumpurėliai;8592046023;Taip;16;0;0;16
13876;Žiedas;Pumpurėliai;1980594198;Taip;15;0;0;15
13877;Žiedas;Pumpurėliai;5814371567;Taip;8;12;0;20
13878;Žiedas;Pumpurėliai;4854055565;Taip;14;0;0;14
13879;Žiedas;Pumpurėliai;3075660919;Taip;10;0;0;10
13880;Žiedas;Pumpurėliai;7801566777;Taip;9;4;0;13
13881;Žiedas;Pumpurėliai;2013485224;Taip;4;0;1;5
13882;Žiedas;"Dobiliukai ";6066566242;Taip;0;4;0;4
13883;Žiedas;"Dobiliukai ";8436592169;Taip;0;10;0;10
13884;Žiedas;"Dobiliukai ";3654878543;Taip;5;0;2;7
13885;Žiedas;"Dobiliukai ";8794003030;Taip;2;2;0;4
13886;Žiedas;"Dobiliukai ";8444690698;Taip;5;0;4;9
13887;Žiedas;"Dobiliukai ";2715554681;Taip;7;1;0;8
13888;Žiedas;"Dobiliukai ";2132564079;Taip;1;0;1;2
13889;Žiedas;"Dobiliukai ";9586578606;Taip;11;4;0;15
13890;Žiedas;"Dobiliukai ";3940002957;Taip;11;1;0;12
13891;Žiedas;"Dobiliukai ";5353507617;Taip;0;7;0;7
13892;Žiedas;"Dobiliukai ";1610219365;Taip;0;3;0;3
13893;Žiedas;"Dobiliukai ";2794691006;Taip;0;1;2;3
13894;Žiedas;"Dobiliukai ";6665199013;Taip;0;3;0;3
13895;Žiedas;"Dobiliukai ";1852347789;Ne;4;3;0;7
13896;Žiedas;"Dobiliukai ";3284907486;Taip;5;0;1;6
13897;Žiedas;"Dobiliukai ";2633676360;Taip;0;4;9;13
13898;Žiedas;"Dobiliukai ";7677595571;Taip;4;2;2;8
13899;Žiedas;"Dobiliukai ";5106427067;Taip;8;0;0;8
13900;Žiedas;"Dobiliukai ";2182340305;Taip;3;1;0;4
13901;Žiedas;"Dobiliukai ";2402512731;Taip;7;0;4;11
13902;Žiedas;RŪTELĖS;1885623466;Taip;16;2;0;18
13903;Žiedas;RŪTELĖS;9464217926;Taip;0;5;0;5
13904;Žiedas;RŪTELĖS;9543860953;Taip;4;0;0;4
13905;Žiedas;RŪTELĖS;3247328978;Taip;2;2;0;4
13906;Žiedas;RŪTELĖS;4250009129;Taip;2;10;0;12
13907;Žiedas;RŪTELĖS;7399937598;Taip;9;0;0;9
13908;Žiedas;RŪTELĖS;1325715061;Taip;3;0;0;3
13909;Žiedas;RŪTELĖS;9111149805;Taip;4;1;0;5
13910;Žiedas;RŪTELĖS;4695900874;Taip;4;1;0;5
13911;Žiedas;RŪTELĖS;6700593422;Taip;19;0;0;19
13912;Žiedas;RŪTELĖS;6245366671;Taip;4;0;0;4
13913;Žiedas;RŪTELĖS;3835714894;Ne;5;0;0;5
13914;Žiedas;RŪTELĖS;7535993061;Taip;6;1;0;7
13915;Žiedas;RŪTELĖS;1956219718;Taip;0;1;0;1
13916;Žiedas;RŪTELĖS;4809093267;Taip;3;1;0;4
13917;Žiedas;RŪTELĖS;6856477482;Taip;6;4;0;10
13918;Žiedas;RŪTELĖS;1874460511;Taip;8;3;0;11
13919;Žiedas;RŪTELĖS;7150427502;Taip;0;5;0;5
13920;Žiedas;RŪTELĖS;1562699898;Taip;8;4;0;12
13921;Žiedas;RŪTELĖS;6312115234;Taip;2;0;0;2
13922;Žiedas;RŪTELĖS;3831917542;Taip;12;1;0;13
13923;Žiedas;RŪTELĖS;1669599543;Taip;15;0;0;15
13924;Žiedas;SAULĖGRĄŽOS;1011602827;Taip;0;1;0;1
13925;Žiedas;SAULĖGRĄŽOS;2932857132;Taip;2;4;2;8
13926;Žiedas;SAULĖGRĄŽOS;5552786845;Taip;4;9;1;14
13927;Žiedas;SAULĖGRĄŽOS;8833895006;Taip;0;2;0;2
13928;Žiedas;SAULĖGRĄŽOS;5658235821;Taip;12;0;0;12
13929;Žiedas;SAULĖGRĄŽOS;4992446383;Taip;6;0;0;6
13930;Žiedas;SAULĖGRĄŽOS;1645402434;Taip;0;1;0;1
13931;Žiedas;SAULĖGRĄŽOS;2026540724;Taip;0;1;0;1
13932;Žiedas;SAULĖGRĄŽOS;4564268323;Taip;0;7;0;7
13933;Žiedas;SAULĖGRĄŽOS;1609487830;Taip;9;0;1;10
13934;Žiedas;SAULĖGRĄŽOS;3437651010;Taip;0;3;1;4
13935;Žiedas;SAULĖGRĄŽOS;3422053505;Taip;2;9;0;11
13936;Žiedas;SAULĖGRĄŽOS;5274845525;Taip;3;1;0;4
13937;Žiedas;SAULĖGRĄŽOS;7057747531;Taip;0;5;0;5
13938;Žiedas;SAULĖGRĄŽOS;8819018248;Taip;0;4;0;4
13939;Žiedas;SAULĖGRĄŽOS;7604200899;Taip;0;4;0;4
13940;Žiedas;SAULĖGRĄŽOS;2134466899;Taip;4;4;0;8
13941;Žiedas;SAULĖGRĄŽOS;6822887260;Taip;0;7;0;7
13942;Žiedas;SAULĖGRĄŽOS;7172793351;Taip;1;1;0;2
13943;Žiedas;RUGIAGĖLĖS;1826599535;Taip;8;0;0;8
13944;Žiedas;RUGIAGĖLĖS;3477341028;Taip;0;8;0;8
13945;Žiedas;RUGIAGĖLĖS;2124086277;Taip;0;0;1;1
13946;Žiedas;RUGIAGĖLĖS;7381658912;Taip;9;0;1;10
13947;Žiedas;RUGIAGĖLĖS;2148027253;Taip;3;0;0;3
13948;Žiedas;RUGIAGĖLĖS;1758868055;Taip;6;0;0;6
13949;Žiedas;RUGIAGĖLĖS;1958481432;Taip;2;0;1;3
13950;Žiedas;RUGIAGĖLĖS;9393499257;Taip;4;3;0;7
13951;Žiedas;RUGIAGĖLĖS;8276022676;Taip;11;0;1;12
13952;Žiedas;RUGIAGĖLĖS;7418985667;Taip;0;1;0;1
13953;Žiedas;RUGIAGĖLĖS;6766710113;Taip;11;2;0;13
13954;Žiedas;RUGIAGĖLĖS;1835893385;Taip;1;1;1;3
13955;Žiedas;RUGIAGĖLĖS;3654749109;Taip;1;3;0;4
13956;Žiedas;RUGIAGĖLĖS;2913328259;Taip;16;0;0;16
13957;Žiedas;RUGIAGĖLĖS;4568189195;Taip;6;1;0;7
13958;Žiedas;RUGIAGĖLĖS;7114207461;Taip;3;1;1;5
13959;Žiedas;RUGIAGĖLĖS;3407247493;Taip;3;0;2;5
13960;Žiedas;RUGIAGĖLĖS;6923562927;Taip;14;0;0;14
13961;Žiedas;RUGIAGĖLĖS;1509140770;Taip;5;0;0;5
13962;Žiedas;RUGIAGĖLĖS;7498211984;Taip;4;0;0;4
13963;Žiedas;RUGIAGĖLĖS;3948942801;Taip;5;0;0;5
13964;Žiedas;RUGIAGĖLĖS;7441475685;Taip;13;0;0;13
13965;Žiedas;Boružėlės;9685152753;Taip;0;0;1;1
13966;Žiedas;Boružėlės;9218388800;Taip;0;5;0;5
13967;Žiedas;Boružėlės;5420327672;Taip;0;0;1;1
13968;Žiedas;Boružėlės;9352485926;Taip;0;1;1;2
13969;Žiedas;Boružėlės;5914428064;Taip;0;4;0;4
13970;Žiedas;Boružėlės;3857121753;Taip;2;3;2;7
13971;Žiedas;Boružėlės;6443633568;Taip;0;4;0;4
13972;Žiedas;Boružėlės;7491134119;Taip;0;2;0;2
13973;Žiedas;Boružėlės;5959899914;Taip;5;3;0;8
13974;Žiedas;Boružėlės;7333813704;Taip;0;3;0;3
13975;Žiedas;Boružėlės;3715928992;Taip;2;1;0;3
13976;Žiedas;Boružėlės;6658762922;Taip;0;4;0;4
13977;Žiedas;Boružėlės;5703750436;Taip;0;3;0;3
13978;Žiedas;Boružėlės;7578964555;Taip;0;1;0;1
13979;Žiedas;Boružėlės;5126173608;Taip;0;6;0;6
13980;Žiedas;Boružėlės;7072578987;Taip;4;4;3;11
13981;Žiedas;Boružėlės;5647232875;Taip;4;0;0;4
13982;Žiedas;Boružėlės;4497634040;Taip;0;8;0;8
13983;Žiedas;Boružėlės;1738121071;Taip;0;3;0;3
13984;Žiedas;AGUONĖLĖS;5518670127;Taip;15;0;0;15
13985;Žiedas;AGUONĖLĖS;2846835865;Taip;8;0;0;8
13986;Žiedas;AGUONĖLĖS;6162306565;Taip;10;0;1;11
13987;Žiedas;AGUONĖLĖS;5211681615;Taip;8;0;0;8
13988;Žiedas;AGUONĖLĖS;5947851166;Taip;5;2;0;7
13989;Žiedas;AGUONĖLĖS;8978215481;Taip;5;4;0;9
13990;Žiedas;AGUONĖLĖS;7159730702;Taip;9;1;1;11
13991;Žiedas;AGUONĖLĖS;8485801027;Taip;7;0;0;7
13992;Žiedas;AGUONĖLĖS;3634949279;Taip;13;0;0;13
13993;Žiedas;AGUONĖLĖS;1147121060;Taip;5;0;0;5
13994;Žiedas;AGUONĖLĖS;5789381608;Taip;0;4;0;4
13995;Žiedas;AGUONĖLĖS;6635256945;Taip;11;1;0;12
13996;Žiedas;AGUONĖLĖS;1642330461;Taip;9;0;0;9
13997;Žiedas;AGUONĖLĖS;7161235417;Taip;0;0;1;1
13998;Žiedas;AGUONĖLĖS;5177625346;Taip;16;0;0;16
13999;Žiedas;AGUONĖLĖS;4914111970;Taip;15;1;0;16
14000;Žiedas;ŽIBUTĖS;8638720939;Taip;6;4;0;10
14001;Žiedas;ŽIBUTĖS;4039958043;Taip;8;2;0;10
14002;Žiedas;ŽIBUTĖS;9269909624;Taip;4;6;0;10
14003;Žiedas;ŽIBUTĖS;8084555994;Taip;0;4;0;4
14004;Žiedas;ŽIBUTĖS;2935037966;Taip;3;1;0;4
14005;Žiedas;ŽIBUTĖS;3271812706;Taip;2;0;0;2
14006;Žiedas;ŽIBUTĖS;6248399763;Taip;0;2;0;2
14007;Žiedas;ŽIBUTĖS;8163426046;Taip;7;1;0;8
14008;Žiedas;ŽIBUTĖS;4530564746;Taip;5;0;0;5
14009;Žiedas;ŽIBUTĖS;1546447912;Taip;9;0;0;9
14010;Žiedas;ŽIBUTĖS;9202969623;Taip;9;6;0;15
14011;Žiedas;ŽIBUTĖS;3488618084;Taip;0;3;2;5
14012;Žiedas;ŽIBUTĖS;8162441626;Taip;13;0;0;13
14013;Žiedas;ŽIBUTĖS;8651843785;Taip;15;0;0;15
14014;Žiedas;ŽIBUTĖS;9834096834;Taip;11;4;0;15
14015;Žiedas;DRUGELIAI;5028265234;Taip;6;2;0;8
14016;Žiedas;DRUGELIAI;6852487760;Taip;19;0;0;19
14017;Žiedas;DRUGELIAI;8645771800;Taip;6;0;0;6
14018;Žiedas;DRUGELIAI;6041919197;Taip;0;1;0;1
14019;Žiedas;DRUGELIAI;8163645535;Taip;12;0;0;12
14020;Žiedas;DRUGELIAI;2182381160;Taip;4;4;0;8
14021;Žiedas;DRUGELIAI;8822472312;Taip;0;7;0;7
14022;Žiedas;DRUGELIAI;9021286246;Taip;7;2;0;9
14023;Žiedas;DRUGELIAI;6261847845;Taip;0;4;0;4
14024;Žiedas;DRUGELIAI;5020148822;Taip;0;3;0;3
14025;Žiedas;DRUGELIAI;1219634640;Taip;0;3;0;3
14026;Žiedas;DRUGELIAI;2170318597;Taip;4;1;0;5
14027;Žiedas;DRUGELIAI;1333233100;Taip;12;4;0;16
14028;Žiogelis;SKRUZDELYTĖS;2959983278;Taip;4;1;0;5
14029;Žiogelis;SKRUZDELYTĖS;4677024422;Taip;6;0;0;6
14030;Žiogelis;SKRUZDELYTĖS;6165380986;Taip;4;0;0;4
14031;Žiogelis;SKRUZDELYTĖS;5281321968;Taip;6;0;0;6
14032;Žiogelis;SKRUZDELYTĖS;8410428124;Taip;5;0;0;5
14033;Žiogelis;SKRUZDELYTĖS;3214640817;Taip;0;10;0;10
14034;Žiogelis;SKRUZDELYTĖS;1937740173;Taip;0;3;0;3
14035;Žiogelis;SKRUZDELYTĖS;4115425880;Taip;0;2;0;2
14036;Žiogelis;SKRUZDELYTĖS;5737326104;Taip;3;0;0;3
14037;Žiogelis;SKRUZDELYTĖS;2614574694;Taip;5;0;0;5
14038;Žiogelis;SKRUZDELYTĖS;7107814348;Taip;14;4;0;18
14039;Žiogelis;SKRUZDELYTĖS;9243862028;Taip;0;9;0;9
14040;Žiogelis;SKRUZDELYTĖS;7395901559;Taip;10;0;0;10
14041;Žiogelis;SKRUZDELYTĖS;9819352425;Taip;8;1;0;9
14042;Žiogelis;SKRUZDELYTĖS;8780773039;Taip;0;16;0;16
14043;Žiogelis;SKRUZDELYTĖS;7881734492;Taip;1;6;0;7
14044;Žiogelis;SKRUZDELYTĖS;2701091043;Taip;11;0;0;11
14045;Žiogelis;SKRUZDELYTĖS;9330018409;Taip;0;5;0;5
14046;Žiogelis;SKRUZDELYTĖS;9120836406;Taip;7;1;0;8
14047;Žiogelis;SKRUZDELYTĖS;6742462116;Taip;0;12;0;12
14048;Žiogelis;SKRUZDELYTĖS;6608146625;Taip;14;0;0;14
14049;Žiogelis;SKRUZDELYTĖS;9035254979;Taip;18;0;0;18
14050;Žiogelis;SKRUZDELYTĖS;8682279246;Taip;0;1;0;1
14051;Žiogelis;ŽIRNIUKAI;9769735869;Taip;5;0;0;5
14052;Žiogelis;ŽIRNIUKAI;1106149118;Taip;2;1;0;3
14053;Žiogelis;ŽIRNIUKAI;9737574835;Taip;10;0;0;10
14054;Žiogelis;ŽIRNIUKAI;6284764694;Taip;1;6;0;7
14055;Žiogelis;ŽIRNIUKAI;9842311161;Taip;0;3;0;3
14056;Žiogelis;ŽIRNIUKAI;2036243422;Taip;9;0;0;9
14057;Žiogelis;ŽIRNIUKAI;9634291623;Taip;0;1;0;1
14058;Žiogelis;ŽIRNIUKAI;6491130711;Taip;3;0;0;3
14059;Žiogelis;ŽIRNIUKAI;9378236361;Taip;1;0;0;1
14060;Žiogelis;ŽIRNIUKAI;5445409452;Taip;1;0;0;1
14061;Žiogelis;ŽIRNIUKAI;4155916507;Taip;5;0;0;5
14062;Žiogelis;ŽIRNIUKAI;4623532521;Taip;0;1;0;1
14063;Žiogelis;ŽIRNIUKAI;6988180082;Taip;10;0;0;10
14064;Žiogelis;ŽIRNIUKAI;4677227753;Taip;10;0;0;10
14065;Žiogelis;ŽIRNIUKAI;5996045442;Taip;15;0;0;15
14066;Žiogelis;ŽIRNIUKAI;5527793395;Taip;2;11;0;13
14067;Žiogelis;ŽIRNIUKAI;4974459437;Taip;14;0;0;14
14068;Žiogelis;ŽIRNIUKAI;8664568879;Taip;0;1;0;1
14069;Žiogelis;ŽIRNIUKAI;9941105459;Taip;9;7;0;16
14070;Žiogelis;ŽIRNIUKAI;3199884855;Taip;17;0;0;17
14071;Žiogelis;ŽIRNIUKAI;5245672298;Taip;14;1;0;15
14072;Žiogelis;ŽIRNIUKAI;7804701635;Taip;4;0;0;4
14073;Žiogelis;DOBILĖLIAI;8485067381;Taip;0;4;0;4
14074;Žiogelis;DOBILĖLIAI;8712788346;Taip;16;0;0;16
14075;Žiogelis;DOBILĖLIAI;7535167450;Taip;6;0;0;6
14076;Žiogelis;DOBILĖLIAI;3361421852;Taip;0;2;0;2
14077;Žiogelis;DOBILĖLIAI;1268908081;Taip;2;1;0;3
14078;Žiogelis;DOBILĖLIAI;3856321373;Taip;4;2;0;6
14079;Žiogelis;DOBILĖLIAI;6378295945;Taip;4;1;0;5
14080;Žiogelis;DOBILĖLIAI;8959934210;Taip;2;2;0;4
14081;Žiogelis;DOBILĖLIAI;8591680136;Taip;0;1;0;1
14082;Žiogelis;DOBILĖLIAI;6980853713;Taip;2;0;0;2
14083;Žiogelis;DOBILĖLIAI;7340918175;Taip;2;1;0;3
14084;Žiogelis;DOBILĖLIAI;5454676924;Taip;1;0;0;1
14085;Žiogelis;DOBILĖLIAI;5487213418;Taip;0;1;0;1
14086;Žiogelis;DOBILĖLIAI;8058231095;Taip;1;2;0;3
14087;Žiogelis;DOBILĖLIAI;7702173581;Taip;0;1;0;1
14088;Žiogelis;DOBILĖLIAI;6593794147;Taip;1;0;0;1
14089;Žiogelis;DOBILĖLIAI;1650284820;Taip;9;0;0;9
14090;Žiogelis;DOBILĖLIAI;6515890056;Taip;0;6;0;6
14091;Žiogelis;DOBILĖLIAI;7310459638;Taip;1;2;0;3
14092;Žiogelis;DOBILĖLIAI;1763603533;Taip;20;0;0;20
14093;Žiogelis;DOBILĖLIAI;9813150014;Taip;9;0;0;9
14094;Žiogelis;BORUŽĖLĖS;8683148826;Taip;9;5;0;14
14095;Žiogelis;BORUŽĖLĖS;6532218580;Taip;7;1;0;8
14096;Žiogelis;BORUŽĖLĖS;1763070523;Taip;0;8;0;8
14097;Žiogelis;BORUŽĖLĖS;2117192553;Taip;1;0;0;1
14098;Žiogelis;BORUŽĖLĖS;3427704550;Ne;4;3;0;7
14099;Žiogelis;BORUŽĖLĖS;5911231906;Taip;0;3;0;3
14100;Žiogelis;BORUŽĖLĖS;1190395481;Taip;0;4;0;4
14101;Žiogelis;BORUŽĖLĖS;6115834138;Taip;14;0;0;14
14102;Žiogelis;BORUŽĖLĖS;1465027680;Taip;8;0;0;8
14103;Žiogelis;BORUŽĖLĖS;4103035195;Taip;0;2;0;2
14104;Žiogelis;BORUŽĖLĖS;5364996984;Taip;5;2;0;7
14105;Žiogelis;BORUŽĖLĖS;9568208184;Taip;5;2;0;7
14106;Žiogelis;BORUŽĖLĖS;6340620973;Ne;6;2;0;8
14107;Žiogelis;BORUŽĖLĖS;3887222613;Taip;0;1;0;1
14108;Žiogelis;BORUŽĖLĖS;9610249055;Taip;0;2;0;2
14109;Žiogelis;BORUŽĖLĖS;3686409773;Taip;5;4;0;9
14110;Žiogelis;BORUŽĖLĖS;2122392982;Taip;1;0;0;1
14111;Žiogelis;DRUGELIAI;2797078863;Taip;23;0;0;23
14112;Žiogelis;DRUGELIAI;3813592739;Taip;4;0;0;4
14113;Žiogelis;DRUGELIAI;3820406417;Taip;0;18;0;18
14114;Žiogelis;DRUGELIAI;9533670829;Taip;10;0;0;10
14115;Žiogelis;DRUGELIAI;1673279182;Taip;5;9;0;14
14116;Žiogelis;DRUGELIAI;9964121573;Taip;18;0;0;18
14117;Žiogelis;DRUGELIAI;2622354022;Taip;10;0;0;10
14118;Žiogelis;DRUGELIAI;2243541285;Taip;10;0;0;10
14119;Žiogelis;DRUGELIAI;3810309354;Taip;23;0;0;23
14120;Žiogelis;DRUGELIAI;2326799191;Taip;2;0;0;2
14121;Žiogelis;DRUGELIAI;1833992163;Taip;15;0;0;15
14122;Žiogelis;DRUGELIAI;2529171444;Taip;4;0;0;4
14123;Žiogelis;DRUGELIAI;4946802677;Taip;1;0;0;1
14124;Žiogelis;DRUGELIAI;8763533677;Taip;8;1;0;9
14125;Žiogelis;DRUGELIAI;4994053705;Taip;9;0;0;9
14126;Žiogelis;DRUGELIAI;2655049586;Taip;6;0;0;6
14127;Žiogelis;DRUGELIAI;4120627587;Taip;4;3;0;7
14128;Žiogelis;PELĖDŽIUKAI;7128248940;Taip;9;0;0;9
14129;Žiogelis;PELĖDŽIUKAI;6709029770;Taip;17;0;0;17
14130;Žiogelis;PELĖDŽIUKAI;7502572217;Taip;11;2;0;13
14131;Žiogelis;PELĖDŽIUKAI;5876904663;Taip;0;4;0;4
14132;Žiogelis;PELĖDŽIUKAI;8217782981;Taip;11;0;0;11
14133;Žiogelis;PELĖDŽIUKAI;7120126547;Taip;0;5;0;5
14134;Žiogelis;PELĖDŽIUKAI;9387048672;Taip;0;14;0;14
14135;Žiogelis;PELĖDŽIUKAI;3937261260;Taip;12;0;0;12
14136;Žiogelis;PELĖDŽIUKAI;8894068297;Taip;4;3;0;7
14137;Žiogelis;PELĖDŽIUKAI;2160862681;Taip;0;2;0;2
14138;Žiogelis;PELĖDŽIUKAI;7725494899;Taip;0;4;0;4
14139;Žiogelis;PELĖDŽIUKAI;1939672072;Taip;6;0;0;6
14140;Žiogelis;PELĖDŽIUKAI;8689074067;Taip;11;0;0;11
14141;Žiogelis;PELĖDŽIUKAI;4565342104;Taip;4;0;0;4
14142;Žiogelis;PELĖDŽIUKAI;1223396469;Taip;0;5;0;5
14143;Žiogelis;PELĖDŽIUKAI;3500076229;Taip;13;6;0;19
14144;Žiogelis;PELĖDŽIUKAI;8715501524;Taip;20;0;0;20
14145;Žiogelis;PELĖDŽIUKAI;6347738933;Taip;10;4;0;14
14146;Žiogelis;PELĖDŽIUKAI;3520393042;Taip;0;2;0;2
14147;Žiogelis;VARPELIAI;8983731310;Taip;0;5;0;5
14148;Žiogelis;VARPELIAI;1954544417;Ne;5;0;0;5
14149;Žiogelis;VARPELIAI;9385596579;Taip;9;0;0;9
14150;Žiogelis;VARPELIAI;1447349850;Taip;5;0;0;5
14151;Žiogelis;VARPELIAI;3752358694;Taip;3;3;0;6
14152;Žiogelis;VARPELIAI;6402784913;Ne;0;2;0;2
14153;Žiogelis;VARPELIAI;4462189852;Taip;0;6;0;6
14154;Žiogelis;VARPELIAI;9470241656;Taip;0;3;0;3
14155;Žiogelis;VARPELIAI;8133583992;Ne;8;3;0;11
14156;Žiogelis;VARPELIAI;2346231162;Ne;3;2;0;5
14157;Žiogelis;VARPELIAI;6658457517;Ne;9;0;0;9
14158;Žiogelis;VARPELIAI;6650891980;Ne;10;1;0;11
14159;Žiogelis;VARPELIAI;1139259000;Taip;14;1;0;15
14160;Žiogelis;VARPELIAI;7992701275;Taip;12;2;0;14
14161;Žiogelis;VARPELIAI;2238709964;Taip;17;1;0;18
14162;Žiogelis;VARPELIAI;5288197445;Taip;0;10;0;10
14163;Žiogelis;VARPELIAI;5336455992;Taip;16;1;0;17
14164;Žiogelis;VARPELIAI;9769801670;Taip;9;0;0;9
14165;Žiogelis;VARPELIAI;3606236367;Taip;8;3;0;11
14166;Žiogelis;VARPELIAI;5115094299;Taip;3;3;0;6
14167;Žiogelis;VARPELIAI;6942174644;Taip;0;1;0;1
14168;Žiogelis;VARPELIAI;1647252870;Ne;23;0;0;23
14169;Žiogelis;KREGŽDUTĖS;5042341085;Taip;1;4;0;5
14170;Žiogelis;KREGŽDUTĖS;9766966628;Taip;7;0;0;7
14171;Žiogelis;KREGŽDUTĖS;8835394030;Taip;4;1;0;5
14172;Žiogelis;KREGŽDUTĖS;3752355139;Taip;2;0;0;2
14173;Žiogelis;KREGŽDUTĖS;9627583831;Taip;0;5;0;5
14174;Žiogelis;KREGŽDUTĖS;3296450902;Taip;0;4;0;4
14175;Žiogelis;KREGŽDUTĖS;4814936645;Taip;3;0;0;3
14176;Žiogelis;KREGŽDUTĖS;3792114246;Taip;0;2;0;2
14177;Žiogelis;KREGŽDUTĖS;4645245689;Taip;3;0;0;3
14178;Žiogelis;KREGŽDUTĖS;9981130790;Taip;3;4;0;7
14179;Žiogelis;KREGŽDUTĖS;4605250897;Taip;0;4;0;4
14180;Žiogelis;KREGŽDUTĖS;3820534331;Taip;0;4;0;4
14181;Žiogelis;KREGŽDUTĖS;4630381709;Taip;0;2;0;2
14182;Žiogelis;KREGŽDUTĖS;9790463889;Ne;4;4;0;8
14183;Žiogelis;KREGŽDUTĖS;9874412804;Taip;0;4;0;4
14184;Žiogelis;KREGŽDUTĖS;6024752960;Taip;0;6;0;6
14185;Žiogelis;KREGŽDUTĖS;8853905367;Taip;0;6;0;6
14186;Žiogelis;KREGŽDUTĖS;1397686161;Taip;14;4;0;18
14187;Žiogelis;KREGŽDUTĖS;2171351454;Taip;0;2;0;2
14188;Žiogelis;KREGŽDUTĖS;2173494736;Taip;0;1;0;1
14189;Žiogelis;KREGŽDUTĖS;1134384178;Taip;2;0;0;2
14190;Žiogelis;KREGŽDUTĖS;4609861306;Taip;2;5;0;7
14191;Žiogelis;KREGŽDUTĖS;2759766559;Taip;0;2;0;2
14192;Žiogelis;ŽVIRBLIUKAI;6718866954;Taip;14;0;0;14
14193;Žiogelis;ŽVIRBLIUKAI;4708377318;Taip;16;1;0;17
14194;Žiogelis;ŽVIRBLIUKAI;8601929848;Taip;2;1;0;3
14195;Žiogelis;ŽVIRBLIUKAI;2028344962;Taip;6;0;0;6
14196;Žiogelis;ŽVIRBLIUKAI;7539495906;Taip;0;4;0;4
14197;Žiogelis;ŽVIRBLIUKAI;2925961701;Taip;11;0;0;11
14198;Žiogelis;ŽVIRBLIUKAI;3407223108;Taip;9;0;0;9
14199;Žiogelis;ŽVIRBLIUKAI;4924536259;Taip;9;0;0;9
14200;Žiogelis;ŽVIRBLIUKAI;1093662117;Taip;9;0;0;9
14201;Žiogelis;ŽVIRBLIUKAI;2540274386;Taip;9;0;0;9
14202;Žiogelis;ŽVIRBLIUKAI;4602474688;Taip;9;0;0;9
14203;Žiogelis;BITUTĖS;5337641310;Taip;4;0;0;4
14204;Žiogelis;BITUTĖS;2771911603;Taip;15;1;0;16
14205;Žiogelis;BITUTĖS;4561384361;Taip;5;0;0;5
14206;Žiogelis;BITUTĖS;6617995346;Taip;4;1;0;5
14207;Žiogelis;BITUTĖS;4755709634;Taip;6;1;0;7
14208;Žiogelis;BITUTĖS;7936785905;Taip;0;8;0;8
14209;Žiogelis;BITUTĖS;2348525913;Taip;10;0;0;10
14210;Žiogelis;BITUTĖS;3628571567;Taip;0;6;0;6
14211;Žiogelis;BITUTĖS;9142952548;Taip;4;2;0;6
14212;Žiogelis;BITUTĖS;4450344120;Taip;13;4;0;17
14213;Žiogelis;BITUTĖS;5223426277;Taip;3;0;0;3
14214;Žiogelis;BITUTĖS;8998694866;Taip;13;0;0;13
14215;Žiogelis;BITUTĖS;3472310047;Taip;0;4;0;4
14216;Žiogelis;BITUTĖS;8018943297;Taip;1;0;0;1
14217;Žiogelis;BITUTĖS;3516143432;Taip;10;0;0;10
14218;Žiogelis;BITUTĖS;2833768296;Taip;0;1;0;1
14219;Žiogelis;BITUTĖS;9918493914;Taip;12;0;0;12
14220;Žiogelis;BITUTĖS;8038242532;Taip;15;0;0;15
14221;Žiogelis;BITUTĖS;2463360858;Taip;4;2;0;6
14222;Žiogelis;BITUTĖS;6857937795;Taip;23;0;0;23
14223;Žiogelis;BITUTĖS;1067136657;Taip;0;1;0;1
14224;Žiogelis;BITUTĖS;9672307977;Taip;16;0;0;16
14225;Žiogelis;BITUTĖS;2799966199;Taip;1;0;0;1
14226;Žiogelis;RIEŠUTĖLIAI;8634114085;Taip;5;0;0;5
14227;Žiogelis;RIEŠUTĖLIAI;6035707604;Taip;5;1;0;6
14228;Žiogelis;RIEŠUTĖLIAI;8743725024;Taip;11;0;0;11
14229;Žiogelis;RIEŠUTĖLIAI;9869864499;Taip;1;0;0;1
14230;Žiogelis;RIEŠUTĖLIAI;8652050979;Taip;8;2;0;10
14231;Žiogelis;RIEŠUTĖLIAI;6470463492;Taip;6;3;0;9
14232;Žiogelis;RIEŠUTĖLIAI;6313053720;Taip;4;0;0;4
14233;Žiogelis;RIEŠUTĖLIAI;5146366874;Taip;21;0;0;21
14234;Žiogelis;RIEŠUTĖLIAI;2454569485;Taip;15;0;0;15
14235;Žiogelis;RIEŠUTĖLIAI;1578732378;Taip;18;0;0;18
14236;Žiogelis;RIEŠUTĖLIAI;3242570582;Taip;11;0;0;11
14237;Žiogelis;RIEŠUTĖLIAI;7001506215;Taip;8;0;0;8
14238;Žiogelis;RIEŠUTĖLIAI;9783948483;Taip;4;0;0;4
14239;Žiogelis;PAKALNUTĖS;9863503924;Taip;5;4;0;9
14240;Žiogelis;PAKALNUTĖS;9144282935;Taip;6;0;0;6
14241;Žiogelis;PAKALNUTĖS;6039409252;Taip;5;0;0;5
14242;Žiogelis;PAKALNUTĖS;2275123126;Taip;4;0;0;4
14243;Žiogelis;PAKALNUTĖS;4587838884;Taip;2;18;0;20
14244;Žiogelis;PAKALNUTĖS;6048534817;Taip;12;0;0;12
14245;Žiogelis;PAKALNUTĖS;5133034709;Taip;5;0;0;5
14246;Žiogelis;PAKALNUTĖS;8303283893;Taip;8;1;0;9
14247;Žiogelis;PAKALNUTĖS;2724389716;Taip;19;0;0;19
14248;Žiogelis;PAKALNUTĖS;7763941077;Taip;4;9;0;13
14249;Žiogelis;PAKALNUTĖS;7008807839;Taip;7;0;0;7
14250;Žiogelis;PAKALNUTĖS;5984496369;Taip;0;5;0;5
14251;Žiogelis;PAKALNUTĖS;5475797764;Taip;6;0;0;6
14252;Žiogelis;PAKALNUTĖS;4376301940;Taip;4;0;0;4
14253;Žiogelis;PAKALNUTĖS;2177479618;Taip;16;0;0;16
14254;Žiogelis;PAKALNUTĖS;6213118462;Taip;0;12;0;12
14255;Žolynėlis;Spanguolėlė;8810441600;Taip;5;0;0;5
14256;Žolynėlis;Spanguolėlė;6440991320;Taip;23;0;0;23
14257;Žolynėlis;Spanguolėlė;3631138915;Taip;15;0;0;15
14258;Žolynėlis;Spanguolėlė;5218448120;Taip;0;3;1;4
14259;Žolynėlis;Spanguolėlė;4076450179;Taip;4;5;0;9
14260;Žolynėlis;Spanguolėlė;4494255525;Taip;3;6;0;9
14261;Žolynėlis;Spanguolėlė;2493633505;Taip;0;0;9;9
14262;Žolynėlis;Spanguolėlė;5208585298;Taip;0;1;0;1
14263;Žolynėlis;Spanguolėlė;7451189254;Taip;7;0;0;7
14264;Žolynėlis;Spanguolėlė;9498369210;Taip;4;1;0;5
14265;Žolynėlis;Spanguolėlė;7260397656;Taip;10;1;0;11
14266;Žolynėlis;Spanguolėlė;2315947380;Taip;4;0;0;4
14267;Žolynėlis;Spanguolėlė;5074658392;Taip;4;0;0;4
14268;Žolynėlis;Spanguolėlė;6288526291;Taip;2;1;0;3
14269;Žolynėlis;Spanguolėlė;7234022613;Ne;0;1;0;1
14270;Žolynėlis;Spanguolėlė;3222329369;Taip;18;0;0;18
14271;Žolynėlis;"SAULUTĖ (spec)";9675783636;Taip;23;0;0;23
14272;Žolynėlis;"SAULUTĖ (spec)";7962304738;Taip;2;2;0;4
14273;Žolynėlis;"SAULUTĖ (spec)";3934182673;Taip;8;1;0;9
14274;Žolynėlis;"SAULUTĖ (spec)";8588753136;Taip;14;1;0;15
14275;Žolynėlis;"SAULUTĖ (spec)";9507509872;Taip;0;10;0;10
14276;Žolynėlis;"LINELIS (spec)";8930536051;Taip;9;0;0;9
14277;Žolynėlis;"LINELIS (spec)";6510930436;Taip;10;1;0;11
14278;Žolynėlis;"LINELIS (spec)";6619551947;Taip;9;0;0;9
14279;Žolynėlis;"LINELIS (spec)";4000928238;Taip;10;1;0;11
14280;Žolynėlis;"LINELIS (spec)";5610113641;Taip;0;1;0;1
14281;Žolynėlis;"LINELIS (spec)";6678697536;Taip;21;0;0;21
14282;Žolynėlis;"LINELIS (spec)";3043560150;Taip;10;5;2;17
14283;Žolynėlis;"RASAKILA (spec)";8839037219;Ne;1;0;0;1
14284;Žolynėlis;"RASAKILA (spec)";4481343085;Ne;23;0;0;23
14285;Žolynėlis;"RASAKILA (spec)";8577197481;Taip;12;2;0;14
14286;Žolynėlis;"RASAKILA (spec)";2327996393;Taip;9;4;0;13
14287;Žolynėlis;"RAMUNĖLĖS (spec)";4559404699;Taip;14;0;0;14
14288;Žolynėlis;"RAMUNĖLĖS (spec)";1703785525;Taip;5;3;4;12
14289;Žolynėlis;"RAMUNĖLĖS (spec)";2072569949;Taip;2;1;0;3
14290;Žolynėlis;"RAMUNĖLĖS (spec)";1090944316;Taip;0;1;0;1
14291;Žolynėlis;"RAMUNĖLĖS (spec)";5729519418;Taip;8;0;0;8
14292;Žolynėlis;"RAMUNĖLĖS (spec)";7266224868;Taip;1;1;0;2
14293;Žolynėlis;"RAMUNĖLĖS (spec)";7085655808;Ne;1;1;0;2
14294;Žolynėlis;"RAMUNĖLĖS (spec)";3748657353;Taip;9;5;0;14
14295;Žolynėlis;Dobiliukai;2005661306;Taip;0;6;0;6
14296;Žolynėlis;Dobiliukai;2820649587;Taip;5;2;0;7
14297;Žolynėlis;Dobiliukai;7581436340;Taip;19;4;0;23
14298;Žolynėlis;Dobiliukai;3385748516;Taip;0;17;0;17
14299;Žolynėlis;Dobiliukai;2957426163;Taip;4;0;0;4
14300;Žolynėlis;Dobiliukai;8341730420;Taip;9;0;0;9
14301;Žolynėlis;Dobiliukai;5634886191;Taip;5;2;1;8
14302;Žolynėlis;Dobiliukai;3350246193;Taip;0;11;0;11
14303;Žolynėlis;Dobiliukai;5269388947;Taip;0;3;0;3
14304;Žolynėlis;Dobiliukai;1206144208;Taip;4;1;0;5
14305;Žolynėlis;Dobiliukai;1213384150;Taip;0;9;0;9
14306;Žolynėlis;Dobiliukai;7485033527;Taip;0;4;0;4
14307;Žolynėlis;Dobiliukai;4462289757;Taip;9;0;0;9
14308;Žolynėlis;Dobiliukai;7053810996;Taip;2;7;0;9
14309;Žolynėlis;Dobiliukai;7201413203;Taip;0;2;0;2
14310;Žolynėlis;Dobiliukai;4229530366;Taip;1;14;1;16
14311;Žolynėlis;Aguonėlė;3071570864;Taip;5;2;3;10
14312;Žolynėlis;Aguonėlė;1440666914;Taip;0;1;0;1
14313;Žolynėlis;Aguonėlė;1365534272;Taip;15;0;0;15
14314;Žolynėlis;Aguonėlė;2628636018;Taip;5;5;0;10
14315;Žolynėlis;Aguonėlė;6740105842;Taip;6;1;0;7
14316;Žolynėlis;Aguonėlė;3952731134;Taip;6;0;1;7
14317;Žolynėlis;Aguonėlė;6554864184;Taip;3;2;0;5
14318;Žolynėlis;Aguonėlė;9904373687;Taip;4;0;0;4
14319;Žolynėlis;Aguonėlė;5243624422;Taip;10;2;0;12
14320;Žolynėlis;Aguonėlė;4761054847;Taip;23;0;0;23
14321;Žolynėlis;Aguonėlė;6354832415;Taip;8;0;0;8
14322;Žolynėlis;Aguonėlė;1748987196;Ne;16;2;0;18
14323;Žolynėlis;Aguonėlė;3819863015;Taip;3;0;3;6
14324;Žolynėlis;Aguonėlė;4094173207;Taip;4;0;0;4
14325;Žolynėlis;Aguonėlė;6034854963;Taip;0;11;0;11
14326;Žolynėlis;Aguonėlė;1847470349;Taip;5;0;1;6
14327;Žolynėlis;Pienė;3520272555;Taip;0;1;0;1
14328;Žolynėlis;Pienė;1163753820;Taip;0;6;0;6
14329;Žolynėlis;Pienė;9238832484;Taip;0;1;0;1
14330;Žolynėlis;Pienė;3877168024;Taip;0;4;0;4
14331;Žolynėlis;Pienė;4618251201;Taip;0;8;0;8
14332;Žolynėlis;Pienė;1264022895;Ne;9;4;0;13
14333;Žolynėlis;Pienė;8713225753;Taip;0;5;0;5
14334;Žolynėlis;Pienė;5332349177;Taip;0;0;1;1
14335;Žolynėlis;Pienė;3091749692;Ne;0;4;0;4
14336;Žolynėlis;Pienė;5149512625;Taip;0;7;0;7
14337;Žolynėlis;Pienė;5973298389;Taip;5;4;0;9
14338;Žolynėlis;Pienė;4048788625;Taip;6;2;0;8
14339;Žolynėlis;Pienė;8552635547;Taip;0;1;3;4
14340;Žolynėlis;Pienė;2256262371;Taip;0;7;0;7
14341;Žolynėlis;Čiobreliai;8215427354;Taip;8;2;0;10
14342;Žolynėlis;Čiobreliai;7339496409;Taip;9;1;0;10
14343;Žolynėlis;Čiobreliai;2565770471;Taip;9;0;0;9
14344;Žolynėlis;Čiobreliai;6829144389;Taip;0;5;0;5
14345;Žolynėlis;Čiobreliai;2108221942;Taip;0;2;0;2
14346;Žolynėlis;Čiobreliai;2881461471;Taip;0;3;0;3
14347;Žolynėlis;Čiobreliai;2460982987;Taip;0;4;0;4
14348;Žolynėlis;Čiobreliai;7980206574;Taip;0;5;0;5
14349;Žolynėlis;Čiobreliai;3088932720;Taip;0;5;0;5
14350;Žolynėlis;Čiobreliai;4758738231;Taip;2;6;0;8
14351;Žolynėlis;Čiobreliai;6024288147;Taip;0;3;0;3
14352;Žolynėlis;Čiobreliai;1485195267;Taip;0;4;0;4
14353;Žolynėlis;Čiobreliai;6763515483;Taip;0;7;0;7
14354;Žolynėlis;Čiobreliai;5432464074;Taip;0;6;0;6
14355;Žolynėlis;Čiobreliai;6416217971;Taip;0;10;0;10
14356;Žolynėlis;Čiobreliai;1879046798;Taip;0;23;0;23
14357;Žolynėlis;Čiobreliai;2934361190;Taip;0;9;0;9
14358;Žolynėlis;Avietėlė;4277871671;Ne;0;1;0;1
14359;Žolynėlis;Avietėlė;9404844632;Ne;4;0;0;4
14360;Žolynėlis;Avietėlė;5873931225;Ne;6;0;0;6
14361;Žolynėlis;Avietėlė;1266614631;Taip;0;7;0;7
14362;Žolynėlis;Avietėlė;7855260478;Taip;0;1;0;1
14363;Žolynėlis;Avietėlė;2718255075;Taip;9;1;0;10
14364;Žolynėlis;Avietėlė;6417150398;Taip;0;0;1;1
14365;Žolynėlis;Avietėlė;7517815798;Taip;2;0;0;2
14366;Žolynėlis;Avietėlė;5581675294;Taip;21;0;0;21
14367;Žolynėlis;Avietėlė;1108820859;Taip;6;0;0;6
14368;Žolynėlis;Avietėlė;9905727117;Taip;9;0;0;9
14369;Žolynėlis;Avietėlė;5234937076;Taip;9;0;0;9
14370;Žolynėlis;RŪTELĖ;3293250169;Taip;9;0;1;10
14371;Žolynėlis;RŪTELĖ;9993230229;Taip;0;1;0;1
14372;Žolynėlis;RŪTELĖ;7264446456;Taip;5;6;0;11
14373;Žolynėlis;RŪTELĖ;3857544079;Taip;7;0;0;7
14374;Žolynėlis;RŪTELĖ;3401352504;Taip;4;0;0;4
14375;Žolynėlis;RŪTELĖ;5175997689;Taip;10;4;0;14
14376;Žolynėlis;RŪTELĖ;4780520358;Taip;7;0;1;8
14377;Žolynėlis;RŪTELĖ;3804251134;Taip;0;1;0;1
14378;Žolynėlis;RŪTELĖ;5666650566;Taip;4;0;1;5
14379;Žolynėlis;RŪTELĖ;5769654742;Taip;13;1;0;14
14380;Žolynėlis;RŪTELĖ;6808975784;Taip;0;1;0;1
14381;Žuvėdra;"JŪROS ŽVAIGŽDUTĖS";1200084485;Taip;4;3;0;7
14382;Žuvėdra;"JŪROS ŽVAIGŽDUTĖS";4177319374;Taip;0;3;2;5
14383;Žuvėdra;"JŪROS ŽVAIGŽDUTĖS";7121154799;Taip;0;16;0;16
14384;Žuvėdra;"JŪROS ŽVAIGŽDUTĖS";7710853637;Taip;4;5;0;9
14385;Žuvėdra;"JŪROS ŽVAIGŽDUTĖS";2858729034;Taip;11;2;0;13
14386;Žuvėdra;"JŪROS ŽVAIGŽDUTĖS";6672289932;Taip;0;1;0;1
14387;Žuvėdra;"JŪROS ŽVAIGŽDUTĖS";5571732399;Taip;2;1;1;4
14388;Žuvėdra;"JŪROS ŽVAIGŽDUTĖS";3620753237;Taip;1;0;0;1
14389;Žuvėdra;"JŪROS ŽVAIGŽDUTĖS";1974766090;Taip;0;2;0;2
14390;Žuvėdra;"JŪROS ŽVAIGŽDUTĖS";8869169590;Taip;11;3;0;14
14391;Žuvėdra;"JŪROS ŽVAIGŽDUTĖS";5436158437;Taip;0;1;0;1
14392;Žuvėdra;"JŪROS ŽVAIGŽDUTĖS";2082128566;Taip;0;12;0;12
14393;Žuvėdra;"JŪROS ŽVAIGŽDUTĖS";2582404760;Taip;0;6;0;6
14394;Žuvėdra;"JŪROS ŽVAIGŽDUTĖS";6952843736;Taip;4;0;0;4
14395;Žuvėdra;"JŪROS ŽVAIGŽDUTĖS";8308610070;Taip;0;1;0;1
14396;Žuvėdra;DELFINUKAI;7235005234;Taip;0;0;1;1
14397;Žuvėdra;DELFINUKAI;5876618912;Taip;16;0;0;16
14398;Žuvėdra;DELFINUKAI;6989906913;Taip;0;9;0;9
14399;Žuvėdra;DELFINUKAI;4702627979;Taip;0;1;0;1
14400;Žuvėdra;DELFINUKAI;7803397430;Taip;7;0;0;7
14401;Žuvėdra;DELFINUKAI;7705946236;Taip;16;0;0;16
14402;Žuvėdra;DELFINUKAI;3069506904;Ne;7;0;5;12
14403;Žuvėdra;DELFINUKAI;5913580058;Taip;9;0;1;10
14404;Žuvėdra;DELFINUKAI;9651268462;Taip;14;0;0;14
14405;Žuvėdra;DELFINUKAI;3423051494;Taip;16;0;1;17
14406;Žuvėdra;DELFINUKAI;4881712317;Taip;23;0;0;23
14407;Žuvėdra;DELFINUKAI;1993897043;Taip;11;0;0;11
14408;Žuvėdra;DELFINUKAI;9200342856;Taip;17;0;0;17
14409;Žuvėdra;DELFINUKAI;1604010000;Taip;0;5;0;5
14410;Žuvėdra;DELFINUKAI;2844920302;Taip;3;0;1;4
14411;Žuvėdra;DELFINUKAI;2323431685;Taip;6;0;0;6
14412;Žuvėdra;OSMINOŽKI;5273726957;Taip;3;3;0;6
14413;Žuvėdra;OSMINOŽKI;7630057671;Taip;0;4;0;4
14414;Žuvėdra;OSMINOŽKI;7368183516;Taip;0;12;0;12
14415;Žuvėdra;OSMINOŽKI;3853045274;Taip;0;6;0;6
14416;Žuvėdra;OSMINOŽKI;3185158741;Taip;0;5;0;5
14417;Žuvėdra;OSMINOŽKI;5198825127;Taip;1;4;0;5
14418;Žuvėdra;OSMINOŽKI;5561903903;Taip;2;1;0;3
14419;Žuvėdra;OSMINOŽKI;5818639448;Taip;4;0;0;4
14420;Žuvėdra;OSMINOŽKI;3613045982;Taip;5;0;0;5
14421;Žuvėdra;OSMINOŽKI;7467154866;Taip;3;3;0;6
14422;Žuvėdra;OSMINOŽKI;5151984122;Taip;0;5;0;5
14423;Žuvėdra;OSMINOŽKI;8670342549;Taip;0;1;0;1
14424;Žuvėdra;OSMINOŽKI;6715416675;Taip;3;0;0;3
14425;Žuvėdra;OSMINOŽKI;3349158713;Taip;11;3;0;14
14426;Žuvėdra;OSMINOŽKI;8942228415;Taip;1;0;0;1
14427;Žuvėdra;OSMINOŽKI;4715123063;Taip;0;2;0;2
14428;Žuvėdra;RUSALAČKA;1707519901;Taip;0;4;0;4
14429;Žuvėdra;RUSALAČKA;1810114962;Taip;15;0;0;15
14430;Žuvėdra;RUSALAČKA;1960306957;Taip;0;14;0;14
14431;Žuvėdra;RUSALAČKA;2640238143;Taip;4;0;6;10
14432;Žuvėdra;RUSALAČKA;2577280901;Taip;4;5;0;9
14433;Žuvėdra;RUSALAČKA;9011276878;Taip;0;6;0;6
14434;Žuvėdra;RUSALAČKA;7387863175;Taip;0;10;0;10
14435;Žuvėdra;RUSALAČKA;7464494386;Taip;0;3;0;3
14436;Žuvėdra;RUSALAČKA;3058300342;Taip;0;1;0;1
14437;Žuvėdra;RUSALAČKA;7227722516;Ne;0;2;1;3
14438;Žuvėdra;RUSALAČKA;1219808187;Taip;0;1;0;1
14439;Žuvėdra;RUSALAČKA;7908898376;Taip;0;0;3;3
14440;Žuvėdra;RUSALAČKA;2197976174;Taip;6;0;0;6
14441;Žuvėdra;RUSALAČKA;9838754800;Taip;4;0;0;4
14442;Žuvėdra;RUSALAČKA;3781157324;Taip;12;0;0;12
14443;Žuvėdra;RUSALAČKA;1171751803;Taip;4;0;0;4
14444;Žuvėdra;RUSALAČKA;1039661177;Taip;0;1;1;2
14445;Žuvėdra;RUSALAČKA;6862766787;Ne;0;2;1;3
14446;Žuvėdra;JANTARIKI;1929548863;Taip;2;0;0;2
14447;Žuvėdra;JANTARIKI;1072201019;Taip;5;0;0;5
14448;Žuvėdra;JANTARIKI;9256424331;Taip;8;8;0;16
14449;Žuvėdra;JANTARIKI;9610223932;Taip;4;0;0;4
14450;Žuvėdra;JANTARIKI;9410938471;Taip;4;3;0;7
14451;Žuvėdra;JANTARIKI;1526878181;Taip;19;0;0;19
14452;Žuvėdra;JANTARIKI;5272918949;Taip;0;12;0;12
14453;Žuvėdra;JANTARIKI;1352508839;Taip;0;1;0;1
14454;Žuvėdra;JANTARIKI;8224363978;Taip;7;1;0;8
14455;Žuvėdra;JANTARIKI;1224866951;Taip;2;0;0;2
14456;Žuvėdra;"AUKSINĖ ŽUVELĖ";6287034023;Taip;5;1;0;6
14457;Žuvėdra;"AUKSINĖ ŽUVELĖ";9460887312;Taip;6;2;0;8
14458;Žuvėdra;"AUKSINĖ ŽUVELĖ";5009153711;Taip;4;2;1;7
14459;Žuvėdra;"AUKSINĖ ŽUVELĖ";4739865462;Taip;2;0;0;2
14460;Žuvėdra;"AUKSINĖ ŽUVELĖ";7135848009;Taip;0;0;1;1
14461;Žuvėdra;"AUKSINĖ ŽUVELĖ";9215777054;Taip;9;0;0;9
14462;Žuvėdra;"AUKSINĖ ŽUVELĖ";4217169024;Taip;9;0;0;9
14463;Žuvėdra;"AUKSINĖ ŽUVELĖ";6451721553;Taip;14;0;0;14
14464;Žuvėdra;"AUKSINĖ ŽUVELĖ";4447517071;Taip;2;0;2;4
14465;Žuvėdra;"AUKSINĖ ŽUVELĖ";2118573300;Taip;6;0;0;6
14466;Žvangutis;PELIUKŲ;7722153982;Taip;0;2;0;2
14467;Žvangutis;PELIUKŲ;4295016449;Taip;7;4;0;11
14468;Žvangutis;PELIUKŲ;9958554027;Taip;0;4;0;4
14469;Žvangutis;PELIUKŲ;3957064486;Taip;0;3;0;3
14470;Žvangutis;PELIUKŲ;5817402847;Taip;7;7;0;14
14471;Žvangutis;PELIUKŲ;4407484687;Taip;7;1;0;8
14472;Žvangutis;PELIUKŲ;5638068914;Taip;4;11;0;15
14473;Žvangutis;PELIUKŲ;4337928288;Taip;0;4;0;4
14474;Žvangutis;PELIUKŲ;8062689240;Taip;2;4;0;6
14475;Žvangutis;PELIUKŲ;3875906173;Taip;0;5;0;5
14476;Žvangutis;PELIUKŲ;1328464199;Taip;3;2;2;7
14477;Žvangutis;PELIUKŲ;3546672690;Taip;0;2;0;2
14478;Žvangutis;PELIUKŲ;4992231141;Taip;8;0;0;8
14479;Žvangutis;PELIUKŲ;3408933802;Taip;1;0;0;1
14480;Žvangutis;PELIUKŲ;8481666202;Taip;0;0;2;2
14481;Žvangutis;PELIUKŲ;7844987649;Taip;0;1;0;1
14482;Žvangutis;ANČIUKŲ;5539992579;Taip;0;5;0;5
14483;Žvangutis;ANČIUKŲ;2411307963;Taip;0;4;0;4
14484;Žvangutis;ANČIUKŲ;8295525284;Taip;2;1;0;3
14485;Žvangutis;ANČIUKŲ;6068428687;Taip;0;3;0;3
14486;Žvangutis;ANČIUKŲ;1322688456;Taip;0;1;0;1
14487;Žvangutis;ANČIUKŲ;9468660351;Taip;0;2;0;2
14488;Žvangutis;ANČIUKŲ;9149037184;Taip;6;2;0;8
14489;Žvangutis;ANČIUKŲ;1404378308;Taip;9;4;0;13
14490;Žvangutis;ANČIUKŲ;1185135525;Taip;0;6;1;7
14491;Žvangutis;ANČIUKŲ;5012996199;Taip;0;4;0;4
14492;Žvangutis;ANČIUKŲ;2623107843;Taip;0;4;0;4
14493;Žvangutis;ANČIUKŲ;3276065009;Taip;11;0;0;11
14494;Žvangutis;ANČIUKŲ;5723728310;Taip;4;2;0;6
14495;Žvangutis;ANČIUKŲ;2570379643;Taip;0;5;0;5
14496;Žvangutis;ANČIUKŲ;9036869235;Taip;0;4;0;4
14497;Žvangutis;ANČIUKŲ;2922083476;Taip;1;1;0;2
14498;Žvangutis;ANČIUKŲ;6040986672;Taip;3;3;1;7
14499;Žvangutis;ANČIUKŲ;2716216474;Taip;0;1;0;1
14500;Žvangutis;PELĖDŽIUKŲ;7599491698;Taip;7;0;0;7
14501;Žvangutis;PELĖDŽIUKŲ;6094686500;Taip;0;0;2;2
14502;Žvangutis;PELĖDŽIUKŲ;9711017196;Taip;0;0;1;1
14503;Žvangutis;PELĖDŽIUKŲ;8906823569;Taip;10;4;0;14
14504;Žvangutis;PELĖDŽIUKŲ;8753815074;Taip;6;0;0;6
14505;Žvangutis;PELĖDŽIUKŲ;3781959962;Ne;5;0;0;5
14506;Žvangutis;PELĖDŽIUKŲ;8506809320;Taip;9;2;0;11
14507;Žvangutis;PELĖDŽIUKŲ;8376022173;Taip;4;0;1;5
14508;Žvangutis;PELĖDŽIUKŲ;6825952779;Taip;5;0;0;5
14509;Žvangutis;PELĖDŽIUKŲ;4920234186;Taip;5;4;1;10
14510;Žvangutis;PELĖDŽIUKŲ;8598396569;Taip;0;0;1;1
14511;Žvangutis;PELĖDŽIUKŲ;1590704985;Taip;0;0;1;1
14512;Žvangutis;PELĖDŽIUKŲ;9306755042;Taip;5;0;0;5
14513;Žvangutis;PELĖDŽIUKŲ;2298103025;Taip;7;0;0;7
14514;Žvangutis;PELĖDŽIUKŲ;9523189658;Taip;8;0;0;8
14515;Žvangutis;PELĖDŽIUKŲ;5126809299;Taip;9;0;0;9
14516;Žvangutis;PELĖDŽIUKŲ;9883337991;Taip;15;0;0;15
14517;Žvangutis;PELĖDŽIUKŲ;2308726385;Taip;0;0;1;1
14518;Žvangutis;KAČIUKŲ;7213349517;Taip;1;5;0;6
14519;Žvangutis;KAČIUKŲ;7581320158;Ne;0;2;0;2
14520;Žvangutis;KAČIUKŲ;2296360416;Taip;0;7;0;7
14521;Žvangutis;KAČIUKŲ;2598842770;Taip;1;4;0;5
14522;Žvangutis;KAČIUKŲ;1142315595;Taip;0;4;0;4
14523;Žvangutis;KAČIUKŲ;9239279639;Taip;4;1;0;5
14524;Žvangutis;KAČIUKŲ;4696437804;Taip;0;2;0;2
14525;Žvangutis;KAČIUKŲ;8492637734;Taip;0;6;0;6
14526;Žvangutis;KAČIUKŲ;2503355659;Taip;0;1;0;1
14527;Žvangutis;KAČIUKŲ;8360356476;Taip;3;1;0;4
14528;Žvangutis;KAČIUKŲ;8863909185;Taip;6;5;0;11
14529;Žvangutis;KAČIUKŲ;3498584864;Taip;0;5;0;5
14530;Žvangutis;KAČIUKŲ;4408086513;Taip;0;8;0;8
14531;Žvangutis;KAČIUKŲ;1256264382;Taip;0;9;0;9
14532;Žvangutis;KAČIUKŲ;8030520477;Taip;4;5;0;9
14533;Žvangutis;KAČIUKŲ;5166614226;Taip;1;0;0;1
14534;Žvangutis;KAČIUKŲ;8810739982;Taip;8;0;0;8
14535;Žvangutis;KAČIUKŲ;2740875969;Taip;1;0;0;1
14536;Žvangutis;KAČIUKŲ;8269992031;Ne;3;7;0;10
14537;Žvangutis;MEŠKUČIŲ;5714127995;Taip;0;2;0;2
14538;Žvangutis;MEŠKUČIŲ;8841791656;Taip;3;1;0;4
14539;Žvangutis;MEŠKUČIŲ;5162865213;Taip;6;0;0;6
14540;Žvangutis;MEŠKUČIŲ;8081046191;Taip;16;0;0;16
14541;Žvangutis;MEŠKUČIŲ;2671205721;Taip;12;0;0;12
14542;Žvangutis;MEŠKUČIŲ;8324813274;Taip;10;0;0;10
14543;Žvangutis;MEŠKUČIŲ;7098816023;Taip;6;0;0;6
14544;Žvangutis;MEŠKUČIŲ;3734153710;Taip;16;0;0;16
14545;Žvangutis;MEŠKUČIŲ;5780339899;Taip;10;1;0;11
14546;Žvangutis;MEŠKUČIŲ;6189100246;Taip;9;0;0;9
14547;Žvangutis;MEŠKUČIŲ;6329268519;Taip;12;0;0;12
14548;Žvangutis;MEŠKUČIŲ;5579521166;Taip;5;0;0;5
14549;Žvangutis;MEŠKUČIŲ;9671139568;Taip;10;0;0;10
14550;Žvangutis;KIŠKUČIŲ;1592158260;Taip;14;0;0;14
14551;Žvangutis;KIŠKUČIŲ;7645908955;Taip;2;0;0;2
14552;Žvangutis;KIŠKUČIŲ;3029382724;Taip;1;0;0;1
14553;Žvangutis;KIŠKUČIŲ;4128856598;Taip;3;0;0;3
14554;Žvangutis;KIŠKUČIŲ;4968365511;Taip;9;0;0;9
14555;Žvangutis;KIŠKUČIŲ;5328547183;Taip;9;0;0;9
14556;Žvangutis;KIŠKUČIŲ;6511539983;Taip;4;0;0;4
14557;Žvangutis;KIŠKUČIŲ;4471191112;Taip;4;0;0;4
14558;Žvangutis;KIŠKUČIŲ;3081929677;Taip;4;0;1;5
14559;Žvangutis;KIŠKUČIŲ;6768957624;Taip;2;0;0;2
14560;Žvangutis;KIŠKUČIŲ;8233392333;Taip;9;0;0;9
14561;Žvangutis;KIŠKUČIŲ;2284700283;Taip;15;0;0;15
14562;Žvangutis;KIŠKUČIŲ;9292902597;Taip;7;0;0;7
14563;Žirniukas;Boružiukų;5311746004;Taip;0;0;21;21
14564;Žirniukas;Boružiukų;2476906136;Taip;0;2;0;2
14565;Žirniukas;Boružiukų;6363169823;Taip;11;1;0;12
14566;Žirniukas;Boružiukų;2636634198;Taip;0;4;0;4
14567;Žirniukas;Boružiukų;8148254025;Ne;10;0;0;10
14568;Žirniukas;Boružiukų;3022672028;Taip;11;5;0;16
14569;Žirniukas;Boružiukų;9896989995;Taip;0;2;0;2
14570;Žirniukas;Boružiukų;7397202752;Taip;0;5;3;8
14571;Žirniukas;Boružiukų;4233026576;Taip;0;0;1;1
14572;Žirniukas;Boružiukų;6598851580;Taip;4;0;4;8
14573;Žirniukas;Boružiukų;7965050711;Taip;0;0;1;1
14574;Žirniukas;Boružiukų;9986289837;Taip;9;0;0;9
14575;Žirniukas;Boružiukų;7872611724;Taip;6;2;0;8
14576;Žirniukas;Boružiukų;3189741449;Taip;5;0;0;5
14577;Žirniukas;Boružiukų;2140863010;Taip;0;0;21;21
14578;Žirniukas;Smalsučiai;6096664609;Taip;0;3;0;3
14579;Žirniukas;Smalsučiai;1074945082;Taip;14;0;0;14
14580;Žirniukas;Smalsučiai;1594735501;Taip;0;1;0;1
14581;Žirniukas;Smalsučiai;4229687519;Taip;14;0;0;14
14582;Žirniukas;Smalsučiai;2733313392;Taip;0;1;0;1
14583;Žirniukas;Smalsučiai;9707776533;Taip;4;5;0;9
14584;Žirniukas;Smalsučiai;7278153529;Taip;4;5;0;9
14585;Žirniukas;Smalsučiai;8151071354;Taip;4;1;0;5
14586;Žirniukas;Smalsučiai;7927815250;Taip;0;1;0;1
14587;Žirniukas;Smalsučiai;2325139043;Taip;3;2;0;5
14588;Žirniukas;Smalsučiai;4527367786;Taip;0;2;0;2
14589;Žirniukas;Smalsučiai;8599313527;Taip;6;5;1;12
14590;Žirniukas;Smalsučiai;4320686646;Taip;0;4;0;4
14591;Žirniukas;Smalsučiai;3610402086;Taip;0;3;0;3
14592;Žirniukas;Smalsučiai;6362626389;Taip;0;1;0;1
14593;Žirniukas;Smalsučiai;9961947583;Taip;4;1;0;5
14594;Žirniukas;Smalsučiai;4045432303;Taip;7;2;0;9
14595;Žirniukas;Gėlyčių;2982628594;Taip;3;0;2;5
14596;Žirniukas;Gėlyčių;6121388208;Taip;0;2;0;2
14597;Žirniukas;Gėlyčių;6201949014;Taip;4;0;0;4
14598;Žirniukas;Gėlyčių;9497414375;Taip;10;0;0;10
14599;Žirniukas;Gėlyčių;6147030672;Taip;12;0;0;12
14600;Žirniukas;Gėlyčių;2423974973;Taip;0;18;0;18
14601;Žirniukas;Gėlyčių;2789026451;Taip;18;0;0;18
14602;Žirniukas;Gėlyčių;1368553187;Taip;0;2;0;2
14603;Žirniukas;Gėlyčių;2221770310;Ne;9;0;0;9
14604;Žirniukas;Gėlyčių;5554441466;Taip;11;0;0;11
14605;Žirniukas;Gėlyčių;6788087742;Taip;4;1;0;5
14606;Žirniukas;Nykštukų;2489070480;Taip;2;0;0;2
14607;Žirniukas;Nykštukų;2746074694;Taip;11;0;0;11
14608;Žirniukas;Nykštukų;4282344625;Taip;0;4;0;4
14609;Žirniukas;Nykštukų;3874713264;Taip;4;7;0;11
14610;Žirniukas;Nykštukų;7368124402;Taip;0;4;0;4
14611;Žirniukas;Nykštukų;1635353228;Taip;2;2;0;4
14612;Žirniukas;Nykštukų;2027344763;Taip;6;2;0;8
14613;Žirniukas;Nykštukų;9730269905;Taip;0;3;0;3
14614;Žirniukas;Nykštukų;4732089209;Taip;6;0;0;6
14615;Žirniukas;Nykštukų;9988669252;Ne;2;2;0;4
14616;Žirniukas;Nykštukų;8242086461;Taip;5;0;0;5
14617;Žirniukas;Nykštukų;8242086461;Taip;5;0;0;5
14618;Žirniukas;Nykštukų;8242086461;Taip;5;0;0;5
14619;Žirniukas;Nykštukų;6511802399;Taip;5;0;0;5
14620;Žirniukas;Nykštukų;6511802399;Taip;5;0;0;5
14621;Žirniukas;Nykštukų;6511802399;Taip;5;0;0;5
14622;Žirniukas;Nykštukų;6349641015;Taip;5;0;0;5
14623;Žirniukas;Nykštukų;2635969699;Ne;4;3;0;7
14624;Žirniukas;Nykštukų;5422282267;Taip;7;0;0;7
14625;Žirniukas;Nykštukų;5103440019;Taip;1;0;0;1
14626;Žirniukas;Saulytės;5613818351;Taip;0;2;0;2
14627;Žirniukas;Saulytės;1345594362;Taip;0;1;0;1
14628;Žirniukas;Saulytės;9847840127;Taip;4;5;0;9
14629;Žirniukas;Saulytės;5212289551;Taip;0;0;1;1
14630;Žirniukas;Saulytės;7968189099;Taip;5;2;0;7
14631;Žirniukas;Saulytės;7081683726;Taip;9;1;0;10
14632;Žirniukas;Saulytės;7021496832;Taip;2;0;1;3
14633;Žirniukas;Saulytės;6594686128;Taip;1;1;0;2
14634;Žirniukas;Saulytės;1679864330;Taip;1;0;0;1
14635;Žirniukas;Saulytės;3438394768;Taip;0;0;1;1
14636;Žirniukas;Saulytės;9569187800;Taip;9;0;0;9
14637;Žirniukas;Saulytės;3603956795;Taip;15;0;0;15
14638;Žirniukas;Saulytės;4902056654;Taip;13;1;0;14
14639;Žirniukas;Saulytės;7563892184;Taip;13;1;0;14
14640;Žirniukas;Saulytės;5194729029;Taip;3;0;0;3
14641;Žirniukas;Drugelių;9232828844;Taip;0;7;0;7
14642;Žirniukas;Drugelių;5269074776;Taip;0;0;5;5
14643;Žirniukas;Drugelių;3509857181;Taip;5;1;0;6
14644;Žirniukas;Drugelių;9901196251;Taip;0;1;0;1
14645;Žirniukas;Drugelių;2555959199;Taip;4;0;0;4
14646;Žirniukas;Drugelių;1826203483;Taip;7;0;0;7
14647;Žirniukas;Drugelių;4536071547;Taip;0;4;1;5
14648;Žirniukas;Drugelių;3996393849;Taip;11;1;0;12
14649;Žirniukas;Drugelių;7240364379;Taip;5;0;0;5
14650;Žirniukas;Drugelių;6300372863;Taip;5;4;0;9
14651;Žirniukas;Drugelių;9794535841;Taip;11;0;0;11
14652;Žirniukas;Drugelių;1031316325;Taip;5;0;0;5
14653;Žirniukas;Drugelių;1018506580;Ne;0;9;0;9
14654;Žirniukas;Drugelių;9384464752;Taip;0;5;0;5
14655;Žirniukas;Pelėdžiukai;7889803840;Taip;0;1;0;1
14656;Žirniukas;Pelėdžiukai;4347695841;Taip;6;0;0;6
14657;Žirniukas;Pelėdžiukai;9381704756;Taip;1;0;0;1
14658;Žirniukas;Pelėdžiukai;4847093256;Taip;2;0;0;2
14659;Žirniukas;Pelėdžiukai;7356213150;Taip;9;1;0;10
14660;Žirniukas;Pelėdžiukai;7545458622;Taip;1;2;0;3
14661;Žirniukas;Pelėdžiukai;5376080603;Taip;1;5;0;6
14662;Žirniukas;Pelėdžiukai;9511974432;Taip;0;2;0;2
14663;Žirniukas;Pelėdžiukai;7755938379;Taip;4;0;0;4
14664;Žirniukas;Pelėdžiukai;5470692657;Taip;5;1;0;6
14665;Žirniukas;Pelėdžiukai;8690042163;Taip;6;0;0;6
14666;Žirniukas;Pelėdžiukai;2332260494;Taip;0;5;0;5
14667;Žirniukas;Pelėdžiukai;6941160450;Taip;8;0;0;8
14668;Žirniukas;Pelėdžiukai;4464151713;Taip;2;0;0;2
14669;Žirniukas;Pelėdžiukai;4069128550;Taip;2;0;0;2
14670;Žirniukas;Pelėdžiukai;2489163786;Taip;4;0;0;4
14671;Žirniukas;Pelėdžiukai;7767762079;Taip;1;0;0;1
14672;Žirniukas;ZUIKUČIAI;4860680720;Taip;13;0;0;13
14673;Žirniukas;ZUIKUČIAI;9993119353;Taip;2;2;0;4
14674;Žirniukas;ZUIKUČIAI;2315136490;Taip;0;1;0;1
14675;Žirniukas;ZUIKUČIAI;4519996144;Taip;0;2;0;2
14676;Žirniukas;ZUIKUČIAI;8511341812;Taip;0;0;2;2
14677;Žirniukas;ZUIKUČIAI;7530076269;Taip;11;2;0;13
14678;Žirniukas;ZUIKUČIAI;6780809984;Taip;5;0;1;6
14679;Žirniukas;ZUIKUČIAI;5580500746;Taip;3;2;2;7
14680;Žirniukas;ZUIKUČIAI;6042654423;Taip;12;0;0;12
14681;Žirniukas;ZUIKUČIAI;6223594794;Taip;7;0;0;7
14682;Aušra;Kodėlčiukai;4540040693;Taip;2;4;0;6
14683;Aušra;Kodėlčiukai;5013135853;Taip;4;1;0;5
14684;Aušra;Kodėlčiukai;7765504789;Taip;4;11;0;15
14685;Aušra;Kodėlčiukai;4824773027;Taip;3;4;0;7
14686;Aušra;Kodėlčiukai;6139706771;Taip;12;0;0;12
14687;Aušra;Kodėlčiukai;8108663467;Taip;0;2;2;4
14688;Aušra;Kodėlčiukai;5046439805;Taip;8;0;0;8
14689;Aušra;Kodėlčiukai;3420851059;Taip;0;1;0;1
14690;Aušra;Kodėlčiukai;7314273812;Taip;4;6;0;10
14691;Aušra;Kodėlčiukai;1423840991;Taip;1;0;0;1
14692;Aušra;Kodėlčiukai;7469266085;Taip;0;18;0;18
14693;Aušra;Kodėlčiukai;1010721404;Taip;3;4;0;7
14694;Aušra;Kodėlčiukai;2611563172;Taip;4;4;0;8
14695;Aušra;Kodėlčiukai;1883185016;Taip;3;3;0;6
14696;Aušra;Kodėlčiukai;9437530221;Taip;0;23;0;23
14697;Aušra;Kodėlčiukai;3627487971;Ne;0;9;0;9
14698;Aušra;Kodėlčiukai;7367602247;Taip;0;5;0;5
14699;Aušra;Smalsučiai;4010347313;Taip;17;0;0;17
14700;Aušra;Smalsučiai;5993984086;Taip;0;2;0;2
14701;Aušra;Smalsučiai;1630814772;Taip;4;4;0;8
14702;Aušra;Smalsučiai;2768220823;Taip;5;5;1;11
14703;Aušra;Smalsučiai;4000881716;Taip;13;1;0;14
14704;Aušra;Smalsučiai;5268479689;Taip;6;0;1;7
14705;Aušra;Smalsučiai;7710131755;Taip;9;1;2;12
14706;Aušra;Smalsučiai;8884580599;Taip;6;0;0;6
14707;Aušra;Smalsučiai;3468946868;Taip;16;1;0;17
14708;Aušra;Smalsučiai;8021547491;Taip;0;2;0;2
14709;Aušra;Smalsučiai;5925213006;Taip;8;2;0;10
14710;Aušra;Smalsučiai;2495610772;Taip;0;5;0;5
14711;Aušra;Smalsučiai;3526010606;Taip;3;2;0;5
14712;Aušra;Smalsučiai;4339450816;Ne;0;4;0;4
14713;Aušra;Smalsučiai;4163605313;Taip;10;3;0;13
14714;Aušra;Smalsučiai;6614027605;Taip;5;3;0;8
14715;Aušra;Smalsučiai;3860755808;Taip;5;9;0;14
14716;Aušra;Smalsučiai;2039920706;Taip;5;4;0;9
14717;Aušra;Smalsučiai;9333701196;Taip;0;13;0;13
14718;Aušra;Smalsučiai;8584355573;Taip;2;12;0;14
14719;Aušra;Smalsučiai;6965081051;Taip;0;10;0;10
14720;Aušra;Smalsučiai;8489362814;Taip;12;0;0;12
14721;Aušra;Smalsučiai;3675175233;Taip;5;9;0;14
14722;Aušra;"1A klasė";5524681006;Taip;0;4;0;4
14723;Aušra;"1A klasė";4404047456;Ne;0;4;0;4
14724;Aušra;"1A klasė";3680329197;Taip;3;4;0;7
14725;Aušra;"1A klasė";1575761029;Taip;0;4;0;4
14726;Aušra;"1A klasė";97102749430;Taip;1;4;0;5
14727;Aušra;"1A klasė";5777939563;Taip;0;4;0;4
14728;Aušra;"1A klasė";8740755922;Taip;0;4;0;4
14729;Aušra;"1A klasė";8500642069;Taip;0;4;0;4
14730;Aušra;"1A klasė";1450251779;Taip;6;4;0;10
14731;Aušra;"1A klasė";8176840834;Taip;0;4;0;4
14732;Aušra;"1A klasė";4922560649;Taip;3;4;0;7
14733;Aušra;"1A klasė";4946988585;Taip;1;4;0;5
14734;Aušra;"1A klasė";3767301684;Taip;0;4;0;4
14735;Aušra;"1A klasė";8755231814;Taip;0;4;0;4
14736;Aušra;"1A klasė";1625009666;Taip;6;4;0;10
14737;Aušra;"1A klasė";9058688663;Taip;0;4;0;4
14738;Aušra;"1A klasė";4468214107;Taip;2;4;0;6
14739;Aušra;"1A klasė";7708360056;Taip;0;4;0;4
14740;Aušra;"1A klasė";8096035110;Taip;1;4;0;5
14741;Aušra;"1A klasė";1687206394;Taip;0;4;0;4
14742;Aušra;"1A klasė";1557503831;Taip;0;4;0;4
14743;Aušra;"1A klasė";1636794584;Taip;0;4;0;4
14744;Aušra;"1A klasė";5258444578;Taip;0;4;0;4
14745;Aušra;"1A klasė";1612662076;Taip;0;4;0;4
14746;Aušra;"1B klasė";5409157554;Taip;3;4;0;7
14747;Aušra;"1B klasė";8709340592;Taip;0;4;0;4
14748;Aušra;"1B klasė";1940882109;Taip;0;4;0;4
14749;Aušra;"1B klasė";6384243597;Taip;1;4;0;5
14750;Aušra;"1B klasė";3898178166;Taip;1;4;0;5
14751;Aušra;"1B klasė";1343532870;Taip;4;4;0;8
14752;Aušra;"1B klasė";9614562473;Taip;4;4;0;8
14753;Aušra;"1B klasė";7921251819;Taip;6;4;0;10
14754;Aušra;"1B klasė";2523842161;Taip;0;4;0;4
14755;Aušra;"1B klasė";1465584524;Taip;0;4;0;4
14756;Aušra;"1B klasė";8036572198;Taip;0;4;0;4
14757;Aušra;"1B klasė";8525869648;Taip;0;4;0;4
14758;Aušra;"1B klasė";9589692031;Taip;2;4;0;6
14759;Aušra;"1B klasė";9972967198;Taip;1;4;0;5
14760;Aušra;"1B klasė";5522008237;Taip;2;4;0;6
14761;Aušra;"1B klasė";5269927048;Taip;1;4;0;5
14762;Aušra;"1B klasė";6084096300;Taip;1;4;0;5
14763;Aušra;"1B klasė";10796114623;Taip;0;4;0;4
14764;Aušra;"1B klasė";2052892422;Taip;0;4;0;4
14765;Aušra;"1B klasė";9197020006;Taip;2;4;0;6
14766;Aušra;"1B klasė";7178676049;Taip;0;4;0;4
14767;Aušra;"1B klasė";1298724775;Taip;0;4;0;4
14768;Aušra;"1B klasė";7918281270;Taip;6;4;0;10
14769;Aušra;"1B klasė";43123279348;Taip;0;4;0;4
14770;Aušra;"2A klasė";3001784066;Taip;0;4;0;4
14771;Aušra;"2A klasė";84116863778;Taip;5;4;0;9
14772;Aušra;"2A klasė";2227238810;Taip;0;4;0;4
14773;Aušra;"2A klasė";59837942520;Taip;0;4;0;4
14774;Aušra;"2A klasė";11053850075;Taip;0;4;0;4
14775;Aušra;"2A klasė";23609052737;Taip;0;4;0;4
14776;Aušra;"2A klasė";41017803426;Taip;0;4;0;4
14777;Aušra;"2A klasė";21544489661;Taip;0;4;0;4
14778;Aušra;"2A klasė";24625925423;Taip;2;4;0;6
14779;Aušra;"2A klasė";62186117615;Taip;2;4;0;6
14780;Aušra;"2A klasė";3526237179;Ne;0;4;0;4
14781;Aušra;"2A klasė";1893586984;Taip;0;23;0;23
14782;Aušra;"2A klasė";8686777160;Taip;0;4;0;4
14783;Aušra;"2A klasė";15657824495;Taip;1;4;0;5
14784;Aušra;"2A klasė";5988529284;Taip;0;4;0;4
14785;Aušra;"2A klasė";79051821501;Taip;0;4;0;4
14786;Aušra;"2A klasė";2062470430;Taip;0;4;0;4
14787;Aušra;"2A klasė";5815377310;Taip;0;4;0;4
14788;Aušra;"2A klasė";58254707316;Taip;0;4;0;4
14789;Aušra;"2A klasė";1385844067;Taip;0;4;0;4
14790;Aušra;"2A klasė";2121418946;Taip;0;4;0;4
14791;Aušra;"2A klasė";1219257874;Taip;0;23;0;23
14792;Aušra;"2A klasė";4325224130;Taip;0;4;0;4
14793;Aušra;"2A klasė";59267104215;Taip;0;4;0;4
14794;Aušra;"2A klasė";3732655408;Taip;1;4;0;5
14795;Aušra;"3A klasė";1049364899;Taip;1;4;0;5
14796;Aušra;"3A klasė";1473962346;Taip;1;4;0;5
14797;Aušra;"3A klasė";1427235223;Taip;3;4;0;7
14798;Aušra;"3A klasė";42344686036;Taip;6;4;0;10
14799;Aušra;"3A klasė";95586246863;Taip;1;4;0;5
14800;Aušra;"3A klasė";1167565535;Taip;0;4;0;4
14801;Aušra;"3A klasė";5468993286;Taip;4;4;0;8
14802;Aušra;"3A klasė";75047415039;Taip;0;4;0;4
14803;Aušra;"3A klasė";85826303673;Taip;9;4;0;13
14804;Aušra;"3A klasė";1145863002;Taip;0;23;0;23
14805;Aušra;"3A klasė";77966124767;Taip;0;4;0;4
14806;Aušra;"3A klasė";97312326369;Ne;2;4;0;6
14807;Aušra;"3A klasė";48817619537;Taip;1;4;0;5
14808;Aušra;"3A klasė";55937499558;Taip;0;4;0;4
14809;Aušra;"3A klasė";35779814505;Taip;0;4;0;4
14810;Aušra;"3A klasė";76280361479;Taip;1;4;0;5
14811;Aušra;"3A klasė";2131349938;Taip;1;4;0;5
14812;Aušra;"3A klasė";1455625997;Taip;1;4;0;5
14813;Aušra;"3A klasė";36447115547;Taip;1;4;0;5
14814;Aušra;"3A klasė";1393006122;Taip;6;4;0;10
14815;Aušra;"3A klasė";7998332115;Taip;1;4;0;5
14816;Aušra;"3A klasė";2647629246;Taip;1;4;0;5
14817;Aušra;"3A klasė";14611425618;Taip;0;23;0;23
14818;Aušra;"3A klasė";31458685084;Taip;9;4;0;13
14819;Aušra;"3A klasė";1315930711;Taip;5;4;0;9
14820;Aušra;"3A klasė";4110537888;Taip;1;4;0;5
14821;Aušra;"3A klasė";9603569117;Taip;1;4;0;5
14822;Aušra;"3A klasė";2019480768;Taip;0;4;0;4
14823;Aušra;"4A klasė";40499781883;Taip;4;4;0;8
14824;Aušra;"4A klasė";73509864636;Ne;0;4;0;4
14825;Aušra;"4A klasė";8510995681;Taip;0;4;0;4
14826;Aušra;"4A klasė";13157844661;Ne;0;4;0;4
14827;Aušra;"4A klasė";70233681803;Taip;0;23;0;23
14828;Aušra;"4A klasė";68160889669;Taip;0;4;0;4
14829;Aušra;"4A klasė";97781409787;Taip;1;4;0;5
14830;Aušra;"4A klasė";9605206310;Taip;4;4;0;8
14831;Aušra;"4A klasė";88655846176;Taip;2;4;0;6
14832;Aušra;"4A klasė";3284383302;Taip;0;4;0;4
14833;Aušra;"4A klasė";1437126272;Taip;1;4;0;5
14834;Aušra;"4A klasė";39537089288;Taip;0;4;0;4
14835;Aušra;"4A klasė";3965445196;Taip;0;4;0;4
14836;Aušra;"4A klasė";85578471272;Taip;0;23;0;23
14837;Aušra;"4A klasė";27958163601;Taip;0;4;0;4
14838;Aušra;"4A klasė";68031503463;Taip;0;23;0;23
14839;Aušra;"4A klasė";81633973264;Taip;0;23;0;23
14840;Aušra;"4A klasė";52985512945;Taip;0;23;0;23
14841;Aušra;"4A klasė";51185323645;Taip;0;23;0;23
14842;Aušra;"4A klasė";1437385365;Taip;0;23;0;23
14843;Aušra;"4A klasė";15330844181;Taip;0;23;0;23
14844;Aušra;"4A klasė";2062775070;Taip;0;23;0;23
14845;Aušra;"4A klasė";14157070764;Taip;1;4;0;5
14846;Aušra;"4A klasė";99073448709;Taip;0;4;0;4
14847;Aušra;"4A klasė";40714551025;Taip;0;4;0;4
14848;Aušra;"4A klasė";58699109274;Taip;0;4;0;4
14849;Aušra;"2B klasė";1988459596;Taip;0;4;0;4
14850;Aušra;"2B klasė";4930807661;Taip;0;4;0;4
14851;Aušra;"2B klasė";86128256406;Taip;0;4;0;4
14852;Aušra;"2B klasė";50687988382;Taip;4;4;0;8
14853;Aušra;"2B klasė";1021183555;Taip;0;4;0;4
14854;Aušra;"2B klasė";41268510292;Taip;0;4;0;4
14855;Aušra;"2B klasė";8428069167;Taip;6;4;0;10
14856;Aušra;"2B klasė";3910688753;Taip;0;4;0;4
14857;Aušra;"2B klasė";4024898537;Taip;1;4;0;5
14858;Aušra;"2B klasė";1238171728;Taip;0;4;0;4
14859;Aušra;"2B klasė";4103951942;Taip;0;4;0;4
14860;Aušra;"2B klasė";46481555688;Ne;1;4;0;5
14861;Aušra;"2B klasė";1063755068;Taip;0;4;0;4
14862;Aušra;"2B klasė";70844824182;Taip;2;4;0;6
14863;Aušra;"2B klasė";17098859260;Taip;0;4;0;4
14864;Aušra;"2B klasė";9940683245;Taip;0;4;0;4
14865;Aušra;"2B klasė";2841526614;Ne;3;4;0;7
14866;Aušra;"2B klasė";8813044848;Taip;2;4;0;6
14867;Aušra;"2B klasė";58741201573;Taip;0;4;0;4
14868;Aušra;"2B klasė";2003368811;Taip;0;4;0;4
14869;Aušra;"2B klasė";65840410497;Ne;0;4;0;4
14870;Aušra;"2B klasė";1640356242;Taip;3;4;0;7
14871;Aušra;"2B klasė";90604001837;Taip;1;4;0;5
14872;Aušra;"2B klasė";7794899167;Taip;0;4;0;4
14873;Aušra;Pabiručiai;8769357172;Taip;0;5;2;7
14874;Aušra;Pabiručiai;8462418277;Taip;0;4;0;4
14875;Aušra;Pabiručiai;6555345047;Taip;6;4;0;10
14876;Aušra;Pabiručiai;1306616759;Taip;15;1;0;16
14877;Aušra;Pabiručiai;3336605264;Taip;8;0;2;10
14878;Aušra;Pabiručiai;7476662446;Taip;8;0;0;8
14879;Aušra;Pabiručiai;7199483890;Taip;0;0;3;3
14880;Aušra;Pabiručiai;9466807067;Taip;5;0;5;10
14881;Aušra;Pabiručiai;7926621700;Taip;0;3;0;3
14882;Aušra;Pabiručiai;2904303784;Taip;4;0;0;4
14883;Aušra;Pabiručiai;7888891808;Taip;0;0;3;3
14884;Aušra;Pabiručiai;7944904281;Taip;10;13;0;23
14885;Aušra;Pabiručiai;4646215025;Taip;5;0;1;6
14886;Aušra;Pabiručiai;6056923592;Taip;0;1;1;2
14887;Aušra;Pabiručiai;8665364744;Taip;12;0;0;12
14888;Aušra;Pabiručiai;3553620602;Taip;0;1;0;1
14889;Aušra;Pabiručiai;4071233786;Taip;5;0;1;6
14890;Aušra;Pabiručiai;3953653896;Taip;0;6;1;7
14891;Aušra;Pabiručiai;6508435821;Taip;0;1;0;1
14892;Aušra;Pabiručiai;5797692122;Taip;4;2;0;6
14893;Aušra;Pabiručiai;7542690501;Taip;0;23;0;23
14894;Aušra;Pabiručiai;3759593393;Taip;0;3;0;3
14895;Aušra;Pabiručiai;2273160688;Taip;12;0;1;13
14896;Aušra;Gudručiai;1933801749;Taip;0;3;0;3
14897;Aušra;Gudručiai;5854637278;Taip;0;1;0;1
14898;Aušra;Gudručiai;4564561993;Taip;0;4;0;4
14899;Aušra;Gudručiai;2243689816;Taip;0;5;0;5
14900;Aušra;Gudručiai;5955385407;Ne;16;0;0;16
14901;Aušra;Gudručiai;2271582954;Taip;0;0;2;2
14902;Aušra;Gudručiai;9628651723;Taip;11;3;0;14
14903;Aušra;Gudručiai;1337138547;Taip;4;4;0;8
14904;Aušra;Gudručiai;3343235857;Taip;0;3;0;3
14905;Aušra;Gudručiai;8715912139;Taip;0;4;0;4
14906;Aušra;Gudručiai;1429548355;Taip;0;23;0;23
14907;Aušra;Gudručiai;1693711284;Taip;5;4;0;9
14908;Aušra;Gudručiai;6935310711;Taip;0;4;0;4
14909;Aušra;Gudručiai;3698868934;Taip;6;1;0;7
14910;Aušra;Gudručiai;9079804366;Taip;0;1;0;1
14911;Aušra;Gudručiai;3498143162;Taip;0;1;0;1
14912;Aušra;Gudručiai;2093165104;Taip;10;0;0;10
14913;Aušra;Naminukai;5596076175;Taip;15;5;0;20
14914;Aušra;Naminukai;5029468798;Taip;14;1;0;15
14915;Aušra;Naminukai;3889084120;Taip;8;1;0;9
14916;Aušra;Naminukai;9817943569;Taip;7;0;0;7
14917;Aušra;Naminukai;9783616691;Taip;0;4;0;4
14918;Aušra;Naminukai;7432671713;Taip;0;5;0;5
14919;Aušra;Naminukai;2372043385;Taip;6;0;0;6
14920;Aušra;Naminukai;8872977307;Taip;6;0;3;9
14921;Aušra;Naminukai;5943702240;Taip;3;2;3;8
14922;Aušra;Naminukai;7833475076;Taip;1;1;0;2
14923;Aušra;Naminukai;1415288593;Taip;6;3;1;10
14924;Aušra;Naminukai;8317843419;Taip;23;0;0;23
14925;Aušra;Naminukai;2831726456;Taip;7;1;0;8
14926;Aušra;Naminukai;5245988936;Taip;0;5;2;7
14927;Aušra;Naminukai;3017627321;Taip;3;0;1;4
14928;Aušra;Naminukai;2109806524;Taip;9;0;0;9
14929;Aušra;Naminukai;4300801436;Taip;4;0;4;8
14930;Aušra;Naminukai;4824331856;Taip;3;1;1;5
14931;Aušra;Naminukai;4779994281;Taip;0;1;0;1
14932;Aušra;Naminukai;5270770998;Taip;0;0;2;2
14933;Aušra;"2 C klasė";1426802917;Taip;0;4;0;4
14934;Aušra;"2 C klasė";26010333641;Taip;0;4;0;4
14935;Aušra;"2 C klasė";3133031845;Taip;3;4;0;7
14936;Aušra;"2 C klasė";11130172902;Ne;0;4;0;4
14937;Aušra;"2 C klasė";43737170074;Taip;2;4;0;6
14938;Aušra;"2 C klasė";1370336984;Ne;0;4;0;4
14939;Aušra;"2 C klasė";6483078840;Taip;0;4;0;4
14940;Aušra;"2 C klasė";1684481833;Taip;3;4;0;7
14941;Aušra;"2 C klasė";1198248619;Taip;0;4;0;4
14942;Aušra;"2 C klasė";4765125810;Taip;0;4;0;4
14943;Aušra;"2 C klasė";5704281727;Taip;0;4;0;4
14944;Aušra;"2 C klasė";1479311429;Taip;0;4;0;4
14945;Aušra;"2 C klasė";1542575012;Taip;0;4;0;4
14946;Aušra;"2 C klasė";1291782232;Taip;0;4;0;4
14947;Aušra;"2 C klasė";90520726029;Taip;0;4;0;4
14948;Aušra;"2 C klasė";1844632980;Ne;0;4;0;4
14949;Aušra;"2 C klasė";94478599707;Taip;0;4;0;4
14950;Aušra;"2 C klasė";78489473446;Taip;0;4;0;4
14951;Aušra;"2 C klasė";29328876924;Taip;0;4;0;4
14952;Aušra;"2 C klasė";7649832094;Taip;0;4;0;4
14953;Aušra;"2 C klasė";8225188274;Taip;1;4;0;5
14954;Aušra;"2 C klasė";1371282149;Taip;1;4;0;5
14955;Aušra;"2 C klasė";57559227292;Taip;0;4;0;4
14956;Berželis;PČIOLKI;3613459846;Taip;0;2;0;2
14957;Berželis;PČIOLKI;7781031211;Taip;1;3;3;7
14958;Berželis;PČIOLKI;4546285993;Taip;0;23;0;23
14959;Berželis;PČIOLKI;7940591009;Taip;0;0;8;8
14960;Berželis;PČIOLKI;6352635742;Taip;0;2;4;6
14961;Berželis;PČIOLKI;2030770943;Taip;0;4;0;4
14962;Berželis;PČIOLKI;6942559693;Taip;0;1;1;2
14963;Berželis;PČIOLKI;5688897783;Taip;0;4;3;7
14964;Berželis;PČIOLKI;2016194182;Taip;0;3;2;5
14965;Berželis;PČIOLKI;5069322062;Taip;0;3;2;5
14966;Berželis;PČIOLKI;6577232093;Taip;0;3;5;8
14967;Berželis;PČIOLKI;9585609150;Taip;0;5;0;5
14968;Berželis;PČIOLKI;9091691636;Taip;0;1;2;3
14969;Berželis;PČIOLKI;2667957070;Taip;0;1;0;1
14970;Berželis;PČIOLKI;8448872491;Taip;0;1;0;1
14971;Berželis;PČIOLKI;6387242787;Taip;0;23;0;23
14972;Berželis;PČIOLKI;2954451168;Taip;6;3;0;9
14973;Berželis;"BOŽJI KOROVKI";7421059780;Taip;8;0;0;8
14974;Berželis;"BOŽJI KOROVKI";4100740863;Taip;9;5;0;14
14975;Berželis;"BOŽJI KOROVKI";5953387226;Taip;0;7;0;7
14976;Berželis;"BOŽJI KOROVKI";3070917065;Taip;9;0;0;9
14977;Berželis;"BOŽJI KOROVKI";8118040960;Taip;3;1;0;4
14978;Berželis;"BOŽJI KOROVKI";9848723402;Taip;2;1;0;3
14979;Berželis;"BOŽJI KOROVKI";5551459997;Taip;3;5;0;8
14980;Berželis;"BOŽJI KOROVKI";6651007152;Ne;10;1;0;11
14981;Berželis;"BOŽJI KOROVKI";8451877584;Taip;4;0;0;4
14982;Berželis;"BOŽJI KOROVKI";7080168105;Taip;9;1;0;10
14983;Berželis;"BOŽJI KOROVKI";9438498834;Ne;0;2;1;3
14984;Berželis;"BOŽJI KOROVKI";1132252592;Taip;11;0;0;11
14985;Berželis;"BOŽJI KOROVKI";5550598069;Taip;5;0;0;5
14986;Berželis;"BOŽJI KOROVKI";1852964349;Taip;0;2;0;2
14987;Berželis;"BOŽJI KOROVKI";8871199713;Taip;0;0;1;1
14988;Berželis;"BOŽJI KOROVKI";1722262813;Taip;0;3;0;3
14989;Berželis;"BOŽJI KOROVKI";9466461910;Taip;8;5;0;13
14990;Berželis;"BOŽJI KOROVKI";2182268389;Taip;4;0;0;4
14991;Berželis;"BOŽJI KOROVKI";2901168499;Taip;8;0;0;8
14992;Berželis;SOLNYŠKO;7411282628;Taip;13;0;0;13
14993;Berželis;SOLNYŠKO;8957312159;Taip;2;0;1;3
14994;Berželis;SOLNYŠKO;1167103292;Taip;0;0;1;1
14995;Berželis;SOLNYŠKO;5408368340;Taip;0;0;7;7
14996;Berželis;SOLNYŠKO;1070751052;Taip;16;0;0;16
14997;Berželis;SOLNYŠKO;5464385395;Taip;0;4;0;4
14998;Berželis;SOLNYŠKO;1424868444;Taip;9;0;0;9
14999;Berželis;SOLNYŠKO;1146976812;Ne;5;1;0;6
15000;Berželis;SOLNYŠKO;6774460279;Taip;13;10;0;23
15001;Berželis;SOLNYŠKO;5866092980;Taip;3;0;2;5
15002;Berželis;SOLNYŠKO;9750863775;Taip;3;0;1;4
15003;Berželis;SOLNYŠKO;2146432569;Taip;13;0;0;13
15004;Berželis;SOLNYŠKO;4125566288;Taip;5;0;0;5
15005;Berželis;SOLNYŠKO;1503116062;Taip;8;0;0;8
15006;Berželis;SOLNYŠKO;8353172510;Taip;0;1;0;1
15007;Berželis;SOLNYŠKO;6281925938;Taip;6;1;0;7
15008;Berželis;SOLNYŠKO;5739847580;Taip;7;0;0;7
15009;Berželis;SOLNYŠKO;5194480946;Taip;0;0;2;2
15010;Berželis;BABOČKI;7535016799;Taip;16;0;0;16
15011;Berželis;BABOČKI;3929755468;Taip;9;0;0;9
15012;Berželis;BABOČKI;7436238561;Taip;2;0;0;2
15013;Berželis;BABOČKI;3118835709;Taip;4;0;0;4
15014;Berželis;BABOČKI;4511595124;Taip;16;0;0;16
15015;Berželis;BABOČKI;9233307928;Taip;10;0;0;10
15016;Berželis;BABOČKI;6476593246;Taip;6;0;0;6
15017;Berželis;BABOČKI;7672845584;Taip;1;0;1;2
15018;Berželis;BABOČKI;5460675556;Taip;9;0;0;9
15019;Berželis;BABOČKI;6465432599;Taip;15;0;0;15
15020;Berželis;BABOČKI;5357039865;Taip;7;0;1;8
15021;Berželis;BABOČKI;9300262294;Taip;8;0;1;9
15022;Berželis;SOVUŠKI;8185887403;Taip;4;0;0;4
15023;Berželis;SOVUŠKI;1289333809;Taip;9;1;0;10
15024;Berželis;SOVUŠKI;8086074279;Taip;12;0;0;12
15025;Berželis;SOVUŠKI;9273819928;Taip;0;4;0;4
15026;Berželis;SOVUŠKI;1769470120;Taip;5;1;0;6
15027;Berželis;SOVUŠKI;2895332184;Ne;5;0;0;5
15028;Berželis;SOVUŠKI;1464998584;Taip;1;0;0;1
15029;Berželis;SOVUŠKI;2844736188;Taip;2;0;0;2
15030;Berželis;SOVUŠKI;3835273594;Taip;11;0;0;11
15031;Berželis;SOVUŠKI;2632535013;Taip;18;0;0;18
15032;Berželis;SOVUŠKI;6698849108;Taip;9;0;2;11
15033;Berželis;SOVUŠKI;1583268041;Taip;9;1;0;10
15034;Berželis;SOVUŠKI;5925726854;Taip;8;0;0;8
15035;Berželis;SOVUŠKI;1044720859;Taip;0;3;0;3
15036;Berželis;SOVUŠKI;2615832804;Taip;0;10;0;10
15037;Berželis;PODSOLNUŠKI;3157906472;Taip;18;0;0;18
15038;Berželis;PODSOLNUŠKI;9945124824;Taip;14;1;0;15
15039;Berželis;PODSOLNUŠKI;8168498937;Taip;7;2;0;9
15040;Berželis;PODSOLNUŠKI;8633724383;Taip;9;0;0;9
15041;Berželis;PODSOLNUŠKI;2259367998;Taip;10;0;0;10
15042;Berželis;PODSOLNUŠKI;3033042487;Taip;9;0;4;13
15043;Berželis;PODSOLNUŠKI;2136455625;Taip;2;0;5;7
15044;Berželis;PODSOLNUŠKI;1964320071;Taip;17;3;0;20
15045;Berželis;PODSOLNUŠKI;9133988149;Taip;5;1;1;7
15046;Berželis;PODSOLNUŠKI;5795151632;Taip;7;0;0;7
15047;Berželis;PODSOLNUŠKI;6686248053;Taip;5;1;0;6
15048;Berželis;PODSOLNUŠKI;5963915092;Ne;7;0;0;7
15049;Berželis;PODSOLNUŠKI;3378237475;Ne;7;0;0;7
15050;Berželis;PODSOLNUŠKI;4681334359;Taip;4;0;0;4
15051;Berželis;LAPIUKAI;3813964138;Taip;5;0;0;5
15052;Berželis;LAPIUKAI;9658062645;Taip;3;0;0;3
15053;Berželis;LAPIUKAI;9681310544;Taip;0;0;6;6
15054;Berželis;LAPIUKAI;9543499205;Taip;2;0;0;2
15055;Berželis;LAPIUKAI;4243086262;Taip;9;0;0;9
15056;Berželis;LAPIUKAI;8994102218;Taip;0;8;0;8
15057;Berželis;LAPIUKAI;4854931959;Taip;11;0;0;11
15058;Berželis;LAPIUKAI;9874401787;Ne;14;0;9;23
15059;Berželis;LAPIUKAI;9234691627;Ne;0;0;1;1
15060;Berželis;LAPIUKAI;4437437529;Taip;15;0;0;15
15061;Berželis;LAPIUKAI;9562165121;Ne;10;0;1;11
15062;Berželis;LAPIUKAI;7848240865;Taip;7;0;1;8
15063;Berželis;LAPIUKAI;7545277683;Taip;0;0;3;3
15064;Berželis;LAPIUKAI;7807553847;Ne;0;0;1;1
15065;Berželis;LAPIUKAI;1456066646;Ne;0;0;1;1
15066;Berželis;LAPIUKAI;6186408090;Taip;3;0;2;5
15067;Berželis;LAPIUKAI;1673524685;Taip;5;0;0;5
15068;Berželis;LAPIUKAI;7902774064;Taip;9;0;2;11
15069;Berželis;MEŠKIUKAI;1235617054;Taip;9;3;0;12
15070;Berželis;MEŠKIUKAI;1178588907;Taip;4;0;1;5
15071;Berželis;MEŠKIUKAI;5100214127;Ne;0;1;0;1
15072;Berželis;MEŠKIUKAI;3535856504;Taip;2;0;0;2
15073;Berželis;MEŠKIUKAI;8560266611;Taip;4;0;0;4
15074;Berželis;MEŠKIUKAI;3936106342;Taip;5;0;0;5
15075;Berželis;MEŠKIUKAI;6689893827;Taip;9;3;0;12
15076;Berželis;MEŠKIUKAI;8251510865;Ne;0;4;4;8
15077;Berželis;MEŠKIUKAI;9182053246;Taip;4;0;0;4
15078;Berželis;MEŠKIUKAI;7374231804;Taip;0;0;1;1
15079;Berželis;MEŠKIUKAI;6394357191;Taip;0;0;1;1
15080;Berželis;ŽIEDELIAI;3786609012;Taip;8;0;0;8
15081;Berželis;ŽIEDELIAI;9805181733;Taip;10;0;0;10
15082;Berželis;ŽIEDELIAI;1165300871;Taip;0;0;3;3
15083;Berželis;ŽIEDELIAI;2016827207;Ne;8;0;1;9
15084;Berželis;ŽIEDELIAI;9979442772;Ne;0;0;4;4
15085;Berželis;ŽIEDELIAI;7042967329;Taip;13;0;1;14
15086;Berželis;ŽIEDELIAI;9925865228;Taip;5;0;0;5
15087;Berželis;ŽIEDELIAI;1402975280;Taip;6;5;0;11
15088;Berželis;ŽIEDELIAI;2030492491;Taip;1;0;1;2
15089;Berželis;ŽIEDELIAI;3351114197;Taip;0;0;6;6
15090;Berželis;ŽIEDELIAI;5248880873;Taip;4;0;5;9
15091;Berželis;ŽIEDELIAI;2508532190;Taip;0;4;1;5
15092;Berželis;ŽIEDELIAI;1834920753;Taip;4;0;0;4
15093;Berželis;ŽIEDELIAI;6384939601;Taip;0;0;2;2
15094;Berželis;ŽIEDELIAI;2794074071;Taip;0;0;1;1
15095;Berželis;NYKŠTUKAI;8148104183;Ne;0;4;3;7
15096;Berželis;NYKŠTUKAI;7935684899;Ne;8;0;4;12
15097;Berželis;NYKŠTUKAI;1403664386;Taip;7;1;0;8
15098;Berželis;NYKŠTUKAI;5637168259;Taip;9;0;2;11
15099;Berželis;NYKŠTUKAI;9666648116;Taip;15;0;1;16
15100;Berželis;NYKŠTUKAI;3559065542;Ne;0;4;5;9
15101;Berželis;NYKŠTUKAI;3556594755;Taip;4;0;5;9
15102;Berželis;NYKŠTUKAI;2933069798;Taip;0;0;1;1
15103;Berželis;NYKŠTUKAI;8430372047;Taip;0;12;0;12
15104;Berželis;NYKŠTUKAI;7676141462;Ne;6;8;0;14
15105;Berželis;NYKŠTUKAI;3852021563;Taip;3;0;3;6
15106;Berželis;NYKŠTUKAI;3379227410;Taip;5;0;0;5
15107;Berželis;NYKŠTUKAI;5012540410;Taip;6;0;2;8
15108;Berželis;NYKŠTUKAI;9925281959;Taip;17;0;0;17
15109;Berželis;UOGELĖS;8735934456;Taip;7;0;1;8
15110;Berželis;UOGELĖS;6136155301;Taip;3;0;3;6
15111;Berželis;UOGELĖS;9950641759;Taip;0;0;1;1
15112;Berželis;UOGELĖS;9034464618;Taip;10;0;0;10
15113;Berželis;UOGELĖS;2321608974;Ne;0;0;6;6
15114;Berželis;UOGELĖS;3229996417;Taip;0;3;0;3
15115;Berželis;UOGELĖS;7750905743;Taip;0;1;0;1
15116;Berželis;UOGELĖS;4607486516;Ne;0;8;1;9
15117;Berželis;UOGELĖS;5197350105;Taip;2;4;0;6
15118;Berželis;KODĖLČIUKAI;5786052354;Ne;0;4;2;6
15119;Berželis;KODĖLČIUKAI;5134372871;Ne;0;1;0;1
15120;Berželis;KODĖLČIUKAI;5751995154;Ne;0;0;1;1
15121;Berželis;KODĖLČIUKAI;3589890886;Taip;0;2;0;2
15122;Berželis;KODĖLČIUKAI;1127524998;Taip;0;9;0;9
15123;Berželis;KODĖLČIUKAI;3951962738;Taip;0;2;0;2
15124;Berželis;KODĖLČIUKAI;2193392844;Taip;5;0;0;5
15125;Berželis;KODĖLČIUKAI;9696962207;Taip;2;0;0;2
15126;Berželis;KODĖLČIUKAI;8286301258;Taip;9;1;0;10
15127;Berželis;KODĖLČIUKAI;6500588668;Taip;0;0;1;1
15128;Berželis;KODĖLČIUKAI;3327751482;Ne;4;0;0;4
15129;Berželis;KODĖLČIUKAI;6060490387;Taip;0;0;1;1
15130;Berželis;KODĖLČIUKAI;9418230816;Taip;5;11;0;16
15131;Berželis;KODĖLČIUKAI;4254592648;Taip;15;0;0;15
15132;Berželis;KODĖLČIUKAI;2144796691;Taip;4;10;0;14
15133;Berželis;KODĖLČIUKAI;8737788279;Taip;3;0;1;4
15134;Saulutė;Drugeliai;5943795519;Taip;9;0;0;9
15135;Saulutė;Drugeliai;4067009709;Taip;3;4;0;7
15136;Saulutė;Drugeliai;3991128892;Taip;7;1;0;8
15137;Saulutė;Drugeliai;7689842018;Taip;2;0;0;2
15138;Saulutė;Drugeliai;4288298305;Taip;6;0;0;6
15139;Saulutė;Drugeliai;9133269796;Taip;11;1;0;12
15140;Saulutė;Drugeliai;6057938367;Taip;5;1;0;6
15141;Saulutė;Drugeliai;1268204445;Taip;0;1;0;1
15142;Saulutė;Drugeliai;1585403702;Taip;2;0;0;2
15143;Saulutė;Drugeliai;8003855875;Taip;1;0;0;1
15144;Saulutė;Drugeliai;2301903550;Taip;8;0;0;8
15145;Saulutė;Drugeliai;2337702344;Taip;2;0;0;2
15146;Saulutė;Drugeliai;3662919521;Taip;4;0;0;4
15147;Saulutė;Drugeliai;6455593653;Taip;8;1;0;9
15148;Saulutė;Drugeliai;9410517602;Taip;7;0;0;7
15149;Saulutė;Drugeliai;1088813143;Taip;8;0;0;8
15150;Saulutė;Drugeliai;6304028361;Ne;6;0;0;6
15151;Saulutė;Drugeliai;7139492238;Taip;5;0;0;5
15152;Saulutė;Drugeliai;2750955550;Taip;16;0;0;16
15153;Saulutė;Drugeliai;5931269521;Taip;8;1;0;9
15154;Saulutė;Drugeliai;3730442890;Taip;0;8;0;8
15155;Saulutė;Drugeliai;8409958782;Taip;18;0;0;18
15156;Saulutė;"Saulės zuikučiai";6924891265;Taip;1;0;0;1
15157;Saulutė;"Saulės zuikučiai";5448950324;Taip;9;10;0;19
15158;Saulutė;"Saulės zuikučiai";3948540247;Taip;0;1;0;1
15159;Saulutė;"Saulės zuikučiai";4130972647;Taip;14;2;0;16
15160;Saulutė;"Saulės zuikučiai";3242810449;Taip;0;10;0;10
15161;Saulutė;"Saulės zuikučiai";9110162513;Taip;0;3;0;3
15162;Saulutė;"Saulės zuikučiai";6927834443;Taip;5;20;0;25
15163;Saulutė;"Saulės zuikučiai";8714520840;Taip;6;9;0;15
15164;Saulutė;"Saulės zuikučiai";9726675673;Taip;33;0;0;33
15165;Saulutė;"Saulės zuikučiai";8520474896;Taip;33;0;0;33
15166;Saulutė;"Saulės zuikučiai";6189637986;Taip;0;4;0;4
15167;Saulutė;"Saulės zuikučiai";7132125341;Taip;1;0;0;1
15168;Saulutė;"Saulės zuikučiai";3215349379;Taip;5;16;0;21
15169;Saulutė;"Saulės zuikučiai";3259790911;Taip;0;12;0;12
15170;Saulutė;"Saulės zuikučiai";7311594119;Taip;21;0;0;21
15171;Saulutė;"Saulės zuikučiai";8952893819;Taip;10;23;0;33
15172;Saulutė;"Saulės zuikučiai";9567511354;Taip;5;0;0;5
15173;Saulutė;"Saulės zuikučiai";6579874077;Ne;0;10;0;10
15174;Saulutė;"Saulės zuikučiai";8472510151;Taip;6;2;0;8
15175;Saulutė;"Saulės zuikučiai";7478215328;Taip;0;4;0;4
15176;Saulutė;"Saulės zuikučiai";9727366891;Taip;0;11;0;11
15177;Saulutė;"Saulės zuikučiai";4222649372;Ne;1;4;0;5
15178;Saulutė;Boružėlės;3295289082;Taip;0;1;0;1
15179;Saulutė;Boružėlės;1587328722;Taip;0;2;0;2
15180;Saulutė;Boružėlės;8390767549;Taip;9;0;0;9
15181;Saulutė;Boružėlės;7576532632;Taip;4;2;0;6
15182;Saulutė;Boružėlės;9314889468;Taip;2;0;0;2
15183;Saulutė;Boružėlės;7764493159;Taip;0;1;0;1
15184;Saulutė;Boružėlės;5565832676;Taip;0;1;0;1
15185;Saulutė;Boružėlės;5811810714;Taip;3;3;0;6
15186;Saulutė;Boružėlės;8643975544;Taip;0;0;1;1
15187;Saulutė;Boružėlės;7081700501;Taip;0;4;0;4
15188;Saulutė;Boružėlės;7474989619;Taip;0;6;0;6
15189;Saulutė;Boružėlės;1803710557;Taip;0;0;1;1
15190;Saulutė;Boružėlės;9173336078;Taip;0;0;2;2
15191;Saulutė;Boružėlės;1265174091;Taip;0;3;0;3
15192;Saulutė;Boružėlės;2988010963;Taip;0;0;2;2
15193;Saulutė;Boružėlės;3852862834;Taip;0;0;1;1
15194;Saulutė;Boružėlės;1275552038;Taip;6;0;0;6
15195;Saulutė;Boružėlės;3363212754;Taip;0;3;0;3
15196;Saulutė;Boružėlės;8086759121;Taip;5;0;0;5
15197;Saulutė;Boružėlės;4840187188;Taip;12;0;0;12
15198;Saulutė;Nykštukai;2601822200;Taip;4;0;1;5
15199;Saulutė;Nykštukai;3244850673;Taip;0;2;0;2
15200;Saulutė;Nykštukai;5607937410;Taip;0;1;0;1
15201;Saulutė;Nykštukai;3221612665;Ne;9;1;0;10
15202;Saulutė;Nykštukai;2140277182;Taip;10;5;0;15
15203;Saulutė;Nykštukai;4800144085;Taip;0;0;4;4
15204;Saulutė;Nykštukai;8257363228;Taip;9;0;1;10
15205;Saulutė;Nykštukai;9664809396;Taip;0;4;0;4
15206;Saulutė;Nykštukai;8984040932;Taip;11;3;0;14
15207;Saulutė;Nykštukai;3463428772;Taip;9;1;0;10
15208;Saulutė;Nykštukai;9930330487;Taip;0;2;1;3
15209;Saulutė;Nykštukai;7158455528;Taip;4;0;0;4
15210;Saulutė;Nykštukai;1229624643;Taip;5;5;0;10
15211;Saulutė;Nykštukai;9572394489;Taip;19;0;2;21
15212;Saulutė;Nykštukai;5509365461;Taip;9;0;1;10
15213;Saulutė;Nykštukai;3408369823;Taip;0;4;1;5
15214;Saulutė;Nykštukai;5264813819;Taip;12;0;2;14
15215;Saulutė;Nykštukai;3265401334;Taip;0;4;2;6
15216;Saulutė;Nykštukai;9497439410;Ne;0;7;0;7
15217;Saulutė;Nykštukai;5335820652;Taip;5;1;0;6
15218;Saulutė;Nykštukai;4510990261;Taip;0;0;3;3
15219;Saulutė;Nykštukai;7555183487;Taip;0;3;0;3
15220;Saulutė;Meškiukai;5219429911;Taip;5;3;0;8
15221;Saulutė;Meškiukai;8787977881;Ne;0;5;0;5
15222;Saulutė;Meškiukai;8147755754;Taip;0;0;1;1
15223;Saulutė;Meškiukai;1562476697;Ne;19;2;0;21
15224;Saulutė;Meškiukai;1776176097;Taip;5;0;0;5
15225;Saulutė;Meškiukai;1408451926;Taip;0;14;0;14
15226;Saulutė;Meškiukai;9175541045;Ne;8;0;1;9
15227;Saulutė;Meškiukai;6978306762;Taip;14;0;0;14
15228;Saulutė;Meškiukai;7757420187;Taip;8;2;0;10
15229;Saulutė;Meškiukai;1415128133;Taip;0;0;5;5
15230;Saulutė;Meškiukai;4451054381;Taip;0;0;3;3
15231;Saulutė;Meškiukai;9919098322;Taip;7;0;3;10
15232;Saulutė;Meškiukai;1848147862;Taip;0;7;1;8
15233;Saulutė;Meškiukai;3883395634;Taip;0;13;0;13
15234;Saulutė;Meškiukai;2929345460;Taip;19;0;0;19
15235;Saulutė;Meškiukai;9825396096;Ne;0;23;0;23
15236;Saulutė;Meškiukai;1175393220;Taip;0;12;0;12
15237;Saulutė;Meškiukai;8844784669;Taip;4;0;1;5
15238;Saulutė;Ežiukai;2813274509;Taip;2;0;0;2
15239;Saulutė;Ežiukai;2315812734;Taip;3;0;0;3
15240;Saulutė;Ežiukai;8736917541;Taip;5;0;0;5
15241;Saulutė;Ežiukai;4363210987;Taip;1;3;0;4
15242;Saulutė;Ežiukai;5972503001;Taip;12;0;0;12
15243;Saulutė;Ežiukai;6884472677;Taip;7;0;0;7
15244;Saulutė;Ežiukai;4194586403;Taip;13;0;0;13
15245;Saulutė;Ežiukai;1666301750;Ne;15;0;0;15
15246;Saulutė;Ežiukai;3133714991;Taip;2;0;0;2
15247;Saulutė;Ežiukai;7967532537;Taip;1;0;0;1
15248;Saulutė;Ežiukai;2728669975;Taip;10;0;0;10
15249;Saulutė;Ežiukai;9398356470;Taip;10;0;0;10
15250;Saulutė;Ežiukai;6126870829;Taip;2;4;0;6
15251;Saulutė;Ežiukai;3565818383;Taip;5;0;0;5
15252;Saulutė;Ežiukai;9101950978;Taip;13;0;0;13
15253;Saulutė;Ežiukai;6982979199;Taip;6;0;0;6
15254;Saulutė;Ežiukai;8919457259;Taip;6;0;0;6
15255;Saulutė;Ežiukai;3125186472;Taip;7;0;0;7
15256;Saulutė;Ežiukai;7941601480;Taip;5;0;0;5
15257;Saulutė;Ežiukai;8961335897;Taip;5;0;0;5
15258;Saulutė;Ežiukai;4039065925;Taip;5;0;0;5
15259;Saulutė;Bitutės;5200638523;Taip;9;0;0;9
15260;Saulutė;Bitutės;5897526863;Taip;9;0;1;10
15261;Saulutė;Bitutės;6531388817;Taip;0;0;2;2
15262;Saulutė;Bitutės;1640977737;Taip;7;0;0;7
15263;Saulutė;Bitutės;8681103477;Taip;0;0;2;2
15264;Saulutė;Bitutės;2251663689;Taip;5;4;6;15
15265;Saulutė;Bitutės;8428335721;Taip;4;6;0;10
15266;Saulutė;Bitutės;5623547412;Taip;14;9;0;23
15267;Saulutė;Bitutės;1931298484;Taip;0;3;0;3
15268;Saulutė;Bitutės;5308928580;Taip;16;0;0;16
15269;Saulutė;Bitutės;9741004996;Taip;8;0;1;9
15270;Saulutė;Bitutės;3883903645;Taip;16;4;3;23
15271;Saulutė;Bitutės;2402895955;Taip;0;2;0;2
15272;Saulutė;Bitutės;8551251470;Ne;16;4;0;20
15273;Saulutė;Bitutės;2849357495;Taip;6;0;0;6
15274;Saulutė;Bitutės;1763631244;Taip;0;0;8;8
15275;Saulutė;Bitutės;7123687661;Taip;15;0;1;16
15276;Saulutė;Pelėdžiukai;8512137633;Taip;15;0;0;15
15277;Saulutė;Pelėdžiukai;4211866191;Taip;3;0;0;3
15278;Saulutė;Pelėdžiukai;2373409300;Taip;4;0;2;6
15279;Saulutė;Pelėdžiukai;8405262902;Taip;3;0;0;3
15280;Saulutė;Pelėdžiukai;1745754752;Taip;1;0;0;1
15281;Saulutė;Pelėdžiukai;4123500930;Ne;1;4;0;5
15282;Saulutė;Pelėdžiukai;1056158093;Taip;4;0;2;6
15283;Saulutė;Pelėdžiukai;8371366346;Taip;0;1;0;1
15284;Saulutė;Pelėdžiukai;6842585310;Taip;4;0;0;4
15285;Saulutė;Pelėdžiukai;1776164273;Taip;0;2;0;2
15286;Saulutė;Pelėdžiukai;5850783789;Taip;0;4;0;4
15287;Saulutė;Pelėdžiukai;6608003946;Taip;0;23;0;23
15288;Saulutė;Pelėdžiukai;7243072252;Taip;0;2;0;2
15289;Saulutė;Pelėdžiukai;9903380188;Taip;6;0;0;6
15290;Saulutė;Pelėdžiukai;2450554594;Taip;0;1;0;1
15291;Saulutė;Pelėdžiukai;7620841597;Taip;10;0;0;10
15292;Saulutė;Pelėdžiukai;7640441297;Taip;0;0;1;1
15293;Saulutė;Pelėdžiukai;6046611248;Taip;0;8;0;8
15294;Saulutė;Pelėdžiukai;4301516165;Taip;14;0;0;14
15295;Saulutė;Pelėdžiukai;7258180835;Ne;2;2;0;4
15296;Saulutė;Pelėdžiukai;2566263680;Ne;9;0;3;12
15297;Saulutė;Pelėdžiukai;4179271978;Ne;23;0;0;23
15298;Saulutė;Zylutės;3228226715;Taip;0;4;0;4
15299;Saulutė;Zylutės;8040751073;Taip;0;1;0;1
15300;Saulutė;Zylutės;2074473832;Taip;0;4;0;4
15301;Saulutė;Zylutės;8041118115;Taip;0;23;0;23
15302;Saulutė;Zylutės;6109527712;Ne;0;2;1;3
15303;Saulutė;Zylutės;7446423510;Taip;4;1;1;6
15304;Saulutė;Zylutės;8717210130;Taip;6;2;0;8
15305;Saulutė;Zylutės;8211523302;Ne;20;0;0;20
15306;Saulutė;Zylutės;3272296969;Taip;0;2;1;3
15307;Saulutė;Zylutės;7032417938;Taip;7;0;0;7
15308;Saulutė;Zylutės;1784093413;Ne;7;5;0;12
15309;Saulutė;Zylutės;8722717930;Taip;7;0;0;7
15310;Saulutė;Zylutės;5442075474;Taip;20;0;0;20
15311;Saulutė;Zylutės;4136425904;Taip;6;2;0;8
15312;Saulutė;Zylutės;4390098560;Taip;4;0;0;4
15313;Saulutė;Zylutės;4663795223;Taip;0;23;0;23
15314;Saulutė;Zylutės;7839168221;Taip;4;0;0;4
15315;Saulutė;Zylutės;2527027536;Taip;5;4;0;9
15316;Saulutė;Zylutės;2725491887;Taip;9;0;1;10
15317;Saulutė;Zylutės;1712365476;Taip;7;4;0;11
15318;Saulutė;Zylutės;4516130694;Ne;19;0;0;19
15319;Saulutė;"1 klasė";7844396402;Taip;1;4;0;5
15320;Saulutė;"1 klasė";8379304869;Ne;3;4;0;7
15321;Saulutė;"1 klasė";9947607411;Ne;0;4;0;4
15322;Saulutė;"1 klasė";7351477901;Taip;0;4;0;4
15323;Saulutė;"1 klasė";1324799653;Taip;1;4;0;5
15324;Saulutė;"1 klasė";95439358242;Taip;3;4;0;7
15325;Saulutė;"1 klasė";3691381351;Taip;2;4;0;6
15326;Saulutė;"1 klasė";8242602551;Ne;0;4;0;4
15327;Saulutė;"1 klasė";2397257894;Taip;0;4;0;4
15328;Saulutė;"1 klasė";5326279083;Taip;0;4;0;4
15329;Saulutė;"1 klasė";8946107286;Taip;0;4;0;4
15330;Saulutė;"1 klasė";7888435573;Taip;1;4;0;5
15331;Saulutė;"1 klasė";2781003892;Taip;0;4;0;4
15332;Saulutė;"1 klasė";2816806902;Taip;0;4;0;4
15333;Saulutė;"1 klasė";5247769309;Taip;1;4;0;5
15334;Saulutė;"1 klasė";9521155670;Taip;1;4;0;5
15335;Saulutė;"1 klasė";3620722907;Taip;5;4;0;9
15336;Saulutė;"1 klasė";3749374270;Taip;0;4;0;4
15337;Saulutė;"1 klasė";5148542811;Taip;6;4;0;10
15338;Saulutė;"1 klasė";1562393383;Taip;10;4;0;14
15339;Saulutė;"1 klasė";5641148690;Taip;0;4;0;4
15340;Saulutė;"1 klasė";4818911910;Ne;19;4;0;23
15341;Saulutė;"1 klasė";1833001939;Ne;0;4;0;4
15342;Saulutė;"1 klasė";8092104136;Taip;4;4;0;8
15343;Saulutė;"1 klasė";1625197280;Taip;0;4;0;4
15344;Saulutė;"1 klasė";4971244488;Taip;2;4;0;6
15345;Saulutė;"2 klasė";61073095949;Taip;0;4;0;4
15346;Saulutė;"2 klasė";1717909005;Taip;0;4;0;4
15347;Saulutė;"2 klasė";1513449225;Taip;15;4;0;19
15348;Saulutė;"2 klasė";87814849917;Taip;0;4;0;4
15349;Saulutė;"2 klasė";84919478493;Taip;0;4;0;4
15350;Saulutė;"2 klasė";1320018338;Taip;0;4;0;4
15351;Saulutė;"2 klasė";8599199376;Taip;1;4;0;5
15352;Saulutė;"2 klasė";8944601874;Taip;0;4;0;4
15353;Saulutė;"2 klasė";3064199909;Taip;0;4;0;4
15354;Saulutė;"2 klasė";1556270046;Taip;2;4;0;6
15355;Saulutė;"2 klasė";1911318708;Taip;0;4;0;4
15356;Saulutė;"2 klasė";4272320685;Taip;2;4;0;6
15357;Saulutė;"2 klasė";8952155496;Ne;0;4;0;4
15358;Saulutė;"2 klasė";28772515317;Taip;0;4;0;4
15359;Saulutė;"2 klasė";1291318940;Ne;0;4;0;4
15360;Saulutė;"2 klasė";2677995903;Taip;0;4;0;4
15361;Saulutė;"2 klasė";1391904744;Taip;0;4;0;4
15362;Saulutė;"2 klasė";1786491396;Taip;1;4;0;5
15363;Saulutė;"2 klasė";1386800520;Taip;2;4;0;6
15364;Saulutė;"2 klasė";6096297366;Ne;0;4;0;4
15365;Saulutė;"2 klasė";1332002470;Taip;0;4;0;4
15366;Saulutė;"2 klasė";1609952589;Taip;4;4;0;8
15367;Saulutė;"2 klasė";89920419797;Taip;1;4;0;5
15368;Saulutė;"3 klasė";45306237230;Taip;17;4;0;21
15369;Saulutė;"3 klasė";79438946697;Taip;3;4;0;7
15370;Saulutė;"3 klasė";79919438191;Ne;4;4;0;8
15371;Saulutė;"3 klasė";29074930927;Ne;1;4;0;5
15372;Saulutė;"3 klasė";8369703027;Taip;0;4;0;4
15373;Saulutė;"3 klasė";21605684303;Taip;5;4;0;9
15374;Saulutė;"3 klasė";31705050946;Taip;3;4;0;7
15375;Saulutė;"3 klasė";37315117916;Taip;0;4;0;4
15376;Saulutė;"3 klasė";3445723020;Ne;0;4;0;4
15377;Saulutė;"3 klasė";2098990667;Taip;3;4;0;7
15378;Saulutė;"3 klasė";27386434894;Taip;0;4;0;4
15379;Saulutė;"3 klasė";77923802656;Taip;1;4;0;5
15380;Saulutė;"3 klasė";46280382280;Taip;0;4;0;4
15381;Saulutė;"3 klasė";1935503629;Taip;1;4;0;5
15382;Saulutė;"3 klasė";75405796772;Taip;1;4;0;5
15383;Saulutė;"3 klasė";1277263391;Taip;1;4;0;5
15384;Saulutė;"3 klasė";97145959022;Taip;7;4;0;11
15385;Saulutė;"3 klasė";64418469679;Taip;0;4;0;4
15386;Saulutė;"3 klasė";77170708225;Taip;6;4;0;10
15387;Saulutė;"3 klasė";4640909915;Ne;0;4;0;4
15388;Saulutė;"3 klasė";65492344097;Taip;0;4;0;4
15389;Saulutė;"3 klasė";1704733670;Ne;1;4;0;5
15390;Saulutė;"3 klasė";1534183935;Taip;0;4;0;4
15391;Saulutė;"3 klasė";5574049005;Taip;1;4;0;5
15392;Saulutė;"3 klasė";1510434265;Taip;0;4;0;4
15393;Saulutė;"3 klasė";1422040758;Taip;4;4;0;8
15394;Saulutė;"3 klasė";77951768319;Ne;3;4;0;7
15395;Saulutė;"4 klasė";1005459768;Taip;4;4;0;8
15396;Saulutė;"4 klasė";1804521229;Taip;1;4;0;5
15397;Saulutė;"4 klasė";76108591835;Taip;4;4;0;8
15398;Saulutė;"4 klasė";1475031090;Taip;0;4;0;4
15399;Saulutė;"4 klasė";3156830821;Taip;1;4;0;5
15400;Saulutė;"4 klasė";5741276602;Taip;0;4;0;4
15401;Saulutė;"4 klasė";3246485288;Taip;2;4;0;6
15402;Saulutė;"4 klasė";44452051978;Ne;0;4;0;4
15403;Saulutė;"4 klasė";78967475616;Ne;0;4;0;4
15404;Saulutė;"4 klasė";89710141573;Taip;0;4;0;4
15405;Saulutė;"4 klasė";25124975646;Taip;2;4;0;6
15406;Saulutė;"4 klasė";3450668814;Taip;1;4;0;5
15407;Saulutė;"4 klasė";8168961080;Ne;1;4;0;5
15408;Saulutė;"4 klasė";57283533169;Taip;0;4;0;4
15409;Saulutė;"4 klasė";76744652185;Taip;2;4;0;6
15410;Saulutė;"4 klasė";97296161595;Taip;0;4;0;4
15411;Saulutė;"4 klasė";87409240076;Taip;0;4;0;4
15412;Saulutė;"4 klasė";1205642335;Taip;0;4;0;4
15413;Saulutė;"4 klasė";2426509692;Taip;1;4;0;5
15414;Saulutė;"4 klasė";36414547943;Taip;0;4;0;4
15415;Saulutė;"4 klasė";99841176399;Taip;0;4;0;4
15416;Saulutė;"4 klasė";21703177024;Taip;0;4;0;4
15417;Saulutė;"4 klasė";1337654926;Taip;2;4;0;6
15418;Saulutė;"4 klasė";54950572289;Taip;0;4;0;4
15419;Saulutė;"4 klasė";2787531476;Ne;4;4;0;8
15420;Saulutė;"4 klasė";13147367113;Taip;6;4;0;10
15421;Saulutė;"4 klasė";2216383015;Taip;0;4;0;4
15422;Saulutė;"4 klasė";1644704074;Taip;0;4;0;4
15423;Saulutė;"4 klasė";96497471950;Taip;3;4;0;7
15424;Saulutė;"4 klasė";6557918941;Ne;3;4;0;7
15425;Svaja;SAULĖGRĄŽA;3792660330;Taip;5;4;0;9
15426;Svaja;SAULĖGRĄŽA;7575922215;Taip;0;0;2;2
15427;Svaja;SAULĖGRĄŽA;4510147045;Taip;5;7;0;12
15428;Svaja;SAULĖGRĄŽA;9680766688;Taip;3;5;1;9
15429;Svaja;SAULĖGRĄŽA;3912426942;Taip;0;4;0;4
15430;Svaja;SAULĖGRĄŽA;3809817617;Taip;4;4;3;11
15431;Svaja;SAULĖGRĄŽA;3501620040;Taip;0;4;0;4
15432;Svaja;SAULĖGRĄŽA;6928763381;Taip;9;0;4;13
15433;Svaja;SAULĖGRĄŽA;7408966637;Taip;13;0;0;13
15434;Svaja;SAULĖGRĄŽA;7089640807;Taip;5;5;0;10
15435;Svaja;SAULĖGRĄŽA;3461282516;Taip;0;0;2;2
15436;Svaja;SAULĖGRĄŽA;4253831334;Taip;4;0;0;4
15437;Svaja;SAULĖGRĄŽA;6963684639;Taip;0;4;0;4
15438;Svaja;SAULĖGRĄŽA;4189290919;Taip;0;23;0;23
15439;Svaja;SAULĖGRĄŽA;7747251736;Taip;0;7;0;7
15440;Svaja;SAULĖGRĄŽA;2481547868;Taip;4;0;0;4
15441;Svaja;SAULĖGRĄŽA;8875703109;Taip;0;1;0;1
15442;Svaja;"STEBUKLINGAS ŽIBINTAS";1558093905;Taip;0;10;0;10
15443;Svaja;"STEBUKLINGAS ŽIBINTAS";1050291871;Taip;3;4;0;7
15444;Svaja;"STEBUKLINGAS ŽIBINTAS";2200408537;Ne;0;1;2;3
15445;Svaja;"STEBUKLINGAS ŽIBINTAS";9814969596;Taip;0;6;0;6
15446;Svaja;"STEBUKLINGAS ŽIBINTAS";4290716676;Taip;8;0;0;8
15447;Svaja;"STEBUKLINGAS ŽIBINTAS";9545690301;Taip;2;4;1;7
15448;Svaja;"STEBUKLINGAS ŽIBINTAS";6128350581;Taip;0;3;1;4
15449;Svaja;"STEBUKLINGAS ŽIBINTAS";9843726794;Taip;0;4;0;4
15450;Svaja;"STEBUKLINGAS ŽIBINTAS";2658828200;Taip;0;4;0;4
15451;Svaja;"STEBUKLINGAS ŽIBINTAS";3940123543;Taip;4;4;0;8
15452;Svaja;"STEBUKLINGAS ŽIBINTAS";1860076171;Taip;2;0;0;2
15453;Svaja;"STEBUKLINGAS ŽIBINTAS";9086270220;Taip;0;4;2;6
15454;Svaja;"STEBUKLINGAS ŽIBINTAS";9259478140;Taip;0;1;0;1
15455;Svaja;"STEBUKLINGAS ŽIBINTAS";4237592104;Ne;12;0;0;12
15456;Svaja;"STEBUKLINGAS ŽIBINTAS";8363418532;Taip;0;0;1;1
15457;Svaja;"STEBUKLINGAS ŽIBINTAS";7277217069;Taip;0;4;6;10
15458;Svaja;"STEBUKLINGAS ŽIBINTAS";8172396846;Taip;7;4;1;12
15459;Svaja;"STEBUKLINGAS ŽIBINTAS";2188430052;Taip;2;0;2;4
15460;Svaja;"STEBUKLINGAS ŽIBINTAS";4004383843;Taip;0;2;0;2
15461;Svaja;"STEBUKLINGAS ŽIBINTAS";8353427144;Taip;7;0;0;7
15462;Svaja;"STEBUKLINGAS ŽIBINTAS";1150040935;Taip;9;2;0;11
15463;Svaja;"STEBUKLINGAS ŽIBINTAS";4565097904;Taip;0;4;3;7
15464;Svaja;SAULUTĖ;8890454460;Taip;0;0;1;1
15465;Svaja;SAULUTĖ;5440231053;Taip;3;4;0;7
15466;Svaja;SAULUTĖ;3382252131;Taip;9;0;0;9
15467;Svaja;SAULUTĖ;4250501744;Taip;9;4;0;13
15468;Svaja;SAULUTĖ;3684781373;Taip;7;4;0;11
15469;Svaja;SAULUTĖ;1013124074;Taip;13;4;1;18
15470;Svaja;SAULUTĖ;8632400763;Taip;10;0;0;10
15471;Svaja;SAULUTĖ;5051491859;Taip;6;0;0;6
15472;Svaja;SAULUTĖ;1312040427;Taip;7;4;0;11
15473;Svaja;SAULUTĖ;5455078232;Taip;8;4;1;13
15474;Svaja;SAULUTĖ;7087302180;Taip;12;4;0;16
15475;Svaja;SAULUTĖ;6335409702;Taip;0;4;2;6
15476;Svaja;SAULUTĖ;6027456849;Taip;10;0;0;10
15477;Svaja;SAULUTĖ;8609098948;Taip;11;0;0;11
15478;Svaja;SAULUTĖ;1344097741;Taip;3;9;0;12
15479;Svaja;SAULUTĖ;7520701357;Taip;10;0;0;10
15480;Svaja;SAULUTĖ;2599692546;Taip;19;0;0;19
15481;Svaja;SAULUTĖ;4415517674;Taip;6;4;0;10
15482;Svaja;SAULUTĖ;6354364944;Taip;16;0;0;16
15483;Svaja;SAULUTĖ;5186248897;Taip;14;0;0;14
15484;Svaja;"AUKSINĖ ŽUVELĖ";1914129062;Taip;8;4;1;13
15485;Svaja;"AUKSINĖ ŽUVELĖ";2427918378;Taip;2;3;0;5
15486;Svaja;"AUKSINĖ ŽUVELĖ";3377044908;Taip;0;4;1;5
15487;Svaja;"AUKSINĖ ŽUVELĖ";3567924341;Taip;6;0;4;10
15488;Svaja;"AUKSINĖ ŽUVELĖ";5033214011;Taip;13;0;0;13
15489;Svaja;"AUKSINĖ ŽUVELĖ";5013548619;Taip;5;0;2;7
15490;Svaja;"AUKSINĖ ŽUVELĖ";9091970902;Taip;8;0;0;8
15491;Svaja;"AUKSINĖ ŽUVELĖ";6028471687;Taip;5;0;3;8
15492;Svaja;"AUKSINĖ ŽUVELĖ";1877749103;Taip;0;4;4;8
15493;Svaja;"AUKSINĖ ŽUVELĖ";7605002899;Taip;0;0;3;3
15494;Svaja;"AUKSINĖ ŽUVELĖ";5230444195;Taip;0;4;1;5
15495;Svaja;"AUKSINĖ ŽUVELĖ";5224855138;Taip;0;7;0;7
15496;Svaja;"AUKSINĖ ŽUVELĖ";5908440171;Taip;0;0;1;1
15497;Svaja;"AUKSINĖ ŽUVELĖ";7562678317;Taip;8;4;1;13
15498;Svaja;"AUKSINĖ ŽUVELĖ";5198482539;Taip;7;2;0;9
15499;Svaja;"AUKSINĖ ŽUVELĖ";7434898745;Taip;0;7;0;7
15500;Svaja;"AUKSINĖ ŽUVELĖ";1932506236;Taip;12;4;2;18
15501;Svaja;"AUKSINĖ ŽUVELĖ";3708286263;Taip;9;0;0;9
15502;Svaja;"PRIE ĮLANKOS";9240037050;Taip;15;0;0;15
15503;Svaja;"PRIE ĮLANKOS";3459060550;Ne;21;0;0;21
15504;Svaja;"PRIE ĮLANKOS";6361228838;Taip;0;0;2;2
15505;Svaja;"PRIE ĮLANKOS";7853479591;Taip;0;12;0;12
15506;Svaja;"PRIE ĮLANKOS";2770477678;Taip;0;7;1;8
15507;Svaja;"PRIE ĮLANKOS";5127370193;Taip;0;0;3;3
15508;Svaja;"PRIE ĮLANKOS";9689082202;Taip;0;0;1;1
15509;Svaja;"PRIE ĮLANKOS";3612833383;Taip;8;0;0;8
15510;Svaja;"PRIE ĮLANKOS";2993145079;Taip;3;0;0;3
15511;Svaja;"PRIE ĮLANKOS";6385127914;Taip;0;4;0;4
15512;Svaja;"PRIE ĮLANKOS";6102907953;Taip;9;0;1;10
15513;Svaja;"PRIE ĮLANKOS";2070084064;Taip;5;0;1;6
15514;Svaja;"PRIE ĮLANKOS";4256222944;Taip;3;0;0;3
15515;Svaja;"PRIE ĮLANKOS";1953538445;Taip;4;0;0;4
15516;Svaja;"PRIE ĮLANKOS";5126348190;Taip;3;0;0;3
15517;Svaja;"PRIE ĮLANKOS";3823958567;Taip;0;0;1;1
15518;Svaja;"PRIE ĮLANKOS";6059069293;Taip;4;0;0;4
15519;Svaja;"PRIE ĮLANKOS";8622800666;Ne;15;0;0;15
15520;Svaja;"1 B klasė";20473739993;Taip;12;11;0;23
15521;Svaja;"1 B klasė";50207734108;Ne;0;4;0;4
15522;Svaja;"1 B klasė";8689706130;Taip;2;4;0;6
15523;Svaja;"1 B klasė";1045300185;Taip;2;4;0;6
15524;Svaja;"1 B klasė";6665752307;Taip;1;4;0;5
15525;Svaja;"1 B klasė";5479482244;Ne;1;4;0;5
15526;Svaja;"1 B klasė";7020342969;Taip;1;4;0;5
15527;Svaja;"1 B klasė";2166382346;Ne;3;4;0;7
15528;Svaja;"1 B klasė";8503177793;Taip;2;4;0;6
15529;Svaja;"1 B klasė";1633236289;Taip;6;4;0;10
15530;Svaja;"1 B klasė";8656417794;Taip;1;4;0;5
15531;Svaja;"1 B klasė";4014493868;Taip;5;4;0;9
15532;Svaja;"1 B klasė";6388514464;Taip;2;4;0;6
15533;Svaja;"1 B klasė";1044733634;Taip;1;4;0;5
15534;Svaja;"1 B klasė";1392455608;Taip;0;4;0;4
15535;Svaja;"1 B klasė";9864664937;Taip;0;4;0;4
15536;Svaja;"1 B klasė";1617844709;Taip;10;4;0;14
15537;Svaja;"1 B klasė";5862570666;Taip;1;4;0;5
15538;Svaja;"1 B klasė";3102257512;Taip;2;4;0;6
15539;Svaja;"1 B klasė";4284157599;Taip;5;4;0;9
15540;Svaja;"1 B klasė";9950569499;Taip;1;4;0;5
15541;Svaja;"1 B klasė";3458374439;Taip;0;4;0;4
15542;Svaja;"1 B klasė";4541391191;Ne;1;4;0;5
15543;Svaja;"1 B klasė";7205437280;Ne;0;4;0;4
15544;Svaja;"1 B klasė";6638804854;Ne;5;4;0;9
15545;Svaja;"1 B klasė";67304194087;Ne;0;4;0;4
15546;Svaja;"1 B klasė";3000676765;Ne;2;4;0;6
15547;Svaja;"1 B klasė";2627089275;Taip;2;4;0;6
15548;Svaja;"1 A klasė";9112198914;Taip;3;4;0;7
15549;Svaja;"1 A klasė";6807834176;Taip;1;4;0;5
15550;Svaja;"1 A klasė";7936765752;Taip;4;4;0;8
15551;Svaja;"1 A klasė";3049808328;Taip;0;4;0;4
15552;Svaja;"1 A klasė";3802996573;Taip;6;4;0;10
15553;Svaja;"1 A klasė";5443682744;Taip;2;4;0;6
15554;Svaja;"1 A klasė";9475971731;Taip;7;4;0;11
15555;Svaja;"1 A klasė";4968201186;Taip;2;4;0;6
15556;Svaja;"1 A klasė";7473493846;Taip;13;4;0;17
15557;Svaja;"1 A klasė";30719991872;Taip;6;4;0;10
15558;Svaja;"1 A klasė";3633996231;Taip;0;4;0;4
15559;Svaja;"1 A klasė";2750615517;Taip;4;4;0;8
15560;Svaja;"1 A klasė";9311520300;Taip;1;4;0;5
15561;Svaja;"1 A klasė";5595087767;Taip;0;4;0;4
15562;Svaja;"1 A klasė";6676145522;Taip;0;4;0;4
15563;Svaja;"1 A klasė";2018689468;Taip;3;4;0;7
15564;Svaja;"1 A klasė";1671495181;Taip;2;4;0;6
15565;Svaja;"1 A klasė";7514587933;Ne;10;4;0;14
15566;Svaja;"1 A klasė";4393041946;Taip;0;4;0;4
15567;Svaja;"1 A klasė";3868254757;Taip;0;4;0;4
15568;Svaja;"1 A klasė";1377813636;Taip;0;4;0;4
15569;Svaja;"1 A klasė";3630922360;Taip;4;4;0;8
15570;Svaja;"1 A klasė";6995285377;Ne;4;4;0;8
15571;Svaja;"1 A klasė";2436416327;Ne;0;4;0;4
15572;Svaja;"1 A klasė";8357287467;Ne;1;4;0;5
15573;Svaja;"1 A klasė";3636826798;Taip;0;4;0;4
15574;Svaja;"1 A klasė";1114477688;Ne;0;4;0;4
15575;Svaja;"1 A klasė";5356005675;Ne;1;4;0;5
15576;Svaja;"2 A klasė";43307670660;Taip;0;4;0;4
15577;Svaja;"2 A klasė";58102699652;Taip;0;4;0;4
15578;Svaja;"2 A klasė";5335776957;Taip;2;21;0;23
15579;Svaja;"2 A klasė";22702341083;Taip;5;4;0;9
15580;Svaja;"2 A klasė";2076060840;Taip;1;4;0;5
15581;Svaja;"2 A klasė";27445299450;Taip;0;4;0;4
15582;Svaja;"2 A klasė";1576498450;Taip;0;4;0;4
15583;Svaja;"2 A klasė";1714711904;Taip;0;4;0;4
15584;Svaja;"2 A klasė";1046879533;Taip;1;4;0;5
15585;Svaja;"2 A klasė";65917456866;Taip;0;4;0;4
15586;Svaja;"2 A klasė";4846025153;Taip;0;4;0;4
15587;Svaja;"2 A klasė";47457128214;Taip;0;4;0;4
15588;Svaja;"2 A klasė";2147266053;Taip;0;4;0;4
15589;Svaja;"2 A klasė";1197826066;Taip;0;4;0;4
15590;Svaja;"2 A klasė";5337604370;Taip;0;4;0;4
15591;Svaja;"2 A klasė";73679997517;Taip;1;4;0;5
15592;Svaja;"2 A klasė";56117509354;Taip;2;4;0;6
15593;Svaja;"2 A klasė";7669562010;Ne;5;4;0;9
15594;Svaja;"2 A klasė";4900757614;Taip;3;4;0;7
15595;Svaja;"2 A klasė";1061894314;Taip;5;4;0;9
15596;Svaja;"2 A klasė";8697355813;Taip;9;4;0;13
15597;Svaja;"2 A klasė";193181908;Ne;0;4;0;4
15598;Svaja;"2 A klasė";193181908;Ne;0;4;0;4
15599;Svaja;"2 B klasė";25194696146;Taip;0;4;0;4
15600;Svaja;"2 B klasė";55925058866;Taip;0;23;0;23
15601;Svaja;"2 B klasė";1704075006;Taip;1;4;0;5
15602;Svaja;"2 B klasė";8875237023;Taip;6;4;0;10
15603;Svaja;"2 B klasė";8279605005;Taip;0;23;0;23
15604;Svaja;"2 B klasė";1437557657;Taip;2;4;0;6
15605;Svaja;"2 B klasė";36505115395;Taip;0;23;0;23
15606;Svaja;"2 B klasė";6593047776;Taip;2;4;0;6
15607;Svaja;"2 B klasė";7911488445;Taip;1;4;0;5
15608;Svaja;"2 B klasė";64196174690;Taip;5;18;0;23
15609;Svaja;"2 B klasė";7753488216;Taip;1;4;0;5
15610;Svaja;"2 B klasė";21871530266;Taip;5;4;0;9
15611;Svaja;"2 B klasė";9110985103;Taip;1;4;0;5
15612;Svaja;"2 B klasė";2985196852;Taip;0;4;0;4
15613;Svaja;"2 B klasė";3562817807;Taip;5;18;0;23
15614;Svaja;"2 B klasė";2069150261;Taip;2;4;0;6
15615;Svaja;"2 B klasė";1191494598;Taip;0;4;0;4
15616;Svaja;"2 B klasė";24863928147;Taip;0;4;0;4
15617;Svaja;"2 B klasė";15159708127;Taip;5;4;0;9
15618;Svaja;"2 B klasė";8491275729;Taip;1;4;0;5
15619;Svaja;"2 B klasė";11671380984;Taip;0;4;0;4
15620;Svaja;"2 B klasė";99183628764;Taip;2;4;0;6
15621;Svaja;"2 B klasė";1369637618;Taip;0;4;0;4
15622;Svaja;"2 B klasė";3660152224;Taip;3;4;0;7
15623;Svaja;"2 B klasė";1865658456;Taip;3;4;0;7
15624;Svaja;"3 A klasė";9628146488;Ne;0;5;0;5
15625;Svaja;"3 A klasė";1017471747;Taip;0;5;0;5
15626;Svaja;"3 A klasė";1304775332;Taip;2;5;0;7
15627;Svaja;"3 A klasė";26902749194;Taip;2;5;0;7
15628;Svaja;"3 A klasė";1297727288;Taip;0;5;0;5
15629;Svaja;"3 A klasė";30027404222;Taip;0;5;0;5
15630;Svaja;"3 A klasė";1352488176;Taip;0;5;0;5
15631;Svaja;"3 A klasė";1943166503;Taip;2;5;0;7
15632;Svaja;"3 A klasė";8198614500;Taip;2;5;0;7
15633;Svaja;"3 A klasė";5522433229;Taip;0;5;0;5
15634;Svaja;"3 A klasė";40856210635;Taip;1;5;0;6
15635;Svaja;"3 A klasė";67462299886;Taip;0;5;0;5
15636;Svaja;"3 A klasė";18733824395;Taip;0;5;0;5
15637;Svaja;"3 A klasė";26500981786;Taip;1;5;0;6
15638;Svaja;"3 A klasė";89042677798;Taip;0;5;0;5
15639;Svaja;"3 A klasė";3022690832;Taip;0;5;0;5
15640;Svaja;"3 A klasė";23112873505;Taip;0;5;0;5
15641;Svaja;"3 A klasė";15246943974;Taip;1;5;0;6
15642;Svaja;"3 A klasė";1562041360;Taip;0;5;0;5
15643;Svaja;"3 A klasė";2058827699;Taip;1;5;0;6
15644;Svaja;"3 A klasė";84508228457;Taip;1;5;0;6
15645;Svaja;"3 A klasė";1048576329;Taip;1;5;0;6
15646;Svaja;"3 B klasė";69028070656;Taip;4;9;0;13
15647;Svaja;"3 B klasė";30360097999;Taip;19;4;0;23
15648;Svaja;"3 B klasė";19887874988;Ne;1;5;0;6
15649;Svaja;"3 B klasė";1967394949;Taip;0;5;0;5
15650;Svaja;"3 B klasė";7719185632;Taip;0;5;0;5
15651;Svaja;"3 B klasė";57216954289;Taip;2;5;0;7
15652;Svaja;"3 B klasė";44989143252;Taip;0;6;0;6
15653;Svaja;"3 B klasė";87432529423;Taip;2;5;0;7
15654;Svaja;"3 B klasė";3077814152;Taip;2;5;0;7
15655;Svaja;"3 B klasė";6056157113;Taip;0;5;0;5
15656;Svaja;"3 B klasė";21608020858;Taip;2;5;0;7
15657;Svaja;"3 B klasė";1655551042;Taip;11;5;0;16
15658;Svaja;"3 B klasė";1601648171;Taip;0;5;0;5
15659;Svaja;"3 B klasė";1509272327;Ne;0;5;0;5
15660;Svaja;"3 B klasė";4804779327;Taip;2;21;0;23
15661;Svaja;"3 B klasė";40814723278;Taip;2;5;0;7
15662;Svaja;"3 B klasė";69413101571;Taip;0;5;0;5
15663;Svaja;"3 B klasė";54745410330;Taip;0;5;0;5
15664;Svaja;"3 B klasė";4881476441;Taip;7;5;0;12
15665;Svaja;"3 B klasė";78293798850;Taip;3;5;0;8
15666;Svaja;"3 B klasė";30036722764;Taip;0;5;0;5
15667;Svaja;"3 B klasė";89316574266;Taip;1;22;0;23
15668;Svaja;"3 B klasė";809734624;Taip;0;5;0;5
15669;Svaja;"3 B klasė";76618850202;Taip;0;5;0;5
15670;Svaja;"3 B klasė";1378219785;Taip;0;5;0;5
15671;Svaja;"4 A klasė";6057524892;Taip;1;5;0;6
15672;Svaja;"4 A klasė";63346231562;Taip;2;6;0;8
15673;Svaja;"4 A klasė";25578518444;Taip;0;5;0;5
15674;Svaja;"4 A klasė";64487515384;Taip;0;23;0;23
15675;Svaja;"4 A klasė";89695643588;Taip;1;5;0;6
15676;Svaja;"4 A klasė";15252353189;Taip;4;5;0;9
15677;Svaja;"4 A klasė";4617061890;Taip;6;5;0;11
15678;Svaja;"4 A klasė";8828911320;Taip;0;23;0;23
15679;Svaja;"4 A klasė";75104768118;Taip;0;5;0;5
15680;Svaja;"4 A klasė";3604946305;Taip;0;23;0;23
15681;Svaja;"4 A klasė";34216516886;Taip;0;4;0;4
15682;Svaja;"4 A klasė";3474439050;Taip;6;5;0;11
15683;Svaja;"4 A klasė";72752022712;Taip;4;4;0;8
15684;Svaja;"4 A klasė";30754812113;Taip;0;5;0;5
15685;Svaja;"4 A klasė";75296600945;Ne;4;5;0;9
15686;Svaja;"4 A klasė";2321739150;Ne;0;5;0;5
15687;Svaja;"4 A klasė";1168637823;Taip;3;5;0;8
15688;Svaja;"4 A klasė";4906784415;Taip;0;5;0;5
15689;Svaja;"4 A klasė";60448774566;Taip;5;8;0;13
15690;Svaja;"4 A klasė";1649920341;Taip;1;5;0;6
15691;Svaja;"4 B klasė";70506691027;Taip;0;23;0;23
15692;Svaja;"4 B klasė";73391331150;Taip;0;23;0;23
15693;Svaja;"4 B klasė";70507326327;Taip;1;22;0;23
15694;Svaja;"4 B klasė";1470843400;Taip;0;5;0;5
15695;Svaja;"4 B klasė";8011137572;Taip;0;5;0;5
15696;Svaja;"4 B klasė";4416877973;Taip;1;5;0;6
15697;Svaja;"4 B klasė";54328462992;Taip;0;23;0;23
15698;Svaja;"4 B klasė";44418402260;Taip;0;5;0;5
15699;Svaja;"4 B klasė";1367687415;Taip;1;5;0;6
15700;Svaja;"4 B klasė";92044111261;Taip;0;5;0;5
15701;Svaja;"4 B klasė";1847775266;Taip;0;5;0;5
15702;Svaja;"4 B klasė";71708072632;Taip;0;5;0;5
15703;Svaja;"4 B klasė";56506642672;Taip;0;5;0;5
15704;Svaja;"4 B klasė";17947580061;Taip;7;5;0;12
15705;Svaja;"4 B klasė";3526873547;Taip;7;5;0;12
15706;Svaja;"4 B klasė";62971657427;Taip;0;5;0;5
15707;Svaja;"4 B klasė";50649509868;Taip;5;18;0;23
15708;Svaja;"4 B klasė";80772711351;Taip;3;5;0;8
15709;Svaja;"4 B klasė";11937575740;Taip;0;5;0;5
15710;Svaja;"4 B klasė";6969692916;Ne;0;5;0;5
15711;Svaja;"4 B klasė";4282243865;Taip;0;5;0;5
15712;Svaja;"4 B klasė";6905550313;Ne;0;5;0;5
15713;Svaja;"4 C klasė";93651139102;Taip;2;5;0;7
15714;Svaja;"4 C klasė";25934507261;Taip;4;5;0;9
15715;Svaja;"4 C klasė";89047123808;Taip;0;5;0;5
15716;Svaja;"4 C klasė";41183537732;Taip;2;5;0;7
15717;Svaja;"4 C klasė";50510924690;Taip;0;5;0;5
15718;Svaja;"4 C klasė";54462393937;Taip;0;5;0;5
15719;Svaja;"4 C klasė";74904581010;Taip;1;5;0;6
15720;Svaja;"4 C klasė";1795682827;Taip;0;5;0;5
15721;Svaja;"4 C klasė";2165716699;Taip;5;18;0;23
15722;Svaja;"4 C klasė";94449039022;Taip;0;23;0;23
15723;Svaja;"4 C klasė";85150525696;Taip;5;5;0;10
15724;Svaja;"4 C klasė";36001411632;Taip;3;5;0;8
15725;Svaja;"4 C klasė";34995551069;Taip;0;5;0;5
15726;Svaja;"4 C klasė";1742951527;Taip;2;5;0;7
15727;Svaja;"4 C klasė";1848422504;Taip;2;5;0;7
15728;Svaja;"4 C klasė";3743948734;Taip;2;5;0;7
15729;Svaja;"4 C klasė";70714898590;Taip;0;5;0;5
15730;Svaja;"4 C klasė";54852358913;Taip;2;5;0;7
15731;Svaja;"4 C klasė";57253216255;Taip;5;5;0;10
15732;Svaja;"4 C klasė";91855230473;Taip;3;5;0;8
15733;Svaja;"4 C klasė";1855559693;Taip;4;19;0;23
15734;Svaja;"4 C klasė";31216445971;Taip;0;23;0;23
15735;Svaja;"4 C klasė";20342193231;Taip;0;5;0;5
15736;Svaja;"4 C klasė";91088224294;Taip;0;23;0;23
15737;Šilelis;PAUKŠTELIAI;6128379060;Taip;12;4;0;16
15738;Šilelis;PAUKŠTELIAI;2823486581;Taip;10;0;0;10
15739;Šilelis;PAUKŠTELIAI;6369443270;Taip;6;9;0;15
15740;Šilelis;PAUKŠTELIAI;7595774842;Taip;7;0;0;7
15741;Šilelis;PAUKŠTELIAI;6614686867;Taip;10;0;0;10
15742;Šilelis;PAUKŠTELIAI;3053443777;Taip;10;0;1;11
15743;Šilelis;PAUKŠTELIAI;4960501068;Taip;6;1;0;7
15744;Šilelis;PAUKŠTELIAI;7072057348;Taip;4;8;0;12
15745;Šilelis;PAUKŠTELIAI;5974537364;Taip;0;4;0;4
15746;Šilelis;PAUKŠTELIAI;8184170908;Taip;9;0;0;9
15747;Šilelis;PAUKŠTELIAI;4432542988;Taip;13;0;0;13
15748;Šilelis;PAUKŠTELIAI;9799198904;Taip;8;0;0;8
15749;Šilelis;PAUKŠTELIAI;5493811298;Ne;3;0;1;4
15750;Šilelis;PAUKŠTELIAI;4032841142;Ne;4;0;1;5
15751;Šilelis;PAUKŠTELIAI;7652950762;Taip;9;0;1;10
15752;Šilelis;SKRUZDELIUKAI;7502057552;Taip;0;1;0;1
15753;Šilelis;SKRUZDELIUKAI;6359318134;Taip;9;4;1;14
15754;Šilelis;SKRUZDELIUKAI;5598152793;Taip;11;1;0;12
15755;Šilelis;SKRUZDELIUKAI;8090773379;Taip;7;3;0;10
15756;Šilelis;SKRUZDELIUKAI;7299084520;Taip;0;8;0;8
15757;Šilelis;SKRUZDELIUKAI;8578620603;Taip;0;0;1;1
15758;Šilelis;SKRUZDELIUKAI;9589138527;Taip;5;5;0;10
15759;Šilelis;SKRUZDELIUKAI;3967932407;Taip;0;4;0;4
15760;Šilelis;SKRUZDELIUKAI;4629917226;Taip;2;1;0;3
15761;Šilelis;SKRUZDELIUKAI;9461117894;Taip;4;0;2;6
15762;Šilelis;SKRUZDELIUKAI;5817818596;Taip;0;4;0;4
15763;Šilelis;SKRUZDELIUKAI;6827855685;Taip;0;0;3;3
15764;Šilelis;SKRUZDELIUKAI;5091571136;Ne;0;0;3;3
15765;Šilelis;SKRUZDELIUKAI;8297975308;Taip;0;12;0;12
15766;Šilelis;SKRUZDELIUKAI;3381053227;Taip;0;3;0;3
15767;Šilelis;SKRUZDELIUKAI;9276607554;Taip;0;6;0;6
15768;Šilelis;SMERFY;3247333567;Taip;0;3;0;3
15769;Šilelis;SMERFY;9886134621;Ne;1;0;0;1
15770;Šilelis;SMERFY;3089270468;Taip;10;0;0;10
15771;Šilelis;SMERFY;4504627601;Taip;13;0;0;13
15772;Šilelis;SMERFY;7534468539;Taip;0;1;0;1
15773;Šilelis;SMERFY;6390855924;Taip;9;0;0;9
15774;Šilelis;SMERFY;1821827154;Taip;0;1;0;1
15775;Šilelis;SMERFY;1890114622;Taip;4;1;0;5
15776;Šilelis;SMERFY;5025956218;Taip;2;4;0;6
15777;Šilelis;SMERFY;8909345826;Taip;0;3;0;3
15778;Šilelis;SMERFY;9502563865;Taip;5;0;0;5
15779;Šilelis;SMERFY;3452984649;Taip;1;0;0;1
15780;Šilelis;SMERFY;1906712332;Taip;11;0;0;11
15781;Šilelis;EŽIUKAI;7074963804;Taip;0;2;0;2
15782;Šilelis;EŽIUKAI;4702068672;Taip;0;4;0;4
15783;Šilelis;EŽIUKAI;2295849333;Taip;4;4;0;8
15784;Šilelis;EŽIUKAI;1883483049;Taip;1;1;0;2
15785;Šilelis;EŽIUKAI;6386996498;Taip;4;0;1;5
15786;Šilelis;EŽIUKAI;6233673622;Taip;16;2;0;18
15787;Šilelis;EŽIUKAI;3312235148;Taip;3;0;1;4
15788;Šilelis;EŽIUKAI;5314433515;Taip;5;0;0;5
15789;Šilelis;EŽIUKAI;1980323777;Taip;5;0;0;5
15790;Šilelis;EŽIUKAI;9203888742;Taip;2;12;0;14
15791;Šilelis;EŽIUKAI;2289616655;Taip;4;0;1;5
15792;Šilelis;EŽIUKAI;5167084901;Ne;0;0;4;4
15793;Šilelis;EŽIUKAI;3669647107;Taip;0;1;0;1
15794;Šilelis;EŽIUKAI;2151250706;Taip;4;0;1;5
15795;Šilelis;EŽIUKAI;7891369140;Taip;3;0;1;4
15796;Šilelis;NYKŠTUKAI;3046954717;Taip;0;4;0;4
15797;Šilelis;NYKŠTUKAI;3158708835;Taip;3;1;0;4
15798;Šilelis;NYKŠTUKAI;6195580698;Taip;0;0;2;2
15799;Šilelis;NYKŠTUKAI;6107771932;Taip;3;2;4;9
15800;Šilelis;NYKŠTUKAI;4323998445;Taip;10;0;0;10
15801;Šilelis;NYKŠTUKAI;2095572561;Taip;4;0;1;5
15802;Šilelis;NYKŠTUKAI;2161973782;Taip;8;0;0;8
15803;Šilelis;NYKŠTUKAI;4459114205;Taip;0;1;0;1
15804;Šilelis;NYKŠTUKAI;3728633100;Taip;7;1;0;8
15805;Šilelis;NYKŠTUKAI;3999426414;Taip;0;4;0;4
15806;Šilelis;NYKŠTUKAI;5745874033;Taip;0;3;0;3
15807;Šilelis;NYKŠTUKAI;9769483899;Taip;10;1;1;12
15808;Šilelis;NYKŠTUKAI;8944490184;Taip;0;0;1;1
15809;Šilelis;NYKŠTUKAI;2908840424;Taip;14;2;0;16
15810;Šilelis;NYKŠTUKAI;6980045156;Taip;0;1;0;1
15811;Šilelis;NYKŠTUKAI;4868465692;Taip;9;1;0;10
15812;Šilelis;NYKŠTUKAI;4754544277;Taip;14;2;0;16
15813;Šilelis;NYKŠTUKAI;1222028604;Taip;4;17;2;23
15814;Šilelis;NYKŠTUKAI;7480611069;Taip;4;1;0;5
15815;Šilelis;NYKŠTUKAI;9360553910;Taip;4;1;0;5
15816;Šilelis;NYKŠTUKAI;6852463814;Ne;5;6;0;11
15817;Šilelis;NYKŠTUKAI;9715544798;Taip;0;4;0;4
15818;Šilelis;ANČIUKAI;1726944289;Taip;7;0;1;8
15819;Šilelis;ANČIUKAI;9661578871;Taip;7;0;2;9
15820;Šilelis;ANČIUKAI;6616262730;Taip;0;6;0;6
15821;Šilelis;ANČIUKAI;4323750313;Taip;7;0;0;7
15822;Šilelis;ANČIUKAI;3221398692;Taip;0;0;1;1
15823;Šilelis;ANČIUKAI;6364741317;Taip;18;0;0;18
15824;Šilelis;ANČIUKAI;1325857464;Taip;4;0;1;5
15825;Šilelis;ANČIUKAI;9407916190;Taip;0;12;0;12
15826;Šilelis;ANČIUKAI;8188160849;Taip;0;0;1;1
15827;Šilelis;ANČIUKAI;7128670936;Taip;16;0;0;16
15828;Šilelis;ANČIUKAI;8613748314;Taip;10;1;0;11
15829;Šilelis;ANČIUKAI;5381213051;Taip;0;4;0;4
15830;Šilelis;ANČIUKAI;8807755852;Taip;9;0;0;9
15831;Šilelis;ANČIUKAI;5926624138;Taip;0;7;0;7
15832;Šilelis;ANČIUKAI;8603589758;Taip;0;0;2;2
15833;Šilelis;ANČIUKAI;4996192593;Taip;17;0;0;17
15834;Šilelis;ANČIUKAI;6485433036;Ne;11;2;1;14
15835;Šilelis;ANČIUKAI;7968869585;Taip;14;0;0;14
15836;Šilelis;ANČIUKAI;3182336761;Taip;9;0;6;15
15837;Šilelis;ANČIUKAI;9767000842;Taip;3;2;0;5
15838;Šilelis;KAČIUKAI;9899047136;Taip;5;0;0;5
15839;Šilelis;KAČIUKAI;3216168797;Taip;8;0;1;9
15840;Šilelis;KAČIUKAI;9848760151;Taip;3;5;2;10
15841;Šilelis;KAČIUKAI;8387022157;Taip;0;12;0;12
15842;Šilelis;KAČIUKAI;3393466953;Taip;0;2;0;2
15843;Šilelis;KAČIUKAI;8064905796;Taip;0;6;0;6
15844;Šilelis;KAČIUKAI;7123048946;Taip;0;0;4;4
15845;Šilelis;KAČIUKAI;2906501601;Taip;0;7;0;7
15846;Šilelis;KAČIUKAI;6510813364;Taip;0;5;0;5
15847;Šilelis;KAČIUKAI;8319185507;Taip;0;1;0;1
15848;Šilelis;KAČIUKAI;8504187981;Taip;0;5;5;10
15849;Šilelis;KAČIUKAI;6470073008;Taip;0;2;0;2
15850;Šilelis;KAČIUKAI;3419284228;Taip;2;1;0;3
15851;Šilelis;KAČIUKAI;3712001932;Taip;3;5;0;8
15852;Šilelis;KAČIUKAI;9106999969;Taip;4;0;0;4
15853;Šilelis;KAČIUKAI;6894466509;Taip;13;0;5;18
15854;Šilelis;KAČIUKAI;5026203678;Taip;9;2;0;11
15855;Šilelis;KAČIUKAI;1395257200;Taip;4;0;0;4
15856;Šilelis;KAČIUKAI;6561145380;Taip;0;4;0;4
15857;Šilelis;KAČIUKAI;5138192616;Taip;5;1;0;6
15858;Šilelis;KIŠKUČIAI;9480895465;Taip;0;0;3;3
15859;Šilelis;KIŠKUČIAI;8759694551;Taip;10;0;0;10
15860;Šilelis;KIŠKUČIAI;2209552706;Taip;12;0;0;12
15861;Šilelis;KIŠKUČIAI;3296197220;Taip;4;0;0;4
15862;Šilelis;KIŠKUČIAI;4386065478;Taip;0;0;1;1
15863;Šilelis;KIŠKUČIAI;7043644521;Taip;6;0;2;8
15864;Šilelis;KIŠKUČIAI;9746722034;Taip;0;1;1;2
15865;Šilelis;KIŠKUČIAI;5815768693;Taip;0;0;1;1
15866;Šilelis;KIŠKUČIAI;8598321310;Taip;0;0;7;7
15867;Šilelis;KIŠKUČIAI;9992207035;Taip;0;0;3;3
15868;Šilelis;KIŠKUČIAI;5431978292;Taip;0;0;3;3
15869;Šilelis;KIŠKUČIAI;6415777619;Taip;17;0;0;17
15870;Šilelis;KIŠKUČIAI;7630784355;Ne;7;6;0;13
15871;Šilelis;KIŠKUČIAI;7822646258;Taip;0;4;1;5
15872;Šilelis;KIŠKUČIAI;4910899296;Taip;0;2;2;4
15873;Šilelis;KREGŽDUTĖS;1025643459;Taip;15;0;0;15
15874;Šilelis;KREGŽDUTĖS;2896605690;Taip;0;4;0;4
15875;Šilelis;KREGŽDUTĖS;8453070684;Taip;0;11;0;11
15876;Šilelis;KREGŽDUTĖS;1286082219;Taip;4;0;0;4
15877;Šilelis;KREGŽDUTĖS;3068950702;Taip;11;0;0;11
15878;Šilelis;KREGŽDUTĖS;8665357907;Taip;18;0;0;18
15879;Šilelis;KREGŽDUTĖS;1152159735;Taip;0;4;0;4
15880;Šilelis;KREGŽDUTĖS;6630114847;Taip;13;0;0;13
15881;Šilelis;KREGŽDUTĖS;3953114161;Taip;2;0;0;2
15882;Šilelis;KREGŽDUTĖS;2499322761;Taip;13;0;0;13
15883;Šilelis;KREGŽDUTĖS;5868594049;Taip;7;0;3;10
15884;Šilelis;KREGŽDUTĖS;8855625488;Taip;1;0;0;1
15885;Šilelis;KREGŽDUTĖS;5223262925;Taip;0;4;0;4
15886;Šilelis;KREGŽDUTĖS;1279361795;Taip;13;0;0;13
15887;Šilelis;KREGŽDUTĖS;9292761872;Taip;13;0;2;15
15888;Šilelis;KREGŽDUTĖS;6987557382;Taip;11;0;2;13
15889;Šilelis;KREGŽDUTĖS;9991765829;Ne;5;0;0;5
15890;Šilelis;KREGŽDUTĖS;4696129999;Taip;7;0;0;7
15891;Šilelis;KREGŽDUTĖS;1805615293;Taip;0;4;0;4
15892;Šilelis;KREGŽDUTĖS;5192604763;Taip;4;0;2;6
15893;Šilelis;KREGŽDUTĖS;6065839221;Ne;9;0;0;9
15894;Šilelis;PAGRANDUKAI;8632645047;Taip;4;0;0;4
15895;Šilelis;PAGRANDUKAI;8616798722;Taip;8;1;0;9
15896;Šilelis;PAGRANDUKAI;6598481106;Taip;21;0;0;21
15897;Šilelis;PAGRANDUKAI;8654600612;Taip;11;0;0;11
15898;Šilelis;PAGRANDUKAI;7900611929;Taip;8;0;0;8
15899;Šilelis;PAGRANDUKAI;1325551883;Taip;11;1;0;12
15900;Šilelis;PAGRANDUKAI;6090493923;Taip;23;0;0;23
15901;Šilelis;PAGRANDUKAI;3627435667;Taip;0;3;0;3
15902;Šilelis;PAGRANDUKAI;5090120850;Taip;13;0;0;13
15903;Šilelis;PAGRANDUKAI;7890456241;Taip;14;0;0;14
15904;Šilelis;PAGRANDUKAI;3147394614;Taip;3;1;0;4
15905;Šilelis;PAGRANDUKAI;2693883266;Taip;8;0;0;8
15906;Šilelis;PAGRANDUKAI;2702371841;Taip;15;0;0;15
15907;Šilelis;PAGRANDUKAI;2378919393;Taip;14;0;0;14
15908;Šilelis;BITUTĖS;7512731255;Taip;12;0;0;12
15909;Šilelis;BITUTĖS;7814807923;Taip;9;6;0;15
15910;Šilelis;BITUTĖS;9071963194;Taip;4;0;1;5
15911;Šilelis;BITUTĖS;1960952604;Taip;5;5;0;10
15912;Šilelis;BITUTĖS;7350013139;Taip;0;0;3;3
15913;Šilelis;BITUTĖS;3879234745;Taip;0;5;3;8
15914;Šilelis;BITUTĖS;3062557053;Taip;0;1;0;1
15915;Šilelis;BITUTĖS;1390916076;Taip;0;2;0;2
15916;Šilelis;BITUTĖS;2023309512;Ne;4;0;0;4
15917;Šilelis;BITUTĖS;5375413045;Taip;0;16;0;16
15918;Šilelis;BITUTĖS;6830200578;Taip;0;3;0;3
15919;Šilelis;BITUTĖS;6479728064;Taip;0;10;0;10
15920;Šilelis;BITUTĖS;3686287802;Ne;0;5;0;5
15921;Šilelis;BITUTĖS;9602317911;Taip;0;3;0;3
15922;Šilelis;BITUTĖS;8304500877;Taip;0;4;0;4
15923;Šilelis;BITUTĖS;7061399035;Taip;0;4;1;5
15924;Šilelis;DRUGELIAI;6800679760;Taip;4;8;1;13
15925;Šilelis;DRUGELIAI;3100416582;Taip;12;0;0;12
15926;Šilelis;DRUGELIAI;8563843417;Taip;12;0;0;12
15927;Šilelis;DRUGELIAI;5131513427;Taip;0;11;0;11
15928;Šilelis;DRUGELIAI;2575292661;Taip;0;12;0;12
15929;Šilelis;DRUGELIAI;8579501639;Taip;14;4;0;18
15930;Šilelis;DRUGELIAI;2073341570;Taip;17;0;1;18
15931;Šilelis;DRUGELIAI;3940956024;Taip;9;0;1;10
15932;Šilelis;DRUGELIAI;9047094780;Taip;4;4;0;8
15933;Šilelis;DRUGELIAI;4513916744;Taip;19;0;0;19
15934;Šilelis;DRUGELIAI;9593306122;Taip;16;0;0;16
15935;Šilelis;DRUGELIAI;5845704184;Taip;0;1;0;1
15936;Šilelis;DRUGELIAI;5899112658;Taip;19;0;0;19
15937;Vaduvos;PAGRANDUKAI;6611531526;Taip;0;8;0;8
15938;Vaduvos;PAGRANDUKAI;5509202519;Taip;2;0;1;3
15939;Vaduvos;PAGRANDUKAI;4576510280;Taip;18;0;0;18
15940;Vaduvos;PAGRANDUKAI;3060409258;Taip;0;2;0;2
15941;Vaduvos;PAGRANDUKAI;8070494719;Taip;4;0;0;4
15942;Vaduvos;PAGRANDUKAI;3206096414;Ne;8;0;0;8
15943;Vaduvos;PAGRANDUKAI;9232960362;Taip;14;0;0;14
15944;Vaduvos;PAGRANDUKAI;7425991335;Taip;5;0;0;5
15945;Vaduvos;PAGRANDUKAI;7592658267;Taip;4;0;0;4
15946;Vaduvos;PAGRANDUKAI;8533315132;Taip;0;8;0;8
15947;Vaduvos;PAGRANDUKAI;2508650990;Taip;0;6;0;6
15948;Vaduvos;PAGRANDUKAI;1466282653;Taip;8;1;0;9
15949;Vaduvos;PAGRANDUKAI;8055108164;Taip;10;0;0;10
15950;Vaduvos;PAGRANDUKAI;6943057114;Taip;0;3;0;3
15951;Vaduvos;PAGRANDUKAI;8669267296;Taip;13;0;0;13
15952;Vaduvos;PAGRANDUKAI;1736248725;Taip;18;0;0;18
15953;Vaduvos;PAGRANDUKAI;2369774637;Taip;16;0;0;16
15954;Vaduvos;PAGRANDUKAI;9385879695;Taip;12;0;1;13
15955;Vaduvos;PAGRANDUKAI;1414575326;Taip;11;0;0;11
15956;Vaduvos;PAGRANDUKAI;3710830036;Taip;3;6;1;10
15957;Vaduvos;PAGRANDUKAI;7205880191;Taip;16;0;0;16
15958;Vaduvos;PAGRANDUKAI;3695552176;Taip;11;0;0;11
15959;Vaduvos;KODĖLČIUKAI;3010510262;Taip;6;0;0;6
15960;Vaduvos;KODĖLČIUKAI;9429028460;Taip;0;5;0;5
15961;Vaduvos;KODĖLČIUKAI;6210729584;Taip;0;6;0;6
15962;Vaduvos;KODĖLČIUKAI;9606193112;Taip;1;6;0;7
15963;Vaduvos;KODĖLČIUKAI;4177935331;Taip;0;2;0;2
15964;Vaduvos;KODĖLČIUKAI;9983148737;Taip;1;0;0;1
15965;Vaduvos;KODĖLČIUKAI;6810198013;Taip;6;3;0;9
15966;Vaduvos;KODĖLČIUKAI;4270137614;Taip;0;4;0;4
15967;Vaduvos;KODĖLČIUKAI;3682708061;Taip;12;1;0;13
15968;Vaduvos;KODĖLČIUKAI;5262165284;Taip;14;0;0;14
15969;Vaduvos;KODĖLČIUKAI;8603418399;Taip;13;0;0;13
15970;Vaduvos;KODĖLČIUKAI;3096104197;Ne;16;0;0;16
15971;Vaduvos;KODĖLČIUKAI;5761137540;Taip;0;2;0;2
15972;Vaduvos;KODĖLČIUKAI;9597857664;Taip;3;3;0;6
15973;Vaduvos;KODĖLČIUKAI;1054097622;Taip;10;0;0;10
15974;Vaduvos;KODĖLČIUKAI;6013737546;Taip;0;4;9;13
15975;Vaduvos;KODĖLČIUKAI;4789480822;Taip;0;2;0;2
15976;Vaduvos;KODĖLČIUKAI;3164402142;Taip;0;10;0;10
15977;Vaduvos;KODĖLČIUKAI;7904713344;Taip;5;4;0;9
15978;Vaduvos;SMALSUČIAI;2184711783;Taip;0;1;0;1
15979;Vaduvos;SMALSUČIAI;3091707832;Ne;5;5;0;10
15980;Vaduvos;SMALSUČIAI;7181151562;Taip;0;4;0;4
15981;Vaduvos;SMALSUČIAI;6462126837;Taip;6;3;0;9
15982;Vaduvos;SMALSUČIAI;6213672547;Taip;2;0;1;3
15983;Vaduvos;SMALSUČIAI;1265287458;Taip;6;0;0;6
15984;Vaduvos;SMALSUČIAI;3948025914;Taip;8;0;1;9
15985;Vaduvos;SMALSUČIAI;6253552951;Taip;3;0;0;3
15986;Vaduvos;SMALSUČIAI;7508333714;Ne;5;5;0;10
15987;Vaduvos;SMALSUČIAI;7789888994;Ne;4;4;1;9
15988;Vaduvos;SMALSUČIAI;6593271671;Taip;2;4;0;6
15989;Vaduvos;SMALSUČIAI;6379952023;Ne;9;0;0;9
15990;Vaduvos;SMALSUČIAI;4550915388;Taip;0;3;0;3
15991;Vaduvos;SMALSUČIAI;8324927031;Taip;4;0;2;6
15992;Vaduvos;SMALSUČIAI;3680758366;Taip;4;0;0;4
15993;Vaduvos;SMALSUČIAI;9896249776;Taip;17;0;0;17
15994;Vaduvos;GILIUKAI;1277811729;Taip;9;0;1;10
15995;Vaduvos;GILIUKAI;1969325922;Taip;5;0;0;5
15996;Vaduvos;GILIUKAI;5376707663;Taip;4;0;0;4
15997;Vaduvos;GILIUKAI;6409466338;Taip;3;0;0;3
15998;Vaduvos;GILIUKAI;2835635250;Taip;4;0;0;4
15999;Vaduvos;GILIUKAI;2939561403;Taip;5;0;2;7
16000;Vaduvos;GILIUKAI;8188374113;Taip;9;0;1;10
16001;Vaduvos;GILIUKAI;6514406042;Taip;4;0;0;4
16002;Vaduvos;GILIUKAI;3057729267;Taip;7;1;0;8
16003;Vaduvos;GILIUKAI;6346625714;Taip;8;0;1;9
16004;Vaduvos;GILIUKAI;8580834401;Taip;2;0;0;2
16005;Vaduvos;GILIUKAI;9167796462;Taip;2;0;0;2
16006;Vaduvos;GILIUKAI;6276149710;Taip;4;0;0;4
16007;Vaduvos;GILIUKAI;6572776966;Taip;9;0;1;10
16008;Vaduvos;GILIUKAI;6676167440;Taip;9;0;0;9
16009;Vaduvos;GILIUKAI;2957685586;Taip;2;10;1;13
16010;Vaduvos;GILIUKAI;3540548094;Taip;10;0;0;10
16011;Vaduvos;GILIUKAI;8964194121;Taip;9;0;0;9
16012;Vaduvos;GILIUKAI;5297217576;Taip;0;8;0;8
16013;Vaduvos;GILIUKAI;5010914832;Taip;9;0;0;9
16014;Vaduvos;GILIUKAI;4030891958;Taip;5;0;0;5
16015;Vaduvos;GILIUKAI;7730737705;Taip;0;0;2;2
16016;Vaduvos;GILIUKAI;2011976336;Taip;8;0;0;8
16017;Vaduvos;GILIUKAI;5510687497;Ne;9;1;0;10
16018;Vaduvos;BORUŽĖLĖS;2277525837;Taip;5;3;0;8
16019;Vaduvos;BORUŽĖLĖS;6439773886;Taip;0;6;0;6
16020;Vaduvos;BORUŽĖLĖS;5634252033;Taip;0;2;0;2
16021;Vaduvos;BORUŽĖLĖS;6593754016;Taip;20;0;0;20
16022;Vaduvos;BORUŽĖLĖS;7521846747;Taip;0;4;0;4
16023;Vaduvos;BORUŽĖLĖS;1422507884;Taip;16;4;0;20
16024;Vaduvos;BORUŽĖLĖS;3461756429;Taip;6;4;0;10
16025;Vaduvos;BORUŽĖLĖS;2417613291;Taip;4;0;0;4
16026;Vaduvos;BORUŽĖLĖS;5717064754;Ne;5;2;0;7
16027;Vaduvos;BORUŽĖLĖS;8064111922;Taip;6;0;0;6
16028;Vaduvos;BORUŽĖLĖS;6552763746;Taip;0;5;0;5
16029;Vaduvos;BORUŽĖLĖS;3255011809;Taip;4;5;0;9
16030;Vaduvos;BORUŽĖLĖS;2366843609;Taip;6;0;2;8
16031;Vaduvos;BORUŽĖLĖS;1924714755;Taip;3;0;1;4
16032;Vaduvos;BORUŽĖLĖS;6991960029;Taip;0;2;0;2
16033;Vaduvos;BORUŽĖLĖS;3833382641;Taip;2;0;1;3
16034;Vaduvos;DRUGELIAI;4936598927;Taip;4;4;0;8
16035;Vaduvos;DRUGELIAI;2341467486;Taip;2;0;0;2
16036;Vaduvos;DRUGELIAI;9824469881;Taip;9;0;0;9
16037;Vaduvos;DRUGELIAI;5915272436;Taip;10;1;0;11
16038;Vaduvos;DRUGELIAI;4238942070;Taip;5;0;0;5
16039;Vaduvos;DRUGELIAI;1539465611;Taip;1;4;0;5
16040;Vaduvos;DRUGELIAI;8384302877;Taip;6;2;0;8
16041;Vaduvos;DRUGELIAI;6770559352;Taip;3;1;0;4
16042;Vaduvos;DRUGELIAI;4856601924;Taip;9;0;0;9
16043;Vaduvos;DRUGELIAI;3477273224;Taip;6;0;0;6
16044;Vaduvos;DRUGELIAI;2452309232;Taip;10;1;0;11
16045;Vaduvos;DRUGELIAI;6776150749;Taip;5;0;0;5
16046;Vaduvos;DRUGELIAI;4587836073;Taip;1;0;0;1
16047;Vaduvos;DRUGELIAI;9333495119;Taip;9;4;0;13
16048;Vaduvos;DRUGELIAI;7597268115;Taip;2;0;0;2
16049;Vaduvos;DRUGELIAI;8400344609;Taip;12;0;0;12
16050;Vaduvos;DRUGELIAI;2789503381;Taip;0;2;0;2
16051;Vaduvos;DRUGELIAI;1987969267;Taip;7;1;0;8
16052;Vaduvos;DRUGELIAI;8990472878;Taip;9;1;0;10
16053;Vaduvos;DRUGELIAI;2717887489;Taip;2;3;0;5
16054;Vaduvos;DRUGELIAI;5881009426;Taip;0;2;1;3
16055;Vaduvos;DRUGELIAI;1434871968;Taip;3;0;2;5
16056;Vaduvos;RIEŠUTĖLIAI;3855900628;Taip;14;0;0;14
16057;Vaduvos;RIEŠUTĖLIAI;8709781176;Taip;19;0;0;19
16058;Vaduvos;RIEŠUTĖLIAI;3690176756;Taip;0;5;0;5
16059;Vaduvos;RIEŠUTĖLIAI;5457850068;Taip;9;5;0;14
16060;Vaduvos;RIEŠUTĖLIAI;9420758132;Taip;0;3;0;3
16061;Vaduvos;RIEŠUTĖLIAI;5217573680;Taip;6;2;0;8
16062;Vaduvos;RIEŠUTĖLIAI;2838261867;Taip;7;0;0;7
16063;Vaduvos;RIEŠUTĖLIAI;3775261278;Taip;9;4;0;13
16064;Vaduvos;RIEŠUTĖLIAI;6824763956;Taip;0;6;0;6
16065;Vaduvos;RIEŠUTĖLIAI;6228969089;Taip;9;1;0;10
16066;Vaduvos;RIEŠUTĖLIAI;6163392340;Taip;9;0;0;9
16067;Vaduvos;RIEŠUTĖLIAI;9508198734;Taip;18;0;0;18
16068;Vaduvos;RIEŠUTĖLIAI;1247907161;Taip;4;0;1;5
16069;Vaduvos;RIEŠUTĖLIAI;5012931485;Taip;15;0;0;15
16070;Vaduvos;RIEŠUTĖLIAI;2767613126;Taip;13;0;0;13
16071;Vaduvos;"1 klasė";4805607216;Taip;0;5;0;5
16072;Vaduvos;"1 klasė";4805607216;Taip;0;5;0;5
16073;Vaduvos;"1 klasė";1696303051;Taip;0;4;0;4
16074;Vaduvos;"1 klasė";1431863758;Taip;0;4;0;4
16075;Vaduvos;"1 klasė";72724196791;Taip;0;4;0;4
16076;Vaduvos;"1 klasė";9371067563;Taip;0;5;0;5
16077;Vaduvos;"1 klasė";2897226343;Taip;0;4;0;4
16078;Vaduvos;"1 klasė";68848152670;Taip;0;4;0;4
16079;Vaduvos;"1 klasė";6425640531;Taip;0;5;0;5
16080;Vaduvos;"1 klasė";4029586203;Taip;0;4;0;4
16081;Vaduvos;"1 klasė";4105978403;Taip;0;4;0;4
16082;Vaduvos;"1 klasė";9540008495;Taip;0;4;0;4
16083;Vaduvos;"1 klasė";8299189235;Taip;0;4;0;4
16084;Vaduvos;"1 klasė";73800920781;Taip;0;4;0;4
16085;Vaduvos;"1 klasė";5428067167;Taip;0;4;0;4
16086;Vaduvos;"1 klasė";5954492368;Taip;0;5;0;5
16087;Vaduvos;"1 klasė";3699578284;Taip;0;4;0;4
16088;Vaduvos;"1 klasė";7397068779;Ne;0;4;0;4
16089;Vaduvos;"1 klasė";8875709110;Taip;0;4;0;4
16090;Vaduvos;"1 klasė";7305111076;Taip;0;4;0;4
16091;Vaduvos;"1 klasė";7163839896;Taip;0;4;0;4
16092;Vaduvos;"1 klasė";7493037613;Taip;0;4;0;4
16093;Vaduvos;"1 klasė";1423148023;Taip;0;4;0;4
16094;Vaduvos;"1 klasė";5573145836;Taip;0;5;0;5
16095;Vaduvos;"1 klasė";7337663549;Ne;0;9;0;9
16096;Vaduvos;"1 klasė";87008942241;Taip;0;4;0;4
16097;Vaduvos;"2 klasė";4365590843;Ne;0;4;0;4
16098;Vaduvos;"2 klasė";3174998523;Taip;0;4;0;4
16099;Vaduvos;"2 klasė";9112649520;Taip;0;4;0;4
16100;Vaduvos;"2 klasė";93702732546;Taip;0;4;0;4
16101;Vaduvos;"2 klasė";15757662594;Taip;0;4;0;4
16102;Vaduvos;"2 klasė";1599595256;Taip;0;4;0;4
16103;Vaduvos;"2 klasė";1825188497;Taip;0;4;0;4
16104;Vaduvos;"2 klasė";4513707989;Taip;0;11;0;11
16105;Vaduvos;"2 klasė";68937983441;Taip;0;4;0;4
16106;Vaduvos;"2 klasė";3722349868;Taip;0;4;0;4
16107;Vaduvos;"2 klasė";13888236429;Taip;0;6;0;6
16108;Vaduvos;"2 klasė";59616893535;Taip;0;4;0;4
16109;Vaduvos;"2 klasė";22641388717;Taip;0;4;0;4
16110;Vaduvos;"2 klasė";21499108813;Taip;0;5;0;5
16111;Vaduvos;"2 klasė";79437154441;Taip;0;4;0;4
16112;Vaduvos;"2 klasė";46608435244;Taip;0;5;0;5
16113;Vaduvos;"2 klasė";5307128703;Taip;0;4;0;4
16114;Vaduvos;"2 klasė";5435336235;Taip;0;4;0;4
16115;Vaduvos;"2 klasė";61046090149;Taip;0;4;0;4
16116;Vaduvos;"2 klasė";56280470781;Taip;0;6;0;6
16117;Vaduvos;"2 klasė";6128582180;Taip;0;7;0;7
16118;Vaduvos;"2 klasė";11202010413;Taip;0;20;0;20
16119;Vaduvos;"2 klasė";1681367373;Taip;0;7;0;7
16120;Vaduvos;"2 klasė";1370696345;Taip;0;5;0;5
16121;Vaduvos;"2 klasė";62183976729;Taip;0;4;0;4
16122;Vaduvos;"2 klasė";4342471835;Taip;0;4;0;4
16123;Vaduvos;"4 klasė";97423576166;Taip;0;4;0;4
16124;Vaduvos;"4 klasė";38504924027;Taip;0;4;0;4
16125;Vaduvos;"4 klasė";12330772986;Taip;0;4;0;4
16126;Vaduvos;"4 klasė";33277362439;Ne;0;14;0;14
16127;Vaduvos;"4 klasė";41272273463;Taip;0;4;0;4
16128;Vaduvos;"4 klasė";67324784528;Taip;0;7;0;7
16129;Vaduvos;"4 klasė";4807104855;Taip;0;4;0;4
16130;Vaduvos;"4 klasė";2181614424;Taip;0;4;0;4
16131;Vaduvos;"4 klasė";2019573643;Taip;0;4;0;4
16132;Vaduvos;"4 klasė";27419094487;Taip;0;4;0;4
16133;Vaduvos;"4 klasė";89793734700;Taip;0;4;0;4
16134;Vaduvos;"4 klasė";7786986697;Taip;0;4;0;4
16135;Vaduvos;"4 klasė";9147332638;Taip;0;5;0;5
16136;Vaduvos;"4 klasė";1532675814;Taip;0;6;0;6
16137;Vaduvos;"4 klasė";36931517006;Taip;0;4;0;4
16138;Vaduvos;"4 klasė";61243424057;Taip;0;4;0;4
16139;Vaduvos;"4 klasė";30979103892;Taip;0;4;0;4
16140;Vaduvos;"4 klasė";78245732319;Taip;0;4;0;4
16141;Vaduvos;"4 klasė";48433447683;Taip;0;4;0;4
16142;Vaduvos;3A;6279678482;Taip;0;20;0;20
16143;Vaduvos;3A;96892752634;Taip;0;4;0;4
16144;Vaduvos;3A;61243200177;Taip;0;4;0;4
16145;Vaduvos;3A;62703428759;Taip;0;4;0;4
16146;Vaduvos;3A;68420568339;Taip;0;4;0;4
16147;Vaduvos;3A;49738318631;Taip;0;6;0;6
16148;Vaduvos;3A;65647119496;Taip;0;4;0;4
16149;Vaduvos;3A;19390879176;Taip;0;4;0;4
16150;Vaduvos;3A;6155494370;Ne;0;6;0;6
16151;Vaduvos;3A;1139509471;Taip;0;23;0;23
16152;Vaduvos;3A;70693742936;Taip;0;10;0;10
16153;Vaduvos;3A;1010061503;Taip;0;10;0;10
16154;Vaduvos;3A;1107557891;Taip;0;23;0;23
16155;Vaduvos;3A;8802765960;Taip;0;4;0;4
16156;Vaduvos;3A;3172047211;Taip;0;4;0;4
16157;Vaduvos;3B;95104294893;Taip;0;9;0;9
16158;Vaduvos;3B;40872193458;Taip;0;23;0;23
16159;Vaduvos;3B;6500567162;Taip;0;7;0;7
16160;Vaduvos;3B;78931952732;Ne;0;4;0;4
16161;Vaduvos;3B;1241148402;Taip;0;4;0;4
16162;Vaduvos;3B;66359913774;Taip;0;4;0;4
16163;Vaduvos;3B;24887196729;Taip;0;7;0;7
16164;Vaduvos;3B;39687066893;Taip;0;18;0;18
16165;Vaduvos;3B;64074141491;Taip;0;16;0;16
16166;Vaduvos;3B;93924290247;Taip;0;4;0;4
16167;Vaduvos;3B;47465933557;Taip;0;4;0;4
16168;Vaduvos;3B;62521006557;Taip;0;7;0;7
16169;Vaduvos;3B;16882774330;Taip;0;7;0;7
16170;Vaduvos;3B;3259114583;Taip;0;6;0;6
16171;Vaduvos;3B;8782782031;Taip;0;4;0;4
16172;Vaduvos;3B;87671358423;Taip;0;4;0;4
16173;Vaduvos;3B;55138588393;Taip;0;6;0;6
16174;Vilkpėdės;PASAKORIŲ;3129307975;Taip;5;0;0;5
16175;Vilkpėdės;PASAKORIŲ;1268568294;Taip;1;5;0;6
16176;Vilkpėdės;PASAKORIŲ;7918728030;Taip;14;0;0;14
16177;Vilkpėdės;PASAKORIŲ;8819707366;Taip;6;0;0;6
16178;Vilkpėdės;PASAKORIŲ;8261543050;Taip;8;0;0;8
16179;Vilkpėdės;PASAKORIŲ;2102814426;Taip;8;0;0;8
16180;Vilkpėdės;PASAKORIŲ;6877083798;Taip;4;0;0;4
16181;Vilkpėdės;PASAKORIŲ;7780157972;Taip;4;0;0;4
16182;Vilkpėdės;PASAKORIŲ;9892981462;Taip;1;0;0;1
16183;Vilkpėdės;PASAKORIŲ;7937515587;Taip;7;0;0;7
16184;Vilkpėdės;PASAKORIŲ;4625117662;Taip;7;0;0;7
16185;Vilkpėdės;PASAKORIŲ;3548680401;Taip;5;0;0;5
16186;Vilkpėdės;PASAKORIŲ;4282952336;Taip;5;0;0;5
16187;Vilkpėdės;PASAKORIŲ;3646631186;Taip;9;0;0;9
16188;Vilkpėdės;PASAKORIŲ;9350127172;Taip;0;4;0;4
16189;Vilkpėdės;MĮSLIUKŲ;7370710652;Taip;16;0;0;16
16190;Vilkpėdės;MĮSLIUKŲ;4314657343;Taip;7;0;0;7
16191;Vilkpėdės;MĮSLIUKŲ;7184242648;Taip;9;1;0;10
16192;Vilkpėdės;MĮSLIUKŲ;4904820034;Taip;4;0;0;4
16193;Vilkpėdės;MĮSLIUKŲ;3863312205;Taip;12;0;0;12
16194;Vilkpėdės;MĮSLIUKŲ;8907004805;Taip;13;0;0;13
16195;Vilkpėdės;MĮSLIUKŲ;7334892130;Taip;10;0;0;10
16196;Vilkpėdės;MĮSLIUKŲ;7900956212;Taip;5;0;0;5
16197;Vilkpėdės;MĮSLIUKŲ;5110059560;Taip;6;0;0;6
16198;Vilkpėdės;ŽINIUKŲ;6819447340;Taip;0;0;1;1
16199;Vilkpėdės;ŽINIUKŲ;9797550851;Taip;0;0;10;10
16200;Vilkpėdės;ŽINIUKŲ;1040357501;Taip;4;1;0;5
16201;Vilkpėdės;ŽINIUKŲ;6876470245;Taip;4;1;0;5
16202;Vilkpėdės;ŽINIUKŲ;1655396296;Taip;2;0;1;3
16203;Vilkpėdės;ŽINIUKŲ;2379571797;Taip;7;0;0;7
16204;Vilkpėdės;ŽINIUKŲ;2358685682;Taip;0;0;3;3
16205;Vilkpėdės;IŠMINČIŲ;8002436634;Taip;9;0;2;11
16206;Vilkpėdės;IŠMINČIŲ;4052026470;Taip;0;7;1;8
16207;Vilkpėdės;IŠMINČIŲ;7992484314;Taip;0;9;0;9
16208;Vilkpėdės;IŠMINČIŲ;5050493757;Taip;11;5;0;16
16209;Vilkpėdės;IŠMINČIŲ;8217972925;Taip;0;2;0;2
16210;Vilkpėdės;IŠMINČIŲ;5677284428;Taip;0;1;0;1
16211;Vilkpėdės;IŠMINČIŲ;2232913117;Taip;0;0;7;7
16212;Vilkpėdės;IŠMINČIŲ;3994451071;Taip;6;0;1;7
16213;Vilkpėdės;IŠMINČIŲ;4726171678;Taip;5;0;1;6
16214;Vilkpėdės;IŠMINČIŲ;2529188623;Taip;0;1;2;3
16215;Vilkpėdės;IŠMINČIŲ;9334610111;Taip;6;5;0;11
16216;Vilkpėdės;IŠMINČIŲ;6268525635;Taip;9;0;1;10
16217;Vilkpėdės;IŠMINČIŲ;3521289746;Taip;0;1;0;1
16218;Vilkpėdės;IŠMINČIŲ;4277073629;Taip;6;0;6;12
16219;Vilkpėdės;IŠMINČIŲ;7489143683;Taip;0;0;3;3
16220;Vilkpėdės;TYRINĖTOJŲ;6418829930;Taip;12;3;0;15
16221;Vilkpėdės;TYRINĖTOJŲ;1633942236;Taip;8;0;0;8
16222;Vilkpėdės;TYRINĖTOJŲ;7829343719;Taip;10;0;0;10
16223;Vilkpėdės;TYRINĖTOJŲ;8484873068;Taip;0;4;0;4
16224;Vilkpėdės;TYRINĖTOJŲ;2503128176;Taip;5;0;0;5
16225;Vilkpėdės;TYRINĖTOJŲ;9570469277;Taip;4;0;0;4
16226;Vilkpėdės;TYRINĖTOJŲ;5274855225;Taip;23;0;0;23
16227;Vilkpėdės;TYRINĖTOJŲ;8860791478;Taip;6;5;0;11
16228;Vilkpėdės;TYRINĖTOJŲ;5420512675;Taip;9;0;0;9
16229;Vilkpėdės;TYRINĖTOJŲ;8613778606;Taip;6;4;0;10
16230;Vilkpėdės;TYRINĖTOJŲ;7991758361;Taip;0;5;0;5
16231;Vilkpėdės;TYRINĖTOJŲ;2736318576;Taip;3;0;0;3
16232;Vilkpėdės;TYRINĖTOJŲ;6064336759;Taip;14;0;0;14
16233;Vilkpėdės;TYRINĖTOJŲ;5577199802;Taip;5;0;0;5
16234;Vilkpėdės;TYRINĖTOJŲ;8930504912;Ne;2;0;0;2
16235;Vilkpėdės;TYRINĖTOJŲ;3303872633;Taip;9;1;0;10
16236;Vilkpėdės;TYRINĖTOJŲ;5972405023;Taip;10;0;0;10
16237;Vilkpėdės;TYRINĖTOJŲ;4485811377;Ne;0;5;0;5
16238;Vilkpėdės;TYRINĖTOJŲ;9841831811;Taip;11;3;0;14
16239;Vilkpėdės;GUDRUOLIŲ;2525399410;Taip;5;0;0;5
16240;Vilkpėdės;GUDRUOLIŲ;1985540746;Taip;5;0;0;5
16241;Vilkpėdės;GUDRUOLIŲ;6198736925;Taip;6;0;1;7
16242;Vilkpėdės;GUDRUOLIŲ;2703704892;Ne;3;0;0;3
16243;Vilkpėdės;GUDRUOLIŲ;5812430367;Taip;0;9;0;9
16244;Vilkpėdės;GUDRUOLIŲ;1478022307;Taip;9;0;0;9
16245;Vilkpėdės;GUDRUOLIŲ;2205143759;Taip;2;0;2;4
16246;Vilkpėdės;GUDRUOLIŲ;4018140154;Taip;5;0;0;5
16247;Vilkpėdės;GUDRUOLIŲ;6598572049;Taip;5;1;0;6
16248;Vilkpėdės;GUDRUOLIŲ;2419661008;Taip;5;0;0;5
16249;Vilkpėdės;GUDRUOLIŲ;7931496783;Taip;1;2;0;3
16250;Vilkpėdės;GUDRUOLIŲ;2418313731;Taip;11;0;0;11
16251;Vilkpėdės;GUDRUOLIŲ;8385974099;Taip;0;8;0;8
16252;Vilkpėdės;GUDRUOLIŲ;1342167313;Taip;9;0;1;10
16253;Vilkpėdės;GUDRUOLIŲ;5334238235;Taip;1;5;0;6
16254;Vilkpėdės;GUDRUOLIŲ;4031175523;Taip;1;0;0;1
16255;Vilkpėdės;GUDRUOLIŲ;6671311193;Taip;0;4;0;4
16256;Vilkpėdės;GUDRUOLIŲ;7114183123;Taip;21;0;0;21
16257;Vilkpėdės;SMALSUOLIŲ;4095366279;Taip;0;3;0;3
16258;Vilkpėdės;SMALSUOLIŲ;6522707709;Taip;11;0;0;11
16259;Vilkpėdės;SMALSUOLIŲ;7894766629;Taip;0;7;0;7
16260;Vilkpėdės;SMALSUOLIŲ;1655985778;Taip;22;0;0;22
16261;Vilkpėdės;SMALSUOLIŲ;4311938034;Taip;0;4;0;4
16262;Vilkpėdės;SMALSUOLIŲ;3664125930;Ne;9;0;0;9
16263;Vilkpėdės;SMALSUOLIŲ;8423972962;Taip;1;4;0;5
16264;Vilkpėdės;SMALSUOLIŲ;3350784810;Taip;13;3;0;16
16265;Vilkpėdės;SMALSUOLIŲ;5346798201;Taip;0;4;0;4
16266;Vilkpėdės;SMALSUOLIŲ;5551822633;Taip;7;5;0;12
16267;Vilkpėdės;SMALSUOLIŲ;9544418642;Taip;0;0;8;8
16268;Vilkpėdės;SMALSUOLIŲ;1063740772;Taip;0;6;0;6
16269;Vilkpėdės;SMALSUOLIŲ;3666145718;Ne;0;4;0;4
16270;Vilkpėdės;SMALSUOLIŲ;5633014328;Taip;0;6;0;6
16271;Vilkpėdės;SMALSUOLIŲ;3737265597;Taip;4;2;0;6
16272;Vilkpėdės;SMALSUOLIŲ;5422061533;Taip;0;3;0;3
16273;Vilkpėdės;SMALSUOLIŲ;7634076203;Taip;5;0;0;5
16274;Vilkpėdės;SMALSUOLIŲ;6690742997;Taip;2;0;0;2
16275;Vilkpėdės;KODĖLČIŲ;6283767445;Taip;0;5;0;5
16276;Vilkpėdės;KODĖLČIŲ;9605430333;Taip;0;7;0;7
16277;Vilkpėdės;KODĖLČIŲ;8969001990;Taip;1;1;0;2
16278;Vilkpėdės;KODĖLČIŲ;7158737372;Taip;8;8;0;16
16279;Vilkpėdės;KODĖLČIŲ;3785308006;Taip;10;0;0;10
16280;Vilkpėdės;KODĖLČIŲ;6744834487;Taip;0;6;0;6
16281;Vilkpėdės;KODĖLČIŲ;4166416292;Taip;14;5;0;19
16282;Vilkpėdės;KODĖLČIŲ;9601934563;Taip;4;4;0;8
16283;Vilkpėdės;KODĖLČIŲ;7401886306;Taip;5;2;0;7
16284;Vilkpėdės;KODĖLČIŲ;7284081203;Taip;5;0;0;5
16285;Vilkpėdės;KODĖLČIŲ;2359315281;Taip;4;0;0;4
16286;Vilkpėdės;KODĖLČIŲ;6820236577;Taip;2;0;0;2
16287;Vilkpėdės;KODĖLČIŲ;4255757333;Ne;6;0;0;6
16288;Vilkpėdės;KODĖLČIŲ;6778288398;Taip;10;0;0;10
16289;Vilkpėdės;KODĖLČIŲ;1537270256;Taip;7;5;0;12
16290;Vilkpėdės;KODĖLČIŲ;3229559339;Taip;7;5;0;12
16291;Vilkpėdės;MOKSLINČIŲ;9294350205;Taip;0;2;0;2
16292;Vilkpėdės;MOKSLINČIŲ;5048931309;Taip;0;3;0;3
16293;Vilkpėdės;MOKSLINČIŲ;7698759895;Taip;5;4;0;9
16294;Vilkpėdės;MOKSLINČIŲ;1217929358;Taip;5;5;0;10
16295;Vilkpėdės;MOKSLINČIŲ;1807884737;Taip;9;1;0;10
16296;Vilkpėdės;MOKSLINČIŲ;2251274741;Taip;4;6;0;10
16297;Vilkpėdės;MOKSLINČIŲ;6816745585;Taip;7;0;0;7
16298;Vilkpėdės;MOKSLINČIŲ;8128254701;Ne;0;8;0;8
16299;Vilkpėdės;MOKSLINČIŲ;8015392054;Taip;0;3;0;3
16300;Vilkpėdės;MOKSLINČIŲ;7747013579;Taip;0;6;0;6
16301;Vilkpėdės;MOKSLINČIŲ;3987021185;Taip;2;13;0;15
16302;Vilkpėdės;MOKSLINČIŲ;7908813288;Taip;0;3;0;3
16303;Vilkpėdės;MOKSLINČIŲ;9795696242;Taip;9;4;0;13
16304;Vilkpėdės;MOKSLINČIŲ;8581661608;Taip;0;2;0;2
16305;Vilkpėdės;MOKSLINČIŲ;6261547304;Taip;0;1;0;1
16306;Vilkpėdės;MOKSLINČIŲ;2420271759;Taip;0;7;0;7
16307;Vilkpėdės;MOKSLINČIŲ;3696611509;Taip;0;9;0;9
16308;Vilkpėdės;MOKSLINČIŲ;2604179994;Taip;0;9;0;9
16309;Vilkpėdės;MOKSLINČIŲ;3888880306;Taip;0;5;0;5
16310;Vilkpėdės;MOKSLINČIŲ;1063561954;Taip;0;1;0;1
16311;Vilkpėdės;MOKSLINČIŲ;8783790519;Taip;4;1;0;5
16312;Žiburėlis;Nykštukai;4109288891;Taip;13;0;0;13
16313;Žiburėlis;Nykštukai;7522040537;Ne;0;2;2;4
16314;Žiburėlis;Nykštukai;1015624216;Taip;1;3;0;4
16315;Žiburėlis;Nykštukai;9526477121;Taip;1;2;0;3
16316;Žiburėlis;Nykštukai;4387021429;Taip;4;2;0;6
16317;Žiburėlis;Nykštukai;4910787530;Taip;0;9;0;9
16318;Žiburėlis;Nykštukai;9783567484;Taip;0;4;0;4
16319;Žiburėlis;Nykštukai;5324852807;Ne;14;2;0;16
16320;Žiburėlis;Nykštukai;4916545915;Taip;0;14;0;14
16321;Žiburėlis;Nykštukai;8133371774;Taip;0;9;0;9
16322;Žiburėlis;Nykštukai;7278242428;Taip;4;0;0;4
16323;Žiburėlis;Nykštukai;1833704617;Ne;0;2;0;2
16324;Žiburėlis;Nykštukai;1228806324;Taip;0;1;0;1
16325;Žiburėlis;Nykštukai;2163018032;Taip;0;2;0;2
16326;Žiburėlis;Nykštukai;5002691930;Taip;0;1;0;1
16327;Žiburėlis;Nykštukai;8346571253;Taip;2;0;0;2
16328;Žiburėlis;Nykštukai;5098955523;Taip;0;10;0;10
16329;Žiburėlis;Nykštukai;5629404179;Taip;0;4;0;4
16330;Žiburėlis;Nykštukai;6647598068;Taip;0;2;0;2
16331;Žiburėlis;Nykštukai;1190058462;Taip;0;1;0;1
16332;Žiburėlis;Nykštukai;7111530833;Taip;0;3;0;3
16333;Žiburėlis;"Žiniukai ";3687703187;Ne;0;5;0;5
16334;Žiburėlis;"Žiniukai ";8215816053;Taip;1;3;0;4
16335;Žiburėlis;"Žiniukai ";7465939429;Taip;5;1;0;6
16336;Žiburėlis;"Žiniukai ";4710995351;Taip;2;1;0;3
16337;Žiburėlis;"Žiniukai ";7211961512;Taip;0;1;0;1
16338;Žiburėlis;"Žiniukai ";1559091567;Taip;8;0;0;8
16339;Žiburėlis;"Žiniukai ";3750024153;Taip;8;1;0;9
16340;Žiburėlis;"Žiniukai ";7633450988;Taip;2;4;0;6
16341;Žiburėlis;"Žiniukai ";8480167191;Taip;12;4;0;16
16342;Žiburėlis;"Žiniukai ";2292895729;Taip;2;17;0;19
16343;Žiburėlis;"Žiniukai ";7163594513;Taip;4;2;0;6
16344;Žiburėlis;"Žiniukai ";5408766721;Taip;0;4;0;4
16345;Žiburėlis;"Žiniukai ";6696156248;Taip;0;3;0;3
16346;Žiburėlis;"Žiniukai ";3938379566;Taip;0;4;0;4
16347;Žiburėlis;"Žiniukai ";5174211773;Taip;0;1;0;1
16348;Žiburėlis;"Žiniukai ";9818415192;Taip;1;4;0;5
16349;Žiburėlis;"Smalsiukai ";5438697081;Taip;11;0;0;11
16350;Žiburėlis;"Smalsiukai ";1126972447;Ne;9;0;0;9
16351;Žiburėlis;"Smalsiukai ";2072972990;Taip;8;4;0;12
16352;Žiburėlis;"Smalsiukai ";3835820013;Taip;10;1;0;11
16353;Žiburėlis;"Smalsiukai ";8875517201;Taip;11;0;0;11
16354;Žiburėlis;"Smalsiukai ";8065557477;Taip;5;0;0;5
16355;Žiburėlis;"Smalsiukai ";3770227955;Taip;9;1;0;10
16356;Žiburėlis;"Smalsiukai ";1843213137;Taip;3;2;0;5
16357;Žiburėlis;"Smalsiukai ";8953230752;Taip;7;1;0;8
16358;Žiburėlis;"Smalsiukai ";7402647048;Taip;10;0;0;10
16359;Žiburėlis;"Smalsiukai ";2491972986;Taip;0;10;0;10
16360;Žiburėlis;"Smalsiukai ";8973307069;Taip;0;9;0;9
16361;Žiburėlis;"Smalsiukai ";7825665451;Taip;9;4;0;13
16362;Žiburėlis;"Smalsiukai ";8970153523;Taip;4;0;0;4
16363;Žiburėlis;"Smalsiukai ";5145195661;Taip;7;0;0;7
16364;Žiburėlis;"Smalsiukai ";8018718405;Taip;2;2;0;4
16365;Žiburėlis;"Giliukai ";1090883494;Taip;5;0;0;5
16366;Žiburėlis;"Giliukai ";9215654134;Taip;4;0;0;4
16367;Žiburėlis;"Giliukai ";2866098551;Taip;10;0;0;10
16368;Žiburėlis;"Giliukai ";6918525245;Taip;1;2;0;3
16369;Žiburėlis;"Giliukai ";6946621147;Taip;0;3;0;3
16370;Žiburėlis;"Giliukai ";5148264064;Taip;0;10;0;10
16371;Žiburėlis;"Giliukai ";6733333096;Taip;4;0;0;4
16372;Žiburėlis;"Giliukai ";6232492947;Taip;10;0;0;10
16373;Žiburėlis;"Giliukai ";4016969144;Taip;4;5;0;9
16374;Žiburėlis;"Giliukai ";3776569251;Taip;4;1;0;5
16375;Žiburėlis;"Giliukai ";9494271740;Taip;1;1;0;2
16376;Žiburėlis;"Giliukai ";3992503848;Taip;0;5;0;5
16377;Žiburėlis;"Giliukai ";8440073413;Taip;7;1;0;8
16378;Žiburėlis;"Giliukai ";6121237159;Taip;7;1;0;8
16379;Žiburėlis;"Giliukai ";6289338466;Taip;12;0;0;12
16380;Žiburėlis;"Giliukai ";7977098545;Taip;14;1;0;15
16381;Žiburėlis;Meškiukai;3593851196;Taip;5;0;0;5
16382;Žiburėlis;Meškiukai;9470154520;Taip;3;2;0;5
16383;Žiburėlis;Meškiukai;2285666668;Ne;5;0;0;5
16384;Žiburėlis;Meškiukai;2836519241;Taip;4;0;0;4
16385;Žiburėlis;Meškiukai;2186032732;Taip;0;1;0;1
16386;Žiburėlis;Meškiukai;9321467329;Taip;6;0;0;6
16387;Žiburėlis;Meškiukai;2254407798;Taip;7;0;0;7
16388;Žiburėlis;Meškiukai;4887304311;Taip;5;0;0;5
16389;Žiburėlis;Meškiukai;1651713696;Taip;2;0;0;2
16390;Žiburėlis;Meškiukai;1105220246;Taip;8;0;0;8
16391;Žiburėlis;Meškiukai;8415647388;Taip;0;2;0;2
16392;Žiburėlis;Meškiukai;2371990135;Taip;0;0;4;4
16393;Žiburėlis;Meškiukai;8883542394;Ne;0;2;0;2
16394;Žiburėlis;Meškiukai;6218255066;Taip;16;0;0;16
16395;Žiburėlis;Meškiukai;3522480911;Taip;10;1;0;11
16396;Žiburėlis;Meškiukai;4667559315;Taip;5;1;0;6
16397;Žiburėlis;Meškiukai;1606332622;Taip;4;2;0;6
16398;Žiburėlis;Meškiukai;1758251348;Taip;0;9;0;9
16399;Žiburėlis;Meškiukai;8284913889;Taip;9;0;0;9
16400;Žiburėlis;Meškiukai;1121755119;Taip;10;0;0;10
16401;Žiburėlis;Meškiukai;2851350451;Taip;3;0;0;3
16402;Žiburėlis;Meškiukai;6206770019;Taip;0;13;0;13
16403;Žiburėlis;Viščiukai;2720743003;Taip;2;0;0;2
16404;Žiburėlis;Viščiukai;7426295852;Taip;0;5;0;5
16405;Žiburėlis;Viščiukai;4679250546;Taip;5;0;0;5
16406;Žiburėlis;Viščiukai;3069436943;Taip;19;0;0;19
16407;Žiburėlis;Viščiukai;1507346142;Taip;15;0;0;15
16408;Žiburėlis;Viščiukai;9369610274;Taip;10;0;0;10
16409;Žiburėlis;Viščiukai;9009869114;Taip;15;0;0;15
16410;Žiburėlis;Viščiukai;1839099729;Taip;14;0;0;14
16411;Žiburėlis;Viščiukai;5490536675;Taip;18;0;0;18
16412;Žiburėlis;Viščiukai;8694628008;Taip;2;0;0;2
16413;Žiburėlis;"Drambliukai ";5115160061;Taip;32;0;0;32
16414;Žiburėlis;"Drambliukai ";7364102991;Taip;7;1;0;8
16415;Žiburėlis;"Drambliukai ";8603154782;Taip;4;1;0;5
16416;Žiburėlis;"Drambliukai ";5213049603;Taip;7;5;0;12
16417;Žiburėlis;"Drambliukai ";6750601280;Taip;4;2;0;6
16418;Žiburėlis;"Drambliukai ";9048781241;Taip;0;8;0;8
16419;Žiburėlis;"Drambliukai ";6126086504;Taip;8;5;0;13
16420;Žiburėlis;"Drambliukai ";7687475882;Taip;7;1;0;8
16421;Žiburėlis;"Drambliukai ";8444514098;Taip;21;0;0;21
16422;Žiburėlis;"Drambliukai ";4459356832;Taip;3;7;0;10
16423;Žiburėlis;"Drambliukai ";3787858744;Taip;23;0;0;23
16424;Žiburėlis;"Drambliukai ";1449541244;Taip;0;10;0;10
16425;Žiburėlis;"Drambliukai ";2472729022;Taip;7;6;0;13
16426;Žiburėlis;BORUŽIUKAI;3723613593;Taip;0;4;0;4
16427;Žiburėlis;BORUŽIUKAI;9964255985;Taip;5;0;0;5
16428;Žiburėlis;BORUŽIUKAI;7895148630;Taip;14;1;0;15
16429;Žiburėlis;BORUŽIUKAI;8936912406;Taip;0;5;0;5
16430;Žiburėlis;BORUŽIUKAI;4631232618;Taip;16;0;0;16
16431;Žiburėlis;BORUŽIUKAI;5793531526;Taip;5;1;0;6
16432;Žiburėlis;BORUŽIUKAI;6128571259;Taip;7;0;0;7
16433;Žiburėlis;BORUŽIUKAI;3760039280;Taip;4;1;0;5
16434;Žiburėlis;BORUŽIUKAI;4229040996;Taip;4;0;0;4
16435;Žiburėlis;BORUŽIUKAI;8373944614;Taip;3;14;0;17
16436;Žiburėlis;BORUŽIUKAI;9256751455;Taip;6;0;0;6
16437;Žiburėlis;BORUŽIUKAI;9357376188;Ne;0;1;0;1
16438;Žiburėlis;BORUŽIUKAI;7017574924;Taip;0;3;0;3
16439;Žiburėlis;BORUŽIUKAI;1661456806;Taip;5;9;0;14
16440;Žiburėlis;BORUŽIUKAI;2527837980;Taip;23;0;0;23
16441;Žiburėlis;BORUŽIUKAI;9771442035;Taip;0;7;0;7
16442;Žiburėlis;SPINDULIUKAI;2995697464;Taip;3;0;0;3
16443;Žiburėlis;SPINDULIUKAI;7856708616;Taip;0;4;0;4
16444;Žiburėlis;SPINDULIUKAI;5205959106;Taip;0;1;0;1
16445;Žiburėlis;SPINDULIUKAI;5951659866;Taip;0;9;0;9
16446;Žiburėlis;SPINDULIUKAI;1775465307;Taip;0;2;0;2
16447;Žiburėlis;SPINDULIUKAI;2808361570;Taip;3;1;0;4
16448;Žiburėlis;SPINDULIUKAI;5881242405;Ne;0;4;0;4
16449;Žiburėlis;SPINDULIUKAI;2131951626;Ne;0;4;0;4
16450;Žiburėlis;SPINDULIUKAI;3253759256;Taip;4;4;0;8
16451;Žiburėlis;SPINDULIUKAI;6220596994;Taip;9;0;0;9
16452;Žiburėlis;SPINDULIUKAI;6969335298;Taip;10;0;0;10
16453;Žiburėlis;SPINDULIUKAI;5835919483;Taip;4;4;0;8
16454;Žiburėlis;SPINDULIUKAI;4738991020;Taip;5;1;0;6
16455;Žiburėlis;SPINDULIUKAI;6080914975;Taip;12;0;0;12
16456;Žiburėlis;SPINDULIUKAI;9325991773;Taip;6;0;0;6
16457;Žiburėlis;SPINDULIUKAI;6674351628;Taip;10;0;0;10
16458;Žiburėlis;SPINDULIUKAI;5075522632;Taip;0;3;0;3
16459;Žiburėlis;SPINDULIUKAI;1908345602;Taip;7;0;0;7
16460;Žiburėlis;SPINDULIUKAI;8140848665;Ne;18;0;0;18
16461;Žiburėlis;SPINDULIUKAI;4727673956;Taip;0;2;0;2
16462;Žiburėlis;SPINDULIUKAI;7140031765;Taip;3;0;0;3
16463;Žiburėlis;KIŠKUČIAI;6492467281;Taip;0;0;1;1
16464;Žiburėlis;KIŠKUČIAI;3352845095;Taip;3;0;3;6
16465;Žiburėlis;KIŠKUČIAI;1004953300;Taip;0;1;0;1
16466;Žiburėlis;KIŠKUČIAI;3296994981;Taip;3;4;0;7
16467;Žiburėlis;KIŠKUČIAI;6019278045;Taip;7;0;0;7
16468;Žiburėlis;KIŠKUČIAI;6044837042;Taip;7;0;0;7
16469;Žiburėlis;KIŠKUČIAI;1334695206;Taip;11;0;0;11
16470;Žiburėlis;KIŠKUČIAI;6562748977;Ne;13;0;0;13
16471;Žiburėlis;KIŠKUČIAI;4477396434;Ne;5;2;0;7
16472;Žiburėlis;KIŠKUČIAI;2712358146;Taip;11;0;1;12
16473;Žiburėlis;KIŠKUČIAI;5410394172;Taip;0;2;0;2
16474;Žiburėlis;KIŠKUČIAI;4003368130;Taip;19;0;0;19
16475;Žiburėlis;KIŠKUČIAI;2456703958;Taip;0;0;1;1
16476;Žiburėlis;KIŠKUČIAI;1868558773;Taip;0;6;0;6
16477;Žiburėlis;KIŠKUČIAI;2083500905;Taip;0;2;0;2
16478;Žiburėlis;KIŠKUČIAI;6577061306;Taip;0;2;0;2
16479;Žiburėlis;KIŠKUČIAI;9731661697;Taip;2;0;1;3
16480;Žiburėlis;DRUGELIAI;9551175579;Taip;7;0;0;7
16481;Žiburėlis;DRUGELIAI;2872122574;Taip;14;1;0;15
16482;Žiburėlis;DRUGELIAI;5422660783;Taip;7;4;0;11
16483;Žiburėlis;DRUGELIAI;5758539955;Taip;11;0;0;11
16484;Žiburėlis;DRUGELIAI;3780842203;Taip;11;0;0;11
16485;Žiburėlis;DRUGELIAI;6751043071;Ne;16;0;0;16
16486;Žiburėlis;DRUGELIAI;8082088504;Taip;1;3;0;4
16487;Žiburėlis;DRUGELIAI;5025452484;Taip;4;0;0;4
16488;Žiburėlis;DRUGELIAI;5724506894;Taip;4;2;0;6
16489;Žiburėlis;DRUGELIAI;8207315673;Taip;6;0;0;6
16490;Žiburėlis;DRUGELIAI;4656467260;Taip;6;0;0;6
16491;Žiburėlis;DRUGELIAI;9344950711;Taip;10;1;0;11
16492;Žiburėlis;DRUGELIAI;5194593598;Taip;17;0;0;17
16493;Žiburėlis;DRUGELIAI;2383554216;Taip;6;2;0;8
16494;Žiburėlis;DRUGELIAI;8285987095;Taip;0;4;0;4
16495;Žiburėlis;DRUGELIAI;8752098051;Taip;8;1;0;9
16496;Žiburėlis;DRUGELIAI;4937518207;Taip;5;0;0;5
16497;Bangelė;Aštuonkojai;6216334243;Taip;0;3;0;3
16498;Bangelė;Aštuonkojai;8406002339;Taip;0;2;6;8
16499;Bangelė;Aštuonkojai;8385661612;Ne;0;4;1;5
16500;Bangelė;Aštuonkojai;7434358474;Taip;0;18;0;18
16501;Bangelė;Aštuonkojai;6978215876;Ne;0;0;11;11
16502;Bangelė;Aštuonkojai;9608900293;Taip;0;0;1;1
16503;Bangelė;Aštuonkojai;7434879947;Taip;2;0;0;2
16504;Bangelė;Aštuonkojai;7107685761;Taip;0;1;0;1
16505;Bangelė;Aštuonkojai;5994720767;Taip;0;6;0;6
16506;Bangelė;Aštuonkojai;4532810332;Taip;0;14;0;14
16507;Bangelė;Aštuonkojai;8575020060;Taip;0;4;1;5
16508;Bangelė;Aštuonkojai;3344441441;Taip;4;0;2;6
16509;Bangelė;Aštuonkojai;2858929915;Taip;9;4;0;13
16510;Bangelė;Aštuonkojai;7068305612;Taip;7;0;4;11
16511;Bangelė;Aštuonkojai;8661284187;Taip;0;0;2;2
16512;Bangelė;Aštuonkojai;8943721679;Taip;4;0;0;4
16513;Bangelė;Delfinukai,;9142460659;Taip;17;0;0;17
16514;Bangelė;Delfinukai,;6566277472;Taip;18;0;0;18
16515;Bangelė;Delfinukai,;1541525635;Taip;5;0;3;8
16516;Bangelė;Delfinukai,;7362196984;Ne;13;0;0;13
16517;Bangelė;Delfinukai,;4317054990;Taip;4;0;3;7
16518;Bangelė;Delfinukai,;4651237403;Taip;13;0;0;13
16519;Bangelė;Delfinukai,;4712616315;Taip;6;0;1;7
16520;Bangelė;Delfinukai,;4940247006;Taip;12;1;0;13
16521;Bangelė;Delfinukai,;8335931279;Taip;0;6;0;6
16522;Bangelė;Delfinukai,;5980274157;Taip;10;1;0;11
16523;Bangelė;Delfinukai,;9955097720;Taip;12;0;0;12
16524;Bangelė;Delfinukai,;2127734178;Taip;4;0;3;7
16525;Bangelė;Delfinukai,;2107766301;Taip;0;0;2;2
16526;Bangelė;Delfinukai,;5237434283;Taip;10;0;0;10
16527;Bangelė;"Saulės spindulėliai";9488932192;Taip;4;4;0;8
16528;Bangelė;"Saulės spindulėliai";8238868856;Taip;7;4;0;11
16529;Bangelė;"Saulės spindulėliai";4843411757;Taip;0;1;0;1
16530;Bangelė;"Saulės spindulėliai";1754002501;Taip;0;0;2;2
16531;Bangelė;"Saulės spindulėliai";6953698592;Ne;0;4;0;4
16532;Bangelė;"Saulės spindulėliai";3063439996;Taip;0;6;0;6
16533;Bangelė;"Saulės spindulėliai";6026399355;Taip;0;5;0;5
16534;Bangelė;"Saulės spindulėliai";2156837975;Taip;5;3;0;8
16535;Bangelė;"Saulės spindulėliai";9143945953;Taip;0;6;0;6
16536;Bangelė;"Saulės spindulėliai";3022508446;Taip;5;4;2;11
16537;Bangelė;"Saulės spindulėliai";5476753511;Taip;0;4;0;4
16538;Bangelė;"Saulės spindulėliai";5546256869;Taip;0;1;0;1
16539;Bangelė;"Saulės spindulėliai";1390623903;Taip;0;7;0;7
16540;Bangelė;"Saulės spindulėliai";9788923823;Taip;9;4;10;23
16541;Bangelė;"Saulės spindulėliai";7136625230;Taip;5;2;0;7
16542;Bangelė;"Saulės spindulėliai";9168310196;Taip;0;1;0;1
16543;Bangelė;"Saulės spindulėliai";9790680407;Taip;9;4;1;14
16544;Bangelė;"Pingvinukai ";2405364948;Taip;11;2;1;14
16545;Bangelė;"Pingvinukai ";8959248662;Taip;4;0;2;6
16546;Bangelė;"Pingvinukai ";5054826517;Ne;0;0;4;4
16547;Bangelė;"Pingvinukai ";8943497040;Taip;9;4;0;13
16548;Bangelė;"Pingvinukai ";8297403610;Taip;20;0;0;20
16549;Bangelė;"Pingvinukai ";2023033514;Taip;23;0;0;23
16550;Bangelė;"Pingvinukai ";3351519357;Taip;20;0;0;20
16551;Bangelė;"Pingvinukai ";8372151959;Taip;3;0;1;4
16552;Bangelė;"Pingvinukai ";2279517392;Taip;7;0;0;7
16553;Bangelė;"Pingvinukai ";6433126719;Taip;0;4;0;4
16554;Bangelė;"Pingvinukai ";9740713810;Taip;15;8;0;23
16555;Bangelė;"Pingvinukai ";5829865386;Taip;2;0;3;5
16556;Bangelė;"Pingvinukai ";1591647267;Ne;0;0;5;5
16557;Bangelė;"Pingvinukai ";8981519368;Taip;0;0;2;2
16558;Bangelė;"Pingvinukai ";2362345363;Taip;5;0;2;7
16559;Bangelė;"Jūros žvaigždutės ";9447145378;Ne;8;0;0;8
16560;Bangelė;"Jūros žvaigždutės ";8745595583;Taip;5;4;0;9
16561;Bangelė;"Jūros žvaigždutės ";6174617493;Taip;0;4;0;4
16562;Bangelė;"Jūros žvaigždutės ";8075810032;Taip;6;0;0;6
16563;Bangelė;"Jūros žvaigždutės ";2624013880;Taip;12;0;0;12
16564;Bangelė;"Jūros žvaigždutės ";6397805392;Taip;14;0;0;14
16565;Bangelė;"Jūros žvaigždutės ";1724955001;Taip;2;0;0;2
16566;Bangelė;"Jūros žvaigždutės ";5961647252;Taip;0;5;0;5
16567;Bangelė;"Jūros žvaigždutės ";3851738513;Taip;0;4;0;4
16568;Bangelė;"Jūros žvaigždutės ";4891131242;Taip;7;0;0;7
16569;Bangelė;"Jūros žvaigždutės ";8931569423;Ne;6;0;0;6
16570;Bangelė;"Jūros žvaigždutės ";7364368699;Taip;11;4;0;15
16571;Bangelė;"Jūros žvaigždutės ";7755966282;Taip;12;0;0;12
16572;Bangelė;"Jūros žvaigždutės ";4480762963;Taip;0;4;2;6
16573;Bangelė;"Jūros žvaigždutės ";5370269001;Taip;9;7;0;16
16574;Bangelė;Žuvytės;7174742281;Taip;14;4;0;18
16575;Bangelė;Žuvytės;6806911810;Taip;4;1;0;5
16576;Bangelė;Žuvytės;6548270099;Taip;10;4;0;14
16577;Bangelė;Žuvytės;4086446380;Taip;0;7;0;7
16578;Bangelė;Žuvytės;9268294844;Taip;0;1;0;1
16579;Bangelė;Žuvytės;4831656996;Taip;15;0;2;17
16580;Bangelė;Žuvytės;3069288815;Taip;14;0;0;14
16581;Bangelė;Žuvytės;9633372201;Ne;0;4;0;4
16582;Bangelė;Žuvytės;9729929020;Taip;0;0;1;1
16583;Bangelė;Žuvytės;8563674709;Taip;12;4;0;16
16584;Bangelė;Žuvytės;5673493708;Taip;8;4;0;12
16585;Bangelė;Žuvytės;3500097405;Taip;22;0;0;22
16586;Bangelė;Žuvytės;1544311819;Ne;5;0;0;5
16587;Bangelė;Žuvytės;4080993439;Taip;0;2;0;2
16588;Bangelė;Žuvytės;3744789873;Ne;0;0;1;1
16589;Bangelė;Žuvytės;3016778137;Taip;0;0;4;4
16590;Bangelė;Žuvytės;1898671487;Taip;5;2;0;7
16591;Bangelė;Ruoniai;8758933649;Taip;5;4;1;10
16592;Bangelė;Ruoniai;8702632542;Ne;0;4;0;4
16593;Bangelė;Ruoniai;6480681705;Taip;0;8;1;9
16594;Bangelė;Ruoniai;7142694888;Ne;0;4;0;4
16595;Bangelė;Ruoniai;8734511431;Taip;0;6;0;6
16596;Bangelė;Ruoniai;1895213200;Taip;4;0;2;6
16597;Bangelė;Ruoniai;9765268154;Taip;8;10;0;18
16598;Bangelė;Ruoniai;8495423628;Taip;7;0;0;7
16599;Bangelė;Ruoniai;7419016784;Ne;8;1;0;9
16600;Bangelė;Ruoniai;5190563034;Taip;0;0;1;1
16601;Bangelė;Ruoniai;9980881014;Taip;6;0;0;6
16602;Bangelė;Ruoniai;9954762483;Taip;9;5;0;14
16603;Bangelė;Ruoniai;9493465898;Ne;0;4;0;4
16604;Bangelė;Ruoniai;5597329949;Taip;9;6;0;15
16605;Bangelė;Ruoniai;2134225414;Taip;5;0;2;7
16606;Bangelė;Ruoniai;4494049529;Taip;0;2;3;5
16607;Bangelė;Ruoniai;3334029244;Taip;0;0;6;6
16608;Bangelė;Ruoniai;6496580354;Taip;18;0;2;20
16609;Bangelė;Ruoniai;6165322599;Taip;0;3;0;3
16610;Bangelė;"Pagrandukai ";9355348960;Taip;14;0;0;14
16611;Bangelė;"Pagrandukai ";1467390411;Taip;10;0;0;10
16612;Bangelė;"Pagrandukai ";7503518328;Taip;0;4;0;4
16613;Bangelė;"Pagrandukai ";4927362383;Taip;0;2;0;2
16614;Bangelė;"Pagrandukai ";7432980844;Taip;0;4;0;4
16615;Bangelė;"Pagrandukai ";8880874539;Taip;10;0;0;10
16616;Bangelė;"Pagrandukai ";7729373603;Taip;5;1;0;6
16617;Bangelė;"Pagrandukai ";5237637695;Ne;0;4;1;5
16618;Bangelė;"Pagrandukai ";7138947462;Ne;0;4;1;5
16619;Bangelė;"Pagrandukai ";2535189316;Taip;4;3;0;7
16620;Bangelė;"Pagrandukai ";9430653481;Taip;12;0;0;12
16621;Bangelė;"Pagrandukai ";4558724094;Taip;19;0;0;19
16622;Bangelė;"Pagrandukai ";3557202302;Taip;3;1;0;4
16623;Bangelė;"Zuikučiai ";3269021780;Ne;0;0;7;7
16624;Bangelė;"Zuikučiai ";4611715232;Ne;17;0;0;17
16625;Bangelė;"Zuikučiai ";6925192867;Ne;7;4;1;12
16626;Bangelė;"Zuikučiai ";6965660021;Taip;10;3;0;13
16627;Bangelė;"Zuikučiai ";3994276744;Ne;9;4;0;13
16628;Bangelė;"Zuikučiai ";3059847953;Taip;15;3;0;18
16629;Bangelė;"Zuikučiai ";5909385625;Taip;6;0;1;7
16630;Bangelė;"Zuikučiai ";4401415720;Taip;11;0;0;11
16631;Bangelė;"Zuikučiai ";1610384455;Taip;7;0;0;7
16632;Bangelė;"Zuikučiai ";9841829359;Taip;11;0;0;11
16633;Bangelė;"Zuikučiai ";8836768508;Taip;7;0;2;9
16634;Bangelė;"Zuikučiai ";6100558953;Taip;0;4;0;4
16635;Bangelė;"Zuikučiai ";5192643204;Taip;12;0;1;13
16636;Bangelė;Vėžliukai;7862345122;Taip;0;0;1;1
16637;Bangelė;Vėžliukai;2630571748;Taip;8;5;0;13
16638;Bangelė;Vėžliukai;6003859569;Taip;15;0;0;15
16639;Bangelė;Vėžliukai;3978683237;Taip;0;0;1;1
16640;Bangelė;Vėžliukai;5779198855;Taip;0;8;0;8
16641;Bangelė;Vėžliukai;5746189515;Taip;9;1;0;10
16642;Bangelė;Vėžliukai;9561221619;Taip;0;3;0;3
16643;Bangelė;Vėžliukai;1182624046;Taip;7;1;0;8
16644;Bangelė;Vėžliukai;5625257865;Taip;0;0;5;5
16645;Bangelė;Vėžliukai;9010238689;Taip;0;3;0;3
16646;Bangelė;Vėžliukai;9128326823;Taip;11;1;0;12
16647;Bangelė;Vėžliukai;6415607960;Taip;21;0;0;21
16648;Bangelė;Vėžliukai;2730545639;Taip;10;0;0;10
16649;Bangelė;Vėžliukai;2301343701;Taip;0;2;0;2
16650;Bangelė;Vėžliukai;6506241123;Taip;4;0;0;4
16651;Bangelė;Vėžliukai;8950435528;Ne;5;0;0;5
16652;Gėlynas;PAKALNUTĖ;4557380282;Taip;8;0;0;8
16653;Gėlynas;PAKALNUTĖ;6884111634;Taip;1;0;0;1
16654;Gėlynas;PAKALNUTĖ;3470963396;Taip;2;6;0;8
16655;Gėlynas;PAKALNUTĖ;6053841081;Taip;1;0;0;1
16656;Gėlynas;PAKALNUTĖ;2171064300;Taip;5;2;0;7
16657;Gėlynas;PAKALNUTĖ;2404562144;Taip;5;2;0;7
16658;Gėlynas;PAKALNUTĖ;7504469409;Taip;4;1;0;5
16659;Gėlynas;PAKALNUTĖ;4366442459;Taip;7;0;0;7
16660;Gėlynas;PAKALNUTĖ;1463783538;Taip;6;4;0;10
16661;Gėlynas;PAKALNUTĖ;7064068912;Taip;9;0;0;9
16662;Gėlynas;PAKALNUTĖ;1822933936;Taip;11;1;0;12
16663;Gėlynas;PAKALNUTĖ;4668195919;Taip;0;8;0;8
16664;Gėlynas;PAKALNUTĖ;8555408466;Taip;1;4;0;5
16665;Gėlynas;PAKALNUTĖ;6296728638;Taip;0;2;0;2
16666;Gėlynas;PAKALNUTĖ;5826067446;Taip;3;1;0;4
16667;Gėlynas;PAKALNUTĖ;2273705177;Taip;8;0;0;8
16668;Gėlynas;PAKALNUTĖ;6244314445;Taip;3;0;0;3
16669;Gėlynas;PAKALNUTĖ;9707677931;Taip;6;2;0;8
16670;Gėlynas;VARPELIS;5898582218;Taip;2;0;0;2
16671;Gėlynas;VARPELIS;1505666690;Taip;1;0;0;1
16672;Gėlynas;VARPELIS;9330385153;Taip;3;3;0;6
16673;Gėlynas;VARPELIS;9724668402;Taip;0;3;0;3
16674;Gėlynas;VARPELIS;2742456983;Taip;0;9;0;9
16675;Gėlynas;VARPELIS;2784709117;Taip;1;4;0;5
16676;Gėlynas;VARPELIS;6114995335;Taip;1;3;0;4
16677;Gėlynas;VARPELIS;6815740588;Taip;6;4;0;10
16678;Gėlynas;VARPELIS;3606076029;Taip;0;4;0;4
16679;Gėlynas;VARPELIS;5291444399;Taip;1;3;0;4
16680;Gėlynas;VARPELIS;5320531856;Ne;4;3;0;7
16681;Gėlynas;VARPELIS;7730322729;Taip;0;6;0;6
16682;Gėlynas;VARPELIS;4505012978;Taip;0;4;0;4
16683;Gėlynas;VARPELIS;2348787949;Taip;0;1;0;1
16684;Gėlynas;VARPELIS;5124029118;Taip;5;0;0;5
16685;Gėlynas;VARPELIS;6528464599;Taip;9;3;0;12
16686;Gėlynas;VARPELIS;8615943743;Taip;0;8;0;8
16687;Gėlynas;VARPELIS;3572020585;Taip;0;3;0;3
16688;Gėlynas;VARPELIS;8999346908;Taip;0;6;0;6
16689;Gėlynas;VARPELIS;3491517766;Taip;0;2;0;2
16690;Gėlynas;RAKTAŽOLĖ;7389502638;Taip;0;5;0;5
16691;Gėlynas;RAKTAŽOLĖ;1590299264;Taip;8;0;0;8
16692;Gėlynas;RAKTAŽOLĖ;5751256561;Taip;11;0;0;11
16693;Gėlynas;RAKTAŽOLĖ;8080660097;Taip;2;0;0;2
16694;Gėlynas;RAKTAŽOLĖ;1015554617;Taip;0;4;0;4
16695;Gėlynas;RAKTAŽOLĖ;6875794958;Taip;1;0;0;1
16696;Gėlynas;RAKTAŽOLĖ;3492361041;Taip;10;0;0;10
16697;Gėlynas;RAKTAŽOLĖ;6451922757;Taip;4;4;0;8
16698;Gėlynas;RAKTAŽOLĖ;2141722631;Taip;10;0;0;10
16699;Gėlynas;RAKTAŽOLĖ;7150367866;Taip;9;0;0;9
16700;Gėlynas;RAKTAŽOLĖ;4983822000;Taip;8;0;0;8
16701;Gėlynas;RAKTAŽOLĖ;3549079170;Taip;4;5;0;9
16702;Gėlynas;RAKTAŽOLĖ;5964419627;Taip;10;0;0;10
16703;Gėlynas;RAKTAŽOLĖ;4824667762;Taip;7;0;0;7
16704;Gėlynas;RAKTAŽOLĖ;7998013477;Taip;6;0;0;6
16705;Gėlynas;RAKTAŽOLĖ;8447789767;Taip;0;4;0;4
16706;Gėlynas;RAKTAŽOLĖ;8743722205;Taip;8;0;0;8
16707;Gėlynas;RAKTAŽOLĖ;1468588114;Taip;7;0;0;7
16708;Gėlynas;RAKTAŽOLĖ;9305282699;Taip;0;4;0;4
16709;Gėlynas;RAKTAŽOLĖ;1235384604;Taip;5;0;0;5
16710;Gėlynas;RAKTAŽOLĖ;8693415786;Taip;3;0;0;3
16711;Gėlynas;RAKTAŽOLĖ;2800420481;Taip;5;2;0;7
16712;Gėlynas;RAKTAŽOLĖ;8444505017;Taip;9;0;0;9
16713;Gėlynas;SAULĖGRĄŽA;3746597878;Taip;8;3;0;11
16714;Gėlynas;SAULĖGRĄŽA;9182072776;Taip;0;2;0;2
16715;Gėlynas;SAULĖGRĄŽA;1862266440;Taip;6;0;0;6
16716;Gėlynas;SAULĖGRĄŽA;4292724541;Taip;0;2;0;2
16717;Gėlynas;SAULĖGRĄŽA;2790269385;Taip;14;0;0;14
16718;Gėlynas;SAULĖGRĄŽA;7988094745;Taip;0;2;5;7
16719;Gėlynas;SAULĖGRĄŽA;4192292896;Taip;0;1;6;7
16720;Gėlynas;SAULĖGRĄŽA;9552677108;Taip;9;1;0;10
16721;Gėlynas;SAULĖGRĄŽA;2608369575;Taip;9;1;0;10
16722;Gėlynas;SAULĖGRĄŽA;1949260962;Taip;0;4;2;6
16723;Gėlynas;SAULĖGRĄŽA;6635004996;Taip;9;3;0;12
16724;Gėlynas;SAULĖGRĄŽA;5942466822;Taip;5;0;1;6
16725;Gėlynas;SAULĖGRĄŽA;2193861056;Taip;7;0;5;12
16726;Gėlynas;SAULĖGRĄŽA;6826311903;Taip;0;3;3;6
16727;Gėlynas;SAULĖGRĄŽA;9230984365;Taip;6;0;0;6
16728;Gėlynas;SAULĖGRĄŽA;6221721945;Taip;4;0;6;10
16729;Gėlynas;SAULĖGRĄŽA;1681208354;Taip;4;1;0;5
16730;Gėlynas;SAULĖGRĄŽA;7005278902;Taip;0;0;2;2
16731;Gėlynas;SAULĖGRĄŽA;6790040590;Taip;7;0;0;7
16732;Gėlynas;SAULĖGRĄŽA;4854709904;Taip;0;2;6;8
16733;Gėlynas;SAULĖGRĄŽA;1665668966;Taip;0;2;3;5
16734;Gėlynas;SAULĖGRĄŽA;1570975863;Taip;4;4;2;10
16735;Gėlynas;SAULĖGRĄŽA;9302757372;Taip;0;20;0;20
16736;Gėlynas;SAULĖGRĄŽA;6342888072;Taip;0;3;0;3
16737;Gėlynas;RAMUNĖLĖ;5813156578;Taip;0;6;0;6
16738;Gėlynas;RAMUNĖLĖ;8550986498;Taip;13;0;0;13
16739;Gėlynas;RAMUNĖLĖ;1003739544;Taip;21;0;0;21
16740;Gėlynas;RAMUNĖLĖ;8483711968;Taip;7;0;0;7
16741;Gėlynas;RAMUNĖLĖ;5576414317;Taip;6;0;0;6
16742;Gėlynas;RAMUNĖLĖ;1625163282;Taip;3;0;0;3
16743;Gėlynas;RAMUNĖLĖ;1962457749;Taip;10;0;0;10
16744;Gėlynas;RAMUNĖLĖ;9063119595;Taip;7;0;0;7
16745;Gėlynas;RAMUNĖLĖ;1923691283;Taip;8;0;0;8
16746;Gėlynas;RAMUNĖLĖ;1360487284;Taip;3;0;0;3
16747;Gėlynas;RAMUNĖLĖ;2043763411;Taip;0;17;0;17
16748;Gėlynas;RAMUNĖLĖ;6447818933;Taip;2;0;0;2
16749;Gėlynas;ŽIBUTĖ;8681345327;Taip;7;0;0;7
16750;Gėlynas;ŽIBUTĖ;1556683639;Taip;4;0;0;4
16751;Gėlynas;ŽIBUTĖ;2885148633;Taip;3;0;0;3
16752;Gėlynas;ŽIBUTĖ;9786032406;Taip;4;3;0;7
16753;Gėlynas;ŽIBUTĖ;6053762333;Taip;4;1;0;5
16754;Gėlynas;ŽIBUTĖ;7633304238;Taip;3;4;0;7
16755;Gėlynas;ŽIBUTĖ;2194665295;Taip;7;0;0;7
16756;Gėlynas;ŽIBUTĖ;1579053252;Taip;13;0;0;13
16757;Gėlynas;ŽIBUTĖ;9980617252;Taip;6;0;0;6
16758;Gėlynas;ŽIBUTĖ;9859626078;Taip;12;0;0;12
16759;Gėlynas;ŽIBUTĖ;1073904355;Taip;0;4;0;4
16760;Gėlynas;ŽIBUTĖ;9256960820;Taip;5;0;0;5
16761;Gėlynas;ŽIBUTĖ;9513419357;Taip;0;8;0;8
16762;Gėlynas;ŽIBUTĖ;3629326461;Taip;11;0;0;11
16763;Gėlynas;ŽIBUTĖ;8122748285;Taip;5;0;0;5
16764;Obelėlė;Gudručiai;9900484892;Taip;0;12;1;13
16765;Obelėlė;Gudručiai;9586720282;Taip;0;4;3;7
16766;Obelėlė;Gudručiai;9567704282;Taip;0;0;2;2
16767;Obelėlė;Gudručiai;4015702815;Taip;0;4;0;4
16768;Obelėlė;Gudručiai;5141585309;Taip;3;4;0;7
16769;Obelėlė;Gudručiai;9736557012;Taip;11;4;0;15
16770;Obelėlė;Gudručiai;6720058972;Taip;0;0;1;1
16771;Obelėlė;Gudručiai;2053807216;Taip;0;4;1;5
16772;Obelėlė;Gudručiai;2204293216;Ne;0;2;5;7
16773;Obelėlė;Gudručiai;1184082097;Taip;0;0;1;1
16774;Obelėlė;Gudručiai;2533715287;Taip;6;4;2;12
16775;Obelėlė;Gudručiai;1312484983;Taip;10;2;0;12
16776;Obelėlė;Gudručiai;1565630870;Taip;0;0;1;1
16777;Obelėlė;Gudručiai;1598785483;Taip;4;4;0;8
16778;Obelėlė;Gudručiai;2170134084;Taip;0;1;1;2
16779;Obelėlė;Gudručiai;8155712451;Taip;0;4;0;4
16780;Obelėlė;Gudručiai;8371648703;Taip;0;0;1;1
16781;Obelėlė;Gudručiai;1630067014;Taip;4;0;0;4
16782;Obelėlė;Pasakaitė;9008900055;Taip;11;0;0;11
16783;Obelėlė;Pasakaitė;9332534001;Taip;11;0;0;11
16784;Obelėlė;Pasakaitė;1788880520;Taip;12;0;0;12
16785;Obelėlė;Pasakaitė;2465101384;Ne;0;1;3;4
16786;Obelėlė;Pasakaitė;5366112771;Taip;0;0;1;1
16787;Obelėlė;Pasakaitė;4505857257;Taip;0;0;1;1
16788;Obelėlė;Pasakaitė;6945301927;Taip;0;0;1;1
16789;Obelėlė;Pasakaitė;5603904852;Taip;3;4;0;7
16790;Obelėlė;Pasakaitė;9995891955;Taip;4;0;0;4
16791;Obelėlė;Pasakaitė;3646359565;Taip;1;0;0;1
16792;Obelėlė;Pasakaitė;2663004768;Taip;7;0;0;7
16793;Obelėlė;Pasakaitė;4707488292;Taip;19;0;0;19
16794;Obelėlė;Pasakaitė;8060994250;Taip;6;0;2;8
16795;Obelėlė;Pasakaitė;5617103957;Taip;0;3;0;3
16796;Obelėlė;Pasakaitė;6321178561;Taip;0;0;2;2
16797;Obelėlė;Pasakaitė;9903010418;Taip;5;0;0;5
16798;Obelėlė;Pasakaitė;4673426170;Taip;5;4;1;10
16799;Obelėlė;Pasakaitė;7901070568;Taip;0;0;1;1
16800;Obelėlė;Svajokliai;9981446556;Taip;0;4;1;5
16801;Obelėlė;Svajokliai;4849499826;Taip;0;0;4;4
16802;Obelėlė;Svajokliai;1469593267;Taip;6;4;3;13
16803;Obelėlė;Svajokliai;9819048265;Taip;4;3;0;7
16804;Obelėlė;Svajokliai;1010954005;Taip;5;0;0;5
16805;Obelėlė;Svajokliai;4489212434;Taip;0;0;1;1
16806;Obelėlė;Svajokliai;6325027163;Taip;1;0;0;1
16807;Obelėlė;Svajokliai;5588467580;Taip;0;4;9;13
16808;Obelėlė;Svajokliai;7094715237;Taip;0;0;5;5
16809;Obelėlė;Svajokliai;9070960601;Taip;2;0;0;2
16810;Obelėlė;Svajokliai;8231489868;Taip;5;0;0;5
16811;Obelėlė;Svajokliai;3986892111;Taip;0;4;0;4
16812;Obelėlė;Svajokliai;9641297002;Taip;4;0;0;4
16813;Obelėlė;Svajokliai;8918176312;Taip;0;6;0;6
16814;Obelėlė;Svajokliai;8604451971;Taip;8;0;0;8
16815;Obelėlė;Svajokliai;6785654280;Taip;4;0;3;7
16816;Obelėlė;Svajokliai;6311322617;Taip;5;0;2;7
16817;Obelėlė;Svajokliai;2813927086;Taip;3;0;0;3
16818;Obelėlė;Smalsučiai;6497584911;Taip;0;4;0;4
16819;Obelėlė;Smalsučiai;1469375976;Taip;0;0;3;3
16820;Obelėlė;Smalsučiai;7108517080;Taip;0;0;1;1
16821;Obelėlė;Smalsučiai;4987747783;Taip;0;0;2;2
16822;Obelėlė;Smalsučiai;8709758561;Taip;8;0;0;8
16823;Obelėlė;Smalsučiai;4318546408;Taip;0;5;0;5
16824;Obelėlė;Smalsučiai;5739522736;Taip;0;4;0;4
16825;Obelėlė;Smalsučiai;2631405243;Taip;5;0;3;8
16826;Obelėlė;Smalsučiai;8173307704;Taip;7;4;0;11
16827;Obelėlė;Smalsučiai;6720808705;Taip;6;4;0;10
16828;Obelėlė;Smalsučiai;7850656031;Taip;4;0;0;4
16829;Obelėlė;Smalsučiai;9084969712;Taip;0;0;2;2
16830;Obelėlė;Smalsučiai;6364101139;Taip;19;4;0;23
16831;Obelėlė;Smalsučiai;6064646690;Taip;5;0;0;5
16832;Obelėlė;Smalsučiai;8183287212;Taip;0;1;1;2
16833;Obelėlė;Smalsučiai;2574840626;Taip;10;8;0;18
16834;Obelėlė;Smalsučiai;8981403984;Taip;18;0;1;19
16835;Obelėlė;Pabiručiai;2035035265;Taip;10;0;0;10
16836;Obelėlė;Pabiručiai;5763713052;Taip;19;0;0;19
16837;Obelėlė;Pabiručiai;1819480590;Taip;1;0;0;1
16838;Obelėlė;Pabiručiai;8579887226;Taip;5;0;0;5
16839;Obelėlė;Pabiručiai;8948297718;Taip;1;0;0;1
16840;Obelėlė;Pabiručiai;3951816174;Taip;8;0;0;8
16841;Obelėlė;Pabiručiai;5599466885;Taip;3;3;1;7
16842;Obelėlė;Pabiručiai;9634414572;Taip;3;0;0;3
16843;Obelėlė;Pabiručiai;2262107831;Taip;0;0;1;1
16844;Obelėlė;Pabiručiai;4851824672;Taip;0;2;0;2
16845;Obelėlė;Pabiručiai;9731565368;Taip;0;4;0;4
16846;Obelėlė;Pabiručiai;8827515572;Taip;9;0;0;9
16847;Obelėlė;Pabiručiai;2399173200;Taip;4;0;0;4
16848;Obelėlė;Pabiručiai;9627134967;Taip;5;1;0;6
16849;Obelėlė;Pabiručiai;4575139158;Taip;18;0;1;19
16850;Obelėlė;Strakaliukai;1706102918;Taip;4;0;0;4
16851;Obelėlė;Strakaliukai;8682794598;Taip;12;0;0;12
16852;Obelėlė;Strakaliukai;8754552660;Taip;3;0;0;3
16853;Obelėlė;Strakaliukai;8092024850;Taip;0;4;0;4
16854;Obelėlė;Strakaliukai;9716500560;Taip;0;0;1;1
16855;Obelėlė;Strakaliukai;4251418414;Taip;0;0;1;1
16856;Obelėlė;Strakaliukai;7128421330;Taip;4;1;1;6
16857;Obelėlė;Strakaliukai;5943314566;Taip;0;4;1;5
16858;Obelėlė;Strakaliukai;8050551266;Taip;0;13;1;14
16859;Obelėlė;Strakaliukai;7468335279;Taip;9;0;0;9
16860;Obelėlė;Strakaliukai;1180508643;Taip;0;3;0;3
16861;Obelėlė;Strakaliukai;7124393375;Taip;0;2;6;8
16862;Obelėlė;Strakaliukai;5001844064;Taip;0;4;2;6
16863;Obelėlė;Strakaliukai;9976694313;Taip;5;1;0;6
16864;Obelėlė;Strakaliukai;1537769810;Taip;0;4;1;5
16865;Obelėlė;Strakaliukai;5776116844;Taip;0;6;0;6
16866;Obelėlė;Strakaliukai;1909459236;Taip;0;0;2;2
16867;Obelėlė;Strakaliukai;3425736276;Taip;0;4;0;4
16868;Obelėlė;Strakaliukai;5374979248;Taip;0;0;1;1
16869;Obelėlė;Saulutė;2772753891;Taip;4;3;0;7
16870;Obelėlė;Saulutė;8486560892;Taip;4;0;0;4
16871;Obelėlė;Saulutė;1858251094;Taip;1;0;3;4
16872;Obelėlė;Saulutė;2893378990;Taip;5;0;0;5
16873;Obelėlė;Saulutė;6874039388;Taip;3;0;0;3
16874;Obelėlė;Saulutė;7491934262;Taip;1;4;0;5
16875;Obelėlė;Saulutė;9043542844;Taip;1;0;0;1
16876;Obelėlė;Saulutė;4321210604;Taip;9;0;0;9
16877;Obelėlė;Saulutė;4209489251;Taip;0;0;1;1
16878;Obelėlė;Saulutė;4309622934;Taip;14;0;0;14
16879;Obelėlė;Saulutė;3590915973;Taip;2;0;0;2
16880;Obelėlė;Saulutė;6470533765;Taip;7;0;0;7
16881;Obelėlė;Saulutė;8223715886;Taip;7;0;0;7
16882;Obelėlė;Saulutė;8461505586;Taip;0;0;3;3
16883;Obelėlė;Saulutė;2730569223;Taip;11;0;3;14
16884;Obelėlė;Saulutė;4218895290;Taip;6;0;1;7
16885;Obelėlė;Saulutė;4262041356;Taip;4;0;0;4
16886;Obelėlė;Rieduliukai;6288343928;Taip;16;0;0;16
16887;Obelėlė;Rieduliukai;8672239434;Taip;1;0;0;1
16888;Obelėlė;Rieduliukai;9980499571;Taip;8;0;0;8
16889;Obelėlė;Rieduliukai;7254219285;Taip;3;0;0;3
16890;Obelėlė;Rieduliukai;9329425457;Taip;0;4;0;4
16891;Obelėlė;Rieduliukai;9418600546;Taip;3;0;0;3
16892;Obelėlė;Rieduliukai;1246354139;Taip;4;0;0;4
16893;Obelėlė;Rieduliukai;8963630504;Taip;1;0;0;1
16894;Obelėlė;Rieduliukai;5441524884;Taip;0;23;0;23
16895;Obelėlė;Rieduliukai;3210789582;Taip;10;0;0;10
16896;Obelėlė;Rieduliukai;1039878043;Taip;10;0;0;10
16897;Obelėlė;Rieduliukai;7111855298;Taip;7;0;0;7
16898;Obelėlė;Rieduliukai;9359921446;Taip;7;0;0;7
16899;Obelėlė;Žirniukai;9542303128;Taip;5;0;0;5
16900;Obelėlė;Žirniukai;3886008149;Taip;10;0;0;10
16901;Obelėlė;Žirniukai;4676986978;Taip;1;0;0;1
16902;Obelėlė;Žirniukai;9222485883;Taip;8;0;0;8
16903;Obelėlė;Žirniukai;4708077301;Taip;21;0;0;21
16904;Obelėlė;Žirniukai;3199776998;Taip;7;0;0;7
16905;Obelėlė;Žirniukai;4979811410;Taip;11;0;0;11
16906;Obelėlė;Žirniukai;1369344706;Taip;11;0;0;11
16907;Obelėlė;Žirniukai;2561695305;Taip;5;0;0;5
16908;Obelėlė;Žirniukai;1329818819;Taip;3;0;0;3
16909;Obelėlė;Žirniukai;5933225940;Taip;0;23;0;23
16910;Obelėlė;Žirniukai;3347690540;Taip;6;0;0;6
16911;Obelėlė;Žirniukai;9502503757;Taip;1;0;0;1
16912;Obelėlė;Žirniukai;3474007758;Taip;12;0;0;12
16913;Obelėlė;Žirniukai;8777938603;Taip;5;1;0;6
16914;Obelėlė;Žirniukai;5213900934;Taip;16;0;0;16
16915;Obelėlė;Žirniukai;4862765923;Taip;5;0;0;5
16916;Obelėlė;Bičiuliai;5209482838;Taip;15;0;0;15
16917;Obelėlė;Bičiuliai;8422696011;Taip;2;4;2;8
16918;Obelėlė;Bičiuliai;1799603610;Taip;17;0;1;18
16919;Obelėlė;Bičiuliai;5192989376;Taip;19;4;0;23
16920;Obelėlė;Bičiuliai;5503843905;Ne;0;4;1;5
16921;Obelėlė;Bičiuliai;3287262204;Taip;0;0;2;2
16922;Obelėlė;Bičiuliai;2769784741;Taip;0;23;0;23
16923;Obelėlė;Bičiuliai;1222183008;Taip;3;0;0;3
16924;Obelėlė;Bičiuliai;7813350634;Taip;3;0;0;3
16925;Obelėlė;Bičiuliai;6133596410;Taip;5;4;0;9
16926;Obelėlė;Bičiuliai;3568124213;Taip;0;9;0;9
16927;Obelėlė;Bičiuliai;8794707243;Taip;0;0;1;1
16928;Obelėlė;Bičiuliai;2702773541;Taip;11;0;0;11
16929;Obelėlė;Bičiuliai;5478392319;Taip;1;0;0;1
16930;Obelėlė;Bičiuliai;4223995429;Taip;4;4;1;9
16931;Obelėlė;Bičiuliai;9005520809;Taip;1;2;0;3
16932;Obelėlė;Bičiuliai;8982197866;Taip;15;0;0;15
16933;Obelėlė;Bičiuliai;5073364608;Taip;2;0;0;2
16934;Obelėlė;Bičiuliai;3881456534;Taip;0;23;0;23
16935;Obelėlė;Kodėlčiukai;1050919659;Taip;5;0;0;5
16936;Obelėlė;Kodėlčiukai;7014872044;Taip;1;0;1;2
16937;Obelėlė;Kodėlčiukai;3028107343;Taip;9;0;0;9
16938;Obelėlė;Kodėlčiukai;4840134079;Taip;4;0;3;7
16939;Obelėlė;Kodėlčiukai;3320493372;Taip;0;3;1;4
16940;Obelėlė;Kodėlčiukai;2227383487;Taip;3;0;0;3
16941;Obelėlė;Kodėlčiukai;8818153952;Taip;8;0;0;8
16942;Obelėlė;Kodėlčiukai;4887103549;Taip;4;0;0;4
16943;Obelėlė;Kodėlčiukai;5221918341;Taip;8;0;1;9
16944;Obelėlė;Kodėlčiukai;3748406335;Taip;4;0;0;4
16945;Obelėlė;Kodėlčiukai;5233321854;Ne;1;0;0;1
16946;Obelėlė;Kodėlčiukai;1472630240;Taip;9;0;2;11
16947;Obelėlė;Kodėlčiukai;7422668691;Taip;4;0;1;5
16948;Obelėlė;Pagrandukai;7934967787;Taip;3;0;0;3
16949;Obelėlė;Pagrandukai;8711370875;Taip;8;0;0;8
16950;Obelėlė;Pagrandukai;6938326798;Taip;8;0;0;8
16951;Obelėlė;Pagrandukai;9258651395;Taip;13;0;0;13
16952;Obelėlė;Pagrandukai;3563701047;Taip;0;0;1;1
16953;Obelėlė;Pagrandukai;8664564820;Taip;9;0;0;9
16954;Obelėlė;Pagrandukai;9170515841;Taip;4;0;0;4
16955;Obelėlė;Pagrandukai;4930485327;Taip;7;0;0;7
16956;Obelėlė;Pagrandukai;9514739912;Taip;7;0;0;7
16957;Obelėlė;Pagrandukai;7368698046;Taip;13;0;0;13
16958;Obelėlė;Pagrandukai;3738932600;Taip;0;0;2;2
16959;Obelėlė;Pagrandukai;2203568007;Taip;8;1;0;9
16960;Obelėlė;Pagrandukai;1423488655;Ne;0;0;3;3
16961;Obelėlė;Pagrandukai;6045739549;Taip;17;0;1;18
16962;Obelėlė;Pagrandukai;1100928253;Taip;16;0;0;16
16963;Spygliukas;Bitutės;9444569348;Taip;14;0;0;14
16964;Spygliukas;Bitutės;8404929784;Taip;0;4;0;4
16965;Spygliukas;Bitutės;4835818382;Taip;4;4;0;8
16966;Spygliukas;Bitutės;9413950200;Taip;2;2;0;4
16967;Spygliukas;Bitutės;1664878188;Taip;0;3;0;3
16968;Spygliukas;Bitutės;5134327772;Taip;0;3;0;3
16969;Spygliukas;Bitutės;8476882854;Taip;5;4;0;9
16970;Spygliukas;Bitutės;3761715811;Taip;4;0;0;4
16971;Spygliukas;Bitutės;8270525839;Taip;0;4;0;4
16972;Spygliukas;Bitutės;3697691132;Taip;14;0;0;14
16973;Spygliukas;Bitutės;1550737449;Taip;10;1;0;11
16974;Spygliukas;Bitutės;5180736358;Taip;0;1;0;1
16975;Spygliukas;Bitutės;9431217584;Taip;0;8;0;8
16976;Spygliukas;Bitutės;8289288541;Taip;0;1;0;1
16977;Spygliukas;Bitutės;8825264090;Taip;8;0;0;8
16978;Spygliukas;Kiškučiai;8246739374;Taip;0;8;0;8
16979;Spygliukas;Kiškučiai;1243647769;Taip;6;3;0;9
16980;Spygliukas;Kiškučiai;6680699873;Taip;4;0;0;4
16981;Spygliukas;Kiškučiai;5043843336;Taip;1;0;0;1
16982;Spygliukas;Kiškučiai;2955219028;Ne;14;4;0;18
16983;Spygliukas;Kiškučiai;1823720183;Taip;4;4;0;8
16984;Spygliukas;Kiškučiai;1775612723;Taip;0;4;0;4
16985;Spygliukas;Kiškučiai;7324915516;Taip;14;0;0;14
16986;Spygliukas;Kiškučiai;6414439254;Taip;14;0;0;14
16987;Spygliukas;Kiškučiai;8565217488;Taip;8;0;0;8
16988;Spygliukas;Kiškučiai;3065727701;Ne;6;0;0;6
16989;Spygliukas;Kiškučiai;2367685286;Taip;0;23;0;23
16990;Spygliukas;Kiškučiai;4409209677;Ne;8;0;0;8
16991;Spygliukas;Boružėlės;5615854225;Taip;0;7;0;7
16992;Spygliukas;Boružėlės;6195903792;Taip;0;4;0;4
16993;Spygliukas;Boružėlės;1927028026;Taip;1;5;0;6
16994;Spygliukas;Boružėlės;7261580644;Taip;6;3;0;9
16995;Spygliukas;Boružėlės;6246925536;Taip;3;1;0;4
16996;Spygliukas;Boružėlės;3094528907;Taip;7;10;0;17
16997;Spygliukas;Boružėlės;8299276429;Taip;0;2;0;2
16998;Spygliukas;Boružėlės;7243104877;Taip;3;0;0;3
16999;Spygliukas;Boružėlės;9813995933;Taip;0;6;0;6
17000;Spygliukas;Boružėlės;4013601534;Taip;7;0;0;7
17001;Spygliukas;Boružėlės;1436452804;Taip;4;1;0;5
17002;Spygliukas;Boružėlės;3959136555;Taip;3;0;0;3
17003;Spygliukas;Boružėlės;6383264068;Taip;4;0;0;4
17004;Spygliukas;Boružėlės;1330384915;Taip;8;0;0;8
17005;Spygliukas;Boružėlės;1037321774;Taip;1;2;0;3
17006;Spygliukas;Boružėlės;9025238241;Taip;3;5;0;8
17007;Spygliukas;Boružėlės;5255993275;Taip;7;1;0;8
17008;Spygliukas;Ežiukai;2164549239;Taip;5;0;0;5
17009;Spygliukas;Ežiukai;4340767624;Taip;3;1;0;4
17010;Spygliukas;Ežiukai;4615217628;Taip;0;6;0;6
17011;Spygliukas;Ežiukai;5612894706;Taip;0;4;0;4
17012;Spygliukas;Ežiukai;1353217998;Taip;1;0;0;1
17013;Spygliukas;Ežiukai;6459076295;Taip;0;1;0;1
17014;Spygliukas;Ežiukai;7749937772;Taip;13;4;0;17
17015;Spygliukas;Ežiukai;2719100414;Taip;1;4;0;5
17016;Spygliukas;Ežiukai;1429613380;Taip;1;3;0;4
17017;Spygliukas;Ežiukai;4026252608;Taip;3;4;0;7
17018;Spygliukas;Ežiukai;4098112375;Taip;1;0;0;1
17019;Spygliukas;Ežiukai;9321493897;Ne;2;4;0;6
17020;Spygliukas;Ežiukai;7908419787;Taip;6;0;0;6
17021;Spygliukas;Ežiukai;5366783639;Taip;1;2;0;3
17022;Spygliukas;Ežiukai;3088387895;Taip;0;4;0;4
17023;Spygliukas;Ežiukai;7287543571;Taip;3;4;0;7
17024;Spygliukas;Ežiukai;3297728501;Taip;0;1;0;1
17025;Spygliukas;Ežiukai;3959227706;Taip;2;2;0;4
17026;Spygliukas;Geniukai;8821434815;Taip;3;0;0;3
17027;Spygliukas;Geniukai;2713999021;Taip;3;0;0;3
17028;Spygliukas;Geniukai;5782501698;Taip;6;0;0;6
17029;Spygliukas;Geniukai;6700076900;Taip;15;0;0;15
17030;Spygliukas;Geniukai;8338260940;Taip;4;4;0;8
17031;Spygliukas;Geniukai;1863442354;Taip;10;0;0;10
17032;Spygliukas;Geniukai;9945315122;Taip;0;4;0;4
17033;Spygliukas;Geniukai;1291429206;Taip;0;5;0;5
17034;Spygliukas;Geniukai;7477731865;Taip;0;4;0;4
17035;Spygliukas;Geniukai;2950722789;Taip;5;0;0;5
17036;Spygliukas;Geniukai;8093949301;Taip;5;0;0;5
17037;Spygliukas;Geniukai;9141146733;Taip;1;0;0;1
17038;Spygliukas;Geniukai;6363991196;Taip;0;3;0;3
17039;Spygliukas;Geniukai;8308394841;Taip;2;0;0;2
17040;Spygliukas;Geniukai;1127941700;Taip;0;1;0;1
17041;Spygliukas;Geniukai;9783154498;Ne;1;0;0;1
17042;Spygliukas;Geniukai;8581453160;Ne;4;0;0;4
17043;Spygliukas;Geniukai;7573756485;Taip;3;0;0;3
17044;Spygliukas;Geniukai;9770852356;Taip;12;0;0;12
17045;Spygliukas;Riešutėliai;9070219319;Taip;0;3;0;3
17046;Spygliukas;Riešutėliai;1333556956;Ne;1;0;0;1
17047;Spygliukas;Riešutėliai;7271659513;Taip;10;4;0;14
17048;Spygliukas;Riešutėliai;9392554576;Taip;0;2;0;2
17049;Spygliukas;Riešutėliai;8604767396;Taip;0;9;0;9
17050;Spygliukas;Riešutėliai;4634660174;Taip;0;1;0;1
17051;Spygliukas;Riešutėliai;8646122773;Taip;0;6;0;6
17052;Spygliukas;Riešutėliai;7924880159;Taip;0;4;0;4
17053;Spygliukas;Riešutėliai;4368224847;Taip;1;1;0;2
17054;Spygliukas;Riešutėliai;9316731983;Taip;2;1;0;3
17055;Spygliukas;Riešutėliai;6630979640;Taip;0;1;0;1
17056;Spygliukas;Riešutėliai;5012876830;Taip;5;0;0;5
17057;Spygliukas;Riešutėliai;2315421636;Taip;0;4;0;4
17058;Spygliukas;Riešutėliai;7125425492;Taip;4;4;0;8
17059;Spygliukas;Riešutėliai;5214431060;Ne;1;2;0;3
17060;Spygliukas;Riešutėliai;9052337501;Taip;0;3;0;3
17061;Spygliukas;Riešutėliai;4505044604;Taip;3;7;0;10
17062;Spygliukas;Riešutėliai;2989701249;Taip;1;0;0;1
17063;Spygliukas;Riešutėliai;9086986643;Taip;0;1;0;1
17064;Spygliukas;Pelėdžiukai;3569857813;Taip;4;0;0;4
17065;Spygliukas;Pelėdžiukai;4577592862;Taip;0;5;0;5
17066;Spygliukas;Pelėdžiukai;6931145017;Taip;4;0;0;4
17067;Spygliukas;Pelėdžiukai;8802722601;Taip;4;4;0;8
17068;Spygliukas;Pelėdžiukai;9285259322;Taip;1;4;0;5
17069;Spygliukas;Pelėdžiukai;6835488489;Taip;8;9;0;17
17070;Spygliukas;Pelėdžiukai;1341333016;Taip;15;4;0;19
17071;Spygliukas;Pelėdžiukai;8806126755;Taip;0;2;0;2
17072;Spygliukas;Pelėdžiukai;4477402331;Taip;7;1;0;8
17073;Spygliukas;Pelėdžiukai;2772801133;Taip;15;0;0;15
17074;Spygliukas;Pelėdžiukai;6332646009;Taip;1;4;0;5
17075;Spygliukas;Pelėdžiukai;3706443395;Taip;4;0;0;4
17076;Spygliukas;Pelėdžiukai;5765106914;Taip;0;2;0;2
17077;Spygliukas;Pelėdžiukai;8708083787;Taip;8;3;0;11
17078;Spygliukas;Pelėdžiukai;1401951658;Taip;2;0;0;2
17079;Spygliukas;Pelėdžiukai;6248409896;Taip;0;1;0;1
17080;Spygliukas;Zylutės;2135024989;Taip;23;0;0;23
17081;Spygliukas;Zylutės;7351963782;Taip;6;0;0;6
17082;Spygliukas;Zylutės;9348022137;Taip;13;0;0;13
17083;Spygliukas;Zylutės;3804738695;Taip;11;0;0;11
17084;Spygliukas;Zylutės;3036959597;Taip;3;0;0;3
17085;Spygliukas;Zylutės;5565042215;Taip;10;0;0;10
17086;Spygliukas;Zylutės;4161787684;Taip;3;0;0;3
17087;Spygliukas;Zylutės;6061859914;Taip;23;0;0;23
17088;Spygliukas;Zylutės;4097562838;Taip;6;0;0;6
17089;Spygliukas;Zylutės;2504348694;Taip;2;0;0;2
17090;Spygliukas;Zylutės;6021859437;Taip;11;0;0;11
17091;Spygliukas;Zylutės;5357257525;Taip;16;0;0;16
17092;Spygliukas;Zylutės;9382060963;Taip;15;0;0;15
17093;Spygliukas;Zylutės;8246963847;Taip;5;0;0;5
17094;Spygliukas;Skruzdėliukai;6828136677;Taip;5;0;0;5
17095;Spygliukas;Skruzdėliukai;7524773805;Taip;0;9;0;9
17096;Spygliukas;Skruzdėliukai;2921299830;Taip;5;0;0;5
17097;Spygliukas;Skruzdėliukai;9138352625;Taip;9;0;0;9
17098;Spygliukas;Skruzdėliukai;1419835654;Taip;10;0;0;10
17099;Spygliukas;Skruzdėliukai;5513126879;Taip;18;0;0;18
17100;Spygliukas;Skruzdėliukai;3458761442;Taip;9;1;0;10
17101;Spygliukas;Skruzdėliukai;9211070397;Taip;10;3;0;13
17102;Spygliukas;Skruzdėliukai;1210648053;Taip;7;0;0;7
17103;Spygliukas;Skruzdėliukai;7163485844;Taip;1;4;0;5
17104;Spygliukas;Skruzdėliukai;4974008654;Taip;5;4;0;9
17105;Spygliukas;Skruzdėliukai;6749921681;Taip;4;1;0;5
17106;Spygliukas;Voveraitės;9112172144;Taip;4;2;0;6
17107;Spygliukas;Voveraitės;7897603878;Taip;0;7;0;7
17108;Spygliukas;Voveraitės;7741841634;Taip;0;7;0;7
17109;Spygliukas;Voveraitės;3077468722;Taip;0;1;0;1
17110;Spygliukas;Voveraitės;2272141731;Taip;0;3;0;3
17111;Spygliukas;Voveraitės;6587957213;Taip;0;10;0;10
17112;Spygliukas;Voveraitės;6758336405;Taip;9;0;0;9
17113;Spygliukas;Voveraitės;3668191959;Taip;5;6;0;11
17114;Spygliukas;Voveraitės;1426267001;Taip;8;0;0;8
17115;Spygliukas;Voveraitės;8189748611;Taip;1;4;0;5
17116;Spygliukas;Voveraitės;6405496193;Taip;0;1;0;1
17117;Spygliukas;Voveraitės;7113913750;Ne;0;4;0;4
17118;Spygliukas;Voveraitės;9231097598;Ne;3;4;0;7
17119;Spygliukas;Voveraitės;4681061579;Taip;9;4;0;13
17120;Spygliukas;Voveraitės;7313828707;Taip;4;0;0;4
17121;Spygliukas;Voveraitės;1234195733;Taip;0;1;0;1
17122;Spygliukas;Giliukų;4854168938;Taip;3;0;0;3
17123;Spygliukas;Giliukų;7522567241;Taip;0;1;0;1
17124;Spygliukas;Giliukų;7460280684;Taip;8;0;0;8
17125;Spygliukas;Giliukų;4429961491;Taip;1;10;0;11
17126;Spygliukas;Giliukų;8821028259;Taip;4;0;0;4
17127;Spygliukas;Giliukų;6485350404;Taip;10;5;0;15
17128;Spygliukas;Giliukų;3237501537;Taip;9;1;0;10
17129;Spygliukas;Giliukų;8722863277;Taip;9;0;0;9
17130;Spygliukas;Giliukų;3603606800;Taip;0;1;0;1
17131;Spygliukas;Giliukų;6290439938;Taip;6;7;0;13
17132;Spygliukas;Giliukų;7776811391;Taip;0;1;0;1
17133;Spygliukas;Giliukų;3777763305;Taip;9;0;0;9
17134;Spygliukas;Giliukų;4626877679;Taip;0;1;0;1
17135;Spygliukas;Giliukų;4494339318;Taip;6;0;0;6
17136;Spygliukas;Drugeliai;8178732077;Taip;2;0;0;2
17137;Spygliukas;Drugeliai;5164567779;Taip;1;1;0;2
17138;Spygliukas;Drugeliai;8366571422;Taip;1;0;0;1
17139;Spygliukas;Drugeliai;9601530981;Taip;5;0;0;5
17140;Spygliukas;Drugeliai;3317395260;Taip;15;0;0;15
17141;Spygliukas;Drugeliai;3811864870;Taip;0;3;0;3
17142;Spygliukas;Drugeliai;5638595939;Taip;1;4;0;5
17143;Spygliukas;Drugeliai;8408234202;Taip;4;5;0;9
17144;Spygliukas;Drugeliai;1729199382;Taip;10;0;0;10
17145;Spygliukas;Drugeliai;5006372835;Taip;3;0;0;3
17146;Spygliukas;Drugeliai;3268222954;Taip;3;0;0;3
17147;Spygliukas;Drugeliai;3066293772;Ne;5;0;0;5
17148;Spygliukas;Drugeliai;6343141973;Taip;6;0;0;6
17149;Spygliukas;Drugeliai;2632672131;Taip;0;1;0;1
17150;Vieversys;Žirniukai;5365334453;Taip;0;8;0;8
17151;Vieversys;Žirniukai;7029322013;Taip;4;1;1;6
17152;Vieversys;Žirniukai;2266222087;Taip;6;0;0;6
17153;Vieversys;Žirniukai;2869545222;Taip;3;0;1;4
17154;Vieversys;Žirniukai;2024837493;Taip;6;0;1;7
17155;Vieversys;Žirniukai;8129566710;Taip;0;5;1;6
17156;Vieversys;Žirniukai;5576923685;Taip;0;1;0;1
17157;Vieversys;Žirniukai;1724543625;Taip;1;14;0;15
17158;Vieversys;Žirniukai;6530685517;Taip;0;6;0;6
17159;Vieversys;Žirniukai;3533711179;Taip;0;1;0;1
17160;Vieversys;Žirniukai;2242368843;Taip;6;0;0;6
17161;Vieversys;Žirniukai;9666764935;Taip;8;0;3;11
17162;Vieversys;Žirniukai;8966020793;Taip;4;0;1;5
17163;Vieversys;Žirniukai;6000875464;Taip;0;4;0;4
17164;Vieversys;Varpelių;5150986489;Taip;6;0;0;6
17165;Vieversys;Varpelių;9463693741;Taip;9;0;0;9
17166;Vieversys;Varpelių;1924774817;Taip;3;1;0;4
17167;Vieversys;Varpelių;3595005599;Taip;9;4;0;13
17168;Vieversys;Varpelių;9155896981;Taip;0;3;0;3
17169;Vieversys;Varpelių;5160814541;Taip;0;1;0;1
17170;Vieversys;Varpelių;9580031042;Taip;4;0;0;4
17171;Vieversys;Varpelių;2635722489;Taip;0;4;0;4
17172;Vieversys;Varpelių;3262738994;Taip;0;5;0;5
17173;Vieversys;Varpelių;8350070741;Taip;1;0;0;1
17174;Vieversys;Varpelių;2805682329;Taip;3;1;0;4
17175;Vieversys;Varpelių;9453100342;Taip;3;0;0;3
17176;Vieversys;Varpelių;1727558984;Taip;9;0;1;10
17177;Vieversys;Varpelių;3780226431;Taip;6;0;2;8
17178;Vieversys;Varpelių;3572628491;Taip;0;4;0;4
17179;Vieversys;Varpelių;1128991679;Taip;2;0;0;2
17180;Vieversys;Varpelių;7611047781;Taip;5;0;0;5
17181;Vieversys;Varpelių;8079885165;Taip;10;0;0;10
17182;Vieversys;Varpelių;4510888337;Taip;0;7;0;7
17183;Vieversys;Kiškučių;3405502715;Taip;2;3;0;5
17184;Vieversys;Kiškučių;6127272124;Taip;0;3;1;4
17185;Vieversys;Kiškučių;4892622551;Taip;0;6;0;6
17186;Vieversys;Kiškučių;3360981720;Taip;8;0;1;9
17187;Vieversys;Kiškučių;5654533451;Taip;0;4;0;4
17188;Vieversys;Kiškučių;9985374057;Taip;8;0;0;8
17189;Vieversys;Kiškučių;3164280186;Taip;6;0;0;6
17190;Vieversys;Kiškučių;1748006118;Taip;10;0;0;10
17191;Vieversys;Kiškučių;4690095102;Taip;0;4;0;4
17192;Vieversys;Kiškučių;7048475906;Taip;0;4;0;4
17193;Vieversys;Kiškučių;4072323869;Taip;0;2;0;2
17194;Vieversys;Kiškučių;2663322242;Taip;4;0;0;4
17195;Vieversys;Kiškučių;7596355010;Taip;0;6;0;6
17196;Vieversys;Kiškučių;9322322737;Taip;0;0;4;4
17197;Vieversys;Kiškučių;9164615794;Taip;0;6;0;6
17198;Vieversys;Kiškučių;8174124875;Taip;0;4;0;4
17199;Vieversys;Pelėdžiukų;3681120339;Taip;0;0;1;1
17200;Vieversys;Pelėdžiukų;6882614465;Taip;0;2;0;2
17201;Vieversys;Pelėdžiukų;7007620994;Taip;4;1;0;5
17202;Vieversys;Pelėdžiukų;3946609345;Taip;5;1;0;6
17203;Vieversys;Pelėdžiukų;3684937630;Taip;9;4;0;13
17204;Vieversys;Pelėdžiukų;4455039401;Taip;0;4;0;4
17205;Vieversys;Pelėdžiukų;6563139211;Taip;0;9;1;10
17206;Vieversys;Pelėdžiukų;4294676988;Taip;10;4;1;15
17207;Vieversys;Pelėdžiukų;4835022593;Taip;3;1;0;4
17208;Vieversys;Pelėdžiukų;3249717073;Taip;0;6;0;6
17209;Vieversys;Pelėdžiukų;7120329258;Taip;0;4;0;4
17210;Vieversys;Pelėdžiukų;9494957750;Taip;0;10;2;12
17211;Vieversys;Pelėdžiukų;9835682858;Taip;0;4;6;10
17212;Vieversys;Pelėdžiukų;5907903394;Taip;0;4;0;4
17213;Vieversys;Pelėdžiukų;5769453869;Taip;0;4;3;7
17214;Vieversys;Saulučių;8706336322;Taip;2;0;0;2
17215;Vieversys;Saulučių;5966170543;Taip;8;0;1;9
17216;Vieversys;Saulučių;9268459013;Taip;5;0;0;5
17217;Vieversys;Saulučių;5210732072;Taip;8;0;0;8
17218;Vieversys;Saulučių;9188208330;Taip;7;0;0;7
17219;Vieversys;Saulučių;9476611261;Taip;0;23;0;23
17220;Vieversys;Saulučių;9978867863;Taip;5;4;0;9
17221;Vieversys;Saulučių;5479620291;Taip;14;0;0;14
17222;Vieversys;Saulučių;6083402842;Taip;4;0;0;4
17223;Vieversys;Saulučių;3601928285;Taip;10;0;0;10
17224;Vieversys;Saulučių;2661027772;Taip;8;0;0;8
17225;Vieversys;Saulučių;4428101863;Taip;16;1;0;17
17226;Vieversys;Saulučių;5417413393;Ne;12;0;0;12
17227;Vieversys;Saulučių;4335653911;Taip;2;0;0;2
17228;Vieversys;Saulučių;9092693925;Taip;8;0;0;8
17229;Vieversys;Kregždučių;3156245273;Taip;2;1;0;3
17230;Vieversys;Kregždučių;5645852451;Taip;11;0;0;11
17231;Vieversys;Kregždučių;7998100115;Taip;0;5;0;5
17232;Vieversys;Kregždučių;9093088054;Taip;0;5;0;5
17233;Vieversys;Kregždučių;4870401841;Taip;4;0;0;4
17234;Vieversys;Kregždučių;2849852593;Taip;2;1;0;3
17235;Vieversys;Kregždučių;6808541662;Taip;1;0;0;1
17236;Vieversys;Kregždučių;2230503026;Taip;2;2;0;4
17237;Vieversys;Kregždučių;8141710663;Taip;3;0;0;3
17238;Vieversys;Kregždučių;6157594693;Taip;2;4;0;6
17239;Vieversys;Kregždučių;1322953831;Taip;0;9;0;9
17240;Vieversys;Kregždučių;4308330177;Taip;5;1;0;6
17241;Vieversys;Kregždučių;3122763958;Taip;7;4;0;11
17242;Vieversys;Kregždučių;2938302462;Taip;6;11;1;18
17243;Vieversys;Kregždučių;9577869269;Taip;4;0;0;4
17244;Vieversys;Boružėlių;8587368497;Taip;0;4;0;4
17245;Vieversys;Boružėlių;9884517851;Taip;0;3;0;3
17246;Vieversys;Boružėlių;4565799599;Taip;0;2;0;2
17247;Vieversys;Boružėlių;7399326463;Taip;9;0;0;9
17248;Vieversys;Boružėlių;7364582681;Taip;2;4;0;6
17249;Vieversys;Boružėlių;8084767846;Taip;0;0;1;1
17250;Vieversys;Boružėlių;9826657384;Taip;0;3;0;3
17251;Vieversys;Boružėlių;3731412573;Taip;0;4;0;4
17252;Vieversys;Boružėlių;7429565381;Taip;0;4;1;5
17253;Vieversys;Boružėlių;4297477514;Taip;5;1;0;6
17254;Vieversys;Boružėlių;2701284187;Taip;3;6;0;9
17255;Vieversys;Boružėlių;6234199996;Taip;7;0;0;7
17256;Vieversys;Boružėlių;4183584366;Taip;10;0;1;11
17257;Vieversys;Boružėlių;4061364544;Taip;7;0;0;7
17258;Vieversys;Boružėlių;8446180685;Taip;20;0;0;20
17259;Vieversys;Boružėlių;6838828193;Taip;6;0;0;6
17260;Vieversys;Bitučių;9802720188;Taip;0;12;0;12
17261;Vieversys;Bitučių;3529067497;Taip;3;0;0;3
17262;Vieversys;Bitučių;7427200045;Taip;3;0;0;3
17263;Vieversys;Bitučių;8339300439;Taip;0;11;0;11
17264;Vieversys;Bitučių;6133686703;Taip;1;0;0;1
17265;Vieversys;Bitučių;8916379820;Taip;2;0;0;2
17266;Vieversys;Bitučių;6070871599;Taip;5;0;0;5
17267;Vieversys;Bitučių;8443729534;Taip;6;3;0;9
17268;Vieversys;Bitučių;7623394512;Taip;0;0;10;10
17269;Vieversys;Bitučių;5598338574;Taip;8;0;0;8
17270;Vieversys;Bitučių;3798183613;Taip;7;0;0;7
17271;Vieversys;Bitučių;3539906884;Taip;0;23;0;23
17272;Vieversys;Bitučių;5226457473;Taip;0;23;0;23
17273;Vieversys;Bitučių;4138476832;Taip;8;1;0;9
17274;Vieversys;Bitučių;1844718177;Taip;1;4;1;6
17275;Vieversys;Smalsučių;9412299328;Taip;9;0;0;9
17276;Vieversys;Smalsučių;8199984460;Taip;0;0;23;23
17277;Vieversys;Smalsučių;7539934804;Taip;0;0;1;1
17278;Vieversys;Smalsučių;1714096583;Taip;17;0;0;17
17279;Vieversys;Smalsučių;8371839883;Taip;8;0;1;9
17280;Vieversys;Smalsučių;5394635510;Taip;3;0;2;5
17281;Vieversys;Smalsučių;8200432952;Taip;11;0;0;11
17282;Vieversys;Smalsučių;2535992834;Taip;4;0;1;5
17283;Vieversys;Smalsučių;4974924858;Taip;8;0;0;8
17284;Vieversys;Smalsučių;7111551694;Taip;17;0;0;17
17285;Vieversys;Smalsučių;3332069842;Taip;0;4;0;4
17286;Vieversys;Smalsučių;2107000312;Taip;4;0;0;4
17287;Vieversys;Smalsučių;4743593002;Taip;11;0;0;11
17288;Vieversys;Smalsučių;6092848276;Taip;5;0;1;6
17289;Vieversys;Smalsučių;6498432810;Taip;17;0;3;20
17290;Vieversys;Kodėlčiukų;5037806018;Taip;2;0;0;2
17291;Vieversys;Kodėlčiukų;1752359969;Taip;0;5;0;5
17292;Vieversys;Kodėlčiukų;6791121542;Taip;5;0;0;5
17293;Vieversys;Kodėlčiukų;5898422871;Taip;3;4;0;7
17294;Vieversys;Kodėlčiukų;6709556873;Taip;2;0;0;2
17295;Vieversys;Kodėlčiukų;4193031329;Taip;4;2;0;6
17296;Vieversys;Kodėlčiukų;7453156612;Taip;6;0;0;6
17297;Vieversys;Kodėlčiukų;6926960486;Taip;0;4;0;4
17298;Vieversys;Kodėlčiukų;3180687885;Taip;7;4;0;11
17299;Vieversys;Kodėlčiukų;1881076551;Taip;0;4;0;4
17300;Vieversys;Kodėlčiukų;1384388802;Taip;0;6;0;6
17301;Vieversys;Kodėlčiukų;2562413607;Taip;8;6;0;14
17302;Vieversys;Kodėlčiukų;9965162863;Taip;2;0;0;2
17303;Vieversys;Kodėlčiukų;4702339508;Taip;7;0;0;7
17304;Vieversys;Kodėlčiukų;4631238425;Taip;2;0;0;2
17305;Vieversys;Kodėlčiukų;8512643926;Taip;11;0;0;11
17306;Vieversys;Kodėlčiukų;7967372524;Ne;4;0;0;4
17307;Vieversys;Kodėlčiukų;4703696958;Taip;6;0;0;6
17308;Vieversys;Kodėlčiukų;9747443326;Taip;5;0;0;5
17309;Vieversys;NYKŠTUKAI;7778432049;Taip;9;0;0;9
17310;Vieversys;NYKŠTUKAI;6767212393;Taip;0;0;1;1
17311;Vieversys;NYKŠTUKAI;2143285915;Taip;5;0;0;5
17312;Vieversys;NYKŠTUKAI;7340840045;Taip;14;4;0;18
17313;Vieversys;NYKŠTUKAI;3557067985;Taip;13;0;0;13
17314;Vieversys;NYKŠTUKAI;3051432532;Taip;0;0;1;1
17315;Vieversys;NYKŠTUKAI;4051613934;Taip;0;0;1;1
17316;Vieversys;NYKŠTUKAI;8054640386;Taip;7;0;0;7
17317;Vieversys;NYKŠTUKAI;9812354315;Taip;13;0;0;13
17318;Vieversys;NYKŠTUKAI;1377293916;Taip;8;0;0;8
17319;Vieversys;NYKŠTUKAI;4482612962;Taip;13;0;0;13
17320;Vieversys;NYKŠTUKAI;6408198729;Taip;2;0;2;4
17321;Vieversys;DRUGELIAI;2638813853;Taip;15;4;0;19
17322;Vieversys;DRUGELIAI;7508850558;Taip;0;0;2;2
17323;Vieversys;DRUGELIAI;1552959751;Taip;3;0;0;3
17324;Vieversys;DRUGELIAI;6669012722;Taip;13;0;0;13
17325;Vieversys;DRUGELIAI;9813883328;Taip;5;0;0;5
17326;Vieversys;DRUGELIAI;7708807923;Taip;6;1;0;7
17327;Vieversys;DRUGELIAI;4129333932;Taip;17;0;0;17
17328;Vieversys;DRUGELIAI;1720061988;Taip;0;4;0;4
17329;Vieversys;DRUGELIAI;6014448044;Taip;4;1;0;5
17330;Vieversys;DRUGELIAI;6222790462;Taip;5;2;0;7
17331;Vieversys;DRUGELIAI;1752390411;Taip;0;3;1;4
17332;Vieversys;DRUGELIAI;4743557459;Taip;14;0;1;15
17333;Vieversys;DRUGELIAI;9377014366;Taip;16;0;0;16
17334;Vieversys;DRUGELIAI;8595221658;Taip;0;0;3;3
17335;Žirmūnėliai;SAULUTĖS;5560694124;Taip;5;1;0;6
17336;Žirmūnėliai;SAULUTĖS;6116321928;Taip;0;12;0;12
17337;Žirmūnėliai;SAULUTĖS;5626711530;Taip;0;11;0;11
17338;Žirmūnėliai;SAULUTĖS;3902161368;Taip;0;1;0;1
17339;Žirmūnėliai;SAULUTĖS;4338673048;Taip;5;6;0;11
17340;Žirmūnėliai;SAULUTĖS;4793967980;Taip;0;4;0;4
17341;Žirmūnėliai;SAULUTĖS;8242112212;Taip;8;6;0;14
17342;Žirmūnėliai;SAULUTĖS;1940552890;Taip;0;4;0;4
17343;Žirmūnėliai;SAULUTĖS;4343419766;Taip;12;2;0;14
17344;Žirmūnėliai;SAULUTĖS;9145626116;Taip;9;6;0;15
17345;Žirmūnėliai;SAULUTĖS;7675488865;Taip;12;0;0;12
17346;Žirmūnėliai;SAULUTĖS;8345632807;Taip;0;2;0;2
17347;Žirmūnėliai;SAULUTĖS;8592714547;Taip;0;4;0;4
17348;Žirmūnėliai;SAULUTĖS;8481357052;Taip;7;0;0;7
17349;Žirmūnėliai;GILIUKAI;6430944858;Taip;0;0;1;1
17350;Žirmūnėliai;GILIUKAI;3562689670;Taip;0;11;0;11
17351;Žirmūnėliai;GILIUKAI;5929166560;Taip;4;1;0;5
17352;Žirmūnėliai;GILIUKAI;3767421827;Taip;3;1;0;4
17353;Žirmūnėliai;GILIUKAI;5104310002;Taip;12;1;0;13
17354;Žirmūnėliai;GILIUKAI;1025809131;Taip;4;0;0;4
17355;Žirmūnėliai;GILIUKAI;6899109664;Taip;3;9;0;12
17356;Žirmūnėliai;GILIUKAI;5089884149;Taip;7;0;0;7
17357;Žirmūnėliai;GILIUKAI;1791977446;Taip;3;2;0;5
17358;Žirmūnėliai;GILIUKAI;6875484657;Taip;0;0;9;9
17359;Žirmūnėliai;GILIUKAI;9871163622;Taip;6;0;0;6
17360;Žirmūnėliai;GILIUKAI;3532895278;Taip;0;1;0;1
17361;Žirmūnėliai;GILIUKAI;2959090234;Taip;4;0;0;4
17362;Žirmūnėliai;GILIUKAI;5486475468;Taip;0;2;0;2
17363;Žirmūnėliai;GILIUKAI;8618410295;Taip;17;0;0;17
17364;Žirmūnėliai;GILIUKAI;1941509002;Ne;8;0;2;10
17365;Žirmūnėliai;GILIUKAI;3646039695;Taip;3;0;0;3
17366;Žirmūnėliai;DRUGELIAI;2802717644;Taip;0;4;0;4
17367;Žirmūnėliai;DRUGELIAI;3029428022;Taip;9;1;0;10
17368;Žirmūnėliai;DRUGELIAI;5281338626;Taip;3;2;0;5
17369;Žirmūnėliai;DRUGELIAI;6892941066;Taip;0;11;0;11
17370;Žirmūnėliai;DRUGELIAI;9280663182;Taip;0;12;0;12
17371;Žirmūnėliai;DRUGELIAI;6427861912;Taip;10;0;0;10
17372;Žirmūnėliai;DRUGELIAI;2736632324;Taip;4;2;0;6
17373;Žirmūnėliai;DRUGELIAI;5892153807;Taip;4;1;0;5
17374;Žirmūnėliai;DRUGELIAI;2870069039;Taip;0;1;0;1
17375;Žirmūnėliai;DRUGELIAI;8271996884;Taip;0;10;0;10
17376;Žirmūnėliai;DRUGELIAI;4291114238;Taip;11;0;0;11
17377;Žirmūnėliai;DRUGELIAI;3012945005;Taip;12;1;0;13
17378;Žirmūnėliai;DRUGELIAI;8782085662;Taip;12;1;0;13
17379;Žirmūnėliai;DRUGELIAI;4836165731;Taip;2;0;0;2
17380;Žirmūnėliai;DRUGELIAI;3174613910;Taip;0;2;0;2
17381;Žirmūnėliai;DRUGELIAI;6812682361;Taip;15;0;0;15
17382;Žirmūnėliai;DRUGELIAI;5668266601;Taip;9;4;0;13
17383;Žirmūnėliai;DRUGELIAI;5616289290;Taip;7;0;0;7
17384;Žirmūnėliai;DRUGELIAI;9908958250;Taip;0;8;0;8
17385;Žirmūnėliai;DRUGELIAI;9978718231;Taip;0;1;0;1
17386;Žirmūnėliai;BORUŽIUKAI;5209700153;Taip;6;4;0;10
17387;Žirmūnėliai;BORUŽIUKAI;4815427530;Taip;4;0;0;4
17388;Žirmūnėliai;BORUŽIUKAI;5316869112;Taip;0;0;1;1
17389;Žirmūnėliai;BORUŽIUKAI;6641667315;Taip;0;6;0;6
17390;Žirmūnėliai;BORUŽIUKAI;8538773532;Taip;5;1;0;6
17391;Žirmūnėliai;BORUŽIUKAI;1401001989;Taip;0;2;0;2
17392;Žirmūnėliai;BORUŽIUKAI;1356219744;Taip;5;7;0;12
17393;Žirmūnėliai;BORUŽIUKAI;2985092368;Taip;14;0;0;14
17394;Žirmūnėliai;BORUŽIUKAI;2841958534;Taip;1;5;0;6
17395;Žirmūnėliai;BORUŽIUKAI;5736502380;Taip;5;5;0;10
17396;Žirmūnėliai;BORUŽIUKAI;9241738140;Taip;18;1;0;19
17397;Žirmūnėliai;BORUŽIUKAI;9378860669;Taip;0;4;0;4
17398;Žirmūnėliai;BORUŽIUKAI;8607934394;Taip;4;4;0;8
17399;Žirmūnėliai;BORUŽIUKAI;7422544482;Taip;3;5;2;10
17400;Žirmūnėliai;BORUŽIUKAI;4336415033;Taip;3;1;0;4
17401;Žirmūnėliai;BORUŽIUKAI;8459217612;Taip;2;0;0;2
17402;Žirmūnėliai;BORUŽIUKAI;1473482823;Ne;3;0;0;3
17403;Žirmūnėliai;EŽIUKAI;7011701994;Taip;5;5;0;10
17404;Žirmūnėliai;EŽIUKAI;2661052835;Taip;0;7;0;7
17405;Žirmūnėliai;EŽIUKAI;1655437833;Taip;11;0;1;12
17406;Žirmūnėliai;EŽIUKAI;3640979388;Taip;0;7;0;7
17407;Žirmūnėliai;EŽIUKAI;6878528100;Taip;5;0;5;10
17408;Žirmūnėliai;EŽIUKAI;8440187348;Taip;3;2;0;5
17409;Žirmūnėliai;EŽIUKAI;4565479092;Taip;4;0;0;4
17410;Žirmūnėliai;EŽIUKAI;4968278870;Taip;15;1;1;17
17411;Žirmūnėliai;EŽIUKAI;2693415717;Taip;9;5;0;14
17412;Žirmūnėliai;EŽIUKAI;7953019230;Taip;5;12;0;17
17413;Žirmūnėliai;EŽIUKAI;1832367936;Taip;1;7;0;8
17414;Žirmūnėliai;EŽIUKAI;9759491055;Taip;7;7;0;14
17415;Žirmūnėliai;EŽIUKAI;1127214387;Taip;12;0;0;12
17416;Žirmūnėliai;EŽIUKAI;4101748829;Taip;8;4;0;12
17417;Žirmūnėliai;EŽIUKAI;2379638934;Taip;0;9;0;9
17418;Žirmūnėliai;EŽIUKAI;4710829908;Taip;0;6;0;6
17419;Žirmūnėliai;EŽIUKAI;7996709950;Taip;0;5;0;5
17420;Žirmūnėliai;EŽIUKAI;7580002502;Taip;10;0;2;12
17421;Žirmūnėliai;EŽIUKAI;4638575301;Taip;0;1;0;1
17422;Žirmūnėliai;EŽIUKAI;1977798059;Taip;0;4;14;18
17423;Žirmūnėliai;EŽIUKAI;3458810185;Taip;4;2;0;6
17424;Žirmūnėliai;ŽVIRBLIUKAI;8627403283;Taip;0;2;1;3
17425;Žirmūnėliai;ŽVIRBLIUKAI;4218266688;Taip;5;0;0;5
17426;Žirmūnėliai;ŽVIRBLIUKAI;7020486370;Taip;0;6;0;6
17427;Žirmūnėliai;ŽVIRBLIUKAI;3449815783;Taip;3;4;0;7
17428;Žirmūnėliai;ŽVIRBLIUKAI;7892626521;Taip;0;6;0;6
17429;Žirmūnėliai;ŽVIRBLIUKAI;4778339658;Taip;0;5;0;5
17430;Žirmūnėliai;ŽVIRBLIUKAI;9541122034;Taip;14;1;0;15
17431;Žirmūnėliai;ŽVIRBLIUKAI;8209309240;Taip;0;9;0;9
17432;Žirmūnėliai;ŽVIRBLIUKAI;2837129621;Taip;0;3;0;3
17433;Žirmūnėliai;ŽVIRBLIUKAI;1273684243;Taip;0;0;1;1
17434;Žirmūnėliai;ŽVIRBLIUKAI;2971175236;Taip;0;4;0;4
17435;Žirmūnėliai;ŽVIRBLIUKAI;9154874729;Taip;3;1;0;4
17436;Žirmūnėliai;ŽVIRBLIUKAI;6594728970;Taip;8;0;0;8
17437;Žirmūnėliai;ŽVIRBLIUKAI;3795476732;Ne;0;1;0;1
17438;Žirmūnėliai;ŽVIRBLIUKAI;9732291476;Taip;3;0;1;4
17439;Žirmūnėliai;ŽVIRBLIUKAI;7087770068;Taip;5;6;0;11
17440;Žirmūnėliai;ŽVIRBLIUKAI;3431320961;Taip;7;0;0;7
17441;Žirmūnėliai;ŽVIRBLIUKAI;1571242696;Taip;3;0;0;3
17442;Žirmūnėliai;ŽVIRBLIUKAI;3766779594;Taip;0;1;0;1
17443;Žirmūnėliai;SPALVELĖS;6259368139;Taip;5;1;0;6
17444;Žirmūnėliai;SPALVELĖS;6934204209;Taip;6;0;0;6
17445;Žirmūnėliai;SPALVELĖS;9306935083;Taip;11;0;0;11
17446;Žirmūnėliai;SPALVELĖS;6817236579;Taip;0;8;0;8
17447;Žirmūnėliai;SPALVELĖS;9042509512;Taip;14;0;0;14
17448;Žirmūnėliai;SPALVELĖS;5076712824;Taip;8;1;0;9
17449;Žirmūnėliai;SPALVELĖS;8444883234;Ne;4;6;0;10
17450;Žirmūnėliai;SPALVELĖS;3977279181;Taip;0;3;0;3
17451;Žirmūnėliai;SPALVELĖS;8002655555;Taip;5;13;0;18
17452;Žirmūnėliai;SPALVELĖS;1116572386;Taip;9;0;0;9
17453;Žirmūnėliai;SPALVELĖS;1255294064;Taip;9;1;0;10
17454;Žirmūnėliai;SPALVELĖS;3520677404;Taip;12;5;0;17
17455;Žirmūnėliai;SPALVELĖS;5646794795;Taip;3;0;1;4
17456;Žirmūnėliai;SPALVELĖS;7589155099;Taip;0;6;0;6
17457;Žirmūnėliai;SPALVELĖS;5901940160;Taip;3;0;2;5
17458;Žirmūnėliai;SPALVELĖS;4641264260;Taip;11;0;0;11
17459;Žirmūnėliai;SPALVELĖS;9858198555;Taip;13;1;0;14
17460;Žirmūnėliai;SPALVELĖS;6523502376;Taip;4;6;0;10
17461;Žirmūnėliai;DEBESĖLIAI;6908512961;Taip;5;8;0;13
17462;Žirmūnėliai;DEBESĖLIAI;4347548125;Taip;21;0;0;21
17463;Žirmūnėliai;DEBESĖLIAI;3330603362;Taip;13;4;0;17
17464;Žirmūnėliai;DEBESĖLIAI;5440814849;Taip;3;4;0;7
17465;Žirmūnėliai;DEBESĖLIAI;8136265008;Taip;0;19;0;19
17466;Žirmūnėliai;DEBESĖLIAI;9813507899;Taip;6;0;3;9
17467;Žirmūnėliai;DEBESĖLIAI;8687642039;Taip;10;0;0;10
17468;Žirmūnėliai;DEBESĖLIAI;5982848146;Taip;4;2;0;6
17469;Žirmūnėliai;DEBESĖLIAI;5676730437;Taip;6;0;0;6
17470;Žirmūnėliai;DEBESĖLIAI;4653124134;Taip;7;0;0;7
17471;Žirmūnėliai;DEBESĖLIAI;4501490189;Ne;4;0;2;6
17472;Žirmūnėliai;DEBESĖLIAI;8239982682;Taip;0;0;1;1
17473;Žirmūnėliai;DEBESĖLIAI;6066212109;Taip;3;0;0;3
17474;Žirmūnėliai;DEBESĖLIAI;9759504463;Taip;4;0;0;4
17475;Žirmūnėliai;DEBESĖLIAI;3641319043;Taip;0;3;0;3
17476;Žirmūnėliai;DEBESĖLIAI;5622319185;Taip;0;4;1;5
17477;Žirmūnėliai;DEBESĖLIAI;7053321410;Taip;23;0;0;23
17478;Žirmūnėliai;DEBESĖLIAI;8615363279;Taip;0;3;0;3
17479;Žirmūnėliai;VIŠČIUKAI;9688789802;Taip;8;0;1;9
17480;Žirmūnėliai;VIŠČIUKAI;2898177059;Taip;1;4;0;5
17481;Žirmūnėliai;VIŠČIUKAI;1512873821;Taip;13;2;0;15
17482;Žirmūnėliai;VIŠČIUKAI;5659912057;Taip;7;2;1;10
17483;Žirmūnėliai;VIŠČIUKAI;4019091254;Taip;5;0;0;5
17484;Žirmūnėliai;VIŠČIUKAI;3144841534;Taip;11;2;0;13
17485;Žirmūnėliai;VIŠČIUKAI;6640314231;Taip;11;0;1;12
17486;Žirmūnėliai;VIŠČIUKAI;7421097025;Taip;7;0;0;7
17487;Žirmūnėliai;VIŠČIUKAI;7287108760;Taip;7;0;0;7
17488;Žirmūnėliai;VIŠČIUKAI;2353478333;Taip;8;0;0;8
17489;Žirmūnėliai;VIŠČIUKAI;4260032711;Taip;10;0;0;10
17490;Žirmūnėliai;VIŠČIUKAI;2821518346;Taip;5;0;0;5
17491;Žirmūnėliai;ZUIKUČIŲ;2074215403;Taip;17;1;0;18
17492;Žirmūnėliai;ZUIKUČIŲ;5981759291;Taip;0;6;0;6
17493;Žirmūnėliai;ZUIKUČIŲ;6122934687;Taip;4;0;0;4
17494;Žirmūnėliai;ZUIKUČIŲ;3560820710;Taip;17;0;0;17
17495;Žirmūnėliai;ZUIKUČIŲ;1582955541;Taip;0;1;0;1
17496;Žirmūnėliai;ZUIKUČIŲ;5772120262;Ne;0;0;18;18
17497;Žirmūnėliai;ZUIKUČIŲ;9448915252;Taip;19;0;0;19
17498;Žirmūnėliai;ZUIKUČIŲ;8526701525;Taip;13;0;0;13
17499;Žirmūnėliai;ZUIKUČIŲ;9953641492;Taip;11;1;0;12
17500;Žirmūnėliai;ZUIKUČIŲ;1498162175;Taip;8;1;0;9
17501;Žirmūnėliai;ZUIKUČIŲ;7232606752;Taip;2;0;0;2
17502;Žirmūnėliai;ZUIKUČIŲ;7771277342;Taip;12;0;1;13
17503;Žirmūnėliai;ZUIKUČIŲ;3825102173;Taip;6;0;0;6
17504;Žirmūnėliai;ZUIKUČIŲ;2069337771;Taip;0;0;20;20
17505;Žirmūnėliai;OBUOLIUKAI;4575123456;Taip;0;2;0;2
17506;Žirmūnėliai;OBUOLIUKAI;9002868728;Taip;0;3;3;6
17507;Žirmūnėliai;OBUOLIUKAI;2073922023;Taip;12;0;1;13
17508;Žirmūnėliai;OBUOLIUKAI;7059249540;Taip;13;0;0;13
17509;Žirmūnėliai;OBUOLIUKAI;4999561481;Taip;0;1;1;2
17510;Žirmūnėliai;OBUOLIUKAI;6358006462;Taip;5;0;0;5
17511;Žirmūnėliai;OBUOLIUKAI;2497258407;Taip;0;4;0;4
17512;Žirmūnėliai;OBUOLIUKAI;3949374730;Taip;3;0;0;3
17513;Žirmūnėliai;OBUOLIUKAI;6869102228;Taip;20;0;0;20
17514;Žirmūnėliai;OBUOLIUKAI;9367849317;Taip;0;1;0;1
17515;Žirmūnėliai;OBUOLIUKAI;9892620134;Taip;6;0;0;6
17516;Žirmūnėliai;OBUOLIUKAI;9225654910;Taip;0;2;0;2
17517;Žirmūnėliai;OBUOLIUKAI;5483418311;Taip;5;2;0;7
17518;Žirmūnėliai;OBUOLIUKAI;7945713337;Taip;0;9;0;9
17519;Žirmūnėliai;OBUOLIUKAI;8823426998;Taip;13;1;0;14
17520;Žirmūnėliai;OBUOLIUKAI;2263820829;Taip;9;0;3;12
17521;Žirmūnėliai;OBUOLIUKAI;9823124599;Taip;22;0;0;22
17522;Žirmūnėliai;OBUOLIUKAI;9682309860;Taip;0;4;2;6
17523;Žirmūnėliai;OBUOLIUKAI;9924145022;Taip;0;4;5;9
17524;Žirmūnėliai;DAINORĖLIAI;6397359786;Taip;0;0;3;3
17525;Žirmūnėliai;DAINORĖLIAI;3493835685;Taip;0;4;0;4
17526;Žirmūnėliai;DAINORĖLIAI;7113999217;Taip;0;0;3;3
17527;Žirmūnėliai;DAINORĖLIAI;9483005892;Taip;11;0;0;11
17528;Žirmūnėliai;DAINORĖLIAI;6736693899;Taip;5;0;0;5
17529;Žirmūnėliai;DAINORĖLIAI;6258830302;Taip;6;0;0;6
17530;Žirmūnėliai;DAINORĖLIAI;5977682064;Taip;23;0;0;23
17531;Žirmūnėliai;DAINORĖLIAI;1162986139;Taip;10;1;0;11
17532;Žirmūnėliai;DAINORĖLIAI;9220007612;Taip;0;0;1;1
17533;Žirmūnėliai;DAINORĖLIAI;2991492176;Taip;11;0;0;11
17534;Žirmūnėliai;DAINORĖLIAI;3319602277;Taip;5;1;0;6
17535;Žirmūnėliai;DAINORĖLIAI;5750554959;Taip;11;0;0;11
17536;Žirmūnėliai;DAINORĖLIAI;8512701905;Taip;3;0;0;3
17537;Žirmūnėliai;DAINORĖLIAI;6026141001;Taip;7;8;0;15
17538;"Dainorėliai (Ankštoji g. 11)";VARPELIAI;3094277796;Taip;0;0;1;1
17539;"Dainorėliai (Ankštoji g. 11)";VARPELIAI;2340411409;Taip;3;0;0;3
17540;"Dainorėliai (Ankštoji g. 11)";VARPELIAI;3205801143;Taip;3;0;0;3
17541;"Dainorėliai (Ankštoji g. 11)";VARPELIAI;6708318702;Taip;18;0;0;18
17542;"Dainorėliai (Ankštoji g. 11)";VARPELIAI;4812986408;Taip;0;2;0;2
17543;"Dainorėliai (Ankštoji g. 11)";VARPELIAI;1822342787;Taip;5;2;0;7
17544;"Dainorėliai (Ankštoji g. 11)";VARPELIAI;6652070415;Taip;6;0;0;6
17545;"Dainorėliai (Ankštoji g. 11)";VARPELIAI;5098256007;Taip;0;0;2;2
17546;"Dainorėliai (Ankštoji g. 11)";VARPELIAI;7476236758;Taip;12;0;0;12
17547;"Dainorėliai (Ankštoji g. 11)";VARPELIAI;4312828453;Taip;0;0;1;1
17548;"Dainorėliai (Ankštoji g. 11)";VARPELIAI;2732648440;Taip;23;0;0;23
17549;"Dainorėliai (Ankštoji g. 11)";VARPELIAI;1505858775;Taip;0;0;2;2
17550;"Dainorėliai (Ankštoji g. 11)";VARPELIAI;9612167901;Taip;14;0;0;14
17551;"Dainorėliai (Ankštoji g. 11)";VARPELIAI;6192380237;Taip;6;3;0;9
17552;"Dainorėliai (Ankštoji g. 11)";ŽIOGELIAI;5591598390;Taip;0;5;0;5
17553;"Dainorėliai (Ankštoji g. 11)";ŽIOGELIAI;8140354445;Taip;0;6;0;6
17554;"Dainorėliai (Ankštoji g. 11)";ŽIOGELIAI;2450726148;Taip;6;0;0;6
17555;"Dainorėliai (Ankštoji g. 11)";ŽIOGELIAI;5793828922;Taip;0;3;0;3
17556;"Dainorėliai (Ankštoji g. 11)";ŽIOGELIAI;7591953671;Taip;8;2;0;10
17557;"Dainorėliai (Ankštoji g. 11)";ŽIOGELIAI;2094849111;Taip;0;7;0;7
17558;"Dainorėliai (Ankštoji g. 11)";ŽIOGELIAI;3887433142;Taip;5;4;0;9
17559;"Dainorėliai (Ankštoji g. 11)";ŽIOGELIAI;2541781620;Taip;2;1;0;3
17560;"Dainorėliai (Ankštoji g. 11)";ŽIOGELIAI;8239000041;Taip;0;4;0;4
17561;"Dainorėliai (Ankštoji g. 11)";ŽIOGELIAI;7984447187;Taip;14;0;0;14
17562;"Dainorėliai (Ankštoji g. 11)";ŽIOGELIAI;5715129088;Taip;5;0;1;6
17563;"Dainorėliai (Ankštoji g. 11)";ŽIOGELIAI;9132532505;Taip;0;1;0;1
17564;"Dainorėliai (Ankštoji g. 11)";ŽIOGELIAI;4307634491;Taip;0;3;0;3
17565;"Dainorėliai (Ankštoji g. 11)";ŽIOGELIAI;5715129088;Taip;5;0;1;6
17566;"Dainorėliai (Ankštoji g. 11)";ŽIOGELIAI;9132532505;Taip;0;1;0;1
17567;"Dainorėliai (Ankštoji g. 11)";ŽIOGELIAI;4307634491;Taip;0;3;0;3
17568;"Dainorėliai (Ankštoji g. 11)";ŽIOGELIAI;4973241539;Taip;20;0;1;21
17569;"Dainorėliai (Ankštoji g. 11)";ŽIOGELIAI;8280877177;Taip;9;0;0;9
17570;"Dainorėliai (Ankštoji g. 11)";ŽIOGELIAI;2215481883;Taip;0;6;0;6
17571;"Dainorėliai (Ankštoji g. 11)";DRUGELIAI;6403389248;Taip;5;0;1;6
17572;"Dainorėliai (Ankštoji g. 11)";DRUGELIAI;4900234806;Taip;1;0;0;1
17573;"Dainorėliai (Ankštoji g. 11)";DRUGELIAI;2703267758;Taip;3;4;0;7
17574;"Dainorėliai (Ankštoji g. 11)";DRUGELIAI;6899629612;Taip;0;1;0;1
17575;"Dainorėliai (Ankštoji g. 11)";DRUGELIAI;2605119306;Taip;0;4;1;5
17576;"Dainorėliai (Ankštoji g. 11)";DRUGELIAI;9976869100;Taip;1;0;0;1
17577;"Dainorėliai (Ankštoji g. 11)";DRUGELIAI;3063825996;Taip;3;1;4;8
17578;"Dainorėliai (Ankštoji g. 11)";DRUGELIAI;5854379630;Taip;0;0;2;2
17579;"Dainorėliai (Ankštoji g. 11)";DRUGELIAI;3711954197;Taip;0;4;1;5
17580;"Dainorėliai (Ankštoji g. 11)";DRUGELIAI;3573324654;Taip;0;0;1;1
17581;"Dainorėliai (Ankštoji g. 11)";DRUGELIAI;8088948564;Taip;12;0;2;14
17582;"Dainorėliai (Ankštoji g. 11)";DRUGELIAI;2803571247;Taip;7;2;1;10
17583;"Dainorėliai (Ankštoji g. 11)";DRUGELIAI;5084474142;Taip;1;0;0;1
17584;"Dainorėliai (Ankštoji g. 11)";DRUGELIAI;1332165159;Taip;28;0;0;28
17585;"Dainorėliai (Ankštoji g. 11)";DRUGELIAI;8684975630;Taip;3;4;0;7
17586;"Dainorėliai (Ankštoji g. 11)";DRUGELIAI;2740773904;Taip;2;4;1;7
17587;"Dainorėliai (Ankštoji g. 11)";DRUGELIAI;9303046800;Taip;1;0;0;1
17588;"Dainorėliai (Ankštoji g. 11)";DRUGELIAI;9592384914;Taip;1;0;2;3
17589;"Dainorėliai (Ankštoji g. 11)";DRUGELIAI;3741337791;Taip;4;0;0;4
17590;"Dainorėliai (Ankštoji g. 11)";DRUGELIAI;7030974201;Taip;4;0;3;7
17591;"Dainorėliai (Ankštoji g. 11)";"1 klasė";88781762328;Taip;3;4;0;7
17592;"Dainorėliai (Ankštoji g. 11)";"1 klasė";5959380807;Taip;0;4;0;4
17593;"Dainorėliai (Ankštoji g. 11)";"1 klasė";7822546498;Taip;0;4;0;4
17594;"Dainorėliai (Ankštoji g. 11)";"1 klasė";4591161640;Taip;1;4;0;5
17595;"Dainorėliai (Ankštoji g. 11)";"1 klasė";9319771186;Taip;2;4;0;6
17596;"Dainorėliai (Ankštoji g. 11)";"1 klasė";6909583023;Taip;0;4;0;4
17597;"Dainorėliai (Ankštoji g. 11)";"1 klasė";9996171088;Taip;3;4;0;7
17598;"Dainorėliai (Ankštoji g. 11)";"1 klasė";6493730577;Taip;0;4;0;4
17599;"Dainorėliai (Ankštoji g. 11)";"1 klasė";7320625500;Taip;0;4;0;4
17600;"Dainorėliai (Ankštoji g. 11)";"1 klasė";7664689396;Taip;0;4;0;4
17601;"Dainorėliai (Ankštoji g. 11)";"1 klasė";2917508421;Taip;2;4;0;6
17602;"Dainorėliai (Ankštoji g. 11)";"1 klasė";2812688181;Taip;0;4;0;4
17603;"Dainorėliai (Ankštoji g. 11)";"1 klasė";18233813290;Taip;0;4;0;4
17604;"Dainorėliai (Ankštoji g. 11)";"1 klasė";2095914442;Taip;1;4;0;5
17605;"Dainorėliai (Ankštoji g. 11)";"1 klasė";4255893222;Taip;0;4;0;4
17606;"Dainorėliai (Ankštoji g. 11)";"1 klasė";1666616466;Taip;2;9;0;11
17607;"Dainorėliai (Ankštoji g. 11)";"1 klasė";1307749129;Taip;0;4;0;4
17608;"Dainorėliai (Ankštoji g. 11)";"1 klasė";1088248393;Taip;4;4;0;8
17609;"Dainorėliai (Ankštoji g. 11)";"1 klasė";2031800114;Taip;0;4;0;4
17610;"Dainorėliai (Ankštoji g. 11)";"1 klasė";43097490633;Taip;2;4;0;6
17611;"Dainorėliai (Ankštoji g. 11)";"1 klasė";65467351140;Taip;0;4;0;4
17612;"Dainorėliai (Ankštoji g. 11)";"1 klasė";87242570532;Taip;0;4;0;4
17613;"Dainorėliai (Ankštoji g. 11)";"1 klasė";5693385617;Taip;0;4;0;4
17614;"Dainorėliai (Ankštoji g. 11)";"1 klasė";9608529135;Taip;0;4;0;4
17615;"Dainorėliai (Ankštoji g. 11)";"1 klasė";68134437706;Ne;2;4;0;6
17616;"Dainorėliai (Ankštoji g. 11)";"1 klasė";3034686938;Taip;0;4;0;4
17617;"Dainorėliai (Ankštoji g. 11)";"2 klasė";2520667095;Taip;1;4;0;5
17618;"Dainorėliai (Ankštoji g. 11)";"2 klasė";1333499160;Taip;4;4;0;8
17619;"Dainorėliai (Ankštoji g. 11)";"2 klasė";50432354832;Taip;4;4;0;8
17620;"Dainorėliai (Ankštoji g. 11)";"2 klasė";1626877066;Taip;0;4;0;4
17621;"Dainorėliai (Ankštoji g. 11)";"2 klasė";1158895670;Taip;0;4;0;4
17622;"Dainorėliai (Ankštoji g. 11)";"2 klasė";73649870571;Taip;0;4;0;4
17623;"Dainorėliai (Ankštoji g. 11)";"2 klasė";1531362555;Ne;4;4;0;8
17624;"Dainorėliai (Ankštoji g. 11)";"2 klasė";19286303769;Taip;0;4;0;4
17625;"Dainorėliai (Ankštoji g. 11)";"2 klasė";73386013083;Taip;4;4;0;8
17626;"Dainorėliai (Ankštoji g. 11)";"2 klasė";27521381629;Taip;1;4;0;5
17627;"Dainorėliai (Ankštoji g. 11)";"2 klasė";53935690864;Taip;0;4;0;4
17628;"Dainorėliai (Ankštoji g. 11)";"2 klasė";2287353933;Taip;2;4;0;6
17629;"Dainorėliai (Ankštoji g. 11)";"2 klasė";1120848949;Taip;0;4;0;4
17630;"Dainorėliai (Ankštoji g. 11)";"2 klasė";36313982965;Taip;2;4;0;6
17631;"Dainorėliai (Ankštoji g. 11)";"2 klasė";86659723162;Taip;0;4;0;4
17632;"Dainorėliai (Ankštoji g. 11)";"2 klasė";6195426672;Taip;0;4;0;4
17633;"Dainorėliai (Ankštoji g. 11)";"2 klasė";5479496104;Taip;1;4;0;5
17634;"Dainorėliai (Ankštoji g. 11)";"2 klasė";94480397292;Taip;0;4;0;4
17635;"Dainorėliai (Ankštoji g. 11)";"2 klasė";6404337541;Taip;6;4;0;10
17636;"Dainorėliai (Ankštoji g. 11)";"2 klasė";49483881135;Taip;2;4;0;6
17637;"Dainorėliai (Ankštoji g. 11)";"2 klasė";86187568203;Taip;1;4;0;5
17638;"Dainorėliai (Ankštoji g. 11)";"2 klasė";1015870220;Ne;1;4;0;5
17639;"Dainorėliai (Ankštoji g. 11)";"2 klasė";1515552402;Taip;1;4;0;5
17640;"Dainorėliai (Ankštoji g. 11)";"2 klasė";7114409929;Taip;7;4;0;11
17641;"Dainorėliai (Ankštoji g. 11)";"2 klasė";1084400276;Taip;1;4;0;5
17642;"Dainorėliai (Ankštoji g. 11)";"3 klasė";67124516230;Ne;0;4;0;4
17643;"Dainorėliai (Ankštoji g. 11)";"3 klasė";7506194777;Taip;0;4;0;4
17644;"Dainorėliai (Ankštoji g. 11)";"3 klasė";1829858221;Taip;0;4;0;4
17645;"Dainorėliai (Ankštoji g. 11)";"3 klasė";1470784692;Taip;0;4;0;4
17646;"Dainorėliai (Ankštoji g. 11)";"3 klasė";7569146994;Taip;2;4;0;6
17647;"Dainorėliai (Ankštoji g. 11)";"3 klasė";45577031767;Taip;0;4;0;4
17648;"Dainorėliai (Ankštoji g. 11)";"3 klasė";1646521870;Taip;7;4;0;11
17649;"Dainorėliai (Ankštoji g. 11)";"3 klasė";29132059636;Taip;0;4;0;4
17650;"Dainorėliai (Ankštoji g. 11)";"3 klasė";32573583030;Taip;0;4;0;4
17651;"Dainorėliai (Ankštoji g. 11)";"3 klasė";97947842490;Taip;0;4;0;4
17652;"Dainorėliai (Ankštoji g. 11)";"3 klasė";63211091321;Taip;0;4;0;4
17653;"Dainorėliai (Ankštoji g. 11)";"3 klasė";87717571411;Taip;5;4;0;9
17654;"Dainorėliai (Ankštoji g. 11)";"3 klasė";18936645521;Ne;0;4;0;4
17655;"Dainorėliai (Ankštoji g. 11)";"3 klasė";80499999855;Taip;0;4;0;4
17656;"Dainorėliai (Ankštoji g. 11)";"3 klasė";6948863728;Taip;0;4;0;4
17657;"Dainorėliai (Ankštoji g. 11)";"3 klasė";2531690903;Taip;4;4;0;8
17658;"Dainorėliai (Ankštoji g. 11)";"3 klasė";35134511946;Taip;0;4;0;4
17659;"Dainorėliai (Ankštoji g. 11)";"3 klasė";1121139222;Taip;0;4;0;4
17660;"Dainorėliai (Ankštoji g. 11)";"3 klasė";99597416067;Taip;0;4;0;4
17661;"Dainorėliai (Ankštoji g. 11)";"3 klasė";77718940253;Taip;3;4;0;7
17662;"Dainorėliai (Ankštoji g. 11)";"3 klasė";5236797727;Taip;0;4;0;4
17663;"Dainorėliai (Ankštoji g. 11)";"3 klasė";33847164571;Taip;0;4;0;4
17664;"Dainorėliai (Ankštoji g. 11)";"4 klasė";49342277188;Taip;1;0;0;1
17665;"Dainorėliai (Ankštoji g. 11)";"4 klasė";98796240124;Taip;3;0;0;3
17666;"Dainorėliai (Ankštoji g. 11)";"4 klasė";2142553899;Taip;3;0;0;3
17667;"Dainorėliai (Ankštoji g. 11)";"4 klasė";37660372564;Taip;2;0;0;2
17668;"Dainorėliai (Ankštoji g. 11)";"4 klasė";37708779599;Taip;3;0;0;3
17669;"Dainorėliai (Ankštoji g. 11)";"4 klasė";47323045857;Taip;4;0;0;4
17670;"Dainorėliai (Ankštoji g. 11)";"4 klasė";69732047046;Taip;5;0;0;5
17671;"Dainorėliai (Ankštoji g. 11)";SAULUTĖS;9130473411;Taip;2;0;0;2
17672;"Dainorėliai (Ankštoji g. 11)";SAULUTĖS;8857018998;Taip;2;0;0;2
17673;"Dainorėliai (Ankštoji g. 11)";SAULUTĖS;4612995336;Ne;1;4;0;5
17674;"Dainorėliai (Ankštoji g. 11)";SAULUTĖS;6704354150;Taip;0;1;0;1
17675;"Dainorėliai (Ankštoji g. 11)";SAULUTĖS;5632663846;Taip;6;0;0;6
17676;"Dainorėliai (Ankštoji g. 11)";SAULUTĖS;1547686786;Taip;0;4;0;4
17677;"Dainorėliai (Ankštoji g. 11)";SAULUTĖS;6385439136;Taip;0;1;0;1
17678;"Dainorėliai (Ankštoji g. 11)";SAULUTĖS;1552829080;Taip;0;1;0;1
17679;"Dainorėliai (Ankštoji g. 11)";SAULUTĖS;5410183494;Taip;12;0;0;12
17680;"Dainorėliai (Ankštoji g. 11)";SAULUTĖS;5587907483;Taip;2;0;0;2
17681;"Dainorėliai (Ankštoji g. 11)";SAULUTĖS;2064843848;Taip;1;4;0;5
17682;"Dainorėliai (Ankštoji g. 11)";SAULUTĖS;5687390372;Taip;1;4;0;5
17683;"Dainorėliai (Ankštoji g. 11)";SAULUTĖS;7804441689;Taip;2;3;0;5
17684;"Dainorėliai (Ankštoji g. 11)";SAULUTĖS;6090746954;Taip;1;2;0;3
17685;"Dainorėliai (Ankštoji g. 11)";SAULUTĖS;4431804759;Taip;0;6;0;6
17686;"Dainorėliai (Ankštoji g. 11)";SAULUTĖS;3762178533;Taip;1;4;0;5
17687;"Dainorėliai (Ankštoji g. 11)";SAULUTĖS;4798415786;Taip;0;1;0;1
17688;"Dainorėliai (Ankštoji g. 11)";SAULUTĖS;4079711515;Taip;3;0;0;3
17689;"Dainorėliai (Ankštoji g. 11)";SAULUTĖS;4798415786;Taip;0;1;0;1
17690;"Dainorėliai (Ankštoji g. 11)";SAULUTĖS;4798415786;Taip;0;1;0;1
17691;Lokiukas;BITUTĖS;3397999534;Taip;0;1;0;1
17692;Lokiukas;BITUTĖS;4551069961;Taip;0;6;0;6
17693;Lokiukas;BITUTĖS;6260486656;Taip;0;6;0;6
17694;Lokiukas;BITUTĖS;9480025132;Taip;0;8;0;8
17695;Lokiukas;BITUTĖS;8334800302;Taip;4;0;0;4
17696;Lokiukas;BITUTĖS;6883994020;Taip;0;4;0;4
17697;Lokiukas;BITUTĖS;1987485885;Ne;0;0;1;1
17698;Lokiukas;BITUTĖS;5794303981;Taip;0;5;1;6
17699;Lokiukas;BITUTĖS;2671053309;Taip;0;11;0;11
17700;Lokiukas;BITUTĖS;8994257898;Taip;4;4;1;9
17701;Lokiukas;BITUTĖS;8378138411;Taip;0;1;0;1
17702;Lokiukas;BITUTĖS;8656751314;Taip;0;4;2;6
17703;Lokiukas;BITUTĖS;2181315008;Taip;3;2;0;5
17704;Lokiukas;BITUTĖS;3896883842;Taip;9;0;0;9
17705;Lokiukas;BITUTĖS;1376124245;Taip;0;23;0;23
17706;Lokiukas;BITUTĖS;7920238202;Taip;0;5;0;5
17707;Lokiukas;BITUTĖS;3329205450;Taip;3;4;1;8
17708;Lokiukas;BITUTĖS;6612382588;Ne;0;5;0;5
17709;Lokiukas;"1 B klasė";1210407640;Taip;1;4;0;5
17710;Lokiukas;"1 B klasė";1733486244;Taip;9;4;0;13
17711;Lokiukas;"1 B klasė";6336140882;Taip;0;4;0;4
17712;Lokiukas;"1 B klasė";3485639108;Taip;1;4;0;5
17713;Lokiukas;"1 B klasė";1606617694;Taip;0;4;0;4
17714;Lokiukas;"1 B klasė";8243342948;Taip;0;4;0;4
17715;Lokiukas;"1 B klasė";3991821717;Taip;5;4;0;9
17716;Lokiukas;"1 B klasė";4633366779;Taip;23;0;0;23
17717;Lokiukas;"1 B klasė";1188049956;Taip;0;4;0;4
17718;Lokiukas;"1 B klasė";5446430319;Taip;1;4;0;5
17719;Lokiukas;"1 B klasė";2354942164;Taip;5;4;0;9
17720;Lokiukas;"1 B klasė";35364823312;Taip;0;4;0;4
17721;Lokiukas;"1 B klasė";8687864179;Taip;0;4;0;4
17722;Lokiukas;"1 B klasė";5076773045;Taip;1;4;0;5
17723;Lokiukas;"1 B klasė";1620856143;Ne;3;4;0;7
17724;Lokiukas;"1 B klasė";1604886863;Ne;0;4;0;4
17725;Lokiukas;"1 B klasė";54341630847;Taip;0;4;0;4
17726;Lokiukas;"1 B klasė";8320696048;Taip;0;4;0;4
17727;Lokiukas;"1 B klasė";2701448160;Taip;23;0;0;23
17728;Lokiukas;"1 B klasė";4024866819;Taip;3;4;0;7
17729;Lokiukas;"1 B klasė";2753402906;Taip;0;4;0;4
17730;Lokiukas;"1 B klasė";5275588088;Taip;8;4;0;12
17731;Lokiukas;"1 B klasė";67972824332;Taip;0;4;0;4
17732;Lokiukas;"1 B klasė";9053427316;Taip;0;4;0;4
17733;Lokiukas;"1 B klasė";8189217660;Taip;6;4;0;10
17734;Lokiukas;"1 B klasė";3423529085;Taip;0;4;0;4
17735;Lokiukas;"1 A klasė";2642065594;Taip;1;4;0;5
17736;Lokiukas;"1 A klasė";1025576053;Taip;0;4;0;4
17737;Lokiukas;"1 A klasė";6069516217;Taip;2;4;0;6
17738;Lokiukas;"1 A klasė";34546519642;Taip;0;4;0;4
17739;Lokiukas;"1 A klasė";1752784666;Taip;0;4;0;4
17740;Lokiukas;"1 A klasė";7943213321;Taip;2;4;0;6
17741;Lokiukas;"1 A klasė";8915504279;Taip;0;4;0;4
17742;Lokiukas;"1 A klasė";8796640190;Taip;0;4;0;4
17743;Lokiukas;"1 A klasė";5943412920;Taip;2;4;0;6
17744;Lokiukas;"1 A klasė";3694653020;Taip;2;4;0;6
17745;Lokiukas;"1 A klasė";8902619265;Taip;0;4;0;4
17746;Lokiukas;"1 A klasė";1040288021;Taip;0;4;0;4
17747;Lokiukas;"1 A klasė";8286358519;Taip;4;4;0;8
17748;Lokiukas;"1 A klasė";3744484616;Taip;0;4;0;4
17749;Lokiukas;"1 A klasė";6758550653;Taip;14;4;0;18
17750;Lokiukas;"1 A klasė";5467387832;Taip;4;4;0;8
17751;Lokiukas;"1 A klasė";9336617879;Taip;0;4;0;4
17752;Lokiukas;"1 A klasė";1886540733;Taip;0;4;0;4
17753;Lokiukas;"1 A klasė";7936978436;Taip;0;4;0;4
17754;Lokiukas;"1 A klasė";3843999609;Taip;23;0;0;23
17755;Lokiukas;"1 A klasė";1898004894;Taip;2;4;0;6
17756;Lokiukas;"1 A klasė";2397366916;Taip;0;4;0;4
17757;Lokiukas;"1 A klasė";4985243068;Taip;1;4;0;5
17758;Lokiukas;"1 A klasė";7623203279;Taip;0;4;0;4
17759;Lokiukas;"1 A klasė";7623203279;Taip;0;4;0;4
17760;Lokiukas;GUDRUČIAI;3930463578;Taip;0;1;0;1
17761;Lokiukas;GUDRUČIAI;4919744559;Taip;7;4;0;11
17762;Lokiukas;GUDRUČIAI;1974049743;Taip;1;4;0;5
17763;Lokiukas;GUDRUČIAI;9354491312;Taip;8;4;0;12
17764;Lokiukas;GUDRUČIAI;6091878190;Taip;0;2;0;2
17765;Lokiukas;GUDRUČIAI;3826815202;Taip;0;1;0;1
17766;Lokiukas;GUDRUČIAI;7208757038;Taip;9;4;0;13
17767;Lokiukas;GUDRUČIAI;4660479216;Taip;3;0;0;3
17768;Lokiukas;GUDRUČIAI;1049009199;Taip;0;4;0;4
17769;Lokiukas;GUDRUČIAI;7904803011;Taip;3;4;0;7
17770;Lokiukas;GUDRUČIAI;8440973450;Taip;0;4;0;4
17771;Lokiukas;GUDRUČIAI;8481539433;Taip;0;4;0;4
17772;Lokiukas;GUDRUČIAI;3411390558;Taip;0;4;0;4
17773;Lokiukas;GUDRUČIAI;2185853339;Taip;0;3;0;3
17774;Lokiukas;GUDRUČIAI;5131051261;Taip;3;4;0;7
17775;Lokiukas;BORUŽĖLĖS;5473316050;Taip;0;4;0;4
17776;Lokiukas;BORUŽĖLĖS;2266747745;Taip;11;4;0;15
17777;Lokiukas;BORUŽĖLĖS;8758248334;Taip;5;4;0;9
17778;Lokiukas;BORUŽĖLĖS;9673257342;Taip;0;2;0;2
17779;Lokiukas;BORUŽĖLĖS;5893844708;Taip;0;4;0;4
17780;Lokiukas;BORUŽĖLĖS;3015119335;Taip;3;4;0;7
17781;Lokiukas;BORUŽĖLĖS;7509043689;Taip;7;4;0;11
17782;Lokiukas;BORUŽĖLĖS;4417116107;Taip;0;4;0;4
17783;Lokiukas;BORUŽĖLĖS;3849212461;Taip;11;4;0;15
17784;Lokiukas;BORUŽĖLĖS;3668903653;Taip;8;1;0;9
17785;Lokiukas;BORUŽĖLĖS;2466354050;Taip;0;4;0;4
17786;Lokiukas;BORUŽĖLĖS;6827710384;Taip;16;4;0;20
17787;Lokiukas;BORUŽĖLĖS;5843699073;Taip;17;4;0;21
17788;Lokiukas;BORUŽĖLĖS;7955048052;Taip;14;4;0;18
17789;Lokiukas;BORUŽĖLĖS;8144936688;Taip;11;4;0;15
17790;Lokiukas;BORUŽĖLĖS;2999594131;Taip;1;2;0;3
17791;Lokiukas;BORUŽĖLĖS;8420913680;Taip;16;4;0;20
17792;Lokiukas;BORUŽĖLĖS;8139809541;Taip;5;8;0;13
17793;Lokiukas;BORUŽĖLĖS;2754009962;Taip;4;0;0;4
17794;Lokiukas;BORUŽĖLĖS;5673557301;Taip;1;1;0;2
17795;Lokiukas;BORUŽĖLĖS;3383354228;Ne;8;4;0;12
17796;Lokiukas;ANČIUKAI;5944620142;Taip;0;1;0;1
17797;Lokiukas;ANČIUKAI;9253014845;Taip;6;1;0;7
17798;Lokiukas;ANČIUKAI;2323620627;Taip;6;1;0;7
17799;Lokiukas;ANČIUKAI;3452792650;Taip;7;6;0;13
17800;Lokiukas;ANČIUKAI;7147146400;Taip;0;4;0;4
17801;Lokiukas;ANČIUKAI;8311551538;Taip;10;4;0;14
17802;Lokiukas;ANČIUKAI;5837961451;Taip;0;4;0;4
17803;Lokiukas;ANČIUKAI;7991284293;Taip;0;23;0;23
17804;Lokiukas;ANČIUKAI;5503888257;Taip;4;0;0;4
17805;Lokiukas;ANČIUKAI;7195614260;Taip;4;4;0;8
17806;Lokiukas;ANČIUKAI;1243077419;Taip;2;8;0;10
17807;Lokiukas;ANČIUKAI;1027917827;Taip;0;33;0;33
17808;Lokiukas;ANČIUKAI;1741109639;Taip;0;23;0;23
17809;Lokiukas;ANČIUKAI;6944809045;Taip;0;8;0;8
17810;Lokiukas;KODĖLČIUKAI;8630112458;Taip;1;4;0;5
17811;Lokiukas;KODĖLČIUKAI;4585621105;Taip;0;1;0;1
17812;Lokiukas;KODĖLČIUKAI;8576418875;Taip;0;16;0;16
17813;Lokiukas;KODĖLČIUKAI;6869785650;Taip;0;7;0;7
17814;Lokiukas;KODĖLČIUKAI;4849031542;Taip;0;4;0;4
17815;Lokiukas;KODĖLČIUKAI;2625981190;Taip;3;3;0;6
17816;Lokiukas;KODĖLČIUKAI;4617372387;Taip;5;0;0;5
17817;Lokiukas;KODĖLČIUKAI;9798351980;Taip;0;2;0;2
17818;Lokiukas;KODĖLČIUKAI;1170293017;Taip;3;5;0;8
17819;Lokiukas;KODĖLČIUKAI;3876368364;Taip;0;4;0;4
17820;Lokiukas;KODĖLČIUKAI;7426579018;Taip;0;4;0;4
17821;Lokiukas;KODĖLČIUKAI;1724976098;Taip;7;3;1;11
17822;Lokiukas;KODĖLČIUKAI;3733581089;Taip;0;8;0;8
17823;Lokiukas;KODĖLČIUKAI;1076719080;Taip;10;5;0;15
17824;Lokiukas;KODĖLČIUKAI;6102196040;Taip;5;4;0;9
17825;Lokiukas;KODĖLČIUKAI;9779789133;Taip;5;4;0;9
17826;Lokiukas;KODĖLČIUKAI;6987657237;Taip;5;4;0;9
17827;Lokiukas;KODĖLČIUKAI;5353687011;Taip;5;3;0;8
17828;Lokiukas;DRUGELIAI;4858829710;Taip;4;0;0;4
17829;Lokiukas;DRUGELIAI;4206181176;Taip;0;1;0;1
17830;Lokiukas;DRUGELIAI;7532603655;Taip;0;1;0;1
17831;Lokiukas;DRUGELIAI;8596706753;Taip;0;7;0;7
17832;Lokiukas;DRUGELIAI;4197547631;Taip;0;2;0;2
17833;Lokiukas;DRUGELIAI;8266708371;Taip;2;6;1;9
17834;Lokiukas;DRUGELIAI;6226281752;Taip;0;4;0;4
17835;Lokiukas;DRUGELIAI;2374601283;Taip;4;5;0;9
17836;Lokiukas;DRUGELIAI;1390586527;Taip;0;2;4;6
17837;Lokiukas;DRUGELIAI;1341265560;Taip;0;6;0;6
17838;Lokiukas;DRUGELIAI;5131662172;Ne;0;0;2;2
17839;Lokiukas;DRUGELIAI;4284574166;Ne;0;0;2;2
17840;Lokiukas;DRUGELIAI;1913742619;Ne;5;4;0;9
17841;Lokiukas;DRUGELIAI;4521556853;Taip;0;1;0;1
17842;Lokiukas;DRUGELIAI;5092095494;Ne;0;4;3;7
17843;Lokiukas;"2 A klasė";1626698185;Taip;3;4;0;7
17844;Lokiukas;"2 A klasė";39222094073;Taip;0;4;0;4
17845;Lokiukas;"2 A klasė";69364831994;Ne;1;4;0;5
17846;Lokiukas;"2 A klasė";74169282323;Taip;0;4;0;4
17847;Lokiukas;"2 A klasė";1625137322;Taip;0;4;0;4
17848;Lokiukas;"2 A klasė";8452600632;Taip;18;0;0;18
17849;Lokiukas;"2 A klasė";35890122494;Taip;0;4;0;4
17850;Lokiukas;"2 A klasė";8270572748;Ne;0;4;0;4
17851;Lokiukas;"2 A klasė";2170176922;Ne;0;4;0;4
17852;Lokiukas;"2 A klasė";8455869600;Taip;0;4;0;4
17853;Lokiukas;"2 A klasė";34800098950;Taip;0;4;0;4
17854;Lokiukas;"2 A klasė";3825101647;Ne;23;0;0;23
17855;Lokiukas;"2 A klasė";8618280811;Taip;22;0;0;22
17856;Lokiukas;"2 A klasė";8323172347;Taip;0;4;0;4
17857;Lokiukas;"2 A klasė";7844351275;Taip;0;4;0;4
17858;Lokiukas;"2 A klasė";2045735700;Taip;0;4;0;4
17859;Lokiukas;"2 A klasė";3981653153;Ne;0;4;0;4
17860;Lokiukas;"2 A klasė";6318538591;Taip;0;4;0;4
17861;Lokiukas;"2 A klasė";43500434912;Taip;0;4;0;4
17862;Lokiukas;"2 A klasė";25141529581;Taip;5;4;0;9
17863;Lokiukas;"2 A klasė";3369746590;Taip;0;4;0;4
17864;Lokiukas;"2 A klasė";3004895246;Ne;21;0;0;21
17865;Lokiukas;"2 A klasė";3061816821;Ne;1;4;0;5
17866;Lokiukas;"2 A klasė";56069293343;Taip;0;4;0;4
17867;Lokiukas;"2 A klasė";4677444685;Taip;0;4;0;4
17868;Lokiukas;"2 B klasė";14605095801;Taip;1;4;0;5
17869;Lokiukas;"2 B klasė";39975872119;Taip;1;4;0;5
17870;Lokiukas;"2 B klasė";8568285232;Taip;7;4;0;11
17871;Lokiukas;"2 B klasė";5453470660;Taip;1;4;0;5
17872;Lokiukas;"2 B klasė";5879386524;Taip;1;4;0;5
17873;Lokiukas;"2 B klasė";7591418969;Taip;4;4;0;8
17874;Lokiukas;"2 B klasė";8036643654;Taip;1;4;0;5
17875;Lokiukas;"2 B klasė";2548712970;Taip;1;4;0;5
17876;Lokiukas;"2 B klasė";4427448272;Taip;23;0;0;23
17877;Lokiukas;"2 B klasė";4580716838;Taip;1;4;0;5
17878;Lokiukas;"2 B klasė";2673522432;Taip;23;0;0;23
17879;Lokiukas;"2 B klasė";8399364170;Taip;5;4;0;9
17880;Lokiukas;"2 B klasė";9625041533;Ne;2;4;0;6
17881;Lokiukas;"2 B klasė";2476231041;Ne;3;4;0;7
17882;Lokiukas;"2 B klasė";5943583254;Taip;1;4;0;5
17883;Lokiukas;"2 B klasė";5437008837;Taip;1;4;0;5
17884;Lokiukas;"2 B klasė";4569798381;Taip;23;0;0;23
17885;Lokiukas;"2 B klasė";97284171512;Taip;1;4;0;5
17886;Lokiukas;"2 B klasė";3070998871;Taip;1;4;0;5
17887;Lokiukas;"2 B klasė";9501202273;Taip;1;4;0;5
17888;Lokiukas;"2 B klasė";20659573470;Taip;23;0;0;23
17889;Lokiukas;"2 B klasė";8943496964;Ne;23;0;0;23
17890;Lokiukas;"2 B klasė";3505492809;Taip;1;4;0;5
17891;Lokiukas;"3 A klasė";83086633109;Taip;1;4;0;5
17892;Lokiukas;"3 A klasė";131300206;Taip;1;4;0;5
17893;Lokiukas;"3 A klasė";82025637099;Taip;12;4;0;16
17894;Lokiukas;"3 A klasė";73515179103;Taip;2;4;0;6
17895;Lokiukas;"3 A klasė";73696992182;Taip;1;4;0;5
17896;Lokiukas;"3 A klasė";8240261104;Taip;1;4;0;5
17897;Lokiukas;"3 A klasė";83528495608;Taip;2;4;0;6
17898;Lokiukas;"3 A klasė";8846527481;Taip;2;4;0;6
17899;Lokiukas;"3 A klasė";67133709394;Taip;1;4;0;5
17900;Lokiukas;"3 A klasė";66528256040;Taip;1;4;0;5
17901;Lokiukas;"3 A klasė";36677665098;Taip;1;4;0;5
17902;Lokiukas;"3 A klasė";1056075876;Taip;1;4;0;5
17903;Lokiukas;"3 A klasė";52940830874;Taip;2;4;0;6
17904;Lokiukas;"3 A klasė";1201125655;Taip;2;4;0;6
17905;Lokiukas;"3 A klasė";38884246104;Taip;2;4;0;6
17906;Lokiukas;"3 A klasė";2502465398;Taip;2;4;0;6
17907;Lokiukas;"3 A klasė";9890308887;Taip;2;4;0;6
17908;Lokiukas;"3 A klasė";77512682081;Taip;2;4;0;6
17909;Lokiukas;"3 A klasė";86120193313;Taip;1;4;0;5
17910;Lokiukas;"3 A klasė";45028887854;Taip;1;4;0;5
17911;Lokiukas;"3 A klasė";51237034253;Taip;2;4;0;6
17912;Lokiukas;"3 A klasė";27403835292;Taip;5;4;0;9
17913;Lokiukas;"3 A klasė";4989577303;Taip;6;4;0;10
17914;Lokiukas;"3 A klasė";1106442860;Taip;2;4;0;6
17915;Lokiukas;"3 B klasė";61807094999;Ne;1;4;0;5
17916;Lokiukas;"3 B klasė";51059574159;Taip;23;0;0;23
17917;Lokiukas;"3 B klasė";32714964224;Taip;1;4;0;5
17918;Lokiukas;"3 B klasė";8920359311;Taip;1;4;0;5
17919;Lokiukas;"3 B klasė";2959877846;Taip;23;0;0;23
17920;Lokiukas;"3 B klasė";57505829630;Taip;0;4;0;4
17921;Lokiukas;"3 B klasė";1072148409;Taip;6;4;0;10
17922;Lokiukas;"3 B klasė";7130407913;Taip;7;4;0;11
17923;Lokiukas;"3 B klasė";7235277422;Taip;23;0;0;23
17924;Lokiukas;"3 B klasė";1133294157;Taip;1;4;0;5
17925;Lokiukas;"3 B klasė";7334971595;Taip;0;4;0;4
17926;Lokiukas;"3 B klasė";92373834478;Ne;9;4;0;13
17927;Lokiukas;"3 B klasė";2054450461;Taip;1;4;0;5
17928;Lokiukas;"3 B klasė";14234831040;Taip;3;4;0;7
17929;Lokiukas;"3 B klasė";4662981914;Taip;2;4;0;6
17930;Lokiukas;"3 B klasė";6414861823;Taip;11;0;0;11
17931;Lokiukas;"3 B klasė";98045145204;Taip;23;0;0;23
17932;Lokiukas;"3 B klasė";68390568000;Taip;8;4;0;12
17933;Lokiukas;"3 B klasė";14937983736;Taip;1;4;0;5
17934;Lokiukas;"3 B klasė";8996622650;Taip;1;4;0;5
17935;Lokiukas;"3 B klasė";2078673522;Taip;0;4;0;4
17936;Lokiukas;"3 B klasė";40006848965;Taip;1;4;0;5
17937;Lokiukas;"3 B klasė";3255141230;Taip;1;4;0;5
17938;Lokiukas;"3 B klasė";3255141230;Taip;1;4;0;5
17939;Lokiukas;"3 B klasė";8980902068;Taip;1;4;0;5
17940;Lokiukas;"3 B klasė";4164426360;Taip;1;4;0;5
17941;Lokiukas;"3 B klasė";38001876942;Taip;2;4;0;6
17942;Lokiukas;"4 A klasė";15406362908;Taip;1;4;0;5
17943;Lokiukas;"4 A klasė";45122233067;Taip;0;4;0;4
17944;Lokiukas;"4 A klasė";10948160841;Taip;23;0;0;23
17945;Lokiukas;"4 A klasė";21802863853;Taip;0;4;0;4
17946;Lokiukas;"4 A klasė";22979689191;Taip;2;4;0;6
17947;Lokiukas;"4 A klasė";80754592972;Taip;7;4;0;11
17948;Lokiukas;"4 A klasė";14903100496;Taip;0;4;0;4
17949;Lokiukas;"4 A klasė";4608275224;Taip;2;4;0;6
17950;Lokiukas;"4 A klasė";99706061553;Taip;2;4;0;6
17951;Lokiukas;"4 A klasė";7785940412;Taip;0;4;0;4
17952;Lokiukas;"4 A klasė";72092394330;Taip;0;4;0;4
17953;Lokiukas;"4 A klasė";35769782473;Taip;23;0;0;23
17954;Lokiukas;"4 A klasė";38531751377;Taip;5;4;0;9
17955;Lokiukas;"4 A klasė";59840033826;Taip;1;4;0;5
17956;Lokiukas;"4 A klasė";80793623068;Ne;3;4;0;7
17957;Lokiukas;"4 A klasė";43070670534;Taip;0;4;0;4
17958;Lokiukas;"4 A klasė";5198408183;Taip;7;4;0;11
17959;Lokiukas;"4 A klasė";24099693663;Taip;23;0;0;23
17960;Lokiukas;"4 A klasė";9747265775;Taip;23;0;0;23
17961;Lokiukas;"4 A klasė";93374754851;Taip;23;0;0;23
17962;Lokiukas;"4 A klasė";25170045140;Taip;23;0;0;23
17963;Lokiukas;"4 A klasė";84273668685;Taip;0;4;0;4
17964;Lokiukas;"4 A klasė";15685936471;Taip;0;4;0;4
17965;Lokiukas;"4 A klasė";97609897018;Taip;2;4;0;6
17966;Lokiukas;"4 A klasė";23688235312;Taip;3;4;0;7
17967;Lokiukas;"4 A klasė";15574258138;Taip;0;4;0;4
17968;Lokiukas;"4 A klasė";9077016953;Taip;0;4;0;4
17969;Lokiukas;"4 A klasė";24523198513;Taip;23;0;0;23
17970;Lokiukas;"4 A klasė";29577495646;Taip;0;4;0;4
17971;Lokiukas;"4 B klasė";32506466236;Taip;10;4;0;14
17972;Lokiukas;"4 B klasė";7324496782;Taip;4;4;0;8
17973;Lokiukas;"4 B klasė";10811780420;Taip;5;4;0;9
17974;Lokiukas;"4 B klasė";28796727185;Taip;23;0;0;23
17975;Lokiukas;"4 B klasė";88415635113;Taip;11;4;0;15
17976;Lokiukas;"4 B klasė";95910336503;Taip;3;4;0;7
17977;Lokiukas;"4 B klasė";7903535850;Taip;6;4;0;10
17978;Lokiukas;"4 B klasė";7497324442;Taip;23;0;0;23
17979;Lokiukas;"4 B klasė";96046361641;Taip;0;4;0;4
17980;Lokiukas;"4 B klasė";18646642032;Taip;1;4;0;5
17981;Lokiukas;"4 B klasė";79109699217;Taip;0;4;0;4
17982;Lokiukas;"4 B klasė";61890775725;Taip;11;4;0;15
17983;Lokiukas;"4 B klasė";24221829774;Taip;4;4;0;8
17984;Lokiukas;"4 B klasė";58513885211;Taip;4;4;0;8
17985;Lokiukas;"4 B klasė";50713289266;Taip;23;0;0;23
17986;Lokiukas;"4 B klasė";20231469825;Taip;5;4;0;9
17987;Lokiukas;"4 B klasė";1146878499;Taip;1;4;0;5
17988;Lokiukas;"4 B klasė";46587243900;Taip;1;4;0;5
17989;Lokiukas;"4 B klasė";9141446821;Taip;4;4;0;8
17990;Lokiukas;"4 B klasė";75507005694;Taip;8;4;0;12
17991;Lokiukas;"4 B klasė";73426072972;Taip;15;4;0;19
17992;Lokiukas;"4 B klasė";59913848400;Taip;5;4;0;9
17993;Lokiukas;"4 B klasė";62268017779;Taip;2;4;0;6
17994;Lokiukas;"4 B klasė";2105377652;Taip;0;4;0;4
17995;Lokiukas;"4 B klasė";39867459515;Taip;8;4;0;12
17996;Lokiukas;"4 B klasė";5311341721;Taip;19;4;0;23
17997;Lokiukas;"4 B klasė";9516336072;Ne;4;4;0;8
17998;Šaltinėlis;Ančiukų;3901200729;Taip;9;4;0;13
17999;Šaltinėlis;Ančiukų;1312785137;Taip;6;1;0;7
18000;Šaltinėlis;Ančiukų;9209105445;Taip;9;3;0;12
18001;Šaltinėlis;Ančiukų;9112527921;Taip;5;4;0;9
18002;Šaltinėlis;Ančiukų;9398488555;Taip;0;2;0;2
18003;Šaltinėlis;Ančiukų;2027779524;Taip;10;4;0;14
18004;Šaltinėlis;Ančiukų;5498764523;Taip;13;0;0;13
18005;Šaltinėlis;Ančiukų;4226929875;Taip;6;4;0;10
18006;Šaltinėlis;Ančiukų;5005394548;Taip;13;6;0;19
18007;Šaltinėlis;Ančiukų;1102861619;Taip;6;0;0;6
18008;Šaltinėlis;Ančiukų;1928794692;Taip;0;1;0;1
18009;Šaltinėlis;Ančiukų;1742421427;Taip;4;0;0;4
18010;Šaltinėlis;Ančiukų;9581384663;Taip;10;4;0;14
18011;Šaltinėlis;Ančiukų;9465174636;Taip;10;4;0;14
18012;Šaltinėlis;Ančiukų;8034195267;Taip;7;0;0;7
18013;Šaltinėlis;Ančiukų;5455997139;Taip;0;5;0;5
18014;Šaltinėlis;Ančiukų;9588260206;Taip;13;1;0;14
18015;Šaltinėlis;Ančiukų;8116985061;Ne;0;23;0;23
18016;Šaltinėlis;Ančiukų;6371994202;Taip;0;5;0;5
18017;Šaltinėlis;Ančiukų;6244924079;Taip;11;0;0;11
18018;Šaltinėlis;Ančiukų;3806267811;Taip;3;0;0;3
18019;Šaltinėlis;Bitučių;7311831014;Taip;0;7;0;7
18020;Šaltinėlis;Bitučių;5854723120;Taip;0;8;0;8
18021;Šaltinėlis;Bitučių;1678450741;Taip;9;3;0;12
18022;Šaltinėlis;Bitučių;5833136956;Taip;0;5;0;5
18023;Šaltinėlis;Bitučių;3483756240;Taip;4;4;0;8
18024;Šaltinėlis;Bitučių;6380346298;Taip;0;4;0;4
18025;Šaltinėlis;Bitučių;5799032398;Taip;0;12;0;12
18026;Šaltinėlis;Bitučių;5525740049;Taip;10;4;0;14
18027;Šaltinėlis;Bitučių;5343279219;Taip;6;4;0;10
18028;Šaltinėlis;Bitučių;3507180650;Taip;10;4;0;14
18029;Šaltinėlis;Bitučių;7118672118;Taip;8;0;0;8
18030;Šaltinėlis;Bitučių;8950694484;Taip;0;5;0;5
18031;Šaltinėlis;Bitučių;2465009553;Taip;0;5;0;5
18032;Šaltinėlis;Bitučių;5382567842;Taip;0;4;0;4
18033;Šaltinėlis;Bitučių;4681460322;Taip;0;6;0;6
18034;Šaltinėlis;Bitučių;3968514430;Taip;0;2;0;2
18035;Šaltinėlis;Bitučių;6721510313;Taip;0;4;0;4
18036;Šaltinėlis;Bitučių;1978469605;Ne;0;9;0;9
18037;Šaltinėlis;Bitučių;5774391181;Ne;5;2;0;7
18038;Šaltinėlis;Bitučių;2499890317;Taip;15;3;0;18
18039;Šaltinėlis;Bitučių;7650840990;Taip;12;5;0;17
18040;Šaltinėlis;Bitučių;5345738219;Taip;9;4;0;13
18041;Šaltinėlis;Bitučių;3579974049;Taip;5;14;0;19
18042;Šaltinėlis;Bitučių;4743907195;Taip;8;2;0;10
18043;Šaltinėlis;Bitučių;1287205292;Taip;0;0;1;1
18044;Šaltinėlis;Bitučių;7973137015;Taip;0;9;0;9
18045;Šaltinėlis;Bitučių;7519967594;Taip;10;4;0;14
18046;Šaltinėlis;Bitučių;3017437426;Taip;5;4;0;9
18047;Šaltinėlis;Bitučių;9983153464;Taip;0;8;0;8
18048;Šaltinėlis;Saulutės;3159555258;Taip;14;5;0;19
18049;Šaltinėlis;Saulutės;9753396159;Taip;13;0;0;13
18050;Šaltinėlis;Saulutės;6774300104;Taip;23;0;0;23
18051;Šaltinėlis;Saulutės;8258039377;Taip;10;4;0;14
18052;Šaltinėlis;Saulutės;2550355455;Taip;0;2;0;2
18053;Šaltinėlis;Saulutės;5871681602;Taip;14;4;0;18
18054;Šaltinėlis;Saulutės;3448242910;Taip;0;4;0;4
18055;Šaltinėlis;Saulutės;8147526528;Taip;0;5;0;5
18056;Šaltinėlis;Saulutės;6109197821;Taip;4;0;0;4
18057;Šaltinėlis;Saulutės;8439306703;Taip;15;0;0;15
18058;Šaltinėlis;Saulutės;3505001330;Taip;10;1;0;11
18059;Šaltinėlis;Saulutės;8973369897;Taip;0;4;0;4
18060;Šaltinėlis;Saulutės;6145605567;Taip;12;3;0;15
18061;Šaltinėlis;Saulutės;3780870805;Taip;0;8;0;8
18062;Šaltinėlis;Saulutės;2157520281;Taip;0;5;0;5
18063;Šaltinėlis;Saulutės;8995954572;Taip;10;4;0;14
18064;Šaltinėlis;Saulutės;5996579651;Taip;4;4;0;8
18065;Šaltinėlis;Saulutės;9613234759;Taip;9;6;0;15
18066;Šaltinėlis;Saulutės;9218436977;Taip;16;3;0;19
18067;Šaltinėlis;Meškiukų;6915625306;Taip;12;0;0;12
18068;Šaltinėlis;Meškiukų;6645807642;Taip;8;0;0;8
18069;Šaltinėlis;Meškiukų;9759912102;Ne;0;3;0;3
18070;Šaltinėlis;Meškiukų;4664741207;Taip;4;1;0;5
18071;Šaltinėlis;Meškiukų;1400918201;Ne;10;4;0;14
18072;Šaltinėlis;Meškiukų;1656674673;Taip;9;0;0;9
18073;Šaltinėlis;Meškiukų;4248763165;Taip;0;7;0;7
18074;Šaltinėlis;Meškiukų;5982018366;Taip;12;0;0;12
18075;Šaltinėlis;Meškiukų;9922223978;Taip;15;0;0;15
18076;Šaltinėlis;Meškiukų;8995077908;Taip;0;3;0;3
18077;Šaltinėlis;Meškiukų;5982188743;Ne;7;0;0;7
18078;Šaltinėlis;Meškiukų;6586783795;Taip;8;4;0;12
18079;Šaltinėlis;Meškiukų;7468640592;Taip;13;1;0;14
18080;Šaltinėlis;Meškiukų;4064231806;Taip;6;4;0;10
18081;Šaltinėlis;Meškiukų;6688536661;Taip;10;1;0;11
18082;Šaltinėlis;Meškiukų;8880659539;Taip;3;3;0;6
18083;Šaltinėlis;Meškiukų;3228788999;Taip;7;0;0;7
18084;Šaltinėlis;Meškiukų;5905345563;Taip;12;0;0;12
18085;Šaltinėlis;Meškiukų;2332065937;Taip;11;0;0;11
18086;Šaltinėlis;Meškiukų;4936982698;Taip;6;0;0;6
18087;Šaltinėlis;Nykštukai;9766640995;Ne;18;0;0;18
18088;Šaltinėlis;Nykštukai;3356138058;Taip;8;4;0;12
18089;Šaltinėlis;Nykštukai;5434349511;Taip;23;0;0;23
18090;Šaltinėlis;Nykštukai;4226068669;Taip;8;2;0;10
18091;Šaltinėlis;Nykštukai;2976773344;Ne;8;5;0;13
18092;Šaltinėlis;Nykštukai;3687243030;Taip;5;7;0;12
18093;Šaltinėlis;Nykštukai;4364256563;Taip;5;4;0;9
18094;Šaltinėlis;Nykštukai;9333013048;Taip;4;0;1;5
18095;Šaltinėlis;Nykštukai;4029616063;Taip;11;4;0;15
18096;Šaltinėlis;Nykštukai;6530797082;Taip;6;0;0;6
18097;Šaltinėlis;Nykštukai;7534585887;Taip;14;0;0;14
18098;Šaltinėlis;Nykštukai;8977029692;Taip;0;7;0;7
18099;Šaltinėlis;Nykštukai;7120592596;Taip;0;4;0;4
18100;Šaltinėlis;Nykštukai;3497881408;Ne;0;10;0;10
18101;Šaltinėlis;Nykštukai;6383844995;Taip;19;0;0;19
18102;Šaltinėlis;Nykštukai;1441937630;Taip;6;0;1;7
18103;Šaltinėlis;Nykštukai;4742849747;Taip;5;4;1;10
18104;Šaltinėlis;Nykštukai;2353630084;Taip;0;3;0;3
18105;Šaltinėlis;Nykštukai;5593692486;Taip;15;0;1;16
18106;Šaltinėlis;Nykštukai;1496105338;Taip;0;0;4;4
18107;Šaltinėlis;Nykštukai;7432957835;Taip;6;0;0;6
18108;Šaltinėlis;Perliukų;2825412170;Taip;6;4;0;10
18109;Šaltinėlis;Perliukų;1686009371;Taip;9;4;0;13
18110;Šaltinėlis;Perliukų;9075507649;Taip;11;0;0;11
18111;Šaltinėlis;Perliukų;7068058767;Taip;14;0;0;14
18112;Šaltinėlis;Perliukų;2189112609;Taip;11;0;0;11
18113;Šaltinėlis;Perliukų;8914777163;Taip;1;13;0;14
18114;Šaltinėlis;Perliukų;7387221265;Taip;6;1;0;7
18115;Šaltinėlis;Perliukų;9674923143;Taip;13;0;0;13
18116;Šaltinėlis;Perliukų;3073692882;Taip;13;0;0;13
18117;Šaltinėlis;Perliukų;5325974488;Taip;12;3;0;15
18118;Šaltinėlis;Perliukų;2022956307;Ne;6;0;0;6
18119;Šaltinėlis;Perliukų;2126751248;Taip;17;0;0;17
18120;Šaltinėlis;Perliukų;3271931810;Taip;17;0;0;17
18121;Šaltinėlis;Perliukų;7955094634;Taip;5;0;0;5
18122;Šaltinėlis;Perliukų;1445108285;Taip;5;5;0;10
18123;Šaltinėlis;Perliukų;7133044918;Taip;16;0;0;16
18124;Šaltinėlis;Perliukų;2806453623;Taip;1;4;0;5
18125;Šaltinėlis;Perliukų;9691993251;Taip;0;4;0;4
18126;Šaltinėlis;Perliukų;8695191968;Taip;2;4;0;6
18127;Šaltinėlis;Perliukų;4430546695;Taip;16;0;0;16
18128;Šaltinėlis;BORUŽĖLĖS;2222188915;Taip;12;0;0;12
18129;Šaltinėlis;BORUŽĖLĖS;8289348049;Taip;29;0;0;29
18130;Šaltinėlis;BORUŽĖLĖS;1012869495;Taip;19;0;0;19
18131;Šaltinėlis;BORUŽĖLĖS;7007255432;Taip;11;3;0;14
18132;Šaltinėlis;BORUŽĖLĖS;7074953363;Taip;8;0;0;8
18133;Šaltinėlis;BORUŽĖLĖS;1283839856;Taip;0;4;0;4
18134;Šaltinėlis;BORUŽĖLĖS;4754031495;Taip;2;0;0;2
18135;Šaltinėlis;BORUŽĖLĖS;8806353914;Ne;4;2;0;6
18136;Šaltinėlis;BORUŽĖLĖS;5943247739;Taip;20;0;0;20
18137;Šaltinėlis;BORUŽĖLĖS;9258088219;Taip;11;0;0;11
18138;Šaltinėlis;BORUŽĖLĖS;8979939577;Taip;0;5;0;5
18139;Šaltinėlis;BORUŽĖLĖS;2053262491;Taip;13;0;0;13
18140;Šaltinėlis;BORUŽĖLĖS;2856977335;Taip;3;0;0;3
18141;Šaltinėlis;BORUŽĖLĖS;6553155860;Ne;19;0;0;19
18142;Šaltinėlis;"4B klasė";93256161233;Taip;0;4;0;4
18143;Šaltinėlis;"4B klasė";83173349544;Taip;0;5;0;5
18144;Šaltinėlis;"4B klasė";39088869084;Taip;0;7;0;7
18145;Šaltinėlis;"4B klasė";1422035829;Taip;0;4;0;4
18146;Šaltinėlis;"4B klasė";7711903999;Ne;0;9;0;9
18147;Šaltinėlis;"4B klasė";95542489944;Taip;0;4;0;4
18148;Šaltinėlis;"4B klasė";3072314714;Taip;0;5;0;5
18149;Šaltinėlis;"4B klasė";1220687492;Taip;0;4;0;4
18150;Šaltinėlis;"4B klasė";74337710550;Taip;0;4;0;4
18151;Šaltinėlis;"4B klasė";35401075864;Taip;0;4;0;4
18152;Šaltinėlis;"4B klasė";19630605543;Taip;0;16;0;16
18153;Šaltinėlis;"4B klasė";84522552145;Taip;0;4;0;4
18154;Šaltinėlis;"4B klasė";3626545396;Ne;0;7;0;7
18155;Šaltinėlis;"4B klasė";6317111400;Taip;0;4;0;4
18156;Šaltinėlis;"4B klasė";4762756751;Ne;0;4;0;4
18157;Šaltinėlis;"4B klasė";72372808270;Taip;0;4;0;4
18158;Šaltinėlis;"4B klasė";1924418657;Taip;0;10;0;10
18159;Šaltinėlis;"4B klasė";77194317310;Taip;0;4;0;4
18160;Šaltinėlis;"4B klasė";57847832778;Taip;0;8;0;8
18161;Šaltinėlis;"4B klasė";2099800744;Taip;0;4;0;4
18162;Šaltinėlis;"4B klasė";70315400705;Taip;0;8;0;8
18163;Šaltinėlis;"4B klasė";81082410620;Taip;0;6;0;6
18164;Šaltinėlis;1A;6487378225;Taip;0;8;0;8
18165;Šaltinėlis;1A;56396772538;Taip;0;4;0;4
18166;Šaltinėlis;1A;5251390843;Taip;0;5;0;5
18167;Šaltinėlis;1A;8500790262;Taip;0;4;0;4
18168;Šaltinėlis;1A;4332884673;Taip;0;6;0;6
18169;Šaltinėlis;1A;3493429067;Taip;0;4;0;4
18170;Šaltinėlis;1A;9362495172;Taip;0;4;0;4
18171;Šaltinėlis;1A;6462738640;Taip;0;9;0;9
18172;Šaltinėlis;1A;77872075694;Taip;0;4;0;4
18173;Šaltinėlis;1A;7133143923;Taip;0;11;0;11
18174;Šaltinėlis;1A;6887838949;Taip;0;23;0;23
18175;Šaltinėlis;1A;1543331408;Taip;0;4;0;4
18176;Šaltinėlis;1A;2630875135;Taip;0;9;0;9
18177;Šaltinėlis;1A;9218883174;Taip;0;4;0;4
18178;Šaltinėlis;1A;2973820849;Taip;0;4;0;4
18179;Šaltinėlis;1A;7737797979;Taip;0;4;0;4
18180;Šaltinėlis;1A;9820788524;Taip;0;23;0;23
18181;Šaltinėlis;1A;2646901307;Taip;0;9;0;9
18182;Šaltinėlis;1A;9274165569;Taip;0;4;0;4
18183;Šaltinėlis;1A;3691635011;Taip;0;4;0;4
18184;Šaltinėlis;1A;2084451705;Taip;0;9;0;9
18185;Šaltinėlis;"2A klasė";1580090516;Taip;0;4;0;4
18186;Šaltinėlis;"2A klasė";2034838765;Taip;0;4;0;4
18187;Šaltinėlis;"2A klasė";2105963102;Taip;0;4;0;4
18188;Šaltinėlis;"2A klasė";3582666579;Taip;0;4;0;4
18189;Šaltinėlis;"2A klasė";46569341613;Taip;0;4;0;4
18190;Šaltinėlis;"2A klasė";2801321116;Taip;0;4;0;4
18191;Šaltinėlis;"2A klasė";1091056386;Taip;0;4;0;4
18192;Šaltinėlis;"2A klasė";52142182972;Taip;0;23;0;23
18193;Šaltinėlis;"2A klasė";6880337593;Ne;0;4;0;4
18194;Šaltinėlis;"2A klasė";9188065549;Ne;12;3;0;15
18195;Šaltinėlis;"2A klasė";9305706589;Taip;0;4;0;4
18196;Šaltinėlis;"2A klasė";3516760367;Taip;0;4;0;4
18197;Šaltinėlis;"2A klasė";56542341895;Ne;0;4;0;4
18198;Šaltinėlis;"2A klasė";5077603802;Taip;0;7;0;7
18199;Šaltinėlis;"2A klasė";1910670134;Taip;0;4;0;4
18200;Šaltinėlis;"2A klasė";9595350871;Ne;0;9;0;9
18201;Šaltinėlis;"2A klasė";15925823621;Taip;0;4;0;4
18202;Šaltinėlis;"2A klasė";8902634958;Taip;0;5;0;5
18203;Šaltinėlis;"2A klasė";9757246434;Taip;0;13;0;13
18204;Šaltinėlis;"2A klasė";7262120071;Ne;0;4;0;4
18205;Šaltinėlis;"2A klasė";1004445904;Taip;0;4;0;4
18206;Šaltinėlis;"2B klasė";84494627465;Taip;0;7;0;7
18207;Šaltinėlis;"2B klasė";2146141461;Taip;0;4;0;4
18208;Šaltinėlis;"2B klasė";6068980312;Taip;0;6;0;6
18209;Šaltinėlis;"2B klasė";9425353041;Taip;0;4;0;4
18210;Šaltinėlis;"2B klasė";17147527171;Taip;0;23;0;23
18211;Šaltinėlis;"2B klasė";1716801722;Taip;0;10;0;10
18212;Šaltinėlis;"2B klasė";2333071711;Taip;0;5;0;5
18213;Šaltinėlis;"2B klasė";23301579810;Taip;0;23;0;23
18214;Šaltinėlis;"2B klasė";526307704;Taip;0;6;0;6
18215;Šaltinėlis;"2B klasė";1958647188;Taip;0;10;0;10
18216;Šaltinėlis;"2B klasė";1583520894;Taip;0;12;0;12
18217;Šaltinėlis;"2B klasė";11083638216;Taip;0;4;0;4
18218;Šaltinėlis;"2B klasė";1023238509;Taip;0;5;0;5
18219;Šaltinėlis;"3A klasė";32264290873;Taip;0;6;0;6
18220;Šaltinėlis;"3A klasė";1767635282;Taip;0;16;0;16
18221;Šaltinėlis;"3A klasė";1390316465;Taip;0;5;0;5
18222;Šaltinėlis;"3A klasė";5442943843;Taip;0;4;0;4
18223;Šaltinėlis;"3A klasė";6764006747;Taip;0;4;0;4
18224;Šaltinėlis;"3A klasė";1658370782;Taip;0;4;0;4
18225;Šaltinėlis;"3A klasė";10918276041;Taip;0;11;0;11
18226;Šaltinėlis;"3A klasė";3455754351;Taip;0;23;0;23
18227;Šaltinėlis;"3A klasė";66575684640;Taip;0;4;0;4
18228;Šaltinėlis;"3A klasė";86592374576;Taip;0;23;0;23
18229;Šaltinėlis;"3A klasė";13808708760;Taip;0;4;0;4
18230;Šaltinėlis;"3A klasė";1614411921;Ne;0;6;0;6
18231;Šaltinėlis;"3A klasė";79406746980;Taip;0;6;0;6
18232;Šaltinėlis;"3A klasė";3577137327;Taip;0;4;0;4
18233;Šaltinėlis;"3A klasė";1224027643;Taip;0;6;0;6
18234;Šaltinėlis;"3A klasė";48525545812;Taip;0;4;0;4
18235;Šaltinėlis;"3A klasė";3022926855;Taip;0;4;0;4
18236;Šaltinėlis;"3A klasė";1190394855;Taip;0;4;0;4
18237;Šaltinėlis;"3A klasė";40186714037;Taip;0;4;0;4
18238;Šaltinėlis;"3A klasė";1456486363;Taip;0;5;0;5
18239;Šaltinėlis;"3A klasė";32949623652;Taip;0;7;0;7
18240;Šaltinėlis;"4A klasė";14213856824;Taip;0;4;0;4
18241;Šaltinėlis;"4A klasė";80649337160;Taip;0;4;0;4
18242;Šaltinėlis;"4A klasė";92958012146;Taip;0;5;0;5
18243;Šaltinėlis;"4A klasė";84656960510;Taip;0;23;0;23
18244;Šaltinėlis;"4A klasė";83621946293;Taip;0;23;0;23
18245;Šaltinėlis;"4A klasė";67808618878;Ne;0;23;0;23
18246;Šaltinėlis;"4A klasė";1278910777;Taip;0;4;0;4
18247;Šaltinėlis;"4A klasė";9647785988;Taip;0;5;0;5
18248;Šaltinėlis;"4A klasė";82671662416;Taip;0;4;0;4
18249;Šaltinėlis;"4A klasė";54025577281;Taip;0;4;0;4
18250;Šaltinėlis;"4A klasė";488285764;Taip;0;8;0;8
18251;Šaltinėlis;"4A klasė";29482180151;Taip;0;4;0;4
18252;Šaltinėlis;"4A klasė";54753218491;Taip;0;4;0;4
18253;Šaltinėlis;"4A klasė";86029472773;Taip;0;4;0;4
18254;Šaltinėlis;"4A klasė";64821172553;Taip;0;5;0;5
18255;Šaltinėlis;"4A klasė";5744976843;Taip;0;5;0;5
18256;Šaltinėlis;"4A klasė";25459069972;Ne;0;4;0;4
18257;Šaltinėlis;"4A klasė";6669392157;Taip;0;4;0;4
18258;Šaltinėlis;"4A klasė";89358384113;Taip;0;14;0;14
18259;Šaltinėlis;"4A klasė";28956971978;Taip;0;4;0;4
18260;Šaltinėlis;"4A klasė";4050444191;Taip;0;9;0;9
18261;Šaltinėlis;"4A klasė";89093437170;Taip;0;5;0;5
18262;Šaltinėlis;"4A klasė";51872331010;Taip;0;4;0;4
18263;Šaltinėlis;1B;7723290276;Taip;0;5;0;5
18264;Šaltinėlis;1B;3660687688;Taip;0;8;0;8
18265;Šaltinėlis;1B;1348724947;Taip;0;23;0;23
18266;Šaltinėlis;1B;2230403251;Ne;0;6;0;6
18267;Šaltinėlis;1B;4387568448;Taip;0;6;0;6
18268;Šaltinėlis;1B;2658414287;Taip;0;10;0;10
18269;Šaltinėlis;1B;7918995181;Taip;0;7;0;7
18270;Šaltinėlis;1B;3638565578;Taip;0;7;0;7
18271;Šaltinėlis;1B;1367082230;Taip;0;9;0;9
18272;Šaltinėlis;1B;5869977541;Ne;0;14;0;14
18273;Šaltinėlis;1B;5099997904;Taip;0;4;0;4
18274;Šaltinėlis;1B;8721116918;Taip;0;6;0;6
18275;Šaltinėlis;1B;3609939325;Ne;0;4;0;4
18276;Šaltinėlis;1B;7211267255;Taip;0;5;0;5
18277;Šaltinėlis;1B;9108653045;Taip;0;6;0;6
18278;Šaltinėlis;1B;6816346946;Taip;0;6;0;6
18279;Šaltinėlis;1B;5495098615;Ne;0;5;0;5
18280;Šaltinėlis;1B;9762392403;Taip;0;5;0;5
18281;Gabijėlė;GANDRIUKŲ;4498088417;Taip;0;3;1;4
18282;Gabijėlė;GANDRIUKŲ;2277489032;Ne;0;0;3;3
18283;Gabijėlė;GANDRIUKŲ;8994076883;Ne;0;0;3;3
18284;Gabijėlė;GANDRIUKŲ;7087892822;Taip;8;0;0;8
18285;Gabijėlė;GANDRIUKŲ;5057272847;Taip;7;0;0;7
18286;Gabijėlė;GANDRIUKŲ;3532989398;Taip;1;3;0;4
18287;Gabijėlė;GANDRIUKŲ;2215880644;Taip;4;6;1;11
18288;Gabijėlė;GANDRIUKŲ;3799003783;Taip;8;4;0;12
18289;Gabijėlė;GANDRIUKŲ;5513530983;Taip;0;2;0;2
18290;Gabijėlė;GANDRIUKŲ;6004026516;Taip;0;8;0;8
18291;Gabijėlė;GANDRIUKŲ;4634029418;Taip;0;5;0;5
18292;Gabijėlė;GANDRIUKŲ;9706026832;Taip;8;2;0;10
18293;Gabijėlė;GANDRIUKŲ;2491503656;Taip;0;4;0;4
18294;Gabijėlė;GANDRIUKŲ;8904768332;Taip;0;1;3;4
18295;Gabijėlė;GANDRIUKŲ;8572833698;Taip;0;1;0;1
18296;Gabijėlė;GANDRIUKŲ;5054419205;Taip;11;2;0;13
18297;Gabijėlė;GANDRIUKŲ;9929652398;Taip;0;4;0;4
18298;Gabijėlė;GANDRIUKŲ;7530976246;Taip;5;0;1;6
18299;Gabijėlė;GANDRIUKŲ;3920525584;Taip;0;0;2;2
18300;Gabijėlė;GANDRIUKŲ;2682112101;Taip;0;3;0;3
18301;Gabijėlė;GANDRIUKŲ;5312189552;Taip;0;4;0;4
18302;Gabijėlė;LAKŠTINGALIUKŲ;7019425859;Taip;3;5;0;8
18303;Gabijėlė;LAKŠTINGALIUKŲ;1611004144;Ne;0;1;0;1
18304;Gabijėlė;LAKŠTINGALIUKŲ;5862882027;Taip;0;4;0;4
18305;Gabijėlė;LAKŠTINGALIUKŲ;8798786098;Taip;0;4;0;4
18306;Gabijėlė;LAKŠTINGALIUKŲ;8035360208;Taip;0;4;0;4
18307;Gabijėlė;LAKŠTINGALIUKŲ;2384469423;Taip;10;0;0;10
18308;Gabijėlė;LAKŠTINGALIUKŲ;8167646385;Taip;6;0;0;6
18309;Gabijėlė;LAKŠTINGALIUKŲ;8926268619;Taip;9;0;0;9
18310;Gabijėlė;LAKŠTINGALIUKŲ;9480021589;Taip;0;4;0;4
18311;Gabijėlė;LAKŠTINGALIUKŲ;3215569531;Taip;2;1;0;3
18312;Gabijėlė;LAKŠTINGALIUKŲ;5992403900;Taip;4;0;0;4
18313;Gabijėlė;LAKŠTINGALIUKŲ;9116943443;Taip;10;1;0;11
18314;Gabijėlė;LAKŠTINGALIUKŲ;8383489040;Taip;0;9;0;9
18315;Gabijėlė;LAKŠTINGALIUKŲ;6927730664;Taip;19;0;0;19
18316;Gabijėlė;LAKŠTINGALIUKŲ;7444385669;Taip;2;0;0;2
18317;Gabijėlė;LAKŠTINGALIUKŲ;9398722388;Taip;0;8;0;8
18318;Gabijėlė;LAKŠTINGALIUKŲ;9491327802;Taip;0;0;1;1
18319;Gabijėlė;LAKŠTINGALIUKŲ;2550300871;Taip;0;10;0;10
18320;Gabijėlė;LAKŠTINGALIUKŲ;9324498850;Taip;3;6;0;9
18321;Gabijėlė;LAKŠTINGALIUKŲ;8314088016;Taip;5;0;0;5
18322;Gabijėlė;LAKŠTINGALIUKŲ;6295299651;Taip;7;0;0;7
18323;Gabijėlė;LAKŠTINGALIUKŲ;9694544564;Taip;0;0;4;4
18324;Gabijėlė;ŽVIRBLIUKŲ;7043775905;Taip;3;3;0;6
18325;Gabijėlė;ŽVIRBLIUKŲ;4475530177;Taip;6;1;0;7
18326;Gabijėlė;ŽVIRBLIUKŲ;5743861607;Taip;0;4;0;4
18327;Gabijėlė;ŽVIRBLIUKŲ;7410541320;Taip;0;7;0;7
18328;Gabijėlė;ŽVIRBLIUKŲ;4493192224;Taip;0;1;0;1
18329;Gabijėlė;ŽVIRBLIUKŲ;9259964641;Taip;5;1;0;6
18330;Gabijėlė;ŽVIRBLIUKŲ;3268231136;Taip;0;6;0;6
18331;Gabijėlė;ŽVIRBLIUKŲ;5332825339;Taip;0;1;4;5
18332;Gabijėlė;ŽVIRBLIUKŲ;2264669298;Taip;0;1;0;1
18333;Gabijėlė;ŽVIRBLIUKŲ;5942625633;Taip;0;1;1;2
18334;Gabijėlė;ŽVIRBLIUKŲ;3155403180;Taip;9;4;0;13
18335;Gabijėlė;ŽVIRBLIUKŲ;1158461185;Taip;9;4;0;13
18336;Gabijėlė;ŽVIRBLIUKŲ;3218415151;Taip;0;5;5;10
18337;Gabijėlė;ŽVIRBLIUKŲ;8823299212;Taip;0;4;0;4
18338;Gabijėlė;ŽVIRBLIUKŲ;8879972953;Taip;4;3;2;9
18339;Gabijėlė;ŽVIRBLIUKŲ;9627906252;Taip;0;2;0;2
18340;Gabijėlė;ŽVIRBLIUKŲ;1725665169;Taip;1;1;0;2
18341;Gabijėlė;ŽVIRBLIUKŲ;6674038058;Taip;0;5;1;6
18342;Gabijėlė;ŽVIRBLIUKŲ;4146051969;Taip;4;3;0;7
18343;Gabijėlė;ŽVIRBLIUKŲ;6604681536;Taip;6;1;0;7
18344;Gabijėlė;ŽVIRBLIUKŲ;1273722177;Taip;4;1;1;6
18345;Gabijėlė;ŽVIRBLIUKŲ;6310234092;Taip;4;4;0;8
18346;Gabijėlė;ŽVIRBLIUKŲ;6154378055;Taip;5;4;0;9
18347;Gabijėlė;ŽVIRBLIUKŲ;9259673720;Taip;5;2;0;7
18348;Gabijėlė;ŽVIRBLIUKŲ;8292463617;Taip;0;4;0;4
18349;Gabijėlė;GENIUKŲ;4827797140;Taip;0;4;0;4
18350;Gabijėlė;GENIUKŲ;6931780900;Taip;8;0;0;8
18351;Gabijėlė;GENIUKŲ;2030555139;Taip;0;8;0;8
18352;Gabijėlė;GENIUKŲ;4908791060;Taip;1;4;0;5
18353;Gabijėlė;GENIUKŲ;7261932151;Taip;1;0;0;1
18354;Gabijėlė;GENIUKŲ;6923511443;Taip;15;0;0;15
18355;Gabijėlė;GENIUKŲ;8384795164;Taip;1;4;0;5
18356;Gabijėlė;GENIUKŲ;3209491491;Taip;8;0;0;8
18357;Gabijėlė;GENIUKŲ;8185042446;Taip;2;0;0;2
18358;Gabijėlė;GENIUKŲ;9413654318;Taip;6;0;0;6
18359;Gabijėlė;GENIUKŲ;5297866989;Taip;6;0;0;6
18360;Gabijėlė;GENIUKŲ;4664011011;Taip;19;0;0;19
18361;Gabijėlė;GENIUKŲ;4490619514;Taip;14;0;0;14
18362;Gabijėlė;GENIUKŲ;1021920133;Taip;10;0;0;10
18363;Gabijėlė;GENIUKŲ;1345747441;Taip;6;0;0;6
18364;Gabijėlė;GENIUKŲ;7597037953;Taip;4;0;0;4
18365;Gabijėlė;GENIUKŲ;6469409776;Taip;10;0;0;10
18366;Gabijėlė;GENIUKŲ;6539078572;Taip;0;2;0;2
18367;Gabijėlė;GENIUKŲ;7509112343;Taip;4;0;1;5
18368;Gabijėlė;DAGILIUKŲ;9348393550;Taip;0;4;0;4
18369;Gabijėlė;DAGILIUKŲ;4264925447;Taip;0;4;0;4
18370;Gabijėlė;DAGILIUKŲ;9494313873;Taip;2;2;0;4
18371;Gabijėlė;DAGILIUKŲ;9783343968;Taip;6;2;0;8
18372;Gabijėlė;DAGILIUKŲ;3017939983;Taip;0;1;0;1
18373;Gabijėlė;DAGILIUKŲ;9503639471;Taip;0;0;1;1
18374;Gabijėlė;DAGILIUKŲ;1988597157;Taip;5;1;1;7
18375;Gabijėlė;DAGILIUKŲ;9895518740;Taip;19;4;0;23
18376;Gabijėlė;DAGILIUKŲ;9449023766;Taip;0;6;0;6
18377;Gabijėlė;DAGILIUKŲ;1286688629;Ne;6;2;0;8
18378;Gabijėlė;DAGILIUKŲ;1455856766;Ne;5;4;1;10
18379;Gabijėlė;DAGILIUKŲ;6438144206;Taip;6;4;3;13
18380;Gabijėlė;DAGILIUKŲ;8662914262;Taip;0;10;0;10
18381;Gabijėlė;DAGILIUKŲ;9280283478;Taip;4;3;0;7
18382;Gabijėlė;DAGILIUKŲ;2254104149;Taip;0;3;0;3
18383;Gabijėlė;DAGILIUKŲ;2386980295;Taip;0;3;1;4
18384;Gabijėlė;DAGILIUKŲ;9581539166;Taip;8;4;3;15
18385;Gabijėlė;DAGILIUKŲ;3548399391;Taip;2;4;2;8
18386;Gabijėlė;DAGILIUKŲ;4328252445;Taip;0;3;0;3
18387;Gabijėlė;DAGILIUKŲ;9893869150;Taip;0;1;0;1
18388;Gabijėlė;PELEDŽIUKŲ;4170105224;Taip;0;2;1;3
18389;Gabijėlė;PELEDŽIUKŲ;5675574534;Taip;7;0;0;7
18390;Gabijėlė;PELEDŽIUKŲ;5163460269;Taip;0;0;1;1
18391;Gabijėlė;PELEDŽIUKŲ;9451897367;Taip;11;0;0;11
18392;Gabijėlė;PELEDŽIUKŲ;1583034900;Taip;0;0;1;1
18393;Gabijėlė;PELEDŽIUKŲ;2128428173;Taip;5;0;2;7
18394;Gabijėlė;PELEDŽIUKŲ;7028670164;Ne;0;0;1;1
18395;Gabijėlė;PELEDŽIUKŲ;5481472116;Taip;2;0;0;2
18396;Gabijėlė;PELEDŽIUKŲ;2885913045;Taip;0;1;0;1
18397;Gabijėlė;PELEDŽIUKŲ;5869580147;Taip;0;4;2;6
18398;Gabijėlė;PELEDŽIUKŲ;7096789623;Taip;4;0;2;6
18399;Gabijėlė;PELEDŽIUKŲ;4724322463;Taip;0;5;0;5
18400;Gabijėlė;PELEDŽIUKŲ;1810898809;Taip;8;0;1;9
18401;Gabijėlė;PELEDŽIUKŲ;5801792404;Taip;11;12;0;23
18402;Gabijėlė;PELEDŽIUKŲ;5579070948;Taip;0;7;3;10
18403;Gabijėlė;PELEDŽIUKŲ;8549800358;Taip;16;0;0;16
18404;Gabijėlė;PELEDŽIUKŲ;8088806507;Taip;0;2;0;2
18405;Gabijėlė;PELEDŽIUKŲ;6728495961;Taip;12;0;1;13
18406;Gabijėlė;KREGZDŽIUKŲ;1759118326;Taip;0;12;0;12
18407;Gabijėlė;KREGZDŽIUKŲ;9533325351;Taip;0;12;0;12
18408;Gabijėlė;KREGZDŽIUKŲ;5407565441;Taip;4;0;3;7
18409;Gabijėlė;KREGZDŽIUKŲ;6845038692;Taip;0;2;0;2
18410;Gabijėlė;KREGZDŽIUKŲ;2357515455;Taip;3;0;1;4
18411;Gabijėlė;KREGZDŽIUKŲ;1574272380;Taip;9;4;0;13
18412;Gabijėlė;KREGZDŽIUKŲ;9675186834;Taip;11;0;0;11
18413;Gabijėlė;KREGZDŽIUKŲ;2634722171;Taip;4;8;0;12
18414;Gabijėlė;KREGZDŽIUKŲ;4317708029;Taip;0;6;0;6
18415;Gabijėlė;KREGZDŽIUKŲ;8555272917;Taip;0;6;0;6
18416;Gabijėlė;KREGZDŽIUKŲ;1142939183;Taip;0;2;0;2
18417;Gabijėlė;KREGZDŽIUKŲ;9676186208;Taip;0;2;0;2
18418;Gabijėlė;KREGZDŽIUKŲ;3584692524;Taip;0;4;0;4
18419;Gabijėlė;KREGZDŽIUKŲ;8613821848;Taip;14;0;0;14
18420;Gabijėlė;KREGZDŽIUKŲ;7038167942;Taip;0;6;0;6
18421;Gabijėlė;KREGZDŽIUKŲ;6570702235;Taip;0;0;3;3
18422;Gabijėlė;KREGZDŽIUKŲ;9528783892;Taip;0;12;0;12
18423;Gabijėlė;KREGZDŽIUKŲ;9030890792;Taip;15;0;0;15
18424;Gabijėlė;KREGZDŽIUKŲ;3031333199;Taip;12;0;0;12
18425;Gabijėlė;KREGZDŽIUKŲ;9116153981;Taip;0;3;0;3
18426;Gabijėlė;KREGZDŽIUKŲ;4575230225;Taip;3;14;0;17
18427;Gabijėlė;ZYLIUKŲ;7700700293;Taip;0;4;4;8
18428;Gabijėlė;ZYLIUKŲ;6759447513;Taip;0;11;0;11
18429;Gabijėlė;ZYLIUKŲ;1090635644;Taip;12;0;1;13
18430;Gabijėlė;ZYLIUKŲ;2764185879;Taip;5;4;1;10
18431;Gabijėlė;ZYLIUKŲ;6463161337;Taip;10;0;1;11
18432;Gabijėlė;ZYLIUKŲ;6562965816;Taip;1;0;0;1
18433;Gabijėlė;ZYLIUKŲ;4376486874;Taip;5;0;0;5
18434;Gabijėlė;ZYLIUKŲ;7047606048;Taip;0;4;1;5
18435;Gabijėlė;ZYLIUKŲ;6983092888;Taip;0;1;0;1
18436;Gabijėlė;ZYLIUKŲ;2727329238;Taip;0;0;1;1
18437;Gabijėlė;ZYLIUKŲ;8362509831;Taip;6;0;0;6
18438;Gabijėlė;ZYLIUKŲ;4907669556;Taip;4;2;0;6
18439;Gabijėlė;ZYLIUKŲ;1947898190;Taip;0;13;0;13
18440;Gabijėlė;ZYLIUKŲ;2384174631;Taip;3;0;3;6
18441;Gabijėlė;ZYLIUKŲ;3181607628;Taip;5;0;0;5
18442;Gabijėlė;ZYLIUKŲ;5736012194;Taip;9;0;0;9
18443;Gabijėlė;ZYLIUKŲ;4712780337;Taip;3;2;0;5
18444;Gabijėlė;ZYLIUKŲ;7180444215;Taip;9;4;4;17
18445;Gabijėlė;ZYLIUKŲ;6446842432;Taip;1;0;0;1
18446;Gabijėlė;VOLUNGĖLIŲ;2099510027;Taip;13;2;0;15
18447;Gabijėlė;VOLUNGĖLIŲ;6842537434;Taip;0;9;0;9
18448;Gabijėlė;VOLUNGĖLIŲ;2227816651;Taip;0;1;0;1
18449;Gabijėlė;VOLUNGĖLIŲ;6956030813;Taip;11;0;0;11
18450;Gabijėlė;VOLUNGĖLIŲ;3902737481;Taip;0;4;0;4
18451;Gabijėlė;VOLUNGĖLIŲ;8733551230;Taip;10;1;0;11
18452;Gabijėlė;VOLUNGĖLIŲ;3763595874;Taip;8;0;0;8
18453;Gabijėlė;VOLUNGĖLIŲ;5360985745;Taip;5;0;0;5
18454;Gabijėlė;VOLUNGĖLIŲ;4580305437;Taip;4;5;0;9
18455;Gabijėlė;VOLUNGĖLIŲ;5737066080;Taip;10;0;0;10
18456;Gabijėlė;VOLUNGĖLIŲ;5972136800;Taip;5;0;0;5
18457;Gabijėlė;VOLUNGĖLIŲ;6643563560;Taip;0;9;0;9
18458;Gabijėlė;VOLUNGĖLIŲ;8312753333;Taip;0;7;0;7
18459;Gabijėlė;VOLUNGĖLIŲ;2523400466;Taip;6;0;0;6
18460;Gabijėlė;VOLUNGĖLIŲ;8569742033;Taip;4;2;0;6
18461;Gabijėlė;VOLUNGĖLIŲ;8327903800;Taip;12;0;0;12
18462;Gabijėlė;VOLUNGĖLIŲ;6960725029;Taip;12;0;0;12
18463;Gabijėlė;VOLUNGĖLIŲ;3098846537;Taip;5;3;0;8
18464;Gabijėlė;VOLUNGĖLIŲ;3995459990;Taip;0;3;0;3
18465;Gabijėlė;VOLUNGĖLIŲ;3267339129;Taip;4;0;0;4
18466;Gabijėlė;VOLUNGĖLIŲ;4304012457;Taip;2;0;0;2
18467;Gabijėlė;VOLUNGĖLIŲ;3324631994;Taip;1;0;0;1
18468;Gabijėlė;ANČIUKŲ;2107898976;Taip;0;10;0;10
18469;Gabijėlė;ANČIUKŲ;2831569080;Taip;5;4;0;9
18470;Gabijėlė;ANČIUKŲ;7178485867;Taip;0;3;0;3
18471;Gabijėlė;ANČIUKŲ;4000838897;Ne;13;0;0;13
18472;Gabijėlė;ANČIUKŲ;5060265729;Taip;3;0;0;3
18473;Gabijėlė;ANČIUKŲ;3972933727;Taip;4;1;2;7
18474;Gabijėlė;ANČIUKŲ;9657713903;Taip;5;0;0;5
18475;Gabijėlė;ANČIUKŲ;4278783863;Taip;0;0;1;1
18476;Gabijėlė;ANČIUKŲ;4087903129;Taip;0;5;0;5
18477;Gabijėlė;ANČIUKŲ;7049399327;Taip;0;1;0;1
18478;Gabijėlė;ANČIUKŲ;8611258788;Taip;7;0;0;7
18479;Gabijėlė;ANČIUKŲ;8834028360;Taip;13;0;0;13
18480;Gabijėlė;ANČIUKŲ;1002680245;Taip;8;0;0;8
18481;Gabijėlė;ANČIUKŲ;6393256426;Taip;0;1;0;1
18482;Gabijėlė;ANČIUKŲ;4692161807;Taip;3;0;0;3
18483;Gabijėlė;ANČIUKŲ;6040818549;Taip;5;0;0;5
18484;Gabijėlė;ANČIUKŲ;6481368028;Taip;18;0;1;19
18485;Gabijėlė;ANČIUKŲ;7590725504;Taip;0;11;0;11
18486;Gabijėlė;ANČIUKŲ;1230236612;Taip;10;0;0;10
18487;Gabijėlė;ANČIUKŲ;1525969706;Taip;5;0;0;5
18488;Gabijėlė;BALANDŽIUKŲ;8514099621;Taip;4;0;0;4
18489;Gabijėlė;BALANDŽIUKŲ;6795173519;Taip;18;0;0;18
18490;Gabijėlė;BALANDŽIUKŲ;6748378606;Taip;13;4;0;17
18491;Gabijėlė;BALANDŽIUKŲ;1612957739;Taip;15;0;0;15
18492;Gabijėlė;BALANDŽIUKŲ;8388297947;Taip;4;0;0;4
18493;Gabijėlė;BALANDŽIUKŲ;7888013969;Taip;1;0;0;1
18494;Gabijėlė;BALANDŽIUKŲ;3011163947;Taip;1;0;0;1
18495;Gabijėlė;BALANDŽIUKŲ;5788152675;Taip;19;0;0;19
18496;Gabijėlė;BALANDŽIUKŲ;6296983654;Taip;0;2;0;2
18497;Gabijėlė;BALANDŽIUKŲ;4160646449;Taip;0;2;0;2
18498;Gabijėlė;BALANDŽIUKŲ;2185615215;Taip;3;0;0;3
18499;Gabijėlė;BALANDŽIUKŲ;4959332778;Taip;10;0;0;10
18500;Gabijėlė;BALANDŽIUKŲ;7224216275;Taip;7;0;1;8
18501;Gabijėlė;BALANDŽIUKŲ;7447079902;Taip;3;0;0;3
18502;Gabijėlė;BALANDŽIUKŲ;2289016022;Taip;4;0;0;4
18503;Gabijėlė;BALANDŽIUKŲ;8698788528;Taip;1;0;0;1
18504;Gabijėlė;VYTURIUKŲ;6131649116;Taip;7;0;2;9
18505;Gabijėlė;VYTURIUKŲ;7894667201;Taip;4;1;0;5
18506;Gabijėlė;VYTURIUKŲ;3960795412;Taip;0;1;0;1
18507;Gabijėlė;VYTURIUKŲ;3973977318;Taip;5;0;0;5
18508;Gabijėlė;VYTURIUKŲ;9628900843;Taip;0;0;2;2
18509;Gabijėlė;VYTURIUKŲ;5769331689;Taip;0;0;6;6
18510;Gabijėlė;VYTURIUKŲ;5652244967;Taip;0;6;2;8
18511;Gabijėlė;VYTURIUKŲ;6013482554;Taip;5;1;2;8
18512;Gabijėlė;VYTURIUKŲ;3343196830;Taip;0;0;2;2
18513;Gabijėlė;VYTURIUKŲ;7295985579;Taip;5;0;0;5
18514;Gabijėlė;VYTURIUKŲ;6834871835;Taip;0;0;4;4
18515;Gabijėlė;VYTURIUKŲ;1185216449;Taip;4;1;0;5
18516;Gabijėlė;VYTURIUKŲ;6107630313;Taip;3;0;0;3
18517;Gabijėlė;VYTURIUKŲ;4248856615;Taip;0;1;0;1
18518;Saulėgrąža;Žvirbliukai;7528030593;Taip;1;0;0;1
18519;Saulėgrąža;Žvirbliukai;1749212067;Taip;0;0;23;23
18520;Saulėgrąža;Žvirbliukai;7205331233;Taip;13;0;0;13
18521;Saulėgrąža;Žvirbliukai;1139417036;Taip;3;0;0;3
18522;Saulėgrąža;Žvirbliukai;2634800266;Taip;0;9;2;11
18523;Saulėgrąža;Žvirbliukai;3735674819;Taip;3;0;0;3
18524;Saulėgrąža;Žvirbliukai;7913268008;Taip;18;0;0;18
18525;Saulėgrąža;Žvirbliukai;6712131257;Taip;20;0;0;20
18526;Saulėgrąža;Žvirbliukai;3167209653;Taip;0;4;1;5
18527;Saulėgrąža;Žvirbliukai;9396867525;Taip;0;0;23;23
18528;Saulėgrąža;Žvirbliukai;3542439844;Taip;2;0;0;2
18529;Saulėgrąža;Žvirbliukai;6862912567;Taip;4;0;0;4
18530;Saulėgrąža;Žvirbliukai;4328258012;Taip;4;0;1;5
18531;"Pilaitukas (I. Kanto al. 7A)";BITUTĖS;7011500012;Taip;0;10;0;10
18532;"Pilaitukas (I. Kanto al. 7A)";BITUTĖS;8943142551;Taip;5;2;1;8
18533;"Pilaitukas (I. Kanto al. 7A)";BITUTĖS;6225968272;Taip;5;2;1;8
18534;"Pilaitukas (I. Kanto al. 7A)";BITUTĖS;5904710385;Taip;0;1;0;1
18535;"Pilaitukas (I. Kanto al. 7A)";BITUTĖS;1486895496;Taip;0;1;0;1
18536;"Pilaitukas (I. Kanto al. 7A)";BITUTĖS;1746050808;Taip;0;1;0;1
18537;"Pilaitukas (I. Kanto al. 7A)";BITUTĖS;5979852431;Taip;9;4;0;13
18538;"Pilaitukas (I. Kanto al. 7A)";BITUTĖS;9950619644;Taip;0;17;0;17
18539;"Pilaitukas (I. Kanto al. 7A)";BITUTĖS;2633256935;Taip;0;2;2;4
18540;"Pilaitukas (I. Kanto al. 7A)";BITUTĖS;8747053041;Taip;0;2;2;4
18541;"Pilaitukas (I. Kanto al. 7A)";BITUTĖS;6271751691;Taip;1;4;3;8
18542;"Pilaitukas (I. Kanto al. 7A)";BITUTĖS;9306169443;Taip;0;1;1;2
18543;"Pilaitukas (I. Kanto al. 7A)";BITUTĖS;1568651642;Taip;9;0;0;9
18544;"Pilaitukas (I. Kanto al. 7A)";BITUTĖS;5155899628;Taip;0;5;0;5
18545;"Pilaitukas (I. Kanto al. 7A)";BITUTĖS;5340877261;Taip;0;5;0;5
18546;"Pilaitukas (I. Kanto al. 7A)";BITUTĖS;6064545501;Taip;9;2;0;11
18547;"Pilaitukas (I. Kanto al. 7A)";BITUTĖS;3751157025;Taip;5;1;3;9
18548;"Pilaitukas (I. Kanto al. 7A)";BITUTĖS;1040103641;Taip;2;0;0;2
18549;"Pilaitukas (I. Kanto al. 7A)";ZUIKUČIAI;4383174356;Taip;4;0;0;4
18550;"Pilaitukas (I. Kanto al. 7A)";ZUIKUČIAI;7766403199;Taip;11;0;0;11
18551;"Pilaitukas (I. Kanto al. 7A)";ZUIKUČIAI;4118652467;Taip;4;0;0;4
18552;"Pilaitukas (I. Kanto al. 7A)";ZUIKUČIAI;1841240800;Taip;2;0;0;2
18553;"Pilaitukas (I. Kanto al. 7A)";ZUIKUČIAI;4710865219;Taip;2;0;0;2
18554;"Pilaitukas (I. Kanto al. 7A)";ZUIKUČIAI;6054821801;Taip;0;4;0;4
18555;"Pilaitukas (I. Kanto al. 7A)";ZUIKUČIAI;5691854235;Taip;1;0;0;1
18556;"Pilaitukas (I. Kanto al. 7A)";ZUIKUČIAI;3952708917;Taip;1;0;0;1
18557;"Pilaitukas (I. Kanto al. 7A)";ZUIKUČIAI;6337917448;Taip;12;1;0;13
18558;"Pilaitukas (I. Kanto al. 7A)";ZUIKUČIAI;3636976107;Taip;12;1;0;13
18559;"Pilaitukas (I. Kanto al. 7A)";ZUIKUČIAI;5026344198;Taip;4;4;0;8
18560;"Pilaitukas (I. Kanto al. 7A)";ZUIKUČIAI;8207648026;Taip;6;0;0;6
18561;"Pilaitukas (I. Kanto al. 7A)";ZUIKUČIAI;3921932673;Taip;6;0;0;6
18562;"Pilaitukas (I. Kanto al. 7A)";ZUIKUČIAI;5682244165;Taip;3;2;0;5
18563;"Pilaitukas (I. Kanto al. 7A)";ZUIKUČIAI;1290017967;Taip;5;5;0;10
18564;"Pilaitukas (I. Kanto al. 7A)";ZUIKUČIAI;5564784922;Taip;2;2;0;4
18565;"Pilaitukas (I. Kanto al. 7A)";ZUIKUČIAI;9150579386;Taip;2;0;0;2
18566;"Pilaitukas (I. Kanto al. 7A)";ZUIKUČIAI;6238537739;Taip;14;0;0;14
18567;"Pilaitukas (I. Kanto al. 7A)";ZUIKUČIAI;6876537203;Taip;4;0;0;4
18568;"Pilaitukas (I. Kanto al. 7A)";ZUIKUČIAI;4312344789;Taip;3;0;0;3
18569;"Pilaitukas (I. Kanto al. 7A)";ANČIUKAI;7773318230;Taip;4;6;0;10
18570;"Pilaitukas (I. Kanto al. 7A)";ANČIUKAI;4097742120;Taip;11;2;0;13
18571;"Pilaitukas (I. Kanto al. 7A)";ANČIUKAI;2923272767;Taip;11;2;0;13
18572;"Pilaitukas (I. Kanto al. 7A)";ANČIUKAI;8620858011;Taip;0;1;0;1
18573;"Pilaitukas (I. Kanto al. 7A)";ANČIUKAI;4286388920;Taip;10;0;0;10
18574;"Pilaitukas (I. Kanto al. 7A)";ANČIUKAI;3761827714;Taip;6;4;0;10
18575;"Pilaitukas (I. Kanto al. 7A)";ANČIUKAI;8643066116;Taip;5;0;0;5
18576;"Pilaitukas (I. Kanto al. 7A)";ANČIUKAI;1120549352;Taip;0;0;2;2
18577;"Pilaitukas (I. Kanto al. 7A)";ANČIUKAI;6888607864;Taip;8;4;0;12
18578;"Pilaitukas (I. Kanto al. 7A)";ANČIUKAI;3035456834;Taip;0;14;0;14
18579;"Pilaitukas (I. Kanto al. 7A)";ANČIUKAI;2476942319;Taip;0;14;0;14
18580;"Pilaitukas (I. Kanto al. 7A)";ANČIUKAI;8033540052;Taip;6;3;0;9
18581;"Pilaitukas (I. Kanto al. 7A)";ANČIUKAI;1781762820;Taip;5;0;0;5
18582;"Pilaitukas (I. Kanto al. 7A)";ANČIUKAI;7189824054;Taip;0;3;0;3
18583;"Pilaitukas (I. Kanto al. 7A)";ANČIUKAI;9332831979;Taip;0;1;0;1
18584;"Pilaitukas (I. Kanto al. 7A)";ANČIUKAI;5706918634;Taip;14;0;0;14
18585;"Pilaitukas (I. Kanto al. 7A)";ANČIUKAI;8954370321;Taip;8;4;0;12
18586;"Pilaitukas (I. Kanto al. 7A)";ANČIUKAI;1660462256;Taip;7;0;0;7
18587;"Pilaitukas (I. Kanto al. 7A)";MEŠKIUKAI;8577357264;Taip;3;0;0;3
18588;"Pilaitukas (I. Kanto al. 7A)";MEŠKIUKAI;5297214263;Taip;8;4;0;12
18589;"Pilaitukas (I. Kanto al. 7A)";MEŠKIUKAI;8268790017;Taip;1;1;0;2
18590;"Pilaitukas (I. Kanto al. 7A)";MEŠKIUKAI;2054626415;Taip;5;3;0;8
18591;"Pilaitukas (I. Kanto al. 7A)";MEŠKIUKAI;9742268665;Taip;13;1;0;14
18592;"Pilaitukas (I. Kanto al. 7A)";MEŠKIUKAI;8322980583;Taip;5;4;0;9
18593;"Pilaitukas (I. Kanto al. 7A)";MEŠKIUKAI;3867660147;Taip;1;0;0;1
18594;"Pilaitukas (I. Kanto al. 7A)";MEŠKIUKAI;2365387089;Taip;1;0;0;1
18595;"Pilaitukas (I. Kanto al. 7A)";MEŠKIUKAI;9670329628;Taip;0;3;0;3
18596;"Pilaitukas (I. Kanto al. 7A)";MEŠKIUKAI;7750575554;Taip;10;4;0;14
18597;"Pilaitukas (I. Kanto al. 7A)";MEŠKIUKAI;9187961584;Taip;0;3;0;3
18598;"Pilaitukas (I. Kanto al. 7A)";MEŠKIUKAI;7781507786;Taip;12;4;0;16
18599;"Pilaitukas (I. Kanto al. 7A)";MEŠKIUKAI;4171896175;Taip;1;0;0;1
18600;"Pilaitukas (I. Kanto al. 7A)";MEŠKIUKAI;1362132769;Ne;4;0;0;4
18601;"Pilaitukas (I. Kanto al. 7A)";MEŠKIUKAI;6807166920;Taip;7;4;0;11
18602;"Pilaitukas (I. Kanto al. 7A)";MEŠKIUKAI;2830212921;Taip;3;2;0;5
18603;"Pilaitukas (I. Kanto al. 7A)";MEŠKIUKAI;9930306085;Taip;11;0;0;11
18604;"Pilaitukas (I. Kanto al. 7A)";ŽUVYTĖS;2317213283;Taip;1;2;0;3
18605;"Pilaitukas (I. Kanto al. 7A)";ŽUVYTĖS;4353195155;Taip;0;2;0;2
18606;"Pilaitukas (I. Kanto al. 7A)";ŽUVYTĖS;8913709682;Taip;2;0;0;2
18607;"Pilaitukas (I. Kanto al. 7A)";ŽUVYTĖS;8877142428;Taip;3;1;0;4
18608;"Pilaitukas (I. Kanto al. 7A)";ŽUVYTĖS;2862447956;Taip;2;4;0;6
18609;"Pilaitukas (I. Kanto al. 7A)";ŽUVYTĖS;8727175656;Taip;2;4;0;6
18610;"Pilaitukas (I. Kanto al. 7A)";ŽUVYTĖS;8207194955;Taip;8;1;2;11
18611;"Pilaitukas (I. Kanto al. 7A)";ŽUVYTĖS;5640802570;Taip;4;0;0;4
18612;"Pilaitukas (I. Kanto al. 7A)";ŽUVYTĖS;8993885764;Taip;11;2;0;13
18613;"Pilaitukas (I. Kanto al. 7A)";ŽUVYTĖS;9260893320;Ne;0;5;0;5
18614;"Pilaitukas (I. Kanto al. 7A)";ŽUVYTĖS;5710747769;Taip;0;3;0;3
18615;"Pilaitukas (I. Kanto al. 7A)";ŽUVYTĖS;5206637809;Taip;5;0;0;5
18616;"Pilaitukas (I. Kanto al. 7A)";ŽUVYTĖS;5288784331;Taip;3;1;0;4
18617;"Pilaitukas (I. Kanto al. 7A)";ŽUVYTĖS;1704055907;Taip;0;4;5;9
18618;"Pilaitukas (I. Kanto al. 7A)";ŽUVYTĖS;8255398803;Taip;4;4;0;8
18619;"Pilaitukas (I. Kanto al. 7A)";ŽUVYTĖS;1607454890;Taip;3;0;1;4
18620;"Pilaitukas (I. Kanto al. 7A)";ŽUVYTĖS;9735358433;Ne;1;0;0;1
18621;"Pilaitukas (I. Kanto al. 7A)";PAUKŠTELIAI;1295215465;Taip;0;5;0;5
18622;"Pilaitukas (I. Kanto al. 7A)";PAUKŠTELIAI;7082099968;Taip;5;7;0;12
18623;"Pilaitukas (I. Kanto al. 7A)";PAUKŠTELIAI;1253300093;Taip;3;5;0;8
18624;"Pilaitukas (I. Kanto al. 7A)";PAUKŠTELIAI;3037850837;Taip;0;1;0;1
18625;"Pilaitukas (I. Kanto al. 7A)";PAUKŠTELIAI;1729494874;Taip;1;3;0;4
18626;"Pilaitukas (I. Kanto al. 7A)";PAUKŠTELIAI;2242454299;Taip;5;4;0;9
18627;"Pilaitukas (I. Kanto al. 7A)";PAUKŠTELIAI;4082490488;Taip;6;5;0;11
18628;"Pilaitukas (I. Kanto al. 7A)";PAUKŠTELIAI;3345387791;Taip;1;0;0;1
18629;"Pilaitukas (I. Kanto al. 7A)";PAUKŠTELIAI;6099109886;Taip;0;1;0;1
18630;"Pilaitukas (I. Kanto al. 7A)";PAUKŠTELIAI;3913169122;Taip;7;4;0;11
18631;"Pilaitukas (I. Kanto al. 7A)";PAUKŠTELIAI;3541354283;Taip;2;0;0;2
18632;"Pilaitukas (I. Kanto al. 7A)";PAUKŠTELIAI;3519198814;Taip;0;5;0;5
18633;"Pilaitukas (I. Kanto al. 7A)";PAUKŠTELIAI;5740951665;Taip;3;4;0;7
18634;"Pilaitukas (I. Kanto al. 7A)";PAUKŠTELIAI;4591799893;Taip;9;1;0;10
18635;"Pilaitukas (I. Kanto al. 7A)";PAUKŠTELIAI;6308557885;Taip;0;1;0;1
18636;"Pilaitukas (I. Kanto al. 7A)";PAUKŠTELIAI;6514731102;Taip;2;0;0;2
18637;"Pilaitukas (I. Kanto al. 7A)";PAUKŠTELIAI;5331915157;Taip;3;4;0;7
18638;"Pilaitukas (I. Kanto al. 7A)";PAUKŠTELIAI;8169484415;Taip;0;9;0;9
18639;"Pilaitukas (I. Kanto al. 7A)";PAUKŠTELIAI;3159733673;Taip;2;0;0;2
18640;"Pilaitukas (I. Kanto al. 7A)";BORUŽĖLĖS;9898379569;Taip;8;0;0;8
18641;"Pilaitukas (I. Kanto al. 7A)";BORUŽĖLĖS;5185051301;Taip;0;1;0;1
18642;"Pilaitukas (I. Kanto al. 7A)";BORUŽĖLĖS;1731106179;Taip;4;5;0;9
18643;"Pilaitukas (I. Kanto al. 7A)";BORUŽĖLĖS;3784944532;Taip;0;0;2;2
18644;"Pilaitukas (I. Kanto al. 7A)";BORUŽĖLĖS;5186675623;Taip;0;0;1;1
18645;"Pilaitukas (I. Kanto al. 7A)";BORUŽĖLĖS;4317406707;Taip;3;0;1;4
18646;"Pilaitukas (I. Kanto al. 7A)";BORUŽĖLĖS;4589130143;Taip;6;0;0;6
18647;"Pilaitukas (I. Kanto al. 7A)";BORUŽĖLĖS;1944443723;Taip;8;0;2;10
18648;"Pilaitukas (I. Kanto al. 7A)";BORUŽĖLĖS;8380819975;Taip;4;3;0;7
18649;"Pilaitukas (I. Kanto al. 7A)";BORUŽĖLĖS;3849247594;Ne;2;0;0;2
18650;"Pilaitukas (I. Kanto al. 7A)";BORUŽĖLĖS;5201301769;Taip;6;0;1;7
18651;"Pilaitukas (I. Kanto al. 7A)";BORUŽĖLĖS;2555073719;Taip;4;0;1;5
18652;"Pilaitukas (I. Kanto al. 7A)";BORUŽĖLĖS;6835592675;Taip;15;0;3;18
18653;"Pilaitukas (I. Kanto al. 7A)";BORUŽĖLĖS;5066594124;Taip;9;0;0;9
18654;"Pilaitukas (I. Kanto al. 7A)";BORUŽĖLĖS;2336933998;Taip;14;0;0;14
18655;"Pilaitukas (I. Kanto al. 7A)";BORUŽĖLĖS;8047683859;Taip;23;0;0;23
18656;"Pilaitukas (I. Kanto al. 7A)";BORUŽĖLĖS;8694369154;Taip;23;0;0;23
18657;"Pilaitukas (I. Kanto al. 7A)";BORUŽĖLĖS;9587140991;Taip;0;11;5;16
18658;"Pilaitukas (I. Kanto al. 7A)";DRUGELIAI;2917197418;Ne;5;3;0;8
18659;"Pilaitukas (I. Kanto al. 7A)";DRUGELIAI;7807341574;Taip;4;4;0;8
18660;"Pilaitukas (I. Kanto al. 7A)";DRUGELIAI;2414941263;Ne;0;0;5;5
18661;"Pilaitukas (I. Kanto al. 7A)";DRUGELIAI;7830059468;Taip;4;3;1;8
18662;"Pilaitukas (I. Kanto al. 7A)";DRUGELIAI;5901884512;Taip;9;0;0;9
18663;"Pilaitukas (I. Kanto al. 7A)";DRUGELIAI;8710069256;Taip;8;0;0;8
18664;"Pilaitukas (I. Kanto al. 7A)";DRUGELIAI;6280870972;Taip;16;0;2;18
18665;"Pilaitukas (I. Kanto al. 7A)";DRUGELIAI;3609692114;Taip;12;0;0;12
18666;"Pilaitukas (I. Kanto al. 7A)";DRUGELIAI;2768655540;Taip;5;0;2;7
18667;"Pilaitukas (I. Kanto al. 7A)";DRUGELIAI;1052452915;Taip;14;0;0;14
18668;"Pilaitukas (I. Kanto al. 7A)";DRUGELIAI;7478616628;Taip;0;7;0;7
18669;"Pilaitukas (I. Kanto al. 7A)";DRUGELIAI;1134083816;Taip;9;0;0;9
18670;"Pilaitukas (I. Kanto al. 7A)";DRUGELIAI;1452645899;Taip;4;0;4;8
18671;"Pilaitukas (I. Kanto al. 7A)";DRUGELIAI;8092422909;Taip;2;0;0;2
18672;"Pilaitukas (I. Kanto al. 7A)";PELIUKAI;9246925227;Taip;3;0;1;4
18673;"Pilaitukas (I. Kanto al. 7A)";PELIUKAI;8769116377;Taip;0;0;1;1
18674;"Pilaitukas (I. Kanto al. 7A)";PELIUKAI;8501376663;Taip;0;1;0;1
18675;"Pilaitukas (I. Kanto al. 7A)";PELIUKAI;5421602723;Ne;0;11;0;11
18676;"Pilaitukas (I. Kanto al. 7A)";PELIUKAI;6754825353;Taip;0;7;0;7
18677;"Pilaitukas (I. Kanto al. 7A)";PELIUKAI;8168228529;Taip;0;11;0;11
18678;"Pilaitukas (I. Kanto al. 7A)";PELIUKAI;6833933586;Taip;10;0;0;10
18679;"Pilaitukas (I. Kanto al. 7A)";PELIUKAI;2416277190;Taip;9;0;0;9
18680;"Pilaitukas (I. Kanto al. 7A)";PELIUKAI;1270365948;Taip;4;1;0;5
18681;"Pilaitukas (I. Kanto al. 7A)";PELIUKAI;7604004800;Taip;4;1;0;5
18682;"Pilaitukas (I. Kanto al. 7A)";PELIUKAI;9556421129;Taip;5;0;0;5
18683;"Pilaitukas (I. Kanto al. 7A)";PELIUKAI;3954210452;Ne;0;2;0;2
18684;"Pilaitukas (I. Kanto al. 7A)";PELIUKAI;3651140874;Taip;0;2;0;2
18685;"Pilaitukas (I. Kanto al. 7A)";PELIUKAI;2823859128;Taip;0;4;0;4
18686;"Pilaitukas (I. Kanto al. 7A)";PELIUKAI;7750936973;Taip;5;0;0;5
18687;"Pilaitukas (I. Kanto al. 7A)";PELIUKAI;6185954940;Taip;2;0;0;2
18688;"Pilaitukas (I. Kanto al. 7A)";KAČIUKAI;9038324313;Taip;0;2;0;2
18689;"Pilaitukas (I. Kanto al. 7A)";KAČIUKAI;7594484959;Taip;5;0;0;5
18690;"Pilaitukas (I. Kanto al. 7A)";KAČIUKAI;2463482642;Taip;1;0;0;1
18691;"Pilaitukas (I. Kanto al. 7A)";KAČIUKAI;3080014745;Taip;12;2;0;14
18692;"Pilaitukas (I. Kanto al. 7A)";KAČIUKAI;6525191057;Taip;0;0;1;1
18693;"Pilaitukas (I. Kanto al. 7A)";KAČIUKAI;8009040109;Taip;1;3;0;4
18694;"Pilaitukas (I. Kanto al. 7A)";KAČIUKAI;2105380328;Taip;5;0;0;5
18695;"Pilaitukas (I. Kanto al. 7A)";KAČIUKAI;5326689274;Taip;0;11;1;12
18696;"Pilaitukas (I. Kanto al. 7A)";KAČIUKAI;9653647227;Taip;2;11;1;14
18697;"Pilaitukas (I. Kanto al. 7A)";KAČIUKAI;4022543517;Taip;0;6;0;6
18698;"Pilaitukas (I. Kanto al. 7A)";KAČIUKAI;3825942473;Taip;0;14;0;14
18699;"Pilaitukas (I. Kanto al. 7A)";KAČIUKAI;1611371690;Taip;0;0;9;9
18700;"Pilaitukas (I. Kanto al. 7A)";KAČIUKAI;9247501721;Taip;5;4;1;10
18701;"Pilaitukas (I. Kanto al. 7A)";KAČIUKAI;6436694057;Taip;0;1;1;2
18702;"Pilaitukas (I. Kanto al. 7A)";KAČIUKAI;9974310580;Taip;1;3;2;6
18703;"Pilaitukas (I. Kanto al. 7A)";KAČIUKAI;6235375235;Taip;4;0;2;6
18704;"Pilaitukas (I. Kanto al. 7A)";KAČIUKAI;9914575692;Taip;4;4;0;8
18705;"Pilaitukas (I. Kanto al. 7A)";KAČIUKAI;4341157841;Taip;13;0;0;13
18706;"Pilaitukas (I. Kanto al. 7A)";SAULUTĖS;2110996493;Taip;14;0;0;14
18707;"Pilaitukas (I. Kanto al. 7A)";SAULUTĖS;8306015313;Taip;1;9;0;10
18708;"Pilaitukas (I. Kanto al. 7A)";SAULUTĖS;3927713632;Taip;11;0;0;11
18709;"Pilaitukas (I. Kanto al. 7A)";SAULUTĖS;1970389617;Taip;3;0;0;3
18710;"Pilaitukas (I. Kanto al. 7A)";SAULUTĖS;1351676866;Taip;13;0;0;13
18711;"Pilaitukas (I. Kanto al. 7A)";SAULUTĖS;4947536980;Taip;13;0;0;13
18712;"Pilaitukas (I. Kanto al. 7A)";SAULUTĖS;8586082743;Taip;9;0;0;9
18713;"Pilaitukas (I. Kanto al. 7A)";SAULUTĖS;8693322790;Taip;14;0;0;14
18714;"Pilaitukas (I. Kanto al. 7A)";MENULIUKAI;1620231835;Taip;1;1;0;2
18715;"Pilaitukas (I. Kanto al. 7A)";MENULIUKAI;8873155277;Taip;0;3;0;3
18716;"Pilaitukas (I. Kanto al. 7A)";MENULIUKAI;1532252453;Taip;5;0;0;5
18717;"Pilaitukas (I. Kanto al. 7A)";MENULIUKAI;8225571149;Taip;11;1;0;12
18718;"Pilaitukas (I. Kanto al. 7A)";MENULIUKAI;7855892595;Taip;4;0;0;4
18719;"Pilaitukas (I. Kanto al. 7A)";MENULIUKAI;8058057477;Taip;13;0;0;13
18720;"Pilaitukas (I. Kanto al. 7A)";MENULIUKAI;7369920743;Taip;6;1;0;7
18721;"Pilaitukas (I. Kanto al. 7A)";MENULIUKAI;9106756175;Taip;14;0;0;14
18722;"Pilaitukas (I. Kanto al. 7A)";MENULIUKAI;5213352941;Taip;19;0;0;19
18723;"Pilaitukas (I. Kanto al. 7A)";MENULIUKAI;4811066607;Taip;2;0;0;2
18724;"Pilaitukas (I. Kanto al. 7A)";MENULIUKAI;1025359287;Taip;7;0;0;7
18725;"Pilaitukas (I. Kanto al. 7A)";MENULIUKAI;4917076546;Taip;7;0;0;7
18726;"Pilaitukas (I. Kanto al. 7A)";MENULIUKAI;9800474455;Taip;6;1;0;7
18727;"Pilaitukas (I. Kanto al. 7A)";ĖŽIUKAI;6019760696;Taip;0;1;0;1
18728;"Pilaitukas (I. Kanto al. 7A)";ĖŽIUKAI;2342453729;Ne;4;1;0;5
18729;"Pilaitukas (I. Kanto al. 7A)";ĖŽIUKAI;2484405944;Taip;7;0;2;9
18730;"Pilaitukas (I. Kanto al. 7A)";ĖŽIUKAI;3283178614;Taip;6;0;0;6
18731;"Pilaitukas (I. Kanto al. 7A)";ĖŽIUKAI;4577941964;Taip;5;1;2;8
18732;"Pilaitukas (I. Kanto al. 7A)";ĖŽIUKAI;9099718179;Taip;4;0;0;4
18733;"Pilaitukas (I. Kanto al. 7A)";ĖŽIUKAI;7075283592;Taip;0;3;0;3
18734;"Pilaitukas (I. Kanto al. 7A)";ĖŽIUKAI;8312146534;Taip;11;3;0;14
18735;"Pilaitukas (I. Kanto al. 7A)";ĖŽIUKAI;1251079289;Taip;3;0;0;3
18736;"Pilaitukas (I. Kanto al. 7A)";ĖŽIUKAI;2600504692;Taip;0;23;0;23
18737;"Pilaitukas (I. Kanto al. 7A)";ĖŽIUKAI;2717071397;Taip;6;0;1;7
18738;Švelnukas;Pelėdžiukai;8016531082;Taip;4;0;2;6
18739;Švelnukas;Pelėdžiukai;8219071968;Taip;6;4;0;10
18740;Švelnukas;Pelėdžiukai;9008722163;Taip;5;4;0;9
18741;Švelnukas;Pelėdžiukai;5699300764;Taip;8;0;0;8
18742;Švelnukas;Pelėdžiukai;1116279011;Ne;10;0;0;10
18743;Švelnukas;Pelėdžiukai;3892058023;Ne;10;0;0;10
18744;Švelnukas;Pelėdžiukai;5681611554;Taip;1;10;0;11
18745;Švelnukas;Pelėdžiukai;8589226595;Taip;17;0;0;17
18746;Švelnukas;Pelėdžiukai;9802064955;Taip;5;4;0;9
18747;Švelnukas;Pelėdžiukai;5041138716;Taip;1;9;0;10
18748;Švelnukas;Pelėdžiukai;3804532959;Taip;0;5;0;5
18749;Švelnukas;Pelėdžiukai;1462620951;Taip;5;0;0;5
18750;Švelnukas;Pelėdžiukai;8650902343;Taip;1;4;0;5
18751;Švelnukas;Pelėdžiukai;1409803554;Taip;5;7;0;12
18752;Švelnukas;Pelėdžiukai;1991507109;Ne;9;6;0;15
18753;Švelnukas;Pelėdžiukai;9808833734;Taip;5;0;4;9
18754;Švelnukas;Pelėdžiukai;9814032171;Taip;11;0;0;11
18755;Švelnukas;Ežiukai;4711482287;Taip;6;1;0;7
18756;Švelnukas;Ežiukai;2892176166;Taip;10;4;0;14
18757;Švelnukas;Ežiukai;2400781175;Taip;0;1;0;1
18758;Švelnukas;Ežiukai;6209334207;Taip;1;0;0;1
18759;Švelnukas;Ežiukai;1201550386;Taip;5;0;0;5
18760;Švelnukas;Ežiukai;2348752207;Taip;0;23;0;23
18761;Švelnukas;Ežiukai;1143579276;Taip;2;0;0;2
18762;Švelnukas;Ežiukai;3645855145;Taip;6;0;0;6
18763;Švelnukas;Ežiukai;9402567487;Taip;9;0;0;9
18764;Švelnukas;Ežiukai;8569985034;Taip;0;3;0;3
18765;Švelnukas;Ežiukai;3235768013;Taip;2;4;0;6
18766;Švelnukas;Ežiukai;9347355242;Taip;5;0;0;5
18767;Švelnukas;Ežiukai;3832011837;Taip;0;1;0;1
18768;Švelnukas;Ežiukai;9829912750;Taip;0;4;0;4
18769;Švelnukas;Ežiukai;9394816723;Taip;1;0;0;1
18770;Švelnukas;Ežiukai;6658530716;Taip;17;0;0;17
18771;Švelnukas;Ežiukai;4035050422;Taip;9;0;0;9
18772;Švelnukas;Ežiukai;4048599050;Taip;7;0;1;8
18773;Švelnukas;Ežiukai;9712567632;Taip;8;0;0;8
18774;Švelnukas;Ežiukai;2106591525;Taip;0;10;1;11
18775;Švelnukas;Švelnukai;4681584014;Taip;6;4;1;11
18776;Švelnukas;Švelnukai;6607578153;Taip;0;0;2;2
18777;Švelnukas;Švelnukai;8847738918;Taip;0;1;1;2
18778;Švelnukas;Švelnukai;1982267458;Taip;0;0;1;1
18779;Švelnukas;Švelnukai;9766734938;Taip;0;2;0;2
18780;Švelnukas;Švelnukai;3020524039;Taip;0;1;2;3
18781;Švelnukas;Švelnukai;1411710913;Taip;0;1;0;1
18782;Švelnukas;Švelnukai;5213589179;Taip;0;6;0;6
18783;Švelnukas;Švelnukai;4544791546;Taip;5;4;0;9
18784;Švelnukas;Švelnukai;1963518457;Taip;0;4;1;5
18785;Švelnukas;Švelnukai;4194249709;Taip;9;0;0;9
18786;Švelnukas;Švelnukai;5936821902;Taip;13;0;0;13
18787;Švelnukas;Švelnukai;4629757899;Taip;7;2;0;9
18788;Švelnukas;Švelnukai;6964997767;Taip;0;4;0;4
18789;Švelnukas;Švelnukai;8951810066;Taip;8;0;1;9
18790;Švelnukas;Švelnukai;2663990082;Taip;0;4;0;4
18791;Švelnukas;Švelnukai;6204286255;Taip;0;0;4;4
18792;Švelnukas;Švelnukai;5960966542;Taip;4;1;0;5
18793;Švelnukas;Boružiukai;1951447127;Taip;0;0;11;11
18794;Švelnukas;Boružiukai;3849957906;Taip;0;0;7;7
18795;Švelnukas;Boružiukai;5550841477;Taip;0;0;5;5
18796;Švelnukas;Boružiukai;1264256177;Taip;0;3;0;3
18797;Švelnukas;Boružiukai;1332533332;Taip;2;0;0;2
18798;Švelnukas;Boružiukai;8458233793;Taip;4;0;0;4
18799;Švelnukas;Boružiukai;8951980999;Taip;0;0;1;1
18800;Švelnukas;Boružiukai;4990399144;Taip;0;2;0;2
18801;Švelnukas;Boružiukai;9575767514;Taip;5;1;1;7
18802;Švelnukas;Boružiukai;6282137936;Taip;0;6;0;6
18803;Švelnukas;Boružiukai;9479536507;Taip;3;0;0;3
18804;Švelnukas;Boružiukai;2088128734;Taip;0;0;1;1
18805;Švelnukas;Boružiukai;2077614498;Taip;0;1;0;1
18806;Švelnukas;Boružiukai;3145935641;Taip;0;1;1;2
18807;Švelnukas;Boružiukai;4404904322;Taip;0;1;1;2
18808;Švelnukas;Boružiukai;8895028305;Taip;0;0;1;1
18809;Švelnukas;Boružiukai;4823928859;Taip;0;0;1;1
18810;Švelnukas;Smalsučiai;9558811523;Taip;0;4;0;4
18811;Švelnukas;Smalsučiai;1661019352;Taip;2;0;0;2
18812;Švelnukas;Smalsučiai;5554625346;Taip;0;1;1;2
18813;Švelnukas;Smalsučiai;3282020958;Taip;0;1;1;2
18814;Švelnukas;Smalsučiai;2730288544;Taip;0;4;0;4
18815;Švelnukas;Smalsučiai;5805289419;Taip;7;0;0;7
18816;Švelnukas;Smalsučiai;8193690277;Taip;0;2;0;2
18817;Švelnukas;Smalsučiai;3472774028;Taip;0;0;7;7
18818;Švelnukas;Smalsučiai;5845744917;Taip;0;4;0;4
18819;Švelnukas;Smalsučiai;6764222588;Taip;0;4;12;16
18820;Švelnukas;Smalsučiai;1840752560;Taip;3;0;0;3
18821;Švelnukas;Smalsučiai;4467095100;Taip;0;0;4;4
18822;Švelnukas;Smalsučiai;7125883267;Taip;8;0;0;8
18823;Švelnukas;Smalsučiai;8210720087;Taip;7;6;0;13
18824;Švelnukas;Smalsučiai;1836913588;Taip;0;0;2;2
18825;Švelnukas;Smalsučiai;6155098464;Taip;4;0;0;4
18826;Švelnukas;Smalsučiai;8829819783;Taip;21;0;0;21
18827;Švelnukas;Nykštukai;1058623863;Taip;5;0;0;5
18828;Švelnukas;Nykštukai;7987715134;Taip;0;1;2;3
18829;Švelnukas;Nykštukai;3455801077;Taip;0;0;11;11
18830;Švelnukas;Nykštukai;9371102717;Taip;0;23;0;23
18831;Švelnukas;Nykštukai;3576731010;Taip;8;0;0;8
18832;Švelnukas;Nykštukai;5969852813;Taip;0;23;0;23
18833;Švelnukas;Nykštukai;5483481191;Taip;7;0;2;9
18834;Švelnukas;Nykštukai;4169142642;Taip;3;0;0;3
18835;Švelnukas;Nykštukai;5097880045;Taip;4;0;2;6
18836;Švelnukas;Nykštukai;8572664468;Taip;0;0;4;4
18837;Švelnukas;Nykštukai;1983560609;Taip;9;0;0;9
18838;Švelnukas;Nykštukai;6135073159;Taip;7;4;1;12
18839;Švelnukas;Nykštukai;2507975729;Taip;4;0;0;4
18840;Švelnukas;Nykštukai;6731324414;Taip;10;0;0;10
18841;Švelnukas;Nykštukai;5066121542;Taip;7;0;2;9
18842;Švelnukas;Nykštukai;3173070733;Taip;0;6;0;6
18843;Boružėlė;"Nykštukai gudručiai";7736917485;Taip;0;23;0;23
18844;Boružėlė;"Nykštukai gudručiai";9520696660;Taip;0;1;0;1
18845;Boružėlė;"Nykštukai gudručiai";5691884576;Taip;2;7;0;9
18846;Boružėlė;"Nykštukai gudručiai";9193273478;Taip;0;1;1;2
18847;Boružėlė;"Nykštukai gudručiai";3237771499;Taip;2;8;0;10
18848;Boružėlė;"Nykštukai gudručiai";8359957290;Taip;0;4;0;4
18849;Boružėlė;"Nykštukai gudručiai";8141240094;Taip;0;0;14;14
18850;Boružėlė;"Nykštukai gudručiai";2349571778;Taip;0;2;0;2
18851;Boružėlė;"Nykštukai gudručiai";1894170218;Taip;4;1;0;5
18852;Boružėlė;"Nykštukai gudručiai";3509512899;Taip;11;0;0;11
18853;Boružėlė;"Nykštukai gudručiai";8888151470;Taip;11;0;0;11
18854;Boružėlė;"Nykštukai gudručiai";3430953692;Taip;0;7;0;7
18855;Boružėlė;"Nykštukai gudručiai";6166247730;Taip;0;1;0;1
18856;Boružėlė;"Nykštukai gudručiai";8365962523;Taip;0;1;7;8
18857;Boružėlė;"Nykštukai gudručiai";3592853535;Taip;0;5;0;5
18858;Boružėlė;"Nykštukai gudručiai";6876323023;Taip;0;3;0;3
18859;Boružėlė;"Nykštukai gudručiai";2744894565;Taip;0;5;0;5
18860;Boružėlė;"Nykštukai gudručiai";6590829182;Taip;0;2;1;3
18861;Boružėlė;"Nykštukai gudručiai";3129825206;Ne;0;5;0;5
18862;Boružėlė;"Nykštukai gudručiai";2571360077;Taip;0;1;0;1
18863;Boružėlė;"Nykštukai gudručiai";9078805020;Taip;0;2;0;2
18864;Boružėlė;"Saulės zuikučiai";4554260776;Taip;4;0;0;4
18865;Boružėlė;"Saulės zuikučiai";5298170118;Taip;0;5;0;5
18866;Boružėlė;"Saulės zuikučiai";2133849514;Taip;0;4;0;4
18867;Boružėlė;"Saulės zuikučiai";1116012068;Taip;0;1;0;1
18868;Boružėlė;"Saulės zuikučiai";1292298259;Taip;4;4;0;8
18869;Boružėlė;"Saulės zuikučiai";3130977416;Taip;0;6;0;6
18870;Boružėlė;"Saulės zuikučiai";7256396576;Taip;0;1;0;1
18871;Boružėlė;"Saulės zuikučiai";4323998138;Taip;19;0;0;19
18872;Boružėlė;"Saulės zuikučiai";2087238951;Taip;0;1;0;1
18873;Boružėlė;"Saulės zuikučiai";4509233532;Taip;0;4;0;4
18874;Boružėlė;"Saulės zuikučiai";3952645542;Taip;0;6;0;6
18875;Boružėlė;"Saulės zuikučiai";5516103398;Taip;10;0;0;10
18876;Boružėlė;"Saulės zuikučiai";1547802140;Taip;8;0;0;8
18877;Boružėlė;"Saulės zuikučiai";4020348640;Taip;7;0;0;7
18878;Boružėlė;"Saulės zuikučiai";2842256033;Taip;0;1;0;1
18879;Boružėlė;"Saulės zuikučiai";6527254253;Taip;5;4;0;9
18880;Boružėlė;"Saulės zuikučiai";7942043844;Taip;5;0;0;5
18881;Boružėlė;Gėlytės;3288141024;Taip;0;2;0;2
18882;Boružėlė;Gėlytės;1166207929;Taip;0;6;3;9
18883;Boružėlė;Gėlytės;7956982615;Taip;0;4;0;4
18884;Boružėlė;Gėlytės;4637656311;Taip;8;0;0;8
18885;Boružėlė;Gėlytės;3226733236;Taip;0;4;0;4
18886;Boružėlė;Gėlytės;6070356395;Taip;9;0;0;9
18887;Boružėlė;Gėlytės;4180537253;Taip;17;0;0;17
18888;Boružėlė;Gėlytės;6722353853;Taip;5;2;0;7
18889;Boružėlė;Gėlytės;8376436755;Taip;0;0;1;1
18890;Boružėlė;Gėlytės;3300678477;Taip;4;0;1;5
18891;Boružėlė;Gėlytės;7763958937;Taip;0;6;1;7
18892;Boružėlė;Gėlytės;9855354210;Taip;9;0;0;9
18893;Boružėlė;Gėlytės;3354291446;Taip;0;1;0;1
18894;Boružėlė;Gėlytės;8520403894;Taip;10;0;0;10
18895;Boružėlė;Gėlytės;7614216150;Taip;3;0;0;3
18896;Boružėlė;Gėlytės;4448964310;Taip;4;10;0;14
18897;Boružėlė;Gėlytės;8205706322;Taip;5;2;0;7
18898;Boružėlė;Gėlytės;8834231529;Taip;18;2;0;20
18899;Boružėlė;Gėlytės;8929444125;Taip;6;0;2;8
18900;Boružėlė;Gėlytės;3604658753;Taip;2;0;2;4
18901;Boružėlė;Gėlytės;9255292099;Taip;0;4;0;4
18902;Boružėlė;Smalsutis;2629139832;Taip;0;1;0;1
18903;Boružėlė;Smalsutis;6734750713;Taip;0;4;0;4
18904;Boružėlė;Smalsutis;5456349784;Taip;9;0;1;10
18905;Boružėlė;Smalsutis;9615931888;Taip;8;0;0;8
18906;Boružėlė;Smalsutis;9993823313;Taip;0;2;2;4
18907;Boružėlė;Smalsutis;5108107657;Taip;2;0;3;5
18908;Boružėlė;Smalsutis;3891448188;Taip;0;0;1;1
18909;Boružėlė;Smalsutis;4606274286;Taip;0;1;0;1
18910;Boružėlė;Smalsutis;8239372270;Taip;0;3;0;3
18911;Boružėlė;Smalsutis;7132100212;Taip;10;0;1;11
18912;Boružėlė;Smalsutis;6367963436;Taip;12;1;2;15
18913;Boružėlė;Smalsutis;5220224249;Taip;0;0;2;2
18914;Boružėlė;Smalsutis;1969793682;Taip;0;3;1;4
18915;Boružėlė;Smalsutis;6767206150;Taip;5;1;0;6
18916;Boružėlė;Smalsutis;4859297816;Taip;12;0;0;12
18917;Boružėlė;Smalsutis;6599359132;Taip;3;0;2;5
18918;Boružėlė;Smalsutis;7089148766;Taip;0;1;0;1
18919;Boružėlė;Drugeliai;8357946299;Taip;0;3;0;3
18920;Boružėlė;Drugeliai;1130980139;Taip;0;4;0;4
18921;Boružėlė;Drugeliai;6463583187;Taip;2;6;0;8
18922;Boružėlė;Drugeliai;3136028536;Taip;4;1;0;5
18923;Boružėlė;Drugeliai;2211576663;Taip;0;6;0;6
18924;Boružėlė;Drugeliai;1559001916;Taip;4;1;0;5
18925;Boružėlė;Drugeliai;9463322491;Taip;0;4;0;4
18926;Boružėlė;Drugeliai;3108758436;Taip;2;0;0;2
18927;Boružėlė;Drugeliai;6902130914;Taip;2;1;0;3
18928;Boružėlė;Drugeliai;6980022864;Taip;12;0;0;12
18929;Boružėlė;Drugeliai;7756929745;Taip;0;4;0;4
18930;Boružėlė;Drugeliai;5726187445;Taip;5;0;0;5
18931;Boružėlė;Drugeliai;2308405580;Taip;2;0;0;2
18932;Boružėlė;Drugeliai;6049501362;Taip;0;1;0;1
18933;Boružėlė;Drugeliai;3331238309;Taip;5;0;0;5
18934;Boružėlė;Drugeliai;2783338563;Taip;0;4;0;4
18935;Boružėlė;Drugeliai;3271262071;Taip;0;1;0;1
18936;Boružėlė;Vyturėliai;7934628014;Taip;6;0;1;7
18937;Boružėlė;Vyturėliai;7887412867;Taip;13;0;2;15
18938;Boružėlė;Vyturėliai;6233993159;Taip;3;0;2;5
18939;Boružėlė;Vyturėliai;6721005189;Taip;3;0;0;3
18940;Boružėlė;Vyturėliai;3991218067;Taip;15;2;0;17
18941;Boružėlė;Vyturėliai;3331139963;Taip;0;1;0;1
18942;Boružėlė;Vyturėliai;2104101406;Taip;0;2;0;2
18943;Boružėlė;Vyturėliai;8377410278;Taip;5;1;2;8
18944;Boružėlė;Vyturėliai;4928818565;Taip;4;4;1;9
18945;Boružėlė;Vyturėliai;5619719965;Taip;0;0;1;1
18946;Boružėlė;Vyturėliai;9822629428;Taip;4;0;0;4
18947;Boružėlė;Vyturėliai;9663535338;Taip;4;0;0;4
18948;Boružėlė;Vyturėliai;8073918985;Taip;4;1;0;5
18949;Boružėlė;Vyturėliai;3595998843;Taip;0;5;0;5
18950;Boružėlė;Vyturėliai;1047419932;Ne;12;1;0;13
18951;Boružėlė;Vyturėliai;1929202434;Taip;0;2;0;2
18952;Boružėlė;Vyturėliai;8165748779;Taip;6;1;5;12
18953;Boružėlė;Vyturėliai;7068409148;Taip;0;1;0;1
18954;Boružėlė;Vyturėliai;8434178580;Taip;11;0;0;11
18955;Boružėlė;Vyturėliai;2084361709;Taip;0;2;0;2
18956;Boružėlė;Vyturėliai;3281431237;Taip;10;0;2;12
18957;Boružėlė;Žvaigždutės;9838823214;Taip;0;4;0;4
18958;Boružėlė;Žvaigždutės;7901880926;Taip;0;1;1;2
18959;Boružėlė;Žvaigždutės;6242220139;Taip;3;4;0;7
18960;Boružėlė;Žvaigždutės;3489498503;Taip;5;5;0;10
18961;Boružėlė;Žvaigždutės;5274016839;Taip;0;4;0;4
18962;Boružėlė;Žvaigždutės;9720535449;Taip;0;1;0;1
18963;Boružėlė;Žvaigždutės;6435556131;Taip;0;1;0;1
18964;Boružėlė;Žvaigždutės;3140264242;Taip;0;4;0;4
18965;Boružėlė;Žvaigždutės;5307997577;Taip;0;1;0;1
18966;Boružėlė;Žvaigždutės;8916241914;Taip;3;2;0;5
18967;Boružėlė;Žvaigždutės;6724101421;Taip;0;2;2;4
18968;Boružėlė;Žvaigždutės;7078709057;Taip;0;4;0;4
18969;Boružėlė;Žvaigždutės;6972646373;Taip;0;1;0;1
18970;Boružėlė;Žvaigždutės;8820827882;Taip;5;6;0;11
18971;Boružėlė;Žvaigždutės;2857645329;Ne;0;1;0;1
18972;Boružėlė;Žvaigždutės;5242187638;Taip;0;2;0;2
18973;Boružėlė;Žvaigždutės;5420788580;Taip;0;7;0;7
18974;Boružėlė;Žvaigždutės;6130634131;Taip;0;7;0;7
18975;Boružėlė;Žvaigždutės;2075050639;Taip;11;0;0;11
18976;Boružėlė;Ąžuoliukai;1874865061;Taip;0;1;10;11
18977;Boružėlė;Ąžuoliukai;6820122408;Taip;0;6;0;6
18978;Boružėlė;Ąžuoliukai;6708666819;Taip;0;0;4;4
18979;Boružėlė;Ąžuoliukai;1237441386;Taip;0;0;1;1
18980;Boružėlė;Ąžuoliukai;5401338963;Taip;0;4;0;4
18981;Boružėlė;Ąžuoliukai;8734782540;Taip;0;6;9;15
18982;Boružėlė;Ąžuoliukai;7065907155;Taip;4;2;0;6
18983;Boružėlė;Ąžuoliukai;4113917886;Taip;0;9;2;11
18984;Boružėlė;Ąžuoliukai;1608652924;Taip;4;0;6;10
18985;Boružėlė;Ąžuoliukai;3005601935;Taip;0;6;14;20
18986;Boružėlė;Ąžuoliukai;8752343077;Taip;0;3;1;4
18987;Boružėlė;Ąžuoliukai;4727351240;Taip;9;3;1;13
18988;Boružėlė;Ąžuoliukai;4497753570;Taip;0;0;10;10
18989;Boružėlė;Ąžuoliukai;1865891989;Taip;0;2;2;4
18990;Boružėlė;Ąžuoliukai;8739264310;Taip;0;13;2;15
18991;Boružėlė;Ąžuoliukai;3097874340;Taip;0;2;2;4
18992;Boružėlė;Ąžuoliukai;7149439740;Taip;0;5;0;5
18993;Boružėlė;Ąžuoliukai;1630903587;Taip;0;0;13;13
18994;Boružėlė;Ąžuoliukai;9964146295;Taip;0;0;1;1
18995;Boružėlė;Ąžuoliukai;9544043839;Taip;0;0;1;1
18996;Boružėlė;Saulutės;9492548829;Taip;16;0;0;16
18997;Boružėlė;Saulutės;5437943626;Taip;5;6;0;11
18998;Boružėlė;Saulutės;3503931241;Taip;5;6;0;11
18999;Boružėlė;Saulutės;8882070834;Taip;9;0;0;9
19000;Boružėlė;Saulutės;2999335505;Taip;10;0;0;10
19001;Boružėlė;Saulutės;6265279517;Taip;5;4;0;9
19002;Boružėlė;Saulutės;6275425512;Taip;7;0;0;7
19003;Boružėlė;Saulutės;2879726579;Taip;9;8;0;17
19004;Boružėlė;Saulutės;8804878419;Taip;0;3;0;3
19005;Boružėlė;Saulutės;3871593172;Taip;0;3;0;3
19006;Boružėlė;Saulutės;3953507461;Taip;5;6;2;13
19007;Boružėlė;Saulutės;1492091211;Taip;0;1;0;1
19008;Boružėlė;Saulutės;1830043506;Taip;0;1;0;1
19009;Boružėlė;Saulutės;5680510186;Taip;0;10;0;10
19010;Boružėlė;Saulutės;1152697871;Taip;0;4;0;4
19011;Boružėlė;Saulutės;1779839709;Taip;0;6;0;6
19012;Boružėlė;Saulutės;7652740249;Taip;5;2;0;7
19013;Boružėlė;Saulutės;8577301586;Taip;0;5;0;5
19014;Boružėlė;Saulutės;8660954142;Taip;0;4;0;4
19015;Boružėlė;Saulutės;3093287452;Taip;0;2;0;2
19016;Boružėlė;Ežiukai;9342498392;Taip;6;0;0;6
19017;Boružėlė;Ežiukai;8195442951;Taip;8;5;0;13
19018;Boružėlė;Ežiukai;6448688592;Taip;0;10;0;10
19019;Boružėlė;Ežiukai;2429696310;Taip;5;5;0;10
19020;Boružėlė;Ežiukai;9893643199;Ne;0;4;0;4
19021;Boružėlė;Ežiukai;3112016309;Taip;5;0;0;5
19022;Boružėlė;Ežiukai;5394149649;Taip;5;0;0;5
19023;Boružėlė;Ežiukai;9391811395;Taip;0;4;0;4
19024;Boružėlė;Ežiukai;8167376712;Taip;0;10;0;10
19025;Boružėlė;Ežiukai;9423458813;Taip;9;1;0;10
19026;Boružėlė;Ežiukai;5825164520;Taip;0;0;2;2
19027;Boružėlė;Ežiukai;7190980006;Taip;0;2;0;2
19028;Boružėlė;Ežiukai;7459531236;Taip;8;1;0;9
19029;Boružėlė;Ežiukai;8818358360;Taip;8;1;0;9
19030;Boružėlė;Ežiukai;2926620929;Taip;5;1;0;6
19031;Boružėlė;Ežiukai;6609156790;Taip;0;4;0;4
19032;Boružėlė;Ežiukai;8291389794;Taip;9;0;0;9
19033;Boružėlė;Ežiukai;2524469162;Taip;6;0;0;6
19034;Boružėlė;Ežiukai;5492228053;Taip;0;1;0;1
19035;Boružėlė;Ežiukai;6087811262;Taip;0;2;0;2
19036;Boružėlė;Boružiukai;8944790932;Taip;15;0;0;15
19037;Boružėlė;Boružiukai;2298750617;Taip;3;0;0;3
19038;Boružėlė;Boružiukai;3097217902;Taip;9;2;0;11
19039;Boružėlė;Boružiukai;6026505923;Taip;4;0;0;4
19040;Boružėlė;Boružiukai;4771951587;Taip;0;4;0;4
19041;Boružėlė;Boružiukai;8868736347;Taip;0;8;0;8
19042;Boružėlė;Boružiukai;1070536820;Taip;0;0;2;2
19043;Boružėlė;Boružiukai;6856426845;Taip;5;0;0;5
19044;Boružėlė;Boružiukai;8512180544;Taip;2;2;0;4
19045;Boružėlė;Boružiukai;3209486458;Taip;0;6;0;6
19046;Boružėlė;Boružiukai;3972950428;Taip;0;1;0;1
19047;Boružėlė;Boružiukai;6010385301;Taip;0;1;0;1
19048;Boružėlė;Boružiukai;2304719318;Taip;0;2;0;2
19049;Boružėlė;Boružiukai;5667227930;Taip;5;0;0;5
19050;Boružėlė;Boružiukai;5545252373;Taip;0;8;0;8
19051;Boružėlė;Nykštukai;1966066642;Taip;6;4;0;10
19052;Boružėlė;Nykštukai;6267999965;Taip;0;10;0;10
19053;Boružėlė;Nykštukai;6776735311;Taip;10;1;0;11
19054;Boružėlė;Nykštukai;6221965115;Taip;11;0;0;11
19055;Boružėlė;Nykštukai;2657554726;Taip;0;4;0;4
19056;Boružėlė;Nykštukai;2930463607;Taip;6;0;0;6
19057;Boružėlė;Nykštukai;6529896335;Taip;0;9;0;9
19058;Boružėlė;Nykštukai;2730704495;Taip;6;5;0;11
19059;Boružėlė;Nykštukai;6273128752;Taip;12;0;0;12
19060;Boružėlė;Nykštukai;6733644286;Taip;3;0;3;6
19061;Boružėlė;Nykštukai;2984478360;Taip;10;4;0;14
19062;Boružėlė;Nykštukai;3471567359;Taip;6;0;0;6
19063;Boružėlė;Nykštukai;1444196386;Taip;13;0;0;13
19064;Boružėlė;Nykštukai;8970308091;Taip;9;1;0;10
19065;Boružėlė;Nykštukai;6330458151;Taip;3;1;1;5
19066;Žaliakalnio;Drugeliai;8056516915;Taip;7;5;0;12
19067;Žaliakalnio;Drugeliai;9106286038;Taip;12;0;0;12
19068;Žaliakalnio;Drugeliai;1004188539;Taip;7;0;0;7
19069;Žaliakalnio;Drugeliai;9762481841;Taip;6;0;0;6
19070;Žaliakalnio;Drugeliai;9710185940;Taip;9;4;0;13
19071;Žaliakalnio;Drugeliai;5626776693;Taip;13;0;0;13
19072;Žaliakalnio;Drugeliai;4945570058;Taip;12;0;0;12
19073;Žaliakalnio;Drugeliai;6521902343;Taip;9;4;0;13
19074;Žaliakalnio;Drugeliai;7351146376;Taip;4;0;0;4
19075;Žaliakalnio;Drugeliai;9790375448;Taip;10;1;0;11
19076;Žaliakalnio;Drugeliai;7966604753;Taip;9;0;0;9
19077;Žaliakalnio;Drugeliai;7078689014;Taip;11;0;0;11
19078;Žaliakalnio;Drugeliai;4642184038;Taip;5;0;0;5
19079;Žaliakalnio;Drugeliai;7229655569;Taip;8;2;0;10
19080;Žaliakalnio;Drugeliai;4888533074;Taip;10;4;0;14
19081;Žaliakalnio;Drugeliai;5305220570;Taip;6;0;0;6
19082;Žaliakalnio;Drugeliai;8852165484;Taip;6;0;4;10
19083;Žaliakalnio;Drugeliai;9167631614;Taip;11;0;0;11
19084;Žaliakalnio;Drugeliai;6166482260;Taip;6;3;0;9
19085;Žaliakalnio;Boružėlių;5843020412;Taip;0;10;0;10
19086;Žaliakalnio;Boružėlių;7087535800;Taip;0;4;0;4
19087;Žaliakalnio;Boružėlių;1528111839;Taip;0;5;0;5
19088;Žaliakalnio;Boružėlių;7023886811;Taip;15;4;0;19
19089;Žaliakalnio;Boružėlių;2284465378;Taip;8;0;0;8
19090;Žaliakalnio;Boružėlių;7977009681;Taip;0;4;0;4
19091;Žaliakalnio;Boružėlių;2808776865;Taip;0;4;0;4
19092;Žaliakalnio;Boružėlių;2278681435;Taip;0;12;0;12
19093;Žaliakalnio;Boružėlių;9421259943;Taip;6;1;0;7
19094;Žaliakalnio;Boružėlių;3105500733;Taip;0;4;0;4
19095;Žaliakalnio;Boružėlių;1200844791;Taip;4;1;0;5
19096;Žaliakalnio;Boružėlių;8052539476;Taip;0;19;0;19
19097;Žaliakalnio;Boružėlių;6590016097;Ne;0;4;0;4
19098;Žaliakalnio;Boružėlių;8304431519;Taip;14;0;0;14
19099;Žaliakalnio;Boružėlių;5488964606;Taip;17;0;0;17
19100;Žaliakalnio;Boružėlių;8429135626;Taip;0;14;0;14
19101;Žaliakalnio;Boružėlių;8073554707;Taip;6;6;0;12
19102;Žaliakalnio;Boružėlių;2987217910;Taip;0;9;0;9
19103;Žaliakalnio;Boružėlių;9032003195;Ne;0;9;0;9
19104;Žaliakalnio;Boružėlių;8715718525;Taip;13;0;0;13
19105;Žaliakalnio;Boružėlių;4961762841;Taip;9;0;0;9
19106;Žaliakalnio;Boružėlių;3027735957;Ne;7;5;0;12
19107;Žaliakalnio;Zuikučiai;3072808139;Taip;11;0;0;11
19108;Žaliakalnio;Zuikučiai;9382616403;Taip;5;0;0;5
19109;Žaliakalnio;Zuikučiai;2111418502;Taip;1;12;0;13
19110;Žaliakalnio;Zuikučiai;2654494663;Taip;14;0;0;14
19111;Žaliakalnio;Zuikučiai;8576412247;Taip;14;0;0;14
19112;Žaliakalnio;Zuikučiai;9317649996;Taip;9;0;0;9
19113;Žaliakalnio;Zuikučiai;6872615333;Taip;9;1;0;10
19114;Žaliakalnio;Zuikučiai;5645294219;Taip;9;1;0;10
19115;Žaliakalnio;Zuikučiai;4879096956;Taip;10;0;0;10
19116;Žaliakalnio;Zuikučiai;7258677907;Taip;9;4;0;13
19117;Žaliakalnio;Zuikučiai;5939383017;Taip;5;7;0;12
19118;Žaliakalnio;Zuikučiai;4231316753;Taip;14;2;0;16
19119;Žaliakalnio;Zuikučiai;9478722760;Taip;4;3;0;7
19120;Žaliakalnio;Zuikučiai;7099047041;Taip;9;0;0;9
19121;Žaliakalnio;Zuikučiai;9378617562;Taip;13;1;0;14
19122;Žaliakalnio;Zuikučiai;6659576919;Taip;6;4;0;10
19123;Žaliakalnio;Zuikučiai;7047556229;Taip;9;1;0;10
19124;Žaliakalnio;Zuikučiai;4563419248;Taip;12;4;0;16
19125;Žaliakalnio;Zuikučiai;3032513275;Taip;6;1;0;7
19126;Žaliakalnio;Zuikučiai;7495990953;Taip;15;0;0;15
19127;Žaliakalnio;Zuikučiai;5566009966;Ne;16;4;0;20
19128;Žaliakalnio;Bitutė;5744370516;Taip;8;0;0;8
19129;Žaliakalnio;Bitutė;3619817569;Taip;6;0;0;6
19130;Žaliakalnio;Bitutė;3905448562;Taip;5;10;0;15
19131;Žaliakalnio;Bitutė;8481665290;Ne;7;2;0;9
19132;Žaliakalnio;Bitutė;8950583202;Taip;4;1;0;5
19133;Žaliakalnio;Bitutė;6324315523;Taip;5;6;1;12
19134;Žaliakalnio;Bitutė;6877235095;Taip;7;3;0;10
19135;Žaliakalnio;Bitutė;2280683252;Ne;0;6;1;7
19136;Žaliakalnio;Bitutė;7711347723;Taip;7;0;0;7
19137;Žaliakalnio;Bitutė;4561672875;Taip;8;2;0;10
19138;Žaliakalnio;Bitutė;8185190219;Taip;9;0;0;9
19139;Žaliakalnio;Bitutė;7830692152;Taip;6;0;0;6
19140;Žaliakalnio;Bitutė;1423481154;Taip;0;6;0;6
19141;Žaliakalnio;Bitutė;4928400872;Taip;7;3;0;10
19142;Žaliakalnio;Bitutė;2613771302;Taip;6;1;0;7
19143;Žaliakalnio;Bitutė;8599646291;Taip;3;0;0;3
19144;Žaliakalnio;Bitutė;1343293430;Ne;4;1;0;5
19145;Žaliakalnio;Bitutė;3721878250;Ne;10;4;5;19
19146;Žaliakalnio;Bitutė;6291287113;Taip;5;2;0;7
19147;Žaliakalnio;Bitutė;1173977434;Taip;10;2;0;12
19148;Žaliakalnio;Bitutė;9485995178;Taip;0;7;0;7
19149;Žaliakalnio;Bitutė;8179329874;Ne;5;0;2;7
19150;Žaliakalnio;Bitutė;1309236035;Ne;10;0;0;10
19151;Žaliakalnio;Bitutė;8534973941;Taip;13;0;0;13
19152;Žaliakalnio;Nykštukų;9069518153;Taip;4;1;0;5
19153;Žaliakalnio;Nykštukų;8142435757;Taip;11;0;0;11
19154;Žaliakalnio;Nykštukų;3446593135;Taip;8;8;0;16
19155;Žaliakalnio;Nykštukų;1064854294;Taip;16;2;0;18
19156;Žaliakalnio;Nykštukų;4891656355;Ne;17;0;0;17
19157;Žaliakalnio;Nykštukų;1632465983;Taip;10;0;0;10
19158;Žaliakalnio;Nykštukų;8472945857;Taip;6;5;0;11
19159;Žaliakalnio;Nykštukų;9521104462;Taip;5;5;0;10
19160;Žaliakalnio;Nykštukų;5565027085;Ne;0;10;0;10
19161;Žaliakalnio;Nykštukų;2242604156;Ne;6;0;0;6
19162;Žaliakalnio;Nykštukų;9801618806;Taip;18;0;0;18
19163;Žaliakalnio;Nykštukų;2225778044;Taip;12;1;0;13
19164;Žaliakalnio;Nykštukų;4255734788;Taip;6;0;0;6
19165;Žaliakalnio;Nykštukų;7793937917;Taip;10;4;0;14
19166;Žaliakalnio;Nykštukų;8117013474;Ne;12;4;0;16
19167;Žaliakalnio;Nykštukų;7205368281;Taip;10;0;0;10
19168;Žaliakalnio;Nykštukų;4036239701;Taip;0;8;0;8
19169;Žaliakalnio;Nykštukų;5258266970;Taip;13;0;0;13
19170;Žaliakalnio;Nykštukų;3041002600;Taip;17;0;0;17
19171;Žaliakalnio;Nykštukų;7636933790;Taip;4;0;0;4
19172;Žaliakalnio;Nykštukų;4154737541;Taip;13;0;0;13
19173;Žaliakalnio;Nykštukų;2155412338;Taip;7;2;0;9
19174;Žaliakalnio;Nykštukų;1511302012;Taip;0;5;0;5
19175;Žaliakalnio;ŽIOGELIAI;2426844621;Ne;0;1;0;1
19176;Žaliakalnio;ŽIOGELIAI;5752912101;Ne;4;1;0;5
19177;Žaliakalnio;ŽIOGELIAI;9967098834;Ne;6;0;0;6
19178;Žaliakalnio;ŽIOGELIAI;1133557422;Taip;3;2;0;5
19179;Žaliakalnio;ŽIOGELIAI;3464935314;Taip;0;2;0;2
19180;Žaliakalnio;ŽIOGELIAI;7648422668;Ne;4;7;0;11
19181;Žaliakalnio;ŽIOGELIAI;4702470511;Taip;0;2;0;2
19182;Žaliakalnio;ŽIOGELIAI;2272043654;Taip;0;1;0;1
19183;Žaliakalnio;ŽIOGELIAI;8518422934;Taip;0;4;0;4
19184;Žaliakalnio;ŽIOGELIAI;6674631040;Taip;8;0;2;10
19185;Žaliakalnio;ŽIOGELIAI;8245784590;Taip;17;1;0;18
19186;Žaliakalnio;ŽIOGELIAI;8383425712;Ne;7;0;1;8
19187;Žaliakalnio;ŽIOGELIAI;7025195076;Taip;7;0;0;7
19188;Žaliakalnio;ŽIOGELIAI;2514763739;Ne;4;4;0;8
19189;Žaliakalnio;ŽIOGELIAI;8891815592;Ne;6;0;0;6
19190;Žaliakalnio;ŽIOGELIAI;6294045755;Taip;0;4;0;4
19191;Žaliakalnio;ŽIOGELIAI;8232697563;Taip;5;3;0;8
19192;Žaliakalnio;ŽIOGELIAI;2694424532;Taip;10;3;0;13
19193;Žaliakalnio;ŽIOGELIAI;6136717862;Ne;5;0;0;5
19194;Žaliakalnio;ŽIOGELIAI;8316505307;Taip;2;5;0;7
19195;Žaliakalnio;ŽIOGELIAI;8568306789;Ne;0;1;0;1
19196;Žaliakalnio;ŽIOGELIAI;9383567339;Taip;3;3;0;6
19197;Žaliakalnio;SAULUTĖS;1253655689;Taip;0;4;0;4
19198;Žaliakalnio;SAULUTĖS;3016537413;Taip;6;6;0;12
19199;Žaliakalnio;SAULUTĖS;6795532166;Taip;8;1;0;9
19200;Žaliakalnio;SAULUTĖS;7913029369;Taip;8;0;0;8
19201;Žaliakalnio;SAULUTĖS;7793917852;Taip;3;5;0;8
19202;Žaliakalnio;SAULUTĖS;3018398546;Taip;12;4;0;16
19203;Žaliakalnio;SAULUTĖS;8765159796;Taip;0;9;0;9
19204;Žaliakalnio;SAULUTĖS;3028921540;Taip;4;7;0;11
19205;Žaliakalnio;SAULUTĖS;4355433666;Taip;5;3;0;8
19206;Žaliakalnio;SAULUTĖS;9016032548;Taip;0;1;0;1
19207;Žaliakalnio;SAULUTĖS;1715385224;Taip;23;0;0;23
19208;Žaliakalnio;SAULUTĖS;3304186400;Taip;9;9;0;18
19209;Žaliakalnio;SAULUTĖS;3832291926;Taip;1;2;0;3
19210;Žaliakalnio;SAULUTĖS;7071209465;Taip;18;0;0;18
19211;Žaliakalnio;SAULUTĖS;7543073516;Taip;11;3;0;14
19212;Žaliakalnio;SAULUTĖS;9379373983;Taip;0;4;0;4
19213;Žaliakalnio;SAULUTĖS;2806386840;Taip;10;0;0;10
19214;Žaliakalnio;SAULUTĖS;9267349375;Taip;9;0;0;9
19215;Žaliakalnio;SAULUTĖS;7989372873;Ne;5;4;0;9
19216;Žaliakalnio;SAULUTĖS;4412760433;Taip;8;4;0;12
19217;Žaliakalnio;SAULUTĖS;4177369871;Taip;0;1;0;1
19218;Volungė;Bitutės;6661730121;Taip;3;0;0;3
19219;Volungė;Bitutės;5791161943;Taip;0;1;1;2
19220;Volungė;Bitutės;3307326410;Taip;9;4;1;14
19221;Volungė;Bitutės;5300334761;Taip;6;4;0;10
19222;Volungė;Bitutės;6755366051;Taip;4;0;1;5
19223;Volungė;Bitutės;4013639324;Taip;0;3;1;4
19224;Volungė;Bitutės;2599441104;Taip;0;0;3;3
19225;Volungė;Bitutės;5892600735;Taip;0;4;1;5
19226;Volungė;Bitutės;1902122510;Taip;10;1;1;12
19227;Volungė;Bitutės;1752817125;Taip;10;4;1;15
19228;Volungė;Bitutės;3515725398;Taip;5;4;0;9
19229;Volungė;Bitutės;3666364101;Taip;0;0;4;4
19230;Volungė;Bitutės;7151952679;Taip;0;4;2;6
19231;Volungė;Bitutės;5960027749;Taip;0;4;6;10
19232;Volungė;Bitutės;9842009354;Taip;8;1;0;9
19233;Volungė;Bitutės;4437625791;Taip;8;0;0;8
19234;Volungė;Boružiukai;6445614647;Taip;4;0;0;4
19235;Volungė;Boružiukai;9382043452;Taip;3;0;0;3
19236;Volungė;Boružiukai;5650558154;Taip;6;0;0;6
19237;Volungė;Boružiukai;6127398531;Taip;0;0;1;1
19238;Volungė;Boružiukai;1592634034;Taip;0;9;0;9
19239;Volungė;Boružiukai;5588544003;Taip;0;4;2;6
19240;Volungė;Boružiukai;3758750922;Taip;0;4;13;17
19241;Volungė;Boružiukai;3460701723;Taip;0;1;0;1
19242;Volungė;Boružiukai;5561683986;Taip;12;0;0;12
19243;Volungė;Boružiukai;9562426487;Taip;7;1;4;12
19244;Volungė;Boružiukai;4664635246;Taip;6;0;0;6
19245;Volungė;Boružiukai;8987748481;Taip;8;0;0;8
19246;Volungė;Boružiukai;5882826586;Taip;0;5;0;5
19247;Volungė;Boružiukai;6969633765;Taip;4;0;0;4
19248;Volungė;Boružiukai;5338942678;Taip;4;8;0;12
19249;Volungė;Žvirbliukai;2360026330;Taip;9;1;0;10
19250;Volungė;Žvirbliukai;8414351815;Ne;9;0;1;10
19251;Volungė;Žvirbliukai;2051410463;Taip;12;1;0;13
19252;Volungė;Žvirbliukai;5074093178;Taip;4;2;0;6
19253;Volungė;Žvirbliukai;5750385275;Taip;9;1;1;11
19254;Volungė;Žvirbliukai;9575894080;Taip;0;0;8;8
19255;Volungė;Žvirbliukai;8927595898;Taip;10;4;0;14
19256;Volungė;Žvirbliukai;9384821249;Taip;10;0;0;10
19257;Volungė;Žvirbliukai;5361410157;Taip;2;4;8;14
19258;Volungė;Žvirbliukai;4235842588;Taip;0;0;2;2
19259;Volungė;Žvirbliukai;3028611395;Taip;10;1;0;11
19260;Volungė;Žvirbliukai;2949033093;Ne;0;1;1;2
19261;Volungė;Žvirbliukai;2159667991;Taip;9;0;10;19
19262;Volungė;Žvirbliukai;5470252589;Taip;0;0;6;6
19263;Volungė;Žvirbliukai;7923029388;Taip;0;4;3;7
19264;Volungė;Žvirbliukai;1022606584;Taip;5;3;0;8
19265;Volungė;Žvirbliukai;8894121428;Taip;4;3;0;7
19266;Volungė;Žvirbliukai;9139746132;Taip;5;0;1;6
19267;Volungė;Žiogeliai;6360834021;Taip;0;4;1;5
19268;Volungė;Žiogeliai;4856240879;Taip;0;4;8;12
19269;Volungė;Žiogeliai;4694016281;Taip;4;4;4;12
19270;Volungė;Žiogeliai;9816038480;Taip;5;0;0;5
19271;Volungė;Žiogeliai;8640511964;Taip;0;4;0;4
19272;Volungė;Žiogeliai;5170536566;Taip;4;3;1;8
19273;Volungė;Žiogeliai;8421730419;Taip;2;4;3;9
19274;Volungė;Žiogeliai;6532202782;Taip;14;4;1;19
19275;Volungė;Žiogeliai;2712034356;Taip;7;4;0;11
19276;Volungė;Žiogeliai;2246291631;Taip;10;4;0;14
19277;Volungė;Žiogeliai;2456643081;Taip;6;4;0;10
19278;Volungė;Žiogeliai;6920821813;Taip;5;4;0;9
19279;Volungė;Žiogeliai;8299305464;Taip;15;0;2;17
19280;Volungė;Žiogeliai;1781838937;Taip;0;4;3;7
19281;Volungė;Žiogeliai;1988082807;Taip;0;4;0;4
19282;Volungė;Žiogeliai;3091641738;Ne;0;4;1;5
19283;Volungė;Žiogeliai;8578521969;Taip;6;3;0;9
19284;Volungė;Žiogeliai;5710662590;Taip;4;4;0;8
19285;Volungė;Žiogeliai;4839484528;Taip;11;4;0;15
19286;Volungė;Žiogeliai;5174427959;Taip;4;2;0;6
19287;Volungė;Žiogeliai;7281448136;Taip;0;4;1;5
19288;Volungė;Žiogeliai;2187800215;Taip;0;4;1;5
19289;Volungė;Pelėdžiukai;3528581949;Taip;0;0;8;8
19290;Volungė;Pelėdžiukai;1137713075;Taip;0;4;0;4
19291;Volungė;Pelėdžiukai;2322594823;Taip;4;0;3;7
19292;Volungė;Pelėdžiukai;7965601199;Taip;0;4;1;5
19293;Volungė;Pelėdžiukai;2603335248;Taip;5;0;0;5
19294;Volungė;Pelėdžiukai;3746978206;Taip;0;4;0;4
19295;Volungė;Pelėdžiukai;1974650443;Taip;0;1;0;1
19296;Volungė;Pelėdžiukai;2068447339;Taip;0;23;0;23
19297;Volungė;Pelėdžiukai;9188994935;Taip;0;11;0;11
19298;Volungė;Pelėdžiukai;1757041481;Taip;0;0;3;3
19299;Volungė;Pelėdžiukai;8285309230;Taip;0;4;2;6
19300;Volungė;Pelėdžiukai;7149986415;Taip;0;3;1;4
19301;Volungė;Pelėdžiukai;4598763851;Taip;0;4;1;5
19302;Volungė;Pelėdžiukai;9677732243;Taip;0;6;0;6
19303;Volungė;Pelėdžiukai;2627555750;Taip;0;0;3;3
19304;Volungė;Pelėdžiukai;7867741556;Taip;0;0;5;5
19305;Volungė;Pelėdžiukai;7971287899;Ne;1;16;1;18
19306;Volungė;Pelėdžiukai;9729285419;Ne;0;0;3;3
19307;Volungė;Pelėdžiukai;9343118795;Taip;0;1;0;1
19308;Volungė;Pelėdžiukai;8459167833;Taip;0;4;1;5
19309;Volungė;Drugeliai;6280208510;Taip;5;4;0;9
19310;Volungė;Drugeliai;4032261812;Taip;0;4;0;4
19311;Volungė;Drugeliai;6488473384;Taip;13;0;0;13
19312;Volungė;Drugeliai;8045459660;Taip;9;1;1;11
19313;Volungė;Drugeliai;1402200673;Taip;9;1;1;11
19314;Volungė;Drugeliai;7574856429;Taip;0;1;0;1
19315;Volungė;Drugeliai;4427076715;Taip;0;2;0;2
19316;Volungė;Drugeliai;2686827560;Taip;0;0;1;1
19317;Volungė;Drugeliai;9973604148;Taip;0;0;9;9
19318;Volungė;Drugeliai;8905401944;Taip;4;0;0;4
19319;Volungė;Drugeliai;2923810441;Ne;0;4;0;4
19320;Volungė;Drugeliai;6782622442;Taip;0;0;3;3
19321;Volungė;Drugeliai;3020629341;Taip;4;1;0;5
19322;Volungė;Drugeliai;4252713086;Taip;0;1;5;6
19323;Volungė;Drugeliai;2530804242;Taip;0;0;1;1
19324;Volungė;Drugeliai;5354511593;Taip;0;0;3;3
19325;Volungė;Drugeliai;4745609424;Taip;0;2;1;3
19326;Volungė;Drugeliai;7584598377;Taip;0;3;1;4
19327;Volungė;"SKRUZDĖLIUKAI ";3394646139;Taip;9;9;0;18
19328;Volungė;"SKRUZDĖLIUKAI ";4223287277;Taip;2;1;2;5
19329;Volungė;"SKRUZDĖLIUKAI ";6464890465;Taip;7;0;1;8
19330;Volungė;"SKRUZDĖLIUKAI ";2493541457;Taip;14;2;0;16
19331;Volungė;"SKRUZDĖLIUKAI ";1948015523;Taip;5;0;0;5
19332;Volungė;"SKRUZDĖLIUKAI ";1101228927;Taip;11;1;0;12
19333;Volungė;"SKRUZDĖLIUKAI ";5332306628;Taip;14;0;0;14
19334;Volungė;"SKRUZDĖLIUKAI ";9319825151;Taip;12;4;0;16
19335;Volungė;"SKRUZDĖLIUKAI ";6370584522;Taip;4;3;0;7
19336;Volungė;"SKRUZDĖLIUKAI ";8168630107;Taip;0;6;0;6
19337;Volungė;"SKRUZDĖLIUKAI ";8992514683;Taip;2;4;1;7
19338;Volungė;"SKRUZDĖLIUKAI ";5833091791;Taip;5;2;0;7
19339;Volungė;"SKRUZDĖLIUKAI ";5994884455;Taip;5;2;0;7
19340;Volungė;"SKRUZDĖLIUKAI ";3818924175;Taip;6;5;5;16
19341;Volungė;"SKRUZDĖLIUKAI ";8244731771;Taip;0;4;0;4
19342;Volungė;"SKRUZDĖLIUKAI ";6110117105;Taip;0;2;4;6
19343;Volungė;"SKRUZDĖLIUKAI ";4944556574;Taip;7;4;1;12
19344;Volungė;"SKRUZDĖLIUKAI ";2212423676;Taip;0;0;1;1
19345;Volungė;"SKRUZDĖLIUKAI ";5942497397;Taip;5;5;0;10
19346;Volungė;"SKRUZDĖLIUKAI ";4991465781;Taip;7;0;0;7
19347;Volungė;"SKRUZDĖLIUKAI ";8613580206;Taip;5;0;0;5
19348;Volungė;Zylutės;1040993908;Taip;12;0;0;12
19349;Volungė;Zylutės;6715770777;Taip;9;0;0;9
19350;Volungė;Zylutės;2874194121;Taip;4;0;0;4
19351;Volungė;Zylutės;4363877851;Taip;6;2;0;8
19352;Volungė;Zylutės;1877753679;Taip;13;0;0;13
19353;Volungė;Zylutės;9005691348;Taip;13;0;0;13
19354;Volungė;Zylutės;2765042584;Taip;10;0;4;14
19355;Volungė;Zylutės;7754202158;Taip;11;0;0;11
19356;Volungė;Zylutės;9519564424;Taip;10;0;0;10
19357;Volungė;Zylutės;5497911485;Taip;17;0;0;17
19358;Volungė;Zylutės;5345072950;Taip;9;0;1;10
19359;Volungė;Zylutės;3042694602;Taip;7;0;0;7
19360;Volungė;Zylutės;2404239677;Taip;3;0;0;3
19361;Giliukas;SMALSUČIAI;9462634699;Taip;4;0;0;4
19362;Giliukas;SMALSUČIAI;7646966187;Taip;3;4;0;7
19363;Giliukas;SMALSUČIAI;9287193955;Taip;8;2;0;10
19364;Giliukas;SMALSUČIAI;7944198886;Taip;4;0;0;4
19365;Giliukas;SMALSUČIAI;5527212334;Taip;5;0;0;5
19366;Giliukas;SMALSUČIAI;9499591494;Taip;6;1;0;7
19367;Giliukas;SMALSUČIAI;2099575372;Taip;10;0;2;12
19368;Giliukas;SMALSUČIAI;7195772641;Taip;11;0;0;11
19369;Giliukas;SMALSUČIAI;4258921446;Taip;4;4;0;8
19370;Giliukas;SMALSUČIAI;1439350058;Taip;6;0;0;6
19371;Giliukas;SMALSUČIAI;4843920452;Taip;1;0;0;1
19372;Giliukas;SMALSUČIAI;2004782696;Taip;1;1;0;2
19373;Giliukas;SMALSUČIAI;8977247073;Taip;2;0;0;2
19374;Giliukas;SMALSUČIAI;9475918013;Taip;3;0;0;3
19375;Giliukas;SMALSUČIAI;9229086918;Taip;10;0;0;10
19376;Giliukas;SMALSUČIAI;8147492951;Taip;11;0;0;11
19377;Giliukas;SMALSUČIAI;2349166172;Taip;8;0;0;8
19378;Giliukas;SMALSUČIAI;8241215831;Taip;19;0;2;21
19379;Giliukas;GUDRUČIAI;9458262379;Taip;1;0;0;1
19380;Giliukas;GUDRUČIAI;6148883070;Taip;3;4;0;7
19381;Giliukas;GUDRUČIAI;8666628432;Taip;2;0;0;2
19382;Giliukas;GUDRUČIAI;7425654504;Taip;2;8;0;10
19383;Giliukas;GUDRUČIAI;7130696530;Taip;6;0;0;6
19384;Giliukas;GUDRUČIAI;6422178450;Ne;0;2;0;2
19385;Giliukas;GUDRUČIAI;3150981084;Taip;0;6;0;6
19386;Giliukas;GUDRUČIAI;6134554678;Taip;4;4;0;8
19387;Giliukas;GUDRUČIAI;3137768675;Taip;2;0;0;2
19388;Giliukas;GUDRUČIAI;2064182165;Taip;4;0;0;4
19389;Giliukas;GUDRUČIAI;6956862865;Taip;0;1;0;1
19390;Giliukas;GUDRUČIAI;9617542456;Taip;10;1;0;11
19391;Giliukas;GUDRUČIAI;3718774263;Taip;12;0;0;12
19392;Giliukas;GUDRUČIAI;9152432124;Taip;12;0;0;12
19393;Giliukas;GUDRUČIAI;4854370266;Ne;0;2;0;2
19394;Giliukas;GUDRUČIAI;6703080106;Taip;0;4;0;4
19395;Giliukas;GUDRUČIAI;4347883309;Taip;0;3;0;3
19396;Giliukas;PABIRUČIAI;4183026763;Taip;0;1;0;1
19397;Giliukas;PABIRUČIAI;4247090684;Taip;9;0;0;9
19398;Giliukas;PABIRUČIAI;2379370477;Taip;0;7;0;7
19399;Giliukas;PABIRUČIAI;3054591644;Taip;2;0;0;2
19400;Giliukas;PABIRUČIAI;3870143024;Taip;9;0;1;10
19401;Giliukas;PABIRUČIAI;6914013230;Taip;1;0;1;2
19402;Giliukas;PABIRUČIAI;7013767174;Ne;3;1;0;4
19403;Giliukas;PABIRUČIAI;4105974682;Taip;0;4;0;4
19404;Giliukas;PABIRUČIAI;8874804636;Taip;9;0;0;9
19405;Giliukas;PABIRUČIAI;8626920684;Taip;5;0;0;5
19406;Giliukas;PABIRUČIAI;7012272912;Taip;1;0;0;1
19407;Giliukas;PABIRUČIAI;2229737837;Taip;4;0;1;5
19408;Giliukas;PABIRUČIAI;1075275967;Taip;0;0;2;2
19409;Giliukas;PABIRUČIAI;3268682615;Taip;4;0;0;4
19410;Giliukas;PABIRUČIAI;4838600191;Taip;0;20;0;20
19411;Giliukas;PABIRUČIAI;1395779355;Taip;0;5;0;5
19412;Giliukas;PABIRUČIAI;7541075946;Taip;7;0;2;9
19413;Giliukas;ŠVELNUKAI;9360994563;Taip;4;0;0;4
19414;Giliukas;ŠVELNUKAI;2012365132;Taip;7;0;0;7
19415;Giliukas;ŠVELNUKAI;4565216956;Taip;6;0;1;7
19416;Giliukas;ŠVELNUKAI;5834233526;Taip;4;0;0;4
19417;Giliukas;ŠVELNUKAI;5000654626;Taip;0;5;0;5
19418;Giliukas;ŠVELNUKAI;8973584424;Taip;4;0;0;4
19419;Giliukas;ŠVELNUKAI;9679421414;Taip;19;0;1;20
19420;Giliukas;ŠVELNUKAI;2881704755;Taip;4;0;0;4
19421;Giliukas;ŠVELNUKAI;4340602792;Taip;5;1;0;6
19422;Giliukas;ŠVELNUKAI;6563305502;Taip;1;6;0;7
19423;Giliukas;ŠVELNUKAI;4301950538;Taip;15;0;0;15
19424;Giliukas;ŠVELNUKAI;7657935162;Taip;6;0;0;6
19425;Giliukas;ŽINIUKAI;2502801547;Taip;12;7;0;19
19426;Giliukas;ŽINIUKAI;2562809633;Taip;8;4;0;12
19427;Giliukas;ŽINIUKAI;5326178821;Ne;5;14;0;19
19428;Giliukas;ŽINIUKAI;5201020765;Taip;12;7;0;19
19429;Giliukas;ŽINIUKAI;2042324002;Taip;3;1;0;4
19430;Giliukas;ŽINIUKAI;2801731379;Taip;10;6;0;16
19431;Giliukas;ŽINIUKAI;8499893356;Ne;1;15;0;16
19432;Giliukas;ŽINIUKAI;9205911152;Taip;10;0;0;10
19433;Giliukas;ŽINIUKAI;3720032249;Taip;10;0;0;10
19434;Giliukas;ŽINIUKAI;3659105022;Taip;0;1;0;1
19435;Giliukas;ŽINIUKAI;4940718205;Taip;13;2;0;15
19436;Giliukas;ŽINIUKAI;8491008130;Taip;21;1;0;22
19437;Giliukas;ŽINIUKAI;4163383707;Taip;17;0;0;17
19438;Giliukas;ŽINIUKAI;1332725572;Taip;9;6;0;15
19439;Giliukas;ŽINIUKAI;2798676079;Taip;0;4;0;4
19440;Giliukas;ŽINIUKAI;4404761569;Taip;10;0;0;10
19441;Giliukas;ŽINIUKAI;1915809569;Taip;0;6;0;6
19442;Giliukas;ŽINIUKAI;2787116787;Taip;0;6;0;6
19443;Giliukas;MYLIMUKAI;7481387658;Taip;4;0;0;4
19444;Giliukas;MYLIMUKAI;7290236898;Taip;17;0;0;17
19445;Giliukas;MYLIMUKAI;2045566679;Taip;2;0;0;2
19446;Giliukas;MYLIMUKAI;8012946026;Taip;14;0;0;14
19447;Giliukas;MYLIMUKAI;7406406981;Taip;0;1;4;5
19448;Giliukas;MYLIMUKAI;2169949712;Taip;8;3;0;11
19449;Giliukas;MYLIMUKAI;5467076457;Taip;2;0;0;2
19450;Giliukas;MYLIMUKAI;2109668106;Taip;16;0;0;16
19451;Giliukas;MYLIMUKAI;6650117646;Taip;1;0;0;1
19452;Giliukas;MYLIMUKAI;5199968458;Taip;7;0;0;7
19453;Giliukas;MYLIMUKAI;3185622470;Taip;11;0;1;12
19454;Giliukas;MYLIMUKAI;8414652507;Taip;23;0;0;23
19455;Giliukas;MYLIMUKAI;7560774044;Taip;5;0;0;5
19456;Giliukas;ČIAUŠKUČIAI;8701216181;Taip;4;1;0;5
19457;Giliukas;ČIAUŠKUČIAI;6742406486;Taip;10;0;0;10
19458;Giliukas;ČIAUŠKUČIAI;9556962586;Ne;7;0;0;7
19459;Giliukas;ČIAUŠKUČIAI;2840410579;Taip;15;3;0;18
19460;Giliukas;ČIAUŠKUČIAI;7316126011;Taip;0;1;4;5
19461;Giliukas;ČIAUŠKUČIAI;9134734376;Taip;11;0;1;12
19462;Giliukas;ČIAUŠKUČIAI;3728323646;Taip;31;0;0;31
19463;Giliukas;ČIAUŠKUČIAI;1710286878;Ne;15;0;3;18
19464;Giliukas;ČIAUŠKUČIAI;9704885611;Taip;0;0;1;1
19465;Giliukas;ČIAUŠKUČIAI;7993049824;Taip;21;0;1;22
19466;Giliukas;ČIAUŠKUČIAI;2700296404;Taip;0;0;1;1
19467;Giliukas;ČIAUŠKUČIAI;9160815037;Taip;4;1;1;6
19468;Giliukas;ČIAUŠKUČIAI;1221640023;Taip;5;1;6;12
19469;Giliukas;ČIAUŠKUČIAI;2298554837;Ne;4;0;7;11
19470;Giliukas;ŠNEKUČIAI;1762536884;Taip;4;6;0;10
19471;Giliukas;ŠNEKUČIAI;2612551188;Taip;1;0;0;1
19472;Giliukas;ŠNEKUČIAI;9366734581;Taip;11;2;0;13
19473;Giliukas;ŠNEKUČIAI;7053406257;Taip;10;0;0;10
19474;Giliukas;ŠNEKUČIAI;2226855971;Taip;1;1;0;2
19475;Giliukas;ŠNEKUČIAI;2742106493;Taip;1;3;0;4
19476;Giliukas;ŠNEKUČIAI;3726149759;Taip;8;0;0;8
19477;Giliukas;ŠNEKUČIAI;6748766233;Taip;3;0;0;3
19478;Giliukas;ŠNEKUČIAI;6953123617;Taip;0;4;0;4
19479;Giliukas;ŠNEKUČIAI;5222092567;Taip;8;0;0;8
19480;Giliukas;ŠNEKUČIAI;5300517567;Taip;3;0;0;3
19481;Giliukas;ŠNEKUČIAI;3055598917;Taip;8;0;0;8
19482;Giliukas;ŠNEKUČIAI;4581414740;Taip;6;2;0;8
19483;Giliukas;ŠNEKUČIAI;7431116067;Taip;1;0;0;1
19484;Giliukas;ŠNEKUČIAI;7205807049;Taip;15;0;0;15
19485;Giliukas;ŠNEKUČIAI;1165810193;Taip;17;0;0;17
19486;Giliukas;ŠNEKUČIAI;1916905497;Taip;7;1;0;8
19487;Giliukas;ŠNEKUČIAI;5625404051;Taip;6;0;0;6
19488;"Lazdynų mokykla (Žėručio g. 4)";LEPG;7487278074;Taip;0;3;1;4
19489;"Lazdynų mokykla (Žėručio g. 4)";LEPG;7320049068;Taip;4;4;1;9
19490;"Lazdynų mokykla (Žėručio g. 4)";LEPG;1396367371;Taip;0;4;1;5
19491;"Lazdynų mokykla (Žėručio g. 4)";LEPG;7324846434;Taip;10;4;0;14
19492;"Lazdynų mokykla (Žėručio g. 4)";LEPG;7659209862;Taip;6;4;1;11
19493;"Lazdynų mokykla (Žėručio g. 4)";LEPG;9654428418;Taip;0;3;0;3
19494;"Lazdynų mokykla (Žėručio g. 4)";LEPG;3435025978;Taip;6;4;1;11
19495;"Lazdynų mokykla (Žėručio g. 4)";LEPG;5420067622;Taip;0;3;0;3
19496;"Lazdynų mokykla (Žėručio g. 4)";LEPG;1738732866;Taip;0;4;1;5
19497;"Lazdynų mokykla (Žėručio g. 4)";LEPG;2059342403;Ne;0;3;0;3
19498;"Lazdynų mokykla (Žėručio g. 4)";LEPG;3268305561;Taip;0;3;0;3
19499;"Lazdynų mokykla (Žėručio g. 4)";LEPG;4562536818;Taip;0;3;0;3
19500;"Lazdynų mokykla (Žėručio g. 4)";LEPG;8990701154;Taip;0;3;0;3
19501;"Lazdynų mokykla (Žėručio g. 4)";LEPG;2666441234;Taip;5;3;0;8
19502;"Lazdynų mokykla (Žėručio g. 4)";LEPG;9382900638;Ne;16;4;0;20
19503;"Lazdynų mokykla (Žėručio g. 4)";LEPG;1624578455;Ne;16;4;0;20
19504;"Lazdynų mokykla (Žėručio g. 4)";RUPG-1;4776074273;Taip;0;4;0;4
19505;"Lazdynų mokykla (Žėručio g. 4)";RUPG-1;2004786841;Taip;0;23;0;23
19506;"Lazdynų mokykla (Žėručio g. 4)";RUPG-1;7110858765;Taip;0;4;0;4
19507;"Lazdynų mokykla (Žėručio g. 4)";RUPG-1;6577255841;Taip;2;14;0;16
19508;"Lazdynų mokykla (Žėručio g. 4)";RUPG-1;7647195979;Ne;0;4;0;4
19509;"Lazdynų mokykla (Žėručio g. 4)";RUPG-1;4715171946;Taip;3;4;0;7
19510;"Lazdynų mokykla (Žėručio g. 4)";RUPG-1;2700475528;Taip;0;4;0;4
19511;"Lazdynų mokykla (Žėručio g. 4)";RUPG-1;7180617984;Taip;2;4;0;6
19512;"Lazdynų mokykla (Žėručio g. 4)";RUPG-1;2308739823;Taip;0;4;0;4
19513;"Lazdynų mokykla (Žėručio g. 4)";RUPG-1;5015519090;Taip;0;4;0;4
19514;"Lazdynų mokykla (Žėručio g. 4)";RUPG-1;9968637187;Ne;8;4;0;12
19515;"Lazdynų mokykla (Žėručio g. 4)";RUPG-1;8886654664;Taip;7;4;0;11
19516;"Lazdynų mokykla (Žėručio g. 4)";RUPG-1;1351714626;Taip;0;4;0;4
19517;"Lazdynų mokykla (Žėručio g. 4)";RUPG-1;4494932923;Taip;0;4;0;4
19518;"Lazdynų mokykla (Žėručio g. 4)";RUPG-1;2035060922;Taip;0;4;0;4
19519;"Lazdynų mokykla (Žėručio g. 4)";RUPG-2;3837424301;Taip;0;4;0;4
19520;"Lazdynų mokykla (Žėručio g. 4)";RUPG-2;8720878006;Taip;0;23;0;23
19521;"Lazdynų mokykla (Žėručio g. 4)";RUPG-2;8675089149;Taip;0;4;0;4
19522;"Lazdynų mokykla (Žėručio g. 4)";RUPG-2;7963866641;Taip;0;4;0;4
19523;"Lazdynų mokykla (Žėručio g. 4)";RUPG-2;9982496951;Taip;0;4;0;4
19524;"Lazdynų mokykla (Žėručio g. 4)";RUPG-2;8229454863;Taip;0;4;0;4
19525;"Lazdynų mokykla (Žėručio g. 4)";RUPG-2;1118653070;Taip;0;9;0;9
19526;"Lazdynų mokykla (Žėručio g. 4)";RUPG-2;5806696915;Taip;2;4;0;6
19527;"Lazdynų mokykla (Žėručio g. 4)";RUPG-2;3634678954;Taip;0;4;0;4
19528;"Lazdynų mokykla (Žėručio g. 4)";RUPG-2;5770044886;Taip;6;5;0;11
19529;"Lazdynų mokykla (Žėručio g. 4)";RUPG-2;2539006620;Taip;0;23;0;23
19530;"Lazdynų mokykla (Žėručio g. 4)";RUPG-2;8757701456;Taip;0;14;0;14
19531;"Lazdynų mokykla (Žėručio g. 4)";RUPG-2;4165354124;Taip;0;4;0;4
19532;"Lazdynų mokykla (Žėručio g. 4)";RUPG-2;9534937419;Taip;5;4;0;9
19533;"„Atžalyno” mokykla-darželis";Giliukai;7652421432;Taip;0;1;0;1
19534;"„Atžalyno” mokykla-darželis";Giliukai;1961428224;Taip;0;20;0;20
19535;"„Atžalyno” mokykla-darželis";Giliukai;9101301819;Ne;4;4;1;9
19536;"„Atžalyno” mokykla-darželis";Giliukai;8320161812;Taip;0;4;2;6
19537;"„Atžalyno” mokykla-darželis";Giliukai;4784990018;Taip;7;4;1;12
19538;"„Atžalyno” mokykla-darželis";Giliukai;2462839180;Taip;1;0;1;2
19539;"„Atžalyno” mokykla-darželis";Giliukai;8070499557;Taip;0;1;8;9
19540;"„Atžalyno” mokykla-darželis";Giliukai;1915676392;Ne;1;4;0;5
19541;"„Atžalyno” mokykla-darželis";Giliukai;4107946143;Taip;4;4;0;8
19542;"„Atžalyno” mokykla-darželis";Giliukai;9913048992;Taip;1;4;0;5
19543;"„Atžalyno” mokykla-darželis";Giliukai;5335059675;Taip;1;1;1;3
19544;"„Atžalyno” mokykla-darželis";Giliukai;9690554753;Taip;10;1;0;11
19545;"„Atžalyno” mokykla-darželis";Giliukai;2446697763;Taip;5;9;0;14
19546;"„Atžalyno” mokykla-darželis";Giliukai;7579781779;Taip;5;1;0;6
19547;"„Atžalyno” mokykla-darželis";Giliukai;7883570492;Ne;0;4;2;6
19548;"„Atžalyno” mokykla-darželis";Giliukai;4616870552;Taip;1;1;0;2
19549;"„Atžalyno” mokykla-darželis";Giliukai;5986664970;Ne;5;0;0;5
19550;"„Atžalyno” mokykla-darželis";Giliukai;6903825217;Taip;4;4;0;8
19551;"„Atžalyno” mokykla-darželis";Giliukai;8357021249;Taip;11;1;0;12
19552;"„Atžalyno” mokykla-darželis";Giliukai;4582284727;Taip;0;4;0;4
19553;"„Atžalyno” mokykla-darželis";Giliukai;4785607785;Taip;0;4;0;4
19554;"„Atžalyno” mokykla-darželis";Giliukai;4166521512;Taip;0;2;0;2
19555;"„Atžalyno” mokykla-darželis";Giliukai;8372179128;Taip;5;4;2;11
19556;"„Atžalyno” mokykla-darželis";Riešutėliai;4360099345;Taip;9;4;0;13
19557;"„Atžalyno” mokykla-darželis";Riešutėliai;5947938371;Ne;9;1;5;15
19558;"„Atžalyno” mokykla-darželis";Riešutėliai;5384245347;Taip;6;1;2;9
19559;"„Atžalyno” mokykla-darželis";Riešutėliai;4246430352;Taip;13;0;0;13
19560;"„Atžalyno” mokykla-darželis";Riešutėliai;8574494664;Ne;0;8;0;8
19561;"„Atžalyno” mokykla-darželis";Riešutėliai;5815412814;Taip;4;0;0;4
19562;"„Atžalyno” mokykla-darželis";Riešutėliai;4161658496;Ne;0;1;0;1
19563;"„Atžalyno” mokykla-darželis";Riešutėliai;8942132574;Taip;0;5;0;5
19564;"„Atžalyno” mokykla-darželis";Riešutėliai;3564781987;Taip;0;0;4;4
19565;"„Atžalyno” mokykla-darželis";Riešutėliai;7368616441;Taip;6;1;3;10
19566;"„Atžalyno” mokykla-darželis";Riešutėliai;5242752663;Taip;7;0;0;7
19567;"„Atžalyno” mokykla-darželis";Riešutėliai;5709028342;Taip;5;2;0;7
19568;"„Atžalyno” mokykla-darželis";Riešutėliai;8803555426;Taip;3;0;0;3
19569;"„Atžalyno” mokykla-darželis";Riešutėliai;5994983369;Ne;0;8;0;8
19570;"„Atžalyno” mokykla-darželis";Riešutėliai;7676614240;Taip;9;0;0;9
19571;"„Atžalyno” mokykla-darželis";Riešutėliai;3751729666;Taip;0;0;2;2
19572;"„Atžalyno” mokykla-darželis";Riešutėliai;3441950153;Taip;0;5;0;5
19573;"„Atžalyno” mokykla-darželis";Riešutėliai;4223591454;Taip;0;2;1;3
19574;"„Atžalyno” mokykla-darželis";Riešutėliai;3555868198;Taip;9;0;3;12
19575;"„Atžalyno” mokykla-darželis";Žirniukai;2849915655;Taip;0;2;0;2
19576;"„Atžalyno” mokykla-darželis";Žirniukai;6120955217;Taip;12;5;0;17
19577;"„Atžalyno” mokykla-darželis";Žirniukai;1787256844;Ne;4;1;2;7
19578;"„Atžalyno” mokykla-darželis";Žirniukai;2547003287;Ne;4;1;2;7
19579;"„Atžalyno” mokykla-darželis";Žirniukai;4503448206;Taip;0;4;0;4
19580;"„Atžalyno” mokykla-darželis";Žirniukai;3664056583;Taip;6;5;0;11
19581;"„Atžalyno” mokykla-darželis";Žirniukai;5456248305;Taip;3;0;0;3
19582;"„Atžalyno” mokykla-darželis";Žirniukai;3719072139;Taip;16;0;0;16
19583;"„Atžalyno” mokykla-darželis";Žirniukai;9245994735;Taip;19;0;0;19
19584;"„Atžalyno” mokykla-darželis";Žirniukai;2000352986;Taip;0;4;0;4
19585;"„Atžalyno” mokykla-darželis";Žirniukai;2177213062;Taip;9;0;0;9
19586;"„Atžalyno” mokykla-darželis";Žirniukai;4635394632;Ne;6;0;1;7
19587;"„Atžalyno” mokykla-darželis";Žirniukai;3524131672;Taip;20;0;1;21
19588;"„Atžalyno” mokykla-darželis";Žirniukai;4840490901;Taip;14;4;0;18
19589;"„Atžalyno” mokykla-darželis";Žirniukai;4796052680;Taip;0;0;1;1
19590;"„Atžalyno” mokykla-darželis";Žirniukai;8163063211;Taip;1;0;2;3
19591;"„Atžalyno” mokykla-darželis";Žirniukai;3770167696;Taip;0;1;5;6
19592;"„Atžalyno” mokykla-darželis";Žirniukai;6307949550;Taip;19;0;14;33
19593;"„Atžalyno” mokykla-darželis";Žirniukai;7625074947;Taip;22;0;0;22
19594;"„Atžalyno” mokykla-darželis";VYŠNIUKAI;9216535506;Taip;19;4;0;23
19595;"„Atžalyno” mokykla-darželis";VYŠNIUKAI;6960661098;Taip;5;1;0;6
19596;"„Atžalyno” mokykla-darželis";VYŠNIUKAI;1059756637;Taip;11;5;0;16
19597;"„Atžalyno” mokykla-darželis";VYŠNIUKAI;7999992997;Taip;21;0;0;21
19598;"„Atžalyno” mokykla-darželis";VYŠNIUKAI;8872288787;Taip;0;4;5;9
19599;"„Atžalyno” mokykla-darželis";VYŠNIUKAI;5410469885;Taip;0;5;0;5
19600;"„Atžalyno” mokykla-darželis";VYŠNIUKAI;5878874414;Taip;10;3;0;13
19601;"„Atžalyno” mokykla-darželis";VYŠNIUKAI;3930056490;Taip;13;0;0;13
19602;"„Atžalyno” mokykla-darželis";VYŠNIUKAI;6984404118;Taip;14;0;0;14
19603;"„Atžalyno” mokykla-darželis";VYŠNIUKAI;6939741360;Taip;6;3;0;9
19604;"„Atžalyno” mokykla-darželis";VYŠNIUKAI;5398871923;Taip;5;2;0;7
19605;"„Atžalyno” mokykla-darželis";VYŠNIUKAI;3046953980;Taip;9;0;0;9
19606;"„Atžalyno” mokykla-darželis";VYŠNIUKAI;2825064244;Taip;15;4;0;19
19607;"„Atžalyno” mokykla-darželis";VYŠNIUKAI;3768908704;Taip;3;2;0;5
19608;"„Atžalyno” mokykla-darželis";VYŠNIUKAI;6959131424;Taip;1;2;0;3
19609;"„Atžalyno” mokykla-darželis";VYŠNIUKAI;1851189680;Taip;0;3;0;3
19610;"„Atžalyno” mokykla-darželis";VYŠNIUKAI;5562429493;Taip;0;1;0;1
19611;"„Atžalyno” mokykla-darželis";PIPIRIUKAI;5615246040;Taip;10;1;2;13
19612;"„Atžalyno” mokykla-darželis";PIPIRIUKAI;1988657552;Taip;6;0;20;26
19613;"„Atžalyno” mokykla-darželis";PIPIRIUKAI;6721771665;Taip;5;4;0;9
19614;"„Atžalyno” mokykla-darželis";PIPIRIUKAI;2921181385;Ne;10;0;8;18
19615;"„Atžalyno” mokykla-darželis";PIPIRIUKAI;2108706876;Taip;7;0;1;8
19616;"„Atžalyno” mokykla-darželis";PIPIRIUKAI;1228919159;Taip;5;11;0;16
19617;"„Atžalyno” mokykla-darželis";PIPIRIUKAI;3919301151;Taip;0;8;3;11
19618;"„Atžalyno” mokykla-darželis";PIPIRIUKAI;2537063401;Taip;0;4;5;9
19619;"„Atžalyno” mokykla-darželis";PIPIRIUKAI;3204191459;Taip;10;2;0;12
19620;"„Atžalyno” mokykla-darželis";PIPIRIUKAI;5321475187;Taip;3;1;0;4
19621;"„Atžalyno” mokykla-darželis";PIPIRIUKAI;3015863723;Taip;9;2;0;11
19622;"„Atžalyno” mokykla-darželis";PIPIRIUKAI;3323233525;Taip;11;0;0;11
19623;"„Atžalyno” mokykla-darželis";PIPIRIUKAI;4596770586;Taip;11;5;1;17
19624;"„Atžalyno” mokykla-darželis";PIPIRIUKAI;1664011018;Taip;16;4;12;32
19625;"„Atžalyno” mokykla-darželis";PIPIRIUKAI;1866452425;Taip;6;1;1;8
19626;"„Atžalyno” mokykla-darželis";PIPIRIUKAI;9737568538;Taip;10;4;0;14
19627;"„Atžalyno” mokykla-darželis";PIPIRIUKAI;5406800599;Taip;1;13;0;14
19628;"„Atžalyno” mokykla-darželis";PIPIRIUKAI;3312254613;Taip;0;1;0;1
19629;"„Atžalyno” mokykla-darželis";PIPIRIUKAI;1443004141;Taip;6;0;7;13
19630;"Vilniaus Naujininkų mokykla";"SAULĖS ZUIKUČIAI";9856315057;Taip;0;4;0;4
19631;"Vilniaus Naujininkų mokykla";"SAULĖS ZUIKUČIAI";1901250406;Ne;0;7;0;7
19632;"Vilniaus Naujininkų mokykla";"SAULĖS ZUIKUČIAI";9411054207;Ne;0;10;0;10
19633;"Vilniaus Naujininkų mokykla";"SAULĖS ZUIKUČIAI";9544088525;Ne;5;6;0;11
19634;"Vilniaus Naujininkų mokykla";"SAULĖS ZUIKUČIAI";9488762308;Taip;17;1;0;18
19635;"Vilniaus Naujininkų mokykla";"SAULĖS ZUIKUČIAI";3929956703;Taip;9;4;0;13
19636;"Vilniaus Naujininkų mokykla";"SAULĖS ZUIKUČIAI";4675274695;Taip;19;1;0;20
19637;"Vilniaus Naujininkų mokykla";"SAULĖS ZUIKUČIAI";3243090025;Ne;1;4;0;5
19638;"Vilniaus Naujininkų mokykla";"SAULĖS ZUIKUČIAI";9786654519;Ne;0;4;0;4
19639;"Vilniaus Naujininkų mokykla";"SAULĖS ZUIKUČIAI";8161853174;Ne;0;4;0;4
19640;"Vilniaus Naujininkų mokykla";"SAULĖS ZUIKUČIAI";6235626283;Taip;8;0;0;8
19641;"Vilniaus Naujininkų mokykla";"SAULĖS ZUIKUČIAI";9699407871;Taip;3;4;0;7
19642;"Vilniaus Naujininkų mokykla";SMALSUČIAI;3654667879;Taip;5;4;0;9
19643;"Vilniaus Naujininkų mokykla";SMALSUČIAI;5236782382;Ne;1;4;0;5
19644;"Vilniaus Naujininkų mokykla";SMALSUČIAI;7020599764;Taip;0;4;0;4
19645;"Vilniaus Naujininkų mokykla";SMALSUČIAI;3192556582;Taip;10;5;0;15
19646;"Vilniaus Naujininkų mokykla";SMALSUČIAI;4985740210;Taip;3;4;1;8
19647;"Vilniaus Naujininkų mokykla";SMALSUČIAI;1460027521;Taip;0;4;0;4
19648;"Vilniaus Naujininkų mokykla";SMALSUČIAI;9993335478;Taip;3;4;0;7
19649;"Vilniaus Naujininkų mokykla";SMALSUČIAI;9990953133;Taip;2;0;0;2
19650;"Vilniaus Naujininkų mokykla";SMALSUČIAI;1306106945;Taip;3;0;0;3
19651;"Vilniaus Naujininkų mokykla";SMALSUČIAI;8555610571;Taip;15;4;0;19
19652;"Vilniaus Naujininkų mokykla";SMALSUČIAI;8637047688;Ne;1;4;0;5
19653;"Vilniaus Naujininkų mokykla";SMALSUČIAI;6417648753;Taip;2;3;0;5
19654;"Vilniaus Naujininkų mokykla";SMALSUČIAI;7407987673;Taip;0;4;0;4
19655;"Vilniaus Naujininkų mokykla";SMALSUČIAI;8935072613;Taip;11;4;1;16
19656;"Vilniaus Naujininkų mokykla";SMALSUČIAI;5512321795;Taip;0;4;0;4
19657;"Vilniaus Naujininkų mokykla";SMALSUČIAI;3810550099;Taip;3;3;0;6
19658;"Vilniaus Naujininkų mokykla";SMALSUČIAI;1096474672;Taip;7;4;0;11
19659;"Vilniaus Naujininkų mokykla";SMALSUČIAI;4784667239;Taip;7;4;0;11
19660;"Vilniaus karaliaus Mindaugo mokykla";"PUG 2";2938446054;Taip;0;4;0;4
19661;"Vilniaus karaliaus Mindaugo mokykla";"PUG 2";3068754741;Taip;5;2;0;7
19662;"Vilniaus karaliaus Mindaugo mokykla";"PUG 2";3170928052;Taip;2;0;0;2
19663;"Vilniaus karaliaus Mindaugo mokykla";"PUG 2";2287044278;Taip;0;4;2;6
19664;"Vilniaus karaliaus Mindaugo mokykla";"PUG 2";7615716438;Taip;5;1;0;6
19665;"Vilniaus karaliaus Mindaugo mokykla";"PUG 2";8229593318;Taip;0;1;0;1
19666;"Vilniaus karaliaus Mindaugo mokykla";"PUG 2";7236658561;Taip;4;0;0;4
19667;"Vilniaus karaliaus Mindaugo mokykla";"PUG 2";8456560292;Taip;0;4;0;4
19668;"Vilniaus karaliaus Mindaugo mokykla";"PUG 2";6384832317;Taip;10;0;0;10
19669;"Vilniaus karaliaus Mindaugo mokykla";"PUG 2";9670205249;Taip;4;0;0;4
19670;"Vilniaus karaliaus Mindaugo mokykla";"PUG 2";3741784446;Taip;5;18;0;23
19671;"Vilniaus karaliaus Mindaugo mokykla";"PUG 2";8578903763;Taip;4;0;0;4
19672;"Vilniaus karaliaus Mindaugo mokykla";"PUG 2";3281475303;Taip;0;6;0;6
19673;"Vilniaus karaliaus Mindaugo mokykla";"PUG 2";9780684867;Taip;0;0;1;1
19674;"Vilniaus karaliaus Mindaugo mokykla";"PUG 2";4920263429;Taip;4;0;0;4
19675;"Vilniaus karaliaus Mindaugo mokykla";"PUG 1";7043125057;Ne;15;0;0;15
19676;"Vilniaus karaliaus Mindaugo mokykla";"PUG 1";5640182548;Taip;0;4;1;5
19677;"Vilniaus karaliaus Mindaugo mokykla";"PUG 1";1998073387;Taip;8;0;0;8
19678;"Vilniaus karaliaus Mindaugo mokykla";"PUG 1";9790803767;Ne;0;4;0;4
19679;"Vilniaus karaliaus Mindaugo mokykla";"PUG 1";4405567649;Taip;5;0;1;6
19680;"Vilniaus karaliaus Mindaugo mokykla";"PUG 1";5752454925;Taip;0;4;0;4
19681;"Vilniaus karaliaus Mindaugo mokykla";"PUG 1";5648658237;Taip;0;0;4;4
19682;"Vilniaus karaliaus Mindaugo mokykla";"PUG 1";5946007985;Taip;0;4;1;5
19683;"Vilniaus karaliaus Mindaugo mokykla";"PUG 1";7770852445;Taip;0;4;1;5
19684;"Vilniaus karaliaus Mindaugo mokykla";"PUG 1";3953844737;Taip;0;0;3;3
19685;"Vilniaus karaliaus Mindaugo mokykla";"PUG 1";7271589727;Taip;0;0;5;5
19686;"Vilniaus karaliaus Mindaugo mokykla";"PUG 1";1403569615;Taip;4;1;0;5
19687;"Vilniaus karaliaus Mindaugo mokykla";"PUG 1";9651789217;Taip;3;0;0;3
19688;"Vilniaus karaliaus Mindaugo mokykla";"PUG 1";2926077771;Taip;0;3;2;5
19689;"Vilniaus karaliaus Mindaugo mokykla";"PUG 1";3587941684;Taip;0;10;0;10
19690;"Vilniaus karaliaus Mindaugo mokykla";"PUG 1";2549704540;Taip;0;0;1;1
19691;"Vilniaus karaliaus Mindaugo mokykla";"PUG 1";2361829423;Taip;0;3;0;3
19692;"Vilniaus karaliaus Mindaugo mokykla";"PUG 3";6406285034;Taip;8;0;1;9
19693;"Vilniaus karaliaus Mindaugo mokykla";"PUG 3";3252419072;Taip;0;0;1;1
19694;"Vilniaus karaliaus Mindaugo mokykla";"PUG 3";9056468879;Taip;11;0;0;11
19695;"Vilniaus karaliaus Mindaugo mokykla";"PUG 3";4559316741;Taip;0;4;0;4
19696;"Vilniaus karaliaus Mindaugo mokykla";"PUG 3";1945918102;Taip;6;0;0;6
19697;"Vilniaus karaliaus Mindaugo mokykla";"PUG 3";1814323427;Taip;0;4;0;4
19698;"Vilniaus karaliaus Mindaugo mokykla";"PUG 3";2319707653;Taip;12;0;1;13
19699;"Vilniaus karaliaus Mindaugo mokykla";"PUG 3";4741154518;Taip;2;0;0;2
19700;"Vilniaus karaliaus Mindaugo mokykla";"PUG 3";4215451069;Taip;8;0;0;8
19701;"Vilniaus karaliaus Mindaugo mokykla";"PUG 3";9921191336;Taip;3;4;0;7
19702;"Vilniaus karaliaus Mindaugo mokykla";"PUG 3";2044795759;Taip;2;0;0;2
19703;"Vilniaus karaliaus Mindaugo mokykla";"PUG 3";5103259175;Taip;2;0;0;2
19704;"Vilniaus karaliaus Mindaugo mokykla";"PUG 3";5613442667;Taip;8;4;3;15
19705;"Vilniaus karaliaus Mindaugo mokykla";"PUG 3";7149197796;Taip;0;23;0;23
19706;"Vilniaus karaliaus Mindaugo mokykla";"PUG 3";6762306583;Taip;4;3;0;7
19707;"Vilniaus Levo Karsavino vidurinė mokykla";PELEDŽIUKAI;4043810535;Taip;0;4;0;4
19708;"Vilniaus Levo Karsavino vidurinė mokykla";PELEDŽIUKAI;1887013803;Taip;2;4;0;6
19709;"Vilniaus Levo Karsavino vidurinė mokykla";PELEDŽIUKAI;6464887268;Taip;0;7;0;7
19710;"Vilniaus Levo Karsavino vidurinė mokykla";PELEDŽIUKAI;5876182759;Taip;6;4;0;10
19711;"Vilniaus Levo Karsavino vidurinė mokykla";PELEDŽIUKAI;6569135467;Taip;5;4;0;9
19712;"Vilniaus Levo Karsavino vidurinė mokykla";PELEDŽIUKAI;3117948118;Taip;10;4;1;15
19713;"Vilniaus Levo Karsavino vidurinė mokykla";PELEDŽIUKAI;2654373943;Taip;4;4;0;8
19714;"Vilniaus Levo Karsavino vidurinė mokykla";PELEDŽIUKAI;9988041515;Taip;4;4;0;8
19715;"Vilniaus Levo Karsavino vidurinė mokykla";PELEDŽIUKAI;9108428738;Taip;4;4;0;8
19716;"Vilniaus Levo Karsavino vidurinė mokykla";PELEDŽIUKAI;6099940488;Taip;0;4;0;4
19717;"Vilniaus Levo Karsavino vidurinė mokykla";PELEDŽIUKAI;7824348276;Taip;9;4;0;13
19718;"Vilniaus Levo Karsavino vidurinė mokykla";PELEDŽIUKAI;3547185618;Taip;0;4;0;4
19719;"Vilniaus Levo Karsavino vidurinė mokykla";PELEDŽIUKAI;2681013154;Taip;6;5;0;11
19720;"Vilniaus Levo Karsavino vidurinė mokykla";PELEDŽIUKAI;3780475392;Taip;7;5;0;12
19721;"Vilniaus Levo Karsavino vidurinė mokykla";PELEDŽIUKAI;3211649292;Ne;3;4;0;7
19722;"Vilniaus Levo Karsavino vidurinė mokykla";PELEDŽIUKAI;8386409466;Taip;5;4;0;9
19723;"Vilniaus Levo Karsavino vidurinė mokykla";PELEDŽIUKAI;3059970035;Taip;0;4;0;4
19724;"Vilniaus Levo Karsavino vidurinė mokykla";PELEDŽIUKAI;7023534254;Taip;4;4;0;8
19725;"Vilniaus Levo Karsavino vidurinė mokykla";PELEDŽIUKAI;4493469560;Taip;9;4;0;13
19726;"Vilniaus Levo Karsavino vidurinė mokykla";PELEDŽIUKAI;3608920051;Taip;5;4;0;9
19727;"Vilniaus Levo Karsavino vidurinė mokykla";ŽINIUKAI;4416434150;Taip;5;4;3;12
19728;"Vilniaus Levo Karsavino vidurinė mokykla";ŽINIUKAI;9325387975;Taip;4;4;1;9
19729;"Vilniaus Levo Karsavino vidurinė mokykla";ŽINIUKAI;2013694393;Taip;10;4;0;14
19730;"Vilniaus Levo Karsavino vidurinė mokykla";ŽINIUKAI;2107123106;Taip;14;4;2;20
19731;"Vilniaus Levo Karsavino vidurinė mokykla";ŽINIUKAI;7482740111;Taip;1;4;0;5
19732;"Vilniaus Levo Karsavino vidurinė mokykla";ŽINIUKAI;5408157164;Taip;0;4;1;5
19733;"Vilniaus Levo Karsavino vidurinė mokykla";ŽINIUKAI;2122665619;Taip;4;4;1;9
19734;"Vilniaus Levo Karsavino vidurinė mokykla";ŽINIUKAI;1632925219;Taip;0;4;3;7
19735;"Vilniaus Levo Karsavino vidurinė mokykla";ŽINIUKAI;1750209600;Taip;4;4;0;8
19736;"Vilniaus Levo Karsavino vidurinė mokykla";ŽINIUKAI;8364902911;Taip;0;4;1;5
19737;"Vilniaus Levo Karsavino vidurinė mokykla";ŽINIUKAI;8827421660;Taip;0;5;0;5
19738;"Vilniaus Levo Karsavino vidurinė mokykla";ŽINIUKAI;3943002728;Taip;7;4;0;11
19739;"Vilniaus Levo Karsavino vidurinė mokykla";ŽINIUKAI;2697867000;Ne;0;4;4;8
19740;"Vilniaus Levo Karsavino vidurinė mokykla";ŽINIUKAI;1165219272;Taip;0;4;0;4
19741;"Vilniaus Levo Karsavino vidurinė mokykla";ŽINIUKAI;7541217656;Taip;6;4;3;13
19742;"Vilniaus Levo Karsavino vidurinė mokykla";ŽINIUKAI;6391999153;Taip;6;4;0;10
19743;"Vilniaus Levo Karsavino vidurinė mokykla";ŽINIUKAI;4613894944;Taip;0;4;0;4
19744;"Vilniaus Levo Karsavino vidurinė mokykla";ŽINIUKAI;8517226350;Taip;0;4;0;4
19745;"Vilniaus Levo Karsavino vidurinė mokykla";ŽINIUKAI;5102718403;Taip;7;4;0;11
19746;"Vilniaus Levo Karsavino vidurinė mokykla";ŽINIUKAI;5692603837;Taip;3;4;1;8
19747;"Vilniaus Levo Karsavino vidurinė mokykla";ŽINIUKAI;6945510312;Taip;10;4;0;14
19748;"Vilniaus Liepkalnio Pagrindinė Mokykla";Bitutės;3144718477;Taip;8;4;0;12
19749;"Vilniaus Liepkalnio Pagrindinė Mokykla";Bitutės;5682528849;Taip;0;4;0;4
19750;"Vilniaus Liepkalnio Pagrindinė Mokykla";Bitutės;1777442316;Taip;0;5;0;5
19751;"Vilniaus Liepkalnio Pagrindinė Mokykla";Bitutės;8723898832;Ne;0;4;0;4
19752;"Vilniaus Liepkalnio Pagrindinė Mokykla";Bitutės;8080492986;Taip;8;4;0;12
19753;"Vilniaus Liepkalnio Pagrindinė Mokykla";Bitutės;3239288878;Taip;7;4;0;11
19754;"Vilniaus Liepkalnio Pagrindinė Mokykla";Bitutės;6829438486;Taip;5;4;0;9
19755;"Vilniaus Liepkalnio Pagrindinė Mokykla";Bitutės;3369970611;Taip;0;4;1;5
19756;"Vilniaus Liepkalnio Pagrindinė Mokykla";Bitutės;4344780723;Taip;0;4;4;8
19757;"Vilniaus Liepkalnio Pagrindinė Mokykla";Bitutės;1085400709;Taip;0;4;1;5
19758;"Vilniaus Liepkalnio Pagrindinė Mokykla";Bitutės;8387453394;Taip;0;4;0;4
19759;"Vilniaus Pranciškaus Skorinos gimnazija";SAULYTĖ;3621289572;Taip;0;4;0;4
19760;"Vilniaus Pranciškaus Skorinos gimnazija";SAULYTĖ;8946940285;Taip;0;5;1;6
19761;"Vilniaus Pranciškaus Skorinos gimnazija";SAULYTĖ;2978563798;Taip;0;13;0;13
19762;"Vilniaus Pranciškaus Skorinos gimnazija";SAULYTĖ;2347857813;Taip;0;5;3;8
19763;"Vilniaus Pranciškaus Skorinos gimnazija";SAULYTĖ;2220506064;Ne;1;8;5;14
19764;"Vilniaus Pranciškaus Skorinos gimnazija";SAULYTĖ;1797706575;Ne;0;9;0;9
19765;"Vilniaus Pranciškaus Skorinos gimnazija";SAULYTĖ;9424930375;Ne;0;9;0;9
19766;"Vilniaus Pranciškaus Skorinos gimnazija";SAULYTĖ;3558729735;Ne;1;10;0;11
19767;"Vilniaus Pranciškaus Skorinos gimnazija";SAULYTĖ;7197420388;Ne;0;4;0;4
19768;"Vilniaus Pranciškaus Skorinos gimnazija";SAULYTĖ;9107920165;Ne;0;4;0;4
19769;"Vilniaus Pranciškaus Skorinos gimnazija";SAULYTĖ;2290343066;Taip;0;24;0;24
19770;"Vilniaus Pranciškaus Skorinos gimnazija";SAULYTĖ;4500542668;Taip;0;4;0;4
19771;"Vilniaus Pranciškaus Skorinos gimnazija";SAULYTĖ;2782818158;Taip;0;4;0;4
19772;"Vilniaus Pranciškaus Skorinos gimnazija";SAULYTĖ;4719223490;Taip;0;4;1;5
19773;"Vilniaus Pranciškaus Skorinos gimnazija";SAULYTĖ;6892006495;Taip;0;6;0;6
19774;"Vilniaus Pranciškaus Skorinos gimnazija";SAULYTĖ;8592478282;Taip;0;5;2;7
19775;"Vilniaus Pranciškaus Skorinos gimnazija";SAULYTĖ;4522879237;Ne;0;4;2;6
19776;"Vilniaus Simono Konarskio mokykla";"1 GR.";9988467124;Taip;2;4;0;6
19777;"Vilniaus Simono Konarskio mokykla";"1 GR.";4029765504;Taip;3;4;0;7
19778;"Vilniaus Simono Konarskio mokykla";"1 GR.";6861123988;Taip;0;4;0;4
19779;"Vilniaus Simono Konarskio mokykla";"1 GR.";7233139048;Taip;0;4;0;4
19780;"Vilniaus Simono Konarskio mokykla";"1 GR.";3835878101;Taip;0;4;0;4
19781;"Vilniaus Simono Konarskio mokykla";"1 GR.";9009809585;Ne;0;4;0;4
19782;"Vilniaus Simono Konarskio mokykla";"1 GR.";6044653707;Taip;3;4;0;7
19783;"Vilniaus Simono Konarskio mokykla";"1 GR.";1915827035;Taip;3;4;0;7
19784;"Vilniaus Simono Konarskio mokykla";"1 GR.";8052276633;Taip;0;4;0;4
19785;"Vilniaus Simono Konarskio mokykla";"1 GR.";9041585534;Taip;0;4;0;4
19786;"Vilniaus Simono Konarskio mokykla";"1 GR.";4048726627;Ne;0;4;0;4
19787;"Vilniaus Simono Konarskio mokykla";"1 GR.";4713033873;Taip;0;4;0;4
19788;"Vilniaus Simono Konarskio mokykla";"1 GR.";6693019825;Taip;0;4;0;4
19789;"Vilniaus Simono Konarskio mokykla";"1 GR.";8916218916;Ne;0;4;0;4
19790;"Vilniaus Simono Konarskio mokykla";"1 GR.";1532248269;Taip;1;4;0;5
19791;"Vilniaus Simono Konarskio mokykla";"1 GR.";3675401775;Taip;0;4;0;4
19792;"Vilniaus Simono Konarskio mokykla";"1 GR.";2764009011;Taip;0;4;0;4
19793;"Vilniaus Simono Konarskio mokykla";"1 GR.";4338067260;Taip;0;4;0;4
19794;"Vilniaus Simono Konarskio mokykla";"1 GR.";3641822841;Taip;0;4;0;4
19795;"Vilniaus Simono Konarskio mokykla";"1 GR.";4858617162;Taip;0;4;0;4
19796;"Vilniaus Simono Konarskio mokykla";"1 GR.";9205217788;Ne;0;4;0;4
19797;"Vilniaus Simono Konarskio mokykla";"1 GR.";3900236858;Taip;1;4;0;5
19798;"Vilniaus Simono Konarskio mokykla";"1 GR.";9065848425;Taip;2;4;0;6
19799;"Vilniaus Simono Konarskio mokykla";"1 GR.";7230987338;Taip;3;4;0;7
19800;"Vilniaus Simono Konarskio mokykla";"1 GR.";7337449523;Taip;0;4;0;4
19801;"Vilniaus Trakų Vokės gimnazija";DRUGELIAI;8874384610;Taip;6;4;0;10
19802;"Vilniaus Trakų Vokės gimnazija";DRUGELIAI;4535167417;Taip;2;5;1;8
19803;"Vilniaus Trakų Vokės gimnazija";DRUGELIAI;2453791555;Taip;18;0;0;18
19804;"Vilniaus Trakų Vokės gimnazija";DRUGELIAI;4854440884;Taip;5;1;3;9
19805;"Vilniaus Trakų Vokės gimnazija";DRUGELIAI;2761614687;Taip;1;1;4;6
19806;"Vilniaus Trakų Vokės gimnazija";DRUGELIAI;8706990390;Taip;6;2;1;9
19807;"Vilniaus Trakų Vokės gimnazija";DRUGELIAI;9094930495;Taip;0;2;0;2
19808;"Vilniaus Trakų Vokės gimnazija";DRUGELIAI;9483709021;Taip;0;1;0;1
19809;"Vilniaus Trakų Vokės gimnazija";DRUGELIAI;2880299812;Taip;5;0;0;5
19810;"Vilniaus Trakų Vokės gimnazija";DRUGELIAI;9506008651;Taip;6;0;2;8
19811;"Vilniaus Trakų Vokės gimnazija";DRUGELIAI;6326568445;Taip;0;2;0;2
19812;"Vilniaus Trakų Vokės gimnazija";DRUGELIAI;1360046096;Taip;6;5;0;11
19813;"Vilniaus Trakų Vokės gimnazija";DRUGELIAI;2503382218;Taip;0;5;0;5
19814;"Vilniaus Trakų Vokės gimnazija";DRUGELIAI;3278842582;Ne;0;4;1;5
19815;"Vilniaus Trakų Vokės gimnazija";DRUGELIAI;3611639112;Taip;0;5;0;5
19816;"Vilniaus Trakų Vokės gimnazija";DRUGELIAI;8605461082;Taip;11;4;0;15
19817;"Vilniaus Trakų Vokės gimnazija";DRUGELIAI;3328527700;Taip;5;5;0;10
19818;"Vilniaus Trakų Vokės gimnazija";DRUGELIAI;5206616285;Taip;4;4;0;8
19819;"Vilniaus Trakų Vokės gimnazija";DRUGELIAI;8929514493;Taip;5;0;0;5
19820;"Vilniaus Trakų Vokės gimnazija";DRUGELIAI;9233090228;Taip;0;0;2;2
19821;"Vilniaus Trakų Vokės gimnazija";VOVERIUKAI;1088928094;Taip;7;0;0;7
19822;"Vilniaus Trakų Vokės gimnazija";VOVERIUKAI;1080300137;Taip;2;6;0;8
19823;"Vilniaus Trakų Vokės gimnazija";VOVERIUKAI;2469340933;Ne;5;0;0;5
19824;"Vilniaus Trakų Vokės gimnazija";VOVERIUKAI;6908913934;Taip;6;4;0;10
19825;"Vilniaus Trakų Vokės gimnazija";VOVERIUKAI;4362066941;Taip;0;6;0;6
19826;"Vilniaus Trakų Vokės gimnazija";VOVERIUKAI;3209594216;Ne;5;0;0;5
19827;"Vilniaus Trakų Vokės gimnazija";VOVERIUKAI;3555513755;Taip;7;4;0;11
19828;"Vilniaus Trakų Vokės gimnazija";VOVERIUKAI;5338798362;Taip;22;4;0;26
19829;"Vilniaus Trakų Vokės gimnazija";VOVERIUKAI;9582511053;Taip;6;8;0;14
19830;"Vilniaus Trakų Vokės gimnazija";VOVERIUKAI;1039690987;Taip;1;1;0;2
19831;"Vilniaus Trakų Vokės gimnazija";VOVERIUKAI;6908487075;Taip;1;4;0;5
19832;"Vilniaus Trakų Vokės gimnazija";VOVERIUKAI;1910363787;Taip;4;4;0;8
19833;"Vilniaus Trakų Vokės gimnazija";VOVERIUKAI;7858812338;Taip;4;5;0;9
19834;"Vilniaus Trakų Vokės gimnazija";VOVERIUKAI;3913623741;Taip;5;1;0;6
19835;"Vilniaus Trakų Vokės gimnazija";VOVERIUKAI;4520091712;Taip;6;1;0;7
19836;"Vilniaus Trakų Vokės gimnazija";VOVERIUKAI;8168960897;Taip;5;4;0;9
19837;"Vilniaus Trakų Vokės gimnazija";VOVERIUKAI;1057189769;Taip;4;11;0;15
19838;"Vilniaus Trakų Vokės gimnazija";VOVERIUKAI;4014027030;Taip;6;1;0;7
19839;"Vilniaus Trakų Vokės gimnazija";VOVERIUKAI;7660240598;Taip;5;13;0;18
19840;"Vilniaus Trakų Vokės gimnazija";VOVERIUKAI;4438127190;Ne;10;0;0;10
19841;"Vilniaus Trakų Vokės gimnazija";VOVERIUKAI;2388817616;Taip;0;14;0;14
19842;"Vilniaus Trakų Vokės gimnazija";VOVERIUKAI;8472834181;Taip;1;5;0;6
19843;"Vilniaus Trakų Vokės gimnazija";BITUTĖS;6369848950;Taip;0;1;0;1
19844;"Vilniaus Trakų Vokės gimnazija";BITUTĖS;6732422645;Taip;0;4;2;6
19845;"Vilniaus Trakų Vokės gimnazija";BITUTĖS;7909596435;Taip;4;0;0;4
19846;"Vilniaus Trakų Vokės gimnazija";BITUTĖS;6751625456;Taip;5;0;1;6
19847;"Vilniaus Trakų Vokės gimnazija";BITUTĖS;7752786907;Taip;4;2;0;6
19848;"Vilniaus Trakų Vokės gimnazija";BITUTĖS;2475068032;Ne;1;4;0;5
19849;"Vilniaus Trakų Vokės gimnazija";BITUTĖS;9819489467;Ne;7;2;0;9
19850;"Vilniaus Trakų Vokės gimnazija";BITUTĖS;2516219363;Taip;0;1;0;1
19851;"Vilniaus Trakų Vokės gimnazija";BITUTĖS;2571561865;Taip;6;1;3;10
19852;"Vilniaus Trakų Vokės gimnazija";BITUTĖS;6765094662;Taip;0;2;0;2
19853;"Vilniaus Trakų Vokės gimnazija";BITUTĖS;4601374629;Ne;5;1;0;6
19854;"Vilniaus Trakų Vokės gimnazija";BITUTĖS;9051697544;Ne;6;0;0;6
19855;"Vilniaus Trakų Vokės gimnazija";BITUTĖS;3346395516;Ne;10;0;0;10
19856;"Vilniaus Trakų Vokės gimnazija";BITUTĖS;9453317084;Taip;4;5;0;9
19857;"Vilniaus Trakų Vokės gimnazija";BITUTĖS;2869217654;Taip;0;2;1;3
19858;"Vilniaus Trakų Vokės gimnazija";BITUTĖS;7508070996;Taip;20;4;0;24
19859;"Vilniaus Trakų Vokės gimnazija";BITUTĖS;1602352855;Taip;5;2;0;7
19860;"Vilniaus Trakų Vokės gimnazija";BITUTĖS;5695160925;Taip;12;4;1;17
19861;"Vilniaus Trakų Vokės gimnazija";BITUTĖS;9668538340;Taip;0;4;0;4
19862;"Vilniaus Trakų Vokės gimnazija";BITUTĖS;3449317958;Taip;0;10;0;10
19863;"Vilniaus Trakų Vokės gimnazija";BITUTĖS;1398572100;Taip;6;2;1;9
19864;"Vilniaus Trakų Vokės gimnazija";BITUTĖS;2469486746;Taip;5;2;3;10
19865;"Vilniaus Ryto progimnazija";RYTUKAI;3397350274;Taip;7;4;0;11
19866;"Vilniaus Ryto progimnazija";RYTUKAI;4822495270;Taip;0;4;0;4
19867;"Vilniaus Ryto progimnazija";RYTUKAI;5267128750;Taip;1;1;0;2
19868;"Vilniaus Ryto progimnazija";RYTUKAI;3235523199;Taip;4;0;0;4
19869;"Vilniaus Ryto progimnazija";RYTUKAI;9197480840;Taip;0;4;0;4
19870;"Vilniaus Ryto progimnazija";RYTUKAI;8625023976;Taip;3;0;0;3
19871;"Vilniaus Ryto progimnazija";RYTUKAI;2537442505;Taip;0;4;0;4
19872;"Vilniaus Ryto progimnazija";RYTUKAI;7365398150;Ne;2;4;0;6
19873;"Vilniaus Ryto progimnazija";RYTUKAI;3461165182;Taip;5;1;3;9
19874;"Vilniaus Ryto progimnazija";RYTUKAI;6340323302;Taip;0;4;2;6
19875;"Vilniaus Ryto progimnazija";RYTUKAI;7638618099;Taip;2;1;0;3
19876;"Vilniaus Ryto progimnazija";RYTUKAI;6852734826;Ne;5;4;0;9
19877;"Vilniaus Ryto progimnazija";RYTUKAI;5494350183;Taip;0;3;0;3
19878;"Vilniaus Ryto progimnazija";RYTUKAI;5148002236;Ne;0;4;0;4
19879;"Vilniaus Ryto progimnazija";RYTUKAI;3192818461;Taip;0;4;0;4
19880;"Vilniaus Ryto progimnazija";RYTUKAI;4086461803;Taip;1;4;0;5
19881;"Vilniaus Ryto progimnazija";RYTUKAI;2921485707;Taip;2;4;4;10
19882;"Vilniaus Ryto progimnazija";RYTUKAI;8011986769;Taip;3;4;0;7
19883;"Vilniaus Ryto progimnazija";RYTUKAI;4029370760;Taip;6;4;0;10
19884;"Vilniaus Salininkų gimnazija";"Priešmokyklinė A";6850925495;Taip;0;4;0;4
19885;"Vilniaus Salininkų gimnazija";"Priešmokyklinė A";6577237672;Taip;0;6;0;6
19886;"Vilniaus Salininkų gimnazija";"Priešmokyklinė A";2760231414;Taip;0;4;0;4
19887;"Vilniaus Salininkų gimnazija";"Priešmokyklinė A";7665409499;Taip;0;4;0;4
19888;"Vilniaus Salininkų gimnazija";"Priešmokyklinė A";8603759429;Taip;0;4;0;4
19889;"Vilniaus Salininkų gimnazija";"Priešmokyklinė A";9724367035;Taip;0;4;0;4
19890;"Vilniaus Salininkų gimnazija";"Priešmokyklinė A";8995565864;Taip;0;8;0;8
19891;"Vilniaus Salininkų gimnazija";"Priešmokyklinė A";7782972361;Taip;0;5;0;5
19892;"Vilniaus Salininkų gimnazija";"Priešmokyklinė A";8394582546;Taip;0;6;0;6
19893;"Vilniaus Salininkų gimnazija";"Priešmokyklinė A";6327046935;Taip;9;4;0;13
19894;"Vilniaus Salininkų gimnazija";"Priešmokyklinė A";4425748908;Taip;0;10;0;10
19895;"Vilniaus Salininkų gimnazija";"Priešmokyklinė A";8774984357;Taip;0;4;0;4
19896;"Vilniaus Salininkų gimnazija";"Priešmokyklinė A";6155979185;Taip;0;7;0;7
19897;"Vilniaus Salininkų gimnazija";"Priešmokyklinė A";6485917683;Taip;0;4;0;4
19898;"Vilniaus Salininkų gimnazija";"Priešmokyklinė A";8206979332;Taip;9;4;0;13
19899;"Vilniaus Salininkų gimnazija";"Priešmokyklinė A";7737045952;Taip;0;4;0;4
19900;"Vilniaus Salininkų gimnazija";"Priešmokyklinė A";4323257798;Taip;0;4;0;4
19901;"Vilniaus Salininkų gimnazija";"Priešmokyklinė A";1975168626;Taip;1;4;0;5
19902;"Vilniaus Salininkų gimnazija";"Priešmokyklinė A";8016341646;Taip;4;4;0;8
19903;"Vilniaus Salininkų gimnazija";"Priešmokyklinė A";2262425557;Taip;10;4;0;14
19904;"Vilniaus Salininkų gimnazija";"PRIEŠMOKYKLINĖ B";5427013789;Taip;0;5;0;5
19905;"Vilniaus Salininkų gimnazija";"PRIEŠMOKYKLINĖ B";3100499807;Taip;0;5;0;5
19906;"Vilniaus Salininkų gimnazija";"PRIEŠMOKYKLINĖ B";5867676844;Taip;0;4;0;4
19907;"Vilniaus Salininkų gimnazija";"PRIEŠMOKYKLINĖ B";3122948974;Taip;0;4;0;4
19908;"Vilniaus Salininkų gimnazija";"PRIEŠMOKYKLINĖ B";3585435095;Taip;1;4;0;5
19909;"Vilniaus Salininkų gimnazija";"PRIEŠMOKYKLINĖ B";1658695150;Taip;1;4;2;7
19910;"Vilniaus Salininkų gimnazija";"PRIEŠMOKYKLINĖ B";3737834032;Taip;0;4;2;6
19911;"Vilniaus Salininkų gimnazija";"PRIEŠMOKYKLINĖ B";9344614003;Taip;3;4;2;9
19912;"Vilniaus Salininkų gimnazija";"PRIEŠMOKYKLINĖ B";2808778763;Taip;1;4;1;6
19913;"Vilniaus Salininkų gimnazija";"PRIEŠMOKYKLINĖ B";9890660815;Taip;0;4;0;4
19914;"Vilniaus Salininkų gimnazija";"PRIEŠMOKYKLINĖ B";8189699392;Taip;0;4;0;4
19915;"Vilniaus Salininkų gimnazija";"PRIEŠMOKYKLINĖ B";8047582970;Taip;4;4;1;9
19916;"Vilniaus Salininkų gimnazija";"PRIEŠMOKYKLINĖ B";3739751121;Taip;5;4;0;9
19917;"Vilniaus Salininkų gimnazija";"PRIEŠMOKYKLINĖ B";7403996266;Taip;0;4;0;4
19918;"Vilniaus Salininkų gimnazija";"PRIEŠMOKYKLINĖ B";2495718547;Taip;3;4;0;7
19919;"Vilniaus Salininkų gimnazija";"PRIEŠMOKYKLINĖ B";9813360176;Taip;0;5;0;5
19920;"Vilniaus Salininkų gimnazija";"PRIEŠMOKYKLINĖ B";6656578271;Taip;1;4;0;5
19921;"Vilniaus Salininkų gimnazija";"PRIEŠMOKYKLINĖ B";6266609965;Taip;0;4;0;4
19922;"Vilniaus Salininkų gimnazija";"PRIEŠMOKYKLINĖ B";3196285660;Taip;4;4;0;8
19923;"Vilniaus Salininkų gimnazija";"PRIEŠMOKYKLINĖ B";4771867627;Taip;6;4;0;10
19924;"Vilniaus „Spindulio“ progimnazija";PM2;8076961367;Taip;0;1;0;1
19925;"Vilniaus „Spindulio“ progimnazija";PM2;8439204095;Taip;6;1;0;7
19926;"Vilniaus „Spindulio“ progimnazija";PM2;6352250868;Taip;3;4;0;7
19927;"Vilniaus „Spindulio“ progimnazija";PM2;8440546956;Taip;12;4;0;16
19928;"Vilniaus „Spindulio“ progimnazija";PM2;1030958414;Taip;0;1;0;1
19929;"Vilniaus „Spindulio“ progimnazija";PM2;5030400578;Taip;0;6;0;6
19930;"Vilniaus „Spindulio“ progimnazija";PM2;1200205376;Taip;0;5;0;5
19931;"Vilniaus „Spindulio“ progimnazija";PM2;1455509576;Taip;5;4;0;9
19932;"Vilniaus „Spindulio“ progimnazija";PM2;6935992202;Taip;4;4;0;8
19933;"Vilniaus „Spindulio“ progimnazija";PM2;1005082012;Taip;2;0;0;2
19934;"Vilniaus „Spindulio“ progimnazija";PM2;7197544314;Taip;0;5;0;5
19935;"Vilniaus „Spindulio“ progimnazija";PM2;4678970810;Taip;0;4;0;4
19936;"Vilniaus „Spindulio“ progimnazija";PM2;3985610575;Ne;3;6;0;9
19937;"Vilniaus „Spindulio“ progimnazija";PM2;6531930806;Taip;7;0;0;7
19938;"Vilniaus „Spindulio“ progimnazija";PM2;4179507316;Taip;0;4;0;4
19939;"Vilniaus „Spindulio“ progimnazija";PM2;8936645508;Taip;0;2;0;2
19940;"Vilniaus „Spindulio“ progimnazija";PM2;8728791932;Taip;4;5;10;19
19941;"Vilniaus „Spindulio“ progimnazija";PM1;8160982025;Taip;5;4;0;9
19942;"Vilniaus „Spindulio“ progimnazija";PM1;5835209357;Taip;1;4;0;5
19943;"Vilniaus „Spindulio“ progimnazija";PM1;6578506861;Taip;3;0;0;3
19944;"Vilniaus „Spindulio“ progimnazija";PM1;9628317328;Taip;0;6;0;6
19945;"Vilniaus „Spindulio“ progimnazija";PM1;9898412288;Taip;5;4;0;9
19946;"Vilniaus „Spindulio“ progimnazija";PM1;6577214344;Taip;3;4;2;9
19947;"Vilniaus „Spindulio“ progimnazija";PM1;8432654056;Taip;0;4;0;4
19948;"Vilniaus „Spindulio“ progimnazija";PM1;7487111570;Taip;0;4;0;4
19949;"Vilniaus „Spindulio“ progimnazija";PM1;5327627748;Taip;2;4;0;6
19950;"Vilniaus „Spindulio“ progimnazija";PM1;6575909478;Ne;6;4;0;10
19951;"Vilniaus „Spindulio“ progimnazija";PM1;6826790492;Taip;0;4;0;4
19952;"Vilniaus „Spindulio“ progimnazija";PM1;5305660046;Taip;1;4;0;5
19953;"Vilniaus „Spindulio“ progimnazija";PM1;2948291866;Taip;0;4;0;4
19954;"Vilniaus „Spindulio“ progimnazija";PM1;2945894661;Taip;4;4;0;8
19955;"Vilniaus „Spindulio“ progimnazija";PM1;1392036584;Taip;3;2;0;5
19956;"Vilniaus „Spindulio“ progimnazija";PM1;8448546818;Taip;0;23;0;23
19957;"Vilniaus „Spindulio“ progimnazija";PM1;4713803167;Taip;8;6;0;14
19958;"Vilniaus „Spindulio“ progimnazija";PM1;2066127119;Taip;1;4;0;5
19959;"Vilniaus „Spindulio“ progimnazija";PM1;9074294473;Taip;4;4;0;8
19960;"Vilniaus „Spindulio“ progimnazija";PM1;3554823424;Taip;0;4;0;4
19961;"Vilniaus „Spindulio“ progimnazija";PM1;4347116918;Taip;0;4;0;4
19962;"Vilniaus Vladislavo Sirokomlės gimnazija";Nykštukai;1588062393;Taip;2;5;0;7
19963;"Vilniaus Vladislavo Sirokomlės gimnazija";Nykštukai;4715704693;Taip;0;4;0;4
19964;"Vilniaus Vladislavo Sirokomlės gimnazija";Nykštukai;6451722893;Ne;7;12;0;19
19965;"Vilniaus Vladislavo Sirokomlės gimnazija";Nykštukai;2923698853;Taip;4;18;0;22
19966;"Vilniaus Vladislavo Sirokomlės gimnazija";Nykštukai;7364698713;Taip;0;5;0;5
19967;"Vilniaus Vladislavo Sirokomlės gimnazija";Nykštukai;6613003059;Ne;5;5;0;10
19968;"Vilniaus Vladislavo Sirokomlės gimnazija";Nykštukai;7113970557;Ne;2;5;0;7
19969;"Vilniaus Vladislavo Sirokomlės gimnazija";Nykštukai;1698478530;Taip;0;6;0;6
19970;"Vilniaus Vladislavo Sirokomlės gimnazija";Nykštukai;7413098580;Taip;4;7;0;11
19971;"Vilniaus Vladislavo Sirokomlės gimnazija";Nykštukai;6843262303;Taip;0;5;0;5
19972;"Vilniaus Vladislavo Sirokomlės gimnazija";Nykštukai;5150028968;Taip;0;5;0;5
19973;"Vilniaus Vladislavo Sirokomlės gimnazija";Nykštukai;5999318972;Taip;0;5;0;5
19974;"Vilniaus Vladislavo Sirokomlės gimnazija";Nykštukai;2092319455;Taip;2;7;0;9
19975;"Vilniaus Vladislavo Sirokomlės gimnazija";Nykštukai;5822045625;Taip;3;5;0;8
19976;"Vilniaus Vladislavo Sirokomlės gimnazija";Nykštukai;2373600520;Ne;5;4;0;9
19977;"Vilniaus Vladislavo Sirokomlės gimnazija";Nykštukai;6166192468;Taip;0;4;0;4
19978;"Vilniaus Vladislavo Sirokomlės gimnazija";Nykštukai;1272758839;Taip;10;4;0;14
19979;"Vilniaus Vladislavo Sirokomlės gimnazija";Nykštukai;1512245903;Taip;0;4;0;4
19980;"Vilniaus Vladislavo Sirokomlės gimnazija";Smurfai;2262586409;Taip;0;33;0;33
19981;"Vilniaus Vladislavo Sirokomlės gimnazija";Smurfai;9457457032;Taip;10;4;0;14
19982;"Vilniaus Vladislavo Sirokomlės gimnazija";Smurfai;5041189990;Taip;0;5;0;5
19983;"Vilniaus Vladislavo Sirokomlės gimnazija";Smurfai;7429739147;Taip;11;6;0;17
19984;"Vilniaus Vladislavo Sirokomlės gimnazija";Smurfai;6866592245;Taip;1;5;0;6
19985;"Vilniaus Vladislavo Sirokomlės gimnazija";Smurfai;9396676137;Taip;0;4;0;4
19986;"Vilniaus Vladislavo Sirokomlės gimnazija";Smurfai;9353066785;Taip;0;4;0;4
19987;"Vilniaus Vladislavo Sirokomlės gimnazija";Smurfai;4415030161;Taip;2;5;0;7
19988;"Vilniaus Vladislavo Sirokomlės gimnazija";Smurfai;1386916991;Taip;8;9;0;17
19989;"Vilniaus Vladislavo Sirokomlės gimnazija";Smurfai;2999425729;Taip;2;7;0;9
19990;"Vilniaus Vladislavo Sirokomlės gimnazija";Smurfai;7334310944;Taip;4;5;0;9
19991;"Vilniaus Vladislavo Sirokomlės gimnazija";Smurfai;6385918522;Taip;0;7;0;7
19992;"Vilniaus Vladislavo Sirokomlės gimnazija";Smurfai;1894717954;Taip;0;4;0;4
19993;"Vilniaus Vladislavo Sirokomlės gimnazija";Smurfai;3810261864;Taip;11;5;0;16
19994;"Vilniaus Vladislavo Sirokomlės gimnazija";Smurfai;4658530212;Taip;0;8;0;8
19995;"Vilniaus Vladislavo Sirokomlės gimnazija";Smurfai;4191386053;Taip;0;5;0;5
19996;"Vilniaus Vladislavo Sirokomlės gimnazija";Smurfai;4760204642;Ne;3;5;0;8
19997;"Vilniaus Vladislavo Sirokomlės gimnazija";Smurfai;3316897176;Taip;3;7;0;10
19998;"Vilniaus „Pelėdos” pradinė mokykla";BITUTĖS;1540892686;Taip;10;4;0;14
19999;"Vilniaus „Pelėdos” pradinė mokykla";BITUTĖS;1775717256;Taip;0;4;0;4
20000;"Vilniaus „Pelėdos” pradinė mokykla";BITUTĖS;7587887488;Taip;2;2;0;4
20001;"Vilniaus „Pelėdos” pradinė mokykla";BITUTĖS;6886461269;Taip;0;4;0;4
20002;"Vilniaus „Pelėdos” pradinė mokykla";BITUTĖS;8466974910;Taip;5;4;0;9
20003;"Vilniaus „Pelėdos” pradinė mokykla";BITUTĖS;8874979704;Taip;8;0;0;8
20004;"Vilniaus „Pelėdos” pradinė mokykla";BITUTĖS;4315677064;Taip;3;0;0;3
20005;"Vilniaus „Pelėdos” pradinė mokykla";BITUTĖS;3247532201;Taip;10;4;2;16
20006;"Vilniaus „Pelėdos” pradinė mokykla";BITUTĖS;5490544278;Taip;0;1;0;1
20007;"Vilniaus „Pelėdos” pradinė mokykla";BITUTĖS;2737277656;Taip;7;4;0;11
20008;"Vilniaus „Pelėdos” pradinė mokykla";BITUTĖS;6191899254;Taip;1;13;0;14
20009;"Vilniaus „Pelėdos” pradinė mokykla";BITUTĖS;6191427974;Taip;1;4;0;5
20010;"Vilniaus „Pelėdos” pradinė mokykla";BITUTĖS;8650379074;Taip;7;2;0;9
20011;"Vilniaus „Pelėdos” pradinė mokykla";BITUTĖS;8874149122;Taip;2;1;0;3
20012;"Vilniaus „Pelėdos” pradinė mokykla";BITUTĖS;3318222372;Taip;0;4;0;4
20013;"Vilniaus „Pelėdos” pradinė mokykla";BITUTĖS;5061655822;Taip;0;4;4;8
20014;"Vilniaus „Pelėdos” pradinė mokykla";BITUTĖS;7960825423;Taip;3;3;0;6
20015;"Vilniaus „Pelėdos” pradinė mokykla";BITUTĖS;4324931449;Ne;1;4;0;5
20016;"Vilniaus „Pelėdos” pradinė mokykla";BITUTĖS;5924332293;Taip;6;4;0;10
20017;"Vilniaus Joachimo Lelevelio inžinerijos gimnazija";0A;7508357392;Taip;9;4;0;13
20018;"Vilniaus Joachimo Lelevelio inžinerijos gimnazija";0A;9106152447;Taip;0;5;0;5
20019;"Vilniaus Joachimo Lelevelio inžinerijos gimnazija";0A;4033866425;Taip;0;4;0;4
20020;"Vilniaus Joachimo Lelevelio inžinerijos gimnazija";0A;8086994543;Taip;0;4;0;4
20021;"Vilniaus Joachimo Lelevelio inžinerijos gimnazija";0A;2701042709;Taip;1;4;0;5
20022;"Vilniaus Joachimo Lelevelio inžinerijos gimnazija";0A;3649329598;Taip;0;4;0;4
20023;"Vilniaus Joachimo Lelevelio inžinerijos gimnazija";0A;2225787182;Taip;2;4;0;6
20024;"Vilniaus Joachimo Lelevelio inžinerijos gimnazija";0A;7307307882;Taip;6;8;0;14
20025;"Vilniaus Joachimo Lelevelio inžinerijos gimnazija";0A;6316768460;Taip;1;4;0;5
20026;"Vilniaus Joachimo Lelevelio inžinerijos gimnazija";0A;9798993200;Taip;0;4;0;4
20027;"Vilniaus Joachimo Lelevelio inžinerijos gimnazija";0A;6417545510;Taip;0;4;0;4
20028;"Vilniaus Joachimo Lelevelio inžinerijos gimnazija";0B;9965517774;Taip;0;12;0;12
20029;"Vilniaus Joachimo Lelevelio inžinerijos gimnazija";0B;7138581709;Taip;0;12;0;12
20030;"Vilniaus Joachimo Lelevelio inžinerijos gimnazija";0B;7911007041;Taip;8;4;0;12
20031;"Vilniaus Joachimo Lelevelio inžinerijos gimnazija";0B;2125410714;Taip;0;5;0;5
20032;"Vilniaus Joachimo Lelevelio inžinerijos gimnazija";0B;7956422880;Taip;1;4;0;5
20033;"Vilniaus Joachimo Lelevelio inžinerijos gimnazija";0B;8446233414;Taip;0;5;0;5
20034;"Vilniaus Joachimo Lelevelio inžinerijos gimnazija";0B;5689369492;Taip;0;5;0;5
20035;"Vilniaus Joachimo Lelevelio inžinerijos gimnazija";0B;8797584508;Taip;0;4;0;4
20036;"Vilniaus Joachimo Lelevelio inžinerijos gimnazija";0B;7553024183;Taip;4;4;0;8
20037;"Vilniaus Joachimo Lelevelio inžinerijos gimnazija";0B;6861062723;Taip;0;4;0;4
20038;"Vilniaus Joachimo Lelevelio inžinerijos gimnazija";0B;8703116268;Taip;0;5;0;5
20039;"Vilniaus Joachimo Lelevelio inžinerijos gimnazija";0B;4312062240;Taip;0;4;0;4
20040;"Vilniaus Juzefo Ignacijaus Kraševskio gimnazija";DRUGĖLIAI;5157814568;Taip;1;4;0;5
20041;"Vilniaus Juzefo Ignacijaus Kraševskio gimnazija";DRUGĖLIAI;8747343811;Taip;3;4;0;7
20042;"Vilniaus Juzefo Ignacijaus Kraševskio gimnazija";DRUGĖLIAI;7502911642;Taip;3;4;0;7
20043;"Vilniaus Juzefo Ignacijaus Kraševskio gimnazija";DRUGĖLIAI;6028582927;Taip;1;4;0;5
20044;"Vilniaus Juzefo Ignacijaus Kraševskio gimnazija";DRUGĖLIAI;6403149921;Taip;5;4;0;9
20045;"Vilniaus Juzefo Ignacijaus Kraševskio gimnazija";DRUGĖLIAI;5328263421;Taip;12;4;0;16
20046;"Vilniaus Juzefo Ignacijaus Kraševskio gimnazija";DRUGĖLIAI;4022408510;Taip;0;4;0;4
20047;"Vilniaus Juzefo Ignacijaus Kraševskio gimnazija";DRUGĖLIAI;4257115650;Ne;5;4;0;9
20048;"Vilniaus Juzefo Ignacijaus Kraševskio gimnazija";DRUGĖLIAI;8521846076;Taip;7;4;0;11
20049;"Vilniaus Juzefo Ignacijaus Kraševskio gimnazija";DRUGĖLIAI;6427289718;Ne;6;4;0;10
20050;"Vilniaus Juzefo Ignacijaus Kraševskio gimnazija";DRUGĖLIAI;8214699601;Taip;0;5;0;5
20051;"Vilniaus Juzefo Ignacijaus Kraševskio gimnazija";DRUGĖLIAI;7685428258;Taip;4;4;0;8
20052;"Vilniaus Juzefo Ignacijaus Kraševskio gimnazija";DRUGĖLIAI;6781303455;Taip;0;6;0;6
20053;"Vilniaus Juzefo Ignacijaus Kraševskio gimnazija";DRUGĖLIAI;7841179083;Ne;0;4;0;4
20054;"Vilniaus Juzefo Ignacijaus Kraševskio gimnazija";DRUGĖLIAI;4845049639;Taip;1;4;0;5
20055;"Vilniaus Juzefo Ignacijaus Kraševskio gimnazija";DRUGĖLIAI;3522200752;Ne;2;4;0;6
20056;"Vilniaus Juzefo Ignacijaus Kraševskio gimnazija";DRUGĖLIAI;8808382134;Taip;11;4;0;15
20057;"Vilniaus Juzefo Ignacijaus Kraševskio gimnazija";DRUGĖLIAI;9333766622;Ne;0;13;0;13
20058;"Vilniaus Juzefo Ignacijaus Kraševskio gimnazija";DRUGĖLIAI;3698808100;Taip;1;4;0;5
20059;"Vilniaus Jono Pauliaus II progimnazija";Nykštukai;2493612905;Taip;10;4;0;14
20060;"Vilniaus Jono Pauliaus II progimnazija";Nykštukai;6742119549;Taip;5;8;0;13
20061;"Vilniaus Jono Pauliaus II progimnazija";Nykštukai;8047799576;Taip;0;4;0;4
20062;"Vilniaus Jono Pauliaus II progimnazija";Nykštukai;1381191703;Taip;0;23;0;23
20063;"Vilniaus Jono Pauliaus II progimnazija";Nykštukai;9042329808;Taip;0;4;0;4
20064;"Vilniaus Jono Pauliaus II progimnazija";Nykštukai;5909697341;Taip;0;4;0;4
20065;"Vilniaus Jono Pauliaus II progimnazija";Nykštukai;2948716989;Taip;0;5;0;5
20066;"Vilniaus Jono Pauliaus II progimnazija";Nykštukai;6525761466;Taip;0;12;0;12
20067;"Vilniaus Jono Pauliaus II progimnazija";Nykštukai;1254369602;Taip;3;4;0;7
20068;"Vilniaus Jono Pauliaus II progimnazija";Nykštukai;3346154143;Taip;4;4;0;8
20069;"Vilniaus Jono Pauliaus II progimnazija";Nykštukai;5734602455;Taip;10;4;0;14
20070;"Vilniaus Jono Pauliaus II progimnazija";Nykštukai;8054114720;Taip;0;7;0;7
20071;"Vilniaus Jono Pauliaus II progimnazija";Nykštukai;2190583964;Taip;7;4;0;11
20072;"Vilniaus Jono Pauliaus II progimnazija";Nykštukai;3920229653;Taip;5;4;0;9
20073;"Vilniaus Jono Pauliaus II progimnazija";Nykštukai;8092890260;Taip;0;4;0;4
20074;"Vilniaus Jono Pauliaus II progimnazija";Nykštukai;3998988004;Taip;1;6;0;7
20075;"Vilniaus Jono Pauliaus II progimnazija";Nykštukai;6756184787;Taip;4;4;0;8
20076;"Vilniaus Jono Pauliaus II progimnazija";Nykštukai;5768470608;Taip;0;4;0;4
20077;"Vilniaus Jono Pauliaus II progimnazija";Nykštukai;3584347608;Taip;0;4;0;4
20078;"Vilniaus Jono Pauliaus II progimnazija";Žiniukai;3687735991;Taip;0;4;0;4
20079;"Vilniaus Jono Pauliaus II progimnazija";Žiniukai;8678437720;Taip;5;4;0;9
20080;"Vilniaus Jono Pauliaus II progimnazija";Žiniukai;4543822765;Taip;11;4;0;15
20081;"Vilniaus Jono Pauliaus II progimnazija";Žiniukai;7459673719;Taip;0;8;0;8
20082;"Vilniaus Jono Pauliaus II progimnazija";Žiniukai;4566817285;Taip;5;4;0;9
20083;"Vilniaus Jono Pauliaus II progimnazija";Žiniukai;3332865242;Taip;0;4;0;4
20084;"Vilniaus Jono Pauliaus II progimnazija";Žiniukai;5978993456;Taip;7;4;0;11
20085;"Vilniaus Jono Pauliaus II progimnazija";Žiniukai;4288487063;Taip;0;4;0;4
20086;"Vilniaus Jono Pauliaus II progimnazija";Žiniukai;9522524163;Taip;8;4;0;12
20087;"Vilniaus Jono Pauliaus II progimnazija";Žiniukai;6712878938;Taip;4;4;0;8
20088;"Vilniaus Jono Pauliaus II progimnazija";Žiniukai;9414051187;Taip;0;4;0;4
20089;"Vilniaus Jono Pauliaus II progimnazija";Žiniukai;8812316692;Taip;4;4;0;8
20090;"Vilniaus Jono Pauliaus II progimnazija";Žiniukai;9357757604;Taip;0;7;0;7
20091;"Vilniaus Jono Pauliaus II progimnazija";Žiniukai;4291690659;Taip;0;4;0;4
20092;"Vilniaus Jono Pauliaus II progimnazija";Žiniukai;3489127587;Taip;9;5;0;14
20093;"Vilniaus Jono Pauliaus II progimnazija";Žiniukai;3772830210;Taip;4;4;0;8
20094;"Vilniaus Jono Pauliaus II progimnazija";Žiniukai;5043122065;Taip;0;4;0;4
20095;"Vilniaus Jono Pauliaus II progimnazija";Žiniukai;3349199472;Taip;0;5;0;5
20096;"Vilniaus Jono Pauliaus II progimnazija";Žiniukai;2654794460;Taip;10;4;0;14
20097;"Vilniaus Jono Pauliaus II progimnazija";Žiniukai;6478873536;Taip;0;5;0;5
20098;"Vilniaus Jono Pauliaus II progimnazija";Spindulėlis;5492437864;Ne;1;12;0;13
20099;"Vilniaus Jono Pauliaus II progimnazija";Spindulėlis;3269357241;Taip;0;5;0;5
20100;"Vilniaus Jono Pauliaus II progimnazija";Spindulėlis;2840112908;Taip;6;5;0;11
20101;"Vilniaus Jono Pauliaus II progimnazija";Spindulėlis;4433799070;Taip;0;4;0;4
20102;"Vilniaus Jono Pauliaus II progimnazija";Spindulėlis;5440679175;Taip;0;5;0;5
20103;"Vilniaus Jono Pauliaus II progimnazija";Spindulėlis;7178844364;Taip;3;4;0;7
20104;"Vilniaus Jono Pauliaus II progimnazija";Spindulėlis;4426643908;Taip;0;5;0;5
20105;"Vilniaus Jono Pauliaus II progimnazija";Spindulėlis;6281687751;Taip;0;4;0;4
20106;"Vilniaus Jono Pauliaus II progimnazija";Spindulėlis;6996900411;Taip;4;6;0;10
20107;"Vilniaus Jono Pauliaus II progimnazija";Spindulėlis;2090334618;Taip;5;4;0;9
20108;"Vilniaus Jono Pauliaus II progimnazija";Spindulėlis;8753972322;Taip;0;5;0;5
20109;"Vilniaus Jono Pauliaus II progimnazija";Spindulėlis;6435612222;Taip;0;8;0;8
20110;"Vilniaus Jono Pauliaus II progimnazija";Spindulėlis;1583038469;Taip;8;4;0;12
20111;"Vilniaus Jono Pauliaus II progimnazija";Spindulėlis;9226214856;Taip;0;4;0;4
20112;"Vilniaus Jono Pauliaus II progimnazija";Spindulėlis;3121251271;Taip;0;10;0;10
20113;"Vilniaus Jono Pauliaus II progimnazija";Spindulėlis;4189943614;Taip;0;4;0;4
20114;"Vilniaus Jono Pauliaus II progimnazija";Spindulėlis;2515028280;Taip;8;4;0;12
20115;"Vilniaus Jono Pauliaus II progimnazija";Spindulėlis;5987294293;Taip;0;9;0;9
20116;"Vilniaus Jono Pauliaus II progimnazija";Spindulėlis;9531574134;Taip;0;4;0;4
20117;"Vilniaus Jono Pauliaus II progimnazija";Spindulėlis;8043493934;Taip;0;4;0;4
20118;"Vilniaus Jono Pauliaus II progimnazija";Uogytės;3502278745;Taip;0;11;0;11
20119;"Vilniaus Jono Pauliaus II progimnazija";Uogytės;3445649442;Taip;4;4;0;8
20120;"Vilniaus Jono Pauliaus II progimnazija";Uogytės;3900091129;Ne;0;4;0;4
20121;"Vilniaus Jono Pauliaus II progimnazija";Uogytės;6367875352;Taip;2;4;0;6
20122;"Vilniaus Jono Pauliaus II progimnazija";Uogytės;2843328732;Taip;1;4;0;5
20123;"Vilniaus Jono Pauliaus II progimnazija";Uogytės;1440531672;Ne;0;4;0;4
20124;"Vilniaus Jono Pauliaus II progimnazija";Uogytės;1502013942;Taip;4;4;0;8
20125;"Vilniaus Jono Pauliaus II progimnazija";Uogytės;2205400512;Taip;5;4;0;9
20126;"Vilniaus Jono Pauliaus II progimnazija";Uogytės;4969561425;Taip;0;4;0;4
20127;"Vilniaus Jono Pauliaus II progimnazija";Uogytės;4726351175;Taip;4;4;0;8
20128;"Vilniaus Jono Pauliaus II progimnazija";Uogytės;5028510873;Ne;3;4;0;7
20129;"Vilniaus Jono Pauliaus II progimnazija";Uogytės;4335378625;Taip;1;4;0;5
20130;"Vilniaus Jono Pauliaus II progimnazija";Uogytės;5600979545;Taip;0;4;0;4
20131;"Vilniaus Jono Pauliaus II progimnazija";Uogytės;8459980712;Taip;0;4;0;4
20132;"Vilniaus Jono Pauliaus II progimnazija";Uogytės;7089883250;Taip;0;4;0;4
20133;"Vilniaus Jono Pauliaus II progimnazija";Uogytės;4733227215;Taip;0;4;0;4
20134;"Vilniaus Jono Pauliaus II progimnazija";Uogytės;1290248125;Ne;1;4;0;5
20135;"Vilniaus Jono Pauliaus II progimnazija";Uogytės;9037835899;Taip;2;10;0;12
20136;"Vilniaus Jono Pauliaus II progimnazija";Uogytės;9235884407;Taip;2;4;0;6
20137;"Vilniaus Jono Pauliaus II progimnazija";Uogytės;8949018147;Ne;0;4;0;4
20138;"Vilniaus Verkių mokykla-daugiafunkcis centras";"SĮUP I m.m., SĮUP II m.m. klasė";1853931111;Taip;0;10;0;10
20139;"Vilniaus Verkių mokykla-daugiafunkcis centras";"SĮUP I m.m., SĮUP II m.m. klasė";2457359072;Ne;0;4;0;4
20140;"Vilniaus Verkių mokykla-daugiafunkcis centras";"SĮUP I m.m., SĮUP II m.m. klasė";6808441017;Ne;0;4;0;4
20141;"Vilniaus Verkių mokykla-daugiafunkcis centras";"SĮUP I m.m., SĮUP II m.m. klasė";7886245604;Taip;0;7;0;7
20142;"Vilniaus Verkių mokykla-daugiafunkcis centras";"SĮUP I m.m., SĮUP II m.m. klasė";5256639859;Taip;0;4;0;4
20143;"Vilniaus Verkių mokykla-daugiafunkcis centras";"SĮUP I m.m., SĮUP II m.m. klasė";6213577188;Taip;0;7;0;7
20144;"Vilniaus Verkių mokykla-daugiafunkcis centras";"SĮUP I m.m., SĮUP II m.m. klasė";8732243137;Ne;0;4;0;4
20145;"Vilniaus Verkių mokykla-daugiafunkcis centras";"SĮUP I m.m., SĮUP II m.m. klasė";6301505187;Taip;0;4;0;4
20146;"Vilniaus Verkių mokykla-daugiafunkcis centras";"SĮUP I m.m., SĮUP II m.m. klasė";9975744237;Ne;0;4;0;4
20147;"Vilniaus Verkių mokykla-daugiafunkcis centras";"SĮUP I m.m., SĮUP II m.m. klasė";5476038315;Taip;0;4;0;4
20148;"Vilniaus Verkių mokykla-daugiafunkcis centras";"SĮUP I m.m., SĮUP II m.m., SĮUP III m.m. klasė ";4518835802;Taip;0;11;0;11
20149;"Vilniaus Verkių mokykla-daugiafunkcis centras";"SĮUP I m.m., SĮUP II m.m., SĮUP III m.m. klasė ";9666721487;Taip;0;8;0;8
20150;"Vilniaus Verkių mokykla-daugiafunkcis centras";"SĮUP I m.m., SĮUP II m.m., SĮUP III m.m. klasė ";2714397701;Ne;0;5;0;5
20151;"Vilniaus Verkių mokykla-daugiafunkcis centras";"SĮUP I m.m., SĮUP II m.m., SĮUP III m.m. klasė ";4054448861;Taip;0;6;0;6
20152;"Vilniaus Verkių mokykla-daugiafunkcis centras";"SĮUP I m.m., SĮUP II m.m., SĮUP III m.m. klasė ";4857786109;Ne;0;8;0;8
20153;"Vilniaus Verkių mokykla-daugiafunkcis centras";"SĮUP I m.m., SĮUP II m.m., SĮUP III m.m. klasė ";9330275690;Ne;0;4;0;4
20154;"Vilniaus Verkių mokykla-daugiafunkcis centras";"SĮUP I m.m., SĮUP II m.m., SĮUP III m.m. klasė ";6901885288;Ne;0;4;0;4
20155;"Vilniaus Verkių mokykla-daugiafunkcis centras";"SĮUP I m.m., SĮUP II m.m., SĮUP III m.m. klasė ";7381890668;Ne;0;5;0;5
20156;"Vilniaus Verkių mokykla-daugiafunkcis centras";"SĮUP I m.m., SĮUP II m.m., SĮUP III m.m. klasė ";2708620759;Taip;0;8;0;8
20157;"Vilniaus Verkių mokykla-daugiafunkcis centras";"SĮUP I m.m., SĮUP II m.m., SĮUP III m.m. klasė ";7323583579;Ne;0;9;0;9
20158;"Vilniaus Verkių mokykla-daugiafunkcis centras";"9, 10 L klasė";2810286239;Ne;0;23;0;23
20159;"Vilniaus Verkių mokykla-daugiafunkcis centras";"9, 10 L klasė";2054806833;Ne;0;6;0;6
20160;"Vilniaus Verkių mokykla-daugiafunkcis centras";"9, 10 L klasė";9613466086;Taip;0;19;0;19
20161;"Vilniaus Verkių mokykla-daugiafunkcis centras";"9, 10 L klasė";9613466086;Taip;0;19;0;19
20162;"Vilniaus Verkių mokykla-daugiafunkcis centras";"9, 10 L klasė";7616694308;Ne;0;7;0;7
20163;"Vilniaus Verkių mokykla-daugiafunkcis centras";"9, 10 L klasė";1480378589;Ne;0;23;0;23
20164;"Vilniaus Verkių mokykla-daugiafunkcis centras";"9, 10 L klasė";3519068093;Ne;0;4;0;4
20165;"Vilniaus Verkių mokykla-daugiafunkcis centras";"9, 10 S klasė";8199430682;Ne;0;9;0;9
20166;"Vilniaus Verkių mokykla-daugiafunkcis centras";"9, 10 S klasė";1368271218;Taip;0;4;0;4
20167;"Vilniaus Verkių mokykla-daugiafunkcis centras";"9, 10 S klasė";7689301739;Ne;0;5;0;5
20168;"Vilniaus Verkių mokykla-daugiafunkcis centras";"9, 10 S klasė";6396691531;Taip;0;21;0;21
20169;"Vilniaus Verkių mokykla-daugiafunkcis centras";"9, 10 S klasė";1937996951;Ne;0;4;0;4
20170;"Vilniaus Verkių mokykla-daugiafunkcis centras";"9, 10 S klasė";7819002176;Taip;0;17;0;17
20171;"Vilniaus Verkių mokykla-daugiafunkcis centras";"9, 10 S klasė";9420292538;Taip;0;4;0;4
20172;"Vilniaus Verkių mokykla-daugiafunkcis centras";"9, 10 S klasė";5030855634;Ne;0;15;0;15
20173;"Vilniaus Verkių mokykla-daugiafunkcis centras";"9, 10 S klasė";1259538808;Taip;0;17;0;17
20174;"Vilniaus Verkių mokykla-daugiafunkcis centras";"9, 10 S klasė";5835522029;Taip;0;4;0;4
20175;"Vilniaus Verkių mokykla-daugiafunkcis centras";"8, 9 S klasė";2360897023;Ne;0;6;0;6
20176;"Vilniaus Verkių mokykla-daugiafunkcis centras";"8, 9 S klasė";2415067230;Ne;0;4;0;4
20177;"Vilniaus Verkių mokykla-daugiafunkcis centras";"8, 9 S klasė";1514869108;Taip;0;9;0;9
20178;"Vilniaus Verkių mokykla-daugiafunkcis centras";"8, 9 S klasė";3145397791;Taip;0;6;0;6
20179;"Vilniaus Verkių mokykla-daugiafunkcis centras";"8, 9 S klasė";8779088808;Taip;0;4;0;4
20180;"Vilniaus Verkių mokykla-daugiafunkcis centras";"8, 9 S klasė";3870610295;Taip;0;4;0;4
20181;"Vilniaus Verkių mokykla-daugiafunkcis centras";"8, 9 S klasė";3444507772;Ne;0;4;0;4
20182;"Vilniaus Verkių mokykla-daugiafunkcis centras";"8, 9 S klasė";3215674630;Taip;0;4;0;4
20183;"Vilniaus Verkių mokykla-daugiafunkcis centras";"7 S klasė";3631392717;Ne;0;7;0;7
20184;"Vilniaus Verkių mokykla-daugiafunkcis centras";"7 S klasė";11657021053;Taip;0;11;0;11
20185;"Vilniaus Verkių mokykla-daugiafunkcis centras";"7 S klasė";13432910676;Taip;0;9;0;9
20186;"Vilniaus Verkių mokykla-daugiafunkcis centras";"7 S klasė";8272359516;Taip;0;7;0;7
20187;"Vilniaus Verkių mokykla-daugiafunkcis centras";"7 S klasė";9598385220;Taip;0;8;0;8
20188;"Vilniaus Verkių mokykla-daugiafunkcis centras";"7 S klasė";4914336091;Taip;0;4;0;4
20189;"Vilniaus Verkių mokykla-daugiafunkcis centras";"7 S klasė";4914336091;Taip;0;4;0;4
20190;"Vilniaus Verkių mokykla-daugiafunkcis centras";"7 S klasė";2254324740;Ne;0;4;0;4
20191;"Vilniaus Verkių mokykla-daugiafunkcis centras";"5, 6, 7, 8 L klasė";37572425955;Taip;0;6;0;6
20192;"Vilniaus Verkių mokykla-daugiafunkcis centras";"5, 6, 7, 8 L klasė";44425437058;Ne;0;6;0;6
20193;"Vilniaus Verkių mokykla-daugiafunkcis centras";"5, 6, 7, 8 L klasė";2261393560;Ne;0;11;0;11
20194;"Vilniaus Verkių mokykla-daugiafunkcis centras";"5, 6, 7, 8 L klasė";7438765543;Taip;0;5;0;5
20195;"Vilniaus Verkių mokykla-daugiafunkcis centras";"5, 6, 7, 8 L klasė";37848550744;Taip;0;23;0;23
20196;"Vilniaus Verkių mokykla-daugiafunkcis centras";"5, 6, 7, 8 L klasė";9362938835;Taip;0;4;0;4
20197;"Vilniaus Verkių mokykla-daugiafunkcis centras";"5, 6, 7, 8 L klasė";5937487837;Ne;0;6;0;6
20198;"Vilniaus Verkių mokykla-daugiafunkcis centras";"5, 6, 7, 8 L klasė";1350580842;Taip;0;6;0;6
20199;"Vilniaus Verkių mokykla-daugiafunkcis centras";"5, 6, 7, 8 L klasė";5865808613;Taip;0;4;0;4
20200;"Vilniaus Verkių mokykla-daugiafunkcis centras";"5, 6, 7, 8 L klasė";1891856371;Ne;0;5;0;5
20201;"Vilniaus Verkių mokykla-daugiafunkcis centras";"5, 6 S klasė";2396841187;Ne;0;12;0;12
20202;"Vilniaus Verkių mokykla-daugiafunkcis centras";"5, 6 S klasė";8342540661;Taip;0;8;0;8
20203;"Vilniaus Verkių mokykla-daugiafunkcis centras";"5, 6 S klasė";9634174513;Taip;0;4;0;4
20204;"Vilniaus Verkių mokykla-daugiafunkcis centras";"5, 6 S klasė";62513475987;Taip;0;9;0;9
20205;"Vilniaus Verkių mokykla-daugiafunkcis centras";"5, 6 S klasė";2728524848;Taip;0;6;0;6
20206;"Vilniaus Verkių mokykla-daugiafunkcis centras";"5, 6 S klasė";9816043688;Ne;0;10;0;10
20207;"Vilniaus Verkių mokykla-daugiafunkcis centras";"5, 6 S klasė";5899020119;Taip;0;4;0;4
20208;"Vilniaus Verkių mokykla-daugiafunkcis centras";"5, 6 S klasė";93185505974;Taip;0;4;0;4
20209;"Vilniaus Verkių mokykla-daugiafunkcis centras";"5, 6 S klasė";24268622677;Taip;0;4;0;4
20210;"Vilniaus Verkių mokykla-daugiafunkcis centras";"5, 6 S klasė";24268622677;Taip;0;4;0;4
20211;"Vilniaus Verkių mokykla-daugiafunkcis centras";"5, 6 S klasė";24268622677;Taip;0;4;0;4
20212;"Vilniaus Verkių mokykla-daugiafunkcis centras";"5, 6 S klasė";24268622677;Taip;0;4;0;4
20213;"Vilniaus Verkių mokykla-daugiafunkcis centras";"5, 6 S klasė";67335258608;Ne;0;23;0;23
20214;"Vilniaus Verkių mokykla-daugiafunkcis centras";"3, 4 S klasė";3669076308;Taip;0;4;0;4
20215;"Vilniaus Verkių mokykla-daugiafunkcis centras";"3, 4 S klasė";4436123342;Taip;0;8;0;8
20216;"Vilniaus Verkių mokykla-daugiafunkcis centras";"3, 4 S klasė";6417342868;Ne;0;5;0;5
20217;"Vilniaus Verkių mokykla-daugiafunkcis centras";"3, 4 S klasė";2428312586;Taip;0;4;0;4
20218;"Vilniaus Verkių mokykla-daugiafunkcis centras";"3, 4 S klasė";2160146000;Ne;0;5;0;5
20219;"Vilniaus Verkių mokykla-daugiafunkcis centras";"3, 4 S klasė";4675792296;Taip;0;23;0;23
20220;"Vilniaus Verkių mokykla-daugiafunkcis centras";"3, 4 S klasė";4675792296;Taip;0;23;0;23
20221;"Vilniaus Verkių mokykla-daugiafunkcis centras";"Priešmokyklinio, 1, 2 S klasė";7942036741;Taip;0;8;0;8
20222;"Vilniaus Verkių mokykla-daugiafunkcis centras";"Priešmokyklinio, 1, 2 S klasė";5586925136;Ne;0;11;0;11
20223;"Vilniaus Verkių mokykla-daugiafunkcis centras";"Priešmokyklinio, 1, 2 S klasė";1809511815;Taip;0;10;0;10
20224;"Vilniaus Verkių mokykla-daugiafunkcis centras";"Priešmokyklinio, 1, 2 S klasė";8844612659;Taip;0;4;0;4
20225;"Vilniaus Verkių mokykla-daugiafunkcis centras";"Priešmokyklinio, 1, 2 S klasė";42873989145;Taip;0;10;0;10
20226;"Vilniaus Verkių mokykla-daugiafunkcis centras";"Priešmokyklinio, 1, 2 S klasė";1732370199;Ne;0;8;0;8
20227;"Vilniaus Verkių mokykla-daugiafunkcis centras";"1, 2, 3, 4 S, L klasė rusų";9256422807;Taip;0;4;0;4
20228;"Vilniaus Verkių mokykla-daugiafunkcis centras";"1, 2, 3, 4 S, L klasė rusų";2064565430;Taip;0;4;0;4
20229;"Vilniaus Verkių mokykla-daugiafunkcis centras";"1, 2, 3, 4 S, L klasė rusų";3504918499;Ne;0;10;0;10
20230;"Vilniaus Verkių mokykla-daugiafunkcis centras";"1, 2, 3, 4 S, L klasė rusų";3504918499;Ne;0;10;0;10
20231;"Vilniaus Verkių mokykla-daugiafunkcis centras";"1, 2, 3, 4 S, L klasė rusų";1515290326;Taip;0;4;0;4
20232;"Vilniaus Verkių mokykla-daugiafunkcis centras";"1, 2, 3, 4 S, L klasė rusų";7977250483;Taip;0;8;0;8
20233;"Vilniaus Verkių mokykla-daugiafunkcis centras";"1, 2, 3, 4 S, L klasė rusų";6951842417;Taip;0;4;0;4
20234;"Vilniaus Verkių mokykla-daugiafunkcis centras";"1, 2, 3, 4 S, L klasė rusų";4011623622;Taip;0;18;0;18
20235;"Vilniaus Verkių mokykla-daugiafunkcis centras";"1, 2, 3, 5, 7 S, L klasė lenkų";6215345468;Ne;0;20;0;20
20236;"Vilniaus Verkių mokykla-daugiafunkcis centras";"1, 2, 3, 5, 7 S, L klasė lenkų";5802046806;Ne;0;5;0;5
20237;"Vilniaus Verkių mokykla-daugiafunkcis centras";"1, 2, 3, 5, 7 S, L klasė lenkų";7591511377;Ne;0;6;0;6
20238;"Vilniaus Verkių mokykla-daugiafunkcis centras";"1, 2, 3, 5, 7 S, L klasė lenkų";6813357731;Ne;0;10;0;10
20239;"Vilniaus Verkių mokykla-daugiafunkcis centras";"1, 2, 3, 5, 7 S, L klasė lenkų";6868531249;Ne;0;11;0;11
20240;"Vilniaus Verkių mokykla-daugiafunkcis centras";"1, 2, 3, 5, 7 S, L klasė lenkų";6868531249;Ne;0;11;0;11
20241;"Vilniaus Verkių mokykla-daugiafunkcis centras";"1, 2, 3, 5, 7 S, L klasė lenkų";6868531249;Ne;0;11;0;11
20242;"Vilniaus Verkių mokykla-daugiafunkcis centras";"1, 2, 3, 5, 7 S, L klasė lenkų";6868531249;Ne;0;11;0;11
20243;"Vilniaus Verkių mokykla-daugiafunkcis centras";"1, 2, 3, 5, 7 S, L klasė lenkų";6868531249;Ne;0;11;0;11
20244;"Vilniaus Verkių mokykla-daugiafunkcis centras";"1, 2, 3, 5, 7 S, L klasė lenkų";6868531249;Ne;0;11;0;11
20245;"Vilniaus Verkių mokykla-daugiafunkcis centras";"1, 2, 3, 5, 7 S, L klasė lenkų";5603432321;Ne;0;5;0;5
20246;"Vilniaus Verkių mokykla-daugiafunkcis centras";"1, 2, 3, 5, 7 S, L klasė lenkų";9355917461;Ne;0;4;0;4
20247;"Vilniaus Verkių mokykla-daugiafunkcis centras";"1, 2, 3, 5, 7 S, L klasė lenkų";4187084284;Ne;0;5;0;5
20248;"Vilniaus Verkių mokykla-daugiafunkcis centras";"5, 6, 7, 8 L klasė RU";64637387481;Ne;0;4;0;4
20249;"Vilniaus Verkių mokykla-daugiafunkcis centras";"5, 6, 7, 8 L klasė RU";64637387481;Ne;0;4;0;4
20250;"Vilniaus Verkių mokykla-daugiafunkcis centras";"5, 6, 7, 8 L klasė RU";4066377955;Ne;0;14;0;14
20251;"Vilniaus Verkių mokykla-daugiafunkcis centras";"5, 6, 7, 8 L klasė RU";44372408680;Ne;0;5;0;5
20252;"Vilniaus Verkių mokykla-daugiafunkcis centras";"5, 6, 7, 8 L klasė RU";1503792026;Ne;0;10;0;10
20253;"Vilniaus Verkių mokykla-daugiafunkcis centras";"5, 6, 7, 8 L klasė RU";55421735777;Taip;0;5;0;5
20254;"Vilniaus Verkių mokykla-daugiafunkcis centras";"5, 6, 7, 8 L klasė RU";9259642351;Ne;0;23;0;23
20255;"Vilniaus Verkių mokykla-daugiafunkcis centras";" SĮUP I m.m., SĮUP II m.m. klasė RU";7000432264;Taip;0;4;0;4
20256;"Vilniaus Verkių mokykla-daugiafunkcis centras";" SĮUP I m.m., SĮUP II m.m. klasė RU";9098854782;Taip;0;4;0;4
20257;"Vilniaus Verkių mokykla-daugiafunkcis centras";" SĮUP I m.m., SĮUP II m.m. klasė RU";6937513931;Ne;0;23;0;23
20258;"Vilniaus Verkių mokykla-daugiafunkcis centras";" SĮUP I m.m., SĮUP II m.m. klasė RU";3155197214;Taip;0;23;0;23
20259;"Vilniaus Verkių mokykla-daugiafunkcis centras";" SĮUP I m.m., SĮUP II m.m. klasė RU";1454746961;Taip;0;5;0;5
20260;"Vilniaus Verkių mokykla-daugiafunkcis centras";" SĮUP I m.m., SĮUP II m.m. klasė RU";2076640938;Ne;0;6;0;6
20261;"Vilniaus Verkių mokykla-daugiafunkcis centras";" SĮUP I m.m., SĮUP II m.m. klasė RU";1062601239;Ne;0;8;0;8
20262;"Vilniaus Verkių mokykla-daugiafunkcis centras";" SĮUP I m.m., SĮUP II m.m. klasė RU";6958157444;Ne;0;6;0;6
20263;"Vilniaus Verkių mokykla-daugiafunkcis centras";" SĮUP I m.m., SĮUP II m.m. klasė RU";9430569608;Taip;0;23;0;23
20264;"Vilniaus Verkių mokykla-daugiafunkcis centras";" SĮUP I m.m., SĮUP II m.m. klasė RU";2305478898;Taip;0;2;0;2
20265;"Vilniaus Verkių mokykla-daugiafunkcis centras";" SĮUP I m.m., SĮUP II m.m. klasė RU";2518928115;Ne;0;2;0;2
20266;Gluosnis;KIŠKUČIAI;8689557248;Taip;0;0;2;2
20267;Gluosnis;KIŠKUČIAI;2984134115;Taip;0;1;0;1
20268;Gluosnis;KIŠKUČIAI;6955695422;Taip;0;0;7;7
20269;Gluosnis;KIŠKUČIAI;4285562600;Taip;0;3;1;4
20270;Gluosnis;KIŠKUČIAI;8009719622;Taip;0;3;3;6
20271;Gluosnis;KIŠKUČIAI;9833971809;Taip;17;0;1;18
20272;Gluosnis;KIŠKUČIAI;6883663577;Taip;0;3;0;3
20273;Gluosnis;KIŠKUČIAI;1512855055;Taip;0;0;1;1
20274;Gluosnis;KIŠKUČIAI;8337313448;Taip;0;0;4;4
20275;Gluosnis;KIŠKUČIAI;4632419177;Taip;0;0;1;1
20276;Gluosnis;KIŠKUČIAI;6113153127;Taip;0;0;2;2
20277;Gluosnis;KIŠKUČIAI;7769522093;Taip;5;0;0;5
20278;Gluosnis;KIŠKUČIAI;8928597187;Taip;0;0;4;4
20279;Gluosnis;KIŠKUČIAI;9993638596;Taip;0;6;4;10
20280;Gluosnis;KIŠKUČIAI;6994005000;Taip;14;0;0;14
20281;Gluosnis;KIŠKUČIAI;9221983318;Taip;10;2;2;14
20282;Gluosnis;KIŠKUČIAI;2187312618;Taip;0;8;2;10
20283;Gluosnis;KIŠKUČIAI;5664156894;Taip;0;5;0;5
20284;Gluosnis;KIŠKUČIAI;7073637619;Taip;0;0;1;1
20285;Gluosnis;KIŠKUČIAI;1391404073;Taip;6;0;2;8
20286;Gluosnis;KIŠKUČIAI;4591550636;Taip;11;2;0;13
20287;Gluosnis;KIŠKUČIAI;6212693015;Taip;11;3;0;14
20288;Gluosnis;KIŠKUČIAI;3673702157;Taip;0;2;0;2
20289;Gluosnis;EŽIUKAI;4153713911;Taip;1;0;0;1
20290;Gluosnis;EŽIUKAI;5350702449;Taip;8;0;0;8
20291;Gluosnis;EŽIUKAI;6622415563;Taip;0;3;0;3
20292;Gluosnis;EŽIUKAI;3988305400;Taip;0;6;0;6
20293;Gluosnis;EŽIUKAI;9788278155;Taip;2;0;0;2
20294;Gluosnis;EŽIUKAI;7974944779;Taip;0;2;0;2
20295;Gluosnis;EŽIUKAI;7526020668;Taip;0;1;0;1
20296;Gluosnis;EŽIUKAI;5522411084;Taip;2;4;0;6
20297;Gluosnis;EŽIUKAI;6681653921;Taip;5;1;0;6
20298;Gluosnis;EŽIUKAI;4902627153;Taip;4;2;1;7
20299;Gluosnis;EŽIUKAI;2525780494;Taip;7;6;0;13
20300;Gluosnis;EŽIUKAI;9389736360;Taip;4;1;1;6
20301;Gluosnis;EŽIUKAI;2707855273;Taip;0;2;0;2
20302;Gluosnis;EŽIUKAI;7523459118;Taip;0;7;0;7
20303;Gluosnis;EŽIUKAI;2794163383;Taip;5;0;0;5
20304;Gluosnis;EŽIUKAI;7264550578;Taip;0;4;3;7
20305;Gluosnis;EŽIUKAI;5368171142;Taip;0;11;0;11
20306;Gluosnis;EŽIUKAI;6754799196;Taip;3;0;0;3
20307;Gluosnis;EŽIUKAI;9888037899;Taip;7;0;2;9
20308;Gluosnis;MEŠKIUKAI;8981904827;Taip;0;0;1;1
20309;Gluosnis;MEŠKIUKAI;8998776286;Taip;0;1;1;2
20310;Gluosnis;MEŠKIUKAI;1846499141;Taip;20;0;1;21
20311;Gluosnis;MEŠKIUKAI;4905002832;Taip;0;5;0;5
20312;Gluosnis;MEŠKIUKAI;9102081648;Taip;2;0;1;3
20313;Gluosnis;MEŠKIUKAI;4498429439;Taip;4;0;0;4
20314;Gluosnis;MEŠKIUKAI;8259160584;Taip;1;2;0;3
20315;Gluosnis;MEŠKIUKAI;1235091885;Taip;0;11;0;11
20316;Gluosnis;MEŠKIUKAI;1165636758;Taip;5;0;3;8
20317;Gluosnis;MEŠKIUKAI;8499748544;Taip;0;2;0;2
20318;Gluosnis;MEŠKIUKAI;2867319899;Taip;5;1;0;6
20319;Gluosnis;MEŠKIUKAI;9699577397;Taip;8;0;1;9
20320;Gluosnis;MEŠKIUKAI;4107344313;Ne;0;0;4;4
20321;Gluosnis;MEŠKIUKAI;1101472999;Taip;0;5;0;5
20322;Gluosnis;MEŠKIUKAI;7995558671;Taip;0;2;0;2
20323;Gluosnis;MEŠKIUKAI;1602556462;Taip;4;0;0;4
20324;Gluosnis;MEŠKIUKAI;8842139496;Taip;3;0;0;3
20325;Gluosnis;MEŠKIUKAI;4060859156;Taip;0;0;1;1
20326;Gluosnis;MEŠKIUKAI;6428753580;Taip;8;0;0;8
20327;Gluosnis;MEŠKIUKAI;3323237449;Taip;0;4;0;4
20328;Gluosnis;MEŠKIUKAI;6246512101;Taip;0;0;1;1
20329;Gluosnis;MEŠKIUKAI;3038732180;Taip;13;4;1;18
20330;Gluosnis;MEŠKIUKAI;1712795835;Taip;0;3;0;3
20331;Gluosnis;BORUŽĖLĖS;8840658383;Taip;0;5;0;5
20332;Gluosnis;BORUŽĖLĖS;1102935178;Ne;0;2;1;3
20333;Gluosnis;BORUŽĖLĖS;4204797742;Taip;0;11;0;11
20334;Gluosnis;BORUŽĖLĖS;6302765948;Taip;0;1;0;1
20335;Gluosnis;BORUŽĖLĖS;9938235476;Taip;0;3;0;3
20336;Gluosnis;BORUŽĖLĖS;2945796648;Taip;0;2;0;2
20337;Gluosnis;BORUŽĖLĖS;4237053702;Taip;15;0;0;15
20338;Gluosnis;BORUŽĖLĖS;6320411660;Taip;0;6;0;6
20339;Gluosnis;BORUŽĖLĖS;7731887361;Taip;0;4;0;4
20340;Gluosnis;BORUŽĖLĖS;8502947568;Taip;0;4;1;5
20341;Gluosnis;BORUŽĖLĖS;1335152703;Taip;0;0;2;2
20342;Gluosnis;BORUŽĖLĖS;1314992969;Taip;0;4;2;6
20343;Gluosnis;BORUŽĖLĖS;7833136455;Taip;0;1;0;1
20344;Gluosnis;BORUŽĖLĖS;5556821953;Taip;5;0;0;5
20345;Gluosnis;BORUŽĖLĖS;2515646510;Ne;0;4;0;4
20346;Gluosnis;BORUŽĖLĖS;6086258054;Taip;11;0;2;13
20347;Gluosnis;BORUŽĖLĖS;1351519995;Taip;3;6;0;9
20348;Gluosnis;BORUŽĖLĖS;6960673767;Taip;17;3;0;20
20349;Gluosnis;LAPIUKAI;7025815772;Taip;0;3;2;5
20350;Gluosnis;LAPIUKAI;5266206726;Taip;10;0;0;10
20351;Gluosnis;LAPIUKAI;2968946946;Taip;5;0;0;5
20352;Gluosnis;LAPIUKAI;8976032500;Taip;0;0;6;6
20353;Gluosnis;LAPIUKAI;3190331209;Taip;0;0;1;1
20354;Gluosnis;LAPIUKAI;5376108804;Taip;5;0;1;6
20355;Gluosnis;LAPIUKAI;9386396460;Taip;11;0;0;11
20356;Gluosnis;LAPIUKAI;1664508998;Taip;7;4;0;11
20357;Gluosnis;LAPIUKAI;1296975213;Taip;13;0;0;13
20358;Gluosnis;LAPIUKAI;8227732558;Ne;7;0;0;7
20359;Gluosnis;LAPIUKAI;6518579198;Taip;5;0;0;5
20360;Gluosnis;LAPIUKAI;4146877525;Taip;7;6;0;13
20361;Gluosnis;LAPIUKAI;4616132460;Taip;1;1;0;2
20362;Gluosnis;LAPIUKAI;7090336454;Taip;0;1;0;1
20363;Gluosnis;LAPIUKAI;2889837198;Taip;8;0;1;9
20364;Gluosnis;PELĖDŽIUKAI;5633386146;Taip;0;0;9;9
20365;Gluosnis;PELĖDŽIUKAI;1144177849;Taip;4;0;0;4
20366;Gluosnis;PELĖDŽIUKAI;6729016081;Taip;4;4;0;8
20367;Gluosnis;PELĖDŽIUKAI;2423433989;Taip;0;0;2;2
20368;Gluosnis;PELĖDŽIUKAI;1263019496;Taip;0;1;0;1
20369;Gluosnis;PELĖDŽIUKAI;6119618742;Taip;4;0;0;4
20370;Gluosnis;PELĖDŽIUKAI;8109714321;Taip;9;0;0;9
20371;Gluosnis;PELĖDŽIUKAI;2794080237;Taip;10;9;0;19
20372;Gluosnis;PELĖDŽIUKAI;4564193030;Taip;0;12;0;12
20373;Gluosnis;PELĖDŽIUKAI;5623135790;Taip;13;3;0;16
20374;Gluosnis;PELĖDŽIUKAI;5210930032;Taip;0;0;2;2
20375;Gluosnis;PELĖDŽIUKAI;5008836118;Taip;0;0;1;1
20376;Gluosnis;PELĖDŽIUKAI;4224637208;Taip;0;3;0;3
20377;Gluosnis;PELĖDŽIUKAI;4361177196;Taip;10;0;0;10
20378;Gluosnis;PELĖDŽIUKAI;9484423786;Taip;8;4;0;12
20379;Gluosnis;PELĖDŽIUKAI;9423229931;Taip;4;0;0;4
20380;Gluosnis;PELĖDŽIUKAI;3578467708;Taip;0;0;1;1
20381;Gluosnis;VOVERIUKAI;4798207493;Taip;8;0;0;8
20382;Gluosnis;VOVERIUKAI;5822836262;Taip;11;0;0;11
20383;Gluosnis;VOVERIUKAI;8374694200;Taip;8;0;0;8
20384;Gluosnis;VOVERIUKAI;8299388060;Taip;6;4;0;10
20385;Gluosnis;VOVERIUKAI;6617408330;Taip;11;0;0;11
20386;Gluosnis;VOVERIUKAI;5972818467;Taip;14;0;0;14
20387;Gluosnis;VOVERIUKAI;3400563947;Taip;1;10;0;11
20388;Gluosnis;VOVERIUKAI;5850079627;Taip;11;0;0;11
20389;Gluosnis;VOVERIUKAI;2243717506;Taip;16;0;0;16
20390;Gluosnis;VOVERIUKAI;8904254546;Taip;1;0;0;1
20391;Gluosnis;VOVERIUKAI;1757821835;Taip;6;0;0;6
20392;Gluosnis;VOVERIUKAI;8310409721;Taip;6;0;0;6
20393;Gluosnis;VOVERIUKAI;2746499687;Taip;9;0;0;9
20394;Gluosnis;VOVERIUKAI;1636516971;Taip;11;0;0;11
20395;Gluosnis;DRUGELIAI;1716235604;Taip;0;10;0;10
20396;Gluosnis;DRUGELIAI;4125830926;Taip;0;4;0;4
20397;Gluosnis;DRUGELIAI;9084785666;Taip;0;0;2;2
20398;Gluosnis;DRUGELIAI;4940563623;Taip;4;4;0;8
20399;Gluosnis;DRUGELIAI;1113731535;Taip;0;2;0;2
20400;Gluosnis;DRUGELIAI;4653963373;Taip;2;0;0;2
20401;Gluosnis;DRUGELIAI;8314366921;Taip;0;0;1;1
20402;Gluosnis;DRUGELIAI;4220504133;Taip;0;0;1;1
20403;Gluosnis;DRUGELIAI;9931766935;Taip;0;3;5;8
20404;Gluosnis;DRUGELIAI;3527418865;Taip;12;4;0;16
20405;Gluosnis;DRUGELIAI;6914171069;Taip;0;1;0;1
20406;Gluosnis;DRUGELIAI;5943955268;Taip;0;0;9;9
20407;Gluosnis;DRUGELIAI;8690911930;Taip;0;1;2;3
20408;Gluosnis;DRUGELIAI;1787206205;Taip;0;2;0;2
20409;Gluosnis;DRUGELIAI;5264930854;Taip;0;1;0;1
20410;Gluosnis;BITUTĖS;4176300773;Taip;0;3;0;3
20411;Gluosnis;BITUTĖS;2554790908;Taip;12;3;0;15
20412;Gluosnis;BITUTĖS;8281499182;Taip;5;4;0;9
20413;Gluosnis;BITUTĖS;2403029153;Taip;0;1;0;1
20414;Gluosnis;BITUTĖS;6432475763;Taip;0;4;0;4
20415;Gluosnis;BITUTĖS;1966484574;Taip;1;5;0;6
20416;Gluosnis;BITUTĖS;5889360726;Taip;3;3;0;6
20417;Gluosnis;BITUTĖS;3362089746;Taip;0;4;2;6
20418;Gluosnis;BITUTĖS;7390361159;Taip;0;3;0;3
20419;Gluosnis;BITUTĖS;8380310240;Taip;3;0;0;3
20420;Gluosnis;BITUTĖS;4481544177;Taip;1;1;0;2
20421;Gluosnis;BITUTĖS;9098141563;Taip;7;0;0;7
20422;Gluosnis;BITUTĖS;9201769624;Taip;0;1;0;1
20423;Gluosnis;BITUTĖS;1306381382;Taip;1;4;0;5
20424;Gluosnis;BITUTĖS;6767500085;Taip;1;0;0;1
20425;Gluosnis;BITUTĖS;6001358241;Taip;0;2;1;3
20426;Gluosnis;BITUTĖS;5380755693;Taip;0;4;0;4
20427;Gluosnis;BITUTĖS;6197840105;Taip;9;3;0;12
20428;Gluosnis;BITUTĖS;5204445760;Taip;10;3;0;13
20429;Gluosnis;BITUTĖS;5432102004;Taip;5;1;0;6
20430;"Vilniaus Simono Stanevičiaus progimnazija";BITUTĖS;7528014407;Taip;1;7;0;8
20431;"Vilniaus Simono Stanevičiaus progimnazija";BITUTĖS;5140264695;Taip;0;1;0;1
20432;"Vilniaus Simono Stanevičiaus progimnazija";BITUTĖS;6700169944;Taip;0;4;0;4
20433;"Vilniaus Simono Stanevičiaus progimnazija";BITUTĖS;9894466439;Taip;0;5;0;5
20434;"Vilniaus Simono Stanevičiaus progimnazija";BITUTĖS;5292978341;Taip;0;1;0;1
20435;"Vilniaus Simono Stanevičiaus progimnazija";BITUTĖS;5733610359;Taip;3;4;9;16
20436;"Vilniaus Simono Stanevičiaus progimnazija";BITUTĖS;2021296978;Taip;2;4;0;6
20437;"Vilniaus Simono Stanevičiaus progimnazija";BITUTĖS;8667155756;Taip;0;1;0;1
20438;"Vilniaus Simono Stanevičiaus progimnazija";BITUTĖS;1566011843;Taip;0;1;0;1
20439;"Vilniaus Simono Stanevičiaus progimnazija";BITUTĖS;9331479613;Taip;0;4;0;4
20440;"Vilniaus Simono Stanevičiaus progimnazija";BITUTĖS;4586098882;Taip;0;7;0;7
20441;"Vilniaus Simono Stanevičiaus progimnazija";BITUTĖS;8378295683;Taip;0;6;0;6
20442;"Vilniaus Simono Stanevičiaus progimnazija";BITUTĖS;8866490265;Taip;0;4;0;4
20443;"Vilniaus Simono Stanevičiaus progimnazija";BITUTĖS;2738119814;Taip;0;5;0;5
20444;"Vilniaus Simono Stanevičiaus progimnazija";BITUTĖS;3678796113;Taip;1;5;0;6
20445;"Vilniaus Simono Stanevičiaus progimnazija";BITUTĖS;7251592439;Taip;0;4;0;4
20446;"Vilniaus Simono Stanevičiaus progimnazija";BITUTĖS;2780141413;Taip;0;4;0;4
20447;"Vilniaus Simono Stanevičiaus progimnazija";BITUTĖS;7335784416;Taip;0;4;0;4
20448;"Vilniaus Simono Stanevičiaus progimnazija";BITUTĖS;6259640492;Taip;12;1;0;13
20449;"Vilniaus Simono Stanevičiaus progimnazija";BITUTĖS;6800864033;Taip;0;4;0;4
20450;"Vilniaus Simono Stanevičiaus progimnazija";KATINĖLIAI;1294225767;Taip;0;1;0;1
20451;"Vilniaus Simono Stanevičiaus progimnazija";KATINĖLIAI;9192285159;Taip;1;4;0;5
20452;"Vilniaus Simono Stanevičiaus progimnazija";KATINĖLIAI;7991650887;Taip;4;4;0;8
20453;"Vilniaus Simono Stanevičiaus progimnazija";KATINĖLIAI;4682659878;Taip;8;6;0;14
20454;"Vilniaus Simono Stanevičiaus progimnazija";KATINĖLIAI;1051805733;Taip;1;2;0;3
20455;"Vilniaus Simono Stanevičiaus progimnazija";KATINĖLIAI;4973969827;Taip;0;5;0;5
20456;"Vilniaus Simono Stanevičiaus progimnazija";KATINĖLIAI;1569084597;Taip;0;5;0;5
20457;"Vilniaus Simono Stanevičiaus progimnazija";KATINĖLIAI;5863422662;Taip;5;0;0;5
20458;"Vilniaus Simono Stanevičiaus progimnazija";KATINĖLIAI;1166282379;Taip;0;1;0;1
20459;"Vilniaus Simono Stanevičiaus progimnazija";KATINĖLIAI;2734024890;Taip;0;4;0;4
20460;"Vilniaus Simono Stanevičiaus progimnazija";KATINĖLIAI;2483957349;Taip;0;6;0;6
20461;"Vilniaus Simono Stanevičiaus progimnazija";KATINĖLIAI;6869418701;Taip;2;0;0;2
20462;"Vilniaus Simono Stanevičiaus progimnazija";KATINĖLIAI;6248532738;Taip;2;4;0;6
20463;"Vilniaus Simono Stanevičiaus progimnazija";KATINĖLIAI;8967704928;Taip;0;4;0;4
20464;"Vilniaus Simono Stanevičiaus progimnazija";KATINĖLIAI;4553345643;Taip;0;4;0;4
20465;"Vilniaus Simono Stanevičiaus progimnazija";KATINĖLIAI;8799003374;Taip;0;4;0;4
20466;"Vilniaus Simono Stanevičiaus progimnazija";KATINĖLIAI;7367485961;Taip;0;4;0;4
20467;"Vilniaus Simono Stanevičiaus progimnazija";KATINĖLIAI;1545323439;Taip;1;5;0;6
20468;"Vilniaus Simono Stanevičiaus progimnazija";KATINĖLIAI;9823633774;Taip;1;0;0;1
20469;"Vilniaus Saulėtekio mokykla-daugiafunkcinis centras";"PRIEŠMOKYKLINĖ 2";7903833413;Taip;0;4;0;4
20470;"Vilniaus Saulėtekio mokykla-daugiafunkcinis centras";"PRIEŠMOKYKLINĖ 2";3499348606;Taip;10;4;0;14
20471;"Vilniaus Saulėtekio mokykla-daugiafunkcinis centras";"PRIEŠMOKYKLINĖ 2";4730746531;Taip;9;4;0;13
20472;"Vilniaus Saulėtekio mokykla-daugiafunkcinis centras";"PRIEŠMOKYKLINĖ 2";1231703889;Ne;0;4;0;4
20473;"Vilniaus Saulėtekio mokykla-daugiafunkcinis centras";"PRIEŠMOKYKLINĖ 2";9471880764;Taip;6;4;1;11
20474;"Vilniaus Saulėtekio mokykla-daugiafunkcinis centras";"PRIEŠMOKYKLINĖ 2";8012122042;Taip;2;4;1;7
20475;"Vilniaus Saulėtekio mokykla-daugiafunkcinis centras";"PRIEŠMOKYKLINĖ 2";2034007263;Taip;0;4;0;4
20476;"Vilniaus Saulėtekio mokykla-daugiafunkcinis centras";"PRIEŠMOKYKLINĖ 2";3928697936;Ne;0;0;7;7
20477;"Vilniaus Saulėtekio mokykla-daugiafunkcinis centras";"PRIEŠMOKYKLINĖ 2";7958528778;Taip;0;33;0;33
20478;"Vilniaus Saulėtekio mokykla-daugiafunkcinis centras";"PRIEŠMOKYKLINĖ 2";3080668107;Taip;1;4;1;6
20479;"Vilniaus Saulėtekio mokykla-daugiafunkcinis centras";"PRIEŠMOKYKLINĖ 2";6080664872;Taip;6;4;4;14
20480;"Vilniaus Saulėtekio mokykla-daugiafunkcinis centras";"PRIEŠMOKYKLINĖ 2";9962905184;Taip;0;4;0;4
20481;"Vilniaus Saulėtekio mokykla-daugiafunkcinis centras";"PRIEŠMOKYKLINĖ 2";3873345138;Ne;1;4;10;15
20482;"Vilniaus Saulėtekio mokykla-daugiafunkcinis centras";"PRIEŠMOKYKLINĖ 2";6702207851;Ne;5;4;1;10
20483;"Vilniaus Saulėtekio mokykla-daugiafunkcinis centras";"PRIEŠMOKYKLINĖ 2";5551184248;Taip;4;14;9;27
20484;"Vilniaus Saulėtekio mokykla-daugiafunkcinis centras";"PRIEŠMOKYKLINĖ 2";2631120189;Taip;25;4;0;29
20485;"Vilniaus Saulėtekio mokykla-daugiafunkcinis centras";"PRIEŠMOKYKLINĖ 2";4402503971;Taip;0;4;0;4
20486;"Vilniaus Saulėtekio mokykla-daugiafunkcinis centras";"PRIEŠMOKYKLINĖ 2";5998344519;Taip;5;4;2;11
20487;"Vilniaus Saulėtekio mokykla-daugiafunkcinis centras";"PRIEŠMOKYKLINĖ 2";1825755877;Taip;1;4;0;5
20488;"Vilniaus Saulėtekio mokykla-daugiafunkcinis centras";"PRIEŠMOKYKLINĖ  1";1816377082;Taip;0;4;4;8
20489;"Vilniaus Saulėtekio mokykla-daugiafunkcinis centras";"PRIEŠMOKYKLINĖ  1";7735063486;Taip;0;4;2;6
20490;"Vilniaus Saulėtekio mokykla-daugiafunkcinis centras";"PRIEŠMOKYKLINĖ  1";3744848906;Taip;9;4;2;15
20491;"Vilniaus Saulėtekio mokykla-daugiafunkcinis centras";"PRIEŠMOKYKLINĖ  1";4234425668;Taip;0;10;1;11
20492;"Vilniaus Saulėtekio mokykla-daugiafunkcinis centras";"PRIEŠMOKYKLINĖ  1";4852738818;Taip;5;4;0;9
20493;"Vilniaus Saulėtekio mokykla-daugiafunkcinis centras";"PRIEŠMOKYKLINĖ  1";5399981203;Taip;0;9;0;9
20494;"Vilniaus Saulėtekio mokykla-daugiafunkcinis centras";"PRIEŠMOKYKLINĖ  1";8997525194;Taip;0;4;6;10
20495;"Vilniaus Saulėtekio mokykla-daugiafunkcinis centras";"PRIEŠMOKYKLINĖ  1";6860696706;Taip;0;4;0;4
20496;"Vilniaus Saulėtekio mokykla-daugiafunkcinis centras";"PRIEŠMOKYKLINĖ  1";9031478765;Taip;0;4;1;5
20497;"Vilniaus Saulėtekio mokykla-daugiafunkcinis centras";"PRIEŠMOKYKLINĖ  1";5532685692;Taip;14;4;0;18
20498;"Vilniaus Saulėtekio mokykla-daugiafunkcinis centras";"PRIEŠMOKYKLINĖ  1";5817562139;Taip;0;23;0;23
20499;"Vilniaus Saulėtekio mokykla-daugiafunkcinis centras";"PRIEŠMOKYKLINĖ  1";8889959782;Taip;0;4;0;4
20500;"Vilniaus Saulėtekio mokykla-daugiafunkcinis centras";"PRIEŠMOKYKLINĖ  1";1625321820;Taip;7;4;0;11
20501;"Vilniaus Saulėtekio mokykla-daugiafunkcinis centras";"PRIEŠMOKYKLINĖ  1";3382354753;Taip;0;4;2;6
20502;"Vilniaus Saulėtekio mokykla-daugiafunkcinis centras";"PRIEŠMOKYKLINĖ  1";9099285081;Taip;0;7;0;7
20503;"Vilniaus Saulėtekio mokykla-daugiafunkcinis centras";"PRIEŠMOKYKLINĖ  1";1839351438;Taip;0;4;1;5
20504;"Vilniaus Saulėtekio mokykla-daugiafunkcinis centras";"PRIEŠMOKYKLINĖ  1";5586871557;Taip;0;23;0;23
20505;"Vilniaus Saulėtekio mokykla-daugiafunkcinis centras";"PRIEŠMOKYKLINĖ  1";2429527586;Taip;0;4;2;6
20506;"Vilniaus Maironio progimnazija";"1 PU";5652769035;Taip;3;4;0;7
20507;"Vilniaus Maironio progimnazija";"1 PU";5593526943;Taip;5;4;0;9
20508;"Vilniaus Maironio progimnazija";"1 PU";1603752483;Taip;5;4;0;9
20509;"Vilniaus Maironio progimnazija";"1 PU";6171650517;Taip;5;4;0;9
20510;"Vilniaus Maironio progimnazija";"1 PU";1591999024;Taip;0;4;0;4
20511;"Vilniaus Maironio progimnazija";"1 PU";5022388487;Taip;0;5;0;5
20512;"Vilniaus Maironio progimnazija";"1 PU";1024337077;Taip;2;14;0;16
20513;"Vilniaus Maironio progimnazija";"1 PU";6176234300;Taip;0;8;0;8
20514;"Vilniaus Maironio progimnazija";"1 PU";1339850717;Taip;4;7;0;11
20515;"Vilniaus Maironio progimnazija";"1 PU";4806652727;Taip;0;4;0;4
20516;"Vilniaus Maironio progimnazija";"1 PU";4570512336;Taip;0;5;0;5
20517;"Vilniaus Maironio progimnazija";"1 PU";6266095782;Taip;5;4;0;9
20518;"Vilniaus Maironio progimnazija";"1 PU";5322766823;Taip;0;4;0;4
20519;"Vilniaus Maironio progimnazija";"1 PU";9803206596;Taip;3;4;0;7
20520;"Vilniaus Maironio progimnazija";"1 PU";5957889361;Taip;1;4;0;5
20521;"Vilniaus Maironio progimnazija";"1 PU";2707029719;Taip;3;5;0;8
20522;"Vilniaus Maironio progimnazija";"1 PU";4917910801;Taip;0;4;0;4
20523;"Vilniaus Maironio progimnazija";"1 PU";3347146751;Taip;3;5;0;8
20524;"Vilniaus Maironio progimnazija";"1 PU";8393893311;Taip;1;4;0;5
20525;"Vilniaus Maironio progimnazija";"1 PU";2443856355;Taip;0;12;0;12
20526;"Vilniaus Maironio progimnazija";"2 PU";7395477522;Taip;4;4;0;8
20527;"Vilniaus Maironio progimnazija";"2 PU";8768526171;Taip;5;4;0;9
20528;"Vilniaus Maironio progimnazija";"2 PU";6949120693;Taip;14;4;0;18
20529;"Vilniaus Maironio progimnazija";"2 PU";7080578299;Taip;9;4;0;13
20530;"Vilniaus Maironio progimnazija";"2 PU";9968072478;Taip;5;7;0;12
20531;"Vilniaus Maironio progimnazija";"2 PU";8480891793;Taip;4;4;0;8
20532;"Vilniaus Maironio progimnazija";"2 PU";2783708905;Taip;1;4;0;5
20533;"Vilniaus Maironio progimnazija";"2 PU";8946678515;Taip;0;4;0;4
20534;"Vilniaus Maironio progimnazija";"2 PU";3320524073;Taip;1;6;0;7
20535;"Vilniaus Maironio progimnazija";"2 PU";2339010385;Taip;0;4;0;4
20536;"Vilniaus Maironio progimnazija";"2 PU";3895256591;Taip;0;9;0;9
20537;"Vilniaus Maironio progimnazija";"2 PU";1827752731;Taip;5;4;0;9
20538;"Vilniaus Maironio progimnazija";"2 PU";7859096984;Taip;5;4;0;9
20539;"Vilniaus Maironio progimnazija";"2 PU";7252265838;Taip;8;5;0;13
20540;"Vilniaus Maironio progimnazija";"2 PU";5883751305;Ne;10;4;0;14
20541;"Vilniaus Maironio progimnazija";"2 PU";2215846642;Taip;0;4;0;4
20542;"Vilniaus Maironio progimnazija";"2 PU";2868899342;Taip;8;4;0;12
20543;"Vilniaus Maironio progimnazija";"2 PU";9804863902;Taip;0;4;0;4
20544;"Vilniaus Maironio progimnazija";"2 PU";8606551477;Taip;1;4;0;5
20545;"Vilniaus Maironio progimnazija";"2 PU";2334234258;Taip;3;4;0;7
20546;"Vilniaus Maironio progimnazija";"2 PU";9978625382;Taip;9;6;0;15
20547;"Vilniaus kunigaikščio Gedimino progimnazija";NYKŠTUKAI;5909584565;Taip;0;4;0;4
20548;"Vilniaus kunigaikščio Gedimino progimnazija";NYKŠTUKAI;6234943180;Taip;0;4;0;4
20549;"Vilniaus kunigaikščio Gedimino progimnazija";NYKŠTUKAI;2406183145;Taip;0;12;0;12
20550;"Vilniaus kunigaikščio Gedimino progimnazija";NYKŠTUKAI;2379660463;Taip;0;12;0;12
20551;"Vilniaus kunigaikščio Gedimino progimnazija";NYKŠTUKAI;3363824185;Taip;5;4;0;9
20552;"Vilniaus kunigaikščio Gedimino progimnazija";NYKŠTUKAI;9408948207;Taip;4;10;0;14
20553;"Vilniaus kunigaikščio Gedimino progimnazija";NYKŠTUKAI;6942029629;Taip;0;10;0;10
20554;"Vilniaus kunigaikščio Gedimino progimnazija";NYKŠTUKAI;7161727352;Taip;0;6;0;6
20555;"Vilniaus kunigaikščio Gedimino progimnazija";NYKŠTUKAI;5695333666;Taip;0;4;0;4
20556;"Vilniaus kunigaikščio Gedimino progimnazija";NYKŠTUKAI;8061678477;Taip;0;6;0;6
20557;"Vilniaus kunigaikščio Gedimino progimnazija";NYKŠTUKAI;4635123721;Taip;0;5;0;5
20558;"Vilniaus kunigaikščio Gedimino progimnazija";NYKŠTUKAI;6574415196;Taip;0;4;0;4
20559;"Vilniaus kunigaikščio Gedimino progimnazija";NYKŠTUKAI;9777202512;Taip;3;9;0;12
20560;"Vilniaus kunigaikščio Gedimino progimnazija";NYKŠTUKAI;5187411500;Taip;0;4;0;4
20561;"Vilniaus kunigaikščio Gedimino progimnazija";NYKŠTUKAI;1420438624;Taip;2;4;0;6
20562;"Vilniaus kunigaikščio Gedimino progimnazija";NYKŠTUKAI;4681686872;Taip;0;5;0;5
20563;"Gintarėlis (Popieriaus g. 46A)";SKRUZDĖLIUKAI;5738933125;Taip;12;2;0;14
20564;"Gintarėlis (Popieriaus g. 46A)";SKRUZDĖLIUKAI;7510541192;Taip;3;0;0;3
20565;"Gintarėlis (Popieriaus g. 46A)";SKRUZDĖLIUKAI;1955719034;Taip;21;2;0;23
20566;"Gintarėlis (Popieriaus g. 46A)";SKRUZDĖLIUKAI;5961603860;Taip;0;9;0;9
20567;"Gintarėlis (Popieriaus g. 46A)";SKRUZDĖLIUKAI;5190355636;Taip;3;0;0;3
20568;"Gintarėlis (Popieriaus g. 46A)";SKRUZDĖLIUKAI;5474876914;Ne;14;1;0;15
20569;"Gintarėlis (Popieriaus g. 46A)";SKRUZDĖLIUKAI;6333647073;Taip;4;1;0;5
20570;"Gintarėlis (Popieriaus g. 46A)";SKRUZDĖLIUKAI;7274616480;Taip;0;2;0;2
20571;"Gintarėlis (Popieriaus g. 46A)";SKRUZDĖLIUKAI;1362980885;Taip;11;0;0;11
20572;"Gintarėlis (Popieriaus g. 46A)";SKRUZDĖLIUKAI;9762364250;Taip;0;7;0;7
20573;"Gintarėlis (Popieriaus g. 46A)";SKRUZDĖLIUKAI;7206593645;Ne;2;0;0;2
20574;"Gintarėlis (Popieriaus g. 46A)";SKRUZDĖLIUKAI;7400455090;Taip;8;6;0;14
20575;"Gintarėlis (Popieriaus g. 46A)";SKRUZDĖLIUKAI;7413074674;Taip;7;1;0;8
20576;"Gintarėlis (Popieriaus g. 46A)";PELĖDŽIUKAI;6506180216;Taip;1;8;0;9
20577;"Gintarėlis (Popieriaus g. 46A)";PELĖDŽIUKAI;8019543081;Taip;0;0;1;1
20578;"Gintarėlis (Popieriaus g. 46A)";PELĖDŽIUKAI;1628276472;Taip;4;1;0;5
20579;"Gintarėlis (Popieriaus g. 46A)";PELĖDŽIUKAI;8792175474;Taip;9;0;1;10
20580;"Gintarėlis (Popieriaus g. 46A)";PELĖDŽIUKAI;3304191482;Taip;0;10;0;10
20581;"Gintarėlis (Popieriaus g. 46A)";PELĖDŽIUKAI;2731865977;Taip;0;1;0;1
20582;"Gintarėlis (Popieriaus g. 46A)";PELĖDŽIUKAI;4181430769;Taip;0;12;0;12
20583;"Gintarėlis (Popieriaus g. 46A)";PELĖDŽIUKAI;3202819190;Taip;4;0;1;5
20584;"Gintarėlis (Popieriaus g. 46A)";PELĖDŽIUKAI;2546360134;Taip;5;0;0;5
20585;"Gintarėlis (Popieriaus g. 46A)";PELĖDŽIUKAI;2308673417;Taip;0;2;0;2
20586;"Gintarėlis (Popieriaus g. 46A)";PELĖDŽIUKAI;6883573289;Taip;18;1;0;19
20587;"Gintarėlis (Popieriaus g. 46A)";PELĖDŽIUKAI;3127881266;Taip;0;2;0;2
20588;"Gintarėlis (Popieriaus g. 46A)";PELĖDŽIUKAI;2052962147;Taip;10;0;1;11
20589;"Gintarėlis (Popieriaus g. 46A)";PELĖDŽIUKAI;8677500463;Taip;13;0;1;14
20590;"Gintarėlis (Popieriaus g. 46A)";PELĖDŽIUKAI;7031945895;Taip;0;3;0;3
20591;"Gintarėlis (Popieriaus g. 46A)";PELĖDŽIUKAI;3744569118;Taip;6;2;0;8
20592;"Gintarėlis (Popieriaus g. 46A)";PELĖDŽIUKAI;8068499156;Taip;8;0;1;9
20593;"Gintarėlis (Popieriaus g. 46A)";"LINKSMASIS AVILYS";7872515649;Taip;17;0;0;17
20594;"Gintarėlis (Popieriaus g. 46A)";"LINKSMASIS AVILYS";7256557310;Taip;0;10;0;10
20595;"Gintarėlis (Popieriaus g. 46A)";"LINKSMASIS AVILYS";7010430969;Taip;0;3;0;3
20596;"Gintarėlis (Popieriaus g. 46A)";"LINKSMASIS AVILYS";8680339493;Taip;12;0;0;12
20597;"Gintarėlis (Popieriaus g. 46A)";"LINKSMASIS AVILYS";5223116373;Taip;2;0;0;2
20598;"Gintarėlis (Popieriaus g. 46A)";"LINKSMASIS AVILYS";6162836315;Taip;0;4;0;4
20599;"Gintarėlis (Popieriaus g. 46A)";"LINKSMASIS AVILYS";3825572125;Taip;0;1;0;1
20600;"Gintarėlis (Popieriaus g. 46A)";"LINKSMASIS AVILYS";1994856959;Taip;0;0;1;1
20601;"Gintarėlis (Popieriaus g. 46A)";"LINKSMASIS AVILYS";1045355492;Taip;1;2;0;3
20602;"Gintarėlis (Popieriaus g. 46A)";"LINKSMASIS AVILYS";6193540660;Taip;11;0;0;11
20603;"Gintarėlis (Popieriaus g. 46A)";"LINKSMASIS AVILYS";7916257692;Taip;1;0;0;1
20604;"Gintarėlis (Popieriaus g. 46A)";"LINKSMASIS AVILYS";9045108717;Taip;18;0;0;18
20605;"Gintarėlis (Popieriaus g. 46A)";"LINKSMASIS AVILYS";5379858630;Taip;0;2;8;10
20606;"Gintarėlis (Popieriaus g. 46A)";Varliukai;6821929306;Taip;0;0;3;3
20607;"Gintarėlis (Popieriaus g. 46A)";Varliukai;4263315669;Taip;11;0;0;11
20608;"Gintarėlis (Popieriaus g. 46A)";Varliukai;6514247750;Taip;5;5;0;10
20609;"Gintarėlis (Popieriaus g. 46A)";Varliukai;1166720069;Taip;7;0;0;7
20610;"Gintarėlis (Popieriaus g. 46A)";Varliukai;4556644354;Taip;15;3;0;18
20611;"Gintarėlis (Popieriaus g. 46A)";Varliukai;7510641510;Taip;2;1;0;3
20612;"Gintarėlis (Popieriaus g. 46A)";Varliukai;6534072038;Taip;11;8;0;19
20613;"Gintarėlis (Popieriaus g. 46A)";Varliukai;5478441530;Taip;0;4;9;13
20614;"Gintarėlis (Popieriaus g. 46A)";Varliukai;5771196440;Taip;5;0;1;6
20615;"Gintarėlis (Popieriaus g. 46A)";Varliukai;7783860076;Taip;0;9;0;9
20616;"Gintarėlis (Popieriaus g. 46A)";Varliukai;7201714826;Taip;13;0;0;13
20617;"Gintarėlis (Popieriaus g. 46A)";Varliukai;6796839291;Taip;3;2;0;5
20618;"Gintarėlis (Popieriaus g. 46A)";Varliukai;3842338529;Taip;0;23;0;23
20619;"Gintarėlis (Popieriaus g. 46A)";Varliukai;2742819175;Taip;13;0;0;13
20620;"Gintarėlis (Popieriaus g. 46A)";Varliukai;2692117849;Taip;12;1;0;13
20621;"Gintarėlis (Popieriaus g. 46A)";Varliukai;9063374884;Taip;2;2;0;4
20622;"Gintarėlis (Popieriaus g. 46A)";Varliukai;8226000686;Taip;2;1;0;3
20623;"Gintarėlis (Popieriaus g. 46A)";Varliukai;7128652904;Taip;4;5;0;9
20624;"Pušynėlis (A. Mickevičiaus g. 21)";DAIGIUKAI;8668906624;Taip;14;0;0;14
20625;"Pušynėlis (A. Mickevičiaus g. 21)";DAIGIUKAI;8473976622;Taip;6;0;0;6
20626;"Pušynėlis (A. Mickevičiaus g. 21)";DAIGIUKAI;6630085270;Taip;9;1;0;10
20627;"Pušynėlis (A. Mickevičiaus g. 21)";DAIGIUKAI;6321506677;Taip;13;0;0;13
20628;"Pušynėlis (A. Mickevičiaus g. 21)";DAIGIUKAI;2065121473;Taip;2;0;5;7
20629;"Pušynėlis (A. Mickevičiaus g. 21)";DAIGIUKAI;5601877137;Taip;4;0;1;5
20630;"Pušynėlis (A. Mickevičiaus g. 21)";DAIGIUKAI;7825721993;Taip;0;2;0;2
20631;"Pušynėlis (A. Mickevičiaus g. 21)";DAIGIUKAI;2905910220;Taip;5;0;0;5
20632;"Pušynėlis (A. Mickevičiaus g. 21)";DAIGIUKAI;2283845338;Taip;6;0;0;6
20633;"Pušynėlis (A. Mickevičiaus g. 21)";DAIGIUKAI;2543730165;Taip;10;1;0;11
20634;"Pušynėlis (A. Mickevičiaus g. 21)";NYKŠTUKAI;8820865805;Ne;0;23;0;23
20635;"Pušynėlis (A. Mickevičiaus g. 21)";NYKŠTUKAI;9520423020;Taip;10;8;2;20
20636;"Pušynėlis (A. Mickevičiaus g. 21)";NYKŠTUKAI;9450347140;Taip;0;2;0;2
20637;"Pušynėlis (A. Mickevičiaus g. 21)";NYKŠTUKAI;3574446664;Taip;0;3;0;3
20638;"Pušynėlis (A. Mickevičiaus g. 21)";NYKŠTUKAI;8512699165;Taip;0;6;0;6
20639;"Pušynėlis (A. Mickevičiaus g. 21)";NYKŠTUKAI;5364537212;Taip;0;6;4;10
20640;"Pušynėlis (A. Mickevičiaus g. 21)";NYKŠTUKAI;8327830781;Taip;0;2;5;7
20641;"Pušynėlis (A. Mickevičiaus g. 21)";NYKŠTUKAI;5317547220;Taip;0;0;2;2
20642;"Pušynėlis (A. Mickevičiaus g. 21)";NYKŠTUKAI;9025539389;Taip;13;0;0;13
20643;"Pušynėlis (A. Mickevičiaus g. 21)";NYKŠTUKAI;6594473055;Taip;0;2;3;5
20644;"Pušynėlis (A. Mickevičiaus g. 21)";NYKŠTUKAI;2763762463;Taip;6;4;0;10
20645;"Pušynėlis (A. Mickevičiaus g. 21)";NYKŠTUKAI;8211464695;Taip;0;2;1;3
20646;"Pušynėlis (A. Mickevičiaus g. 21)";NYKŠTUKAI;1085678424;Taip;5;0;0;5
20647;"Pušynėlis (A. Mickevičiaus g. 21)";NYKŠTUKAI;6270870180;Taip;14;0;0;14
20648;"Pušynėlis (A. Mickevičiaus g. 21)";NYKŠTUKAI;4685125111;Taip;0;1;0;1
20649;"Pušynėlis (A. Mickevičiaus g. 21)";NYKŠTUKAI;9717473430;Taip;8;4;0;12
20650;"Pušynėlis (A. Mickevičiaus g. 21)";NYKŠTUKAI;1057676386;Taip;0;2;6;8
20651;"Pušynėlis (A. Mickevičiaus g. 21)";NYKŠTUKAI;5512586591;Taip;11;1;0;12
20652;"Pušynėlis (A. Mickevičiaus g. 21)";GILIUKAI;9517319856;Taip;2;6;0;8
20653;"Pušynėlis (A. Mickevičiaus g. 21)";GILIUKAI;2825756894;Taip;17;0;0;17
20654;"Pušynėlis (A. Mickevičiaus g. 21)";GILIUKAI;2712755125;Taip;0;0;4;4
20655;"Pušynėlis (A. Mickevičiaus g. 21)";GILIUKAI;3301741162;Taip;3;2;0;5
20656;"Pušynėlis (A. Mickevičiaus g. 21)";GILIUKAI;9028515427;Taip;0;0;1;1
20657;"Pušynėlis (A. Mickevičiaus g. 21)";GILIUKAI;8298368128;Taip;1;0;0;1
20658;"Pušynėlis (A. Mickevičiaus g. 21)";GILIUKAI;8712141140;Taip;2;2;0;4
20659;"Pušynėlis (A. Mickevičiaus g. 21)";GILIUKAI;9220344337;Taip;4;0;0;4
20660;"Pušynėlis (A. Mickevičiaus g. 21)";GILIUKAI;1050710006;Taip;1;1;0;2
20661;"Pušynėlis (A. Mickevičiaus g. 21)";GILIUKAI;2222790161;Taip;0;6;1;7
20662;"Pušynėlis (A. Mickevičiaus g. 21)";GILIUKAI;7596876368;Taip;4;1;0;5
20663;"Pušynėlis (A. Mickevičiaus g. 21)";GILIUKAI;1758632291;Taip;15;0;0;15
20664;"Pušynėlis (A. Mickevičiaus g. 21)";GILIUKAI;2892213973;Taip;0;1;0;1
20665;"Pušynėlis (A. Mickevičiaus g. 21)";GILIUKAI;7429853563;Taip;0;9;0;9
20666;"Pušynėlis (A. Mickevičiaus g. 21)";GILIUKAI;8464672994;Ne;0;5;0;5
20667;"Pušynėlis (A. Mickevičiaus g. 21)";GILIUKAI;9055713601;Taip;2;0;0;2
20668;"Pušynėlis (A. Mickevičiaus g. 21)";GILIUKAI;1904434730;Taip;0;0;4;4
20669;"Pušynėlis (A. Mickevičiaus g. 21)";GILIUKAI;3362971538;Taip;0;5;0;5
20670;"Pušynėlis (A. Mickevičiaus g. 21)";GILIUKAI;8699085292;Ne;0;1;0;1
20671;"Pušynėlis (A. Mickevičiaus g. 21)";LINELIS;4126444564;Ne;7;4;0;11
20672;"Pušynėlis (A. Mickevičiaus g. 21)";LINELIS;4738909947;Ne;0;6;0;6
20673;"Pušynėlis (A. Mickevičiaus g. 21)";LINELIS;3189188757;Taip;0;9;0;9
20674;"Pušynėlis (A. Mickevičiaus g. 21)";LINELIS;3682550072;Ne;3;3;0;6
20675;"Pušynėlis (A. Mickevičiaus g. 21)";LINELIS;8654487151;Taip;8;1;0;9
20676;"Pušynėlis (A. Mickevičiaus g. 21)";LINELIS;8837847094;Taip;0;6;4;10
20677;"Pušynėlis (A. Mickevičiaus g. 21)";LINELIS;6374352500;Taip;8;0;0;8
20678;"Pušynėlis (A. Mickevičiaus g. 21)";LINELIS;6374352500;Taip;8;0;0;8
20679;"Pušynėlis (A. Mickevičiaus g. 21)";LINELIS;9216703884;Taip;0;4;0;4
20680;"Pušynėlis (A. Mickevičiaus g. 21)";LINELIS;5668765825;Taip;13;4;0;17
20681;"Pušynėlis (A. Mickevičiaus g. 21)";LINELIS;3954867816;Taip;0;2;2;4
20682;"Pušynėlis (A. Mickevičiaus g. 21)";LINELIS;7685809238;Ne;0;4;0;4
20683;"Pušynėlis (A. Mickevičiaus g. 21)";LINELIS;7011836009;Taip;20;0;1;21
20684;"Pušynėlis (A. Mickevičiaus g. 21)";LINELIS;6735037523;Taip;11;2;2;15
20685;"Pušynėlis (A. Mickevičiaus g. 21)";LINELIS;9401101407;Taip;0;1;0;1
20686;"Pušynėlis (A. Mickevičiaus g. 21)";LINELIS;9147558926;Taip;0;1;0;1
20687;"Pušynėlis (A. Mickevičiaus g. 21)";LINELIS;7881263225;Taip;12;0;0;12
20688;"Pušynėlis (A. Mickevičiaus g. 21)";LINELIS;1612049897;Taip;0;7;0;7
20689;"Pušynėlis (A. Mickevičiaus g. 21)";LINELIS;9920959446;Taip;0;4;0;4
20690;"Pušynėlis (A. Mickevičiaus g. 21)";LINELIS;4898147530;Taip;0;1;0;1
20691;"Pušynėlis (A. Mickevičiaus g. 21)";LINELIS;2228682366;Taip;0;7;0;7
20692;"Pušynėlis (A. Mickevičiaus g. 21)";LINELIS;4464615995;Taip;12;1;0;13
20693;"Naminukas (Klinikų g. 5)";VARPELIAI;3281707263;Taip;4;0;3;7
20694;"Naminukas (Klinikų g. 5)";VARPELIAI;3683089217;Taip;2;0;0;2
20695;"Naminukas (Klinikų g. 5)";VARPELIAI;1086919259;Taip;14;0;0;14
20696;"Naminukas (Klinikų g. 5)";VARPELIAI;2576516583;Taip;0;5;0;5
20697;"Naminukas (Klinikų g. 5)";VARPELIAI;8694425584;Taip;7;3;1;11
20698;"Naminukas (Klinikų g. 5)";VARPELIAI;8782832803;Taip;4;0;0;4
20699;"Naminukas (Klinikų g. 5)";VARPELIAI;7555926818;Ne;10;0;3;13
20700;"Naminukas (Klinikų g. 5)";VARPELIAI;8392480469;Taip;4;0;0;4
20701;"Naminukas (Klinikų g. 5)";VARPELIAI;9426969493;Taip;1;0;0;1
20702;"Naminukas (Klinikų g. 5)";VARPELIAI;6834388512;Taip;15;0;1;16
20703;"Naminukas (Klinikų g. 5)";VARPELIAI;8212264128;Taip;11;0;1;12
20704;"Naminukas (Klinikų g. 5)";VARPELIAI;8659342548;Taip;5;0;2;7
20705;"Naminukas (Klinikų g. 5)";VARPELIAI;1415188327;Taip;14;0;0;14
20706;"Naminukas (Klinikų g. 5)";VARPELIAI;5154177047;Taip;14;0;0;14
20707;"Naminukas (Klinikų g. 5)";SAULUTĖS;7947598191;Taip;5;0;1;6
20708;"Naminukas (Klinikų g. 5)";SAULUTĖS;2516513740;Taip;6;1;0;7
20709;"Naminukas (Klinikų g. 5)";SAULUTĖS;2721723305;Taip;5;3;0;8
20710;"Naminukas (Klinikų g. 5)";SAULUTĖS;6559544449;Taip;0;0;1;1
20711;"Naminukas (Klinikų g. 5)";SAULUTĖS;8052458976;Taip;9;0;0;9
20712;"Naminukas (Klinikų g. 5)";SAULUTĖS;2089455192;Taip;4;0;0;4
20713;"Naminukas (Klinikų g. 5)";SAULUTĖS;1828220049;Taip;7;0;0;7
20714;"Naminukas (Klinikų g. 5)";SAULUTĖS;5172385044;Taip;12;0;0;12
20715;"Naminukas (Klinikų g. 5)";SAULUTĖS;7772300667;Taip;23;0;0;23
20716;"Naminukas (Klinikų g. 5)";SAULUTĖS;3497829075;Taip;5;0;0;5
20717;"Naminukas (Klinikų g. 5)";SAULUTĖS;6515021073;Taip;1;1;6;8
20718;"Naminukas (Klinikų g. 5)";SAULUTĖS;9894306360;Taip;6;6;0;12
20719;"Naminukas (Klinikų g. 5)";SAULUTĖS;5991261279;Taip;8;0;1;9
20720;"Naminukas (Klinikų g. 5)";SAULUTĖS;9537360943;Taip;4;0;3;7
20721;"Naminukas (Klinikų g. 5)";DRUGELIAI;7033053271;Taip;10;0;1;11
20722;"Naminukas (Klinikų g. 5)";DRUGELIAI;8432194383;Taip;0;5;0;5
20723;"Naminukas (Klinikų g. 5)";DRUGELIAI;9835701381;Ne;9;0;0;9
20724;"Naminukas (Klinikų g. 5)";DRUGELIAI;1092799944;Taip;0;0;2;2
20725;"Naminukas (Klinikų g. 5)";DRUGELIAI;8595804874;Taip;1;3;0;4
20726;"Naminukas (Klinikų g. 5)";DRUGELIAI;3911352454;Taip;14;0;0;14
20727;"Naminukas (Klinikų g. 5)";DRUGELIAI;7107337857;Taip;9;2;1;12
20728;"Naminukas (Klinikų g. 5)";DRUGELIAI;9212800864;Ne;9;2;0;11
20729;"Naminukas (Klinikų g. 5)";DRUGELIAI;2336627398;Taip;5;0;0;5
20730;"Naminukas (Klinikų g. 5)";DRUGELIAI;1879925655;Taip;0;2;0;2
20731;"Naminukas (Klinikų g. 5)";DRUGELIAI;2881576194;Taip;11;0;0;11
20732;"Naminukas (Klinikų g. 5)";DRUGELIAI;4836599508;Taip;5;0;0;5
20733;"Naminukas (Klinikų g. 5)";DRUGELIAI;4709625816;Taip;0;1;1;2
20734;"Naminukas (Klinikų g. 5)";DRUGELIAI;6471277755;Taip;0;4;0;4
20735;"Naminukas (Klinikų g. 5)";DRUGELIAI;1932169696;Taip;10;0;0;10
20736;"Naminukas (Klinikų g. 5)";DRUGELIAI;9215327479;Taip;10;0;0;10
20737;"Naminukas (Klinikų g. 5)";BITUTĖS;6592057292;Taip;6;4;0;10
20738;"Naminukas (Klinikų g. 5)";BITUTĖS;5578151523;Taip;4;0;0;4
20739;"Naminukas (Klinikų g. 5)";BITUTĖS;5288557629;Taip;10;6;0;16
20740;"Naminukas (Klinikų g. 5)";BITUTĖS;5233044803;Taip;3;0;0;3
20741;"Naminukas (Klinikų g. 5)";BITUTĖS;3791118736;Taip;3;0;1;4
20742;"Naminukas (Klinikų g. 5)";BITUTĖS;7099787230;Taip;6;1;0;7
20743;"Naminukas (Klinikų g. 5)";BITUTĖS;3088386659;Taip;6;3;0;9
20744;"Naminukas (Klinikų g. 5)";BITUTĖS;3276656641;Taip;0;0;3;3
20745;"Naminukas (Klinikų g. 5)";BITUTĖS;2004615252;Taip;0;2;1;3
20746;"Naminukas (Klinikų g. 5)";BITUTĖS;6633031473;Taip;5;1;0;6
20747;"Naminukas (Klinikų g. 5)";BITUTĖS;4116151797;Taip;3;0;2;5
20748;"Naminukas (Klinikų g. 5)";BITUTĖS;2339599448;Taip;0;1;0;1
20749;"Naminukas (Klinikų g. 5)";BITUTĖS;4077985773;Taip;1;3;0;4
20750;"Naminukas (Klinikų g. 5)";BITUTĖS;1454039572;Taip;2;0;0;2
20751;"Naminukas (Klinikų g. 5)";BITUTĖS;6949857110;Taip;0;4;0;4
20752;"Naminukas (Klinikų g. 5)";BITUTĖS;7463647806;Taip;4;0;0;4
20753;"Naminukas (Klinikų g. 5)";BITUTĖS;4171789569;Taip;0;4;0;4
20754;"Naminukas (Klinikų g. 5)";BITUTĖS;6880075874;Taip;7;1;0;8
20755;"Naminukas (Klinikų g. 5)";BITUTĖS;8793327541;Taip;0;1;0;1
20756;"Gervelė (Stadiono g. 5)";BORUŽĖLĖS;2696708010;Taip;1;0;0;1
20757;"Gervelė (Stadiono g. 5)";BORUŽĖLĖS;2136541073;Taip;3;0;0;3
20758;"Gervelė (Stadiono g. 5)";BORUŽĖLĖS;4354544070;Taip;7;0;0;7
20759;"Gervelė (Stadiono g. 5)";BORUŽĖLĖS;3448452820;Taip;20;0;0;20
20760;"Gervelė (Stadiono g. 5)";BORUŽĖLĖS;2794943031;Taip;12;0;0;12
20761;"Gervelė (Stadiono g. 5)";BORUŽĖLĖS;8763515382;Ne;7;0;0;7
20762;"Gervelė (Stadiono g. 5)";BORUŽĖLĖS;6340371637;Ne;7;0;0;7
20763;"Gervelė (Stadiono g. 5)";PAUKŠTELIAI;7959839478;Ne;8;0;0;8
20764;"Gervelė (Stadiono g. 5)";PAUKŠTELIAI;2892214705;Taip;3;8;0;11
20765;"Gervelė (Stadiono g. 5)";PAUKŠTELIAI;9154032804;Ne;6;4;0;10
20766;"Gervelė (Stadiono g. 5)";PAUKŠTELIAI;7843800194;Taip;5;0;0;5
20767;"Gervelė (Stadiono g. 5)";PAUKŠTELIAI;4588890423;Taip;0;10;0;10
20768;"Gervelė (Stadiono g. 5)";PAUKŠTELIAI;7847393041;Ne;17;1;0;18
20769;"Gervelė (Stadiono g. 5)";PAUKŠTELIAI;6427072260;Taip;1;0;0;1
20770;"Gervelė (Stadiono g. 5)";PAUKŠTELIAI;5285868851;Taip;4;0;0;4
20771;"Gervelė (Stadiono g. 5)";PAUKŠTELIAI;2622183564;Taip;10;11;0;21
20772;"Gervelė (Stadiono g. 5)";PAUKŠTELIAI;1006720360;Taip;1;4;0;5
20773;"Gervelė (Stadiono g. 5)";PAUKŠTELIAI;8190190100;Taip;6;0;0;6
20774;"Gervelė (Stadiono g. 5)";PAUKŠTELIAI;2712133300;Taip;10;1;0;11
20775;"Gervelė (Stadiono g. 5)";SPINDULĖLIAI;4051246539;Ne;0;0;1;1
20776;"Gervelė (Stadiono g. 5)";SPINDULĖLIAI;6241611652;Taip;0;9;0;9
20777;"Gervelė (Stadiono g. 5)";SPINDULĖLIAI;1204513844;Taip;0;4;1;5
20778;"Gervelė (Stadiono g. 5)";SPINDULĖLIAI;8710469480;Taip;0;6;0;6
20779;"Gervelė (Stadiono g. 5)";SPINDULĖLIAI;9777308731;Taip;3;9;0;12
20780;"Gervelė (Stadiono g. 5)";SPINDULĖLIAI;6573919007;Ne;4;0;0;4
20781;"Gervelė (Stadiono g. 5)";SPINDULĖLIAI;3676856569;Taip;5;0;0;5
20782;"Gervelė (Stadiono g. 5)";SPINDULĖLIAI;3567687304;Taip;0;0;2;2
20783;"Gervelė (Stadiono g. 5)";SPINDULĖLIAI;6372245141;Taip;0;4;1;5
20784;"Gervelė (Stadiono g. 5)";SPINDULĖLIAI;5818430690;Taip;9;0;0;9
20785;"Gervelė (Stadiono g. 5)";SPINDULĖLIAI;1515920896;Taip;2;0;1;3
20786;"Gervelė (Stadiono g. 5)";SPINDULĖLIAI;2031118410;Taip;0;10;0;10
20787;"Gervelė (Stadiono g. 5)";SPINDULĖLIAI;9542729826;Ne;0;0;1;1
20788;"Gervelė (Stadiono g. 5)";SPINDULĖLIAI;1751440418;Taip;3;0;0;3
20789;"Gervelė (Stadiono g. 5)";GĖLYTĖS;6621769160;Taip;7;0;0;7
20790;"Gervelė (Stadiono g. 5)";GĖLYTĖS;4832348492;Taip;0;2;0;2
20791;"Gervelė (Stadiono g. 5)";GĖLYTĖS;7855598075;Taip;0;8;0;8
20792;"Gervelė (Stadiono g. 5)";GĖLYTĖS;6488139414;Taip;5;4;0;9
20793;"Gervelė (Stadiono g. 5)";GĖLYTĖS;3216423543;Taip;7;0;0;7
20794;"Gervelė (Stadiono g. 5)";GĖLYTĖS;8423813651;Ne;0;0;2;2
20795;"Gervelė (Stadiono g. 5)";GĖLYTĖS;7952102572;Taip;5;4;6;15
20796;"Gervelė (Stadiono g. 5)";GĖLYTĖS;5966215998;Taip;18;0;0;18
20797;"Gervelė (Stadiono g. 5)";GĖLYTĖS;7463376031;Taip;0;10;0;10
20798;"Gervelė (Stadiono g. 5)";GĖLYTĖS;2431435960;Taip;0;3;5;8
20799;"Gervelė (Stadiono g. 5)";GĖLYTĖS;9100411947;Taip;5;4;0;9
20800;"Kūlverstukas (Mindaugo g. 7)";GNOMIKI;1720671485;Ne;0;7;0;7
20801;"Kūlverstukas (Mindaugo g. 7)";GNOMIKI;4894478262;Taip;1;7;0;8
20802;"Kūlverstukas (Mindaugo g. 7)";GNOMIKI;2501327054;Ne;4;2;0;6
20803;"Kūlverstukas (Mindaugo g. 7)";GNOMIKI;8348978878;Taip;4;4;0;8
20804;"Kūlverstukas (Mindaugo g. 7)";GNOMIKI;8927489885;Taip;14;0;0;14
20805;"Kūlverstukas (Mindaugo g. 7)";GNOMIKI;2709547427;Taip;11;4;0;15
20806;"Kūlverstukas (Mindaugo g. 7)";GNOMIKI;5532063862;Taip;5;0;0;5
20807;"Kūlverstukas (Mindaugo g. 7)";GNOMIKI;5747277587;Taip;0;2;5;7
20808;"Kūlverstukas (Mindaugo g. 7)";GNOMIKI;1848018684;Taip;0;7;0;7
20809;"Kūlverstukas (Mindaugo g. 7)";GNOMIKI;1166429762;Taip;15;1;0;16
20810;"Kūlverstukas (Mindaugo g. 7)";GNOMIKI;6514730230;Taip;6;2;0;8
20811;"Kūlverstukas (Mindaugo g. 7)";GNOMIKI;1916522637;Taip;0;0;2;2
20812;"Kūlverstukas (Mindaugo g. 7)";GNOMIKI;3239566139;Taip;0;9;0;9
20813;"Kūlverstukas (Mindaugo g. 7)";GNOMIKI;5260820316;Taip;0;7;0;7
20814;"Kūlverstukas (Mindaugo g. 7)";GNOMIKI;6387540242;Taip;2;2;1;5
20815;"Kūlverstukas (Mindaugo g. 7)";GNOMIKI;3029705994;Taip;2;0;1;3
20816;"Kūlverstukas (Mindaugo g. 7)";GNOMIKI;1869389013;Taip;2;2;0;4
20817;"Kūlverstukas (Mindaugo g. 7)";GNOMIKI;3201081769;Taip;9;0;3;12
20818;"Kūlverstukas (Mindaugo g. 7)";GNOMIKI;2822906102;Ne;4;2;0;6
20819;"Kūlverstukas (Mindaugo g. 7)";GNOMIKI;5879283662;Taip;2;0;4;6
20820;"Kūlverstukas (Mindaugo g. 7)";ZAIČIATA;8994705290;Taip;0;12;0;12
20821;"Kūlverstukas (Mindaugo g. 7)";ZAIČIATA;2494202134;Taip;0;3;0;3
20822;"Kūlverstukas (Mindaugo g. 7)";ZAIČIATA;2714297182;Taip;0;3;0;3
20823;"Kūlverstukas (Mindaugo g. 7)";ZAIČIATA;4998847820;Ne;6;0;0;6
20824;"Kūlverstukas (Mindaugo g. 7)";ZAIČIATA;3660002342;Taip;9;0;0;9
20825;"Kūlverstukas (Mindaugo g. 7)";ZAIČIATA;7883325884;Ne;4;0;0;4
20826;"Kūlverstukas (Mindaugo g. 7)";ZAIČIATA;6621027840;Taip;5;0;0;5
20827;"Kūlverstukas (Mindaugo g. 7)";ZAIČIATA;6090797103;Taip;7;0;0;7
20828;"Kūlverstukas (Mindaugo g. 7)";ZAIČIATA;6872789727;Taip;7;0;0;7
20829;"Kūlverstukas (Mindaugo g. 7)";ZAIČIATA;1229210560;Taip;5;0;0;5
20830;"Kūlverstukas (Mindaugo g. 7)";ZAIČIATA;9596978613;Taip;11;0;0;11
20831;"Kūlverstukas (Mindaugo g. 7)";ZAIČIATA;8841423764;Taip;1;0;0;1
20832;"Kūlverstukas (Mindaugo g. 7)";SVETLIAČKI;2154916232;Taip;0;9;0;9
20833;"Kūlverstukas (Mindaugo g. 7)";SVETLIAČKI;5794471794;Taip;0;0;1;1
20834;"Kūlverstukas (Mindaugo g. 7)";SVETLIAČKI;7829384850;Taip;6;0;0;6
20835;"Kūlverstukas (Mindaugo g. 7)";SVETLIAČKI;3449300504;Taip;0;3;0;3
20836;"Kūlverstukas (Mindaugo g. 7)";SVETLIAČKI;1102996499;Taip;4;0;0;4
20837;"Kūlverstukas (Mindaugo g. 7)";SVETLIAČKI;6311116034;Taip;4;0;0;4
20838;"Kūlverstukas (Mindaugo g. 7)";SVETLIAČKI;1635418112;Taip;2;0;0;2
20839;"Kūlverstukas (Mindaugo g. 7)";SVETLIAČKI;4352034102;Taip;6;0;0;6
20840;"Kūlverstukas (Mindaugo g. 7)";SVETLIAČKI;6497373567;Taip;4;0;0;4
20841;"Kūlverstukas (Mindaugo g. 7)";SVETLIAČKI;1034428300;Taip;1;0;0;1
20842;"Kūlverstukas (Mindaugo g. 7)";SVETLIAČKI;2434552926;Taip;1;0;0;1
20843;"Kūlverstukas (Mindaugo g. 7)";SVETLIAČKI;2589356040;Taip;6;0;0;6
20844;"Kūlverstukas (Mindaugo g. 7)";SVETLIAČKI;8496678513;Taip;1;0;0;1
20845;"Kūlverstukas (Mindaugo g. 7)";SVETLIAČKI;5079635330;Taip;6;0;0;6
20846;"Kūlverstukas (Mindaugo g. 7)";ZVONOČKI;8835111916;Taip;3;3;1;7
20847;"Kūlverstukas (Mindaugo g. 7)";ZVONOČKI;5724787637;Taip;0;1;0;1
20848;"Kūlverstukas (Mindaugo g. 7)";ZVONOČKI;9835391223;Taip;9;1;0;10
20849;"Kūlverstukas (Mindaugo g. 7)";ZVONOČKI;1566191212;Taip;0;0;2;2
20850;"Kūlverstukas (Mindaugo g. 7)";ZVONOČKI;9569296370;Taip;8;1;0;9
20851;"Kūlverstukas (Mindaugo g. 7)";ZVONOČKI;1047459617;Taip;3;0;0;3
20852;"Kūlverstukas (Mindaugo g. 7)";ZVONOČKI;2091204077;Ne;0;4;0;4
20853;"Kūlverstukas (Mindaugo g. 7)";ZVONOČKI;6463626516;Taip;0;4;14;18
20854;"Kūlverstukas (Mindaugo g. 7)";ZVONOČKI;8814110710;Taip;3;0;0;3
20855;"Kūlverstukas (Mindaugo g. 7)";ZVONOČKI;4152186586;Taip;0;3;0;3
20856;"Kūlverstukas (Mindaugo g. 7)";ZVONOČKI;6680792848;Ne;4;0;0;4
20857;"Kūlverstukas (Mindaugo g. 7)";ZVONOČKI;4424095457;Taip;4;1;0;5
20858;"Kūlverstukas (Mindaugo g. 7)";ZVONOČKI;1808699695;Taip;4;4;1;9
20859;"Kūlverstukas (Mindaugo g. 7)";ZVONOČKI;1646912457;Taip;0;1;0;1
20860;"Kūlverstukas (Mindaugo g. 7)";ZVONOČKI;4116831802;Ne;7;0;0;7
20861;"Kūlverstukas (Mindaugo g. 7)";ZVONOČKI;6219872984;Taip;4;1;2;7
20862;"Kūlverstukas (Mindaugo g. 7)";ZVONOČKI;9098427210;Taip;14;4;0;18
20863;"Vilniaus Pavilnio pagrindinė mokykla";"PRIEŠMOKYKLINĖ RU";1445328501;Taip;2;4;0;6
20864;"Vilniaus Pavilnio pagrindinė mokykla";"PRIEŠMOKYKLINĖ RU";6537464526;Taip;3;4;0;7
20865;"Vilniaus Pavilnio pagrindinė mokykla";"PRIEŠMOKYKLINĖ RU";1509519996;Taip;7;4;0;11
20866;"Vilniaus Pavilnio pagrindinė mokykla";"PRIEŠMOKYKLINĖ RU";5706671963;Taip;1;4;0;5
20867;"Vilniaus Pavilnio pagrindinė mokykla";"PRIEŠMOKYKLINĖ RU";1035890284;Ne;1;4;0;5
20868;"Vilniaus Pavilnio pagrindinė mokykla";"PRIEŠMOKYKLINĖ RU";4602268315;Taip;2;4;0;6
20869;"Vilniaus Pavilnio pagrindinė mokykla";"PRIEŠMOKYKLINĖ RU";4676626786;Ne;0;0;10;10
20870;"Vilniaus Pavilnio pagrindinė mokykla";"PRIEŠMOKYKLINĖ RU";1107633909;Ne;4;4;0;8
20871;"Vilniaus Pavilnio pagrindinė mokykla";"PRIEŠMOKYKLINĖ RU";1344983194;Taip;2;4;0;6
20872;"Vilniaus Pavilnio pagrindinė mokykla";"PRIEŠMOKYKLINĖ RU";8684207189;Ne;0;23;0;23
20873;"Vilniaus Pavilnio pagrindinė mokykla";"PRIEŠMOKYKLINĖ RU";8262619320;Taip;8;4;0;12
20874;"Vilniaus Pavilnio pagrindinė mokykla";"PRIEŠMOKYKLINĖ RU";4516507512;Ne;6;4;0;10
20875;"Vilniaus Pavilnio pagrindinė mokykla";"PRIEŠMOKYKLINĖ PL";4038279267;Taip;0;4;0;4
20876;"Vilniaus Pavilnio pagrindinė mokykla";"PRIEŠMOKYKLINĖ PL";9533901360;Taip;14;4;0;18
20877;"Vilniaus Pavilnio pagrindinė mokykla";"PRIEŠMOKYKLINĖ PL";6716558946;Taip;0;4;0;4
20878;"Lazdynų mokykla (Liudvinavo g.128)";DRUGELIAI;7524849851;Taip;5;4;0;9
20879;"Lazdynų mokykla (Liudvinavo g.128)";DRUGELIAI;8650496265;Taip;1;1;0;2
20880;"Lazdynų mokykla (Liudvinavo g.128)";DRUGELIAI;9196184984;Taip;0;5;0;5
20881;"Lazdynų mokykla (Liudvinavo g.128)";DRUGELIAI;2767732459;Ne;0;8;0;8
20882;"Lazdynų mokykla (Liudvinavo g.128)";DRUGELIAI;6394098306;Taip;6;0;0;6
20883;"Lazdynų mokykla (Liudvinavo g.128)";DRUGELIAI;7074859809;Taip;7;2;0;9
20884;"Lazdynų mokykla (Liudvinavo g.128)";DRUGELIAI;4097980299;Ne;1;4;0;5
20885;"Lazdynų mokykla (Liudvinavo g.128)";DRUGELIAI;8001610972;Ne;0;4;0;4
20886;"Lazdynų mokykla (Liudvinavo g.128)";DRUGELIAI;7590111138;Taip;1;6;0;7
20887;"Lazdynų mokykla (Liudvinavo g.128)";DRUGELIAI;2027751624;Taip;0;5;0;5
20888;"Lazdynų mokykla (Liudvinavo g.128)";ZUIKUČIAI;7232402011;Taip;0;1;0;1
20889;"Lazdynų mokykla (Liudvinavo g.128)";ZUIKUČIAI;4166599533;Taip;1;0;0;1
20890;"Lazdynų mokykla (Liudvinavo g.128)";ZUIKUČIAI;7000921682;Taip;1;3;0;4
20891;"Lazdynų mokykla (Liudvinavo g.128)";ZUIKUČIAI;3535244441;Taip;13;0;0;13
20892;"Lazdynų mokykla (Liudvinavo g.128)";ZUIKUČIAI;7594978836;Taip;0;6;0;6
20893;"Lazdynų mokykla (Liudvinavo g.128)";ZUIKUČIAI;5465094647;Taip;9;9;0;18
20894;"Lazdynų mokykla (Liudvinavo g.128)";ZUIKUČIAI;1044630813;Taip;0;1;0;1
20895;"Lazdynų mokykla (Liudvinavo g.128)";ZUIKUČIAI;7229926614;Taip;4;0;0;4
20896;"Lazdynų mokykla (Liudvinavo g.128)";ZUIKUČIAI;8899186547;Taip;5;0;0;5
20897;"Lazdynų mokykla (Liudvinavo g.128)";ZUIKUČIAI;5181200460;Taip;8;0;0;8
20898;"Vilniaus Šilo mokykla";Boružėlės;7122041826;Taip;15;1;0;16
20899;"Vilniaus Šilo mokykla";Boružėlės;9967276147;Taip;1;1;0;2
20900;"Vilniaus Šilo mokykla";Boružėlės;5962551687;Taip;4;4;0;8
20901;"Vilniaus Šilo mokykla";Boružėlės;1196172221;Ne;9;1;0;10
20902;"Vilniaus Šilo mokykla";Boružėlės;1538635985;Taip;5;4;0;9
20903;"Vilniaus Šilo mokykla";Boružėlės;6136087920;Taip;0;23;0;23
20904;"Vilniaus Šilo mokykla";Boružėlės;4544126354;Taip;9;4;0;13
20905;"Vilniaus Šilo mokykla";Boružėlės;8897729962;Ne;2;4;0;6
20906;"Vilniaus Šilo mokykla";"3 spec.";73899364649;Taip;0;4;0;4
20907;"Vilniaus Šilo mokykla";"3 spec.";1417978731;Taip;0;4;0;4
20908;"Vilniaus Šilo mokykla";"3 spec.";28814860843;Taip;0;23;0;23
20909;"Vilniaus Šilo mokykla";"3 spec.";93519259505;Taip;0;23;0;23
20910;"Vilniaus Šilo mokykla";"3 spec.";63472451321;Taip;0;23;0;23
20911;"Vilniaus Šilo mokykla";"3 spec.";3473596157;Taip;2;4;0;6
20912;"Vilniaus Šilo mokykla";"3 spec.";1475766630;Taip;0;23;0;23
20913;"Vilniaus Šilo mokykla";"3 spec.";1401546788;Taip;1;4;0;5
20914;"Vilniaus Šilo mokykla";"7-10 spec.";9944901942;Taip;1;4;0;5
20915;"Vilniaus Šilo mokykla";"7-10 spec.";3333634089;Taip;0;23;0;23
20916;"Vilniaus Šilo mokykla";"7-10 spec.";8548722736;Taip;0;4;0;4
20917;"Vilniaus Šilo mokykla";"7-10 spec.";5255365063;Taip;0;4;0;4
20918;"Vilniaus Šilo mokykla";"7-10 spec.";6452740859;Ne;0;4;0;4
20919;"Vilniaus Šilo mokykla";"7-10 spec.";60608633947;Ne;1;4;0;5
20920;"Vilniaus Šilo mokykla";"7-10 spec.";4906175269;Taip;0;4;0;4
20921;"Vilniaus Šilo mokykla";"7-10 spec.";9264140610;Taip;0;4;0;4
20922;"Vilniaus Šilo mokykla";"7-10 lav.";92425322676;Ne;0;4;0;4
20923;"Vilniaus Šilo mokykla";"7-10 lav.";5905008395;Taip;0;4;0;4
20924;"Vilniaus Šilo mokykla";"7-10 lav.";4738867530;Taip;0;4;0;4
20925;"Vilniaus Šilo mokykla";"7-10 lav.";81654551230;Taip;1;4;0;5
20926;"Vilniaus Šilo mokykla";"7-10 lav.";7740504510;Taip;0;4;0;4
20927;"Vilniaus Šilo mokykla";"7-10 lav.";5388697695;Taip;1;4;0;5
20928;"Vilniaus Šilo mokykla";"7-10 lav.";20604410476;Ne;0;4;0;4
20929;"Vilniaus Šilo mokykla";"7-10 lav.";6868265902;Taip;0;23;0;23
20930;"Vilniaus Šilo mokykla";"7-10 lav.";2234931428;Taip;0;23;0;23
20931;"Vilniaus Šilo mokykla";"SĮ A";6954467869;Taip;0;23;0;23
20932;"Vilniaus Šilo mokykla";"SĮ A";9354191217;Taip;1;4;0;5
20933;"Vilniaus Šilo mokykla";"SĮ A";9471629029;Taip;1;4;0;5
20934;"Vilniaus Šilo mokykla";"SĮ A";6088433049;Taip;3;4;0;7
20935;"Vilniaus Šilo mokykla";"SĮ A";1819519275;Ne;0;4;0;4
20936;"Vilniaus Šilo mokykla";"SĮ A";9845575989;Ne;2;4;0;6
20937;"Vilniaus Šilo mokykla";"SĮ A";3308772529;Taip;0;4;0;4
20938;"Vilniaus Šilo mokykla";"SĮ A";1726056983;Taip;6;4;0;10
20939;"Vilniaus Šilo mokykla";"SĮ A";3442250711;Ne;10;4;0;14
20940;"Vilniaus Šilo mokykla";"SĮ A";2755910347;Taip;1;4;0;5
20941;"Vilniaus Šilo mokykla";"SĮ C";1322335360;Taip;0;4;0;4
20942;"Vilniaus Šilo mokykla";"SĮ C";8642665550;Taip;0;4;0;4
20943;"Vilniaus Šilo mokykla";"SĮ C";5309862220;Taip;0;23;0;23
20944;"Vilniaus Šilo mokykla";"SĮ C";1010885560;Taip;0;4;0;4
20945;"Vilniaus Šilo mokykla";"SĮ C";2501187241;Ne;0;4;0;4
20946;"Vilniaus Šilo mokykla";"SĮ C";2681438925;Taip;0;4;0;4
20947;"Vilniaus Šilo mokykla";"8 spec.";948748525;Ne;1;4;0;5
20948;"Vilniaus Šilo mokykla";"8 spec.";1422218905;Taip;0;23;0;23
20949;"Vilniaus Šilo mokykla";"8 spec.";1177826873;Taip;0;4;0;4
20950;"Vilniaus Šilo mokykla";"8 spec.";3776046409;Taip;1;4;0;5
20951;"Vilniaus Šilo mokykla";"8 spec.";9784624648;Taip;1;4;0;5
20952;"Vilniaus Šilo mokykla";"8 spec.";3621978449;Taip;3;4;0;7
20953;"Vilniaus Šilo mokykla";"8 spec.";5186364504;Taip;0;23;0;23
20954;"Vilniaus Šilo mokykla";"8 spec.";9277299634;Taip;1;4;0;5
20955;"Vilniaus Šilo mokykla";"8 spec.";2672192094;Taip;0;4;0;4
20956;"Vilniaus Šilo mokykla";"8 spec.";2672192094;Taip;0;4;0;4
20957;"Vilniaus Šilo mokykla";"8-10 lav.";2020417997;Taip;4;4;0;8
20958;"Vilniaus Šilo mokykla";"8-10 lav.";1298624014;Taip;2;4;0;6
20959;"Vilniaus Šilo mokykla";"8-10 lav.";8926954085;Taip;0;4;0;4
20960;"Vilniaus Šilo mokykla";"8-10 lav.";7040253931;Taip;1;4;0;5
20961;"Vilniaus Šilo mokykla";"8-10 lav.";8276932013;Taip;1;4;0;5
20962;"Vilniaus Šilo mokykla";"7 lav.";3612746646;Taip;1;4;0;5
20963;"Vilniaus Šilo mokykla";"7 lav.";9054390753;Taip;0;4;0;4
20964;"Vilniaus Šilo mokykla";"7 lav.";29353956408;Taip;3;4;0;7
20965;"Vilniaus Šilo mokykla";"7 lav.";83007167743;Taip;0;4;0;4
20966;"Vilniaus Šilo mokykla";"7 lav.";2862598950;Ne;0;4;0;4
20967;"Vilniaus Šilo mokykla";"7 lav.";67989956617;Taip;0;23;0;23
20968;"Vilniaus Šilo mokykla";"7 lav.";49892720109;Taip;0;4;0;4
20969;"Vilniaus Šilo mokykla";"7 lav.";7418552136;Taip;0;4;0;4
20970;"Vilniaus Šilo mokykla";"7-8 lav.";4081645294;Taip;0;4;0;4
20971;"Vilniaus Šilo mokykla";"7-8 lav.";1705610089;Taip;0;23;0;23
20972;"Vilniaus Šilo mokykla";"7-8 lav.";62142659591;Taip;3;4;0;7
20973;"Vilniaus Šilo mokykla";"7-8 lav.";8566222716;Taip;8;4;0;12
20974;"Vilniaus Šilo mokykla";"7-8 lav.";7056277395;Taip;0;23;0;23
20975;"Vilniaus Šilo mokykla";"7-8 lav.";74897451962;Ne;5;4;0;9
20976;"Vilniaus Šilo mokykla";"7-8 lav.";6700004229;Taip;2;4;0;6
20977;"Vilniaus Šilo mokykla";"7-8 lav.";50288610995;Taip;16;4;0;20
20978;"Vilniaus Šilo mokykla";"7-8 lav.";4416954354;Ne;7;4;0;11
20979;"Vilniaus Šilo mokykla";"6-9 spec.";4887033681;Taip;2;4;0;6
20980;"Vilniaus Šilo mokykla";"6-9 spec.";61123788986;Taip;0;23;0;23
20981;"Vilniaus Šilo mokykla";"6-9 spec.";2631958308;Taip;2;4;0;6
20982;"Vilniaus Šilo mokykla";"6-9 spec.";73335629450;Ne;0;4;0;4
20983;"Vilniaus Šilo mokykla";"6-9 spec.";6695507703;Ne;2;4;0;6
20984;"Vilniaus Šilo mokykla";"6-9 spec.";94126055953;Ne;4;4;0;8
20985;"Vilniaus Šilo mokykla";"6-9 spec.";6930420609;Taip;0;4;0;4
20986;"Vilniaus Šilo mokykla";"5-10 lav.";6356218442;Taip;1;4;0;5
20987;"Vilniaus Šilo mokykla";"5-10 lav.";88721781220;Ne;1;0;0;1
20988;"Vilniaus Šilo mokykla";"5-10 lav.";4990112920;Taip;1;4;0;5
20989;"Vilniaus Šilo mokykla";"5-10 lav.";9057435844;Taip;3;4;0;7
20990;"Vilniaus Šilo mokykla";"5-10 lav.";7354905114;Taip;14;4;0;18
20991;"Vilniaus Šilo mokykla";"5-10 lav.";4890362155;Taip;0;4;0;4
20992;"Vilniaus Šilo mokykla";"5-10 lav.";2000234311;Taip;6;4;0;10
20993;"Vilniaus Šilo mokykla";"5-10 lav.";63508565206;Ne;0;4;0;4
20994;"Vilniaus Šilo mokykla";"5-6 spec. RU";3419495275;Taip;5;4;0;9
20995;"Vilniaus Šilo mokykla";"5-6 spec. RU";9789373884;Taip;0;23;0;23
20996;"Vilniaus Šilo mokykla";"5-6 spec. RU";1989565075;Ne;0;23;0;23
20997;"Vilniaus Šilo mokykla";"5-6 spec. RU";11529512484;Taip;4;4;0;8
20998;"Vilniaus Šilo mokykla";"5-6 spec. RU";13277011762;Taip;0;4;0;4
20999;"Vilniaus Šilo mokykla";"5-6 spec. RU";34463714051;Ne;0;4;0;4
21000;"Vilniaus Šilo mokykla";"5-6 lav.";7329254454;Taip;0;23;0;23
21001;"Vilniaus Šilo mokykla";"5-6 lav.";1535004699;Ne;14;4;0;18
21002;"Vilniaus Šilo mokykla";"5-6 lav.";3194974747;Taip;2;4;0;6
21003;"Vilniaus Šilo mokykla";"5-6 lav.";26052502707;Taip;5;4;0;9
21004;"Vilniaus Šilo mokykla";"5-6 lav.";74782962545;Ne;0;23;0;23
21005;"Vilniaus Šilo mokykla";"5-6 lav.";72751441075;Taip;0;4;0;4
21006;"Vilniaus Šilo mokykla";"5-6 lav.";87692349348;Taip;0;23;0;23
21007;"Vilniaus Šilo mokykla";"3-4 spec. LT";5835827997;Ne;0;23;0;23
21008;"Vilniaus Šilo mokykla";"3-4 spec. LT";17920063762;Taip;0;4;0;4
21009;"Vilniaus Šilo mokykla";"3-4 spec. LT";7418149721;Taip;3;4;0;7
21010;"Vilniaus Šilo mokykla";"3-4 spec. LT";7418149721;Taip;3;4;0;7
21011;"Vilniaus Šilo mokykla";"3-4 spec. LT";19739614989;Taip;0;4;0;4
21012;"Vilniaus Šilo mokykla";"3-4 spec. LT";3366848846;Taip;1;4;0;5
21013;"Vilniaus Šilo mokykla";"3-4 spec. LT";78634860827;Taip;0;4;0;4
21014;"Vilniaus Šilo mokykla";"3-4 spec. LT";67103811533;Taip;0;4;0;4
21015;"Vilniaus Šilo mokykla";"3-4 spec. LT";30738331224;Taip;0;4;0;4
21016;"Vilniaus Šilo mokykla";"1 spec. B";3237698420;Taip;5;4;0;9
21017;"Vilniaus Šilo mokykla";"1 spec. B";1657452686;Taip;1;4;0;5
21018;"Vilniaus Šilo mokykla";"1 spec. B";3055294324;Taip;1;4;0;5
21019;"Vilniaus Šilo mokykla";"1 spec. B";9072764004;Taip;0;4;0;4
21020;"Vilniaus Šilo mokykla";"1 spec. B";1739403100;Taip;0;23;0;23
21021;"Vilniaus Šilo mokykla";"1 spec. B";8500010303;Taip;0;23;0;23
21022;"Vilniaus Šilo mokykla";"1 spec. B";60265156684;Taip;2;4;0;6
21023;"Vilniaus Šilo mokykla";"2-4 spec. RU";4908579339;Taip;4;4;0;8
21024;"Vilniaus Šilo mokykla";"2-4 spec. RU";2401287472;Taip;15;0;0;15
21025;"Vilniaus Šilo mokykla";"2-4 spec. RU";8817950372;Taip;0;4;0;4
21026;"Vilniaus Šilo mokykla";"2-4 spec. RU";8817950372;Taip;0;4;0;4
21027;"Vilniaus Šilo mokykla";"2-4 spec. RU";70678189213;Taip;0;4;0;4
21028;"Vilniaus Šilo mokykla";"2-4 spec. RU";4078721064;Ne;2;4;0;6
21029;"Vilniaus Šilo mokykla";"2-4 spec. RU";4574965127;Ne;0;4;0;4
21030;"Vilniaus Šilo mokykla";"2 spec.";1153167430;Taip;5;4;0;9
21031;"Vilniaus Šilo mokykla";"2 spec.";4438939800;Ne;0;4;0;4
21032;"Vilniaus Šilo mokykla";"2 spec.";1971717759;Ne;4;4;0;8
21033;"Vilniaus Šilo mokykla";"2 spec.";1180183091;Taip;0;23;0;23
21034;"Vilniaus Šilo mokykla";"2 spec.";8863021708;Ne;0;4;0;4
21035;"Vilniaus Šilo mokykla";"3-4 lav. ";3127870635;Taip;1;4;0;5
21036;"Vilniaus Šilo mokykla";"3-4 lav. ";1505697405;Ne;0;4;0;4
21037;"Vilniaus Šilo mokykla";"3-4 lav. ";1999375828;Taip;0;23;0;23
21038;"Vilniaus Šilo mokykla";"3-4 lav. ";3748420427;Taip;9;4;0;13
21039;"Vilniaus Šilo mokykla";"3-4 lav. ";2954393415;Taip;5;4;0;9
21040;"Vilniaus Šilo mokykla";"1 spec. A";5311183877;Taip;19;4;0;23
21041;"Vilniaus Šilo mokykla";"1 spec. A";1675384533;Taip;8;4;0;12
21042;"Vilniaus Šilo mokykla";"1 spec. A";2070454339;Ne;0;23;0;23
21043;"Vilniaus Šilo mokykla";"1 spec. A";8915901727;Taip;4;4;0;8
21044;"Vilniaus Šilo mokykla";"1 spec. A";7966574791;Taip;6;4;0;10
21045;"Vilniaus Šilo mokykla";"1 spec. A";2048595572;Taip;0;4;0;4
21046;"Vilniaus Šilo mokykla";"1 spec. A";30383556768;Taip;0;23;0;23
21047;"Vilniaus Šilo mokykla";"5-6 spec. ";90363704660;Taip;3;4;0;7
21048;"Vilniaus Šilo mokykla";"5-6 spec. ";1079077463;Taip;3;4;0;7
21049;"Vilniaus Šilo mokykla";"5-6 spec. ";2321953405;Ne;6;4;0;10
21050;"Vilniaus Šilo mokykla";"5-6 spec. ";2093680385;Taip;3;4;0;7
21051;"Vilniaus Šilo mokykla";"5-6 spec. ";3352991548;Ne;1;4;0;5
21052;"Vilniaus Šilo mokykla";"5-6 spec. ";1340301492;Taip;2;4;0;6
21053;"Vilniaus Šilo mokykla";"5-6 spec. ";987829287;Taip;0;4;0;4
21054;"Vilniaus Šilo mokykla";"5-6 spec. ";99943424821;Taip;0;4;0;4
21055;Malūnėlis;BITUTĖS;1001575740;Taip;7;0;0;7
21056;Malūnėlis;BITUTĖS;8618778205;Taip;5;4;0;9
21057;Malūnėlis;BITUTĖS;3329510128;Taip;8;3;0;11
21058;Malūnėlis;BITUTĖS;5402027714;Taip;0;2;0;2
21059;Malūnėlis;BITUTĖS;6199265600;Taip;8;1;0;9
21060;Malūnėlis;BITUTĖS;7144098762;Taip;9;5;0;14
21061;Malūnėlis;BITUTĖS;1146723570;Taip;8;0;0;8
21062;Malūnėlis;BITUTĖS;9891418762;Taip;8;7;0;15
21063;Malūnėlis;BITUTĖS;8642960989;Taip;0;1;1;2
21064;Malūnėlis;BITUTĖS;5959610426;Taip;9;0;0;9
21065;Malūnėlis;BITUTĖS;4367009696;Taip;2;9;0;11
21066;Malūnėlis;BITUTĖS;9936144392;Taip;2;0;0;2
21067;Malūnėlis;BITUTĖS;8643210289;Taip;2;0;0;2
21068;Malūnėlis;BITUTĖS;8440160819;Taip;3;6;0;9
21069;Malūnėlis;BITUTĖS;1528972517;Taip;0;18;0;18
21070;Malūnėlis;BITUTĖS;4202723476;Taip;11;0;0;11
21071;Malūnėlis;BITUTĖS;8007350745;Taip;0;1;0;1
21072;Malūnėlis;BITUTĖS;3402561453;Ne;5;11;0;16
21073;Malūnėlis;BITUTĖS;6805587761;Taip;9;2;0;11
21074;Malūnėlis;BITUTĖS;2495112045;Taip;13;3;0;16
21075;Malūnėlis;BITUTĖS;4802771311;Taip;0;4;0;4
21076;Malūnėlis;BITUTĖS;3935474148;Taip;0;4;0;4
21077;Malūnėlis;BITUTĖS;8528076375;Taip;0;5;0;5
21078;Malūnėlis;VOVERIUKAI;3779723692;Taip;0;2;0;2
21079;Malūnėlis;VOVERIUKAI;9592117637;Taip;0;2;0;2
21080;Malūnėlis;VOVERIUKAI;2029506037;Taip;5;1;0;6
21081;Malūnėlis;VOVERIUKAI;2246526281;Taip;0;1;0;1
21082;Malūnėlis;VOVERIUKAI;2192305527;Taip;10;2;0;12
21083;Malūnėlis;VOVERIUKAI;3371260811;Taip;0;6;0;6
21084;Malūnėlis;VOVERIUKAI;5061720786;Taip;1;4;0;5
21085;Malūnėlis;VOVERIUKAI;1770049356;Taip;7;0;0;7
21086;Malūnėlis;VOVERIUKAI;6081634102;Taip;11;2;0;13
21087;Malūnėlis;VOVERIUKAI;5540120728;Taip;11;5;0;16
21088;Malūnėlis;VOVERIUKAI;7556990784;Taip;1;0;0;1
21089;Malūnėlis;VOVERIUKAI;2525923211;Taip;0;4;0;4
21090;Malūnėlis;VOVERIUKAI;1574941416;Taip;2;1;0;3
21091;Malūnėlis;VOVERIUKAI;6531364407;Taip;1;0;0;1
21092;Malūnėlis;VOVERIUKAI;5727725132;Taip;0;4;0;4
21093;Malūnėlis;VOVERIUKAI;2637299307;Taip;2;0;0;2
21094;Malūnėlis;VOVERIUKAI;5686301875;Taip;7;1;0;8
21095;Malūnėlis;BORUŽĖLĖS;8551271848;Taip;0;0;3;3
21096;Malūnėlis;BORUŽĖLĖS;4787212056;Taip;3;0;0;3
21097;Malūnėlis;BORUŽĖLĖS;9185138453;Taip;14;5;0;19
21098;Malūnėlis;BORUŽĖLĖS;7350160970;Taip;4;1;0;5
21099;Malūnėlis;BORUŽĖLĖS;5722497620;Taip;0;3;0;3
21100;Malūnėlis;BORUŽĖLĖS;3364355098;Taip;7;4;0;11
21101;Malūnėlis;BORUŽĖLĖS;9539119799;Taip;0;2;0;2
21102;Malūnėlis;BORUŽĖLĖS;1523505295;Taip;12;0;1;13
21103;Malūnėlis;BORUŽĖLĖS;7756102926;Taip;12;0;1;13
21104;Malūnėlis;BORUŽĖLĖS;4164843364;Taip;0;4;0;4
21105;Malūnėlis;BORUŽĖLĖS;3504339452;Taip;0;5;0;5
21106;Malūnėlis;BORUŽĖLĖS;5197527972;Taip;1;0;0;1
21107;Malūnėlis;BORUŽĖLĖS;4288943715;Taip;5;0;2;7
21108;Malūnėlis;Skruzdėliukų;9798968369;Taip;1;0;0;1
21109;Malūnėlis;Skruzdėliukų;4859886340;Taip;7;0;0;7
21110;Malūnėlis;Skruzdėliukų;1213476648;Taip;7;0;0;7
21111;Malūnėlis;Skruzdėliukų;9300944734;Taip;15;2;0;17
21112;Malūnėlis;Skruzdėliukų;5877882690;Taip;1;3;0;4
21113;Malūnėlis;Skruzdėliukų;5474437579;Taip;3;0;0;3
21114;Malūnėlis;Skruzdėliukų;1549241453;Taip;12;0;0;12
21115;Malūnėlis;Skruzdėliukų;5478561852;Taip;2;1;0;3
21116;Malūnėlis;Skruzdėliukų;9207327884;Ne;0;8;0;8
21117;Malūnėlis;Skruzdėliukų;6609446450;Taip;5;0;0;5
21118;Malūnėlis;Skruzdėliukų;5687585794;Taip;15;0;0;15
21119;Malūnėlis;Skruzdėliukų;8076487157;Taip;2;0;0;2
21120;Malūnėlis;Skruzdėliukų;8751365673;Ne;1;0;1;2
21121;Malūnėlis;Skruzdėliukų;4307232411;Taip;2;1;0;3
21122;Malūnėlis;Skruzdėliukų;6575258889;Taip;1;0;1;2
21123;Malūnėlis;Skruzdėliukų;1003043129;Taip;10;0;0;10
21124;Malūnėlis;Skruzdėliukų;7983537913;Taip;0;9;0;9
21125;Malūnėlis;Skruzdėliukų;9894452403;Taip;9;1;0;10
21126;Malūnėlis;Skruzdėliukų;9342720464;Taip;0;4;0;4
21127;Malūnėlis;Skruzdėliukų;5232728972;Taip;3;0;0;3
21128;Malūnėlis;Skruzdėliukų;2574604828;Taip;7;4;0;11
21129;Malūnėlis;Skruzdėliukų;5909022614;Taip;2;0;0;2
21130;Malūnėlis;Žirniukų;3791873303;Taip;7;7;0;14
21131;Malūnėlis;Žirniukų;3031849277;Taip;6;1;0;7
21132;Malūnėlis;Žirniukų;6747286787;Taip;0;5;0;5
21133;Malūnėlis;Žirniukų;4539998453;Taip;4;1;0;5
21134;Malūnėlis;Žirniukų;4841028952;Ne;7;3;0;10
21135;Malūnėlis;Žirniukų;7097858329;Taip;7;0;0;7
21136;Malūnėlis;Žirniukų;5893575540;Taip;18;0;0;18
21137;Malūnėlis;Žirniukų;1398391534;Taip;7;0;0;7
21138;Malūnėlis;Žirniukų;2961972215;Taip;12;0;0;12
21139;Malūnėlis;Žirniukų;5622982984;Taip;3;0;0;3
21140;Malūnėlis;Žirniukų;3315571256;Taip;3;0;0;3
21141;Malūnėlis;Žirniukų;3315571256;Taip;3;0;0;3
21142;Malūnėlis;Žirniukų;3315571256;Taip;3;0;0;3
21143;Malūnėlis;Žirniukų;3464224841;Taip;12;0;0;12
21144;Malūnėlis;Žirniukų;6047042736;Taip;9;0;0;9
21145;Malūnėlis;Žirniukų;4875859413;Taip;11;0;0;11
21146;Malūnėlis;Žirniukų;6647872886;Taip;5;1;0;6
21147;Malūnėlis;Žirniukų;9559372808;Taip;5;6;0;11
21148;Malūnėlis;Žirniukų;1407908511;Taip;1;0;0;1
21149;"Dainorėliai (Goštauto g. 4)";PUMPURĖLIAI;6132543858;Taip;0;9;8;17
21150;"Dainorėliai (Goštauto g. 4)";PUMPURĖLIAI;4560328911;Taip;3;5;9;17
21151;"Dainorėliai (Goštauto g. 4)";PUMPURĖLIAI;4435310580;Taip;2;3;13;18
21152;"Dainorėliai (Goštauto g. 4)";PUMPURĖLIAI;7197089520;Taip;8;5;2;15
21153;"Dainorėliai (Goštauto g. 4)";PUMPURĖLIAI;5534783929;Taip;7;0;0;7
21154;"Dainorėliai (Goštauto g. 4)";PUMPURĖLIAI;4848146301;Taip;0;2;1;3
21155;"Dainorėliai (Goštauto g. 4)";PUMPURĖLIAI;1796037404;Taip;0;4;0;4
21156;"Dainorėliai (Goštauto g. 4)";PUMPURĖLIAI;1030872812;Taip;0;3;0;3
21157;"Dainorėliai (Goštauto g. 4)";PUMPURĖLIAI;7986631005;Taip;6;4;2;12
21158;"Dainorėliai (Goštauto g. 4)";PUMPURĖLIAI;7802165127;Taip;0;3;0;3
21159;"Dainorėliai (Goštauto g. 4)";PUMPURĖLIAI;6203352124;Taip;3;0;0;3
21160;"Dainorėliai (Goštauto g. 4)";DEBESĖLIŲ;6513417505;Taip;8;4;0;12
21161;"Dainorėliai (Goštauto g. 4)";DEBESĖLIŲ;1873415679;Ne;0;1;0;1
21162;"Dainorėliai (Goštauto g. 4)";DEBESĖLIŲ;4286864865;Taip;4;0;0;4
21163;"Dainorėliai (Goštauto g. 4)";DEBESĖLIŲ;1554081754;Taip;5;0;0;5
21164;"Dainorėliai (Goštauto g. 4)";DEBESĖLIŲ;9285865812;Taip;0;4;0;4
21165;"Dainorėliai (Goštauto g. 4)";DEBESĖLIŲ;6284140548;Taip;0;6;1;7
21166;"Dainorėliai (Goštauto g. 4)";DEBESĖLIŲ;6362265057;Taip;6;0;0;6
21167;"Dainorėliai (Goštauto g. 4)";DEBESĖLIŲ;3705286231;Taip;0;2;0;2
21168;"Dainorėliai (Goštauto g. 4)";DEBESĖLIŲ;1233029451;Taip;4;15;0;19
21169;"Dainorėliai (Goštauto g. 4)";DEBESĖLIŲ;6449332338;Taip;0;5;0;5
21170;"Krivūlė (Vokiečių g. 1)";PABIRUČIAI;1944288576;Taip;0;4;0;4
21171;"Krivūlė (Vokiečių g. 1)";PABIRUČIAI;3696403149;Taip;7;1;3;11
21172;"Krivūlė (Vokiečių g. 1)";PABIRUČIAI;5721252419;Taip;0;0;2;2
21173;"Krivūlė (Vokiečių g. 1)";PABIRUČIAI;4600688626;Taip;0;0;1;1
21174;"Krivūlė (Vokiečių g. 1)";PABIRUČIAI;8678565710;Taip;5;0;8;13
21175;"Krivūlė (Vokiečių g. 1)";PABIRUČIAI;3138555448;Taip;11;10;0;21
21176;"Krivūlė (Vokiečių g. 1)";PABIRUČIAI;3227555647;Taip;0;0;2;2
21177;"Krivūlė (Vokiečių g. 1)";PABIRUČIAI;6632875947;Taip;4;2;0;6
21178;"Krivūlė (Vokiečių g. 1)";PABIRUČIAI;7556723960;Taip;9;0;0;9
21179;"Krivūlė (Vokiečių g. 1)";PABIRUČIAI;6422534805;Taip;0;4;1;5
21180;"Krivūlė (Vokiečių g. 1)";PABIRUČIAI;3209201717;Taip;6;0;0;6
21181;"Krivūlė (Vokiečių g. 1)";SMALSUČIAI;5304221329;Taip;0;4;2;6
21182;"Krivūlė (Vokiečių g. 1)";SMALSUČIAI;7508079584;Taip;10;0;2;12
21183;"Krivūlė (Vokiečių g. 1)";SMALSUČIAI;7997564406;Taip;0;5;0;5
21184;"Krivūlė (Vokiečių g. 1)";SMALSUČIAI;8710938907;Taip;0;0;8;8
21185;"Krivūlė (Vokiečių g. 1)";SMALSUČIAI;4491462086;Taip;3;0;6;9
21186;"Krivūlė (Vokiečių g. 1)";SMALSUČIAI;4773564048;Taip;0;0;5;5
21187;"Krivūlė (Vokiečių g. 1)";SMALSUČIAI;3324090723;Taip;0;0;3;3
21188;"Krivūlė (Vokiečių g. 1)";SMALSUČIAI;8042469720;Taip;0;5;0;5
21189;"Krivūlė (Vokiečių g. 1)";SMALSUČIAI;4845066055;Taip;0;4;17;21
21190;"Krivūlė (Vokiečių g. 1)";SMALSUČIAI;7528273082;Taip;0;4;0;4
21191;"Krivūlė (Vokiečių g. 1)";SMALSUČIAI;6521798502;Taip;0;0;2;2
21192;"Krivūlė (Vokiečių g. 1)";SMALSUČIAI;1851097789;Taip;0;0;5;5
21193;"Krivūlė (Vokiečių g. 1)";GUDRUČIAI;8520470321;Taip;0;0;1;1
21194;"Krivūlė (Vokiečių g. 1)";GUDRUČIAI;5753204752;Taip;3;0;1;4
21195;"Krivūlė (Vokiečių g. 1)";GUDRUČIAI;2536472220;Taip;0;0;4;4
21196;"Krivūlė (Vokiečių g. 1)";GUDRUČIAI;7727246187;Taip;0;4;0;4
21197;"Krivūlė (Vokiečių g. 1)";GUDRUČIAI;6072261879;Taip;9;0;4;13
21198;"Krivūlė (Vokiečių g. 1)";GUDRUČIAI;7904390075;Taip;0;6;0;6
21199;"Krivūlė (Vokiečių g. 1)";GUDRUČIAI;6931566125;Taip;0;0;4;4
21200;"Krivūlė (Vokiečių g. 1)";GUDRUČIAI;5149419581;Taip;0;0;5;5
21201;"Krivūlė (Vokiečių g. 1)";GUDRUČIAI;9693693101;Taip;7;0;1;8
21202;"Krivūlė (Vokiečių g. 1)";GUDRUČIAI;5462491857;Ne;0;5;3;8
21203;"Krivūlė (Vokiečių g. 1)";GUDRUČIAI;8871794542;Taip;0;4;1;5
21204;"Krivūlė (Vokiečių g. 1)";GUDRUČIAI;3076382863;Taip;0;1;3;4
21205;"Krivūlė (Vokiečių g. 1)";GUDRUČIAI;5199600243;Taip;0;4;1;5
21206;"Pumpurėlis (Trinapolio g. 11)";GUDRUČIAI;3387386473;Taip;0;6;0;6
21207;"Pumpurėlis (Trinapolio g. 11)";GUDRUČIAI;7177681927;Taip;3;0;0;3
21208;"Pumpurėlis (Trinapolio g. 11)";GUDRUČIAI;2130008026;Taip;2;0;2;4
21209;"Pumpurėlis (Trinapolio g. 11)";GUDRUČIAI;8475215020;Taip;0;0;2;2
21210;"Pumpurėlis (Trinapolio g. 11)";GUDRUČIAI;3333547914;Taip;13;0;2;15
21211;"Pumpurėlis (Trinapolio g. 11)";GUDRUČIAI;9550967420;Taip;20;0;2;22
21212;"Pumpurėlis (Trinapolio g. 11)";GUDRUČIAI;1750311606;Taip;0;0;2;2
21213;"Pumpurėlis (Trinapolio g. 11)";GUDRUČIAI;8134060801;Taip;0;23;0;23
21214;"Pumpurėlis (Trinapolio g. 11)";GUDRUČIAI;1682281017;Taip;4;0;2;6
21215;"Pumpurėlis (Trinapolio g. 11)";GUDRUČIAI;9154835447;Taip;3;0;0;3
21216;"Pumpurėlis (Trinapolio g. 11)";GUDRUČIAI;3546444707;Taip;2;0;1;3
21217;"Pumpurėlis (Trinapolio g. 11)";GUDRUČIAI;2071687578;Taip;4;0;5;9
21218;"Pumpurėlis (Trinapolio g. 11)";GUDRUČIAI;8090926450;Taip;9;0;3;12
21219;"Pumpurėlis (Trinapolio g. 11)";GUDRUČIAI;6459621192;Taip;18;0;0;18
21220;"Pumpurėlis (Trinapolio g. 11)";GUDRUČIAI;6766514486;Taip;2;1;0;3
21221;"Pumpurėlis (Trinapolio g. 11)";PABIRUČIAI;9824315755;Taip;0;2;0;2
21222;"Pumpurėlis (Trinapolio g. 11)";PABIRUČIAI;4565317498;Taip;12;0;0;12
21223;"Pumpurėlis (Trinapolio g. 11)";PABIRUČIAI;7910361194;Taip;12;11;0;23
21224;"Pumpurėlis (Trinapolio g. 11)";PABIRUČIAI;5249717804;Taip;1;0;0;1
21225;"Pumpurėlis (Trinapolio g. 11)";PABIRUČIAI;5403012236;Taip;0;5;0;5
21226;"Pumpurėlis (Trinapolio g. 11)";PABIRUČIAI;4955734206;Taip;14;0;0;14
21227;"Pumpurėlis (Trinapolio g. 11)";PABIRUČIAI;8704865319;Ne;6;8;0;14
21228;"Pumpurėlis (Trinapolio g. 11)";PABIRUČIAI;4696006714;Taip;6;0;0;6
21229;"Pumpurėlis (Trinapolio g. 11)";PABIRUČIAI;9597889927;Taip;0;3;0;3
21230;"Pumpurėlis (Trinapolio g. 11)";PABIRUČIAI;2187090934;Taip;4;0;0;4
21231;"Pumpurėlis (Trinapolio g. 11)";PABIRUČIAI;1222204689;Taip;18;0;0;18
21232;"Pumpurėlis (Trinapolio g. 11)";PABIRUČIAI;6920353753;Taip;7;2;0;9
21233;"Pumpurėlis (Trinapolio g. 11)";PABIRUČIAI;6920353753;Taip;7;2;0;9
21234;"Pumpurėlis (Trinapolio g. 11)";PABIRUČIAI;3841134563;Taip;1;0;1;2
21235;"Pumpurėlis (Trinapolio g. 11)";PABIRUČIAI;3841134563;Taip;1;0;1;2
21236;"Pumpurėlis (Trinapolio g. 11)";PABIRUČIAI;3841134563;Taip;1;0;1;2
21237;"Pumpurėlis (Trinapolio g. 11)";PABIRUČIAI;6732130591;Taip;9;0;0;9
21238;"Pumpurėlis (Trinapolio g. 11)";PABIRUČIAI;7145050820;Taip;0;0;2;2
21239;"Pumpurėlis (Trinapolio g. 11)";PABIRUČIAI;3464806589;Ne;0;0;2;2
21240;"Pumpurėlis (Trinapolio g. 11)";PABIRUČIAI;9012133443;Ne;18;0;0;18
21241;"Pumpurėlis (Trinapolio g. 11)";PABIRUČIAI;5703275497;Taip;7;0;0;7
21242;"Pumpurėlis (Trinapolio g. 11)";PABIRUČIAI;7199184901;Taip;4;0;2;6
21243;"Gilužis (Įsruties g. 30)";AITVARIUKŲ;3612834040;Taip;9;0;0;9
21244;"Gilužis (Įsruties g. 30)";AITVARIUKŲ;6279641042;Taip;4;0;1;5
21245;"Gilužis (Įsruties g. 30)";AITVARIUKŲ;6430615720;Taip;11;0;1;12
21246;"Gilužis (Įsruties g. 30)";AITVARIUKŲ;4351997862;Taip;18;0;0;18
21247;"Gilužis (Įsruties g. 30)";AITVARIUKŲ;2094662680;Taip;17;1;0;18
21248;"Gilužis (Įsruties g. 30)";AITVARIUKŲ;6020457766;Taip;9;0;3;12
21249;"Gilužis (Įsruties g. 30)";AITVARIUKŲ;8950433662;Taip;14;0;0;14
21250;"Gilužis (Įsruties g. 30)";AITVARIUKŲ;1766021430;Taip;4;0;0;4
21251;"Gilužis (Įsruties g. 30)";AITVARIUKŲ;2401999477;Taip;10;0;1;11
21252;"Gilužis (Įsruties g. 30)";AITVARIUKŲ;8268273217;Taip;6;0;1;7
21253;"Gilužis (Įsruties g. 30)";AITVARIUKŲ;9434214933;Taip;15;0;0;15
21254;"Gilužis (Įsruties g. 30)";AITVARIUKŲ;4731369089;Taip;8;0;0;8
21255;"Gilužis (Įsruties g. 30)";AITVARIUKŲ;2614683353;Taip;23;0;0;23
21256;"Gilužis (Įsruties g. 30)";AITVARIUKŲ;2657805562;Taip;17;0;0;17
21257;"Gilužis (Įsruties g. 30)";AITVARIUKŲ;6713383000;Taip;4;0;0;4
21258;"Gilužis (Įsruties g. 30)";SPINDULIUKŲ;8951766269;Taip;7;0;1;8
21259;"Gilužis (Įsruties g. 30)";SPINDULIUKŲ;8712363813;Taip;5;4;0;9
21260;"Gilužis (Įsruties g. 30)";SPINDULIUKŲ;8499650174;Taip;12;0;0;12
21261;"Gilužis (Įsruties g. 30)";SPINDULIUKŲ;4939683067;Taip;7;4;0;11
21262;"Gilužis (Įsruties g. 30)";SPINDULIUKŲ;4483309790;Taip;2;0;2;4
21263;"Gilužis (Įsruties g. 30)";SPINDULIUKŲ;7513403761;Taip;8;0;0;8
21264;"Gilužis (Įsruties g. 30)";SPINDULIUKŲ;8587454386;Taip;7;0;1;8
21265;"Gilužis (Įsruties g. 30)";SPINDULIUKŲ;6582408024;Taip;11;0;0;11
21266;"Gilužis (Įsruties g. 30)";SPINDULIUKŲ;7606952525;Taip;4;1;0;5
21267;"Gilužis (Įsruties g. 30)";SPINDULIUKŲ;8238801880;Taip;10;4;0;14
21268;"Gilužis (Įsruties g. 30)";SPINDULIUKŲ;7924726810;Taip;8;0;0;8
21269;"Gilužis (Įsruties g. 30)";SPINDULIUKŲ;5971465705;Taip;5;0;2;7
21270;"Gilužis (Įsruties g. 30)";SPINDULIUKŲ;9352644751;Taip;19;0;0;19
21271;"Gilužis (Įsruties g. 30)";SPINDULIUKŲ;9689776829;Taip;0;0;3;3
21272;"Gilužis (Įsruties g. 30)";SPINDULIUKŲ;9807489364;Taip;12;0;1;13
21273;"Gilužis (Įsruties g. 30)";ŽIRNIUKŲ;1660797528;Taip;12;0;0;12
21274;"Gilužis (Įsruties g. 30)";ŽIRNIUKŲ;1584356386;Taip;12;0;0;12
21275;"Gilužis (Įsruties g. 30)";ŽIRNIUKŲ;8845494720;Taip;7;0;1;8
21276;"Gilužis (Įsruties g. 30)";ŽIRNIUKŲ;3355341868;Taip;5;0;0;5
21277;"Gilužis (Įsruties g. 30)";ŽIRNIUKŲ;1710906417;Taip;10;0;0;10
21278;"Gilužis (Įsruties g. 30)";ŽIRNIUKŲ;2831924292;Taip;12;0;1;13
21279;"Gilužis (Įsruties g. 30)";ŽIRNIUKŲ;3250662431;Taip;7;0;2;9
21280;"Gilužis (Įsruties g. 30)";ŽIRNIUKŲ;8078194153;Taip;0;1;1;2
21281;"Gilužis (Įsruties g. 30)";ŽIRNIUKŲ;3224917490;Taip;10;0;0;10
21282;"Gilužis (Įsruties g. 30)";ŽIRNIUKŲ;3272561030;Taip;9;0;0;9
21283;"Gilužis (Įsruties g. 30)";ŽIRNIUKŲ;4224203032;Taip;5;0;0;5
21284;"Gilužis (Įsruties g. 30)";ŽIRNIUKŲ;7620828905;Taip;3;0;0;3
21285;"Gilužis (Įsruties g. 30)";ŽIRNIUKŲ;1173529743;Taip;0;9;0;9
21286;"Gilužis (Įsruties g. 30)";ŽIRNIUKŲ;3504412599;Taip;2;14;0;16
21287;"Pilaitukas (Įsruties g. 27)";ŠNEKUČIAI;9940643503;Taip;3;0;0;3
21288;"Pilaitukas (Įsruties g. 27)";ŠNEKUČIAI;1445759374;Taip;1;0;0;1
21289;"Pilaitukas (Įsruties g. 27)";ŠNEKUČIAI;1859101624;Taip;7;0;0;7
21290;"Pilaitukas (Įsruties g. 27)";ŠNEKUČIAI;8479229073;Taip;8;0;0;8
21291;"Pilaitukas (Įsruties g. 27)";ŠNEKUČIAI;9731380502;Taip;3;0;0;3
21292;"Pilaitukas (Įsruties g. 27)";ŠNEKUČIAI;7224121082;Taip;2;0;0;2
21293;"Pilaitukas (Įsruties g. 27)";ŠNEKUČIAI;9115588495;Taip;6;0;0;6
21294;"Pilaitukas (Įsruties g. 27)";ŠNEKUČIAI;1082342063;Taip;5;0;0;5
21295;"Pilaitukas (Įsruties g. 27)";ŠNEKUČIAI;8801482035;Taip;17;0;0;17
21296;"Pilaitukas (Įsruties g. 27)";ŠNEKUČIAI;2894028512;Taip;5;0;0;5
21297;"Pilaitukas (Įsruties g. 27)";ŠNEKUČIAI;9622989196;Taip;5;0;0;5
21298;"Pilaitukas (Įsruties g. 27)";ŠNEKUČIAI;1356473379;Taip;0;23;0;23
21299;"Pilaitukas (Įsruties g. 27)";ŠNEKUČIAI;2883122532;Taip;8;0;0;8
21300;"Pilaitukas (Įsruties g. 27)";ŠNEKUČIAI;2883122532;Taip;8;0;0;8
21301;"Pilaitukas (Įsruties g. 27)";ŠNEKUČIAI;2883122532;Taip;8;0;0;8
21302;"Pilaitukas (Įsruties g. 27)";ŠNEKUČIAI;1309209771;Taip;9;0;0;9
21303;"Pilaitukas (Įsruties g. 27)";ŠNEKUČIAI;6092611227;Taip;8;0;0;8
21304;"Pilaitukas (Įsruties g. 27)";ŠNEKUČIAI;4567479900;Taip;5;3;0;8
21305;"Pilaitukas (Įsruties g. 27)";ŠNEKUČIAI;7933780448;Taip;3;0;0;3
21306;"Pilaitukas (Įsruties g. 27)";SMALSUČIAI;1815311248;Taip;1;0;0;1
21307;"Pilaitukas (Įsruties g. 27)";SMALSUČIAI;3215689222;Taip;2;2;1;5
21308;"Pilaitukas (Įsruties g. 27)";SMALSUČIAI;8755603496;Taip;3;0;3;6
21309;"Pilaitukas (Įsruties g. 27)";SMALSUČIAI;1974429718;Ne;19;0;0;19
21310;"Pilaitukas (Įsruties g. 27)";SMALSUČIAI;4544849086;Taip;10;0;2;12
21311;"Pilaitukas (Įsruties g. 27)";SMALSUČIAI;6934677745;Taip;7;0;0;7
21312;"Pilaitukas (Įsruties g. 27)";SMALSUČIAI;6496708020;Taip;0;0;1;1
21313;"Pilaitukas (Įsruties g. 27)";SMALSUČIAI;4608105047;Taip;6;0;1;7
21314;"Pilaitukas (Įsruties g. 27)";SMALSUČIAI;8698639192;Taip;6;0;3;9
21315;"Pilaitukas (Įsruties g. 27)";SMALSUČIAI;3273127718;Taip;0;4;0;4
21316;"Pilaitukas (Įsruties g. 27)";SMALSUČIAI;4898803794;Taip;8;3;0;11
21317;"Pilaitukas (Įsruties g. 27)";SMALSUČIAI;3544734838;Taip;0;7;0;7
21318;"Pilaitukas (Įsruties g. 27)";SMALSUČIAI;7034013577;Taip;4;3;0;7
21319;"Pilaitukas (Įsruties g. 27)";SMALSUČIAI;1793393776;Taip;7;0;4;11
21320;"Pilaitukas (Įsruties g. 27)";SMALSUČIAI;2210253038;Taip;8;4;2;14
21321;"Pilaitukas (Įsruties g. 27)";" GUDRUČIAI";3068325053;Taip;0;4;0;4
21322;"Pilaitukas (Įsruties g. 27)";" GUDRUČIAI";1571691020;Taip;0;4;0;4
21323;"Pilaitukas (Įsruties g. 27)";" GUDRUČIAI";9186679454;Taip;0;3;0;3
21324;"Pilaitukas (Įsruties g. 27)";" GUDRUČIAI";8584321345;Taip;0;1;0;1
21325;"Pilaitukas (Įsruties g. 27)";" GUDRUČIAI";3621245783;Taip;0;4;2;6
21326;"Pilaitukas (Įsruties g. 27)";" GUDRUČIAI";3927118900;Taip;0;4;1;5
21327;"Pilaitukas (Įsruties g. 27)";" GUDRUČIAI";5464065587;Taip;0;1;0;1
21328;"Pilaitukas (Įsruties g. 27)";" GUDRUČIAI";6844500395;Taip;0;4;0;4
21329;"Pilaitukas (Įsruties g. 27)";" GUDRUČIAI";4810825253;Taip;1;5;0;6
21330;"Pilaitukas (Įsruties g. 27)";" GUDRUČIAI";9774222130;Taip;0;3;2;5
21331;"Pilaitukas (Įsruties g. 27)";" GUDRUČIAI";4623818227;Taip;0;4;0;4
21332;"Pilaitukas (Įsruties g. 27)";" GUDRUČIAI";7568744500;Taip;3;4;1;8
21333;"Pilaitukas (Įsruties g. 27)";" GUDRUČIAI";5407354218;Taip;0;5;0;5
21334;"Pilaitukas (Įsruties g. 27)";" GUDRUČIAI";6838035491;Taip;0;0;1;1
21335;"Pilaitukas (Įsruties g. 27)";" GUDRUČIAI";5326258755;Taip;0;3;0;3
